H_chr	H_start	H_end	Harbor	TE_chr	TE_start	TE_end	TE	score	TE_strand	TE_half	TE_middle_pos	TE_dis
chr1	26400749	26600749	harbor1	chr1	26444317	26444406	DNA/hAT-Charlie	433	+	44	26444361	43612
chr1	16423038	16623038	harbor1	chr1	16431797	16431907	DNA/hAT-Charlie	449	+	55	16431852	8814
chr1	16423038	16623038	harbor1	chr1	16443236	16443542	DNA/hAT-Charlie	803	+	153	16443389	20351
chr1	6046640	6246640	harbor1	chr1	6075938	6076110	DNA/hAT-Charlie	882	+	86	6076024	29384
chr1	108941871	109141871	harbor1	chr1	108953327	108953504	DNA/hAT-Charlie	1033	+	88	108953415	11544
chr1	108941871	109141871	harbor1	chr1	108979853	108980195	DNA/hAT-Charlie	2260	+	171	108980024	38153
chr1	108941871	109141871	harbor1	chr1	108989673	108989703	DNA/hAT-Charlie	446	+	15	108989688	47817
chr1	108941871	109141871	harbor1	chr1	108989995	108990076	DNA/hAT-Charlie	446	+	40	108990035	48164
chr1	108941871	109141871	harbor1	chr1	109019471	109019685	DNA/hAT-Charlie	1063	+	107	109019578	77707
chr1	108941871	109141871	harbor1	chr1	109034474	109034797	DNA/hAT-Charlie	1727	+	162	109034636	92765
chr1	178438257	178638257	harbor1	chr1	178517481	178517657	DNA/hAT-Charlie	678	+	88	178517569	79312
chr1	178438257	178638257	harbor1	chr1	178531650	178531806	DNA/hAT-Charlie	698	+	78	178531728	93471
chr1	178438257	178638257	harbor1	chr1	178536663	178536803	DNA/hAT-Charlie	540	+	70	178536733	98476
chr1	211033794	211233794	harbor1	chr1	211100800	211100948	DNA/hAT-Charlie	588	+	74	211100874	67080
chr1	33156095	33356095	harbor1	chr1	33165889	33166410	DNA/hAT-Charlie	3343	+	260	33166149	10054
chr1	33156095	33356095	harbor1	chr1	33179762	33179952	DNA/hAT-Charlie	591	+	95	33179857	23762
chr1	33156095	33356095	harbor1	chr1	33182274	33182542	DNA/hAT-Charlie	525	+	134	33182408	26313
chr1	33156095	33356095	harbor1	chr1	33177593	33177792	DNA/hAT-Charlie	1074	+	100	33177693	21598
chr1	109183430	109383430	harbor1	chr1	109211037	109211194	DNA/hAT-Charlie	543	+	78	109211115	27685
chr1	109183430	109383430	harbor1	chr1	109231857	109232015	DNA/hAT-Charlie	719	+	79	109231936	48506
chr1	109183430	109383430	harbor1	chr1	109233026	109233186	DNA/hAT-Charlie	728	+	80	109233106	49676
chr1	109183430	109383430	harbor1	chr1	109248211	109248421	DNA/hAT-Charlie	515	+	105	109248316	64886
chr1	717645	917645	harbor1	chr1	782829	783115	DNA/hAT-Charlie	1171	+	143	782972	65327
chr1	717645	917645	harbor1	chr1	795362	795592	DNA/hAT-Charlie	461	+	115	795477	77832
chr1	717645	917645	harbor1	chr1	795939	796100	DNA/hAT-Charlie	817	+	80	796019	78374
chr1	717645	917645	harbor1	chr1	804219	804482	DNA/hAT-Charlie	792	+	132	804351	86706
chr1	47316941	47516941	harbor1	chr1	47331175	47331304	DNA/hAT-Charlie	530	+	64	47331239	14298
chr1	226479130	226679130	harbor1	chr1	226532973	226533170	DNA/hAT-Charlie	962	+	98	226533071	53941
chr1	211033705	211233705	harbor1	chr1	211100800	211100948	DNA/hAT-Charlie	588	+	74	211100874	67169
chr1	47316928	47516928	harbor1	chr1	47331175	47331304	DNA/hAT-Charlie	530	+	64	47331239	14311
chr1	13662912	13862912	harbor1	chr1	13663331	13663395	DNA/hAT-Charlie	1145	+	32	13663363	451
chr1	13662912	13862912	harbor1	chr1	13663692	13663860	DNA/hAT-Charlie	1145	+	84	13663776	864
chr1	13662912	13862912	harbor1	chr1	13678192	13678282	DNA/hAT-Charlie	485	+	45	13678237	15325
chr1	13662912	13862912	harbor1	chr1	13689872	13689891	DNA/hAT-Charlie	519	+	10	13689882	26970
chr1	13662912	13862912	harbor1	chr1	13690247	13690384	DNA/hAT-Charlie	519	+	68	13690315	27403
chr1	13662912	13862912	harbor1	chr1	13737202	13737494	DNA/hAT-Charlie	1543	+	146	13737348	74436
chr1	211033814	211233814	harbor1	chr1	211100800	211100948	DNA/hAT-Charlie	588	+	74	211100874	67060
chr1	6684326	6884326	harbor1	chr1	6685235	6685408	DNA/hAT-Charlie	1770	+	86	6685321	995
chr1	6684326	6884326	harbor1	chr1	6685827	6686113	DNA/hAT-Charlie	1770	+	143	6685970	1644
chr1	6684326	6884326	harbor1	chr1	6686106	6686219	DNA/hAT-Charlie	635	+	56	6686162	1836
chr1	6684326	6884326	harbor1	chr1	6718785	6718893	DNA/hAT-Charlie	1526	+	54	6718839	34513
chr1	6684326	6884326	harbor1	chr1	6719183	6719299	DNA/hAT-Charlie	1526	+	58	6719241	34915
chr1	6684326	6884326	harbor1	chr1	6727636	6727866	DNA/hAT-Charlie	929	+	115	6727751	43425
chr1	6684326	6884326	harbor1	chr1	6743342	6743501	DNA/hAT-Charlie	756	+	80	6743422	59096
chr1	6684326	6884326	harbor1	chr1	6775819	6775994	DNA/hAT-Charlie	801	+	88	6775907	91581
chr1	16625283	16825283	harbor1	chr1	16690584	16690790	DNA/hAT-Charlie	850	+	103	16690687	65404
chr1	16625283	16825283	harbor1	chr1	16695805	16695968	DNA/hAT-Charlie	685	+	82	16695887	70604
chr1	16625207	16825207	harbor1	chr1	16690584	16690790	DNA/hAT-Charlie	850	+	103	16690687	65480
chr1	16625207	16825207	harbor1	chr1	16695805	16695968	DNA/hAT-Charlie	685	+	82	16695887	70680
chr1	17288486	17488486	harbor1	chr1	17291786	17291978	DNA/hAT-Charlie	1005	+	96	17291882	3396
chr1	17288486	17488486	harbor1	chr1	17373988	17374167	DNA/hAT-Charlie	491	+	90	17374078	85592
chr1	21742070	21942070	harbor1	chr1	21824925	21825287	DNA/hAT-Charlie	1362	+	181	21825106	83036
chr1	205330408	205530408	harbor1	chr1	205353140	205353480	DNA/hAT-Charlie	2060	+	170	205353310	22902
chr1	205330408	205530408	harbor1	chr1	205371117	205371250	DNA/hAT-Charlie	441	+	66	205371183	40775
chr1	5895458	6095458	harbor1	chr1	5918991	5919198	DNA/hAT-Charlie	1005	+	104	5919095	23637
chr1	5895458	6095458	harbor1	chr1	5967691	5967918	DNA/hAT-Charlie	1053	+	114	5967805	72347
chr1	5895458	6095458	harbor1	chr1	5987346	5987506	DNA/hAT-Charlie	482	+	80	5987426	91968
chr1	5895458	6095458	harbor1	chr1	5987550	5988662	DNA/hAT-Charlie	4624	+	556	5988106	92648
chr1	5895458	6095458	harbor1	chr1	5991414	5991535	DNA/hAT-Charlie	439	+	60	5991474	96016
chr1	1	128757	harbor1	chr1	27269	27518	DNA/hAT-Charlie	1300	+	124	27393	27392
chr1	1	128757	harbor1	chr1	37045	37431	DNA/hAT-Charlie	1566	+	193	37238	37237
chr1	39855348	40055348	harbor1	chr1	39863884	39863930	DNA/hAT-Charlie	889	+	23	39863907	8559
chr1	39855348	40055348	harbor1	chr1	39864186	39864327	DNA/hAT-Charlie	889	+	70	39864256	8908
chr1	39855348	40055348	harbor1	chr1	39864619	39864664	DNA/hAT-Charlie	889	+	22	39864641	9293
chr1	39855348	40055348	harbor1	chr1	39928377	39928718	DNA/hAT-Charlie	2389	+	170	39928547	73199
chr1	15323291	15523291	harbor1	chr1	15337507	15337672	DNA/hAT-Charlie	711	+	82	15337589	14298
chr1	15323291	15523291	harbor1	chr1	15346220	15346508	DNA/hAT-Charlie	506	+	144	15346364	23073
chr1	15323291	15523291	harbor1	chr1	15373076	15373225	DNA/hAT-Charlie	506	+	74	15373150	49859
chr1	15323291	15523291	harbor1	chr1	15395712	15395903	DNA/hAT-Charlie	1338	+	96	15395808	72517
chr1	15323291	15523291	harbor1	chr1	15400501	15400710	DNA/hAT-Charlie	1133	+	104	15400605	77314
chr1	15323291	15523291	harbor1	chr1	15416722	15416815	DNA/hAT-Charlie	460	+	46	15416768	93477
chr1	15323291	15523291	harbor1	chr1	15417111	15417168	DNA/hAT-Charlie	460	+	28	15417139	93848
chr1	755937	955937	harbor1	chr1	782829	783115	DNA/hAT-Charlie	1171	+	143	782972	27035
chr1	755937	955937	harbor1	chr1	795362	795592	DNA/hAT-Charlie	461	+	115	795477	39540
chr1	755937	955937	harbor1	chr1	795939	796100	DNA/hAT-Charlie	817	+	80	796019	40082
chr1	755937	955937	harbor1	chr1	804219	804482	DNA/hAT-Charlie	792	+	132	804351	48414
chr1	755937	955937	harbor1	chr1	818622	818794	DNA/hAT-Charlie	517	+	86	818708	62771
chr1	755937	955937	harbor1	chr1	841508	841658	DNA/hAT-Charlie	530	+	75	841583	85646
chr1	755937	955937	harbor1	chr1	846972	847188	DNA/hAT-Charlie	799	+	108	847080	91143
chr1	47234717	47434717	harbor1	chr1	47236524	47236693	DNA/hAT-Charlie	817	+	84	47236608	1891
chr1	47234717	47434717	harbor1	chr1	47331175	47331304	DNA/hAT-Charlie	530	+	64	47331239	96522
chr1	29137918	29337918	harbor1	chr1	29204396	29204617	DNA/hAT-Charlie	707	+	110	29204506	66588
chr1	29137918	29337918	harbor1	chr1	29211025	29211088	DNA/hAT-Charlie	1074	+	32	29211057	73139
chr1	29137918	29337918	harbor1	chr1	29211366	29211531	DNA/hAT-Charlie	1074	+	82	29211448	73530
chr1	87225746	87425746	harbor1	chr1	87266882	87267107	DNA/hAT-Charlie	1068	+	112	87266994	41248
chr1	87225746	87425746	harbor1	chr1	87303970	87304257	DNA/hAT-Charlie	751	+	144	87304114	78368
chr1	211033766	211233766	harbor1	chr1	211100800	211100948	DNA/hAT-Charlie	588	+	74	211100874	67108
chr1	11498163	11698163	harbor1	chr1	11505069	11505203	DNA/hAT-Charlie	528	+	67	11505136	6973
chr1	11498163	11698163	harbor1	chr1	11567619	11567822	DNA/hAT-Charlie	1135	+	102	11567721	69558
chr1	11498163	11698163	harbor1	chr1	11584689	11585005	DNA/hAT-Charlie	1663	+	158	11584847	86684
chr1	154985127	155185127	harbor1	chr1	155076027	155076212	DNA/hAT-Charlie	441	+	92	155076119	90992
chr1	154985127	155185127	harbor1	chr1	155076267	155076326	DNA/hAT-Charlie	441	+	30	155076297	91170
chr1	26400777	26600777	harbor1	chr1	26444317	26444406	DNA/hAT-Charlie	433	+	44	26444361	43584
chr1	51230780	51430780	harbor1	chr1	51259084	51259296	DNA/hAT-Charlie	1047	+	106	51259190	28410
chr1	51230780	51430780	harbor1	chr1	51300406	51300570	DNA/hAT-Charlie	431	+	82	51300488	69708
chr1	51230780	51430780	harbor1	chr1	51303934	51304388	DNA/hAT-Charlie	795	+	227	51304161	73381
chr1	244605801	244805801	harbor1	chr1	244643746	244644002	DNA/hAT-Charlie	1595	+	128	244643874	38073
chr1	244605801	244805801	harbor1	chr1	244671617	244671860	DNA/hAT-Charlie	659	+	122	244671739	65938
chr1	244605801	244805801	harbor1	chr1	244692782	244692945	DNA/hAT-Charlie	847	+	82	244692864	87063
chr1	244605801	244805801	harbor1	chr1	244694199	244694378	DNA/hAT-Charlie	647	+	90	244694289	88488
chr1	244605801	244805801	harbor1	chr1	244694752	244694914	DNA/hAT-Charlie	906	+	81	244694833	89032
chr1	6685401	6885401	harbor1	chr1	6685235	6685408	DNA/hAT-Charlie	1770	+	86	6685321	80
chr1	6685401	6885401	harbor1	chr1	6685827	6686113	DNA/hAT-Charlie	1770	+	143	6685970	569
chr1	6685401	6885401	harbor1	chr1	6686106	6686219	DNA/hAT-Charlie	635	+	56	6686162	761
chr1	6685401	6885401	harbor1	chr1	6718785	6718893	DNA/hAT-Charlie	1526	+	54	6718839	33438
chr1	6685401	6885401	harbor1	chr1	6719183	6719299	DNA/hAT-Charlie	1526	+	58	6719241	33840
chr1	6685401	6885401	harbor1	chr1	6727636	6727866	DNA/hAT-Charlie	929	+	115	6727751	42350
chr1	6685401	6885401	harbor1	chr1	6743342	6743501	DNA/hAT-Charlie	756	+	80	6743422	58021
chr1	6685401	6885401	harbor1	chr1	6775819	6775994	DNA/hAT-Charlie	801	+	88	6775907	90506
chr1	39855400	40055400	harbor1	chr1	39863884	39863930	DNA/hAT-Charlie	889	+	23	39863907	8507
chr1	39855400	40055400	harbor1	chr1	39864186	39864327	DNA/hAT-Charlie	889	+	70	39864256	8856
chr1	39855400	40055400	harbor1	chr1	39864619	39864664	DNA/hAT-Charlie	889	+	22	39864641	9241
chr1	39855400	40055400	harbor1	chr1	39928377	39928718	DNA/hAT-Charlie	2389	+	170	39928547	73147
chr1	226638244	226838244	harbor1	chr1	226665028	226665134	DNA/hAT-Charlie	443	+	53	226665081	26837
chr1	226638244	226838244	harbor1	chr1	226714854	226715039	DNA/hAT-Charlie	957	+	92	226714946	76702
chr1	16624842	16824842	harbor1	chr1	16690584	16690790	DNA/hAT-Charlie	850	+	103	16690687	65845
chr1	16624842	16824842	harbor1	chr1	16695805	16695968	DNA/hAT-Charlie	685	+	82	16695887	71045
chr1	16625292	16825292	harbor1	chr1	16690584	16690790	DNA/hAT-Charlie	850	+	103	16690687	65395
chr1	16625292	16825292	harbor1	chr1	16695805	16695968	DNA/hAT-Charlie	685	+	82	16695887	70595
chr1	54939721	55139721	harbor1	chr1	54955363	54955552	DNA/hAT-Charlie	780	+	94	54955457	15736
chr1	54939721	55139721	harbor1	chr1	54968988	54969121	DNA/hAT-Charlie	518	+	66	54969054	29333
chr1	15213281	15413281	harbor1	chr1	15227260	15227448	DNA/hAT-Charlie	849	+	94	15227354	14073
chr1	15213281	15413281	harbor1	chr1	15278075	15278271	DNA/hAT-Charlie	962	+	98	15278173	64892
chr1	15213281	15413281	harbor1	chr1	15309561	15309791	DNA/hAT-Charlie	1567	+	115	15309676	96395
chr1	15213281	15413281	harbor1	chr1	15310572	15310724	DNA/hAT-Charlie	752	+	76	15310648	97367
chr1	15213189	15413189	harbor1	chr1	15227260	15227448	DNA/hAT-Charlie	849	+	94	15227354	14165
chr1	15213189	15413189	harbor1	chr1	15278075	15278271	DNA/hAT-Charlie	962	+	98	15278173	64984
chr1	15213189	15413189	harbor1	chr1	15309561	15309791	DNA/hAT-Charlie	1567	+	115	15309676	96487
chr1	15213189	15413189	harbor1	chr1	15310572	15310724	DNA/hAT-Charlie	752	+	76	15310648	97459
chr1	10110200	10310200	harbor1	chr1	10190960	10191191	DNA/hAT-Charlie	1778	+	116	10191076	80876
chr1	205329486	205529486	harbor1	chr1	205353140	205353480	DNA/hAT-Charlie	2060	+	170	205353310	23824
chr1	205329486	205529486	harbor1	chr1	205371117	205371250	DNA/hAT-Charlie	441	+	66	205371183	41697
chr1	16625346	16825346	harbor1	chr1	16690584	16690790	DNA/hAT-Charlie	850	+	103	16690687	65341
chr1	16625346	16825346	harbor1	chr1	16695805	16695968	DNA/hAT-Charlie	685	+	82	16695887	70541
chr1	51230829	51430829	harbor1	chr1	51259084	51259296	DNA/hAT-Charlie	1047	+	106	51259190	28361
chr1	51230829	51430829	harbor1	chr1	51300406	51300570	DNA/hAT-Charlie	431	+	82	51300488	69659
chr1	51230829	51430829	harbor1	chr1	51303934	51304388	DNA/hAT-Charlie	795	+	227	51304161	73332
chr1	11740558	11940558	harbor1	chr1	11778332	11778493	DNA/hAT-Charlie	432	+	80	11778412	37854
chr1	11740558	11940558	harbor1	chr1	11819027	11819186	DNA/hAT-Charlie	928	+	80	11819107	78549
chr1	11740558	11940558	harbor1	chr1	11831454	11831575	DNA/hAT-Charlie	575	+	60	11831514	90956
chr1	4224540	4424540	harbor1	chr1	4256280	4256472	DNA/hAT-Charlie	522	+	96	4256376	31836
chr1	154870697	155070697	harbor1	chr1	154910581	154910792	DNA/hAT-Charlie	621	+	106	154910687	39990
chr1	43447541	43647541	harbor1	chr1	43449057	43449216	DNA/hAT-Charlie	727	+	80	43449137	1596
chr1	43447541	43647541	harbor1	chr1	43503954	43504078	DNA/hAT-Charlie	490	+	62	43504016	56475
chr1	43447541	43647541	harbor1	chr1	43509213	43509433	DNA/hAT-Charlie	1349	+	110	43509323	61782
chr1	43447541	43647541	harbor1	chr1	43515553	43515748	DNA/hAT-Charlie	944	+	98	43515651	68110
chr1	726325	926325	harbor1	chr1	782829	783115	DNA/hAT-Charlie	1171	+	143	782972	56647
chr1	726325	926325	harbor1	chr1	795362	795592	DNA/hAT-Charlie	461	+	115	795477	69152
chr1	726325	926325	harbor1	chr1	795939	796100	DNA/hAT-Charlie	817	+	80	796019	69694
chr1	726325	926325	harbor1	chr1	804219	804482	DNA/hAT-Charlie	792	+	132	804351	78026
chr1	726325	926325	harbor1	chr1	818622	818794	DNA/hAT-Charlie	517	+	86	818708	92383
chr1	226637969	226837969	harbor1	chr1	226665028	226665134	DNA/hAT-Charlie	443	+	53	226665081	27112
chr1	226637969	226837969	harbor1	chr1	226714854	226715039	DNA/hAT-Charlie	957	+	92	226714946	76977
chr1	86604779	86804779	harbor1	chr1	86702566	86702710	DNA/hAT-Charlie	602	+	72	86702638	97859
chr1	25518162	25718162	harbor1	chr1	25542660	25542767	DNA/hAT-Charlie	1443	+	54	25542714	24552
chr1	25518162	25718162	harbor1	chr1	25543080	25543209	DNA/hAT-Charlie	1443	+	64	25543144	24982
chr1	25518162	25718162	harbor1	chr1	25546782	25546939	DNA/hAT-Charlie	993	+	78	25546860	28698
chr1	25518162	25718162	harbor1	chr1	25607602	25607751	DNA/hAT-Charlie	644	+	74	25607676	89514
chr1	25518162	25718162	harbor1	chr1	25608047	25608086	DNA/hAT-Charlie	644	+	20	25608067	89905
chr1	25518162	25718162	harbor1	chr1	25608397	25608463	DNA/hAT-Charlie	644	+	33	25608430	90268
chr1	53370479	53570479	harbor1	chr1	53382899	53383038	DNA/hAT-Charlie	527	+	70	53382969	12490
chr1	53370479	53570479	harbor1	chr1	53443150	53443369	DNA/hAT-Charlie	722	+	110	53443260	72781
chr1	16625216	16825216	harbor1	chr1	16690584	16690790	DNA/hAT-Charlie	850	+	103	16690687	65471
chr1	16625216	16825216	harbor1	chr1	16695805	16695968	DNA/hAT-Charlie	685	+	82	16695887	70671
chr1	16625249	16825249	harbor1	chr1	16690584	16690790	DNA/hAT-Charlie	850	+	103	16690687	65438
chr1	16625249	16825249	harbor1	chr1	16695805	16695968	DNA/hAT-Charlie	685	+	82	16695887	70638
chr1	244589301	244789301	harbor1	chr1	244589513	244589675	DNA/hAT-Charlie	792	+	81	244589594	293
chr1	244589301	244789301	harbor1	chr1	244643746	244644002	DNA/hAT-Charlie	1595	+	128	244643874	54573
chr1	244589301	244789301	harbor1	chr1	244671617	244671860	DNA/hAT-Charlie	659	+	122	244671739	82438
chr1	3141145	3341145	harbor1	chr1	3192835	3192996	DNA/hAT-Charlie	628	+	80	3192915	51770
chr1	16596778	16796778	harbor1	chr1	16690584	16690790	DNA/hAT-Charlie	850	+	103	16690687	93909
chr1	16596778	16796778	harbor1	chr1	16695805	16695968	DNA/hAT-Charlie	685	+	82	16695887	99109
chr1	16619578	16819578	harbor1	chr1	16690584	16690790	DNA/hAT-Charlie	850	+	103	16690687	71109
chr1	16619578	16819578	harbor1	chr1	16695805	16695968	DNA/hAT-Charlie	685	+	82	16695887	76309
chr1	226638245	226838245	harbor1	chr1	226665028	226665134	DNA/hAT-Charlie	443	+	53	226665081	26836
chr1	226638245	226838245	harbor1	chr1	226714854	226715039	DNA/hAT-Charlie	957	+	92	226714946	76701
chr1	154985666	155185666	harbor1	chr1	155076027	155076212	DNA/hAT-Charlie	441	+	92	155076119	90453
chr1	154985666	155185666	harbor1	chr1	155076267	155076326	DNA/hAT-Charlie	441	+	30	155076297	90631
chr1	53846279	54046279	harbor1	chr1	53849758	53850037	DNA/hAT-Charlie	642	+	140	53849898	3619
chr1	53846279	54046279	harbor1	chr1	53905704	53905855	DNA/hAT-Charlie	494	+	76	53905780	59501
chr1	53846279	54046279	harbor1	chr1	53942265	53942585	DNA/hAT-Charlie	1467	+	160	53942425	96146
chr1	53846338	54046338	harbor1	chr1	53849758	53850037	DNA/hAT-Charlie	642	+	140	53849898	3560
chr1	53846338	54046338	harbor1	chr1	53905704	53905855	DNA/hAT-Charlie	494	+	76	53905780	59442
chr1	53846338	54046338	harbor1	chr1	53942265	53942585	DNA/hAT-Charlie	1467	+	160	53942425	96087
chr1	154400577	154600577	harbor1	chr1	154404900	154405005	DNA/hAT-Charlie	505	+	52	154404952	4375
chr1	204585380	204785380	harbor1	chr1	204608619	204608786	DNA/hAT-Charlie	912	+	84	204608703	23323
chr1	204585380	204785380	harbor1	chr1	204615941	204616118	DNA/hAT-Charlie	656	+	88	204616029	30649
chr1	204585380	204785380	harbor1	chr1	204626756	204626882	DNA/hAT-Charlie	443	+	63	204626819	41439
chr1	204585380	204785380	harbor1	chr1	204630988	204631180	DNA/hAT-Charlie	955	+	96	204631084	45704
chr1	204585380	204785380	harbor1	chr1	204643263	204643428	DNA/hAT-Charlie	567	+	82	204643345	57965
chr1	204585380	204785380	harbor1	chr1	204646613	204646802	DNA/hAT-Charlie	772	+	94	204646707	61327
chr1	204585380	204785380	harbor1	chr1	204647753	204647988	DNA/hAT-Charlie	1032	+	118	204647871	62491
chr1	1676051	1876051	harbor1	chr1	1768927	1769088	DNA/hAT-Charlie	435	+	80	1769007	92956
chr1	16625276	16825276	harbor1	chr1	16690584	16690790	DNA/hAT-Charlie	850	+	103	16690687	65411
chr1	16625276	16825276	harbor1	chr1	16695805	16695968	DNA/hAT-Charlie	685	+	82	16695887	70611
chr1	211033792	211233792	harbor1	chr1	211100800	211100948	DNA/hAT-Charlie	588	+	74	211100874	67082
chr1	59714670	59914670	harbor1	chr1	59715821	59716035	DNA/hAT-Charlie	1155	+	107	59715928	1258
chr1	59714670	59914670	harbor1	chr1	59740815	59741115	DNA/hAT-Charlie	1418	+	150	59740965	26295
chr1	59714670	59914670	harbor1	chr1	59770977	59771156	DNA/hAT-Charlie	526	+	90	59771067	56397
chr1	244735088	244935088	harbor1	chr1	244786350	244786446	DNA/hAT-Charlie	561	+	48	244786398	51310
chr1	244735088	244935088	harbor1	chr1	244797936	244798144	DNA/hAT-Charlie	1398	+	104	244798040	62952
chr1	9254542	9454542	harbor1	chr1	9351081	9351242	DNA/hAT-Charlie	784	+	80	9351161	96619
chr1	9254542	9454542	harbor1	chr1	9352399	9352571	DNA/hAT-Charlie	597	+	86	9352485	97943
chr1	25516681	25716681	harbor1	chr1	25542660	25542767	DNA/hAT-Charlie	1443	+	54	25542714	26033
chr1	25516681	25716681	harbor1	chr1	25543080	25543209	DNA/hAT-Charlie	1443	+	64	25543144	26463
chr1	25516681	25716681	harbor1	chr1	25546782	25546939	DNA/hAT-Charlie	993	+	78	25546860	30179
chr1	25516681	25716681	harbor1	chr1	25607602	25607751	DNA/hAT-Charlie	644	+	74	25607676	90995
chr1	25516681	25716681	harbor1	chr1	25608047	25608086	DNA/hAT-Charlie	644	+	20	25608067	91386
chr1	25516681	25716681	harbor1	chr1	25608397	25608463	DNA/hAT-Charlie	644	+	33	25608430	91749
chr1	116272513	116472513	harbor1	chr1	116278253	116278426	DNA/hAT-Charlie	496	+	86	116278339	5826
chr1	116272513	116472513	harbor1	chr1	116288756	116288936	DNA/hAT-Charlie	916	+	90	116288846	16333
chr1	116272513	116472513	harbor1	chr1	116289305	116289509	DNA/hAT-Charlie	947	+	102	116289407	16894
chr1	116272513	116472513	harbor1	chr1	116306301	116306799	DNA/hAT-Charlie	2058	+	249	116306550	34037
chr1	116272513	116472513	harbor1	chr1	116313467	116313650	DNA/hAT-Charlie	819	+	92	116313559	41046
chr1	116272513	116472513	harbor1	chr1	116314011	116314136	DNA/hAT-Charlie	536	+	62	116314073	41560
chr1	116272513	116472513	harbor1	chr1	116325749	116325932	DNA/hAT-Charlie	1221	+	92	116325841	53328
chr1	116272513	116472513	harbor1	chr1	116335438	116335603	DNA/hAT-Charlie	678	+	82	116335520	63007
chr1	244605835	244805835	harbor1	chr1	244643746	244644002	DNA/hAT-Charlie	1595	+	128	244643874	38039
chr1	244605835	244805835	harbor1	chr1	244671617	244671860	DNA/hAT-Charlie	659	+	122	244671739	65904
chr1	244605835	244805835	harbor1	chr1	244692782	244692945	DNA/hAT-Charlie	847	+	82	244692864	87029
chr1	244605835	244805835	harbor1	chr1	244694199	244694378	DNA/hAT-Charlie	647	+	90	244694289	88454
chr1	244605835	244805835	harbor1	chr1	244694752	244694914	DNA/hAT-Charlie	906	+	81	244694833	88998
chr1	244605400	244805400	harbor1	chr1	244643746	244644002	DNA/hAT-Charlie	1595	+	128	244643874	38474
chr1	244605400	244805400	harbor1	chr1	244671617	244671860	DNA/hAT-Charlie	659	+	122	244671739	66339
chr1	244605400	244805400	harbor1	chr1	244692782	244692945	DNA/hAT-Charlie	847	+	82	244692864	87464
chr1	244605400	244805400	harbor1	chr1	244694199	244694378	DNA/hAT-Charlie	647	+	90	244694289	88889
chr1	244605400	244805400	harbor1	chr1	244694752	244694914	DNA/hAT-Charlie	906	+	81	244694833	89433
chr1	17019452	17219452	harbor1	chr1	17064634	17064958	DNA/hAT-Charlie	1532	+	162	17064796	45344
chr1	17019452	17219452	harbor1	chr1	17075321	17075517	DNA/hAT-Charlie	939	+	98	17075419	55967
chr1	17019452	17219452	harbor1	chr1	17104319	17104426	DNA/hAT-Charlie	667	+	54	17104373	84921
chr1	17019452	17219452	harbor1	chr1	17104733	17104812	DNA/hAT-Charlie	667	+	40	17104773	85321
chr1	17019452	17219452	harbor1	chr1	17108726	17108912	DNA/hAT-Charlie	455	+	93	17108819	89367
chr1	17019452	17219452	harbor1	chr1	17116940	17117135	DNA/hAT-Charlie	934	+	98	17117038	97586
chr1	17019452	17219452	harbor1	chr1	17117144	17117428	DNA/hAT-Charlie	1195	+	142	17117286	97834
chr1	16625337	16825337	harbor1	chr1	16690584	16690790	DNA/hAT-Charlie	850	+	103	16690687	65350
chr1	16625337	16825337	harbor1	chr1	16695805	16695968	DNA/hAT-Charlie	685	+	82	16695887	70550
chr1	16625340	16825340	harbor1	chr1	16690584	16690790	DNA/hAT-Charlie	850	+	103	16690687	65347
chr1	16625340	16825340	harbor1	chr1	16695805	16695968	DNA/hAT-Charlie	685	+	82	16695887	70547
chr1	30662344	30862344	harbor1	chr1	30755177	30755370	DNA/hAT-Charlie	743	+	96	30755273	92929
chr1	30662344	30862344	harbor1	chr1	30755725	30756015	DNA/hAT-Charlie	556	+	145	30755870	93526
chr1	30662344	30862344	harbor1	chr1	30759511	30759797	DNA/hAT-Charlie	518	+	143	30759654	97310
chr1	51419171	51619171	harbor1	chr1	51467580	51467911	DNA/hAT-Charlie	2275	+	166	51467746	48575
chr1	51419171	51619171	harbor1	chr1	51471896	51472124	DNA/hAT-Charlie	1551	+	114	51472010	52839
chr1	51419171	51619171	harbor1	chr1	51511535	51511737	DNA/hAT-Charlie	1092	+	101	51511636	92465
chr1	110112132	110312132	harbor1	chr1	110193997	110194181	DNA/hAT-Charlie	600	+	92	110194089	81957
chr1	179714840	179914840	harbor1	chr1	179739425	179739654	DNA/hAT-Charlie	1470	+	114	179739539	24699
chr1	179714840	179914840	harbor1	chr1	179772435	179772591	DNA/hAT-Charlie	875	+	78	179772513	57673
chr1	179714840	179914840	harbor1	chr1	179774390	179774511	DNA/hAT-Charlie	551	+	60	179774450	59610
chr1	179714840	179914840	harbor1	chr1	179780519	179780693	DNA/hAT-Charlie	1125	+	87	179780606	65766
chr1	23269371	23469371	harbor1	chr1	23280534	23280636	DNA/hAT-Charlie	563	+	51	23280585	11214
chr1	23269371	23469371	harbor1	chr1	23301560	23301709	DNA/hAT-Charlie	635	+	74	23301634	32263
chr1	23269371	23469371	harbor1	chr1	23335366	23335809	DNA/hAT-Charlie	2920	+	222	23335588	66217
chr1	31080007	31280007	harbor1	chr1	31098456	31098701	DNA/hAT-Charlie	1120	+	122	31098578	18571
chr1	31080007	31280007	harbor1	chr1	31166405	31166613	DNA/hAT-Charlie	1007	+	104	31166509	86502
chr1	726411	926411	harbor1	chr1	782829	783115	DNA/hAT-Charlie	1171	+	143	782972	56561
chr1	726411	926411	harbor1	chr1	795362	795592	DNA/hAT-Charlie	461	+	115	795477	69066
chr1	726411	926411	harbor1	chr1	795939	796100	DNA/hAT-Charlie	817	+	80	796019	69608
chr1	726411	926411	harbor1	chr1	804219	804482	DNA/hAT-Charlie	792	+	132	804351	77940
chr1	726411	926411	harbor1	chr1	818622	818794	DNA/hAT-Charlie	517	+	86	818708	92297
chr1	7671217	7871217	harbor1	chr1	7709845	7709975	DNA/hAT-Charlie	440	+	65	7709910	38693
chr1	7671217	7871217	harbor1	chr1	7725664	7725827	DNA/hAT-Charlie	719	+	82	7725746	54529
chr1	7671217	7871217	harbor1	chr1	7747199	7747369	DNA/hAT-Charlie	440	+	85	7747284	76067
chr1	24895887	25095887	harbor1	chr1	24922320	24922797	DNA/hAT-Charlie	1823	+	238	24922558	26671
chr1	24895887	25095887	harbor1	chr1	24924048	24924084	DNA/hAT-Charlie	829	+	18	24924066	28179
chr1	24895887	25095887	harbor1	chr1	24924385	24924847	DNA/hAT-Charlie	829	+	231	24924616	28729
chr1	24895887	25095887	harbor1	chr1	24962072	24962391	DNA/hAT-Charlie	545	+	160	24962232	66345
chr1	32106047	32306047	harbor1	chr1	32186799	32186925	DNA/hAT-Charlie	1060	+	63	32186862	80815
chr1	32106047	32306047	harbor1	chr1	32187202	32187364	DNA/hAT-Charlie	1060	+	81	32187283	81236
chr1	51229911	51429911	harbor1	chr1	51259084	51259296	DNA/hAT-Charlie	1047	+	106	51259190	29279
chr1	51229911	51429911	harbor1	chr1	51300406	51300570	DNA/hAT-Charlie	431	+	82	51300488	70577
chr1	51229911	51429911	harbor1	chr1	51303934	51304388	DNA/hAT-Charlie	795	+	227	51304161	74250
chr1	244605782	244805782	harbor1	chr1	244643746	244644002	DNA/hAT-Charlie	1595	+	128	244643874	38092
chr1	244605782	244805782	harbor1	chr1	244671617	244671860	DNA/hAT-Charlie	659	+	122	244671739	65957
chr1	244605782	244805782	harbor1	chr1	244692782	244692945	DNA/hAT-Charlie	847	+	82	244692864	87082
chr1	244605782	244805782	harbor1	chr1	244694199	244694378	DNA/hAT-Charlie	647	+	90	244694289	88507
chr1	244605782	244805782	harbor1	chr1	244694752	244694914	DNA/hAT-Charlie	906	+	81	244694833	89051
chr1	20048547	20248547	harbor1	chr1	20064807	20064973	DNA/hAT-Charlie	757	+	83	20064890	16343
chr1	20048547	20248547	harbor1	chr1	20147127	20147301	DNA/hAT-Charlie	857	+	87	20147214	98667
chr1	16625259	16825259	harbor1	chr1	16690584	16690790	DNA/hAT-Charlie	850	+	103	16690687	65428
chr1	16625259	16825259	harbor1	chr1	16695805	16695968	DNA/hAT-Charlie	685	+	82	16695887	70628
chr1	16625336	16825336	harbor1	chr1	16690584	16690790	DNA/hAT-Charlie	850	+	103	16690687	65351
chr1	16625336	16825336	harbor1	chr1	16695805	16695968	DNA/hAT-Charlie	685	+	82	16695887	70551
chr1	22501599	22701599	harbor1	chr1	22536856	22537036	DNA/hAT-Charlie	674	+	90	22536946	35347
chr1	22501599	22701599	harbor1	chr1	22540872	22540970	DNA/hAT-Charlie	471	+	49	22540921	39322
chr1	22501599	22701599	harbor1	chr1	22541887	22541990	DNA/hAT-Charlie	445	+	52	22541939	40340
chr1	22501599	22701599	harbor1	chr1	22542303	22542372	DNA/hAT-Charlie	445	+	34	22542337	40738
chr1	22501599	22701599	harbor1	chr1	22594393	22594547	DNA/hAT-Charlie	673	+	77	22594470	92871
chr1	227983972	228183972	harbor1	chr1	228003167	228003334	DNA/hAT-Charlie	466	+	84	228003251	19279
chr1	194372730	194572730	harbor1	chr1	194373830	194373986	DNA/hAT-Charlie	569	+	78	194373908	1178
chr1	194372730	194572730	harbor1	chr1	194432554	194432895	DNA/hAT-Charlie	759	+	170	194432724	59994
chr1	230025255	230225255	harbor1	chr1	230046034	230046308	DNA/hAT-Charlie	786	+	137	230046171	20916
chr1	230025255	230225255	harbor1	chr1	230087496	230087637	DNA/hAT-Charlie	468	+	70	230087566	62311
chr1	47316981	47516981	harbor1	chr1	47331175	47331304	DNA/hAT-Charlie	530	+	64	47331239	14258
chr1	165531488	165731488	harbor1	chr1	165550323	165550517	DNA/hAT-Charlie	962	+	97	165550420	18932
chr1	165531488	165731488	harbor1	chr1	165594014	165594303	DNA/hAT-Charlie	1379	+	144	165594158	62670
chr1	222687998	222887998	harbor1	chr1	222716544	222716764	DNA/hAT-Charlie	836	+	110	222716654	28656
chr1	222687998	222887998	harbor1	chr1	222784724	222784961	DNA/hAT-Charlie	475	+	118	222784842	96844
chr1	44702951	44902951	harbor1	chr1	44783726	44783905	DNA/hAT-Charlie	919	+	90	44783816	80865
chr1	16625314	16825314	harbor1	chr1	16690584	16690790	DNA/hAT-Charlie	850	+	103	16690687	65373
chr1	16625314	16825314	harbor1	chr1	16695805	16695968	DNA/hAT-Charlie	685	+	82	16695887	70573
chr1	11740582	11940582	harbor1	chr1	11778332	11778493	DNA/hAT-Charlie	432	+	80	11778412	37830
chr1	11740582	11940582	harbor1	chr1	11819027	11819186	DNA/hAT-Charlie	928	+	80	11819107	78525
chr1	11740582	11940582	harbor1	chr1	11831454	11831575	DNA/hAT-Charlie	575	+	60	11831514	90932
chr1	203028332	203228332	harbor1	chr1	203064556	203064859	DNA/hAT-Charlie	1016	+	152	203064708	36376
chr1	153435311	153635311	harbor1	chr1	153503336	153503522	DNA/hAT-Charlie	899	+	93	153503429	68118
chr1	53187531	53387531	harbor1	chr1	53190226	53190474	DNA/hAT-Charlie	1042	+	124	53190350	2819
chr1	53187531	53387531	harbor1	chr1	53194816	53195018	DNA/hAT-Charlie	1281	+	101	53194917	7386
chr1	53187531	53387531	harbor1	chr1	53239210	53239369	DNA/hAT-Charlie	607	+	80	53239290	51759
chr1	207819139	208019139	harbor1	chr1	207857234	207857506	DNA/hAT-Charlie	693	+	136	207857370	38231
chr1	207819139	208019139	harbor1	chr1	207857505	207857641	DNA/hAT-Charlie	1893	+	68	207857573	38434
chr1	207819139	208019139	harbor1	chr1	207857937	207858504	DNA/hAT-Charlie	1893	+	284	207858221	39082
chr1	207819139	208019139	harbor1	chr1	207859106	207859404	DNA/hAT-Charlie	627	+	149	207859255	40116
chr1	207819139	208019139	harbor1	chr1	207881163	207881377	DNA/hAT-Charlie	2167	+	107	207881270	62131
chr1	207819139	208019139	harbor1	chr1	207881684	207881971	DNA/hAT-Charlie	2167	+	144	207881828	62689
chr1	207819139	208019139	harbor1	chr1	207905050	207905137	DNA/hAT-Charlie	870	+	44	207905094	85955
chr1	207819139	208019139	harbor1	chr1	207905436	207905563	DNA/hAT-Charlie	870	+	64	207905500	86361
chr1	89721428	89921428	harbor1	chr1	89731481	89731651	DNA/hAT-Charlie	764	+	85	89731566	10138
chr1	89721428	89921428	harbor1	chr1	89754727	89754941	DNA/hAT-Charlie	1142	+	107	89754834	33406
chr1	89721428	89921428	harbor1	chr1	89800566	89800709	DNA/hAT-Charlie	464	+	72	89800638	79210
chr1	220687422	220887422	harbor1	chr1	220760240	220760746	DNA/hAT-Charlie	1556	+	253	220760493	73071
chr1	220687422	220887422	harbor1	chr1	220760780	220761111	DNA/hAT-Charlie	962	+	166	220760946	73524
chr1	220687422	220887422	harbor1	chr1	220761340	220761481	DNA/hAT-Charlie	713	+	70	220761410	73988
chr1	220687422	220887422	harbor1	chr1	220768154	220768401	DNA/hAT-Charlie	708	+	124	220768278	80856
chr1	204879064	205079064	harbor1	chr1	204892531	204892847	DNA/hAT-Charlie	1272	+	158	204892689	13625
chr1	204879064	205079064	harbor1	chr1	204896985	204897154	DNA/hAT-Charlie	617	+	84	204897069	18005
chr1	204879064	205079064	harbor1	chr1	204918268	204918468	DNA/hAT-Charlie	1295	+	100	204918368	39304
chr1	204879064	205079064	harbor1	chr1	204932562	204932766	DNA/hAT-Charlie	932	+	102	204932664	53600
chr1	204879064	205079064	harbor1	chr1	204943889	204944103	DNA/hAT-Charlie	1114	+	107	204943996	64932
chr1	204879064	205079064	harbor1	chr1	204949622	204949775	DNA/hAT-Charlie	777	+	76	204949698	70634
chr1	16625248	16825248	harbor1	chr1	16690584	16690790	DNA/hAT-Charlie	850	+	103	16690687	65439
chr1	16625248	16825248	harbor1	chr1	16695805	16695968	DNA/hAT-Charlie	685	+	82	16695887	70639
chr1	23877841	24077841	harbor1	chr1	23915656	23915813	DNA/hAT-Charlie	938	+	78	23915734	37893
chr1	53846292	54046292	harbor1	chr1	53849758	53850037	DNA/hAT-Charlie	642	+	140	53849898	3606
chr1	53846292	54046292	harbor1	chr1	53905704	53905855	DNA/hAT-Charlie	494	+	76	53905780	59488
chr1	53846292	54046292	harbor1	chr1	53942265	53942585	DNA/hAT-Charlie	1467	+	160	53942425	96133
chr1	207924797	208124797	harbor1	chr1	208001327	208001487	DNA/hAT-Charlie	684	+	80	208001407	76610
chr1	7604696	7804696	harbor1	chr1	7620171	7620367	DNA/hAT-Charlie	883	+	98	7620269	15573
chr1	7604696	7804696	harbor1	chr1	7640081	7640291	DNA/hAT-Charlie	945	+	105	7640186	35490
chr1	53370409	53570409	harbor1	chr1	53382899	53383038	DNA/hAT-Charlie	527	+	70	53382969	12560
chr1	53370409	53570409	harbor1	chr1	53443150	53443369	DNA/hAT-Charlie	722	+	110	53443260	72851
chr1	19565207	19765207	harbor1	chr1	19567266	19567670	DNA/hAT-Charlie	1784	+	202	19567468	2261
chr1	19565207	19765207	harbor1	chr1	19567988	19568071	DNA/hAT-Charlie	1784	+	42	19568030	2823
chr1	43447553	43647553	harbor1	chr1	43449057	43449216	DNA/hAT-Charlie	727	+	80	43449137	1584
chr1	43447553	43647553	harbor1	chr1	43503954	43504078	DNA/hAT-Charlie	490	+	62	43504016	56463
chr1	43447553	43647553	harbor1	chr1	43509213	43509433	DNA/hAT-Charlie	1349	+	110	43509323	61770
chr1	43447553	43647553	harbor1	chr1	43515553	43515748	DNA/hAT-Charlie	944	+	98	43515651	68098
chr1	53846310	54046310	harbor1	chr1	53849758	53850037	DNA/hAT-Charlie	642	+	140	53849898	3588
chr1	53846310	54046310	harbor1	chr1	53905704	53905855	DNA/hAT-Charlie	494	+	76	53905780	59470
chr1	53846310	54046310	harbor1	chr1	53942265	53942585	DNA/hAT-Charlie	1467	+	160	53942425	96115
chr1	25773550	25973550	harbor1	chr1	25773880	25774034	DNA/hAT-Charlie	565	+	77	25773957	407
chr1	245603515	245803515	harbor1	chr1	245621023	245621196	DNA/hAT-Charlie	781	+	86	245621109	17594
chr1	245603515	245803515	harbor1	chr1	245651580	245651901	DNA/hAT-Charlie	1861	+	160	245651740	48225
chr1	26400758	26600758	harbor1	chr1	26444317	26444406	DNA/hAT-Charlie	433	+	44	26444361	43603
chr1	13663032	13863032	harbor1	chr1	13663331	13663395	DNA/hAT-Charlie	1145	+	32	13663363	331
chr1	13663032	13863032	harbor1	chr1	13663692	13663860	DNA/hAT-Charlie	1145	+	84	13663776	744
chr1	13663032	13863032	harbor1	chr1	13678192	13678282	DNA/hAT-Charlie	485	+	45	13678237	15205
chr1	13663032	13863032	harbor1	chr1	13689872	13689891	DNA/hAT-Charlie	519	+	10	13689882	26850
chr1	13663032	13863032	harbor1	chr1	13690247	13690384	DNA/hAT-Charlie	519	+	68	13690315	27283
chr1	13663032	13863032	harbor1	chr1	13737202	13737494	DNA/hAT-Charlie	1543	+	146	13737348	74316
chr1	40761841	40961841	harbor1	chr1	40794579	40794827	DNA/hAT-Charlie	931	+	124	40794703	32862
chr1	40761841	40961841	harbor1	chr1	40811389	40811569	DNA/hAT-Charlie	952	+	90	40811479	49638
chr1	40761841	40961841	harbor1	chr1	40826306	40826480	DNA/hAT-Charlie	486	+	87	40826393	64552
chr1	230759103	230959103	harbor1	chr1	230797044	230797192	DNA/hAT-Charlie	487	+	74	230797118	38015
chr1	230759103	230959103	harbor1	chr1	230798776	230798930	DNA/hAT-Charlie	540	+	77	230798853	39750
chr1	230759103	230959103	harbor1	chr1	230800669	230800818	DNA/hAT-Charlie	791	+	74	230800743	41640
chr1	16625224	16825224	harbor1	chr1	16690584	16690790	DNA/hAT-Charlie	850	+	103	16690687	65463
chr1	16625224	16825224	harbor1	chr1	16695805	16695968	DNA/hAT-Charlie	685	+	82	16695887	70663
chr1	24195409	24395409	harbor1	chr1	24211471	24211748	DNA/hAT-Charlie	1167	+	138	24211609	16200
chr1	24195409	24395409	harbor1	chr1	24234982	24235207	DNA/hAT-Charlie	1076	+	112	24235094	39685
chr1	24195409	24395409	harbor1	chr1	24248688	24248948	DNA/hAT-Charlie	597	+	130	24248818	53409
chr1	13662918	13862918	harbor1	chr1	13663331	13663395	DNA/hAT-Charlie	1145	+	32	13663363	445
chr1	13662918	13862918	harbor1	chr1	13663692	13663860	DNA/hAT-Charlie	1145	+	84	13663776	858
chr1	13662918	13862918	harbor1	chr1	13678192	13678282	DNA/hAT-Charlie	485	+	45	13678237	15319
chr1	13662918	13862918	harbor1	chr1	13689872	13689891	DNA/hAT-Charlie	519	+	10	13689882	26964
chr1	13662918	13862918	harbor1	chr1	13690247	13690384	DNA/hAT-Charlie	519	+	68	13690315	27397
chr1	13662918	13862918	harbor1	chr1	13737202	13737494	DNA/hAT-Charlie	1543	+	146	13737348	74430
chr1	31972870	32172870	harbor1	chr1	32028202	32028369	DNA/hAT-Charlie	776	+	84	32028286	55416
chr1	31972870	32172870	harbor1	chr1	32054686	32054876	DNA/hAT-Charlie	1201	+	95	32054781	81911
chr1	16625200	16825200	harbor1	chr1	16690584	16690790	DNA/hAT-Charlie	850	+	103	16690687	65487
chr1	16625200	16825200	harbor1	chr1	16695805	16695968	DNA/hAT-Charlie	685	+	82	16695887	70687
chr1	205329484	205529484	harbor1	chr1	205353140	205353480	DNA/hAT-Charlie	2060	+	170	205353310	23826
chr1	205329484	205529484	harbor1	chr1	205371117	205371250	DNA/hAT-Charlie	441	+	66	205371183	41699
chr1	13672401	13872401	harbor1	chr1	13678192	13678282	DNA/hAT-Charlie	485	+	45	13678237	5836
chr1	13672401	13872401	harbor1	chr1	13689872	13689891	DNA/hAT-Charlie	519	+	10	13689882	17481
chr1	13672401	13872401	harbor1	chr1	13690247	13690384	DNA/hAT-Charlie	519	+	68	13690315	17914
chr1	13672401	13872401	harbor1	chr1	13737202	13737494	DNA/hAT-Charlie	1543	+	146	13737348	64947
chr1	13672401	13872401	harbor1	chr1	13769851	13770066	DNA/hAT-Charlie	988	+	108	13769959	97558
chr1	248592141	248792141	harbor1	chr1	248651792	248652073	DNA/hAT-Charlie	645	+	140	248651932	59791
chr1	6685469	6885469	harbor1	chr1	6685827	6686113	DNA/hAT-Charlie	1770	+	143	6685970	501
chr1	6685469	6885469	harbor1	chr1	6686106	6686219	DNA/hAT-Charlie	635	+	56	6686162	693
chr1	6685469	6885469	harbor1	chr1	6718785	6718893	DNA/hAT-Charlie	1526	+	54	6718839	33370
chr1	6685469	6885469	harbor1	chr1	6719183	6719299	DNA/hAT-Charlie	1526	+	58	6719241	33772
chr1	6685469	6885469	harbor1	chr1	6727636	6727866	DNA/hAT-Charlie	929	+	115	6727751	42282
chr1	6685469	6885469	harbor1	chr1	6743342	6743501	DNA/hAT-Charlie	756	+	80	6743422	57953
chr1	6685469	6885469	harbor1	chr1	6775819	6775994	DNA/hAT-Charlie	801	+	88	6775907	90438
chr1	244605833	244805833	harbor1	chr1	244643746	244644002	DNA/hAT-Charlie	1595	+	128	244643874	38041
chr1	244605833	244805833	harbor1	chr1	244671617	244671860	DNA/hAT-Charlie	659	+	122	244671739	65906
chr1	244605833	244805833	harbor1	chr1	244692782	244692945	DNA/hAT-Charlie	847	+	82	244692864	87031
chr1	244605833	244805833	harbor1	chr1	244694199	244694378	DNA/hAT-Charlie	647	+	90	244694289	88456
chr1	244605833	244805833	harbor1	chr1	244694752	244694914	DNA/hAT-Charlie	906	+	81	244694833	89000
chr1	40913010	41113010	harbor1	chr1	40939933	40940075	DNA/hAT-Charlie	469	+	71	40940004	26994
chr1	40913010	41113010	harbor1	chr1	40940060	40940216	DNA/hAT-Charlie	669	+	78	40940138	27128
chr1	40913010	41113010	harbor1	chr1	40950741	40950912	DNA/hAT-Charlie	429	+	86	40950827	37817
chr1	40913010	41113010	harbor1	chr1	40956541	40956874	DNA/hAT-Charlie	779	+	166	40956707	43697
chr1	40913010	41113010	harbor1	chr1	40960075	40960144	DNA/hAT-Charlie	3116	+	34	40960109	47099
chr1	40913010	41113010	harbor1	chr1	40960442	40960558	DNA/hAT-Charlie	3116	+	58	40960500	47490
chr1	40913010	41113010	harbor1	chr1	40961733	40961999	DNA/hAT-Charlie	3116	+	133	40961866	48856
chr1	40913010	41113010	harbor1	chr1	40962277	40962359	DNA/hAT-Charlie	3116	+	41	40962318	49308
chr1	40913010	41113010	harbor1	chr1	40962665	40962984	DNA/hAT-Charlie	3116	+	160	40962825	49815
chr1	40913010	41113010	harbor1	chr1	40963420	40963443	DNA/hAT-Charlie	3116	+	12	40963432	50422
chr1	40913010	41113010	harbor1	chr1	40963756	40963866	DNA/hAT-Charlie	3116	+	55	40963811	50801
chr1	40913010	41113010	harbor1	chr1	40975366	40975584	DNA/hAT-Charlie	680	+	109	40975475	62465
chr1	40913010	41113010	harbor1	chr1	40990033	40990254	DNA/hAT-Charlie	1063	+	110	40990143	77133
chr1	40913010	41113010	harbor1	chr1	40959824	40960076	DNA/hAT-Charlie	1032	+	126	40959950	46940
chr1	13686837	13886837	harbor1	chr1	13689872	13689891	DNA/hAT-Charlie	519	+	10	13689882	3045
chr1	13686837	13886837	harbor1	chr1	13690247	13690384	DNA/hAT-Charlie	519	+	68	13690315	3478
chr1	13686837	13886837	harbor1	chr1	13737202	13737494	DNA/hAT-Charlie	1543	+	146	13737348	50511
chr1	13686837	13886837	harbor1	chr1	13769851	13770066	DNA/hAT-Charlie	988	+	108	13769959	83122
chr1	234508642	234708642	harbor1	chr1	234524921	234525042	DNA/hAT-Charlie	429	+	60	234524981	16339
chr1	234508642	234708642	harbor1	chr1	234578320	234578465	DNA/hAT-Charlie	578	+	72	234578392	69750
chr1	211033696	211233696	harbor1	chr1	211100800	211100948	DNA/hAT-Charlie	588	+	74	211100874	67178
chr1	24895890	25095890	harbor1	chr1	24922320	24922797	DNA/hAT-Charlie	1823	+	238	24922558	26668
chr1	24895890	25095890	harbor1	chr1	24924048	24924084	DNA/hAT-Charlie	829	+	18	24924066	28176
chr1	24895890	25095890	harbor1	chr1	24924385	24924847	DNA/hAT-Charlie	829	+	231	24924616	28726
chr1	24895890	25095890	harbor1	chr1	24962072	24962391	DNA/hAT-Charlie	545	+	160	24962232	66342
chr1	16625343	16825343	harbor1	chr1	16690584	16690790	DNA/hAT-Charlie	850	+	103	16690687	65344
chr1	16625343	16825343	harbor1	chr1	16695805	16695968	DNA/hAT-Charlie	685	+	82	16695887	70544
chr1	27503616	27703616	harbor1	chr1	27530030	27530160	DNA/hAT-Charlie	639	+	65	27530095	26479
chr1	27503616	27703616	harbor1	chr1	27578102	27578307	DNA/hAT-Charlie	1362	+	102	27578204	74588
chr1	27503616	27703616	harbor1	chr1	27578610	27578697	DNA/hAT-Charlie	1362	+	44	27578654	75038
chr1	27503616	27703616	harbor1	chr1	27578994	27579035	DNA/hAT-Charlie	1362	+	20	27579014	75398
chr1	27503616	27703616	harbor1	chr1	27579650	27579831	DNA/hAT-Charlie	770	+	90	27579740	76124
chr1	148910670	149110670	harbor1	chr1	148937499	148937647	DNA/hAT-Charlie	433	+	74	148937573	26903
chr1	148910670	149110670	harbor1	chr1	148947866	148948053	DNA/hAT-Charlie	1172	+	94	148947960	37290
chr1	148910670	149110670	harbor1	chr1	148958556	148958888	DNA/hAT-Charlie	1470	+	166	148958722	48052
chr1	148910670	149110670	harbor1	chr1	149003119	149003241	DNA/hAT-Charlie	527	+	61	149003180	92510
chr1	3141136	3341136	harbor1	chr1	3192835	3192996	DNA/hAT-Charlie	628	+	80	3192915	51779
chr1	226307818	226507818	harbor1	chr1	226347036	226347216	DNA/hAT-Charlie	982	+	90	226347126	39308
chr1	226307818	226507818	harbor1	chr1	226375549	226375803	DNA/hAT-Charlie	976	+	127	226375676	67858
chr1	54786918	54986918	harbor1	chr1	54793939	54794106	DNA/hAT-Charlie	869	+	84	54794023	7105
chr1	54786918	54986918	harbor1	chr1	54843122	54843411	DNA/hAT-Charlie	1753	+	144	54843266	56348
chr1	54786918	54986918	harbor1	chr1	54856191	54856311	DNA/hAT-Charlie	510	+	60	54856251	69333
chr1	54786918	54986918	harbor1	chr1	54861205	54861379	DNA/hAT-Charlie	566	+	87	54861292	74374
chr1	46503416	46703416	harbor1	chr1	46602561	46602761	DNA/hAT-Charlie	1395	+	100	46602661	99245
chr1	54307464	54507464	harbor1	chr1	54364084	54364303	DNA/hAT-Charlie	1197	+	110	54364194	56730
chr1	54307464	54507464	harbor1	chr1	54370332	54370498	DNA/hAT-Charlie	546	+	83	54370415	62951
chr1	25330942	25530942	harbor1	chr1	25337538	25337749	DNA/hAT-Charlie	911	+	106	25337644	6702
chr1	25330942	25530942	harbor1	chr1	25417284	25417621	DNA/hAT-Charlie	1077	+	168	25417452	86510
chr2	196073592	196273592	harbor1	chr2	196077153	196077364	DNA/hAT-Charlie	1259	+	106	196077259	3667
chr2	196073592	196273592	harbor1	chr2	196122262	196122424	DNA/hAT-Charlie	774	+	81	196122343	48751
chr2	196073592	196273592	harbor1	chr2	196134271	196134571	DNA/hAT-Charlie	1443	+	150	196134421	60829
chr2	196073592	196273592	harbor1	chr2	196148133	196148636	DNA/hAT-Charlie	719	+	252	196148385	74793
chr2	26950219	27150219	harbor1	chr2	26997254	26997472	DNA/hAT-Charlie	1490	+	109	26997363	47144
chr2	26950219	27150219	harbor1	chr2	27037275	27037443	DNA/hAT-Charlie	514	+	84	27037359	87140
chr2	74415405	74615405	harbor1	chr2	74437571	74437731	DNA/hAT-Charlie	498	+	80	74437651	22246
chr2	74415405	74615405	harbor1	chr2	74494651	74494723	DNA/hAT-Charlie	779	+	36	74494687	79282
chr2	74415405	74615405	harbor1	chr2	74495020	74495123	DNA/hAT-Charlie	779	+	52	74495072	79667
chr2	152618051	152818051	harbor1	chr2	152663268	152663415	DNA/hAT-Charlie	863	+	74	152663342	45291
chr2	152618051	152818051	harbor1	chr2	152664820	152665107	DNA/hAT-Charlie	1556	+	144	152664964	46913
chr2	152618051	152818051	harbor1	chr2	152665170	152665358	DNA/hAT-Charlie	638	+	94	152665264	47213
chr2	152618051	152818051	harbor1	chr2	152667713	152667838	DNA/hAT-Charlie	581	+	62	152667775	49724
chr2	152618051	152818051	harbor1	chr2	152674101	152674309	DNA/hAT-Charlie	479	+	104	152674205	56154
chr2	152618051	152818051	harbor1	chr2	152682838	152683140	DNA/hAT-Charlie	1916	+	151	152682989	64938
chr2	152618051	152818051	harbor1	chr2	152699165	152699383	DNA/hAT-Charlie	1361	+	109	152699274	81223
chr2	26950237	27150237	harbor1	chr2	26997254	26997472	DNA/hAT-Charlie	1490	+	109	26997363	47126
chr2	26950237	27150237	harbor1	chr2	27037275	27037443	DNA/hAT-Charlie	514	+	84	27037359	87122
chr2	74453401	74653401	harbor1	chr2	74494651	74494723	DNA/hAT-Charlie	779	+	36	74494687	41286
chr2	74453401	74653401	harbor1	chr2	74495020	74495123	DNA/hAT-Charlie	779	+	52	74495072	41671
chr2	219058841	219258841	harbor1	chr2	219077830	219078031	DNA/hAT-Charlie	1087	+	100	219077930	19089
chr2	219058841	219258841	harbor1	chr2	219078778	219079012	DNA/hAT-Charlie	754	+	117	219078895	20054
chr2	219058841	219258841	harbor1	chr2	219128104	219128369	DNA/hAT-Charlie	1310	+	132	219128236	69395
chr2	218221236	218421236	harbor1	chr2	218317227	218317360	DNA/hAT-Charlie	460	+	66	218317293	96057
chr2	219073554	219273554	harbor1	chr2	219077830	219078031	DNA/hAT-Charlie	1087	+	100	219077930	4376
chr2	219073554	219273554	harbor1	chr2	219078778	219079012	DNA/hAT-Charlie	754	+	117	219078895	5341
chr2	219073554	219273554	harbor1	chr2	219128104	219128369	DNA/hAT-Charlie	1310	+	132	219128236	54682
chr2	219073013	219273013	harbor1	chr2	219077830	219078031	DNA/hAT-Charlie	1087	+	100	219077930	4917
chr2	219073013	219273013	harbor1	chr2	219078778	219079012	DNA/hAT-Charlie	754	+	117	219078895	5882
chr2	219073013	219273013	harbor1	chr2	219128104	219128369	DNA/hAT-Charlie	1310	+	132	219128236	55223
chr2	152617998	152817998	harbor1	chr2	152663268	152663415	DNA/hAT-Charlie	863	+	74	152663342	45344
chr2	152617998	152817998	harbor1	chr2	152664820	152665107	DNA/hAT-Charlie	1556	+	144	152664964	46966
chr2	152617998	152817998	harbor1	chr2	152665170	152665358	DNA/hAT-Charlie	638	+	94	152665264	47266
chr2	152617998	152817998	harbor1	chr2	152667713	152667838	DNA/hAT-Charlie	581	+	62	152667775	49777
chr2	152617998	152817998	harbor1	chr2	152674101	152674309	DNA/hAT-Charlie	479	+	104	152674205	56207
chr2	152617998	152817998	harbor1	chr2	152682838	152683140	DNA/hAT-Charlie	1916	+	151	152682989	64991
chr2	152617998	152817998	harbor1	chr2	152699165	152699383	DNA/hAT-Charlie	1361	+	109	152699274	81276
chr2	86976337	87176337	harbor1	chr2	87001766	87001861	DNA/hAT-Charlie	459	+	48	87001814	25477
chr2	86976337	87176337	harbor1	chr2	87002181	87002242	DNA/hAT-Charlie	459	+	30	87002211	25874
chr2	86976337	87176337	harbor1	chr2	87006205	87006479	DNA/hAT-Charlie	1246	+	137	87006342	30005
chr2	86976337	87176337	harbor1	chr2	87010407	87010625	DNA/hAT-Charlie	653	+	109	87010516	34179
chr2	86976337	87176337	harbor1	chr2	87028939	87029152	DNA/hAT-Charlie	901	+	106	87029045	52708
chr2	53759964	53959964	harbor1	chr2	53770996	53771173	DNA/hAT-Charlie	697	+	88	53771084	11120
chr2	53759964	53959964	harbor1	chr2	53793360	53793549	DNA/hAT-Charlie	728	+	94	53793454	33490
chr2	15464442	15664442	harbor1	chr2	15503712	15503908	DNA/hAT-Charlie	567	+	98	15503810	39368
chr2	15464442	15664442	harbor1	chr2	15521766	15521982	DNA/hAT-Charlie	969	+	108	15521874	57432
chr2	15464442	15664442	harbor1	chr2	15537959	15538205	DNA/hAT-Charlie	909	+	123	15538082	73640
chr2	15464442	15664442	harbor1	chr2	15538400	15538594	DNA/hAT-Charlie	602	+	97	15538497	74055
chr2	158868018	159068018	harbor1	chr2	158901178	158901384	DNA/hAT-Charlie	630	+	103	158901281	33263
chr2	219073574	219273574	harbor1	chr2	219077830	219078031	DNA/hAT-Charlie	1087	+	100	219077930	4356
chr2	219073574	219273574	harbor1	chr2	219078778	219079012	DNA/hAT-Charlie	754	+	117	219078895	5321
chr2	219073574	219273574	harbor1	chr2	219128104	219128369	DNA/hAT-Charlie	1310	+	132	219128236	54662
chr2	85228519	85428519	harbor1	chr2	85270483	85270665	DNA/hAT-Charlie	640	+	91	85270574	42055
chr2	85228519	85428519	harbor1	chr2	85280140	85280360	DNA/hAT-Charlie	743	+	110	85280250	51731
chr2	85228519	85428519	harbor1	chr2	85324071	85324140	DNA/hAT-Charlie	518	+	34	85324105	95586
chr2	85228519	85428519	harbor1	chr2	85324439	85324541	DNA/hAT-Charlie	518	+	51	85324490	95971
chr2	241405862	241605862	harbor1	chr2	241475337	241475720	DNA/hAT-Charlie	2163	+	192	241475529	69667
chr2	219070180	219270180	harbor1	chr2	219077830	219078031	DNA/hAT-Charlie	1087	+	100	219077930	7750
chr2	219070180	219270180	harbor1	chr2	219078778	219079012	DNA/hAT-Charlie	754	+	117	219078895	8715
chr2	219070180	219270180	harbor1	chr2	219128104	219128369	DNA/hAT-Charlie	1310	+	132	219128236	58056
chr2	219458053	219658053	harbor1	chr2	219458323	219458561	DNA/hAT-Charlie	903	+	119	219458442	389
chr2	219458053	219658053	harbor1	chr2	219519544	219519726	DNA/hAT-Charlie	1013	+	91	219519635	61582
chr2	74453409	74653409	harbor1	chr2	74494651	74494723	DNA/hAT-Charlie	779	+	36	74494687	41278
chr2	74453409	74653409	harbor1	chr2	74495020	74495123	DNA/hAT-Charlie	779	+	52	74495072	41663
chr2	219068681	219268681	harbor1	chr2	219077830	219078031	DNA/hAT-Charlie	1087	+	100	219077930	9249
chr2	219068681	219268681	harbor1	chr2	219078778	219079012	DNA/hAT-Charlie	754	+	117	219078895	10214
chr2	219068681	219268681	harbor1	chr2	219128104	219128369	DNA/hAT-Charlie	1310	+	132	219128236	59555
chr2	175979735	176179735	harbor1	chr2	175980047	175980193	DNA/hAT-Charlie	451	+	73	175980120	385
chr2	175979735	176179735	harbor1	chr2	176050904	176051080	DNA/hAT-Charlie	499	+	88	176050992	71257
chr2	42069399	42269399	harbor1	chr2	42091119	42091351	DNA/hAT-Charlie	1062	+	116	42091235	21836
chr2	42069399	42269399	harbor1	chr2	42093210	42093379	DNA/hAT-Charlie	557	+	84	42093294	23895
chr2	42069399	42269399	harbor1	chr2	42133844	42133991	DNA/hAT-Charlie	535	+	74	42133918	64519
chr2	42069399	42269399	harbor1	chr2	42134308	42134347	DNA/hAT-Charlie	535	+	20	42134328	64929
chr2	42033084	42233084	harbor1	chr2	42056550	42056617	DNA/hAT-Charlie	499	+	34	42056584	23500
chr2	42033084	42233084	harbor1	chr2	42056782	42056852	DNA/hAT-Charlie	499	+	35	42056817	23733
chr2	42033084	42233084	harbor1	chr2	42062628	42062871	DNA/hAT-Charlie	985	+	122	42062750	29666
chr2	42033084	42233084	harbor1	chr2	42091119	42091351	DNA/hAT-Charlie	1062	+	116	42091235	58151
chr2	42033084	42233084	harbor1	chr2	42093210	42093379	DNA/hAT-Charlie	557	+	84	42093294	60210
chr2	26950242	27150242	harbor1	chr2	26997254	26997472	DNA/hAT-Charlie	1490	+	109	26997363	47121
chr2	26950242	27150242	harbor1	chr2	27037275	27037443	DNA/hAT-Charlie	514	+	84	27037359	87117
chr2	84760927	84960927	harbor1	chr2	84808923	84809096	DNA/hAT-Charlie	487	+	86	84809009	48082
chr2	84760927	84960927	harbor1	chr2	84825681	84826024	DNA/hAT-Charlie	2113	+	172	84825853	64926
chr2	84760927	84960927	harbor1	chr2	84842756	84842866	DNA/hAT-Charlie	558	+	55	84842811	81884
chr2	219383264	219583264	harbor1	chr2	219391691	219391833	DNA/hAT-Charlie	770	+	71	219391762	8498
chr2	219383264	219583264	harbor1	chr2	219401108	219401353	DNA/hAT-Charlie	988	+	122	219401230	17966
chr2	219383264	219583264	harbor1	chr2	219401658	219401744	DNA/hAT-Charlie	988	+	43	219401701	18437
chr2	219383264	219583264	harbor1	chr2	219455330	219455526	DNA/hAT-Charlie	913	+	98	219455428	72164
chr2	219383264	219583264	harbor1	chr2	219458323	219458561	DNA/hAT-Charlie	903	+	119	219458442	75178
chr2	113484040	113684040	harbor1	chr2	113512986	113513219	DNA/hAT-Charlie	627	+	116	113513102	29062
chr2	113484040	113684040	harbor1	chr2	113516723	113516803	DNA/hAT-Charlie	1034	+	40	113516763	32723
chr2	113484040	113684040	harbor1	chr2	113517074	113517234	DNA/hAT-Charlie	1034	+	80	113517154	33114
chr2	113484040	113684040	harbor1	chr2	113523848	113524027	DNA/hAT-Charlie	852	+	90	113523938	39898
chr2	113484040	113684040	harbor1	chr2	113524375	113524516	DNA/hAT-Charlie	625	+	70	113524445	40405
chr2	113484040	113684040	harbor1	chr2	113524868	113525145	DNA/hAT-Charlie	584	+	138	113525006	40966
chr2	113484040	113684040	harbor1	chr2	113537458	113537650	DNA/hAT-Charlie	595	+	96	113537554	53514
chr2	113484040	113684040	harbor1	chr2	113538181	113538335	DNA/hAT-Charlie	469	+	77	113538258	54218
chr2	113484040	113684040	harbor1	chr2	113548013	113548217	DNA/hAT-Charlie	1103	+	102	113548115	64075
chr2	31910614	32110614	harbor1	chr2	31925572	31926085	DNA/hAT-Charlie	4073	+	256	31925828	15214
chr2	31910614	32110614	harbor1	chr2	31926394	31926567	DNA/hAT-Charlie	4073	+	86	31926480	15866
chr2	31910614	32110614	harbor1	chr2	31926877	31927048	DNA/hAT-Charlie	4073	+	86	31926963	16349
chr2	31910614	32110614	harbor1	chr2	31927326	31927879	DNA/hAT-Charlie	4073	+	276	31927602	16988
chr2	31910614	32110614	harbor1	chr2	31963797	31964102	DNA/hAT-Charlie	1213	+	152	31963949	53335
chr2	31910614	32110614	harbor1	chr2	31988157	31988264	DNA/hAT-Charlie	1010	+	54	31988211	77597
chr2	31910614	32110614	harbor1	chr2	31988563	31988778	DNA/hAT-Charlie	1010	+	108	31988671	78057
chr2	31910614	32110614	harbor1	chr2	31988782	31988925	DNA/hAT-Charlie	1844	+	72	31988854	78240
chr2	31910614	32110614	harbor1	chr2	31989259	31989657	DNA/hAT-Charlie	1844	+	199	31989458	78844
chr2	31910614	32110614	harbor1	chr2	31989753	31989834	DNA/hAT-Charlie	1651	+	40	31989793	79179
chr2	31910614	32110614	harbor1	chr2	31990123	31990411	DNA/hAT-Charlie	1651	+	144	31990267	79653
chr2	31910614	32110614	harbor1	chr2	31990729	31990844	DNA/hAT-Charlie	525	+	58	31990787	80173
chr2	31910614	32110614	harbor1	chr2	31992214	31992394	DNA/hAT-Charlie	870	+	90	31992304	81690
chr2	207648472	207848472	harbor1	chr2	207666502	207666780	DNA/hAT-Charlie	622	+	139	207666641	18169
chr2	207648472	207848472	harbor1	chr2	207735519	207735583	DNA/hAT-Charlie	562	+	32	207735551	87079
chr2	207648472	207848472	harbor1	chr2	207735894	207736026	DNA/hAT-Charlie	562	+	66	207735960	87488
chr2	237867399	238067399	harbor1	chr2	237932310	237932409	DNA/hAT-Charlie	1474	+	50	237932360	64961
chr2	237867399	238067399	harbor1	chr2	237932680	237932804	DNA/hAT-Charlie	1474	+	62	237932742	65343
chr2	71780774	71980774	harbor1	chr2	71816367	71816572	DNA/hAT-Charlie	850	+	102	71816469	35695
chr2	53759991	53959991	harbor1	chr2	53770996	53771173	DNA/hAT-Charlie	697	+	88	53771084	11093
chr2	53759991	53959991	harbor1	chr2	53793360	53793549	DNA/hAT-Charlie	728	+	94	53793454	33463
chr2	113484101	113684101	harbor1	chr2	113512986	113513219	DNA/hAT-Charlie	627	+	116	113513102	29001
chr2	113484101	113684101	harbor1	chr2	113516723	113516803	DNA/hAT-Charlie	1034	+	40	113516763	32662
chr2	113484101	113684101	harbor1	chr2	113517074	113517234	DNA/hAT-Charlie	1034	+	80	113517154	33053
chr2	113484101	113684101	harbor1	chr2	113523848	113524027	DNA/hAT-Charlie	852	+	90	113523938	39837
chr2	113484101	113684101	harbor1	chr2	113524375	113524516	DNA/hAT-Charlie	625	+	70	113524445	40344
chr2	113484101	113684101	harbor1	chr2	113524868	113525145	DNA/hAT-Charlie	584	+	138	113525006	40905
chr2	113484101	113684101	harbor1	chr2	113537458	113537650	DNA/hAT-Charlie	595	+	96	113537554	53453
chr2	113484101	113684101	harbor1	chr2	113538181	113538335	DNA/hAT-Charlie	469	+	77	113538258	54157
chr2	113484101	113684101	harbor1	chr2	113548013	113548217	DNA/hAT-Charlie	1103	+	102	113548115	64014
chr2	113484028	113684028	harbor1	chr2	113512986	113513219	DNA/hAT-Charlie	627	+	116	113513102	29074
chr2	113484028	113684028	harbor1	chr2	113516723	113516803	DNA/hAT-Charlie	1034	+	40	113516763	32735
chr2	113484028	113684028	harbor1	chr2	113517074	113517234	DNA/hAT-Charlie	1034	+	80	113517154	33126
chr2	113484028	113684028	harbor1	chr2	113523848	113524027	DNA/hAT-Charlie	852	+	90	113523938	39910
chr2	113484028	113684028	harbor1	chr2	113524375	113524516	DNA/hAT-Charlie	625	+	70	113524445	40417
chr2	113484028	113684028	harbor1	chr2	113524868	113525145	DNA/hAT-Charlie	584	+	138	113525006	40978
chr2	113484028	113684028	harbor1	chr2	113537458	113537650	DNA/hAT-Charlie	595	+	96	113537554	53526
chr2	113484028	113684028	harbor1	chr2	113538181	113538335	DNA/hAT-Charlie	469	+	77	113538258	54230
chr2	113484028	113684028	harbor1	chr2	113548013	113548217	DNA/hAT-Charlie	1103	+	102	113548115	64087
chr2	219335190	219535190	harbor1	chr2	219391691	219391833	DNA/hAT-Charlie	770	+	71	219391762	56572
chr2	219335190	219535190	harbor1	chr2	219401108	219401353	DNA/hAT-Charlie	988	+	122	219401230	66040
chr2	219335190	219535190	harbor1	chr2	219401658	219401744	DNA/hAT-Charlie	988	+	43	219401701	66511
chr2	47682917	47882917	harbor1	chr2	47704569	47704779	DNA/hAT-Charlie	1040	+	105	47704674	21757
chr2	47682917	47882917	harbor1	chr2	47705079	47705105	DNA/hAT-Charlie	1040	+	13	47705092	22175
chr2	47682917	47882917	harbor1	chr2	47758344	47758520	DNA/hAT-Charlie	490	+	88	47758432	75515
chr2	46198512	46398512	harbor1	chr2	46199416	46199580	DNA/hAT-Charlie	934	+	82	46199498	986
chr2	46198512	46398512	harbor1	chr2	46199581	46199656	DNA/hAT-Charlie	472	+	38	46199619	1107
chr2	46198512	46398512	harbor1	chr2	46199955	46199986	DNA/hAT-Charlie	472	+	16	46199971	1459
chr2	46198512	46398512	harbor1	chr2	46218480	46218654	DNA/hAT-Charlie	818	+	87	46218567	20055
chr2	46198512	46398512	harbor1	chr2	46227485	46227668	DNA/hAT-Charlie	449	+	92	46227577	29065
chr2	46198512	46398512	harbor1	chr2	46268132	46268276	DNA/hAT-Charlie	487	+	72	46268204	69692
chr2	113484029	113684029	harbor1	chr2	113512986	113513219	DNA/hAT-Charlie	627	+	116	113513102	29073
chr2	113484029	113684029	harbor1	chr2	113516723	113516803	DNA/hAT-Charlie	1034	+	40	113516763	32734
chr2	113484029	113684029	harbor1	chr2	113517074	113517234	DNA/hAT-Charlie	1034	+	80	113517154	33125
chr2	113484029	113684029	harbor1	chr2	113523848	113524027	DNA/hAT-Charlie	852	+	90	113523938	39909
chr2	113484029	113684029	harbor1	chr2	113524375	113524516	DNA/hAT-Charlie	625	+	70	113524445	40416
chr2	113484029	113684029	harbor1	chr2	113524868	113525145	DNA/hAT-Charlie	584	+	138	113525006	40977
chr2	113484029	113684029	harbor1	chr2	113537458	113537650	DNA/hAT-Charlie	595	+	96	113537554	53525
chr2	113484029	113684029	harbor1	chr2	113538181	113538335	DNA/hAT-Charlie	469	+	77	113538258	54229
chr2	113484029	113684029	harbor1	chr2	113548013	113548217	DNA/hAT-Charlie	1103	+	102	113548115	64086
chr2	70453429	70653429	harbor1	chr2	70460125	70460282	DNA/hAT-Charlie	818	+	78	70460203	6774
chr2	70453429	70653429	harbor1	chr2	70460841	70460985	DNA/hAT-Charlie	628	+	72	70460913	7484
chr2	70453429	70653429	harbor1	chr2	70464447	70464646	DNA/hAT-Charlie	1002	+	100	70464547	11118
chr2	70453429	70653429	harbor1	chr2	70468557	70468994	DNA/hAT-Charlie	3065	+	218	70468775	15346
chr2	70453429	70653429	harbor1	chr2	70489751	70489908	DNA/hAT-Charlie	785	+	78	70489829	36400
chr2	70453429	70653429	harbor1	chr2	70498891	70499061	DNA/hAT-Charlie	876	+	85	70498976	45547
chr2	70453429	70653429	harbor1	chr2	70505090	70505293	DNA/hAT-Charlie	783	+	102	70505192	51763
chr2	111955709	112155709	harbor1	chr2	112030785	112030816	DNA/hAT-Charlie	1106	+	16	112030801	75092
chr2	111955709	112155709	harbor1	chr2	112031111	112031587	DNA/hAT-Charlie	1106	+	238	112031349	75640
chr2	219077883	219277883	harbor1	chr2	219077830	219078031	DNA/hAT-Charlie	1087	+	100	219077930	47
chr2	219077883	219277883	harbor1	chr2	219078778	219079012	DNA/hAT-Charlie	754	+	117	219078895	1012
chr2	219077883	219277883	harbor1	chr2	219128104	219128369	DNA/hAT-Charlie	1310	+	132	219128236	50353
chr2	207668782	207868782	harbor1	chr2	207735519	207735583	DNA/hAT-Charlie	562	+	32	207735551	66769
chr2	207668782	207868782	harbor1	chr2	207735894	207736026	DNA/hAT-Charlie	562	+	66	207735960	67178
chr2	46198543	46398543	harbor1	chr2	46199416	46199580	DNA/hAT-Charlie	934	+	82	46199498	955
chr2	46198543	46398543	harbor1	chr2	46199581	46199656	DNA/hAT-Charlie	472	+	38	46199619	1076
chr2	46198543	46398543	harbor1	chr2	46199955	46199986	DNA/hAT-Charlie	472	+	16	46199971	1428
chr2	46198543	46398543	harbor1	chr2	46218480	46218654	DNA/hAT-Charlie	818	+	87	46218567	20024
chr2	46198543	46398543	harbor1	chr2	46227485	46227668	DNA/hAT-Charlie	449	+	92	46227577	29034
chr2	46198543	46398543	harbor1	chr2	46268132	46268276	DNA/hAT-Charlie	487	+	72	46268204	69661
chr2	27018955	27218955	harbor1	chr2	27037275	27037443	DNA/hAT-Charlie	514	+	84	27037359	18404
chr2	27018955	27218955	harbor1	chr2	27068355	27068566	DNA/hAT-Charlie	1094	+	106	27068461	49506
chr2	46198523	46398523	harbor1	chr2	46199416	46199580	DNA/hAT-Charlie	934	+	82	46199498	975
chr2	46198523	46398523	harbor1	chr2	46199581	46199656	DNA/hAT-Charlie	472	+	38	46199619	1096
chr2	46198523	46398523	harbor1	chr2	46199955	46199986	DNA/hAT-Charlie	472	+	16	46199971	1448
chr2	46198523	46398523	harbor1	chr2	46218480	46218654	DNA/hAT-Charlie	818	+	87	46218567	20044
chr2	46198523	46398523	harbor1	chr2	46227485	46227668	DNA/hAT-Charlie	449	+	92	46227577	29054
chr2	46198523	46398523	harbor1	chr2	46268132	46268276	DNA/hAT-Charlie	487	+	72	46268204	69681
chr2	26403762	26603762	harbor1	chr2	26492166	26492361	DNA/hAT-Charlie	994	+	98	26492264	88502
chr2	113484023	113684023	harbor1	chr2	113512986	113513219	DNA/hAT-Charlie	627	+	116	113513102	29079
chr2	113484023	113684023	harbor1	chr2	113516723	113516803	DNA/hAT-Charlie	1034	+	40	113516763	32740
chr2	113484023	113684023	harbor1	chr2	113517074	113517234	DNA/hAT-Charlie	1034	+	80	113517154	33131
chr2	113484023	113684023	harbor1	chr2	113523848	113524027	DNA/hAT-Charlie	852	+	90	113523938	39915
chr2	113484023	113684023	harbor1	chr2	113524375	113524516	DNA/hAT-Charlie	625	+	70	113524445	40422
chr2	113484023	113684023	harbor1	chr2	113524868	113525145	DNA/hAT-Charlie	584	+	138	113525006	40983
chr2	113484023	113684023	harbor1	chr2	113537458	113537650	DNA/hAT-Charlie	595	+	96	113537554	53531
chr2	113484023	113684023	harbor1	chr2	113538181	113538335	DNA/hAT-Charlie	469	+	77	113538258	54235
chr2	113484023	113684023	harbor1	chr2	113548013	113548217	DNA/hAT-Charlie	1103	+	102	113548115	64092
chr2	86976362	87176362	harbor1	chr2	87001766	87001861	DNA/hAT-Charlie	459	+	48	87001814	25452
chr2	86976362	87176362	harbor1	chr2	87002181	87002242	DNA/hAT-Charlie	459	+	30	87002211	25849
chr2	86976362	87176362	harbor1	chr2	87006205	87006479	DNA/hAT-Charlie	1246	+	137	87006342	29980
chr2	86976362	87176362	harbor1	chr2	87010407	87010625	DNA/hAT-Charlie	653	+	109	87010516	34154
chr2	86976362	87176362	harbor1	chr2	87028939	87029152	DNA/hAT-Charlie	901	+	106	87029045	52683
chr2	26403771	26603771	harbor1	chr2	26492166	26492361	DNA/hAT-Charlie	994	+	98	26492264	88493
chr2	129830912	130030912	harbor1	chr2	129896604	129896742	DNA/hAT-Charlie	507	+	69	129896673	65761
chr2	26950298	27150298	harbor1	chr2	26997254	26997472	DNA/hAT-Charlie	1490	+	109	26997363	47065
chr2	26950298	27150298	harbor1	chr2	27037275	27037443	DNA/hAT-Charlie	514	+	84	27037359	87061
chr2	130256054	130456054	harbor1	chr2	130334151	130334475	DNA/hAT-Charlie	1749	+	162	130334313	78259
chr2	130256054	130456054	harbor1	chr2	130354815	130354964	DNA/hAT-Charlie	537	+	74	130354889	98835
chr2	9301841	9501841	harbor1	chr2	9309699	9309900	DNA/hAT-Charlie	869	+	100	9309799	7958
chr2	9301841	9501841	harbor1	chr2	9382406	9382547	DNA/hAT-Charlie	768	+	70	9382476	80635
chr2	9301841	9501841	harbor1	chr2	9397605	9397750	DNA/hAT-Charlie	1229	+	72	9397677	95836
chr2	9301841	9501841	harbor1	chr2	9398058	9398228	DNA/hAT-Charlie	1229	+	85	9398143	96302
chr2	9301841	9501841	harbor1	chr2	9398827	9398886	DNA/hAT-Charlie	1229	+	30	9398857	97016
chr2	70771149	70971149	harbor1	chr2	70814395	70814541	DNA/hAT-Charlie	608	+	73	70814468	43319
chr2	70771149	70971149	harbor1	chr2	70814570	70814753	DNA/hAT-Charlie	572	+	92	70814662	43513
chr2	70771149	70971149	harbor1	chr2	70814764	70814941	DNA/hAT-Charlie	465	+	88	70814852	43703
chr2	70771149	70971149	harbor1	chr2	70817234	70817618	DNA/hAT-Charlie	943	+	192	70817426	46277
chr2	60880293	61080293	harbor1	chr2	60885796	60886008	DNA/hAT-Charlie	608	+	106	60885902	5609
chr2	60880293	61080293	harbor1	chr2	60920916	60921119	DNA/hAT-Charlie	765	+	102	60921018	40725
chr2	60880293	61080293	harbor1	chr2	60963972	60964190	DNA/hAT-Charlie	559	+	109	60964081	83788
chr2	152618050	152818050	harbor1	chr2	152663268	152663415	DNA/hAT-Charlie	863	+	74	152663342	45292
chr2	152618050	152818050	harbor1	chr2	152664820	152665107	DNA/hAT-Charlie	1556	+	144	152664964	46914
chr2	152618050	152818050	harbor1	chr2	152665170	152665358	DNA/hAT-Charlie	638	+	94	152665264	47214
chr2	152618050	152818050	harbor1	chr2	152667713	152667838	DNA/hAT-Charlie	581	+	62	152667775	49725
chr2	152618050	152818050	harbor1	chr2	152674101	152674309	DNA/hAT-Charlie	479	+	104	152674205	56155
chr2	152618050	152818050	harbor1	chr2	152682838	152683140	DNA/hAT-Charlie	1916	+	151	152682989	64939
chr2	152618050	152818050	harbor1	chr2	152699165	152699383	DNA/hAT-Charlie	1361	+	109	152699274	81224
chr2	9945874	10145874	harbor1	chr2	9981475	9981652	DNA/hAT-Charlie	560	+	88	9981563	35689
chr2	9945874	10145874	harbor1	chr2	10037000	10037074	DNA/hAT-Charlie	566	+	37	10037037	91163
chr2	9945874	10145874	harbor1	chr2	10037376	10037483	DNA/hAT-Charlie	566	+	54	10037430	91556
chr2	30046187	30246187	harbor1	chr2	30079991	30080322	DNA/hAT-Charlie	2061	+	166	30080157	33970
chr2	30046187	30246187	harbor1	chr2	30109793	30109971	DNA/hAT-Charlie	605	+	89	30109882	63695
chr2	72971135	73171135	harbor1	chr2	72973329	72973543	DNA/hAT-Charlie	964	+	107	72973436	2301
chr2	72971135	73171135	harbor1	chr2	73033791	73034006	DNA/hAT-Charlie	1066	+	108	73033899	62764
chr2	152617972	152817972	harbor1	chr2	152663268	152663415	DNA/hAT-Charlie	863	+	74	152663342	45370
chr2	152617972	152817972	harbor1	chr2	152664820	152665107	DNA/hAT-Charlie	1556	+	144	152664964	46992
chr2	152617972	152817972	harbor1	chr2	152665170	152665358	DNA/hAT-Charlie	638	+	94	152665264	47292
chr2	152617972	152817972	harbor1	chr2	152667713	152667838	DNA/hAT-Charlie	581	+	62	152667775	49803
chr2	152617972	152817972	harbor1	chr2	152674101	152674309	DNA/hAT-Charlie	479	+	104	152674205	56233
chr2	152617972	152817972	harbor1	chr2	152682838	152683140	DNA/hAT-Charlie	1916	+	151	152682989	65017
chr2	152617972	152817972	harbor1	chr2	152699165	152699383	DNA/hAT-Charlie	1361	+	109	152699274	81302
chr2	152250414	152450414	harbor1	chr2	152262928	152262971	DNA/hAT-Charlie	760	+	22	152262950	12536
chr2	152250414	152450414	harbor1	chr2	152263272	152263434	DNA/hAT-Charlie	760	+	81	152263353	12939
chr2	152250414	152450414	harbor1	chr2	152291853	152292195	DNA/hAT-Charlie	2183	+	171	152292024	41610
chr2	152250414	152450414	harbor1	chr2	152339108	152339305	DNA/hAT-Charlie	1336	+	98	152339206	88792
chr2	74415635	74615635	harbor1	chr2	74437571	74437731	DNA/hAT-Charlie	498	+	80	74437651	22016
chr2	74415635	74615635	harbor1	chr2	74494651	74494723	DNA/hAT-Charlie	779	+	36	74494687	79052
chr2	74415635	74615635	harbor1	chr2	74495020	74495123	DNA/hAT-Charlie	779	+	52	74495072	79437
chr2	66333430	66533430	harbor1	chr2	66387645	66387885	DNA/hAT-Charlie	588	+	120	66387765	54335
chr2	59821692	60021692	harbor1	chr2	59856881	59857093	DNA/hAT-Charlie	660	+	106	59856987	35295
chr2	74415479	74615479	harbor1	chr2	74437571	74437731	DNA/hAT-Charlie	498	+	80	74437651	22172
chr2	74415479	74615479	harbor1	chr2	74494651	74494723	DNA/hAT-Charlie	779	+	36	74494687	79208
chr2	74415479	74615479	harbor1	chr2	74495020	74495123	DNA/hAT-Charlie	779	+	52	74495072	79593
chr2	131392202	131592202	harbor1	chr2	131404814	131404967	DNA/hAT-Charlie	674	+	76	131404890	12688
chr2	131392202	131592202	harbor1	chr2	131437198	131437582	DNA/hAT-Charlie	700	+	192	131437390	45188
chr2	131392202	131592202	harbor1	chr2	131437895	131437944	DNA/hAT-Charlie	700	+	24	131437919	45717
chr2	131392202	131592202	harbor1	chr2	131438076	131438373	DNA/hAT-Charlie	1017	+	148	131438224	46022
chr2	131392202	131592202	harbor1	chr2	131468671	131468897	DNA/hAT-Charlie	1361	+	113	131468784	76582
chr2	131392202	131592202	harbor1	chr2	131469207	131469429	DNA/hAT-Charlie	1361	+	111	131469318	77116
chr2	22969090	23169090	harbor1	chr2	22976203	22976693	DNA/hAT-Charlie	1697	+	245	22976448	7358
chr2	22969090	23169090	harbor1	chr2	23009203	23009340	DNA/hAT-Charlie	447	+	68	23009271	40181
chr2	22969090	23169090	harbor1	chr2	23014343	23014632	DNA/hAT-Charlie	1052	+	144	23014487	45397
chr2	22969090	23169090	harbor1	chr2	23017837	23018028	DNA/hAT-Charlie	773	+	96	23017933	48843
chr2	22969090	23169090	harbor1	chr2	23017996	23018269	DNA/hAT-Charlie	1179	+	136	23018132	49042
chr2	22969090	23169090	harbor1	chr2	23032268	23032439	DNA/hAT-Charlie	473	+	86	23032354	63264
chr2	22969090	23169090	harbor1	chr2	23057108	23057375	DNA/hAT-Charlie	850	+	134	23057242	88152
chr2	22969090	23169090	harbor1	chr2	23068368	23068545	DNA/hAT-Charlie	919	+	88	23068456	99366
chr2	219458132	219658132	harbor1	chr2	219458323	219458561	DNA/hAT-Charlie	903	+	119	219458442	310
chr2	219458132	219658132	harbor1	chr2	219519544	219519726	DNA/hAT-Charlie	1013	+	91	219519635	61503
chr2	217888302	218088302	harbor1	chr2	217971699	217971836	DNA/hAT-Charlie	591	+	68	217971767	83465
chr2	217888302	218088302	harbor1	chr2	217984321	217984476	DNA/hAT-Charlie	1366	+	78	217984399	96097
chr2	217888302	218088302	harbor1	chr2	217985056	217985184	DNA/hAT-Charlie	1366	+	64	217985120	96818
chr2	21176381	21376381	harbor1	chr2	21247192	21247637	DNA/hAT-Charlie	1857	+	222	21247414	71033
chr2	21176381	21376381	harbor1	chr2	21247664	21247832	DNA/hAT-Charlie	499	+	84	21247748	71367
chr2	26403748	26603748	harbor1	chr2	26492166	26492361	DNA/hAT-Charlie	994	+	98	26492264	88516
chr2	74415451	74615451	harbor1	chr2	74437571	74437731	DNA/hAT-Charlie	498	+	80	74437651	22200
chr2	74415451	74615451	harbor1	chr2	74494651	74494723	DNA/hAT-Charlie	779	+	36	74494687	79236
chr2	74415451	74615451	harbor1	chr2	74495020	74495123	DNA/hAT-Charlie	779	+	52	74495072	79621
chr2	151310331	151510331	harbor1	chr2	151374009	151374225	DNA/hAT-Charlie	676	+	108	151374117	63786
chr2	237589573	237789573	harbor1	chr2	237638570	237638760	DNA/hAT-Charlie	534	+	95	237638665	49092
chr2	237589573	237789573	harbor1	chr2	237674695	237674837	DNA/hAT-Charlie	481	+	71	237674766	85193
chr2	237589573	237789573	harbor1	chr2	237675371	237675505	DNA/hAT-Charlie	573	+	67	237675438	85865
chr2	237589573	237789573	harbor1	chr2	237682943	237683119	DNA/hAT-Charlie	749	+	88	237683031	93458
chr2	219077865	219277865	harbor1	chr2	219077830	219078031	DNA/hAT-Charlie	1087	+	100	219077930	65
chr2	219077865	219277865	harbor1	chr2	219078778	219079012	DNA/hAT-Charlie	754	+	117	219078895	1030
chr2	219077865	219277865	harbor1	chr2	219128104	219128369	DNA/hAT-Charlie	1310	+	132	219128236	50371
chr2	218773740	218973740	harbor1	chr2	218776503	218776673	DNA/hAT-Charlie	607	+	85	218776588	2848
chr2	218773740	218973740	harbor1	chr2	218806332	218806542	DNA/hAT-Charlie	855	+	105	218806437	32697
chr2	56085032	56285032	harbor1	chr2	56107091	56107405	DNA/hAT-Charlie	1478	+	157	56107248	22216
chr2	56085032	56285032	harbor1	chr2	56112338	56112517	DNA/hAT-Charlie	904	+	90	56112428	27396
chr2	56085032	56285032	harbor1	chr2	56113157	56113340	DNA/hAT-Charlie	848	+	92	56113249	28217
chr2	56085032	56285032	harbor1	chr2	56115749	56115957	DNA/hAT-Charlie	512	+	104	56115853	30821
chr2	56085032	56285032	harbor1	chr2	56117881	56118061	DNA/hAT-Charlie	902	+	90	56117971	32939
chr2	56085032	56285032	harbor1	chr2	56120822	56120976	DNA/hAT-Charlie	469	+	77	56120899	35867
chr2	56085032	56285032	harbor1	chr2	56146915	56147130	DNA/hAT-Charlie	1583	+	108	56147023	61991
chr2	56085032	56285032	harbor1	chr2	56151074	56151204	DNA/hAT-Charlie	541	+	65	56151139	66107
chr2	56085032	56285032	harbor1	chr2	56176933	56177221	DNA/hAT-Charlie	1557	+	144	56177077	92045
chr2	56085032	56285032	harbor1	chr2	56177249	56177396	DNA/hAT-Charlie	593	+	74	56177323	92291
chr2	46198453	46398453	harbor1	chr2	46199416	46199580	DNA/hAT-Charlie	934	+	82	46199498	1045
chr2	46198453	46398453	harbor1	chr2	46199581	46199656	DNA/hAT-Charlie	472	+	38	46199619	1166
chr2	46198453	46398453	harbor1	chr2	46199955	46199986	DNA/hAT-Charlie	472	+	16	46199971	1518
chr2	46198453	46398453	harbor1	chr2	46218480	46218654	DNA/hAT-Charlie	818	+	87	46218567	20114
chr2	46198453	46398453	harbor1	chr2	46227485	46227668	DNA/hAT-Charlie	449	+	92	46227577	29124
chr2	46198453	46398453	harbor1	chr2	46268132	46268276	DNA/hAT-Charlie	487	+	72	46268204	69751
chr2	46198517	46398517	harbor1	chr2	46199416	46199580	DNA/hAT-Charlie	934	+	82	46199498	981
chr2	46198517	46398517	harbor1	chr2	46199581	46199656	DNA/hAT-Charlie	472	+	38	46199619	1102
chr2	46198517	46398517	harbor1	chr2	46199955	46199986	DNA/hAT-Charlie	472	+	16	46199971	1454
chr2	46198517	46398517	harbor1	chr2	46218480	46218654	DNA/hAT-Charlie	818	+	87	46218567	20050
chr2	46198517	46398517	harbor1	chr2	46227485	46227668	DNA/hAT-Charlie	449	+	92	46227577	29060
chr2	46198517	46398517	harbor1	chr2	46268132	46268276	DNA/hAT-Charlie	487	+	72	46268204	69687
chr2	113481247	113681247	harbor1	chr2	113512986	113513219	DNA/hAT-Charlie	627	+	116	113513102	31855
chr2	113481247	113681247	harbor1	chr2	113516723	113516803	DNA/hAT-Charlie	1034	+	40	113516763	35516
chr2	113481247	113681247	harbor1	chr2	113517074	113517234	DNA/hAT-Charlie	1034	+	80	113517154	35907
chr2	113481247	113681247	harbor1	chr2	113523848	113524027	DNA/hAT-Charlie	852	+	90	113523938	42691
chr2	113481247	113681247	harbor1	chr2	113524375	113524516	DNA/hAT-Charlie	625	+	70	113524445	43198
chr2	113481247	113681247	harbor1	chr2	113524868	113525145	DNA/hAT-Charlie	584	+	138	113525006	43759
chr2	113481247	113681247	harbor1	chr2	113537458	113537650	DNA/hAT-Charlie	595	+	96	113537554	56307
chr2	113481247	113681247	harbor1	chr2	113538181	113538335	DNA/hAT-Charlie	469	+	77	113538258	57011
chr2	113481247	113681247	harbor1	chr2	113548013	113548217	DNA/hAT-Charlie	1103	+	102	113548115	66868
chr2	45443610	45643610	harbor1	chr2	45466898	45467030	DNA/hAT-Charlie	510	+	66	45466964	23354
chr2	45443610	45643610	harbor1	chr2	45467199	45467333	DNA/hAT-Charlie	449	+	67	45467266	23656
chr2	219071902	219271902	harbor1	chr2	219077830	219078031	DNA/hAT-Charlie	1087	+	100	219077930	6028
chr2	219071902	219271902	harbor1	chr2	219078778	219079012	DNA/hAT-Charlie	754	+	117	219078895	6993
chr2	219071902	219271902	harbor1	chr2	219128104	219128369	DNA/hAT-Charlie	1310	+	132	219128236	56334
chr2	200971419	201171419	harbor1	chr2	200993461	200993699	DNA/hAT-Charlie	1468	+	119	200993580	22161
chr2	200971419	201171419	harbor1	chr2	200993997	200994238	DNA/hAT-Charlie	1468	+	120	200994117	22698
chr2	200971419	201171419	harbor1	chr2	200994537	200994679	DNA/hAT-Charlie	1468	+	71	200994608	23189
chr2	200971419	201171419	harbor1	chr2	201048398	201048623	DNA/hAT-Charlie	1340	+	112	201048510	77091
chr2	46198560	46398560	harbor1	chr2	46199416	46199580	DNA/hAT-Charlie	934	+	82	46199498	938
chr2	46198560	46398560	harbor1	chr2	46199581	46199656	DNA/hAT-Charlie	472	+	38	46199619	1059
chr2	46198560	46398560	harbor1	chr2	46199955	46199986	DNA/hAT-Charlie	472	+	16	46199971	1411
chr2	46198560	46398560	harbor1	chr2	46218480	46218654	DNA/hAT-Charlie	818	+	87	46218567	20007
chr2	46198560	46398560	harbor1	chr2	46227485	46227668	DNA/hAT-Charlie	449	+	92	46227577	29017
chr2	46198560	46398560	harbor1	chr2	46268132	46268276	DNA/hAT-Charlie	487	+	72	46268204	69644
chr2	72971209	73171209	harbor1	chr2	72973329	72973543	DNA/hAT-Charlie	964	+	107	72973436	2227
chr2	72971209	73171209	harbor1	chr2	73033791	73034006	DNA/hAT-Charlie	1066	+	108	73033899	62690
chr2	26950213	27150213	harbor1	chr2	26997254	26997472	DNA/hAT-Charlie	1490	+	109	26997363	47150
chr2	26950213	27150213	harbor1	chr2	27037275	27037443	DNA/hAT-Charlie	514	+	84	27037359	87146
chr2	74415403	74615403	harbor1	chr2	74437571	74437731	DNA/hAT-Charlie	498	+	80	74437651	22248
chr2	74415403	74615403	harbor1	chr2	74494651	74494723	DNA/hAT-Charlie	779	+	36	74494687	79284
chr2	74415403	74615403	harbor1	chr2	74495020	74495123	DNA/hAT-Charlie	779	+	52	74495072	79669
chr2	42971427	43171427	harbor1	chr2	43009462	43009837	DNA/hAT-Charlie	2385	+	188	43009650	38223
chr2	74405689	74605689	harbor1	chr2	74437571	74437731	DNA/hAT-Charlie	498	+	80	74437651	31962
chr2	74405689	74605689	harbor1	chr2	74494651	74494723	DNA/hAT-Charlie	779	+	36	74494687	88998
chr2	74405689	74605689	harbor1	chr2	74495020	74495123	DNA/hAT-Charlie	779	+	52	74495072	89383
chr2	231861900	232061900	harbor1	chr2	231906042	231906206	DNA/hAT-Charlie	715	+	82	231906124	44224
chr2	156336151	156536151	harbor1	chr2	156349701	156350234	DNA/hAT-Charlie	3078	+	266	156349967	13816
chr2	156336151	156536151	harbor1	chr2	156360474	156360582	DNA/hAT-Charlie	555	+	54	156360528	24377
chr2	156336151	156536151	harbor1	chr2	156360681	156360817	DNA/hAT-Charlie	567	+	68	156360749	24598
chr2	156336151	156536151	harbor1	chr2	156396443	156396601	DNA/hAT-Charlie	794	+	79	156396522	60371
chr2	156336151	156536151	harbor1	chr2	156424728	156424847	DNA/hAT-Charlie	508	+	60	156424788	88637
chr2	72787358	72987358	harbor1	chr2	72802791	72802973	DNA/hAT-Charlie	1101	+	91	72802882	15524
chr2	1486893	1686893	harbor1	chr2	1554476	1554715	DNA/hAT-Charlie	630	+	120	1554596	67703
chr2	1486893	1686893	harbor1	chr2	1576740	1576962	DNA/hAT-Charlie	1516	+	111	1576851	89958
chr2	111023146	111223146	harbor1	chr2	111032192	111032402	DNA/hAT-Charlie	1029	+	105	111032297	9151
chr2	66131385	66331385	harbor1	chr2	66191375	66191523	DNA/hAT-Charlie	561	+	74	66191449	60064
chr2	108438378	108638378	harbor1	chr2	108503732	108503827	DNA/hAT-Charlie	570	+	48	108503780	65402
chr2	108438378	108638378	harbor1	chr2	108504146	108504209	DNA/hAT-Charlie	570	+	32	108504178	65800
chr2	108438378	108638378	harbor1	chr2	108514952	108515226	DNA/hAT-Charlie	1386	+	137	108515089	76711
chr2	72787359	72987359	harbor1	chr2	72802791	72802973	DNA/hAT-Charlie	1101	+	91	72802882	15523
chr2	113454958	113654958	harbor1	chr2	113512986	113513219	DNA/hAT-Charlie	627	+	116	113513102	58144
chr2	113454958	113654958	harbor1	chr2	113516723	113516803	DNA/hAT-Charlie	1034	+	40	113516763	61805
chr2	113454958	113654958	harbor1	chr2	113517074	113517234	DNA/hAT-Charlie	1034	+	80	113517154	62196
chr2	113454958	113654958	harbor1	chr2	113523848	113524027	DNA/hAT-Charlie	852	+	90	113523938	68980
chr2	113454958	113654958	harbor1	chr2	113524375	113524516	DNA/hAT-Charlie	625	+	70	113524445	69487
chr2	113454958	113654958	harbor1	chr2	113524868	113525145	DNA/hAT-Charlie	584	+	138	113525006	70048
chr2	113454958	113654958	harbor1	chr2	113537458	113537650	DNA/hAT-Charlie	595	+	96	113537554	82596
chr2	113454958	113654958	harbor1	chr2	113538181	113538335	DNA/hAT-Charlie	469	+	77	113538258	83300
chr2	113454958	113654958	harbor1	chr2	113548013	113548217	DNA/hAT-Charlie	1103	+	102	113548115	93157
chr2	112640558	112840558	harbor1	chr2	112666490	112666640	DNA/hAT-Charlie	704	+	75	112666565	26007
chr2	112640558	112840558	harbor1	chr2	112684452	112684657	DNA/hAT-Charlie	1117	+	102	112684554	43996
chr2	112640558	112840558	harbor1	chr2	112729829	112730030	DNA/hAT-Charlie	509	+	100	112729929	89371
chr2	113484018	113684018	harbor1	chr2	113512986	113513219	DNA/hAT-Charlie	627	+	116	113513102	29084
chr2	113484018	113684018	harbor1	chr2	113516723	113516803	DNA/hAT-Charlie	1034	+	40	113516763	32745
chr2	113484018	113684018	harbor1	chr2	113517074	113517234	DNA/hAT-Charlie	1034	+	80	113517154	33136
chr2	113484018	113684018	harbor1	chr2	113523848	113524027	DNA/hAT-Charlie	852	+	90	113523938	39920
chr2	113484018	113684018	harbor1	chr2	113524375	113524516	DNA/hAT-Charlie	625	+	70	113524445	40427
chr2	113484018	113684018	harbor1	chr2	113524868	113525145	DNA/hAT-Charlie	584	+	138	113525006	40988
chr2	113484018	113684018	harbor1	chr2	113537458	113537650	DNA/hAT-Charlie	595	+	96	113537554	53536
chr2	113484018	113684018	harbor1	chr2	113538181	113538335	DNA/hAT-Charlie	469	+	77	113538258	54240
chr2	113484018	113684018	harbor1	chr2	113548013	113548217	DNA/hAT-Charlie	1103	+	102	113548115	64097
chr2	69729666	69929666	harbor1	chr2	69815615	69815819	DNA/hAT-Charlie	986	+	102	69815717	86051
chr2	219392988	219592988	harbor1	chr2	219401108	219401353	DNA/hAT-Charlie	988	+	122	219401230	8242
chr2	219392988	219592988	harbor1	chr2	219401658	219401744	DNA/hAT-Charlie	988	+	43	219401701	8713
chr2	219392988	219592988	harbor1	chr2	219455330	219455526	DNA/hAT-Charlie	913	+	98	219455428	62440
chr2	219392988	219592988	harbor1	chr2	219458323	219458561	DNA/hAT-Charlie	903	+	119	219458442	65454
chr2	64294495	64494495	harbor1	chr2	64300614	64300756	DNA/hAT-Charlie	654	+	71	64300685	6190
chr2	64294495	64494495	harbor1	chr2	64339744	64339938	DNA/hAT-Charlie	644	+	97	64339841	45346
chr2	74415978	74615978	harbor1	chr2	74437571	74437731	DNA/hAT-Charlie	498	+	80	74437651	21673
chr2	74415978	74615978	harbor1	chr2	74494651	74494723	DNA/hAT-Charlie	779	+	36	74494687	78709
chr2	74415978	74615978	harbor1	chr2	74495020	74495123	DNA/hAT-Charlie	779	+	52	74495072	79094
chr2	2132316	2332316	harbor1	chr2	2170324	2170532	DNA/hAT-Charlie	593	+	104	2170428	38112
chr2	2132316	2332316	harbor1	chr2	2189339	2189723	DNA/hAT-Charlie	1283	+	192	2189531	57215
chr2	219060085	219260085	harbor1	chr2	219077830	219078031	DNA/hAT-Charlie	1087	+	100	219077930	17845
chr2	219060085	219260085	harbor1	chr2	219078778	219079012	DNA/hAT-Charlie	754	+	117	219078895	18810
chr2	219060085	219260085	harbor1	chr2	219128104	219128369	DNA/hAT-Charlie	1310	+	132	219128236	68151
chr2	43054951	43254951	harbor1	chr2	43106680	43106854	DNA/hAT-Charlie	727	+	87	43106767	51816
chr2	43054951	43254951	harbor1	chr2	43108527	43108750	DNA/hAT-Charlie	1079	+	112	43108639	53688
chr2	43054951	43254951	harbor1	chr2	43122512	43122944	DNA/hAT-Charlie	1473	+	216	43122728	67777
chr2	204956154	205156154	harbor1	chr2	205042964	205043118	DNA/hAT-Charlie	509	+	77	205043041	86887
chr2	204956154	205156154	harbor1	chr2	205050468	205050789	DNA/hAT-Charlie	1484	+	160	205050628	94474
chr2	95924862	96124862	harbor1	chr2	95925163	95925264	DNA/hAT-Charlie	460	+	50	95925213	351
chr2	95924862	96124862	harbor1	chr2	95928882	95929009	DNA/hAT-Charlie	444	+	64	95928946	4084
chr2	95924862	96124862	harbor1	chr2	95962164	95962277	DNA/hAT-Charlie	456	+	56	95962220	37358
chr2	175979808	176179808	harbor1	chr2	175980047	175980193	DNA/hAT-Charlie	451	+	73	175980120	312
chr2	175979808	176179808	harbor1	chr2	176050904	176051080	DNA/hAT-Charlie	499	+	88	176050992	71184
chr2	89546776	89746776	harbor1	chr2	89571517	89571692	DNA/hAT-Charlie	834	+	88	89571605	24829
chr2	89546776	89746776	harbor1	chr2	89629862	89629988	DNA/hAT-Charlie	467	+	63	89629925	83149
chr2	89546776	89746776	harbor1	chr2	89632413	89632499	DNA/hAT-Charlie	566	+	43	89632456	85680
chr2	89546776	89746776	harbor1	chr2	89632737	89632826	DNA/hAT-Charlie	566	+	44	89632781	86005
chr2	89546776	89746776	harbor1	chr2	89554914	89554999	DNA/hAT-Charlie	491	+	42	89554956	8180
chr2	74415961	74615961	harbor1	chr2	74437571	74437731	DNA/hAT-Charlie	498	+	80	74437651	21690
chr2	74415961	74615961	harbor1	chr2	74494651	74494723	DNA/hAT-Charlie	779	+	36	74494687	78726
chr2	74415961	74615961	harbor1	chr2	74495020	74495123	DNA/hAT-Charlie	779	+	52	74495072	79111
chr2	11244853	11444853	harbor1	chr2	11300854	11301097	DNA/hAT-Charlie	725	+	122	11300976	56123
chr2	11244853	11444853	harbor1	chr2	11302580	11302916	DNA/hAT-Charlie	1424	+	168	11302748	57895
chr2	11244853	11444853	harbor1	chr2	11311881	11312217	DNA/hAT-Charlie	1296	+	168	11312049	67196
chr2	11244853	11444853	harbor1	chr2	11315887	11316057	DNA/hAT-Charlie	776	+	85	11315972	71119
chr2	239594717	239794717	harbor1	chr2	239672006	239672381	DNA/hAT-Charlie	4032	+	188	239672194	77477
chr2	239594717	239794717	harbor1	chr2	239672681	239673687	DNA/hAT-Charlie	4032	+	503	239673184	78467
chr2	219060809	219260809	harbor1	chr2	219077830	219078031	DNA/hAT-Charlie	1087	+	100	219077930	17121
chr2	219060809	219260809	harbor1	chr2	219078778	219079012	DNA/hAT-Charlie	754	+	117	219078895	18086
chr2	219060809	219260809	harbor1	chr2	219128104	219128369	DNA/hAT-Charlie	1310	+	132	219128236	67427
chr2	119120408	119320408	harbor1	chr2	119122138	119122188	DNA/hAT-Charlie	660	+	25	119122163	1755
chr2	119120408	119320408	harbor1	chr2	119122502	119122676	DNA/hAT-Charlie	660	+	87	119122589	2181
chr2	119120408	119320408	harbor1	chr2	119122683	119122875	DNA/hAT-Charlie	884	+	96	119122779	2371
chr2	119120408	119320408	harbor1	chr2	119128455	119128604	DNA/hAT-Charlie	512	+	74	119128529	8121
chr2	119120408	119320408	harbor1	chr2	119171499	119171689	DNA/hAT-Charlie	636	+	95	119171594	51186
chr2	119120408	119320408	harbor1	chr2	119192370	119192653	DNA/hAT-Charlie	1221	+	142	119192512	72104
chr2	119120408	119320408	harbor1	chr2	119206192	119206338	DNA/hAT-Charlie	536	+	73	119206265	85857
chr2	60966422	61166422	harbor1	chr2	61002079	61002239	DNA/hAT-Charlie	615	+	80	61002159	35737
chr2	60966422	61166422	harbor1	chr2	61042008	61042918	DNA/hAT-Charlie	3400	+	455	61042463	76041
chr2	60966422	61166422	harbor1	chr2	61043375	61043944	DNA/hAT-Charlie	2573	+	284	61043659	77237
chr2	60966422	61166422	harbor1	chr2	61044690	61045497	DNA/hAT-Charlie	3418	+	404	61045094	78672
chr2	237867415	238067415	harbor1	chr2	237932310	237932409	DNA/hAT-Charlie	1474	+	50	237932360	64945
chr2	237867415	238067415	harbor1	chr2	237932680	237932804	DNA/hAT-Charlie	1474	+	62	237932742	65327
chr2	61805680	62005680	harbor1	chr2	61817022	61817546	DNA/hAT-Charlie	1443	+	262	61817284	11604
chr2	61805680	62005680	harbor1	chr2	61817558	61817684	DNA/hAT-Charlie	576	+	63	61817621	11941
chr2	61805680	62005680	harbor1	chr2	61832561	61832904	DNA/hAT-Charlie	1854	+	172	61832733	27053
chr2	61805680	62005680	harbor1	chr2	61865638	61865857	DNA/hAT-Charlie	1450	+	110	61865748	60068
chr2	61805680	62005680	harbor1	chr2	61903924	61904014	DNA/hAT-Charlie	1628	+	45	61903969	98289
chr2	61805680	62005680	harbor1	chr2	61904310	61904694	DNA/hAT-Charlie	1628	+	192	61904502	98822
chr2	61805680	62005680	harbor1	chr2	61905040	61905150	DNA/hAT-Charlie	1628	+	55	61905095	99415
chr2	74415475	74615475	harbor1	chr2	74437571	74437731	DNA/hAT-Charlie	498	+	80	74437651	22176
chr2	74415475	74615475	harbor1	chr2	74494651	74494723	DNA/hAT-Charlie	779	+	36	74494687	79212
chr2	74415475	74615475	harbor1	chr2	74495020	74495123	DNA/hAT-Charlie	779	+	52	74495072	79597
chr2	74415962	74615962	harbor1	chr2	74437571	74437731	DNA/hAT-Charlie	498	+	80	74437651	21689
chr2	74415962	74615962	harbor1	chr2	74494651	74494723	DNA/hAT-Charlie	779	+	36	74494687	78725
chr2	74415962	74615962	harbor1	chr2	74495020	74495123	DNA/hAT-Charlie	779	+	52	74495072	79110
chr2	70771714	70971714	harbor1	chr2	70814395	70814541	DNA/hAT-Charlie	608	+	73	70814468	42754
chr2	70771714	70971714	harbor1	chr2	70814570	70814753	DNA/hAT-Charlie	572	+	92	70814662	42948
chr2	70771714	70971714	harbor1	chr2	70814764	70814941	DNA/hAT-Charlie	465	+	88	70814852	43138
chr2	70771714	70971714	harbor1	chr2	70817234	70817618	DNA/hAT-Charlie	943	+	192	70817426	45712
chr2	232203322	232403322	harbor1	chr2	232238878	232238993	DNA/hAT-Charlie	453	+	58	232238936	35614
chr2	232203322	232403322	harbor1	chr2	232262461	232262667	DNA/hAT-Charlie	1061	+	103	232262564	59242
chr2	218914258	219114258	harbor1	chr2	219012747	219012995	DNA/hAT-Charlie	469	+	124	219012871	98613
chr2	53759983	53959983	harbor1	chr2	53770996	53771173	DNA/hAT-Charlie	697	+	88	53771084	11101
chr2	53759983	53959983	harbor1	chr2	53793360	53793549	DNA/hAT-Charlie	728	+	94	53793454	33471
chr2	42069583	42269583	harbor1	chr2	42091119	42091351	DNA/hAT-Charlie	1062	+	116	42091235	21652
chr2	42069583	42269583	harbor1	chr2	42093210	42093379	DNA/hAT-Charlie	557	+	84	42093294	23711
chr2	42069583	42269583	harbor1	chr2	42133844	42133991	DNA/hAT-Charlie	535	+	74	42133918	64335
chr2	42069583	42269583	harbor1	chr2	42134308	42134347	DNA/hAT-Charlie	535	+	20	42134328	64745
chr2	158868003	159068003	harbor1	chr2	158901178	158901384	DNA/hAT-Charlie	630	+	103	158901281	33278
chr2	43126586	43326586	harbor1	chr2	43184757	43184974	DNA/hAT-Charlie	690	+	108	43184865	58279
chr2	43126586	43326586	harbor1	chr2	43213534	43213708	DNA/hAT-Charlie	851	+	87	43213621	87035
chr2	97589114	97789114	harbor1	chr2	97643696	97643872	DNA/hAT-Charlie	616	+	88	97643784	54670
chr2	97589114	97789114	harbor1	chr2	97644358	97644620	DNA/hAT-Charlie	635	+	131	97644489	55375
chr2	97589114	97789114	harbor1	chr2	97650544	97650708	DNA/hAT-Charlie	789	+	82	97650626	61512
chr2	97589114	97789114	harbor1	chr2	97662090	97662304	DNA/hAT-Charlie	832	+	107	97662197	73083
chr2	72971106	73171106	harbor1	chr2	72973329	72973543	DNA/hAT-Charlie	964	+	107	72973436	2330
chr2	72971106	73171106	harbor1	chr2	73033791	73034006	DNA/hAT-Charlie	1066	+	108	73033899	62793
chr2	27395167	27595167	harbor1	chr2	27450505	27450591	DNA/hAT-Charlie	849	+	43	27450548	55381
chr2	27395167	27595167	harbor1	chr2	27450890	27451054	DNA/hAT-Charlie	849	+	82	27450972	55805
chr2	27395167	27595167	harbor1	chr2	27463427	27463648	DNA/hAT-Charlie	1424	+	110	27463537	68370
chr2	26957504	27157504	harbor1	chr2	26997254	26997472	DNA/hAT-Charlie	1490	+	109	26997363	39859
chr2	26957504	27157504	harbor1	chr2	27037275	27037443	DNA/hAT-Charlie	514	+	84	27037359	79855
chr2	28770576	28970576	harbor1	chr2	28814357	28814578	DNA/hAT-Charlie	936	+	110	28814467	43891
chr2	43055485	43255485	harbor1	chr2	43106680	43106854	DNA/hAT-Charlie	727	+	87	43106767	51282
chr2	43055485	43255485	harbor1	chr2	43108527	43108750	DNA/hAT-Charlie	1079	+	112	43108639	53154
chr2	43055485	43255485	harbor1	chr2	43122512	43122944	DNA/hAT-Charlie	1473	+	216	43122728	67243
chr2	46198514	46398514	harbor1	chr2	46199416	46199580	DNA/hAT-Charlie	934	+	82	46199498	984
chr2	46198514	46398514	harbor1	chr2	46199581	46199656	DNA/hAT-Charlie	472	+	38	46199619	1105
chr2	46198514	46398514	harbor1	chr2	46199955	46199986	DNA/hAT-Charlie	472	+	16	46199971	1457
chr2	46198514	46398514	harbor1	chr2	46218480	46218654	DNA/hAT-Charlie	818	+	87	46218567	20053
chr2	46198514	46398514	harbor1	chr2	46227485	46227668	DNA/hAT-Charlie	449	+	92	46227577	29063
chr2	46198514	46398514	harbor1	chr2	46268132	46268276	DNA/hAT-Charlie	487	+	72	46268204	69690
chr2	42069420	42269420	harbor1	chr2	42091119	42091351	DNA/hAT-Charlie	1062	+	116	42091235	21815
chr2	42069420	42269420	harbor1	chr2	42093210	42093379	DNA/hAT-Charlie	557	+	84	42093294	23874
chr2	42069420	42269420	harbor1	chr2	42133844	42133991	DNA/hAT-Charlie	535	+	74	42133918	64498
chr2	42069420	42269420	harbor1	chr2	42134308	42134347	DNA/hAT-Charlie	535	+	20	42134328	64908
chr2	219458026	219658026	harbor1	chr2	219458323	219458561	DNA/hAT-Charlie	903	+	119	219458442	416
chr2	219458026	219658026	harbor1	chr2	219519544	219519726	DNA/hAT-Charlie	1013	+	91	219519635	61609
chr2	43118487	43318487	harbor1	chr2	43184757	43184974	DNA/hAT-Charlie	690	+	108	43184865	66378
chr2	43118487	43318487	harbor1	chr2	43213534	43213708	DNA/hAT-Charlie	851	+	87	43213621	95134
chr2	43118487	43318487	harbor1	chr2	43122512	43122944	DNA/hAT-Charlie	1473	+	216	43122728	4241
chr2	60966462	61166462	harbor1	chr2	61002079	61002239	DNA/hAT-Charlie	615	+	80	61002159	35697
chr2	60966462	61166462	harbor1	chr2	61042008	61042918	DNA/hAT-Charlie	3400	+	455	61042463	76001
chr2	60966462	61166462	harbor1	chr2	61043375	61043944	DNA/hAT-Charlie	2573	+	284	61043659	77197
chr2	60966462	61166462	harbor1	chr2	61044690	61045497	DNA/hAT-Charlie	3418	+	404	61045094	78632
chr2	236586213	236786213	harbor1	chr2	236586319	236586487	DNA/hAT-Charlie	863	+	84	236586403	190
chr2	236586213	236786213	harbor1	chr2	236586907	236586952	DNA/hAT-Charlie	863	+	22	236586929	716
chr2	236586213	236786213	harbor1	chr2	236662663	236662875	DNA/hAT-Charlie	1170	+	106	236662769	76556
chr2	24693648	24893648	harbor1	chr2	24744718	24744920	DNA/hAT-Charlie	828	+	101	24744819	51171
chr2	217614103	217814103	harbor1	chr2	217630346	217630608	DNA/hAT-Charlie	612	+	131	217630477	16374
chr2	217614103	217814103	harbor1	chr2	217657890	217658034	DNA/hAT-Charlie	815	+	72	217657962	43859
chr2	217614103	217814103	harbor1	chr2	217664137	217664287	DNA/hAT-Charlie	500	+	75	217664212	50109
chr2	160393135	160593135	harbor1	chr2	160434535	160434715	DNA/hAT-Charlie	864	+	90	160434625	41490
chr2	94934942	95134942	harbor1	chr2	95006379	95006671	DNA/hAT-Charlie	1105	+	146	95006525	71583
chr2	97564374	97764374	harbor1	chr2	97643696	97643872	DNA/hAT-Charlie	616	+	88	97643784	79410
chr2	97564374	97764374	harbor1	chr2	97644358	97644620	DNA/hAT-Charlie	635	+	131	97644489	80115
chr2	97564374	97764374	harbor1	chr2	97650544	97650708	DNA/hAT-Charlie	789	+	82	97650626	86252
chr2	97564374	97764374	harbor1	chr2	97662090	97662304	DNA/hAT-Charlie	832	+	107	97662197	97823
chr2	111955759	112155759	harbor1	chr2	112030785	112030816	DNA/hAT-Charlie	1106	+	16	112030801	75042
chr2	111955759	112155759	harbor1	chr2	112031111	112031587	DNA/hAT-Charlie	1106	+	238	112031349	75590
chr2	217374869	217574869	harbor1	chr2	217383053	217383376	DNA/hAT-Charlie	971	+	162	217383215	8346
chr2	112779792	112979792	harbor1	chr2	112818176	112818395	DNA/hAT-Charlie	967	+	110	112818286	38494
chr2	26403834	26603834	harbor1	chr2	26492166	26492361	DNA/hAT-Charlie	994	+	98	26492264	88430
chr2	219077829	219277829	harbor1	chr2	219077830	219078031	DNA/hAT-Charlie	1087	+	100	219077930	101
chr2	219077829	219277829	harbor1	chr2	219078778	219079012	DNA/hAT-Charlie	754	+	117	219078895	1066
chr2	219077829	219277829	harbor1	chr2	219128104	219128369	DNA/hAT-Charlie	1310	+	132	219128236	50407
chr2	26950239	27150239	harbor1	chr2	26997254	26997472	DNA/hAT-Charlie	1490	+	109	26997363	47124
chr2	26950239	27150239	harbor1	chr2	27037275	27037443	DNA/hAT-Charlie	514	+	84	27037359	87120
chr2	217726903	217926903	harbor1	chr2	217796125	217796248	DNA/hAT-Charlie	522	+	62	217796187	69284
chr2	217726903	217926903	harbor1	chr2	217798034	217798293	DNA/hAT-Charlie	2182	+	130	217798164	71261
chr2	217726903	217926903	harbor1	chr2	217798594	217798844	DNA/hAT-Charlie	2182	+	125	217798719	71816
chr3	127489937	127689937	harbor1	chr3	127500397	127500717	DNA/hAT-Charlie	1477	+	160	127500557	10620
chr3	127489937	127689937	harbor1	chr3	127500716	127500873	DNA/hAT-Charlie	587	+	78	127500794	10857
chr3	51869986	52069986	harbor1	chr3	51881448	51882253	DNA/hAT-Charlie	10724	+	402	51881850	11864
chr3	51869986	52069986	harbor1	chr3	51882555	51883727	DNA/hAT-Charlie	10724	+	586	51883141	13155
chr3	51869986	52069986	harbor1	chr3	51884150	51884545	DNA/hAT-Charlie	10724	+	198	51884348	14362
chr3	138334620	138534620	harbor1	chr3	138353094	138353372	DNA/hAT-Charlie	439	+	139	138353233	18613
chr3	138334620	138534620	harbor1	chr3	138373304	138373443	DNA/hAT-Charlie	539	+	70	138373374	38754
chr3	138334620	138534620	harbor1	chr3	138373515	138373659	DNA/hAT-Charlie	566	+	72	138373587	38967
chr3	138334620	138534620	harbor1	chr3	138408752	138408869	DNA/hAT-Charlie	543	+	58	138408810	74190
chr3	138334620	138534620	harbor1	chr3	138409534	138409716	DNA/hAT-Charlie	996	+	91	138409625	75005
chr3	138334620	138534620	harbor1	chr3	138410440	138410565	DNA/hAT-Charlie	461	+	62	138410502	75882
chr3	138334620	138534620	harbor1	chr3	138418417	138418596	DNA/hAT-Charlie	655	+	90	138418507	83887
chr3	138334620	138534620	harbor1	chr3	138433249	138433389	DNA/hAT-Charlie	525	+	70	138433319	98699
chr3	107991341	108191341	harbor1	chr3	108027029	108027151	DNA/hAT-Charlie	470	+	61	108027090	35749
chr3	107991308	108191308	harbor1	chr3	108027029	108027151	DNA/hAT-Charlie	470	+	61	108027090	35782
chr3	107991371	108191371	harbor1	chr3	108027029	108027151	DNA/hAT-Charlie	470	+	61	108027090	35719
chr3	107991316	108191316	harbor1	chr3	108027029	108027151	DNA/hAT-Charlie	470	+	61	108027090	35774
chr3	9817202	10017202	harbor1	chr3	9820976	9821243	DNA/hAT-Charlie	653	+	134	9821110	3908
chr3	9817202	10017202	harbor1	chr3	9878214	9878381	DNA/hAT-Charlie	734	+	84	9878298	61096
chr3	9817202	10017202	harbor1	chr3	9879039	9879161	DNA/hAT-Charlie	774	+	61	9879100	61898
chr3	9817202	10017202	harbor1	chr3	9914097	9914385	DNA/hAT-Charlie	831	+	144	9914241	97039
chr3	9817202	10017202	harbor1	chr3	9879471	9879560	DNA/hAT-Charlie	774	+	44	9879515	62313
chr3	9817202	10017202	harbor1	chr3	9911978	9912321	DNA/hAT-Charlie	2138	+	172	9912150	94948
chr3	107991276	108191276	harbor1	chr3	108027029	108027151	DNA/hAT-Charlie	470	+	61	108027090	35814
chr3	107991357	108191357	harbor1	chr3	108027029	108027151	DNA/hAT-Charlie	470	+	61	108027090	35733
chr3	107991312	108191312	harbor1	chr3	108027029	108027151	DNA/hAT-Charlie	470	+	61	108027090	35778
chr3	107991310	108191310	harbor1	chr3	108027029	108027151	DNA/hAT-Charlie	470	+	61	108027090	35780
chr3	107991337	108191337	harbor1	chr3	108027029	108027151	DNA/hAT-Charlie	470	+	61	108027090	35753
chr3	107991338	108191338	harbor1	chr3	108027029	108027151	DNA/hAT-Charlie	470	+	61	108027090	35752
chr3	107991370	108191370	harbor1	chr3	108027029	108027151	DNA/hAT-Charlie	470	+	61	108027090	35720
chr3	107991302	108191302	harbor1	chr3	108027029	108027151	DNA/hAT-Charlie	470	+	61	108027090	35788
chr3	42586603	42786603	harbor1	chr3	42589524	42589828	DNA/hAT-Charlie	1597	+	152	42589676	3073
chr3	42586603	42786603	harbor1	chr3	42597613	42597822	DNA/hAT-Charlie	1321	+	104	42597717	11114
chr3	42586603	42786603	harbor1	chr3	42616344	42616540	DNA/hAT-Charlie	864	+	98	42616442	29839
chr3	42586603	42786603	harbor1	chr3	42616522	42616642	DNA/hAT-Charlie	534	+	60	42616582	29979
chr3	156989205	157189205	harbor1	chr3	157051065	157051153	DNA/hAT-Charlie	413	+	44	157051109	61904
chr3	156989205	157189205	harbor1	chr3	157068079	157068307	DNA/hAT-Charlie	993	+	114	157068193	78988
chr3	156989205	157189205	harbor1	chr3	157078248	157078443	DNA/hAT-Charlie	763	+	98	157078346	89141
chr3	107991361	108191361	harbor1	chr3	108027029	108027151	DNA/hAT-Charlie	470	+	61	108027090	35729
chr3	107991380	108191380	harbor1	chr3	108027029	108027151	DNA/hAT-Charlie	470	+	61	108027090	35710
chr3	46799563	46999563	harbor1	chr3	46811515	46811610	DNA/hAT-Charlie	429	+	48	46811563	12000
chr3	46799563	46999563	harbor1	chr3	46817241	46818336	DNA/hAT-Charlie	4866	+	548	46817789	18226
chr3	50288182	50488182	harbor1	chr3	50376995	50377299	DNA/hAT-Charlie	1364	+	152	50377147	88965
chr3	50288182	50488182	harbor1	chr3	50382542	50382688	DNA/hAT-Charlie	429	+	73	50382615	94433
chr3	107991451	108191451	harbor1	chr3	108027029	108027151	DNA/hAT-Charlie	470	+	61	108027090	35639
chr3	129021155	129221155	harbor1	chr3	129021003	129021430	DNA/hAT-Charlie	1179	+	214	129021217	62
chr3	129021155	129221155	harbor1	chr3	129021764	129021998	DNA/hAT-Charlie	525	+	117	129021881	726
chr3	129021155	129221155	harbor1	chr3	129022929	129023080	DNA/hAT-Charlie	462	+	76	129023005	1850
chr3	129021155	129221155	harbor1	chr3	129067150	129067474	DNA/hAT-Charlie	911	+	162	129067312	46157
chr3	129021155	129221155	harbor1	chr3	129068911	129069105	DNA/hAT-Charlie	567	+	97	129069008	47853
chr3	129021155	129221155	harbor1	chr3	129094065	129094232	DNA/hAT-Charlie	711	+	84	129094149	72994
chr3	107991298	108191298	harbor1	chr3	108027029	108027151	DNA/hAT-Charlie	470	+	61	108027090	35792
chr3	52222004	52422004	harbor1	chr3	52233380	52233537	DNA/hAT-Charlie	479	+	78	52233458	11454
chr3	147453950	147653950	harbor1	chr3	147488309	147488502	DNA/hAT-Charlie	691	+	96	147488405	34455
chr3	147453950	147653950	harbor1	chr3	147510722	147510898	DNA/hAT-Charlie	416	+	88	147510810	56860
chr3	147453950	147653950	harbor1	chr3	147517941	147518091	DNA/hAT-Charlie	659	+	75	147518016	64066
chr3	161005424	161205424	harbor1	chr3	161007540	161007759	DNA/hAT-Charlie	1401	+	110	161007650	2226
chr3	161005424	161205424	harbor1	chr3	161057571	161057785	DNA/hAT-Charlie	567	+	107	161057678	52254
chr3	161005424	161205424	harbor1	chr3	161096803	161096931	DNA/hAT-Charlie	461	+	64	161096867	91443
chr3	161005424	161205424	harbor1	chr3	161097010	161097146	DNA/hAT-Charlie	492	+	68	161097078	91654
chr3	107991375	108191375	harbor1	chr3	108027029	108027151	DNA/hAT-Charlie	470	+	61	108027090	35715
chr3	107991366	108191366	harbor1	chr3	108027029	108027151	DNA/hAT-Charlie	470	+	61	108027090	35724
chr3	107991309	108191309	harbor1	chr3	108027029	108027151	DNA/hAT-Charlie	470	+	61	108027090	35781
chr3	43899206	44099206	harbor1	chr3	43968607	43968763	DNA/hAT-Charlie	552	+	78	43968685	69479
chr3	43899206	44099206	harbor1	chr3	43970084	43970292	DNA/hAT-Charlie	1156	+	104	43970188	70982
chr3	47681961	47881961	harbor1	chr3	47724469	47724686	DNA/hAT-Charlie	1250	+	108	47724577	42616
chr3	47681961	47881961	harbor1	chr3	47756625	47756828	DNA/hAT-Charlie	661	+	102	47756727	74766
chr3	47681961	47881961	harbor1	chr3	47758545	47758691	DNA/hAT-Charlie	469	+	73	47758618	76657
chr3	107991277	108191277	harbor1	chr3	108027029	108027151	DNA/hAT-Charlie	470	+	61	108027090	35813
chr3	124721335	124921335	harbor1	chr3	124732922	124732967	DNA/hAT-Charlie	587	+	22	124732944	11609
chr3	124721335	124921335	harbor1	chr3	124732998	124733336	DNA/hAT-Charlie	587	+	169	124733167	11832
chr3	124721335	124921335	harbor1	chr3	124733782	124734156	DNA/hAT-Charlie	1141	+	187	124733969	12634
chr3	125916736	126116736	harbor1	chr3	125926924	125927096	DNA/hAT-Charlie	1205	+	86	125927010	10274
chr3	125916736	126116736	harbor1	chr3	125929933	125930132	DNA/hAT-Charlie	831	+	100	125930033	13297
chr3	125916736	126116736	harbor1	chr3	125982657	125982799	DNA/hAT-Charlie	676	+	71	125982728	65992
chr3	125916736	126116736	harbor1	chr3	126014276	126014527	DNA/hAT-Charlie	409	+	126	126014402	97666
chr3	195981907	196181907	harbor1	chr3	196064740	196064876	DNA/hAT-Charlie	415	+	68	196064808	82901
chr3	107991343	108191343	harbor1	chr3	108027029	108027151	DNA/hAT-Charlie	470	+	61	108027090	35747
chr3	17061072	17261072	harbor1	chr3	17070115	17070279	DNA/hAT-Charlie	977	+	82	17070197	9125
chr3	17061072	17261072	harbor1	chr3	17088634	17088807	DNA/hAT-Charlie	514	+	86	17088720	27648
chr3	17061072	17261072	harbor1	chr3	17096047	17096258	DNA/hAT-Charlie	483	+	106	17096153	35081
chr3	17061072	17261072	harbor1	chr3	17120247	17120435	DNA/hAT-Charlie	804	+	94	17120341	59269
chr3	17061072	17261072	harbor1	chr3	17133679	17133907	DNA/hAT-Charlie	793	+	114	17133793	72721
chr3	17061072	17261072	harbor1	chr3	17135625	17135764	DNA/hAT-Charlie	787	+	70	17135695	74623
chr3	17061072	17261072	harbor1	chr3	17150439	17150631	DNA/hAT-Charlie	523	+	96	17150535	89463
chr3	107991355	108191355	harbor1	chr3	108027029	108027151	DNA/hAT-Charlie	470	+	61	108027090	35735
chr3	43899195	44099195	harbor1	chr3	43968607	43968763	DNA/hAT-Charlie	552	+	78	43968685	69490
chr3	43899195	44099195	harbor1	chr3	43970084	43970292	DNA/hAT-Charlie	1156	+	104	43970188	70993
chr3	184085534	184285534	harbor1	chr3	184126432	184126590	DNA/hAT-Charlie	825	+	79	184126511	40977
chr3	123349837	123549837	harbor1	chr3	123365944	123366232	DNA/hAT-Charlie	1027	+	144	123366088	16251
chr3	123349837	123549837	harbor1	chr3	123399149	123399386	DNA/hAT-Charlie	899	+	118	123399267	49430
chr3	123349837	123549837	harbor1	chr3	123409574	123409740	DNA/hAT-Charlie	562	+	83	123409657	59820
chr3	123349837	123549837	harbor1	chr3	123428756	123428894	DNA/hAT-Charlie	414	+	69	123428825	78988
chr3	195853169	196053169	harbor1	chr3	195890238	195890366	DNA/hAT-Charlie	417	+	64	195890302	37133
chr3	195853169	196053169	harbor1	chr3	195890369	195890446	DNA/hAT-Charlie	857	+	38	195890407	37238
chr3	195853169	196053169	harbor1	chr3	195890728	195891118	DNA/hAT-Charlie	857	+	195	195890923	37754
chr3	185838095	186038095	harbor1	chr3	185871250	185871646	DNA/hAT-Charlie	2533	+	198	185871448	33353
chr3	185838095	186038095	harbor1	chr3	185872252	185872560	DNA/hAT-Charlie	2533	+	154	185872406	34311
chr3	185838095	186038095	harbor1	chr3	185873165	185873384	DNA/hAT-Charlie	2533	+	110	185873275	35180
chr3	185838095	186038095	harbor1	chr3	185877082	185877222	DNA/hAT-Charlie	493	+	70	185877152	39057
chr3	185838095	186038095	harbor1	chr3	185922389	185922657	DNA/hAT-Charlie	828	+	134	185922523	84428
chr3	142754359	142954359	harbor1	chr3	142800381	142800585	DNA/hAT-Charlie	526	+	102	142800483	46124
chr3	142754359	142954359	harbor1	chr3	142824222	142824430	DNA/hAT-Charlie	920	+	104	142824326	69967
chr3	196916565	197116565	harbor1	chr3	196930524	196930715	DNA/hAT-Charlie	1118	+	96	196930620	14055
chr3	196916565	197116565	harbor1	chr3	197000063	197000226	DNA/hAT-Charlie	908	+	82	197000145	83580
chr3	23710846	23910846	harbor1	chr3	23731814	23731989	DNA/hAT-Charlie	942	+	88	23731902	21056
chr3	23710846	23910846	harbor1	chr3	23732297	23732339	DNA/hAT-Charlie	942	+	21	23732318	21472
chr3	23710846	23910846	harbor1	chr3	23751806	23752117	DNA/hAT-Charlie	874	+	156	23751962	41116
chr3	107991335	108191335	harbor1	chr3	108027029	108027151	DNA/hAT-Charlie	470	+	61	108027090	35755
chr3	39004795	39204795	harbor1	chr3	39008919	39009360	DNA/hAT-Charlie	1785	+	220	39009139	4344
chr3	127581151	127781151	harbor1	chr3	127612019	127612220	DNA/hAT-Charlie	447	+	100	127612119	30968
chr3	127581151	127781151	harbor1	chr3	127635600	127635772	DNA/hAT-Charlie	757	+	86	127635686	54535
chr3	123544681	123744681	harbor1	chr3	123557104	123557387	DNA/hAT-Charlie	1933	+	142	123557246	12565
chr3	123544681	123744681	harbor1	chr3	123610161	123610289	DNA/hAT-Charlie	713	+	64	123610225	65544
chr3	16431951	16631951	harbor1	chr3	16445533	16445844	DNA/hAT-Charlie	1534	+	156	16445689	13738
chr3	16431951	16631951	harbor1	chr3	16448017	16448313	DNA/hAT-Charlie	1342	+	148	16448165	16214
chr3	16431951	16631951	harbor1	chr3	16464628	16464864	DNA/hAT-Charlie	1231	+	118	16464746	32795
chr3	16431951	16631951	harbor1	chr3	16483796	16483979	DNA/hAT-Charlie	1183	+	92	16483888	51937
chr3	16431951	16631951	harbor1	chr3	16487423	16487616	DNA/hAT-Charlie	1053	+	96	16487519	55568
chr3	16431951	16631951	harbor1	chr3	16493142	16493235	DNA/hAT-Charlie	467	+	46	16493188	61237
chr3	16431951	16631951	harbor1	chr3	16493531	16493580	DNA/hAT-Charlie	467	+	24	16493555	61604
chr3	16431951	16631951	harbor1	chr3	16503212	16503373	DNA/hAT-Charlie	691	+	80	16503292	71341
chr3	16431951	16631951	harbor1	chr3	16508854	16509063	DNA/hAT-Charlie	1093	+	104	16508958	77007
chr3	23710841	23910841	harbor1	chr3	23731814	23731989	DNA/hAT-Charlie	942	+	88	23731902	21061
chr3	23710841	23910841	harbor1	chr3	23732297	23732339	DNA/hAT-Charlie	942	+	21	23732318	21477
chr3	23710841	23910841	harbor1	chr3	23751806	23752117	DNA/hAT-Charlie	874	+	156	23751962	41121
chr3	128328692	128528692	harbor1	chr3	128348370	128348786	DNA/hAT-Charlie	743	+	208	128348578	19886
chr3	128328692	128528692	harbor1	chr3	128426853	128427098	DNA/hAT-Charlie	642	+	122	128426975	98283
chr3	123349752	123549752	harbor1	chr3	123365944	123366232	DNA/hAT-Charlie	1027	+	144	123366088	16336
chr3	123349752	123549752	harbor1	chr3	123399149	123399386	DNA/hAT-Charlie	899	+	118	123399267	49515
chr3	123349752	123549752	harbor1	chr3	123409574	123409740	DNA/hAT-Charlie	562	+	83	123409657	59905
chr3	123349752	123549752	harbor1	chr3	123428756	123428894	DNA/hAT-Charlie	414	+	69	123428825	79073
chr3	52121829	52321829	harbor1	chr3	52172847	52172959	DNA/hAT-Charlie	428	+	56	52172903	51074
chr3	52121829	52321829	harbor1	chr3	52172969	52173171	DNA/hAT-Charlie	1101	+	101	52173070	51241
chr3	46771747	46971747	harbor1	chr3	46811515	46811610	DNA/hAT-Charlie	429	+	48	46811563	39816
chr3	46771747	46971747	harbor1	chr3	46817241	46818336	DNA/hAT-Charlie	4866	+	548	46817789	46042
chr3	138334619	138534619	harbor1	chr3	138353094	138353372	DNA/hAT-Charlie	439	+	139	138353233	18614
chr3	138334619	138534619	harbor1	chr3	138373304	138373443	DNA/hAT-Charlie	539	+	70	138373374	38755
chr3	138334619	138534619	harbor1	chr3	138373515	138373659	DNA/hAT-Charlie	566	+	72	138373587	38968
chr3	138334619	138534619	harbor1	chr3	138408752	138408869	DNA/hAT-Charlie	543	+	58	138408810	74191
chr3	138334619	138534619	harbor1	chr3	138409534	138409716	DNA/hAT-Charlie	996	+	91	138409625	75006
chr3	138334619	138534619	harbor1	chr3	138410440	138410565	DNA/hAT-Charlie	461	+	62	138410502	75883
chr3	138334619	138534619	harbor1	chr3	138418417	138418596	DNA/hAT-Charlie	655	+	90	138418507	83888
chr3	138334619	138534619	harbor1	chr3	138433249	138433389	DNA/hAT-Charlie	525	+	70	138433319	98700
chr3	127490156	127690156	harbor1	chr3	127500397	127500717	DNA/hAT-Charlie	1477	+	160	127500557	10401
chr3	127490156	127690156	harbor1	chr3	127500716	127500873	DNA/hAT-Charlie	587	+	78	127500794	10638
chr3	113647007	113847007	harbor1	chr3	113693979	113694152	DNA/hAT-Charlie	428	+	86	113694065	47058
chr3	113647007	113847007	harbor1	chr3	113741752	113742107	DNA/hAT-Charlie	1073	+	178	113741930	94923
chr3	179842465	180042465	harbor1	chr3	179843232	179843404	DNA/hAT-Charlie	707	+	86	179843318	853
chr3	179842465	180042465	harbor1	chr3	179860408	179860568	DNA/hAT-Charlie	505	+	80	179860488	18023
chr3	179842465	180042465	harbor1	chr3	179923431	179923613	DNA/hAT-Charlie	764	+	91	179923522	81057
chr3	179842465	180042465	harbor1	chr3	179927461	179927742	DNA/hAT-Charlie	913	+	140	179927601	85136
chr3	179842465	180042465	harbor1	chr3	179930018	179930203	DNA/hAT-Charlie	965	+	92	179930110	87645
chr3	179842465	180042465	harbor1	chr3	179939301	179939420	DNA/hAT-Charlie	543	+	60	179939361	96896
chr3	190413906	190613906	harbor1	chr3	190430652	190430851	DNA/hAT-Charlie	735	+	100	190430752	16846
chr3	190413906	190613906	harbor1	chr3	190467782	190467979	DNA/hAT-Charlie	1026	+	98	190467880	53974
chr3	52945185	53145185	harbor1	chr3	53036259	53036385	DNA/hAT-Charlie	439	+	63	53036322	91137
chr3	127490312	127690312	harbor1	chr3	127500397	127500717	DNA/hAT-Charlie	1477	+	160	127500557	10245
chr3	127490312	127690312	harbor1	chr3	127500716	127500873	DNA/hAT-Charlie	587	+	78	127500794	10482
chr3	128328699	128528699	harbor1	chr3	128348370	128348786	DNA/hAT-Charlie	743	+	208	128348578	19879
chr3	128328699	128528699	harbor1	chr3	128426853	128427098	DNA/hAT-Charlie	642	+	122	128426975	98276
chr3	128328755	128528755	harbor1	chr3	128348370	128348786	DNA/hAT-Charlie	743	+	208	128348578	19823
chr3	128328755	128528755	harbor1	chr3	128426853	128427098	DNA/hAT-Charlie	642	+	122	128426975	98220
chr3	184199369	184399369	harbor1	chr3	184217898	184218219	DNA/hAT-Charlie	1692	+	160	184218058	18689
chr3	123544677	123744677	harbor1	chr3	123557104	123557387	DNA/hAT-Charlie	1933	+	142	123557246	12569
chr3	123544677	123744677	harbor1	chr3	123610161	123610289	DNA/hAT-Charlie	713	+	64	123610225	65548
chr3	128581053	128781053	harbor1	chr3	128586111	128586276	DNA/hAT-Charlie	459	+	82	128586193	5140
chr3	128581053	128781053	harbor1	chr3	128598050	128598287	DNA/hAT-Charlie	760	+	118	128598168	17115
chr3	128581053	128781053	harbor1	chr3	128598569	128598694	DNA/hAT-Charlie	760	+	62	128598631	17578
chr3	128581053	128781053	harbor1	chr3	128647296	128647414	DNA/hAT-Charlie	477	+	59	128647355	66302
chr3	128581053	128781053	harbor1	chr3	128647710	128647899	DNA/hAT-Charlie	477	+	94	128647804	66751
chr3	47681964	47881964	harbor1	chr3	47724469	47724686	DNA/hAT-Charlie	1250	+	108	47724577	42613
chr3	47681964	47881964	harbor1	chr3	47756625	47756828	DNA/hAT-Charlie	661	+	102	47756727	74763
chr3	47681964	47881964	harbor1	chr3	47758545	47758691	DNA/hAT-Charlie	469	+	73	47758618	76654
chr3	138087580	138287580	harbor1	chr3	138099205	138099422	DNA/hAT-Charlie	1537	+	108	138099313	11733
chr3	138087580	138287580	harbor1	chr3	138108870	138108963	DNA/hAT-Charlie	694	+	46	138108916	21336
chr3	138087580	138287580	harbor1	chr3	138128001	138128231	DNA/hAT-Charlie	757	+	115	138128116	40536
chr3	138087580	138287580	harbor1	chr3	138129637	138129725	DNA/hAT-Charlie	518	+	44	138129681	42101
chr3	138087580	138287580	harbor1	chr3	138185956	138186203	DNA/hAT-Charlie	670	+	124	138186080	98500
chr3	50288152	50488152	harbor1	chr3	50376995	50377299	DNA/hAT-Charlie	1364	+	152	50377147	88995
chr3	50288152	50488152	harbor1	chr3	50382542	50382688	DNA/hAT-Charlie	429	+	73	50382615	94463
chr3	107991305	108191305	harbor1	chr3	108027029	108027151	DNA/hAT-Charlie	470	+	61	108027090	35785
chr3	50278721	50478721	harbor1	chr3	50376995	50377299	DNA/hAT-Charlie	1364	+	152	50377147	98426
chr3	51571820	51771820	harbor1	chr3	51613850	51614062	DNA/hAT-Charlie	1088	+	106	51613956	42136
chr3	51571820	51771820	harbor1	chr3	51640224	51640381	DNA/hAT-Charlie	793	+	78	51640302	68482
chr3	51571820	51771820	harbor1	chr3	51658816	51659098	DNA/hAT-Charlie	1108	+	141	51658957	87137
chr3	51571820	51771820	harbor1	chr3	51659405	51659446	DNA/hAT-Charlie	1108	+	20	51659425	87605
chr3	51571820	51771820	harbor1	chr3	51593074	51593296	DNA/hAT-Charlie	1015	+	111	51593185	21365
chr3	51571820	51771820	harbor1	chr3	51642288	51642518	DNA/hAT-Charlie	547	+	115	51642403	70583
chr3	113849062	114049062	harbor1	chr3	113873387	113873512	DNA/hAT-Charlie	749	+	62	113873449	24387
chr3	113849062	114049062	harbor1	chr3	113873819	113873877	DNA/hAT-Charlie	749	+	29	113873848	24786
chr3	113849062	114049062	harbor1	chr3	113892882	113893190	DNA/hAT-Charlie	1956	+	154	113893036	43974
chr3	113849062	114049062	harbor1	chr3	113936892	113937068	DNA/hAT-Charlie	412	+	88	113936980	87918
chr3	21855680	22055680	harbor1	chr3	21866900	21866963	DNA/hAT-Charlie	602	+	32	21866932	11252
chr3	21855680	22055680	harbor1	chr3	21867347	21867429	DNA/hAT-Charlie	602	+	41	21867388	11708
chr3	21855680	22055680	harbor1	chr3	21867796	21867976	DNA/hAT-Charlie	764	+	90	21867886	12206
chr3	21855680	22055680	harbor1	chr3	21875822	21876060	DNA/hAT-Charlie	472	+	119	21875941	20261
chr3	21855680	22055680	harbor1	chr3	21880166	21880229	DNA/hAT-Charlie	589	+	32	21880198	24518
chr3	21855680	22055680	harbor1	chr3	21882599	21882694	DNA/hAT-Charlie	589	+	48	21882647	26967
chr3	21855680	22055680	harbor1	chr3	21884869	21885091	DNA/hAT-Charlie	646	+	111	21884980	29300
chr3	21855680	22055680	harbor1	chr3	21899040	21899268	DNA/hAT-Charlie	957	+	114	21899154	43474
chr3	21855680	22055680	harbor1	chr3	21920020	21920206	DNA/hAT-Charlie	561	+	93	21920113	64433
chr3	19954840	20154840	harbor1	chr3	19955349	19955509	DNA/hAT-Charlie	483	+	80	19955429	589
chr3	19954840	20154840	harbor1	chr3	20046794	20047016	DNA/hAT-Charlie	1177	+	111	20046905	92065
chr3	52946732	53146732	harbor1	chr3	53036259	53036385	DNA/hAT-Charlie	439	+	63	53036322	89590
chr3	47725179	47925179	harbor1	chr3	47756625	47756828	DNA/hAT-Charlie	661	+	102	47756727	31548
chr3	47725179	47925179	harbor1	chr3	47758545	47758691	DNA/hAT-Charlie	469	+	73	47758618	33439
chr3	197857923	198057923	harbor1	chr3	197859287	197859491	DNA/hAT-Charlie	744	+	102	197859389	1466
chr3	197857923	198057923	harbor1	chr3	197874139	197874677	DNA/hAT-Charlie	3833	+	269	197874408	16485
chr3	197857923	198057923	harbor1	chr3	197874787	197874923	DNA/hAT-Charlie	796	+	68	197874855	16932
chr3	197857923	198057923	harbor1	chr3	197875229	197875301	DNA/hAT-Charlie	796	+	36	197875265	17342
chr3	197857923	198057923	harbor1	chr3	197895176	197895266	DNA/hAT-Charlie	514	+	45	197895221	37298
chr3	197857923	198057923	harbor1	chr3	197895566	197895690	DNA/hAT-Charlie	514	+	62	197895628	37705
chr3	197857923	198057923	harbor1	chr3	197895994	197896020	DNA/hAT-Charlie	514	+	13	197896007	38084
chr3	58016450	58216450	harbor1	chr3	58045361	58045582	DNA/hAT-Charlie	1546	+	110	58045471	29021
chr3	58016450	58216450	harbor1	chr3	58054801	58054984	DNA/hAT-Charlie	1045	+	92	58054893	38443
chr3	58016450	58216450	harbor1	chr3	58055280	58055318	DNA/hAT-Charlie	1045	+	19	58055299	38849
chr3	58016450	58216450	harbor1	chr3	58074164	58074329	DNA/hAT-Charlie	871	+	82	58074246	57796
chr3	30507293	30707293	harbor1	chr3	30543806	30544017	DNA/hAT-Charlie	903	+	106	30543912	36619
chr3	30507293	30707293	harbor1	chr3	30545090	30545282	DNA/hAT-Charlie	889	+	96	30545186	37893
chr3	30507293	30707293	harbor1	chr3	30565471	30565792	DNA/hAT-Charlie	463	+	160	30565631	58338
chr3	30507293	30707293	harbor1	chr3	30582422	30582724	DNA/hAT-Charlie	1023	+	151	30582573	75280
chr3	30507293	30707293	harbor1	chr3	30582963	30583277	DNA/hAT-Charlie	718	+	157	30583120	75827
chr3	30507293	30707293	harbor1	chr3	30605917	30606037	DNA/hAT-Charlie	631	+	60	30605977	98684
chr3	23710887	23910887	harbor1	chr3	23731814	23731989	DNA/hAT-Charlie	942	+	88	23731902	21015
chr3	23710887	23910887	harbor1	chr3	23732297	23732339	DNA/hAT-Charlie	942	+	21	23732318	21431
chr3	23710887	23910887	harbor1	chr3	23751806	23752117	DNA/hAT-Charlie	874	+	156	23751962	41075
chr3	53395675	53595675	harbor1	chr3	53451180	53451401	DNA/hAT-Charlie	1520	+	110	53451290	55615
chr3	53395675	53595675	harbor1	chr3	53480796	53480872	DNA/hAT-Charlie	680	+	38	53480834	85159
chr3	53395675	53595675	harbor1	chr3	53481499	53481596	DNA/hAT-Charlie	680	+	48	53481547	85872
chr3	53395675	53595675	harbor1	chr3	53487924	53489142	DNA/hAT-Charlie	6274	+	609	53488533	92858
chr3	182580289	182780289	harbor1	chr3	182656676	182656846	DNA/hAT-Charlie	446	+	85	182656761	76472
chr3	182580289	182780289	harbor1	chr3	182658493	182658737	DNA/hAT-Charlie	496	+	122	182658615	78326
chr3	182580289	182780289	harbor1	chr3	182659040	182659151	DNA/hAT-Charlie	496	+	56	182659096	78807
chr3	182580289	182780289	harbor1	chr3	182663221	182663361	DNA/hAT-Charlie	473	+	70	182663291	83002
chr3	107991294	108191294	harbor1	chr3	108027029	108027151	DNA/hAT-Charlie	470	+	61	108027090	35796
chr3	159480531	159680531	harbor1	chr3	159480766	159480791	DNA/hAT-Charlie	754	+	12	159480778	247
chr3	159480531	159680531	harbor1	chr3	159481163	159481300	DNA/hAT-Charlie	754	+	68	159481231	700
chr3	159480531	159680531	harbor1	chr3	159517216	159517928	DNA/hAT-Charlie	1131	+	356	159517572	37041
chr3	159480531	159680531	harbor1	chr3	159521396	159521613	DNA/hAT-Charlie	772	+	108	159521504	40973
chr3	159480531	159680531	harbor1	chr3	159578190	159578494	DNA/hAT-Charlie	1029	+	152	159578342	97811
chr3	156989217	157189217	harbor1	chr3	157051065	157051153	DNA/hAT-Charlie	413	+	44	157051109	61892
chr3	156989217	157189217	harbor1	chr3	157068079	157068307	DNA/hAT-Charlie	993	+	114	157068193	78976
chr3	156989217	157189217	harbor1	chr3	157078248	157078443	DNA/hAT-Charlie	763	+	98	157078346	89129
chr3	123544615	123744615	harbor1	chr3	123557104	123557387	DNA/hAT-Charlie	1933	+	142	123557246	12631
chr3	123544615	123744615	harbor1	chr3	123610161	123610289	DNA/hAT-Charlie	713	+	64	123610225	65610
chr3	46799778	46999778	harbor1	chr3	46811515	46811610	DNA/hAT-Charlie	429	+	48	46811563	11785
chr3	46799778	46999778	harbor1	chr3	46817241	46818336	DNA/hAT-Charlie	4866	+	548	46817789	18011
chr3	48890290	49090290	harbor1	chr3	48919544	48919739	DNA/hAT-Charlie	1014	+	98	48919642	29352
chr3	48890290	49090290	harbor1	chr3	48950630	48950839	DNA/hAT-Charlie	839	+	104	48950734	60444
chr3	51281519	51481519	harbor1	chr3	51331511	51331676	DNA/hAT-Charlie	613	+	82	51331593	50074
chr3	51281519	51481519	harbor1	chr3	51331809	51331940	DNA/hAT-Charlie	613	+	66	51331875	50356
chr3	107991304	108191304	harbor1	chr3	108027029	108027151	DNA/hAT-Charlie	470	+	61	108027090	35786
chr3	38066121	38266121	harbor1	chr3	38150626	38150778	DNA/hAT-Charlie	569	+	76	38150702	84581
chr3	129021082	129221082	harbor1	chr3	129021003	129021430	DNA/hAT-Charlie	1179	+	214	129021217	135
chr3	129021082	129221082	harbor1	chr3	129021764	129021998	DNA/hAT-Charlie	525	+	117	129021881	799
chr3	129021082	129221082	harbor1	chr3	129022929	129023080	DNA/hAT-Charlie	462	+	76	129023005	1923
chr3	129021082	129221082	harbor1	chr3	129067150	129067474	DNA/hAT-Charlie	911	+	162	129067312	46230
chr3	129021082	129221082	harbor1	chr3	129068911	129069105	DNA/hAT-Charlie	567	+	97	129069008	47926
chr3	129021082	129221082	harbor1	chr3	129094065	129094232	DNA/hAT-Charlie	711	+	84	129094149	73067
chr3	47725235	47925235	harbor1	chr3	47756625	47756828	DNA/hAT-Charlie	661	+	102	47756727	31492
chr3	47725235	47925235	harbor1	chr3	47758545	47758691	DNA/hAT-Charlie	469	+	73	47758618	33383
chr3	49623710	49823710	harbor1	chr3	49690214	49690408	DNA/hAT-Charlie	1036	+	97	49690311	66601
chr3	12827739	13027739	harbor1	chr3	12830971	12831182	DNA/hAT-Charlie	435	+	106	12831077	3338
chr3	12827739	13027739	harbor1	chr3	12906946	12907156	DNA/hAT-Charlie	1091	+	105	12907051	79312
chr3	12827739	13027739	harbor1	chr3	12919891	12920119	DNA/hAT-Charlie	459	+	114	12920005	92266
chr3	12827739	13027739	harbor1	chr3	12927176	12927325	DNA/hAT-Charlie	563	+	74	12927250	99511
chr3	195982427	196182427	harbor1	chr3	196064740	196064876	DNA/hAT-Charlie	415	+	68	196064808	82381
chr3	107991392	108191392	harbor1	chr3	108027029	108027151	DNA/hAT-Charlie	470	+	61	108027090	35698
chr3	128328747	128528747	harbor1	chr3	128348370	128348786	DNA/hAT-Charlie	743	+	208	128348578	19831
chr3	128328747	128528747	harbor1	chr3	128426853	128427098	DNA/hAT-Charlie	642	+	122	128426975	98228
chr3	126256502	126456502	harbor1	chr3	126269394	126269570	DNA/hAT-Charlie	601	+	88	126269482	12980
chr3	126256502	126456502	harbor1	chr3	126269884	126270019	DNA/hAT-Charlie	447	+	68	126269952	13450
chr3	126256502	126456502	harbor1	chr3	126307649	126307842	DNA/hAT-Charlie	454	+	96	126307745	51243
chr3	126256502	126456502	harbor1	chr3	126313911	126314103	DNA/hAT-Charlie	890	+	96	126314007	57505
chr3	126256502	126456502	harbor1	chr3	126315982	126316167	DNA/hAT-Charlie	705	+	92	126316074	59572
chr3	128328796	128528796	harbor1	chr3	128348370	128348786	DNA/hAT-Charlie	743	+	208	128348578	19782
chr3	128328796	128528796	harbor1	chr3	128426853	128427098	DNA/hAT-Charlie	642	+	122	128426975	98179
chr3	51571305	51771305	harbor1	chr3	51613850	51614062	DNA/hAT-Charlie	1088	+	106	51613956	42651
chr3	51571305	51771305	harbor1	chr3	51640224	51640381	DNA/hAT-Charlie	793	+	78	51640302	68997
chr3	51571305	51771305	harbor1	chr3	51658816	51659098	DNA/hAT-Charlie	1108	+	141	51658957	87652
chr3	51571305	51771305	harbor1	chr3	51659405	51659446	DNA/hAT-Charlie	1108	+	20	51659425	88120
chr3	51571305	51771305	harbor1	chr3	51593074	51593296	DNA/hAT-Charlie	1015	+	111	51593185	21880
chr3	51571305	51771305	harbor1	chr3	51642288	51642518	DNA/hAT-Charlie	547	+	115	51642403	71098
chr3	138334857	138534857	harbor1	chr3	138353094	138353372	DNA/hAT-Charlie	439	+	139	138353233	18376
chr3	138334857	138534857	harbor1	chr3	138373304	138373443	DNA/hAT-Charlie	539	+	70	138373374	38517
chr3	138334857	138534857	harbor1	chr3	138373515	138373659	DNA/hAT-Charlie	566	+	72	138373587	38730
chr3	138334857	138534857	harbor1	chr3	138408752	138408869	DNA/hAT-Charlie	543	+	58	138408810	73953
chr3	138334857	138534857	harbor1	chr3	138409534	138409716	DNA/hAT-Charlie	996	+	91	138409625	74768
chr3	138334857	138534857	harbor1	chr3	138410440	138410565	DNA/hAT-Charlie	461	+	62	138410502	75645
chr3	138334857	138534857	harbor1	chr3	138418417	138418596	DNA/hAT-Charlie	655	+	90	138418507	83650
chr3	138334857	138534857	harbor1	chr3	138433249	138433389	DNA/hAT-Charlie	525	+	70	138433319	98462
chr3	42482018	42682018	harbor1	chr3	42535483	42535679	DNA/hAT-Charlie	631	+	98	42535581	53563
chr3	42482018	42682018	harbor1	chr3	42557978	42558196	DNA/hAT-Charlie	1260	+	109	42558087	76069
chr3	127581163	127781163	harbor1	chr3	127612019	127612220	DNA/hAT-Charlie	447	+	100	127612119	30956
chr3	127581163	127781163	harbor1	chr3	127635600	127635772	DNA/hAT-Charlie	757	+	86	127635686	54523
chr4	2656082	2856082	harbor1	chr4	2707398	2707706	DNA/hAT-Charlie	1377	+	154	2707552	51470
chr4	2656082	2856082	harbor1	chr4	2708050	2708078	DNA/hAT-Charlie	1377	+	14	2708064	51982
chr4	694465	894465	harbor1	chr4	740949	741394	DNA/hAT-Charlie	1006	+	222	741171	46706
chr4	6810048	7010048	harbor1	chr4	6812235	6812399	DNA/hAT-Charlie	785	+	82	6812317	2269
chr4	6810048	7010048	harbor1	chr4	6841070	6841578	DNA/hAT-Charlie	2192	+	254	6841324	31276
chr4	6810048	7010048	harbor1	chr4	6846303	6846622	DNA/hAT-Charlie	1906	+	160	6846463	36415
chr4	6810048	7010048	harbor1	chr4	6859375	6859678	DNA/hAT-Charlie	1164	+	152	6859527	49479
chr4	145080529	145280529	harbor1	chr4	145080369	145080555	DNA/hAT-Charlie	617	+	93	145080462	67
chr4	145080529	145280529	harbor1	chr4	145083559	145083794	DNA/hAT-Charlie	563	+	118	145083677	3148
chr4	145080529	145280529	harbor1	chr4	145084708	145084982	DNA/hAT-Charlie	1046	+	137	145084845	4316
chr4	145080529	145280529	harbor1	chr4	145086435	145086604	DNA/hAT-Charlie	631	+	84	145086519	5990
chr4	145080529	145280529	harbor1	chr4	145161603	145161781	DNA/hAT-Charlie	858	+	89	145161692	81163
chr4	551216	751216	harbor1	chr4	606019	606267	DNA/hAT-Charlie	1413	+	124	606143	54927
chr4	25761117	25961117	harbor1	chr4	25815777	25816000	DNA/hAT-Charlie	970	+	112	25815889	54772
chr4	25761117	25961117	harbor1	chr4	25853430	25853664	DNA/hAT-Charlie	1326	+	117	25853547	92430
chr4	25761117	25961117	harbor1	chr4	25853972	25854066	DNA/hAT-Charlie	1326	+	47	25854019	92902
chr4	150914523	151114523	harbor1	chr4	150986281	150986442	DNA/hAT-Charlie	774	+	80	150986361	71838
chr4	145080526	145280526	harbor1	chr4	145080369	145080555	DNA/hAT-Charlie	617	+	93	145080462	64
chr4	145080526	145280526	harbor1	chr4	145083559	145083794	DNA/hAT-Charlie	563	+	118	145083677	3151
chr4	145080526	145280526	harbor1	chr4	145084708	145084982	DNA/hAT-Charlie	1046	+	137	145084845	4319
chr4	145080526	145280526	harbor1	chr4	145086435	145086604	DNA/hAT-Charlie	631	+	84	145086519	5993
chr4	145080526	145280526	harbor1	chr4	145161603	145161781	DNA/hAT-Charlie	858	+	89	145161692	81166
chr4	726100	926100	harbor1	chr4	740949	741394	DNA/hAT-Charlie	1006	+	222	741171	15071
chr4	70739795	70939795	harbor1	chr4	70759802	70760020	DNA/hAT-Charlie	601	+	109	70759911	20116
chr4	159002387	159202387	harbor1	chr4	159005547	159005773	DNA/hAT-Charlie	1334	+	113	159005660	3273
chr4	159002387	159202387	harbor1	chr4	159006064	159006145	DNA/hAT-Charlie	1334	+	40	159006104	3717
chr4	159002387	159202387	harbor1	chr4	159009233	159009416	DNA/hAT-Charlie	972	+	92	159009325	6938
chr4	159002387	159202387	harbor1	chr4	159025103	159025189	DNA/hAT-Charlie	742	+	43	159025146	22759
chr4	159002387	159202387	harbor1	chr4	159025461	159025529	DNA/hAT-Charlie	742	+	34	159025495	23108
chr4	159002718	159202718	harbor1	chr4	159005547	159005773	DNA/hAT-Charlie	1334	+	113	159005660	2942
chr4	159002718	159202718	harbor1	chr4	159006064	159006145	DNA/hAT-Charlie	1334	+	40	159006104	3386
chr4	159002718	159202718	harbor1	chr4	159009233	159009416	DNA/hAT-Charlie	972	+	92	159009325	6607
chr4	159002718	159202718	harbor1	chr4	159025103	159025189	DNA/hAT-Charlie	742	+	43	159025146	22428
chr4	159002718	159202718	harbor1	chr4	159025461	159025529	DNA/hAT-Charlie	742	+	34	159025495	22777
chr4	139456023	139656023	harbor1	chr4	139457677	139457827	DNA/hAT-Charlie	603	+	75	139457752	1729
chr4	139456023	139656023	harbor1	chr4	139485915	139486470	DNA/hAT-Charlie	1456	+	278	139486193	30170
chr4	139456023	139656023	harbor1	chr4	139486768	139487017	DNA/hAT-Charlie	1456	+	124	139486892	30869
chr4	139456023	139656023	harbor1	chr4	139494561	139494876	DNA/hAT-Charlie	594	+	158	139494719	38696
chr4	139456023	139656023	harbor1	chr4	139511964	139512115	DNA/hAT-Charlie	756	+	76	139512040	56017
chr4	139456023	139656023	harbor1	chr4	139520904	139521125	DNA/hAT-Charlie	1377	+	110	139521014	64991
chr4	139456023	139656023	harbor1	chr4	139535980	139536178	DNA/hAT-Charlie	907	+	99	139536079	80056
chr4	1661985	1861985	harbor1	chr4	1736455	1736626	DNA/hAT-Charlie	672	+	86	1736541	74556
chr4	3263597	3463597	harbor1	chr4	3322678	3322882	DNA/hAT-Charlie	715	+	102	3322780	59183
chr4	39598067	39798067	harbor1	chr4	39625935	39626288	DNA/hAT-Charlie	1830	+	176	39626111	28044
chr4	2826505	3026505	harbor1	chr4	2838544	2838749	DNA/hAT-Charlie	1268	+	102	2838646	12141
chr4	2826505	3026505	harbor1	chr4	2861839	2862035	DNA/hAT-Charlie	1406	+	98	2861937	35432
chr4	2826505	3026505	harbor1	chr4	2874791	2874944	DNA/hAT-Charlie	740	+	76	2874867	48362
chr4	6922283	7122283	harbor1	chr4	6971642	6971825	DNA/hAT-Charlie	864	+	92	6971734	49451
chr4	145080585	145280585	harbor1	chr4	145083559	145083794	DNA/hAT-Charlie	563	+	118	145083677	3092
chr4	145080585	145280585	harbor1	chr4	145084708	145084982	DNA/hAT-Charlie	1046	+	137	145084845	4260
chr4	145080585	145280585	harbor1	chr4	145086435	145086604	DNA/hAT-Charlie	631	+	84	145086519	5934
chr4	145080585	145280585	harbor1	chr4	145161603	145161781	DNA/hAT-Charlie	858	+	89	145161692	81107
chr4	158917337	159117337	harbor1	chr4	159005547	159005773	DNA/hAT-Charlie	1334	+	113	159005660	88323
chr4	158917337	159117337	harbor1	chr4	159006064	159006145	DNA/hAT-Charlie	1334	+	40	159006104	88767
chr4	158917337	159117337	harbor1	chr4	159009233	159009416	DNA/hAT-Charlie	972	+	92	159009325	91988
chr4	9441130	9641130	harbor1	chr4	9540079	9540274	DNA/hAT-Charlie	1015	+	98	9540177	99047
chr4	1107423	1307423	harbor1	chr4	1114464	1114640	DNA/hAT-Charlie	532	+	88	1114552	7129
chr4	551200	751200	harbor1	chr4	606019	606267	DNA/hAT-Charlie	1413	+	124	606143	54943
chr4	150608140	150808140	harbor1	chr4	150630688	150630960	DNA/hAT-Charlie	732	+	136	150630824	22684
chr4	150608140	150808140	harbor1	chr4	150640172	150640608	DNA/hAT-Charlie	711	+	218	150640390	32250
chr4	150608140	150808140	harbor1	chr4	150643743	150646109	DNA/hAT-Charlie	9807	+	1183	150644926	36786
chr4	150608140	150808140	harbor1	chr4	150672117	150672291	DNA/hAT-Charlie	605	+	87	150672204	64064
chr4	150608140	150808140	harbor1	chr4	150684380	150684514	DNA/hAT-Charlie	536	+	67	150684447	76307
chr4	52497288	52697288	harbor1	chr4	52510814	52511034	DNA/hAT-Charlie	1708	+	110	52510924	13636
chr4	52497288	52697288	harbor1	chr4	52583327	52583548	DNA/hAT-Charlie	647	+	110	52583437	86149
chr4	52497288	52697288	harbor1	chr4	52583551	52583822	DNA/hAT-Charlie	653	+	136	52583687	86399
chr4	76113424	76313424	harbor1	chr4	76137737	76138022	DNA/hAT-Charlie	851	+	142	76137879	24455
chr4	76113424	76313424	harbor1	chr4	76149985	76150205	DNA/hAT-Charlie	1449	+	110	76150095	36671
chr4	76113424	76313424	harbor1	chr4	76151028	76151249	DNA/hAT-Charlie	689	+	110	76151138	37714
chr4	76113424	76313424	harbor1	chr4	76155791	76155978	DNA/hAT-Charlie	695	+	94	76155885	42461
chr4	76113424	76313424	harbor1	chr4	76182240	76182540	DNA/hAT-Charlie	1338	+	150	76182390	68966
chr4	76113424	76313424	harbor1	chr4	76190841	76191033	DNA/hAT-Charlie	1130	+	96	76190937	77513
chr4	76113424	76313424	harbor1	chr4	76207058	76207267	DNA/hAT-Charlie	1002	+	104	76207162	93738
chr4	2826521	3026521	harbor1	chr4	2838544	2838749	DNA/hAT-Charlie	1268	+	102	2838646	12125
chr4	2826521	3026521	harbor1	chr4	2861839	2862035	DNA/hAT-Charlie	1406	+	98	2861937	35416
chr4	2826521	3026521	harbor1	chr4	2874791	2874944	DNA/hAT-Charlie	740	+	76	2874867	48346
chr4	2832662	3032662	harbor1	chr4	2838544	2838749	DNA/hAT-Charlie	1268	+	102	2838646	5984
chr4	2832662	3032662	harbor1	chr4	2861839	2862035	DNA/hAT-Charlie	1406	+	98	2861937	29275
chr4	2832662	3032662	harbor1	chr4	2874791	2874944	DNA/hAT-Charlie	740	+	76	2874867	42205
chr4	8767896	8967896	harbor1	chr4	8848028	8848391	DNA/hAT-Charlie	1389	+	182	8848210	80314
chr4	143414065	143614065	harbor1	chr4	143420685	143420844	DNA/hAT-Charlie	549	+	80	143420765	6700
chr4	143414065	143614065	harbor1	chr4	143459563	143459767	DNA/hAT-Charlie	820	+	102	143459665	45600
chr4	143414065	143614065	harbor1	chr4	143459764	143459902	DNA/hAT-Charlie	661	+	69	143459833	45768
chr4	148339554	148539554	harbor1	chr4	148346569	148346866	DNA/hAT-Charlie	1042	+	148	148346717	7163
chr4	55295888	55495888	harbor1	chr4	55321980	55322270	DNA/hAT-Charlie	1159	+	145	55322125	26237
chr4	55295888	55495888	harbor1	chr4	55322279	55322439	DNA/hAT-Charlie	743	+	80	55322359	26471
chr4	55295888	55495888	harbor1	chr4	55349811	55350087	DNA/hAT-Charlie	1308	+	138	55349949	54061
chr4	55295888	55495888	harbor1	chr4	55350383	55350484	DNA/hAT-Charlie	1308	+	50	55350433	54545
chr4	55295888	55495888	harbor1	chr4	55357993	55358247	DNA/hAT-Charlie	1191	+	127	55358120	62232
chr4	55295888	55495888	harbor1	chr4	55358564	55358825	DNA/hAT-Charlie	1191	+	130	55358694	62806
chr4	55295888	55495888	harbor1	chr4	55385689	55385773	DNA/hAT-Charlie	706	+	42	55385731	89843
chr4	55295888	55495888	harbor1	chr4	55386584	55386756	DNA/hAT-Charlie	706	+	86	55386670	90782
chr4	25762833	25962833	harbor1	chr4	25815777	25816000	DNA/hAT-Charlie	970	+	112	25815889	53056
chr4	25762833	25962833	harbor1	chr4	25853430	25853664	DNA/hAT-Charlie	1326	+	117	25853547	90714
chr4	25762833	25962833	harbor1	chr4	25853972	25854066	DNA/hAT-Charlie	1326	+	47	25854019	91186
chr4	70739714	70939714	harbor1	chr4	70759802	70760020	DNA/hAT-Charlie	601	+	109	70759911	20197
chr4	70588818	70788818	harbor1	chr4	70652359	70652514	DNA/hAT-Charlie	618	+	78	70652437	63619
chr4	70588818	70788818	harbor1	chr4	70683433	70683542	DNA/hAT-Charlie	1291	+	54	70683487	94669
chr4	70588818	70788818	harbor1	chr4	70683843	70683934	DNA/hAT-Charlie	1291	+	46	70683889	95071
chr4	551205	751205	harbor1	chr4	606019	606267	DNA/hAT-Charlie	1413	+	124	606143	54938
chr4	153364398	153564398	harbor1	chr4	153389882	153390070	DNA/hAT-Charlie	779	+	94	153389976	25578
chr4	153364398	153564398	harbor1	chr4	153421731	153421902	DNA/hAT-Charlie	610	+	86	153421817	57419
chr4	15581883	15781883	harbor1	chr4	15650075	15650253	DNA/hAT-Charlie	785	+	89	15650164	68281
chr4	15581883	15781883	harbor1	chr4	15667617	15667775	DNA/hAT-Charlie	1685	+	79	15667696	85813
chr4	15581883	15781883	harbor1	chr4	15668058	15669103	DNA/hAT-Charlie	1685	+	522	15668580	86697
chr4	15581883	15781883	harbor1	chr4	15669743	15670056	DNA/hAT-Charlie	1224	+	156	15669899	88016
chr4	15581883	15781883	harbor1	chr4	15674014	15674529	DNA/hAT-Charlie	985	+	258	15674272	92389
chr4	139076181	139276181	harbor1	chr4	139105903	139106071	DNA/hAT-Charlie	969	+	84	139105987	29806
chr4	139076181	139276181	harbor1	chr4	139106448	139106736	DNA/hAT-Charlie	1500	+	144	139106592	30411
chr4	139076181	139276181	harbor1	chr4	139107046	139107187	DNA/hAT-Charlie	1500	+	70	139107116	30935
chr4	55295797	55495797	harbor1	chr4	55321980	55322270	DNA/hAT-Charlie	1159	+	145	55322125	26328
chr4	55295797	55495797	harbor1	chr4	55322279	55322439	DNA/hAT-Charlie	743	+	80	55322359	26562
chr4	55295797	55495797	harbor1	chr4	55349811	55350087	DNA/hAT-Charlie	1308	+	138	55349949	54152
chr4	55295797	55495797	harbor1	chr4	55350383	55350484	DNA/hAT-Charlie	1308	+	50	55350433	54636
chr4	55295797	55495797	harbor1	chr4	55357993	55358247	DNA/hAT-Charlie	1191	+	127	55358120	62323
chr4	55295797	55495797	harbor1	chr4	55358564	55358825	DNA/hAT-Charlie	1191	+	130	55358694	62897
chr4	55295797	55495797	harbor1	chr4	55385689	55385773	DNA/hAT-Charlie	706	+	42	55385731	89934
chr4	55295797	55495797	harbor1	chr4	55386584	55386756	DNA/hAT-Charlie	706	+	86	55386670	90873
chr5	73351493	73551493	harbor1	chr5	73411255	73411378	DNA/hAT-Charlie	417	+	62	73411317	59824
chr5	73351493	73551493	harbor1	chr5	73426804	73426946	DNA/hAT-Charlie	659	+	71	73426875	75382
chr5	9549845	9749845	harbor1	chr5	9575911	9576666	DNA/hAT-Charlie	1295	+	378	9576289	26444
chr5	9549845	9749845	harbor1	chr5	9577859	9577959	DNA/hAT-Charlie	443	+	50	9577909	28064
chr5	9549845	9749845	harbor1	chr5	9600372	9600592	DNA/hAT-Charlie	1067	+	110	9600482	50637
chr5	9549845	9749845	harbor1	chr5	9618216	9618413	DNA/hAT-Charlie	899	+	98	9618314	68469
chr5	10661237	10861237	harbor1	chr5	10661299	10661381	DNA/hAT-Charlie	480	+	41	10661340	103
chr5	10661237	10861237	harbor1	chr5	10661837	10661860	DNA/hAT-Charlie	480	+	12	10661849	612
chr5	10661237	10861237	harbor1	chr5	10665546	10665891	DNA/hAT-Charlie	1803	+	172	10665718	4481
chr5	10661237	10861237	harbor1	chr5	10714140	10714504	DNA/hAT-Charlie	849	+	182	10714322	53085
chr5	10661237	10861237	harbor1	chr5	10726369	10726520	DNA/hAT-Charlie	614	+	76	10726445	65208
chr5	10661237	10861237	harbor1	chr5	10735140	10735479	DNA/hAT-Charlie	972	+	170	10735310	74073
chr5	10661237	10861237	harbor1	chr5	10735473	10735663	DNA/hAT-Charlie	475	+	95	10735568	74331
chr5	10661237	10861237	harbor1	chr5	10749598	10749751	DNA/hAT-Charlie	411	+	76	10749674	88437
chr5	9114326	9314326	harbor1	chr5	9149171	9149307	DNA/hAT-Charlie	525	+	68	9149239	34913
chr5	9114326	9314326	harbor1	chr5	9204716	9205066	DNA/hAT-Charlie	2150	+	175	9204891	90565
chr5	9114326	9314326	harbor1	chr5	9213579	9213796	DNA/hAT-Charlie	878	+	108	9213687	99361
chr5	10341920	10541920	harbor1	chr5	10349865	10350009	DNA/hAT-Charlie	509	+	72	10349937	8017
chr5	10341920	10541920	harbor1	chr5	10399199	10399399	DNA/hAT-Charlie	421	+	100	10399299	57379
chr5	10341920	10541920	harbor1	chr5	10405917	10406234	DNA/hAT-Charlie	1881	+	158	10406075	64155
chr5	150532654	150732654	harbor1	chr5	150541051	150541237	DNA/hAT-Charlie	935	+	93	150541144	8490
chr5	150532654	150732654	harbor1	chr5	150542543	150542681	DNA/hAT-Charlie	546	+	69	150542612	9958
chr5	150532654	150732654	harbor1	chr5	150547520	150547734	DNA/hAT-Charlie	626	+	107	150547627	14973
chr5	150532654	150732654	harbor1	chr5	150617680	150617961	DNA/hAT-Charlie	425	+	140	150617820	85166
chr5	150532654	150732654	harbor1	chr5	150632187	150632345	DNA/hAT-Charlie	780	+	79	150632266	99612
chr5	37007782	37207782	harbor1	chr5	37018024	37018219	DNA/hAT-Charlie	584	+	98	37018122	10340
chr5	37007782	37207782	harbor1	chr5	37032020	37032174	DNA/hAT-Charlie	760	+	77	37032097	24315
chr5	37007782	37207782	harbor1	chr5	37058077	37058236	DNA/hAT-Charlie	738	+	80	37058157	50375
chr5	37007782	37207782	harbor1	chr5	37063479	37063663	DNA/hAT-Charlie	850	+	92	37063571	55789
chr5	6633235	6833235	harbor1	chr5	6722844	6723013	DNA/hAT-Charlie	913	+	84	6722928	89693
chr5	10102676	10302676	harbor1	chr5	10121999	10122699	DNA/hAT-Charlie	1645	+	350	10122349	19673
chr5	10296849	10496849	harbor1	chr5	10349865	10350009	DNA/hAT-Charlie	509	+	72	10349937	53088
chr5	10661256	10861256	harbor1	chr5	10661299	10661381	DNA/hAT-Charlie	480	+	41	10661340	84
chr5	10661256	10861256	harbor1	chr5	10661837	10661860	DNA/hAT-Charlie	480	+	12	10661849	593
chr5	10661256	10861256	harbor1	chr5	10665546	10665891	DNA/hAT-Charlie	1803	+	172	10665718	4462
chr5	10661256	10861256	harbor1	chr5	10714140	10714504	DNA/hAT-Charlie	849	+	182	10714322	53066
chr5	10661256	10861256	harbor1	chr5	10726369	10726520	DNA/hAT-Charlie	614	+	76	10726445	65189
chr5	10661256	10861256	harbor1	chr5	10735140	10735479	DNA/hAT-Charlie	972	+	170	10735310	74054
chr5	10661256	10861256	harbor1	chr5	10735473	10735663	DNA/hAT-Charlie	475	+	95	10735568	74312
chr5	10661256	10861256	harbor1	chr5	10749598	10749751	DNA/hAT-Charlie	411	+	76	10749674	88418
chr5	40697590	40897590	harbor1	chr5	40756751	40756958	DNA/hAT-Charlie	2090	+	104	40756855	59265
chr5	40697590	40897590	harbor1	chr5	40757233	40757847	DNA/hAT-Charlie	2090	+	307	40757540	59950
chr5	10661135	10861135	harbor1	chr5	10661299	10661381	DNA/hAT-Charlie	480	+	41	10661340	205
chr5	10661135	10861135	harbor1	chr5	10661837	10661860	DNA/hAT-Charlie	480	+	12	10661849	714
chr5	10661135	10861135	harbor1	chr5	10665546	10665891	DNA/hAT-Charlie	1803	+	172	10665718	4583
chr5	10661135	10861135	harbor1	chr5	10714140	10714504	DNA/hAT-Charlie	849	+	182	10714322	53187
chr5	10661135	10861135	harbor1	chr5	10726369	10726520	DNA/hAT-Charlie	614	+	76	10726445	65310
chr5	10661135	10861135	harbor1	chr5	10735140	10735479	DNA/hAT-Charlie	972	+	170	10735310	74175
chr5	10661135	10861135	harbor1	chr5	10735473	10735663	DNA/hAT-Charlie	475	+	95	10735568	74433
chr5	10661135	10861135	harbor1	chr5	10749598	10749751	DNA/hAT-Charlie	411	+	76	10749674	88539
chr5	10184404	10384404	harbor1	chr5	10267291	10267475	DNA/hAT-Charlie	763	+	92	10267383	82979
chr5	10184404	10384404	harbor1	chr5	10267788	10267929	DNA/hAT-Charlie	706	+	70	10267858	83454
chr5	10184404	10384404	harbor1	chr5	10267953	10268066	DNA/hAT-Charlie	665	+	56	10268009	83605
chr5	10184404	10384404	harbor1	chr5	10276735	10277089	DNA/hAT-Charlie	2399	+	177	10276912	92508
chr5	10184404	10384404	harbor1	chr5	10277392	10277647	DNA/hAT-Charlie	2399	+	128	10277520	93116
chr5	135008188	135208188	harbor1	chr5	135105420	135105587	DNA/hAT-Charlie	738	+	84	135105504	97316
chr5	169913062	170113062	harbor1	chr5	169914539	169914837	DNA/hAT-Charlie	452	+	149	169914688	1626
chr5	169913062	170113062	harbor1	chr5	169929811	169929979	DNA/hAT-Charlie	487	+	84	169929895	16833
chr5	169913062	170113062	harbor1	chr5	169930290	169930327	DNA/hAT-Charlie	487	+	18	169930308	17246
chr5	169913062	170113062	harbor1	chr5	169937092	169937293	DNA/hAT-Charlie	813	+	100	169937192	24130
chr5	169913062	170113062	harbor1	chr5	169940271	169940368	DNA/hAT-Charlie	707	+	48	169940319	27257
chr5	169913062	170113062	harbor1	chr5	169940878	169940974	DNA/hAT-Charlie	707	+	48	169940926	27864
chr5	169913062	170113062	harbor1	chr5	169943378	169943653	DNA/hAT-Charlie	420	+	138	169943516	30454
chr5	169913062	170113062	harbor1	chr5	169943665	169943847	DNA/hAT-Charlie	981	+	91	169943756	30694
chr5	169913062	170113062	harbor1	chr5	169950863	169951227	DNA/hAT-Charlie	615	+	182	169951045	37983
chr5	169913062	170113062	harbor1	chr5	169984677	169984778	DNA/hAT-Charlie	511	+	50	169984727	71665
chr5	169913062	170113062	harbor1	chr5	169986258	169986389	DNA/hAT-Charlie	601	+	66	169986324	73262
chr5	109788598	109988598	harbor1	chr5	109791615	109791832	DNA/hAT-Charlie	701	+	108	109791723	3125
chr5	109788598	109988598	harbor1	chr5	109871942	109872110	DNA/hAT-Charlie	617	+	84	109872026	83428
chr5	109788598	109988598	harbor1	chr5	109872193	109872343	DNA/hAT-Charlie	653	+	75	109872268	83670
chr5	109788598	109988598	harbor1	chr5	109875452	109875551	DNA/hAT-Charlie	465	+	50	109875502	86904
chr5	109788598	109988598	harbor1	chr5	109879461	109879673	DNA/hAT-Charlie	837	+	106	109879567	90969
chr5	132128916	132328916	harbor1	chr5	132141723	132141999	DNA/hAT-Charlie	925	+	138	132141861	12945
chr5	132128916	132328916	harbor1	chr5	132142091	132142231	DNA/hAT-Charlie	655	+	70	132142161	13245
chr5	132128916	132328916	harbor1	chr5	132148046	132148155	DNA/hAT-Charlie	566	+	54	132148100	19184
chr5	132128916	132328916	harbor1	chr5	132175058	132175254	DNA/hAT-Charlie	903	+	98	132175156	46240
chr5	132128916	132328916	harbor1	chr5	132176498	132176838	DNA/hAT-Charlie	2153	+	170	132176668	47752
chr5	73351452	73551452	harbor1	chr5	73411255	73411378	DNA/hAT-Charlie	417	+	62	73411317	59865
chr5	73351452	73551452	harbor1	chr5	73426804	73426946	DNA/hAT-Charlie	659	+	71	73426875	75423
chr5	37740423	37940423	harbor1	chr5	37740926	37741124	DNA/hAT-Charlie	545	+	99	37741025	602
chr5	37740423	37940423	harbor1	chr5	37801931	37802091	DNA/hAT-Charlie	1009	+	80	37802011	61588
chr5	37740423	37940423	harbor1	chr5	37805214	37805279	DNA/hAT-Charlie	508	+	32	37805246	64823
chr5	37740423	37940423	harbor1	chr5	37807901	37808176	DNA/hAT-Charlie	524	+	138	37808039	67616
chr5	37740423	37940423	harbor1	chr5	37826633	37826921	DNA/hAT-Charlie	719	+	144	37826777	86354
chr5	37740423	37940423	harbor1	chr5	37827677	37827762	DNA/hAT-Charlie	444	+	42	37827719	87296
chr5	37740423	37940423	harbor1	chr5	37827851	37827975	DNA/hAT-Charlie	495	+	62	37827913	87490
chr5	37740423	37940423	harbor1	chr5	37832750	37832892	DNA/hAT-Charlie	851	+	71	37832821	92398
chr5	9749157	9949157	harbor1	chr5	9797156	9797347	DNA/hAT-Charlie	730	+	96	9797252	48095
chr5	9749157	9949157	harbor1	chr5	9800115	9800277	DNA/hAT-Charlie	767	+	81	9800196	51039
chr5	9749157	9949157	harbor1	chr5	9847878	9848067	DNA/hAT-Charlie	1179	+	94	9847972	98815
chr5	10341913	10541913	harbor1	chr5	10349865	10350009	DNA/hAT-Charlie	509	+	72	10349937	8024
chr5	10341913	10541913	harbor1	chr5	10399199	10399399	DNA/hAT-Charlie	421	+	100	10399299	57386
chr5	10341913	10541913	harbor1	chr5	10405917	10406234	DNA/hAT-Charlie	1881	+	158	10406075	64162
chr5	73350932	73550932	harbor1	chr5	73411255	73411378	DNA/hAT-Charlie	417	+	62	73411317	60385
chr5	73350932	73550932	harbor1	chr5	73426804	73426946	DNA/hAT-Charlie	659	+	71	73426875	75943
chr5	9879703	10079703	harbor1	chr5	9890968	9891108	DNA/hAT-Charlie	440	+	70	9891038	11335
chr5	9879703	10079703	harbor1	chr5	9891102	9891486	DNA/hAT-Charlie	1439	+	192	9891294	11591
chr5	9879703	10079703	harbor1	chr5	9938565	9938785	DNA/hAT-Charlie	1261	+	110	9938675	58972
chr5	10661236	10861236	harbor1	chr5	10661299	10661381	DNA/hAT-Charlie	480	+	41	10661340	104
chr5	10661236	10861236	harbor1	chr5	10661837	10661860	DNA/hAT-Charlie	480	+	12	10661849	613
chr5	10661236	10861236	harbor1	chr5	10665546	10665891	DNA/hAT-Charlie	1803	+	172	10665718	4482
chr5	10661236	10861236	harbor1	chr5	10714140	10714504	DNA/hAT-Charlie	849	+	182	10714322	53086
chr5	10661236	10861236	harbor1	chr5	10726369	10726520	DNA/hAT-Charlie	614	+	76	10726445	65209
chr5	10661236	10861236	harbor1	chr5	10735140	10735479	DNA/hAT-Charlie	972	+	170	10735310	74074
chr5	10661236	10861236	harbor1	chr5	10735473	10735663	DNA/hAT-Charlie	475	+	95	10735568	74332
chr5	10661236	10861236	harbor1	chr5	10749598	10749751	DNA/hAT-Charlie	411	+	76	10749674	88438
chr5	176525237	176725237	harbor1	chr5	176559803	176559898	DNA/hAT-Charlie	526	+	48	176559851	34614
chr5	176525237	176725237	harbor1	chr5	176566080	176566383	DNA/hAT-Charlie	592	+	152	176566232	40995
chr5	176525237	176725237	harbor1	chr5	176606359	176606631	DNA/hAT-Charlie	603	+	136	176606495	81258
chr5	79136023	79336023	harbor1	chr5	79144088	79144259	DNA/hAT-Charlie	653	+	86	79144174	8151
chr5	79136023	79336023	harbor1	chr5	79148964	79149303	DNA/hAT-Charlie	497	+	170	79149134	13111
chr5	79136023	79336023	harbor1	chr5	79149508	79149829	DNA/hAT-Charlie	1954	+	160	79149668	13645
chr5	79136023	79336023	harbor1	chr5	79150140	79150185	DNA/hAT-Charlie	1954	+	22	79150162	14139
chr5	79136023	79336023	harbor1	chr5	79150477	79150645	DNA/hAT-Charlie	1954	+	84	79150561	14538
chr5	79136023	79336023	harbor1	chr5	79150929	79151075	DNA/hAT-Charlie	1954	+	73	79151002	14979
chr5	79136023	79336023	harbor1	chr5	79157856	79158018	DNA/hAT-Charlie	838	+	81	79157937	21914
chr5	79136023	79336023	harbor1	chr5	79194041	79194218	DNA/hAT-Charlie	937	+	88	79194129	58106
chr5	79136023	79336023	harbor1	chr5	79194227	79194560	DNA/hAT-Charlie	2246	+	166	79194393	58370
chr5	135374498	135574498	harbor1	chr5	135403849	135404073	DNA/hAT-Charlie	1357	+	112	135403961	29463
chr5	135374498	135574498	harbor1	chr5	135404123	135404173	DNA/hAT-Charlie	1357	+	25	135404148	29650
chr5	135374498	135574498	harbor1	chr5	135404180	135404569	DNA/hAT-Charlie	2210	+	194	135404374	29876
chr5	135374498	135574498	harbor1	chr5	135463059	135463327	DNA/hAT-Charlie	589	+	134	135463193	88695
chr5	135374498	135574498	harbor1	chr5	135472492	135472844	DNA/hAT-Charlie	1386	+	176	135472668	98170
chr5	135008281	135208281	harbor1	chr5	135105420	135105587	DNA/hAT-Charlie	738	+	84	135105504	97223
chr5	135830655	136030655	harbor1	chr5	135845962	135846288	DNA/hAT-Charlie	2180	+	163	135846125	15470
chr5	135830655	136030655	harbor1	chr5	135867295	135868022	DNA/hAT-Charlie	1070	+	364	135867659	37004
chr5	135830655	136030655	harbor1	chr5	135899054	135899228	DNA/hAT-Charlie	580	+	87	135899141	68486
chr5	10341778	10541778	harbor1	chr5	10349865	10350009	DNA/hAT-Charlie	509	+	72	10349937	8159
chr5	10341778	10541778	harbor1	chr5	10399199	10399399	DNA/hAT-Charlie	421	+	100	10399299	57521
chr5	10341778	10541778	harbor1	chr5	10405917	10406234	DNA/hAT-Charlie	1881	+	158	10406075	64297
chr5	177199777	177399777	harbor1	chr5	177263363	177264028	DNA/hAT-Charlie	2600	+	332	177263695	63918
chr5	177199777	177399777	harbor1	chr5	177264230	177264516	DNA/hAT-Charlie	1112	+	143	177264373	64596
chr5	177199777	177399777	harbor1	chr5	177277176	177277498	DNA/hAT-Charlie	1290	+	161	177277337	77560
chr5	177199777	177399777	harbor1	chr5	177285105	177285219	DNA/hAT-Charlie	445	+	57	177285162	85385
chr5	71628508	71828508	harbor1	chr5	71664418	71664481	DNA/hAT-Charlie	752	+	32	71664450	35942
chr5	71628508	71828508	harbor1	chr5	71664797	71664922	DNA/hAT-Charlie	752	+	62	71664859	36351
chr5	71628508	71828508	harbor1	chr5	71706137	71706278	DNA/hAT-Charlie	441	+	70	71706207	77699
chr5	52700042	52900042	harbor1	chr5	52711938	52712105	DNA/hAT-Charlie	525	+	84	52712022	11980
chr5	52700042	52900042	harbor1	chr5	52724514	52724640	DNA/hAT-Charlie	600	+	63	52724577	24535
chr5	52700042	52900042	harbor1	chr5	52759915	52760115	DNA/hAT-Charlie	1002	+	100	52760015	59973
chr5	52700042	52900042	harbor1	chr5	52763227	52763402	DNA/hAT-Charlie	639	+	88	52763315	63273
chr5	52700042	52900042	harbor1	chr5	52763764	52763904	DNA/hAT-Charlie	639	+	70	52763834	63792
chr5	52700042	52900042	harbor1	chr5	52707301	52707478	DNA/hAT-Charlie	571	+	88	52707389	7347
chr5	135297931	135497931	harbor1	chr5	135325848	135326038	DNA/hAT-Charlie	897	+	95	135325943	28012
chr5	135297931	135497931	harbor1	chr5	135361201	135361405	DNA/hAT-Charlie	534	+	102	135361303	63372
chr5	135297931	135497931	harbor1	chr5	135361443	135361690	DNA/hAT-Charlie	766	+	124	135361567	63636
chr5	135297931	135497931	harbor1	chr5	135361785	135362223	DNA/hAT-Charlie	1496	+	219	135362004	64073
chr5	135297931	135497931	harbor1	chr5	135362390	135362944	DNA/hAT-Charlie	1654	+	277	135362667	64736
chr5	135297931	135497931	harbor1	chr5	135365144	135365263	DNA/hAT-Charlie	506	+	60	135365204	67273
chr5	73350824	73550824	harbor1	chr5	73411255	73411378	DNA/hAT-Charlie	417	+	62	73411317	60493
chr5	73350824	73550824	harbor1	chr5	73426804	73426946	DNA/hAT-Charlie	659	+	71	73426875	76051
chr5	10661301	10861301	harbor1	chr5	10661299	10661381	DNA/hAT-Charlie	480	+	41	10661340	39
chr5	10661301	10861301	harbor1	chr5	10661837	10661860	DNA/hAT-Charlie	480	+	12	10661849	548
chr5	10661301	10861301	harbor1	chr5	10665546	10665891	DNA/hAT-Charlie	1803	+	172	10665718	4417
chr5	10661301	10861301	harbor1	chr5	10714140	10714504	DNA/hAT-Charlie	849	+	182	10714322	53021
chr5	10661301	10861301	harbor1	chr5	10726369	10726520	DNA/hAT-Charlie	614	+	76	10726445	65144
chr5	10661301	10861301	harbor1	chr5	10735140	10735479	DNA/hAT-Charlie	972	+	170	10735310	74009
chr5	10661301	10861301	harbor1	chr5	10735473	10735663	DNA/hAT-Charlie	475	+	95	10735568	74267
chr5	10661301	10861301	harbor1	chr5	10749598	10749751	DNA/hAT-Charlie	411	+	76	10749674	88373
chr5	73336206	73536206	harbor1	chr5	73411255	73411378	DNA/hAT-Charlie	417	+	62	73411317	75111
chr5	73336206	73536206	harbor1	chr5	73426804	73426946	DNA/hAT-Charlie	659	+	71	73426875	90669
chr5	9111212	9311212	harbor1	chr5	9149171	9149307	DNA/hAT-Charlie	525	+	68	9149239	38027
chr5	9111212	9311212	harbor1	chr5	9204716	9205066	DNA/hAT-Charlie	2150	+	175	9204891	93679
chr5	79136006	79336006	harbor1	chr5	79144088	79144259	DNA/hAT-Charlie	653	+	86	79144174	8168
chr5	79136006	79336006	harbor1	chr5	79148964	79149303	DNA/hAT-Charlie	497	+	170	79149134	13128
chr5	79136006	79336006	harbor1	chr5	79149508	79149829	DNA/hAT-Charlie	1954	+	160	79149668	13662
chr5	79136006	79336006	harbor1	chr5	79150140	79150185	DNA/hAT-Charlie	1954	+	22	79150162	14156
chr5	79136006	79336006	harbor1	chr5	79150477	79150645	DNA/hAT-Charlie	1954	+	84	79150561	14555
chr5	79136006	79336006	harbor1	chr5	79150929	79151075	DNA/hAT-Charlie	1954	+	73	79151002	14996
chr5	79136006	79336006	harbor1	chr5	79157856	79158018	DNA/hAT-Charlie	838	+	81	79157937	21931
chr5	79136006	79336006	harbor1	chr5	79194041	79194218	DNA/hAT-Charlie	937	+	88	79194129	58123
chr5	79136006	79336006	harbor1	chr5	79194227	79194560	DNA/hAT-Charlie	2246	+	166	79194393	58387
chr5	73177858	73377858	harbor1	chr5	73184249	73184477	DNA/hAT-Charlie	816	+	114	73184363	6505
chr5	73177858	73377858	harbor1	chr5	73185215	73186457	DNA/hAT-Charlie	5731	+	621	73185836	7978
chr5	73177858	73377858	harbor1	chr5	73190388	73190563	DNA/hAT-Charlie	574	+	88	73190476	12618
chr5	73177858	73377858	harbor1	chr5	73194417	73194536	DNA/hAT-Charlie	607	+	60	73194477	16619
chr5	73177858	73377858	harbor1	chr5	73213421	73213592	DNA/hAT-Charlie	485	+	86	73213507	35649
chr5	73177858	73377858	harbor1	chr5	73273310	73273465	DNA/hAT-Charlie	780	+	78	73273388	95530
chr5	73177858	73377858	harbor1	chr5	73203694	73203851	DNA/hAT-Charlie	662	+	78	73203772	25914
chr5	10341929	10541929	harbor1	chr5	10349865	10350009	DNA/hAT-Charlie	509	+	72	10349937	8008
chr5	10341929	10541929	harbor1	chr5	10399199	10399399	DNA/hAT-Charlie	421	+	100	10399299	57370
chr5	10341929	10541929	harbor1	chr5	10405917	10406234	DNA/hAT-Charlie	1881	+	158	10406075	64146
chr5	4034239	4234239	harbor1	chr5	4098357	4098482	DNA/hAT-Charlie	518	+	62	4098419	64180
chr5	4034239	4234239	harbor1	chr5	4112681	4112854	DNA/hAT-Charlie	805	+	86	4112767	78528
chr5	4034239	4234239	harbor1	chr5	4112860	4112987	DNA/hAT-Charlie	601	+	64	4112924	78685
chr5	4034239	4234239	harbor1	chr5	4112377	4112411	DNA/hAT-Charlie	805	+	17	4112394	78155
chr5	10660380	10860380	harbor1	chr5	10661299	10661381	DNA/hAT-Charlie	480	+	41	10661340	960
chr5	10660380	10860380	harbor1	chr5	10661837	10661860	DNA/hAT-Charlie	480	+	12	10661849	1469
chr5	10660380	10860380	harbor1	chr5	10665546	10665891	DNA/hAT-Charlie	1803	+	172	10665718	5338
chr5	10660380	10860380	harbor1	chr5	10714140	10714504	DNA/hAT-Charlie	849	+	182	10714322	53942
chr5	10660380	10860380	harbor1	chr5	10726369	10726520	DNA/hAT-Charlie	614	+	76	10726445	66065
chr5	10660380	10860380	harbor1	chr5	10735140	10735479	DNA/hAT-Charlie	972	+	170	10735310	74930
chr5	10660380	10860380	harbor1	chr5	10735473	10735663	DNA/hAT-Charlie	475	+	95	10735568	75188
chr5	10660380	10860380	harbor1	chr5	10749598	10749751	DNA/hAT-Charlie	411	+	76	10749674	89294
chr5	139797116	139997116	harbor1	chr5	139837925	139838070	DNA/hAT-Charlie	507	+	72	139837997	40881
chr5	139797116	139997116	harbor1	chr5	139891840	139891908	DNA/hAT-Charlie	444	+	34	139891874	94758
chr5	73351484	73551484	harbor1	chr5	73411255	73411378	DNA/hAT-Charlie	417	+	62	73411317	59833
chr5	73351484	73551484	harbor1	chr5	73426804	73426946	DNA/hAT-Charlie	659	+	71	73426875	75391
chr5	9114356	9314356	harbor1	chr5	9149171	9149307	DNA/hAT-Charlie	525	+	68	9149239	34883
chr5	9114356	9314356	harbor1	chr5	9204716	9205066	DNA/hAT-Charlie	2150	+	175	9204891	90535
chr5	9114356	9314356	harbor1	chr5	9213579	9213796	DNA/hAT-Charlie	878	+	108	9213687	99331
chr5	1029386	1229386	harbor1	chr5	1039964	1040294	DNA/hAT-Charlie	2157	+	165	1040129	10743
chr5	9114296	9314296	harbor1	chr5	9149171	9149307	DNA/hAT-Charlie	525	+	68	9149239	34943
chr5	9114296	9314296	harbor1	chr5	9204716	9205066	DNA/hAT-Charlie	2150	+	175	9204891	90595
chr5	9114296	9314296	harbor1	chr5	9213579	9213796	DNA/hAT-Charlie	878	+	108	9213687	99391
chr5	132103968	132303968	harbor1	chr5	132111943	132112157	DNA/hAT-Charlie	1035	+	107	132112050	8082
chr5	132103968	132303968	harbor1	chr5	132141723	132141999	DNA/hAT-Charlie	925	+	138	132141861	37893
chr5	132103968	132303968	harbor1	chr5	132142091	132142231	DNA/hAT-Charlie	655	+	70	132142161	38193
chr5	132103968	132303968	harbor1	chr5	132148046	132148155	DNA/hAT-Charlie	566	+	54	132148100	44132
chr5	132103968	132303968	harbor1	chr5	132175058	132175254	DNA/hAT-Charlie	903	+	98	132175156	71188
chr5	132103968	132303968	harbor1	chr5	132176498	132176838	DNA/hAT-Charlie	2153	+	170	132176668	72700
chr5	150964914	151164914	harbor1	chr5	151036219	151036621	DNA/hAT-Charlie	1149	+	201	151036420	71506
chr5	150964914	151164914	harbor1	chr5	151039561	151039708	DNA/hAT-Charlie	463	+	74	151039635	74721
chr5	150964914	151164914	harbor1	chr5	151050208	151050631	DNA/hAT-Charlie	1341	+	212	151050420	85506
chr5	135980228	136180228	harbor1	chr5	135982188	135982302	DNA/hAT-Charlie	586	+	57	135982245	2017
chr5	135980228	136180228	harbor1	chr5	136010568	136010910	DNA/hAT-Charlie	1534	+	171	136010739	30511
chr5	135980228	136180228	harbor1	chr5	136016256	136016494	DNA/hAT-Charlie	538	+	119	136016375	36147
chr5	135980228	136180228	harbor1	chr5	136040309	136040621	DNA/hAT-Charlie	1934	+	156	136040465	60237
chr5	135980228	136180228	harbor1	chr5	136075319	136075488	DNA/hAT-Charlie	588	+	84	136075403	95175
chr5	73351560	73551560	harbor1	chr5	73411255	73411378	DNA/hAT-Charlie	417	+	62	73411317	59757
chr5	73351560	73551560	harbor1	chr5	73426804	73426946	DNA/hAT-Charlie	659	+	71	73426875	75315
chr5	10661235	10861235	harbor1	chr5	10661299	10661381	DNA/hAT-Charlie	480	+	41	10661340	105
chr5	10661235	10861235	harbor1	chr5	10661837	10661860	DNA/hAT-Charlie	480	+	12	10661849	614
chr5	10661235	10861235	harbor1	chr5	10665546	10665891	DNA/hAT-Charlie	1803	+	172	10665718	4483
chr5	10661235	10861235	harbor1	chr5	10714140	10714504	DNA/hAT-Charlie	849	+	182	10714322	53087
chr5	10661235	10861235	harbor1	chr5	10726369	10726520	DNA/hAT-Charlie	614	+	76	10726445	65210
chr5	10661235	10861235	harbor1	chr5	10735140	10735479	DNA/hAT-Charlie	972	+	170	10735310	74075
chr5	10661235	10861235	harbor1	chr5	10735473	10735663	DNA/hAT-Charlie	475	+	95	10735568	74333
chr5	10661235	10861235	harbor1	chr5	10749598	10749751	DNA/hAT-Charlie	411	+	76	10749674	88439
chr5	9114331	9314331	harbor1	chr5	9149171	9149307	DNA/hAT-Charlie	525	+	68	9149239	34908
chr5	9114331	9314331	harbor1	chr5	9204716	9205066	DNA/hAT-Charlie	2150	+	175	9204891	90560
chr5	9114331	9314331	harbor1	chr5	9213579	9213796	DNA/hAT-Charlie	878	+	108	9213687	99356
chr5	52699384	52899384	harbor1	chr5	52711938	52712105	DNA/hAT-Charlie	525	+	84	52712022	12638
chr5	52699384	52899384	harbor1	chr5	52724514	52724640	DNA/hAT-Charlie	600	+	63	52724577	25193
chr5	52699384	52899384	harbor1	chr5	52759915	52760115	DNA/hAT-Charlie	1002	+	100	52760015	60631
chr5	52699384	52899384	harbor1	chr5	52763227	52763402	DNA/hAT-Charlie	639	+	88	52763315	63931
chr5	52699384	52899384	harbor1	chr5	52763764	52763904	DNA/hAT-Charlie	639	+	70	52763834	64450
chr5	52699384	52899384	harbor1	chr5	52707301	52707478	DNA/hAT-Charlie	571	+	88	52707389	8005
chr5	9114252	9314252	harbor1	chr5	9149171	9149307	DNA/hAT-Charlie	525	+	68	9149239	34987
chr5	9114252	9314252	harbor1	chr5	9204716	9205066	DNA/hAT-Charlie	2150	+	175	9204891	90639
chr5	9114252	9314252	harbor1	chr5	9213579	9213796	DNA/hAT-Charlie	878	+	108	9213687	99435
chr5	9114320	9314320	harbor1	chr5	9149171	9149307	DNA/hAT-Charlie	525	+	68	9149239	34919
chr5	9114320	9314320	harbor1	chr5	9204716	9205066	DNA/hAT-Charlie	2150	+	175	9204891	90571
chr5	9114320	9314320	harbor1	chr5	9213579	9213796	DNA/hAT-Charlie	878	+	108	9213687	99367
chr5	93472721	93672721	harbor1	chr5	93509285	93509476	DNA/hAT-Charlie	708	+	96	93509381	36660
chr5	93472721	93672721	harbor1	chr5	93511623	93511961	DNA/hAT-Charlie	2167	+	169	93511792	39071
chr5	73351469	73551469	harbor1	chr5	73411255	73411378	DNA/hAT-Charlie	417	+	62	73411317	59848
chr5	73351469	73551469	harbor1	chr5	73426804	73426946	DNA/hAT-Charlie	659	+	71	73426875	75406
chr5	7622638	7822638	harbor1	chr5	7669524	7669677	DNA/hAT-Charlie	419	+	76	7669600	46962
chr5	7622638	7822638	harbor1	chr5	7672405	7672498	DNA/hAT-Charlie	547	+	46	7672451	49813
chr5	7622638	7822638	harbor1	chr5	7672689	7672902	DNA/hAT-Charlie	910	+	106	7672795	50157
chr5	7622638	7822638	harbor1	chr5	7680129	7680379	DNA/hAT-Charlie	645	+	125	7680254	57616
chr5	9057233	9257233	harbor1	chr5	9149171	9149307	DNA/hAT-Charlie	525	+	68	9149239	92006
chr5	9114329	9314329	harbor1	chr5	9149171	9149307	DNA/hAT-Charlie	525	+	68	9149239	34910
chr5	9114329	9314329	harbor1	chr5	9204716	9205066	DNA/hAT-Charlie	2150	+	175	9204891	90562
chr5	9114329	9314329	harbor1	chr5	9213579	9213796	DNA/hAT-Charlie	878	+	108	9213687	99358
chr5	10311688	10511688	harbor1	chr5	10349865	10350009	DNA/hAT-Charlie	509	+	72	10349937	38249
chr5	10311688	10511688	harbor1	chr5	10399199	10399399	DNA/hAT-Charlie	421	+	100	10399299	87611
chr5	10311688	10511688	harbor1	chr5	10405917	10406234	DNA/hAT-Charlie	1881	+	158	10406075	94387
chr5	74950541	75150541	harbor1	chr5	74966278	74966448	DNA/hAT-Charlie	586	+	85	74966363	15822
chr5	74950541	75150541	harbor1	chr5	75017957	75018105	DNA/hAT-Charlie	765	+	74	75018031	67490
chr5	74950541	75150541	harbor1	chr5	75022492	75022659	DNA/hAT-Charlie	660	+	84	75022576	72035
chr5	143206591	143406591	harbor1	chr5	143212713	143212789	DNA/hAT-Charlie	462	+	38	143212751	6160
chr5	143206591	143406591	harbor1	chr5	143212798	143212863	DNA/hAT-Charlie	545	+	32	143212830	6239
chr5	143206591	143406591	harbor1	chr5	143213161	143213249	DNA/hAT-Charlie	545	+	44	143213205	6614
chr5	143206591	143406591	harbor1	chr5	143218030	143218164	DNA/hAT-Charlie	673	+	67	143218097	11506
chr5	143206591	143406591	harbor1	chr5	143255316	143255688	DNA/hAT-Charlie	732	+	186	143255502	48911
chr5	143206591	143406591	harbor1	chr5	143255985	143256125	DNA/hAT-Charlie	732	+	70	143256055	49464
chr5	143206591	143406591	harbor1	chr5	143256204	143256433	DNA/hAT-Charlie	540	+	114	143256318	49727
chr5	143206591	143406591	harbor1	chr5	143283804	143283997	DNA/hAT-Charlie	432	+	96	143283900	77309
chr5	143206591	143406591	harbor1	chr5	143287851	143287999	DNA/hAT-Charlie	618	+	74	143287925	81334
chr5	143206591	143406591	harbor1	chr5	143290217	143290425	DNA/hAT-Charlie	1136	+	104	143290321	83730
chr5	73114177	73314177	harbor1	chr5	73145963	73146173	DNA/hAT-Charlie	845	+	105	73146068	31891
chr5	73114177	73314177	harbor1	chr5	73184249	73184477	DNA/hAT-Charlie	816	+	114	73184363	70186
chr5	73114177	73314177	harbor1	chr5	73185215	73186457	DNA/hAT-Charlie	5731	+	621	73185836	71659
chr5	73114177	73314177	harbor1	chr5	73190388	73190563	DNA/hAT-Charlie	574	+	88	73190476	76299
chr5	73114177	73314177	harbor1	chr5	73194417	73194536	DNA/hAT-Charlie	607	+	60	73194477	80300
chr5	73114177	73314177	harbor1	chr5	73213421	73213592	DNA/hAT-Charlie	485	+	86	73213507	99330
chr5	73114177	73314177	harbor1	chr5	73203694	73203851	DNA/hAT-Charlie	662	+	78	73203772	89595
chr5	10661175	10861175	harbor1	chr5	10661299	10661381	DNA/hAT-Charlie	480	+	41	10661340	165
chr5	10661175	10861175	harbor1	chr5	10661837	10661860	DNA/hAT-Charlie	480	+	12	10661849	674
chr5	10661175	10861175	harbor1	chr5	10665546	10665891	DNA/hAT-Charlie	1803	+	172	10665718	4543
chr5	10661175	10861175	harbor1	chr5	10714140	10714504	DNA/hAT-Charlie	849	+	182	10714322	53147
chr5	10661175	10861175	harbor1	chr5	10726369	10726520	DNA/hAT-Charlie	614	+	76	10726445	65270
chr5	10661175	10861175	harbor1	chr5	10735140	10735479	DNA/hAT-Charlie	972	+	170	10735310	74135
chr5	10661175	10861175	harbor1	chr5	10735473	10735663	DNA/hAT-Charlie	475	+	95	10735568	74393
chr5	10661175	10861175	harbor1	chr5	10749598	10749751	DNA/hAT-Charlie	411	+	76	10749674	88499
chr5	93221055	93421055	harbor1	chr5	93259926	93260101	DNA/hAT-Charlie	912	+	88	93260014	38959
chr5	93221055	93421055	harbor1	chr5	93291288	93291466	DNA/hAT-Charlie	888	+	89	93291377	70322
chr5	61231969	61431969	harbor1	chr5	61309512	61309709	DNA/hAT-Charlie	778	+	98	61309610	77641
chr5	61231969	61431969	harbor1	chr5	61326558	61326731	DNA/hAT-Charlie	457	+	86	61326644	94675
chr5	52700079	52900079	harbor1	chr5	52711938	52712105	DNA/hAT-Charlie	525	+	84	52712022	11943
chr5	52700079	52900079	harbor1	chr5	52724514	52724640	DNA/hAT-Charlie	600	+	63	52724577	24498
chr5	52700079	52900079	harbor1	chr5	52759915	52760115	DNA/hAT-Charlie	1002	+	100	52760015	59936
chr5	52700079	52900079	harbor1	chr5	52763227	52763402	DNA/hAT-Charlie	639	+	88	52763315	63236
chr5	52700079	52900079	harbor1	chr5	52763764	52763904	DNA/hAT-Charlie	639	+	70	52763834	63755
chr5	52700079	52900079	harbor1	chr5	52707301	52707478	DNA/hAT-Charlie	571	+	88	52707389	7310
chr5	4842506	5042506	harbor1	chr5	4907563	4907839	DNA/hAT-Charlie	1110	+	138	4907701	65195
chr5	150964913	151164913	harbor1	chr5	151036219	151036621	DNA/hAT-Charlie	1149	+	201	151036420	71507
chr5	150964913	151164913	harbor1	chr5	151039561	151039708	DNA/hAT-Charlie	463	+	74	151039635	74722
chr5	150964913	151164913	harbor1	chr5	151050208	151050631	DNA/hAT-Charlie	1341	+	212	151050420	85507
chr5	52699708	52899708	harbor1	chr5	52711938	52712105	DNA/hAT-Charlie	525	+	84	52712022	12314
chr5	52699708	52899708	harbor1	chr5	52724514	52724640	DNA/hAT-Charlie	600	+	63	52724577	24869
chr5	52699708	52899708	harbor1	chr5	52759915	52760115	DNA/hAT-Charlie	1002	+	100	52760015	60307
chr5	52699708	52899708	harbor1	chr5	52763227	52763402	DNA/hAT-Charlie	639	+	88	52763315	63607
chr5	52699708	52899708	harbor1	chr5	52763764	52763904	DNA/hAT-Charlie	639	+	70	52763834	64126
chr5	52699708	52899708	harbor1	chr5	52707301	52707478	DNA/hAT-Charlie	571	+	88	52707389	7681
chr5	10660536	10860536	harbor1	chr5	10661299	10661381	DNA/hAT-Charlie	480	+	41	10661340	804
chr5	10660536	10860536	harbor1	chr5	10661837	10661860	DNA/hAT-Charlie	480	+	12	10661849	1313
chr5	10660536	10860536	harbor1	chr5	10665546	10665891	DNA/hAT-Charlie	1803	+	172	10665718	5182
chr5	10660536	10860536	harbor1	chr5	10714140	10714504	DNA/hAT-Charlie	849	+	182	10714322	53786
chr5	10660536	10860536	harbor1	chr5	10726369	10726520	DNA/hAT-Charlie	614	+	76	10726445	65909
chr5	10660536	10860536	harbor1	chr5	10735140	10735479	DNA/hAT-Charlie	972	+	170	10735310	74774
chr5	10660536	10860536	harbor1	chr5	10735473	10735663	DNA/hAT-Charlie	475	+	95	10735568	75032
chr5	10660536	10860536	harbor1	chr5	10749598	10749751	DNA/hAT-Charlie	411	+	76	10749674	89138
chr5	10024023	10224023	harbor1	chr5	10121999	10122699	DNA/hAT-Charlie	1645	+	350	10122349	98326
chr5	170538258	170738258	harbor1	chr5	170567116	170567336	DNA/hAT-Charlie	578	+	110	170567226	28968
chr5	170538258	170738258	harbor1	chr5	170574989	170575364	DNA/hAT-Charlie	1207	+	188	170575177	36919
chr5	170538258	170738258	harbor1	chr5	170581404	170581596	DNA/hAT-Charlie	554	+	96	170581500	43242
chr5	170538258	170738258	harbor1	chr5	170584082	170584234	DNA/hAT-Charlie	585	+	76	170584158	45900
chr5	170538258	170738258	harbor1	chr5	170610075	170610236	DNA/hAT-Charlie	604	+	80	170610155	71897
chr5	170538258	170738258	harbor1	chr5	170573545	170573870	DNA/hAT-Charlie	1177	+	162	170573707	35449
chr5	64935093	65135093	harbor1	chr5	64948161	64948317	DNA/hAT-Charlie	528	+	78	64948239	13146
chr5	64935093	65135093	harbor1	chr5	64949970	64950220	DNA/hAT-Charlie	760	+	125	64950095	15002
chr5	64935093	65135093	harbor1	chr5	64982789	64983129	DNA/hAT-Charlie	2150	+	170	64982959	47866
chr5	64935093	65135093	harbor1	chr5	64996657	64996874	DNA/hAT-Charlie	683	+	108	64996765	61672
chr5	64935093	65135093	harbor1	chr5	65012855	65013004	DNA/hAT-Charlie	429	+	74	65012929	77836
chr5	132103911	132303911	harbor1	chr5	132111943	132112157	DNA/hAT-Charlie	1035	+	107	132112050	8139
chr5	132103911	132303911	harbor1	chr5	132141723	132141999	DNA/hAT-Charlie	925	+	138	132141861	37950
chr5	132103911	132303911	harbor1	chr5	132142091	132142231	DNA/hAT-Charlie	655	+	70	132142161	38250
chr5	132103911	132303911	harbor1	chr5	132148046	132148155	DNA/hAT-Charlie	566	+	54	132148100	44189
chr5	132103911	132303911	harbor1	chr5	132175058	132175254	DNA/hAT-Charlie	903	+	98	132175156	71245
chr5	132103911	132303911	harbor1	chr5	132176498	132176838	DNA/hAT-Charlie	2153	+	170	132176668	72757
chr5	79136012	79336012	harbor1	chr5	79144088	79144259	DNA/hAT-Charlie	653	+	86	79144174	8162
chr5	79136012	79336012	harbor1	chr5	79148964	79149303	DNA/hAT-Charlie	497	+	170	79149134	13122
chr5	79136012	79336012	harbor1	chr5	79149508	79149829	DNA/hAT-Charlie	1954	+	160	79149668	13656
chr5	79136012	79336012	harbor1	chr5	79150140	79150185	DNA/hAT-Charlie	1954	+	22	79150162	14150
chr5	79136012	79336012	harbor1	chr5	79150477	79150645	DNA/hAT-Charlie	1954	+	84	79150561	14549
chr5	79136012	79336012	harbor1	chr5	79150929	79151075	DNA/hAT-Charlie	1954	+	73	79151002	14990
chr5	79136012	79336012	harbor1	chr5	79157856	79158018	DNA/hAT-Charlie	838	+	81	79157937	21925
chr5	79136012	79336012	harbor1	chr5	79194041	79194218	DNA/hAT-Charlie	937	+	88	79194129	58117
chr5	79136012	79336012	harbor1	chr5	79194227	79194560	DNA/hAT-Charlie	2246	+	166	79194393	58381
chr5	73350822	73550822	harbor1	chr5	73411255	73411378	DNA/hAT-Charlie	417	+	62	73411317	60495
chr5	73350822	73550822	harbor1	chr5	73426804	73426946	DNA/hAT-Charlie	659	+	71	73426875	76053
chr5	10661147	10861147	harbor1	chr5	10661299	10661381	DNA/hAT-Charlie	480	+	41	10661340	193
chr5	10661147	10861147	harbor1	chr5	10661837	10661860	DNA/hAT-Charlie	480	+	12	10661849	702
chr5	10661147	10861147	harbor1	chr5	10665546	10665891	DNA/hAT-Charlie	1803	+	172	10665718	4571
chr5	10661147	10861147	harbor1	chr5	10714140	10714504	DNA/hAT-Charlie	849	+	182	10714322	53175
chr5	10661147	10861147	harbor1	chr5	10726369	10726520	DNA/hAT-Charlie	614	+	76	10726445	65298
chr5	10661147	10861147	harbor1	chr5	10735140	10735479	DNA/hAT-Charlie	972	+	170	10735310	74163
chr5	10661147	10861147	harbor1	chr5	10735473	10735663	DNA/hAT-Charlie	475	+	95	10735568	74421
chr5	10661147	10861147	harbor1	chr5	10749598	10749751	DNA/hAT-Charlie	411	+	76	10749674	88527
chr5	135919218	136119218	harbor1	chr5	135948412	135948659	DNA/hAT-Charlie	1133	+	124	135948536	29318
chr5	135919218	136119218	harbor1	chr5	135982188	135982302	DNA/hAT-Charlie	586	+	57	135982245	63027
chr5	135919218	136119218	harbor1	chr5	136010568	136010910	DNA/hAT-Charlie	1534	+	171	136010739	91521
chr5	135919218	136119218	harbor1	chr5	136016256	136016494	DNA/hAT-Charlie	538	+	119	136016375	97157
chr5	6533033	6733033	harbor1	chr5	6565425	6565594	DNA/hAT-Charlie	492	+	84	6565509	32476
chr5	6533033	6733033	harbor1	chr5	6626081	6626316	DNA/hAT-Charlie	554	+	118	6626199	93166
chr5	126677744	126877744	harbor1	chr5	126694443	126694647	DNA/hAT-Charlie	569	+	102	126694545	16801
chr5	126677744	126877744	harbor1	chr5	126695621	126695782	DNA/hAT-Charlie	820	+	80	126695701	17957
chr5	126677744	126877744	harbor1	chr5	126730035	126730185	DNA/hAT-Charlie	602	+	75	126730110	52366
chr5	10341894	10541894	harbor1	chr5	10349865	10350009	DNA/hAT-Charlie	509	+	72	10349937	8043
chr5	10341894	10541894	harbor1	chr5	10399199	10399399	DNA/hAT-Charlie	421	+	100	10399299	57405
chr5	10341894	10541894	harbor1	chr5	10405917	10406234	DNA/hAT-Charlie	1881	+	158	10406075	64181
chr5	10231669	10431669	harbor1	chr5	10267291	10267475	DNA/hAT-Charlie	763	+	92	10267383	35714
chr5	10231669	10431669	harbor1	chr5	10267788	10267929	DNA/hAT-Charlie	706	+	70	10267858	36189
chr5	10231669	10431669	harbor1	chr5	10267953	10268066	DNA/hAT-Charlie	665	+	56	10268009	36340
chr5	10231669	10431669	harbor1	chr5	10276735	10277089	DNA/hAT-Charlie	2399	+	177	10276912	45243
chr5	10231669	10431669	harbor1	chr5	10277392	10277647	DNA/hAT-Charlie	2399	+	128	10277520	45851
chr5	93490732	93690732	harbor1	chr5	93509285	93509476	DNA/hAT-Charlie	708	+	96	93509381	18649
chr5	93490732	93690732	harbor1	chr5	93511623	93511961	DNA/hAT-Charlie	2167	+	169	93511792	21060
chr5	71628507	71828507	harbor1	chr5	71664418	71664481	DNA/hAT-Charlie	752	+	32	71664450	35943
chr5	71628507	71828507	harbor1	chr5	71664797	71664922	DNA/hAT-Charlie	752	+	62	71664859	36352
chr5	71628507	71828507	harbor1	chr5	71706137	71706278	DNA/hAT-Charlie	441	+	70	71706207	77700
chr5	177199421	177399421	harbor1	chr5	177263363	177264028	DNA/hAT-Charlie	2600	+	332	177263695	64274
chr5	177199421	177399421	harbor1	chr5	177264230	177264516	DNA/hAT-Charlie	1112	+	143	177264373	64952
chr5	177199421	177399421	harbor1	chr5	177277176	177277498	DNA/hAT-Charlie	1290	+	161	177277337	77916
chr5	177199421	177399421	harbor1	chr5	177285105	177285219	DNA/hAT-Charlie	445	+	57	177285162	85741
chr5	179703607	179903607	harbor1	chr5	179751280	179751435	DNA/hAT-Charlie	478	+	78	179751358	47751
chr5	179703607	179903607	harbor1	chr5	179752017	179752045	DNA/hAT-Charlie	478	+	14	179752031	48424
chr5	179703607	179903607	harbor1	chr5	179752352	179752394	DNA/hAT-Charlie	478	+	21	179752373	48766
chr5	179703607	179903607	harbor1	chr5	179755609	179755768	DNA/hAT-Charlie	1286	+	80	179755689	52082
chr5	179703607	179903607	harbor1	chr5	179756063	179756113	DNA/hAT-Charlie	1286	+	25	179756088	52481
chr5	78709775	78909775	harbor1	chr5	78736256	78736431	DNA/hAT-Charlie	528	+	88	78736344	26569
chr5	78709775	78909775	harbor1	chr5	78736553	78736697	DNA/hAT-Charlie	1631	+	72	78736625	26850
chr5	78709775	78909775	harbor1	chr5	78736952	78736988	DNA/hAT-Charlie	1631	+	18	78736970	27195
chr5	78709775	78909775	harbor1	chr5	78737276	78737443	DNA/hAT-Charlie	1631	+	84	78737360	27585
chr5	78709775	78909775	harbor1	chr5	78737735	78738289	DNA/hAT-Charlie	1631	+	277	78738012	28237
chr5	78709775	78909775	harbor1	chr5	78738596	78738679	DNA/hAT-Charlie	1631	+	42	78738638	28863
chr5	78709775	78909775	harbor1	chr5	78780901	78781009	DNA/hAT-Charlie	528	+	54	78780955	71180
chr5	78410099	78610099	harbor1	chr5	78422539	78422682	DNA/hAT-Charlie	433	+	72	78422611	12512
chr5	78410099	78610099	harbor1	chr5	78431039	78431144	DNA/hAT-Charlie	524	+	52	78431091	20992
chr5	78410099	78610099	harbor1	chr5	78446900	78447228	DNA/hAT-Charlie	2245	+	164	78447064	36965
chr5	78410099	78610099	harbor1	chr5	78489734	78489920	DNA/hAT-Charlie	514	+	93	78489827	79728
chr5	10661144	10861144	harbor1	chr5	10661299	10661381	DNA/hAT-Charlie	480	+	41	10661340	196
chr5	10661144	10861144	harbor1	chr5	10661837	10661860	DNA/hAT-Charlie	480	+	12	10661849	705
chr5	10661144	10861144	harbor1	chr5	10665546	10665891	DNA/hAT-Charlie	1803	+	172	10665718	4574
chr5	10661144	10861144	harbor1	chr5	10714140	10714504	DNA/hAT-Charlie	849	+	182	10714322	53178
chr5	10661144	10861144	harbor1	chr5	10726369	10726520	DNA/hAT-Charlie	614	+	76	10726445	65301
chr5	10661144	10861144	harbor1	chr5	10735140	10735479	DNA/hAT-Charlie	972	+	170	10735310	74166
chr5	10661144	10861144	harbor1	chr5	10735473	10735663	DNA/hAT-Charlie	475	+	95	10735568	74424
chr5	10661144	10861144	harbor1	chr5	10749598	10749751	DNA/hAT-Charlie	411	+	76	10749674	88530
chr5	10661231	10861231	harbor1	chr5	10661299	10661381	DNA/hAT-Charlie	480	+	41	10661340	109
chr5	10661231	10861231	harbor1	chr5	10661837	10661860	DNA/hAT-Charlie	480	+	12	10661849	618
chr5	10661231	10861231	harbor1	chr5	10665546	10665891	DNA/hAT-Charlie	1803	+	172	10665718	4487
chr5	10661231	10861231	harbor1	chr5	10714140	10714504	DNA/hAT-Charlie	849	+	182	10714322	53091
chr5	10661231	10861231	harbor1	chr5	10726369	10726520	DNA/hAT-Charlie	614	+	76	10726445	65214
chr5	10661231	10861231	harbor1	chr5	10735140	10735479	DNA/hAT-Charlie	972	+	170	10735310	74079
chr5	10661231	10861231	harbor1	chr5	10735473	10735663	DNA/hAT-Charlie	475	+	95	10735568	74337
chr5	10661231	10861231	harbor1	chr5	10749598	10749751	DNA/hAT-Charlie	411	+	76	10749674	88443
chr5	10339015	10539015	harbor1	chr5	10349865	10350009	DNA/hAT-Charlie	509	+	72	10349937	10922
chr5	10339015	10539015	harbor1	chr5	10399199	10399399	DNA/hAT-Charlie	421	+	100	10399299	60284
chr5	10339015	10539015	harbor1	chr5	10405917	10406234	DNA/hAT-Charlie	1881	+	158	10406075	67060
chr5	137653913	137853913	harbor1	chr5	137667062	137667268	DNA/hAT-Charlie	1212	+	103	137667165	13252
chr5	137653913	137853913	harbor1	chr5	137717930	137718202	DNA/hAT-Charlie	850	+	136	137718066	64153
chr5	78410150	78610150	harbor1	chr5	78422539	78422682	DNA/hAT-Charlie	433	+	72	78422611	12461
chr5	78410150	78610150	harbor1	chr5	78431039	78431144	DNA/hAT-Charlie	524	+	52	78431091	20941
chr5	78410150	78610150	harbor1	chr5	78446900	78447228	DNA/hAT-Charlie	2245	+	164	78447064	36914
chr5	78410150	78610150	harbor1	chr5	78489734	78489920	DNA/hAT-Charlie	514	+	93	78489827	79677
chr6	139275451	139475451	harbor1	chr6	139286578	139287057	DNA/hAT-Charlie	3411	+	240	139286818	11367
chr6	31056818	31256818	harbor1	chr6	31058256	31058580	DNA/hAT-Charlie	1163	+	162	31058418	1600
chr6	31056818	31256818	harbor1	chr6	31071864	31072167	DNA/hAT-Charlie	1528	+	152	31072016	15198
chr6	31056818	31256818	harbor1	chr6	31121786	31121928	DNA/hAT-Charlie	479	+	71	31121857	65039
chr6	139275552	139475552	harbor1	chr6	139286578	139287057	DNA/hAT-Charlie	3411	+	240	139286818	11266
chr6	37070857	37270857	harbor1	chr6	37075709	37075891	DNA/hAT-Charlie	1619	+	91	37075800	4943
chr6	37070857	37270857	harbor1	chr6	37076204	37076365	DNA/hAT-Charlie	1619	+	80	37076284	5427
chr6	37070857	37270857	harbor1	chr6	37078794	37079053	DNA/hAT-Charlie	463	+	130	37078924	8067
chr6	37070857	37270857	harbor1	chr6	37083921	37084081	DNA/hAT-Charlie	825	+	80	37084001	13144
chr6	37070857	37270857	harbor1	chr6	37084384	37084431	DNA/hAT-Charlie	825	+	24	37084408	13551
chr6	37070857	37270857	harbor1	chr6	37139662	37139816	DNA/hAT-Charlie	542	+	77	37139739	68882
chr6	139268099	139468099	harbor1	chr6	139286578	139287057	DNA/hAT-Charlie	3411	+	240	139286818	18719
chr6	127167311	127367311	harbor1	chr6	127234504	127234697	DNA/hAT-Charlie	528	+	96	127234600	67289
chr6	89719728	89919728	harbor1	chr6	89736910	89737044	DNA/hAT-Charlie	510	+	67	89736977	17249
chr6	37002869	37202869	harbor1	chr6	37036238	37036554	DNA/hAT-Charlie	1909	+	158	37036396	33527
chr6	37002869	37202869	harbor1	chr6	37075709	37075891	DNA/hAT-Charlie	1619	+	91	37075800	72931
chr6	37002869	37202869	harbor1	chr6	37076204	37076365	DNA/hAT-Charlie	1619	+	80	37076284	73415
chr6	37002869	37202869	harbor1	chr6	37078794	37079053	DNA/hAT-Charlie	463	+	130	37078924	76055
chr6	37002869	37202869	harbor1	chr6	37083921	37084081	DNA/hAT-Charlie	825	+	80	37084001	81132
chr6	37002869	37202869	harbor1	chr6	37084384	37084431	DNA/hAT-Charlie	825	+	24	37084408	81539
chr6	37070851	37270851	harbor1	chr6	37075709	37075891	DNA/hAT-Charlie	1619	+	91	37075800	4949
chr6	37070851	37270851	harbor1	chr6	37076204	37076365	DNA/hAT-Charlie	1619	+	80	37076284	5433
chr6	37070851	37270851	harbor1	chr6	37078794	37079053	DNA/hAT-Charlie	463	+	130	37078924	8073
chr6	37070851	37270851	harbor1	chr6	37083921	37084081	DNA/hAT-Charlie	825	+	80	37084001	13150
chr6	37070851	37270851	harbor1	chr6	37084384	37084431	DNA/hAT-Charlie	825	+	24	37084408	13557
chr6	37070851	37270851	harbor1	chr6	37139662	37139816	DNA/hAT-Charlie	542	+	77	37139739	68888
chr6	37070872	37270872	harbor1	chr6	37075709	37075891	DNA/hAT-Charlie	1619	+	91	37075800	4928
chr6	37070872	37270872	harbor1	chr6	37076204	37076365	DNA/hAT-Charlie	1619	+	80	37076284	5412
chr6	37070872	37270872	harbor1	chr6	37078794	37079053	DNA/hAT-Charlie	463	+	130	37078924	8052
chr6	37070872	37270872	harbor1	chr6	37083921	37084081	DNA/hAT-Charlie	825	+	80	37084001	13129
chr6	37070872	37270872	harbor1	chr6	37084384	37084431	DNA/hAT-Charlie	825	+	24	37084408	13536
chr6	37070872	37270872	harbor1	chr6	37139662	37139816	DNA/hAT-Charlie	542	+	77	37139739	68867
chr6	139275170	139475170	harbor1	chr6	139286578	139287057	DNA/hAT-Charlie	3411	+	240	139286818	11648
chr6	124862435	125062435	harbor1	chr6	124889605	124889781	DNA/hAT-Charlie	815	+	88	124889693	27258
chr6	124862435	125062435	harbor1	chr6	124899014	124899144	DNA/hAT-Charlie	718	+	65	124899079	36644
chr6	124862435	125062435	harbor1	chr6	124899122	124899834	DNA/hAT-Charlie	2647	+	356	124899478	37043
chr6	11481954	11681954	harbor1	chr6	11509451	11509677	DNA/hAT-Charlie	811	+	113	11509564	27610
chr6	11481954	11681954	harbor1	chr6	11558423	11558601	DNA/hAT-Charlie	674	+	89	11558512	76558
chr6	37070827	37270827	harbor1	chr6	37075709	37075891	DNA/hAT-Charlie	1619	+	91	37075800	4973
chr6	37070827	37270827	harbor1	chr6	37076204	37076365	DNA/hAT-Charlie	1619	+	80	37076284	5457
chr6	37070827	37270827	harbor1	chr6	37078794	37079053	DNA/hAT-Charlie	463	+	130	37078924	8097
chr6	37070827	37270827	harbor1	chr6	37083921	37084081	DNA/hAT-Charlie	825	+	80	37084001	13174
chr6	37070827	37270827	harbor1	chr6	37084384	37084431	DNA/hAT-Charlie	825	+	24	37084408	13581
chr6	37070827	37270827	harbor1	chr6	37139662	37139816	DNA/hAT-Charlie	542	+	77	37139739	68912
chr6	7626957	7826957	harbor1	chr6	7651827	7652000	DNA/hAT-Charlie	460	+	86	7651913	24956
chr6	7626957	7826957	harbor1	chr6	7685736	7685941	DNA/hAT-Charlie	1160	+	102	7685838	58881
chr6	7626957	7826957	harbor1	chr6	7708279	7708432	DNA/hAT-Charlie	1238	+	76	7708355	81398
chr6	7626957	7826957	harbor1	chr6	7708730	7708810	DNA/hAT-Charlie	1238	+	40	7708770	81813
chr6	105894234	106094234	harbor1	chr6	105909931	105910117	DNA/hAT-Charlie	1093	+	93	105910024	15790
chr6	105894234	106094234	harbor1	chr6	105952477	105952638	DNA/hAT-Charlie	917	+	80	105952557	58323
chr6	105894234	106094234	harbor1	chr6	105906152	105906304	DNA/hAT-Charlie	672	+	76	105906228	11994
chr6	36992832	37192832	harbor1	chr6	37001074	37001368	DNA/hAT-Charlie	1713	+	147	37001221	8389
chr6	36992832	37192832	harbor1	chr6	37036238	37036554	DNA/hAT-Charlie	1909	+	158	37036396	43564
chr6	36992832	37192832	harbor1	chr6	37075709	37075891	DNA/hAT-Charlie	1619	+	91	37075800	82968
chr6	36992832	37192832	harbor1	chr6	37076204	37076365	DNA/hAT-Charlie	1619	+	80	37076284	83452
chr6	36992832	37192832	harbor1	chr6	37078794	37079053	DNA/hAT-Charlie	463	+	130	37078924	86092
chr6	36992832	37192832	harbor1	chr6	37083921	37084081	DNA/hAT-Charlie	825	+	80	37084001	91169
chr6	36992832	37192832	harbor1	chr6	37084384	37084431	DNA/hAT-Charlie	825	+	24	37084408	91576
chr6	107387585	107587585	harbor1	chr6	107397136	107398570	DNA/hAT-Charlie	5857	+	717	107397853	10268
chr6	138673799	138873799	harbor1	chr6	138726864	138727207	DNA/hAT-Charlie	683	+	172	138727036	53237
chr6	138673799	138873799	harbor1	chr6	138744056	138744159	DNA/hAT-Charlie	477	+	52	138744108	70309
chr6	35352746	35552746	harbor1	chr6	35409804	35409959	DNA/hAT-Charlie	697	+	78	35409882	57136
chr6	45541025	45741025	harbor1	chr6	45593908	45594206	DNA/hAT-Charlie	931	+	149	45594057	53032
chr6	45541025	45741025	harbor1	chr6	45594678	45594859	DNA/hAT-Charlie	923	+	90	45594768	53743
chr6	45541025	45741025	harbor1	chr6	45615797	45616085	DNA/hAT-Charlie	1596	+	144	45615941	74916
chr6	99421500	99621500	harbor1	chr6	99495800	99495980	DNA/hAT-Charlie	811	+	90	99495890	74390
chr6	99421500	99621500	harbor1	chr6	99498616	99498954	DNA/hAT-Charlie	1490	+	169	99498785	77285
chr6	99421500	99621500	harbor1	chr6	99504709	99504922	DNA/hAT-Charlie	761	+	106	99504815	83315
chr6	99421500	99621500	harbor1	chr6	99505725	99505909	DNA/hAT-Charlie	842	+	92	99505817	84317
chr6	31970478	32170478	harbor1	chr6	32055615	32055741	DNA/hAT-Charlie	592	+	63	32055678	85200
chr6	41820289	42020289	harbor1	chr6	41897182	41897440	DNA/hAT-Charlie	3216	+	129	41897311	77022
chr6	41820289	42020289	harbor1	chr6	41897740	41898040	DNA/hAT-Charlie	3216	+	150	41897890	77601
chr6	41820289	42020289	harbor1	chr6	41898340	41898447	DNA/hAT-Charlie	3216	+	54	41898394	78105
chr6	41820289	42020289	harbor1	chr6	41899070	41899693	DNA/hAT-Charlie	3216	+	312	41899382	79093
chr6	41820289	42020289	harbor1	chr6	41899995	41900016	DNA/hAT-Charlie	3216	+	10	41900005	79716
chr6	41820289	42020289	harbor1	chr6	41900244	41900302	DNA/hAT-Charlie	3216	+	29	41900273	79984
chr6	41820289	42020289	harbor1	chr6	41913133	41913259	DNA/hAT-Charlie	548	+	63	41913196	92907
chr6	41820289	42020289	harbor1	chr6	41917650	41917810	DNA/hAT-Charlie	598	+	80	41917730	97441
chr6	107722375	107922375	harbor1	chr6	107729584	107729781	DNA/hAT-Charlie	487	+	98	107729682	7307
chr6	107722375	107922375	harbor1	chr6	107737937	107738040	DNA/hAT-Charlie	657	+	52	107737989	15614
chr6	107722375	107922375	harbor1	chr6	107815163	107815880	DNA/hAT-Charlie	1660	+	358	107815521	93146
chr6	139274146	139474146	harbor1	chr6	139286578	139287057	DNA/hAT-Charlie	3411	+	240	139286818	12672
chr6	36493941	36693941	harbor1	chr6	36505058	36505226	DNA/hAT-Charlie	799	+	84	36505142	11201
chr6	36493941	36693941	harbor1	chr6	36505555	36505965	DNA/hAT-Charlie	907	+	205	36505760	11819
chr6	36493941	36693941	harbor1	chr6	36556012	36556142	DNA/hAT-Charlie	471	+	65	36556077	62136
chr6	36493941	36693941	harbor1	chr6	36566894	36567095	DNA/hAT-Charlie	633	+	100	36566994	73053
chr6	36493941	36693941	harbor1	chr6	36567399	36567449	DNA/hAT-Charlie	633	+	25	36567424	73483
chr6	36493941	36693941	harbor1	chr6	36567723	36567775	DNA/hAT-Charlie	633	+	26	36567749	73808
chr6	77363005	77563005	harbor1	chr6	77376635	77376865	DNA/hAT-Charlie	801	+	115	77376750	13745
chr6	77363005	77563005	harbor1	chr6	77386549	77386740	DNA/hAT-Charlie	838	+	96	77386645	23640
chr6	77363005	77563005	harbor1	chr6	77451056	77451219	DNA/hAT-Charlie	770	+	82	77451138	88133
chr6	77363005	77563005	harbor1	chr6	77455686	77455851	DNA/hAT-Charlie	774	+	82	77455768	92763
chr6	37002597	37202597	harbor1	chr6	37036238	37036554	DNA/hAT-Charlie	1909	+	158	37036396	33799
chr6	37002597	37202597	harbor1	chr6	37075709	37075891	DNA/hAT-Charlie	1619	+	91	37075800	73203
chr6	37002597	37202597	harbor1	chr6	37076204	37076365	DNA/hAT-Charlie	1619	+	80	37076284	73687
chr6	37002597	37202597	harbor1	chr6	37078794	37079053	DNA/hAT-Charlie	463	+	130	37078924	76327
chr6	37002597	37202597	harbor1	chr6	37083921	37084081	DNA/hAT-Charlie	825	+	80	37084001	81404
chr6	37002597	37202597	harbor1	chr6	37084384	37084431	DNA/hAT-Charlie	825	+	24	37084408	81811
chr6	139274683	139474683	harbor1	chr6	139286578	139287057	DNA/hAT-Charlie	3411	+	240	139286818	12135
chr6	169864005	170064005	harbor1	chr6	169894576	169894908	DNA/hAT-Charlie	1944	+	166	169894742	30737
chr6	169864005	170064005	harbor1	chr6	169955699	169955875	DNA/hAT-Charlie	476	+	88	169955787	91782
chr6	37070831	37270831	harbor1	chr6	37075709	37075891	DNA/hAT-Charlie	1619	+	91	37075800	4969
chr6	37070831	37270831	harbor1	chr6	37076204	37076365	DNA/hAT-Charlie	1619	+	80	37076284	5453
chr6	37070831	37270831	harbor1	chr6	37078794	37079053	DNA/hAT-Charlie	463	+	130	37078924	8093
chr6	37070831	37270831	harbor1	chr6	37083921	37084081	DNA/hAT-Charlie	825	+	80	37084001	13170
chr6	37070831	37270831	harbor1	chr6	37084384	37084431	DNA/hAT-Charlie	825	+	24	37084408	13577
chr6	37070831	37270831	harbor1	chr6	37139662	37139816	DNA/hAT-Charlie	542	+	77	37139739	68908
chr6	37070836	37270836	harbor1	chr6	37075709	37075891	DNA/hAT-Charlie	1619	+	91	37075800	4964
chr6	37070836	37270836	harbor1	chr6	37076204	37076365	DNA/hAT-Charlie	1619	+	80	37076284	5448
chr6	37070836	37270836	harbor1	chr6	37078794	37079053	DNA/hAT-Charlie	463	+	130	37078924	8088
chr6	37070836	37270836	harbor1	chr6	37083921	37084081	DNA/hAT-Charlie	825	+	80	37084001	13165
chr6	37070836	37270836	harbor1	chr6	37084384	37084431	DNA/hAT-Charlie	825	+	24	37084408	13572
chr6	37070836	37270836	harbor1	chr6	37139662	37139816	DNA/hAT-Charlie	542	+	77	37139739	68903
chr6	167862748	168062748	harbor1	chr6	167947479	167947616	DNA/hAT-Charlie	597	+	68	167947547	84799
chr6	167862748	168062748	harbor1	chr6	167958938	167959119	DNA/hAT-Charlie	467	+	90	167959028	96280
chr6	10421300	10621300	harbor1	chr6	10448576	10448742	DNA/hAT-Charlie	931	+	83	10448659	27359
chr6	10421300	10621300	harbor1	chr6	10490053	10490421	DNA/hAT-Charlie	1889	+	184	10490237	68937
chr6	10421300	10621300	harbor1	chr6	10507372	10507564	DNA/hAT-Charlie	1154	+	96	10507468	86168
chr6	139275445	139475445	harbor1	chr6	139286578	139287057	DNA/hAT-Charlie	3411	+	240	139286818	11373
chr6	7626988	7826988	harbor1	chr6	7651827	7652000	DNA/hAT-Charlie	460	+	86	7651913	24925
chr6	7626988	7826988	harbor1	chr6	7685736	7685941	DNA/hAT-Charlie	1160	+	102	7685838	58850
chr6	7626988	7826988	harbor1	chr6	7708279	7708432	DNA/hAT-Charlie	1238	+	76	7708355	81367
chr6	7626988	7826988	harbor1	chr6	7708730	7708810	DNA/hAT-Charlie	1238	+	40	7708770	81782
chr6	27415355	27615355	harbor1	chr6	27439048	27439175	DNA/hAT-Charlie	463	+	64	27439112	23757
chr6	27415355	27615355	harbor1	chr6	27514477	27514696	DNA/hAT-Charlie	1204	+	110	27514587	99232
chr6	37070816	37270816	harbor1	chr6	37075709	37075891	DNA/hAT-Charlie	1619	+	91	37075800	4984
chr6	37070816	37270816	harbor1	chr6	37076204	37076365	DNA/hAT-Charlie	1619	+	80	37076284	5468
chr6	37070816	37270816	harbor1	chr6	37078794	37079053	DNA/hAT-Charlie	463	+	130	37078924	8108
chr6	37070816	37270816	harbor1	chr6	37083921	37084081	DNA/hAT-Charlie	825	+	80	37084001	13185
chr6	37070816	37270816	harbor1	chr6	37084384	37084431	DNA/hAT-Charlie	825	+	24	37084408	13592
chr6	37070816	37270816	harbor1	chr6	37139662	37139816	DNA/hAT-Charlie	542	+	77	37139739	68923
chr6	167862786	168062786	harbor1	chr6	167947479	167947616	DNA/hAT-Charlie	597	+	68	167947547	84761
chr6	167862786	168062786	harbor1	chr6	167958938	167959119	DNA/hAT-Charlie	467	+	90	167959028	96242
chr6	30366671	30566671	harbor1	chr6	30405398	30405750	DNA/hAT-Charlie	2036	+	176	30405574	38903
chr6	30366671	30566671	harbor1	chr6	30443668	30443775	DNA/hAT-Charlie	545	+	54	30443722	77051
chr6	139274657	139474657	harbor1	chr6	139286578	139287057	DNA/hAT-Charlie	3411	+	240	139286818	12161
chr6	37070849	37270849	harbor1	chr6	37075709	37075891	DNA/hAT-Charlie	1619	+	91	37075800	4951
chr6	37070849	37270849	harbor1	chr6	37076204	37076365	DNA/hAT-Charlie	1619	+	80	37076284	5435
chr6	37070849	37270849	harbor1	chr6	37078794	37079053	DNA/hAT-Charlie	463	+	130	37078924	8075
chr6	37070849	37270849	harbor1	chr6	37083921	37084081	DNA/hAT-Charlie	825	+	80	37084001	13152
chr6	37070849	37270849	harbor1	chr6	37084384	37084431	DNA/hAT-Charlie	825	+	24	37084408	13559
chr6	37070849	37270849	harbor1	chr6	37139662	37139816	DNA/hAT-Charlie	542	+	77	37139739	68890
chr6	81650363	81850363	harbor1	chr6	81700089	81700303	DNA/hAT-Charlie	804	+	107	81700196	49833
chr6	147104160	147304160	harbor1	chr6	147161748	147162026	DNA/hAT-Charlie	1068	+	139	147161887	57727
chr6	147104160	147304160	harbor1	chr6	147167711	147167861	DNA/hAT-Charlie	519	+	75	147167786	63626
chr6	147104160	147304160	harbor1	chr6	147169383	147169709	DNA/hAT-Charlie	1243	+	163	147169546	65386
chr6	147104160	147304160	harbor1	chr6	147192397	147192602	DNA/hAT-Charlie	860	+	102	147192499	88339
chr6	37070846	37270846	harbor1	chr6	37075709	37075891	DNA/hAT-Charlie	1619	+	91	37075800	4954
chr6	37070846	37270846	harbor1	chr6	37076204	37076365	DNA/hAT-Charlie	1619	+	80	37076284	5438
chr6	37070846	37270846	harbor1	chr6	37078794	37079053	DNA/hAT-Charlie	463	+	130	37078924	8078
chr6	37070846	37270846	harbor1	chr6	37083921	37084081	DNA/hAT-Charlie	825	+	80	37084001	13155
chr6	37070846	37270846	harbor1	chr6	37084384	37084431	DNA/hAT-Charlie	825	+	24	37084408	13562
chr6	37070846	37270846	harbor1	chr6	37139662	37139816	DNA/hAT-Charlie	542	+	77	37139739	68893
chr6	37070848	37270848	harbor1	chr6	37075709	37075891	DNA/hAT-Charlie	1619	+	91	37075800	4952
chr6	37070848	37270848	harbor1	chr6	37076204	37076365	DNA/hAT-Charlie	1619	+	80	37076284	5436
chr6	37070848	37270848	harbor1	chr6	37078794	37079053	DNA/hAT-Charlie	463	+	130	37078924	8076
chr6	37070848	37270848	harbor1	chr6	37083921	37084081	DNA/hAT-Charlie	825	+	80	37084001	13153
chr6	37070848	37270848	harbor1	chr6	37084384	37084431	DNA/hAT-Charlie	825	+	24	37084408	13560
chr6	37070848	37270848	harbor1	chr6	37139662	37139816	DNA/hAT-Charlie	542	+	77	37139739	68891
chr6	36343280	36543280	harbor1	chr6	36382377	36382536	DNA/hAT-Charlie	873	+	80	36382457	39177
chr6	36343280	36543280	harbor1	chr6	36399923	36400087	DNA/hAT-Charlie	689	+	82	36400005	56725
chr6	36343280	36543280	harbor1	chr6	36436901	36437003	DNA/hAT-Charlie	810	+	51	36436952	93672
chr6	36343280	36543280	harbor1	chr6	36437314	36437513	DNA/hAT-Charlie	810	+	100	36437414	94134
chr6	101699773	101899773	harbor1	chr6	101712229	101712379	DNA/hAT-Charlie	684	+	75	101712304	12531
chr6	37070843	37270843	harbor1	chr6	37075709	37075891	DNA/hAT-Charlie	1619	+	91	37075800	4957
chr6	37070843	37270843	harbor1	chr6	37076204	37076365	DNA/hAT-Charlie	1619	+	80	37076284	5441
chr6	37070843	37270843	harbor1	chr6	37078794	37079053	DNA/hAT-Charlie	463	+	130	37078924	8081
chr6	37070843	37270843	harbor1	chr6	37083921	37084081	DNA/hAT-Charlie	825	+	80	37084001	13158
chr6	37070843	37270843	harbor1	chr6	37084384	37084431	DNA/hAT-Charlie	825	+	24	37084408	13565
chr6	37070843	37270843	harbor1	chr6	37139662	37139816	DNA/hAT-Charlie	542	+	77	37139739	68896
chr6	34135066	34335066	harbor1	chr6	34155435	34155523	DNA/hAT-Charlie	494	+	44	34155479	20413
chr6	34135066	34335066	harbor1	chr6	34155648	34155720	DNA/hAT-Charlie	494	+	36	34155684	20618
chr6	52184786	52384786	harbor1	chr6	52192515	52192805	DNA/hAT-Charlie	925	+	145	52192660	7874
chr6	52184786	52384786	harbor1	chr6	52253158	52253324	DNA/hAT-Charlie	734	+	83	52253241	68455
chr6	52184786	52384786	harbor1	chr6	52256061	52256301	DNA/hAT-Charlie	1513	+	120	52256181	71395
chr6	52184744	52384744	harbor1	chr6	52192515	52192805	DNA/hAT-Charlie	925	+	145	52192660	7916
chr6	52184744	52384744	harbor1	chr6	52253158	52253324	DNA/hAT-Charlie	734	+	83	52253241	68497
chr6	52184744	52384744	harbor1	chr6	52256061	52256301	DNA/hAT-Charlie	1513	+	120	52256181	71437
chr6	169864011	170064011	harbor1	chr6	169894576	169894908	DNA/hAT-Charlie	1944	+	166	169894742	30731
chr6	169864011	170064011	harbor1	chr6	169955699	169955875	DNA/hAT-Charlie	476	+	88	169955787	91776
chr6	149351029	149551029	harbor1	chr6	149369234	149369352	DNA/hAT-Charlie	497	+	59	149369293	18264
chr6	10422562	10622562	harbor1	chr6	10448576	10448742	DNA/hAT-Charlie	931	+	83	10448659	26097
chr6	10422562	10622562	harbor1	chr6	10490053	10490421	DNA/hAT-Charlie	1889	+	184	10490237	67675
chr6	10422562	10622562	harbor1	chr6	10507372	10507564	DNA/hAT-Charlie	1154	+	96	10507468	84906
chr6	147104106	147304106	harbor1	chr6	147161748	147162026	DNA/hAT-Charlie	1068	+	139	147161887	57781
chr6	147104106	147304106	harbor1	chr6	147167711	147167861	DNA/hAT-Charlie	519	+	75	147167786	63680
chr6	147104106	147304106	harbor1	chr6	147169383	147169709	DNA/hAT-Charlie	1243	+	163	147169546	65440
chr6	147104106	147304106	harbor1	chr6	147192397	147192602	DNA/hAT-Charlie	860	+	102	147192499	88393
chr6	110248805	110448805	harbor1	chr6	110288245	110288410	DNA/hAT-Charlie	656	+	82	110288327	39522
chr6	110248805	110448805	harbor1	chr6	110309907	110310024	DNA/hAT-Charlie	506	+	58	110309965	61160
chr6	110248805	110448805	harbor1	chr6	110317765	110317924	DNA/hAT-Charlie	526	+	80	110317845	69040
chr6	7626967	7826967	harbor1	chr6	7651827	7652000	DNA/hAT-Charlie	460	+	86	7651913	24946
chr6	7626967	7826967	harbor1	chr6	7685736	7685941	DNA/hAT-Charlie	1160	+	102	7685838	58871
chr6	7626967	7826967	harbor1	chr6	7708279	7708432	DNA/hAT-Charlie	1238	+	76	7708355	81388
chr6	7626967	7826967	harbor1	chr6	7708730	7708810	DNA/hAT-Charlie	1238	+	40	7708770	81803
chr6	31996362	32196362	harbor1	chr6	32055615	32055741	DNA/hAT-Charlie	592	+	63	32055678	59316
chr6	31996362	32196362	harbor1	chr6	32072367	32072687	DNA/hAT-Charlie	1597	+	160	32072527	76165
chr6	31996362	32196362	harbor1	chr6	32072968	32073081	DNA/hAT-Charlie	1597	+	56	32073024	76662
chr6	104840667	105040667	harbor1	chr6	104861866	104862069	DNA/hAT-Charlie	854	+	102	104861968	21301
chr6	52476539	52676539	harbor1	chr6	52478618	52478982	DNA/hAT-Charlie	627	+	182	52478800	2261
chr6	52476539	52676539	harbor1	chr6	52523856	52524020	DNA/hAT-Charlie	537	+	82	52523938	47399
chr6	52476539	52676539	harbor1	chr6	52534539	52534815	DNA/hAT-Charlie	571	+	138	52534677	58138
chr6	52476539	52676539	harbor1	chr6	52538577	52538735	DNA/hAT-Charlie	676	+	79	52538656	62117
chr6	139274673	139474673	harbor1	chr6	139286578	139287057	DNA/hAT-Charlie	3411	+	240	139286818	12145
chr6	30366631	30566631	harbor1	chr6	30405398	30405750	DNA/hAT-Charlie	2036	+	176	30405574	38943
chr6	30366631	30566631	harbor1	chr6	30443668	30443775	DNA/hAT-Charlie	545	+	54	30443722	77091
chr6	127167329	127367329	harbor1	chr6	127234504	127234697	DNA/hAT-Charlie	528	+	96	127234600	67271
chr6	52184830	52384830	harbor1	chr6	52192515	52192805	DNA/hAT-Charlie	925	+	145	52192660	7830
chr6	52184830	52384830	harbor1	chr6	52253158	52253324	DNA/hAT-Charlie	734	+	83	52253241	68411
chr6	52184830	52384830	harbor1	chr6	52256061	52256301	DNA/hAT-Charlie	1513	+	120	52256181	71351
chr6	139274467	139474467	harbor1	chr6	139286578	139287057	DNA/hAT-Charlie	3411	+	240	139286818	12351
chr6	127167314	127367314	harbor1	chr6	127234504	127234697	DNA/hAT-Charlie	528	+	96	127234600	67286
chr6	33522121	33722121	harbor1	chr6	33528464	33528577	DNA/hAT-Charlie	532	+	56	33528520	6399
chr6	33522121	33722121	harbor1	chr6	33595389	33595603	DNA/hAT-Charlie	1357	+	107	33595496	73375
chr6	33522121	33722121	harbor1	chr6	33570669	33571073	DNA/hAT-Charlie	820	+	202	33570871	48750
chr6	33522121	33722121	harbor1	chr6	33619792	33620028	DNA/hAT-Charlie	608	+	118	33619910	97789
chr6	139274604	139474604	harbor1	chr6	139286578	139287057	DNA/hAT-Charlie	3411	+	240	139286818	12214
chr6	147104102	147304102	harbor1	chr6	147161748	147162026	DNA/hAT-Charlie	1068	+	139	147161887	57785
chr6	147104102	147304102	harbor1	chr6	147167711	147167861	DNA/hAT-Charlie	519	+	75	147167786	63684
chr6	147104102	147304102	harbor1	chr6	147169383	147169709	DNA/hAT-Charlie	1243	+	163	147169546	65444
chr6	147104102	147304102	harbor1	chr6	147192397	147192602	DNA/hAT-Charlie	860	+	102	147192499	88397
chr6	139275131	139475131	harbor1	chr6	139286578	139287057	DNA/hAT-Charlie	3411	+	240	139286818	11687
chr6	149351091	149551091	harbor1	chr6	149369234	149369352	DNA/hAT-Charlie	497	+	59	149369293	18202
chr6	79847089	80047089	harbor1	chr6	79894021	79894360	DNA/hAT-Charlie	2020	+	170	79894191	47102
chr6	79847089	80047089	harbor1	chr6	79935861	79936022	DNA/hAT-Charlie	896	+	80	79935941	88852
chr6	165559697	165759697	harbor1	chr6	165562793	165563019	DNA/hAT-Charlie	711	+	113	165562906	3209
chr6	165559697	165759697	harbor1	chr6	165568923	165569239	DNA/hAT-Charlie	827	+	158	165569081	9384
chr6	150799534	150999534	harbor1	chr6	150838299	150838524	DNA/hAT-Charlie	1303	+	112	150838411	38877
chr6	41091863	41291863	harbor1	chr6	41103757	41103874	DNA/hAT-Charlie	532	+	58	41103815	11952
chr6	41091863	41291863	harbor1	chr6	41182386	41182548	DNA/hAT-Charlie	661	+	81	41182467	90604
chr6	139275443	139475443	harbor1	chr6	139286578	139287057	DNA/hAT-Charlie	3411	+	240	139286818	11375
chr6	45540941	45740941	harbor1	chr6	45593908	45594206	DNA/hAT-Charlie	931	+	149	45594057	53116
chr6	45540941	45740941	harbor1	chr6	45594678	45594859	DNA/hAT-Charlie	923	+	90	45594768	53827
chr6	45540941	45740941	harbor1	chr6	45615797	45616085	DNA/hAT-Charlie	1596	+	144	45615941	75000
chr6	139275520	139475520	harbor1	chr6	139286578	139287057	DNA/hAT-Charlie	3411	+	240	139286818	11298
chr6	45540990	45740990	harbor1	chr6	45593908	45594206	DNA/hAT-Charlie	931	+	149	45594057	53067
chr6	45540990	45740990	harbor1	chr6	45594678	45594859	DNA/hAT-Charlie	923	+	90	45594768	53778
chr6	45540990	45740990	harbor1	chr6	45615797	45616085	DNA/hAT-Charlie	1596	+	144	45615941	74951
chr6	37070864	37270864	harbor1	chr6	37075709	37075891	DNA/hAT-Charlie	1619	+	91	37075800	4936
chr6	37070864	37270864	harbor1	chr6	37076204	37076365	DNA/hAT-Charlie	1619	+	80	37076284	5420
chr6	37070864	37270864	harbor1	chr6	37078794	37079053	DNA/hAT-Charlie	463	+	130	37078924	8060
chr6	37070864	37270864	harbor1	chr6	37083921	37084081	DNA/hAT-Charlie	825	+	80	37084001	13137
chr6	37070864	37270864	harbor1	chr6	37084384	37084431	DNA/hAT-Charlie	825	+	24	37084408	13544
chr6	37070864	37270864	harbor1	chr6	37139662	37139816	DNA/hAT-Charlie	542	+	77	37139739	68875
chr6	43355517	43555517	harbor1	chr6	43358066	43358230	DNA/hAT-Charlie	874	+	82	43358148	2631
chr6	34138380	34338380	harbor1	chr6	34155435	34155523	DNA/hAT-Charlie	494	+	44	34155479	17099
chr6	34138380	34338380	harbor1	chr6	34155648	34155720	DNA/hAT-Charlie	494	+	36	34155684	17304
chr6	45540939	45740939	harbor1	chr6	45593908	45594206	DNA/hAT-Charlie	931	+	149	45594057	53118
chr6	45540939	45740939	harbor1	chr6	45594678	45594859	DNA/hAT-Charlie	923	+	90	45594768	53829
chr6	45540939	45740939	harbor1	chr6	45615797	45616085	DNA/hAT-Charlie	1596	+	144	45615941	75002
chr6	43815149	44015149	harbor1	chr6	43834205	43834358	DNA/hAT-Charlie	610	+	76	43834281	19132
chr6	139274545	139474545	harbor1	chr6	139286578	139287057	DNA/hAT-Charlie	3411	+	240	139286818	12273
chr6	21629834	21829834	harbor1	chr6	21631489	21631602	DNA/hAT-Charlie	555	+	56	21631545	1711
chr6	21629834	21829834	harbor1	chr6	21632275	21632392	DNA/hAT-Charlie	555	+	58	21632333	2499
chr6	21629834	21829834	harbor1	chr6	21685747	21686302	DNA/hAT-Charlie	3444	+	278	21686025	56191
chr6	21629834	21829834	harbor1	chr6	21726958	21727093	DNA/hAT-Charlie	478	+	68	21727026	97192
chr6	7626958	7826958	harbor1	chr6	7651827	7652000	DNA/hAT-Charlie	460	+	86	7651913	24955
chr6	7626958	7826958	harbor1	chr6	7685736	7685941	DNA/hAT-Charlie	1160	+	102	7685838	58880
chr6	7626958	7826958	harbor1	chr6	7708279	7708432	DNA/hAT-Charlie	1238	+	76	7708355	81397
chr6	7626958	7826958	harbor1	chr6	7708730	7708810	DNA/hAT-Charlie	1238	+	40	7708770	81812
chr6	144187246	144387246	harbor1	chr6	144226053	144226433	DNA/hAT-Charlie	1513	+	190	144226243	38997
chr6	144187246	144387246	harbor1	chr6	144226727	144226837	DNA/hAT-Charlie	1513	+	55	144226782	39536
chr6	144187246	144387246	harbor1	chr6	144234313	144234451	DNA/hAT-Charlie	512	+	69	144234382	47136
chr6	127167324	127367324	harbor1	chr6	127234504	127234697	DNA/hAT-Charlie	528	+	96	127234600	67276
chr6	52184746	52384746	harbor1	chr6	52192515	52192805	DNA/hAT-Charlie	925	+	145	52192660	7914
chr6	52184746	52384746	harbor1	chr6	52253158	52253324	DNA/hAT-Charlie	734	+	83	52253241	68495
chr6	52184746	52384746	harbor1	chr6	52256061	52256301	DNA/hAT-Charlie	1513	+	120	52256181	71435
chr6	169863372	170063372	harbor1	chr6	169894576	169894908	DNA/hAT-Charlie	1944	+	166	169894742	31370
chr6	169863372	170063372	harbor1	chr6	169955699	169955875	DNA/hAT-Charlie	476	+	88	169955787	92415
chr6	166855964	167055964	harbor1	chr6	166902839	166902998	DNA/hAT-Charlie	499	+	80	166902919	46955
chr6	166855964	167055964	harbor1	chr6	166935173	166935411	DNA/hAT-Charlie	861	+	119	166935292	79328
chr6	127167395	127367395	harbor1	chr6	127234504	127234697	DNA/hAT-Charlie	528	+	96	127234600	67205
chr6	324347	524347	harbor1	chr6	339939	340245	DNA/hAT-Charlie	659	+	153	340092	15745
chr6	324347	524347	harbor1	chr6	353223	353532	DNA/hAT-Charlie	1755	+	154	353377	29030
chr6	324347	524347	harbor1	chr6	365985	366179	DNA/hAT-Charlie	728	+	97	366082	41735
chr6	324347	524347	harbor1	chr6	401121	401338	DNA/hAT-Charlie	503	+	108	401229	76882
chr6	56854700	57054700	harbor1	chr6	56877769	56878001	DNA/hAT-Charlie	762	+	116	56877885	23185
chr6	56854700	57054700	harbor1	chr6	56908302	56908574	DNA/hAT-Charlie	1294	+	136	56908438	53738
chr6	56854700	57054700	harbor1	chr6	56909129	56909244	DNA/hAT-Charlie	1294	+	58	56909187	54487
chr6	56854700	57054700	harbor1	chr6	56913406	56913629	DNA/hAT-Charlie	1187	+	112	56913518	58818
chr6	56854700	57054700	harbor1	chr6	56920536	56920716	DNA/hAT-Charlie	2323	+	90	56920626	65926
chr6	56854700	57054700	harbor1	chr6	56921040	56921640	DNA/hAT-Charlie	2323	+	300	56921340	66640
chr6	56854700	57054700	harbor1	chr6	56921656	56921785	DNA/hAT-Charlie	545	+	64	56921720	67020
chr6	24811164	25011164	harbor1	chr6	24863571	24864018	DNA/hAT-Charlie	1616	+	224	24863795	52631
chr6	24811164	25011164	harbor1	chr6	24866399	24866518	DNA/hAT-Charlie	762	+	60	24866459	55295
chr6	139275141	139475141	harbor1	chr6	139286578	139287057	DNA/hAT-Charlie	3411	+	240	139286818	11677
chr6	151197903	151397903	harbor1	chr6	151201066	151201249	DNA/hAT-Charlie	893	+	92	151201158	3255
chr6	149351013	149551013	harbor1	chr6	149369234	149369352	DNA/hAT-Charlie	497	+	59	149369293	18280
chr6	105894232	106094232	harbor1	chr6	105909931	105910117	DNA/hAT-Charlie	1093	+	93	105910024	15792
chr6	105894232	106094232	harbor1	chr6	105952477	105952638	DNA/hAT-Charlie	917	+	80	105952557	58325
chr6	105894232	106094232	harbor1	chr6	105906152	105906304	DNA/hAT-Charlie	672	+	76	105906228	11996
chr6	158436948	158636948	harbor1	chr6	158456298	158456512	DNA/hAT-Charlie	1478	+	107	158456405	19457
chr6	158436948	158636948	harbor1	chr6	158505334	158505547	DNA/hAT-Charlie	983	+	106	158505440	68492
chr6	127167313	127367313	harbor1	chr6	127234504	127234697	DNA/hAT-Charlie	528	+	96	127234600	67287
chr6	45540950	45740950	harbor1	chr6	45593908	45594206	DNA/hAT-Charlie	931	+	149	45594057	53107
chr6	45540950	45740950	harbor1	chr6	45594678	45594859	DNA/hAT-Charlie	923	+	90	45594768	53818
chr6	45540950	45740950	harbor1	chr6	45615797	45616085	DNA/hAT-Charlie	1596	+	144	45615941	74991
chr6	2665182	2865182	harbor1	chr6	2685715	2685788	DNA/hAT-Charlie	531	+	36	2685751	20569
chr6	2665182	2865182	harbor1	chr6	2686098	2686232	DNA/hAT-Charlie	531	+	67	2686165	20983
chr6	2665182	2865182	harbor1	chr6	2701698	2701864	DNA/hAT-Charlie	589	+	83	2701781	36599
chr6	2665182	2865182	harbor1	chr6	2710880	2711149	DNA/hAT-Charlie	594	+	134	2711014	45832
chr6	2665182	2865182	harbor1	chr6	2742950	2743187	DNA/hAT-Charlie	626	+	118	2743068	77886
chr6	27415346	27615346	harbor1	chr6	27439048	27439175	DNA/hAT-Charlie	463	+	64	27439112	23766
chr6	27415346	27615346	harbor1	chr6	27514477	27514696	DNA/hAT-Charlie	1204	+	110	27514587	99241
chr6	43521769	43721769	harbor1	chr6	43577749	43577802	DNA/hAT-Charlie	508	+	26	43577775	56006
chr6	43521769	43721769	harbor1	chr6	43578094	43578104	DNA/hAT-Charlie	508	+	5	43578099	56330
chr6	43521769	43721769	harbor1	chr6	43578412	43578489	DNA/hAT-Charlie	508	+	38	43578450	56681
chr6	27415357	27615357	harbor1	chr6	27439048	27439175	DNA/hAT-Charlie	463	+	64	27439112	23755
chr6	27415357	27615357	harbor1	chr6	27514477	27514696	DNA/hAT-Charlie	1204	+	110	27514587	99230
chr6	34138364	34338364	harbor1	chr6	34155435	34155523	DNA/hAT-Charlie	494	+	44	34155479	17115
chr6	34138364	34338364	harbor1	chr6	34155648	34155720	DNA/hAT-Charlie	494	+	36	34155684	17320
chr6	107857147	108057147	harbor1	chr6	107894884	107895033	DNA/hAT-Charlie	465	+	74	107894958	37811
chr6	107857147	108057147	harbor1	chr6	107951564	107951701	DNA/hAT-Charlie	565	+	68	107951632	94485
chr6	107857147	108057147	harbor1	chr6	107951990	107952033	DNA/hAT-Charlie	565	+	22	107952012	94865
chr6	35352842	35552842	harbor1	chr6	35409804	35409959	DNA/hAT-Charlie	697	+	78	35409882	57040
chr6	31172336	31372336	harbor1	chr6	31193737	31193812	DNA/hAT-Charlie	481	+	38	31193775	21439
chr6	31172336	31372336	harbor1	chr6	31194123	31194169	DNA/hAT-Charlie	481	+	23	31194146	21810
chr6	31172336	31372336	harbor1	chr6	31231784	31231967	DNA/hAT-Charlie	561	+	92	31231876	59540
chr6	31172336	31372336	harbor1	chr6	31261884	31262237	DNA/hAT-Charlie	1928	+	176	31262060	89724
chr6	13611912	13811912	harbor1	chr6	13630561	13630847	DNA/hAT-Charlie	1307	+	143	13630704	18792
chr6	70156169	70356169	harbor1	chr6	70171048	70171264	DNA/hAT-Charlie	1431	+	108	70171156	14987
chr6	70156169	70356169	harbor1	chr6	70190820	70191145	DNA/hAT-Charlie	896	+	162	70190982	34813
chr6	70156169	70356169	harbor1	chr6	70217336	70217649	DNA/hAT-Charlie	1262	+	156	70217492	61323
chr6	70156169	70356169	harbor1	chr6	70219325	70219513	DNA/hAT-Charlie	805	+	94	70219419	63250
chr6	70156169	70356169	harbor1	chr6	70230699	70230856	DNA/hAT-Charlie	920	+	78	70230777	74608
chr6	70156169	70356169	harbor1	chr6	70172513	70172677	DNA/hAT-Charlie	514	+	82	70172595	16426
chr6	52184768	52384768	harbor1	chr6	52192515	52192805	DNA/hAT-Charlie	925	+	145	52192660	7892
chr6	52184768	52384768	harbor1	chr6	52253158	52253324	DNA/hAT-Charlie	734	+	83	52253241	68473
chr6	52184768	52384768	harbor1	chr6	52256061	52256301	DNA/hAT-Charlie	1513	+	120	52256181	71413
chr6	167860893	168060893	harbor1	chr6	167947479	167947616	DNA/hAT-Charlie	597	+	68	167947547	86654
chr6	167860893	168060893	harbor1	chr6	167958938	167959119	DNA/hAT-Charlie	467	+	90	167959028	98135
chr6	124862446	125062446	harbor1	chr6	124889605	124889781	DNA/hAT-Charlie	815	+	88	124889693	27247
chr6	124862446	125062446	harbor1	chr6	124899014	124899144	DNA/hAT-Charlie	718	+	65	124899079	36633
chr6	124862446	125062446	harbor1	chr6	124899122	124899834	DNA/hAT-Charlie	2647	+	356	124899478	37032
chr6	139275129	139475129	harbor1	chr6	139286578	139287057	DNA/hAT-Charlie	3411	+	240	139286818	11689
chr6	111111942	111311942	harbor1	chr6	111173441	111173965	DNA/hAT-Charlie	3880	+	262	111173703	61761
chr6	111111942	111311942	harbor1	chr6	111204661	111204853	DNA/hAT-Charlie	468	+	96	111204757	92815
chr6	139275116	139475116	harbor1	chr6	139286578	139287057	DNA/hAT-Charlie	3411	+	240	139286818	11702
chr6	31901468	32101468	harbor1	chr6	31910544	31910698	DNA/hAT-Charlie	792	+	77	31910621	9153
chr6	31901468	32101468	harbor1	chr6	31911334	31911529	DNA/hAT-Charlie	792	+	98	31911432	9964
chr6	41091918	41291918	harbor1	chr6	41103757	41103874	DNA/hAT-Charlie	532	+	58	41103815	11897
chr6	41091918	41291918	harbor1	chr6	41182386	41182548	DNA/hAT-Charlie	661	+	81	41182467	90549
chr6	31996234	32196234	harbor1	chr6	32055615	32055741	DNA/hAT-Charlie	592	+	63	32055678	59444
chr6	31996234	32196234	harbor1	chr6	32072367	32072687	DNA/hAT-Charlie	1597	+	160	32072527	76293
chr6	31996234	32196234	harbor1	chr6	32072968	32073081	DNA/hAT-Charlie	1597	+	56	32073024	76790
chr6	34138141	34338141	harbor1	chr6	34155435	34155523	DNA/hAT-Charlie	494	+	44	34155479	17338
chr6	34138141	34338141	harbor1	chr6	34155648	34155720	DNA/hAT-Charlie	494	+	36	34155684	17543
chr6	73362002	73562002	harbor1	chr6	73368167	73368343	DNA/hAT-Charlie	650	+	88	73368255	6253
chr6	73362002	73562002	harbor1	chr6	73404921	73405078	DNA/hAT-Charlie	519	+	78	73404999	42997
chr6	208571	408571	harbor1	chr6	259600	259820	DNA/hAT-Charlie	1556	+	110	259710	51139
chr6	208571	408571	harbor1	chr6	288906	289065	DNA/hAT-Charlie	795	+	80	288986	80415
chr6	63473420	63673420	harbor1	chr6	63473945	63474326	DNA/hAT-Charlie	855	+	190	63474135	715
chr6	63473420	63673420	harbor1	chr6	63474629	63474639	DNA/hAT-Charlie	855	+	5	63474634	1214
chr6	63473420	63673420	harbor1	chr6	63474914	63475175	DNA/hAT-Charlie	855	+	130	63475044	1624
chr6	63473420	63673420	harbor1	chr6	63523655	63523840	DNA/hAT-Charlie	1155	+	92	63523747	50327
chr6	63473420	63673420	harbor1	chr6	63537218	63537375	DNA/hAT-Charlie	727	+	78	63537296	63876
chr6	167863263	168063263	harbor1	chr6	167947479	167947616	DNA/hAT-Charlie	597	+	68	167947547	84284
chr6	167863263	168063263	harbor1	chr6	167958938	167959119	DNA/hAT-Charlie	467	+	90	167959028	95765
chr6	145635082	145835082	harbor1	chr6	145649659	145649876	DNA/hAT-Charlie	1132	+	108	145649767	14685
chr6	145635082	145835082	harbor1	chr6	145715525	145716043	DNA/hAT-Charlie	3236	+	259	145715784	80702
chr6	27415340	27615340	harbor1	chr6	27439048	27439175	DNA/hAT-Charlie	463	+	64	27439112	23772
chr6	27415340	27615340	harbor1	chr6	27514477	27514696	DNA/hAT-Charlie	1204	+	110	27514587	99247
chr6	87813618	88013618	harbor1	chr6	87886697	87886854	DNA/hAT-Charlie	731	+	78	87886775	73157
chr6	63535819	63735819	harbor1	chr6	63537218	63537375	DNA/hAT-Charlie	727	+	78	63537296	1477
chr6	158719384	158919384	harbor1	chr6	158724520	158724704	DNA/hAT-Charlie	721	+	92	158724612	5228
chr6	158719384	158919384	harbor1	chr6	158759491	158759525	DNA/hAT-Charlie	1267	+	17	158759508	40124
chr6	158719384	158919384	harbor1	chr6	158759831	158760001	DNA/hAT-Charlie	1267	+	85	158759916	40532
chr6	32050380	32250380	harbor1	chr6	32055615	32055741	DNA/hAT-Charlie	592	+	63	32055678	5298
chr6	32050380	32250380	harbor1	chr6	32072367	32072687	DNA/hAT-Charlie	1597	+	160	32072527	22147
chr6	32050380	32250380	harbor1	chr6	32072968	32073081	DNA/hAT-Charlie	1597	+	56	32073024	22644
chr6	169863974	170063974	harbor1	chr6	169894576	169894908	DNA/hAT-Charlie	1944	+	166	169894742	30768
chr6	169863974	170063974	harbor1	chr6	169955699	169955875	DNA/hAT-Charlie	476	+	88	169955787	91813
chr6	52184773	52384773	harbor1	chr6	52192515	52192805	DNA/hAT-Charlie	925	+	145	52192660	7887
chr6	52184773	52384773	harbor1	chr6	52253158	52253324	DNA/hAT-Charlie	734	+	83	52253241	68468
chr6	52184773	52384773	harbor1	chr6	52256061	52256301	DNA/hAT-Charlie	1513	+	120	52256181	71408
chr7	28080201	28280201	harbor1	chr7	28128168	28128241	DNA/hAT-Charlie	815	+	36	28128204	48003
chr7	28080201	28280201	harbor1	chr7	28128536	28128653	DNA/hAT-Charlie	815	+	58	28128594	48393
chr7	28080201	28280201	harbor1	chr7	28160036	28160248	DNA/hAT-Charlie	701	+	106	28160142	79941
chr7	28080201	28280201	harbor1	chr7	28168039	28168100	DNA/hAT-Charlie	718	+	30	28168069	87868
chr7	28080201	28280201	harbor1	chr7	28168404	28168639	DNA/hAT-Charlie	718	+	118	28168522	88321
chr7	50203946	50403946	harbor1	chr7	50219211	50219336	DNA/hAT-Charlie	562	+	62	50219273	15327
chr7	1801883	2001883	harbor1	chr7	1810204	1810449	DNA/hAT-Charlie	603	+	122	1810326	8443
chr7	1801883	2001883	harbor1	chr7	1877177	1877378	DNA/hAT-Charlie	922	+	100	1877277	75394
chr7	130391130	130591130	harbor1	chr7	130404844	130406251	DNA/hAT-Charlie	5701	+	704	130405548	14418
chr7	130391130	130591130	harbor1	chr7	130431870	130432082	DNA/hAT-Charlie	1054	+	106	130431976	40846
chr7	151420770	151620770	harbor1	chr7	151425977	151426142	DNA/hAT-Charlie	498	+	82	151426059	5289
chr7	151420770	151620770	harbor1	chr7	151459107	151459446	DNA/hAT-Charlie	2318	+	170	151459277	38507
chr7	151420770	151620770	harbor1	chr7	151476277	151476375	DNA/hAT-Charlie	475	+	49	151476326	55556
chr7	151420770	151620770	harbor1	chr7	151487847	151488343	DNA/hAT-Charlie	1254	+	248	151488095	67325
chr7	151420770	151620770	harbor1	chr7	151497266	151497428	DNA/hAT-Charlie	488	+	81	151497347	76577
chr7	151420770	151620770	harbor1	chr7	151508389	151508633	DNA/hAT-Charlie	748	+	122	151508511	87741
chr7	151420770	151620770	harbor1	chr7	151509654	151509988	DNA/hAT-Charlie	1602	+	167	151509821	89051
chr7	151420770	151620770	harbor1	chr7	151512770	151513766	DNA/hAT-Charlie	4245	+	498	151513268	92498
chr7	28080214	28280214	harbor1	chr7	28128168	28128241	DNA/hAT-Charlie	815	+	36	28128204	47990
chr7	28080214	28280214	harbor1	chr7	28128536	28128653	DNA/hAT-Charlie	815	+	58	28128594	48380
chr7	28080214	28280214	harbor1	chr7	28160036	28160248	DNA/hAT-Charlie	701	+	106	28160142	79928
chr7	28080214	28280214	harbor1	chr7	28168039	28168100	DNA/hAT-Charlie	718	+	30	28168069	87855
chr7	28080214	28280214	harbor1	chr7	28168404	28168639	DNA/hAT-Charlie	718	+	118	28168522	88308
chr7	1312721	1512721	harbor1	chr7	1315376	1315537	DNA/hAT-Charlie	724	+	80	1315456	2735
chr7	1312721	1512721	harbor1	chr7	1315853	1315953	DNA/hAT-Charlie	724	+	50	1315903	3182
chr7	1136759	1336759	harbor1	chr7	1191328	1191438	DNA/hAT-Charlie	3358	+	55	1191383	54624
chr7	1136759	1336759	harbor1	chr7	1191736	1192161	DNA/hAT-Charlie	3358	+	212	1191948	55189
chr7	39729557	39929557	harbor1	chr7	39749752	39749975	DNA/hAT-Charlie	775	+	112	39749864	20307
chr7	39729557	39929557	harbor1	chr7	39750462	39750788	DNA/hAT-Charlie	1608	+	163	39750625	21068
chr7	39729557	39929557	harbor1	chr7	39781866	39782297	DNA/hAT-Charlie	2916	+	216	39782082	52525
chr7	39729557	39929557	harbor1	chr7	39791315	39791732	DNA/hAT-Charlie	2536	+	208	39791523	61966
chr7	130568057	130768057	harbor1	chr7	130619133	130619334	DNA/hAT-Charlie	832	+	100	130619233	51176
chr7	50203894	50403894	harbor1	chr7	50219211	50219336	DNA/hAT-Charlie	562	+	62	50219273	15379
chr7	1798159	1998159	harbor1	chr7	1810204	1810449	DNA/hAT-Charlie	603	+	122	1810326	12167
chr7	1798159	1998159	harbor1	chr7	1877177	1877378	DNA/hAT-Charlie	922	+	100	1877277	79118
chr7	128305676	128505676	harbor1	chr7	128322295	128322679	DNA/hAT-Charlie	632	+	192	128322487	16811
chr7	28080184	28280184	harbor1	chr7	28128168	28128241	DNA/hAT-Charlie	815	+	36	28128204	48020
chr7	28080184	28280184	harbor1	chr7	28128536	28128653	DNA/hAT-Charlie	815	+	58	28128594	48410
chr7	28080184	28280184	harbor1	chr7	28160036	28160248	DNA/hAT-Charlie	701	+	106	28160142	79958
chr7	28080184	28280184	harbor1	chr7	28168039	28168100	DNA/hAT-Charlie	718	+	30	28168069	87885
chr7	28080184	28280184	harbor1	chr7	28168404	28168639	DNA/hAT-Charlie	718	+	118	28168522	88338
chr7	1293735	1493735	harbor1	chr7	1315376	1315537	DNA/hAT-Charlie	724	+	80	1315456	21721
chr7	1293735	1493735	harbor1	chr7	1315853	1315953	DNA/hAT-Charlie	724	+	50	1315903	22168
chr7	50283638	50483638	harbor1	chr7	50329413	50329613	DNA/hAT-Charlie	646	+	100	50329513	45875
chr7	50283638	50483638	harbor1	chr7	50367114	50367220	DNA/hAT-Charlie	517	+	53	50367167	83529
chr7	884561	1084561	harbor1	chr7	939084	939221	DNA/hAT-Charlie	587	+	68	939152	54591
chr7	884561	1084561	harbor1	chr7	939518	939547	DNA/hAT-Charlie	587	+	14	939532	54971
chr7	149613875	149813875	harbor1	chr7	149620151	149620369	DNA/hAT-Charlie	926	+	109	149620260	6385
chr7	149613875	149813875	harbor1	chr7	149705574	149705789	DNA/hAT-Charlie	848	+	108	149705682	91807
chr7	149613875	149813875	harbor1	chr7	149713156	149713516	DNA/hAT-Charlie	1626	+	180	149713336	99461
chr7	123649229	123849229	harbor1	chr7	123658761	123658931	DNA/hAT-Charlie	621	+	85	123658846	9617
chr7	123649229	123849229	harbor1	chr7	123691341	123691669	DNA/hAT-Charlie	1212	+	164	123691505	42276
chr7	123649229	123849229	harbor1	chr7	123738599	123738737	DNA/hAT-Charlie	451	+	69	123738668	89439
chr7	50204667	50404667	harbor1	chr7	50219211	50219336	DNA/hAT-Charlie	562	+	62	50219273	14606
chr7	44506818	44706818	harbor1	chr7	44537987	44538127	DNA/hAT-Charlie	697	+	70	44538057	31239
chr7	44506818	44706818	harbor1	chr7	44585107	44585344	DNA/hAT-Charlie	1081	+	118	44585225	78407
chr7	44506818	44706818	harbor1	chr7	44586021	44586196	DNA/hAT-Charlie	1217	+	88	44586109	79291
chr7	28080180	28280180	harbor1	chr7	28128168	28128241	DNA/hAT-Charlie	815	+	36	28128204	48024
chr7	28080180	28280180	harbor1	chr7	28128536	28128653	DNA/hAT-Charlie	815	+	58	28128594	48414
chr7	28080180	28280180	harbor1	chr7	28160036	28160248	DNA/hAT-Charlie	701	+	106	28160142	79962
chr7	28080180	28280180	harbor1	chr7	28168039	28168100	DNA/hAT-Charlie	718	+	30	28168069	87889
chr7	28080180	28280180	harbor1	chr7	28168404	28168639	DNA/hAT-Charlie	718	+	118	28168522	88342
chr7	123649386	123849386	harbor1	chr7	123658761	123658931	DNA/hAT-Charlie	621	+	85	123658846	9460
chr7	123649386	123849386	harbor1	chr7	123691341	123691669	DNA/hAT-Charlie	1212	+	164	123691505	42119
chr7	123649386	123849386	harbor1	chr7	123738599	123738737	DNA/hAT-Charlie	451	+	69	123738668	89282
chr7	41324284	41524284	harbor1	chr7	41332725	41332949	DNA/hAT-Charlie	732	+	112	41332837	8553
chr7	41324284	41524284	harbor1	chr7	41349879	41350406	DNA/hAT-Charlie	3752	+	264	41350143	25859
chr7	50203975	50403975	harbor1	chr7	50219211	50219336	DNA/hAT-Charlie	562	+	62	50219273	15298
chr7	6404408	6604408	harbor1	chr7	6473444	6473709	DNA/hAT-Charlie	498	+	132	6473576	69168
chr7	28080194	28280194	harbor1	chr7	28128168	28128241	DNA/hAT-Charlie	815	+	36	28128204	48010
chr7	28080194	28280194	harbor1	chr7	28128536	28128653	DNA/hAT-Charlie	815	+	58	28128594	48400
chr7	28080194	28280194	harbor1	chr7	28160036	28160248	DNA/hAT-Charlie	701	+	106	28160142	79948
chr7	28080194	28280194	harbor1	chr7	28168039	28168100	DNA/hAT-Charlie	718	+	30	28168069	87875
chr7	28080194	28280194	harbor1	chr7	28168404	28168639	DNA/hAT-Charlie	718	+	118	28168522	88328
chr7	123649293	123849293	harbor1	chr7	123658761	123658931	DNA/hAT-Charlie	621	+	85	123658846	9553
chr7	123649293	123849293	harbor1	chr7	123691341	123691669	DNA/hAT-Charlie	1212	+	164	123691505	42212
chr7	123649293	123849293	harbor1	chr7	123738599	123738737	DNA/hAT-Charlie	451	+	69	123738668	89375
chr7	155249500	155449500	harbor1	chr7	155253439	155253599	DNA/hAT-Charlie	589	+	80	155253519	4019
chr7	155249500	155449500	harbor1	chr7	155276522	155276672	DNA/hAT-Charlie	497	+	75	155276597	27097
chr7	140597158	140797158	harbor1	chr7	140652140	140652197	DNA/hAT-Charlie	795	+	28	140652168	55010
chr7	140597158	140797158	harbor1	chr7	140652508	140652560	DNA/hAT-Charlie	795	+	26	140652534	55376
chr7	140597158	140797158	harbor1	chr7	140653226	140653364	DNA/hAT-Charlie	795	+	69	140653295	56137
chr7	140597158	140797158	harbor1	chr7	140655197	140655359	DNA/hAT-Charlie	834	+	81	140655278	58120
chr7	140597158	140797158	harbor1	chr7	140683677	140683833	DNA/hAT-Charlie	708	+	78	140683755	86597
chr7	28080212	28280212	harbor1	chr7	28128168	28128241	DNA/hAT-Charlie	815	+	36	28128204	47992
chr7	28080212	28280212	harbor1	chr7	28128536	28128653	DNA/hAT-Charlie	815	+	58	28128594	48382
chr7	28080212	28280212	harbor1	chr7	28160036	28160248	DNA/hAT-Charlie	701	+	106	28160142	79930
chr7	28080212	28280212	harbor1	chr7	28168039	28168100	DNA/hAT-Charlie	718	+	30	28168069	87857
chr7	28080212	28280212	harbor1	chr7	28168404	28168639	DNA/hAT-Charlie	718	+	118	28168522	88310
chr7	1798568	1998568	harbor1	chr7	1810204	1810449	DNA/hAT-Charlie	603	+	122	1810326	11758
chr7	1798568	1998568	harbor1	chr7	1877177	1877378	DNA/hAT-Charlie	922	+	100	1877277	78709
chr7	65651047	65851047	harbor1	chr7	65660855	65661186	DNA/hAT-Charlie	1949	+	166	65661021	9974
chr7	65651047	65851047	harbor1	chr7	65699186	65699386	DNA/hAT-Charlie	1130	+	100	65699286	48239
chr7	65651047	65851047	harbor1	chr7	65705360	65705683	DNA/hAT-Charlie	1250	+	162	65705522	54475
chr7	65651047	65851047	harbor1	chr7	65719864	65720040	DNA/hAT-Charlie	458	+	88	65719952	68905
chr7	65651047	65851047	harbor1	chr7	65683445	65683609	DNA/hAT-Charlie	501	+	82	65683527	32480
chr7	77912395	78112395	harbor1	chr7	77969070	77969363	DNA/hAT-Charlie	1102	+	146	77969216	56821
chr7	77912395	78112395	harbor1	chr7	77978655	77978776	DNA/hAT-Charlie	917	+	60	77978715	66320
chr7	77912395	78112395	harbor1	chr7	77979080	77979270	DNA/hAT-Charlie	917	+	95	77979175	66780
chr7	77912395	78112395	harbor1	chr7	78001097	78001247	DNA/hAT-Charlie	753	+	75	78001172	88777
chr7	77912395	78112395	harbor1	chr7	78002057	78002184	DNA/hAT-Charlie	676	+	64	78002121	89726
chr7	28080187	28280187	harbor1	chr7	28128168	28128241	DNA/hAT-Charlie	815	+	36	28128204	48017
chr7	28080187	28280187	harbor1	chr7	28128536	28128653	DNA/hAT-Charlie	815	+	58	28128594	48407
chr7	28080187	28280187	harbor1	chr7	28160036	28160248	DNA/hAT-Charlie	701	+	106	28160142	79955
chr7	28080187	28280187	harbor1	chr7	28168039	28168100	DNA/hAT-Charlie	718	+	30	28168069	87882
chr7	28080187	28280187	harbor1	chr7	28168404	28168639	DNA/hAT-Charlie	718	+	118	28168522	88335
chr7	65982514	66182514	harbor1	chr7	66001705	66001807	DNA/hAT-Charlie	522	+	51	66001756	19242
chr7	65982514	66182514	harbor1	chr7	66003468	66003670	DNA/hAT-Charlie	765	+	101	66003569	21055
chr7	123610933	123810933	harbor1	chr7	123658761	123658931	DNA/hAT-Charlie	621	+	85	123658846	47913
chr7	123610933	123810933	harbor1	chr7	123691341	123691669	DNA/hAT-Charlie	1212	+	164	123691505	80572
chr7	1801969	2001969	harbor1	chr7	1810204	1810449	DNA/hAT-Charlie	603	+	122	1810326	8357
chr7	1801969	2001969	harbor1	chr7	1877177	1877378	DNA/hAT-Charlie	922	+	100	1877277	75308
chr7	123649263	123849263	harbor1	chr7	123658761	123658931	DNA/hAT-Charlie	621	+	85	123658846	9583
chr7	123649263	123849263	harbor1	chr7	123691341	123691669	DNA/hAT-Charlie	1212	+	164	123691505	42242
chr7	123649263	123849263	harbor1	chr7	123738599	123738737	DNA/hAT-Charlie	451	+	69	123738668	89405
chr7	155231815	155431815	harbor1	chr7	155253439	155253599	DNA/hAT-Charlie	589	+	80	155253519	21704
chr7	155231815	155431815	harbor1	chr7	155276522	155276672	DNA/hAT-Charlie	497	+	75	155276597	44782
chr7	1564241	1764241	harbor1	chr7	1616519	1616696	DNA/hAT-Charlie	530	+	88	1616607	52366
chr7	50203887	50403887	harbor1	chr7	50219211	50219336	DNA/hAT-Charlie	562	+	62	50219273	15386
chr7	150941267	151141267	harbor1	chr7	150960522	150960687	DNA/hAT-Charlie	466	+	82	150960604	19337
chr7	150941267	151141267	harbor1	chr7	151021441	151021650	DNA/hAT-Charlie	613	+	104	151021545	80278
chr7	150941267	151141267	harbor1	chr7	151021949	151021980	DNA/hAT-Charlie	613	+	16	151021965	80698
chr7	80035348	80235348	harbor1	chr7	80035243	80035408	DNA/hAT-Charlie	1034	+	82	80035325	23
chr7	80035348	80235348	harbor1	chr7	80088786	80088992	DNA/hAT-Charlie	961	+	103	80088889	53541
chr7	80035348	80235348	harbor1	chr7	80109296	80109460	DNA/hAT-Charlie	793	+	82	80109378	74030
chr7	80035348	80235348	harbor1	chr7	80121151	80121298	DNA/hAT-Charlie	544	+	74	80121225	85877
chr7	80035348	80235348	harbor1	chr7	80121793	80121988	DNA/hAT-Charlie	595	+	98	80121891	86543
chr7	90221478	90421478	harbor1	chr7	90224649	90224800	DNA/hAT-Charlie	718	+	76	90224725	3247
chr7	90221478	90421478	harbor1	chr7	90241514	90241692	DNA/hAT-Charlie	821	+	89	90241603	20125
chr7	90221478	90421478	harbor1	chr7	90259978	90260194	DNA/hAT-Charlie	1377	+	108	90260086	38608
chr7	90221478	90421478	harbor1	chr7	90271176	90271388	DNA/hAT-Charlie	831	+	106	90271282	49804
chr7	90221478	90421478	harbor1	chr7	90304237	90304356	DNA/hAT-Charlie	740	+	60	90304297	82819
chr7	123649244	123849244	harbor1	chr7	123658761	123658931	DNA/hAT-Charlie	621	+	85	123658846	9602
chr7	123649244	123849244	harbor1	chr7	123691341	123691669	DNA/hAT-Charlie	1212	+	164	123691505	42261
chr7	123649244	123849244	harbor1	chr7	123738599	123738737	DNA/hAT-Charlie	451	+	69	123738668	89424
chr7	100698745	100898745	harbor1	chr7	100729084	100729212	DNA/hAT-Charlie	431	+	64	100729148	30403
chr7	1226149	1426149	harbor1	chr7	1281286	1281514	DNA/hAT-Charlie	644	+	114	1281400	55251
chr7	1226149	1426149	harbor1	chr7	1315376	1315537	DNA/hAT-Charlie	724	+	80	1315456	89307
chr7	1226149	1426149	harbor1	chr7	1315853	1315953	DNA/hAT-Charlie	724	+	50	1315903	89754
chr7	127292503	127492503	harbor1	chr7	127337364	127337588	DNA/hAT-Charlie	876	+	112	127337476	44973
chr7	127292503	127492503	harbor1	chr7	127359968	127360121	DNA/hAT-Charlie	651	+	76	127360044	67541
chr7	128101419	128301419	harbor1	chr7	128101665	128101834	DNA/hAT-Charlie	600	+	84	128101749	330
chr7	128101419	128301419	harbor1	chr7	128104830	128104903	DNA/hAT-Charlie	787	+	36	128104866	3447
chr7	128101419	128301419	harbor1	chr7	128105196	128105290	DNA/hAT-Charlie	787	+	47	128105243	3824
chr7	128101419	128301419	harbor1	chr7	128153072	128153265	DNA/hAT-Charlie	1220	+	96	128153168	51749
chr7	128101419	128301419	harbor1	chr7	128153574	128153703	DNA/hAT-Charlie	1220	+	64	128153638	52219
chr7	128101419	128301419	harbor1	chr7	128155924	128156048	DNA/hAT-Charlie	1004	+	62	128155986	54567
chr7	128101419	128301419	harbor1	chr7	128156383	128156427	DNA/hAT-Charlie	1004	+	22	128156405	54986
chr7	128101419	128301419	harbor1	chr7	128156741	128156781	DNA/hAT-Charlie	1004	+	20	128156761	55342
chr7	128101419	128301419	harbor1	chr7	128176043	128176158	DNA/hAT-Charlie	684	+	58	128176101	74682
chr7	128101419	128301419	harbor1	chr7	128178966	128179148	DNA/hAT-Charlie	1433	+	91	128179057	77638
chr7	128101419	128301419	harbor1	chr7	128179455	128179578	DNA/hAT-Charlie	1433	+	62	128179517	78098
chr7	128101419	128301419	harbor1	chr7	128179705	128180120	DNA/hAT-Charlie	1433	+	208	128179913	78494
chr7	123649264	123849264	harbor1	chr7	123658761	123658931	DNA/hAT-Charlie	621	+	85	123658846	9582
chr7	123649264	123849264	harbor1	chr7	123691341	123691669	DNA/hAT-Charlie	1212	+	164	123691505	42241
chr7	123649264	123849264	harbor1	chr7	123738599	123738737	DNA/hAT-Charlie	451	+	69	123738668	89404
chr7	1801933	2001933	harbor1	chr7	1810204	1810449	DNA/hAT-Charlie	603	+	122	1810326	8393
chr7	1801933	2001933	harbor1	chr7	1877177	1877378	DNA/hAT-Charlie	922	+	100	1877277	75344
chr7	151420775	151620775	harbor1	chr7	151425977	151426142	DNA/hAT-Charlie	498	+	82	151426059	5284
chr7	151420775	151620775	harbor1	chr7	151459107	151459446	DNA/hAT-Charlie	2318	+	170	151459277	38502
chr7	151420775	151620775	harbor1	chr7	151476277	151476375	DNA/hAT-Charlie	475	+	49	151476326	55551
chr7	151420775	151620775	harbor1	chr7	151487847	151488343	DNA/hAT-Charlie	1254	+	248	151488095	67320
chr7	151420775	151620775	harbor1	chr7	151497266	151497428	DNA/hAT-Charlie	488	+	81	151497347	76572
chr7	151420775	151620775	harbor1	chr7	151508389	151508633	DNA/hAT-Charlie	748	+	122	151508511	87736
chr7	151420775	151620775	harbor1	chr7	151509654	151509988	DNA/hAT-Charlie	1602	+	167	151509821	89046
chr7	151420775	151620775	harbor1	chr7	151512770	151513766	DNA/hAT-Charlie	4245	+	498	151513268	92493
chr7	123437338	123637338	harbor1	chr7	123498207	123498352	DNA/hAT-Charlie	625	+	72	123498279	60941
chr7	141411856	141611856	harbor1	chr7	141440298	141440401	DNA/hAT-Charlie	464	+	52	141440350	28494
chr7	141411856	141611856	harbor1	chr7	141468191	141468328	DNA/hAT-Charlie	691	+	68	141468259	56403
chr7	141411856	141611856	harbor1	chr7	141484337	141484484	DNA/hAT-Charlie	771	+	74	141484411	72555
chr7	28080189	28280189	harbor1	chr7	28128168	28128241	DNA/hAT-Charlie	815	+	36	28128204	48015
chr7	28080189	28280189	harbor1	chr7	28128536	28128653	DNA/hAT-Charlie	815	+	58	28128594	48405
chr7	28080189	28280189	harbor1	chr7	28160036	28160248	DNA/hAT-Charlie	701	+	106	28160142	79953
chr7	28080189	28280189	harbor1	chr7	28168039	28168100	DNA/hAT-Charlie	718	+	30	28168069	87880
chr7	28080189	28280189	harbor1	chr7	28168404	28168639	DNA/hAT-Charlie	718	+	118	28168522	88333
chr7	26995642	27195642	harbor1	chr7	27054392	27054567	DNA/hAT-Charlie	520	+	88	27054480	58838
chr7	102378973	102578973	harbor1	chr7	102477237	102477410	DNA/hAT-Charlie	879	+	86	102477323	98350
chr7	105288909	105488909	harbor1	chr7	105317075	105317583	DNA/hAT-Charlie	1689	+	254	105317329	28420
chr7	105288909	105488909	harbor1	chr7	105317610	105317763	DNA/hAT-Charlie	1116	+	76	105317686	28777
chr7	105288909	105488909	harbor1	chr7	105318057	105318101	DNA/hAT-Charlie	1116	+	22	105318079	29170
chr7	105288909	105488909	harbor1	chr7	105318395	105318560	DNA/hAT-Charlie	1116	+	82	105318477	29568
chr7	105288909	105488909	harbor1	chr7	105327188	105327459	DNA/hAT-Charlie	1337	+	136	105327324	38415
chr7	105288909	105488909	harbor1	chr7	105339743	105339778	DNA/hAT-Charlie	1815	+	18	105339761	50852
chr7	105288909	105488909	harbor1	chr7	105340082	105340389	DNA/hAT-Charlie	1815	+	154	105340236	51327
chr7	105288909	105488909	harbor1	chr7	105340744	105341032	DNA/hAT-Charlie	1815	+	144	105340888	51979
chr7	25270046	25470046	harbor1	chr7	25273207	25273440	DNA/hAT-Charlie	1023	+	116	25273323	3277
chr7	25270046	25470046	harbor1	chr7	25282593	25282769	DNA/hAT-Charlie	664	+	88	25282681	12635
chr7	25270046	25470046	harbor1	chr7	25294748	25294970	DNA/hAT-Charlie	1211	+	111	25294859	24813
chr7	25270046	25470046	harbor1	chr7	25310063	25310146	DNA/hAT-Charlie	577	+	42	25310105	40059
chr7	25270046	25470046	harbor1	chr7	25330626	25330828	DNA/hAT-Charlie	1080	+	101	25330727	60681
chr7	6060488	6260488	harbor1	chr7	6112656	6112846	DNA/hAT-Charlie	1291	+	95	6112751	52263
chr7	6060488	6260488	harbor1	chr7	6138586	6138905	DNA/hAT-Charlie	2088	+	160	6138746	78258
chr7	6060488	6260488	harbor1	chr7	6158012	6158338	DNA/hAT-Charlie	1016	+	163	6158175	97687
chr7	25697532	25897532	harbor1	chr7	25722121	25722387	DNA/hAT-Charlie	578	+	133	25722254	24722
chr7	25697532	25897532	harbor1	chr7	25779003	25779140	DNA/hAT-Charlie	524	+	68	25779071	81539
chr7	25697532	25897532	harbor1	chr7	25779511	25779568	DNA/hAT-Charlie	524	+	28	25779539	82007
chr7	25697532	25897532	harbor1	chr7	25785834	25785921	DNA/hAT-Charlie	467	+	44	25785878	88346
chr7	25697532	25897532	harbor1	chr7	25789368	25789483	DNA/hAT-Charlie	433	+	58	25789426	91894
chr7	1312753	1512753	harbor1	chr7	1315376	1315537	DNA/hAT-Charlie	724	+	80	1315456	2703
chr7	1312753	1512753	harbor1	chr7	1315853	1315953	DNA/hAT-Charlie	724	+	50	1315903	3150
chr7	1312775	1512775	harbor1	chr7	1315376	1315537	DNA/hAT-Charlie	724	+	80	1315456	2681
chr7	1312775	1512775	harbor1	chr7	1315853	1315953	DNA/hAT-Charlie	724	+	50	1315903	3128
chr7	504701	704701	harbor1	chr7	524204	524423	DNA/hAT-Charlie	734	+	110	524314	19613
chr7	16531	216531	harbor1	chr7	58541	58760	DNA/hAT-Charlie	1281	+	110	58651	42120
chr7	16531	216531	harbor1	chr7	93409	93710	DNA/hAT-Charlie	1506	+	150	93559	77028
chr7	108470160	108670160	harbor1	chr7	108474929	108475396	DNA/hAT-Charlie	3214	+	234	108475163	5003
chr7	108470160	108670160	harbor1	chr7	108526799	108527038	DNA/hAT-Charlie	708	+	120	108526919	56759
chr7	108470160	108670160	harbor1	chr7	108551700	108551878	DNA/hAT-Charlie	764	+	89	108551789	81629
chr7	1312762	1512762	harbor1	chr7	1315376	1315537	DNA/hAT-Charlie	724	+	80	1315456	2694
chr7	1312762	1512762	harbor1	chr7	1315853	1315953	DNA/hAT-Charlie	724	+	50	1315903	3141
chr7	123649335	123849335	harbor1	chr7	123658761	123658931	DNA/hAT-Charlie	621	+	85	123658846	9511
chr7	123649335	123849335	harbor1	chr7	123691341	123691669	DNA/hAT-Charlie	1212	+	164	123691505	42170
chr7	123649335	123849335	harbor1	chr7	123738599	123738737	DNA/hAT-Charlie	451	+	69	123738668	89333
chr7	123649230	123849230	harbor1	chr7	123658761	123658931	DNA/hAT-Charlie	621	+	85	123658846	9616
chr7	123649230	123849230	harbor1	chr7	123691341	123691669	DNA/hAT-Charlie	1212	+	164	123691505	42275
chr7	123649230	123849230	harbor1	chr7	123738599	123738737	DNA/hAT-Charlie	451	+	69	123738668	89438
chr7	73478344	73678344	harbor1	chr7	73501482	73501644	DNA/hAT-Charlie	760	+	81	73501563	23219
chr7	73478344	73678344	harbor1	chr7	73512196	73512400	DNA/hAT-Charlie	1218	+	102	73512298	33954
chr7	1795705	1995705	harbor1	chr7	1810204	1810449	DNA/hAT-Charlie	603	+	122	1810326	14621
chr7	1795705	1995705	harbor1	chr7	1877177	1877378	DNA/hAT-Charlie	922	+	100	1877277	81572
chr7	123481083	123681083	harbor1	chr7	123498207	123498352	DNA/hAT-Charlie	625	+	72	123498279	17196
chr7	123481083	123681083	harbor1	chr7	123543415	123543610	DNA/hAT-Charlie	927	+	98	123543513	62430
chr7	123481083	123681083	harbor1	chr7	123554059	123554374	DNA/hAT-Charlie	1019	+	158	123554217	73134
chr7	155196997	155396997	harbor1	chr7	155204985	155205258	DNA/hAT-Charlie	914	+	136	155205121	8124
chr7	155196997	155396997	harbor1	chr7	155230015	155230187	DNA/hAT-Charlie	585	+	86	155230101	33104
chr7	155196997	155396997	harbor1	chr7	155253439	155253599	DNA/hAT-Charlie	589	+	80	155253519	56522
chr7	155196997	155396997	harbor1	chr7	155276522	155276672	DNA/hAT-Charlie	497	+	75	155276597	79600
chr7	884593	1084593	harbor1	chr7	939084	939221	DNA/hAT-Charlie	587	+	68	939152	54559
chr7	884593	1084593	harbor1	chr7	939518	939547	DNA/hAT-Charlie	587	+	14	939532	54939
chr7	32628791	32828791	harbor1	chr7	32636195	32636439	DNA/hAT-Charlie	580	+	122	32636317	7526
chr7	6059184	6259184	harbor1	chr7	6112656	6112846	DNA/hAT-Charlie	1291	+	95	6112751	53567
chr7	6059184	6259184	harbor1	chr7	6138586	6138905	DNA/hAT-Charlie	2088	+	160	6138746	79562
chr7	6059184	6259184	harbor1	chr7	6158012	6158338	DNA/hAT-Charlie	1016	+	163	6158175	98991
chr7	141411783	141611783	harbor1	chr7	141440298	141440401	DNA/hAT-Charlie	464	+	52	141440350	28567
chr7	141411783	141611783	harbor1	chr7	141468191	141468328	DNA/hAT-Charlie	691	+	68	141468259	56476
chr7	141411783	141611783	harbor1	chr7	141484337	141484484	DNA/hAT-Charlie	771	+	74	141484411	72628
chr7	30975839	31175839	harbor1	chr7	31030628	31030839	DNA/hAT-Charlie	884	+	106	31030734	54895
chr7	30975839	31175839	harbor1	chr7	31031360	31031412	DNA/hAT-Charlie	1119	+	26	31031386	55547
chr7	30975839	31175839	harbor1	chr7	31031703	31031930	DNA/hAT-Charlie	1119	+	114	31031817	55978
chr7	30975839	31175839	harbor1	chr7	31037361	31037525	DNA/hAT-Charlie	741	+	82	31037443	61604
chr7	30975839	31175839	harbor1	chr7	31049130	31049309	DNA/hAT-Charlie	619	+	90	31049220	73381
chr7	30975839	31175839	harbor1	chr7	31066599	31066767	DNA/hAT-Charlie	652	+	84	31066683	90844
chr7	30975839	31175839	harbor1	chr7	31068984	31069143	DNA/hAT-Charlie	433	+	80	31069064	93225
chr7	30579971	30779971	harbor1	chr7	30596964	30597508	DNA/hAT-Charlie	2465	+	272	30597236	17265
chr7	30579971	30779971	harbor1	chr7	30610083	30610283	DNA/hAT-Charlie	972	+	100	30610183	30212
chr7	30579971	30779971	harbor1	chr7	30624000	30624220	DNA/hAT-Charlie	1504	+	110	30624110	44139
chr7	30579971	30779971	harbor1	chr7	30633170	30633365	DNA/hAT-Charlie	839	+	98	30633268	53297
chr7	30579971	30779971	harbor1	chr7	30650926	30651636	DNA/hAT-Charlie	1809	+	355	30651281	71310
chr7	30579971	30779971	harbor1	chr7	30651867	30652110	DNA/hAT-Charlie	976	+	122	30651989	72018
chr7	30579971	30779971	harbor1	chr7	30662944	30663293	DNA/hAT-Charlie	802	+	174	30663118	83147
chr7	189947	389947	harbor1	chr7	247427	247567	DNA/hAT-Charlie	451	+	70	247497	57550
chr7	127133798	127333798	harbor1	chr7	127147986	127148112	DNA/hAT-Charlie	745	+	63	127148049	14251
chr7	127133798	127333798	harbor1	chr7	127213258	127213452	DNA/hAT-Charlie	833	+	97	127213355	79557
chr7	43919232	44119232	harbor1	chr7	43943353	43943578	DNA/hAT-Charlie	808	+	112	43943465	24233
chr7	43919232	44119232	harbor1	chr7	44017491	44017663	DNA/hAT-Charlie	878	+	86	44017577	98345
chr7	1312948	1512948	harbor1	chr7	1315376	1315537	DNA/hAT-Charlie	724	+	80	1315456	2508
chr7	1312948	1512948	harbor1	chr7	1315853	1315953	DNA/hAT-Charlie	724	+	50	1315903	2955
chr7	140378858	140578858	harbor1	chr7	140386507	140386767	DNA/hAT-Charlie	447	+	130	140386637	7779
chr7	140378858	140578858	harbor1	chr7	140422506	140422598	DNA/hAT-Charlie	464	+	46	140422552	43694
chr7	140378858	140578858	harbor1	chr7	140448924	140449012	DNA/hAT-Charlie	464	+	44	140448968	70110
chr7	44436448	44636448	harbor1	chr7	44462674	44462837	DNA/hAT-Charlie	617	+	82	44462756	26308
chr7	44436448	44636448	harbor1	chr7	44473139	44473259	DNA/hAT-Charlie	470	+	60	44473199	36751
chr7	122786849	122986849	harbor1	chr7	122814439	122814734	DNA/hAT-Charlie	1362	+	148	122814587	27738
chr7	90112306	90312306	harbor1	chr7	90154033	90154206	DNA/hAT-Charlie	755	+	86	90154119	41813
chr7	90112306	90312306	harbor1	chr7	90156436	90156776	DNA/hAT-Charlie	2272	+	170	90156606	44300
chr7	90112306	90312306	harbor1	chr7	90172520	90172706	DNA/hAT-Charlie	775	+	93	90172613	60307
chr7	90112306	90312306	harbor1	chr7	90172719	90172913	DNA/hAT-Charlie	1013	+	97	90172816	60510
chr7	1801912	2001912	harbor1	chr7	1810204	1810449	DNA/hAT-Charlie	603	+	122	1810326	8414
chr7	1801912	2001912	harbor1	chr7	1877177	1877378	DNA/hAT-Charlie	922	+	100	1877277	75365
chr7	123648388	123848388	harbor1	chr7	123658761	123658931	DNA/hAT-Charlie	621	+	85	123658846	10458
chr7	123648388	123848388	harbor1	chr7	123691341	123691669	DNA/hAT-Charlie	1212	+	164	123691505	43117
chr7	123648388	123848388	harbor1	chr7	123738599	123738737	DNA/hAT-Charlie	451	+	69	123738668	90280
chr7	1799784	1999784	harbor1	chr7	1810204	1810449	DNA/hAT-Charlie	603	+	122	1810326	10542
chr7	1799784	1999784	harbor1	chr7	1877177	1877378	DNA/hAT-Charlie	922	+	100	1877277	77493
chr7	123649270	123849270	harbor1	chr7	123658761	123658931	DNA/hAT-Charlie	621	+	85	123658846	9576
chr7	123649270	123849270	harbor1	chr7	123691341	123691669	DNA/hAT-Charlie	1212	+	164	123691505	42235
chr7	123649270	123849270	harbor1	chr7	123738599	123738737	DNA/hAT-Charlie	451	+	69	123738668	89398
chr7	1312758	1512758	harbor1	chr7	1315376	1315537	DNA/hAT-Charlie	724	+	80	1315456	2698
chr7	1312758	1512758	harbor1	chr7	1315853	1315953	DNA/hAT-Charlie	724	+	50	1315903	3145
chr7	1801263	2001263	harbor1	chr7	1810204	1810449	DNA/hAT-Charlie	603	+	122	1810326	9063
chr7	1801263	2001263	harbor1	chr7	1877177	1877378	DNA/hAT-Charlie	922	+	100	1877277	76014
chr7	123457458	123657458	harbor1	chr7	123498207	123498352	DNA/hAT-Charlie	625	+	72	123498279	40821
chr7	123457458	123657458	harbor1	chr7	123543415	123543610	DNA/hAT-Charlie	927	+	98	123543513	86055
chr7	123457458	123657458	harbor1	chr7	123554059	123554374	DNA/hAT-Charlie	1019	+	158	123554217	96759
chr7	123649311	123849311	harbor1	chr7	123658761	123658931	DNA/hAT-Charlie	621	+	85	123658846	9535
chr7	123649311	123849311	harbor1	chr7	123691341	123691669	DNA/hAT-Charlie	1212	+	164	123691505	42194
chr7	123649311	123849311	harbor1	chr7	123738599	123738737	DNA/hAT-Charlie	451	+	69	123738668	89357
chr7	1801911	2001911	harbor1	chr7	1810204	1810449	DNA/hAT-Charlie	603	+	122	1810326	8415
chr7	1801911	2001911	harbor1	chr7	1877177	1877378	DNA/hAT-Charlie	922	+	100	1877277	75366
chr7	47306156	47506156	harbor1	chr7	47356247	47356364	DNA/hAT-Charlie	444	+	58	47356305	50149
chr7	47306156	47506156	harbor1	chr7	47359610	47359816	DNA/hAT-Charlie	681	+	103	47359713	53557
chr7	1801805	2001805	harbor1	chr7	1810204	1810449	DNA/hAT-Charlie	603	+	122	1810326	8521
chr7	1801805	2001805	harbor1	chr7	1877177	1877378	DNA/hAT-Charlie	922	+	100	1877277	75472
chr8	38169171	38369171	harbor1	chr8	38180680	38180835	DNA/hAT-Charlie	811	+	78	38180758	11587
chr8	38169171	38369171	harbor1	chr8	38227898	38228102	DNA/hAT-Charlie	778	+	102	38228000	58829
chr8	38169171	38369171	harbor1	chr8	38229016	38229501	DNA/hAT-Charlie	2335	+	242	38229258	60087
chr8	38169171	38369171	harbor1	chr8	38229589	38229680	DNA/hAT-Charlie	432	+	46	38229635	60464
chr8	23428482	23628482	harbor1	chr8	23433605	23434009	DNA/hAT-Charlie	1649	+	202	23433807	5325
chr8	23428482	23628482	harbor1	chr8	23508419	23508518	DNA/hAT-Charlie	511	+	50	23508469	79987
chr8	23428482	23628482	harbor1	chr8	23512241	23512398	DNA/hAT-Charlie	723	+	78	23512319	83837
chr8	23428482	23628482	harbor1	chr8	23512395	23512524	DNA/hAT-Charlie	723	+	64	23512459	83977
chr8	23428482	23628482	harbor1	chr8	23514644	23514749	DNA/hAT-Charlie	621	+	52	23514696	86214
chr8	38169174	38369174	harbor1	chr8	38180680	38180835	DNA/hAT-Charlie	811	+	78	38180758	11584
chr8	38169174	38369174	harbor1	chr8	38227898	38228102	DNA/hAT-Charlie	778	+	102	38228000	58826
chr8	38169174	38369174	harbor1	chr8	38229016	38229501	DNA/hAT-Charlie	2335	+	242	38229258	60084
chr8	38169174	38369174	harbor1	chr8	38229589	38229680	DNA/hAT-Charlie	432	+	46	38229635	60461
chr8	18018925	18218925	harbor1	chr8	18051763	18051893	DNA/hAT-Charlie	463	+	65	18051828	32903
chr8	18018925	18218925	harbor1	chr8	18068544	18068717	DNA/hAT-Charlie	816	+	86	18068630	49705
chr8	23381169	23581169	harbor1	chr8	23417110	23417239	DNA/hAT-Charlie	641	+	64	23417174	36005
chr8	23381169	23581169	harbor1	chr8	23422576	23422683	DNA/hAT-Charlie	454	+	54	23422630	41461
chr8	23381169	23581169	harbor1	chr8	23433605	23434009	DNA/hAT-Charlie	1649	+	202	23433807	52638
chr8	23381133	23581133	harbor1	chr8	23417110	23417239	DNA/hAT-Charlie	641	+	64	23417174	36041
chr8	23381133	23581133	harbor1	chr8	23422576	23422683	DNA/hAT-Charlie	454	+	54	23422630	41497
chr8	23381133	23581133	harbor1	chr8	23433605	23434009	DNA/hAT-Charlie	1649	+	202	23433807	52674
chr8	23379942	23579942	harbor1	chr8	23417110	23417239	DNA/hAT-Charlie	641	+	64	23417174	37232
chr8	23379942	23579942	harbor1	chr8	23422576	23422683	DNA/hAT-Charlie	454	+	54	23422630	42688
chr8	23379942	23579942	harbor1	chr8	23433605	23434009	DNA/hAT-Charlie	1649	+	202	23433807	53865
chr8	23382754	23582754	harbor1	chr8	23417110	23417239	DNA/hAT-Charlie	641	+	64	23417174	34420
chr8	23382754	23582754	harbor1	chr8	23422576	23422683	DNA/hAT-Charlie	454	+	54	23422630	39876
chr8	23382754	23582754	harbor1	chr8	23433605	23434009	DNA/hAT-Charlie	1649	+	202	23433807	51053
chr8	23428976	23628976	harbor1	chr8	23433605	23434009	DNA/hAT-Charlie	1649	+	202	23433807	4831
chr8	23428976	23628976	harbor1	chr8	23508419	23508518	DNA/hAT-Charlie	511	+	50	23508469	79493
chr8	23428976	23628976	harbor1	chr8	23512241	23512398	DNA/hAT-Charlie	723	+	78	23512319	83343
chr8	23428976	23628976	harbor1	chr8	23512395	23512524	DNA/hAT-Charlie	723	+	64	23512459	83483
chr8	23428976	23628976	harbor1	chr8	23514644	23514749	DNA/hAT-Charlie	621	+	52	23514696	85720
chr8	85145898	85345898	harbor1	chr8	85159829	85160040	DNA/hAT-Charlie	850	+	106	85159935	14037
chr8	85145898	85345898	harbor1	chr8	85167608	85167710	DNA/hAT-Charlie	513	+	51	85167659	21761
chr8	85145898	85345898	harbor1	chr8	85168008	85168067	DNA/hAT-Charlie	513	+	30	85168038	22140
chr8	85145898	85345898	harbor1	chr8	85223835	85224142	DNA/hAT-Charlie	1291	+	154	85223989	78091
chr8	85145898	85345898	harbor1	chr8	85233279	85233419	DNA/hAT-Charlie	703	+	70	85233349	87451
chr8	85145898	85345898	harbor1	chr8	85234618	85234770	DNA/hAT-Charlie	512	+	76	85234694	88796
chr8	23428919	23628919	harbor1	chr8	23433605	23434009	DNA/hAT-Charlie	1649	+	202	23433807	4888
chr8	23428919	23628919	harbor1	chr8	23508419	23508518	DNA/hAT-Charlie	511	+	50	23508469	79550
chr8	23428919	23628919	harbor1	chr8	23512241	23512398	DNA/hAT-Charlie	723	+	78	23512319	83400
chr8	23428919	23628919	harbor1	chr8	23512395	23512524	DNA/hAT-Charlie	723	+	64	23512459	83540
chr8	23428919	23628919	harbor1	chr8	23514644	23514749	DNA/hAT-Charlie	621	+	52	23514696	85777
chr8	599970	799970	harbor1	chr8	632782	632971	DNA/hAT-Charlie	637	+	94	632876	32906
chr8	100620899	100820899	harbor1	chr8	100636424	100636712	DNA/hAT-Charlie	1705	+	144	100636568	15669
chr8	100620899	100820899	harbor1	chr8	100637021	100637057	DNA/hAT-Charlie	1705	+	18	100637039	16140
chr8	100620899	100820899	harbor1	chr8	100666242	100666889	DNA/hAT-Charlie	2361	+	324	100666566	45667
chr8	100620899	100820899	harbor1	chr8	100671473	100671635	DNA/hAT-Charlie	691	+	81	100671554	50655
chr8	100620899	100820899	harbor1	chr8	100703410	100703619	DNA/hAT-Charlie	630	+	104	100703514	82615
chr8	23428922	23628922	harbor1	chr8	23433605	23434009	DNA/hAT-Charlie	1649	+	202	23433807	4885
chr8	23428922	23628922	harbor1	chr8	23508419	23508518	DNA/hAT-Charlie	511	+	50	23508469	79547
chr8	23428922	23628922	harbor1	chr8	23512241	23512398	DNA/hAT-Charlie	723	+	78	23512319	83397
chr8	23428922	23628922	harbor1	chr8	23512395	23512524	DNA/hAT-Charlie	723	+	64	23512459	83537
chr8	23428922	23628922	harbor1	chr8	23514644	23514749	DNA/hAT-Charlie	621	+	52	23514696	85774
chr8	38169283	38369283	harbor1	chr8	38180680	38180835	DNA/hAT-Charlie	811	+	78	38180758	11475
chr8	38169283	38369283	harbor1	chr8	38227898	38228102	DNA/hAT-Charlie	778	+	102	38228000	58717
chr8	38169283	38369283	harbor1	chr8	38229016	38229501	DNA/hAT-Charlie	2335	+	242	38229258	59975
chr8	38169283	38369283	harbor1	chr8	38229589	38229680	DNA/hAT-Charlie	432	+	46	38229635	60352
chr8	23374002	23574002	harbor1	chr8	23417110	23417239	DNA/hAT-Charlie	641	+	64	23417174	43172
chr8	23374002	23574002	harbor1	chr8	23422576	23422683	DNA/hAT-Charlie	454	+	54	23422630	48628
chr8	23374002	23574002	harbor1	chr8	23433605	23434009	DNA/hAT-Charlie	1649	+	202	23433807	59805
chr8	23379952	23579952	harbor1	chr8	23417110	23417239	DNA/hAT-Charlie	641	+	64	23417174	37222
chr8	23379952	23579952	harbor1	chr8	23422576	23422683	DNA/hAT-Charlie	454	+	54	23422630	42678
chr8	23379952	23579952	harbor1	chr8	23433605	23434009	DNA/hAT-Charlie	1649	+	202	23433807	53855
chr8	38168881	38368881	harbor1	chr8	38180680	38180835	DNA/hAT-Charlie	811	+	78	38180758	11877
chr8	38168881	38368881	harbor1	chr8	38227898	38228102	DNA/hAT-Charlie	778	+	102	38228000	59119
chr8	38168881	38368881	harbor1	chr8	38229016	38229501	DNA/hAT-Charlie	2335	+	242	38229258	60377
chr8	38168881	38368881	harbor1	chr8	38229589	38229680	DNA/hAT-Charlie	432	+	46	38229635	60754
chr8	143715221	143915221	harbor1	chr8	143761389	143761487	DNA/hAT-Charlie	488	+	49	143761438	46217
chr8	143715221	143915221	harbor1	chr8	143761737	143762154	DNA/hAT-Charlie	488	+	208	143761945	46724
chr8	23428500	23628500	harbor1	chr8	23433605	23434009	DNA/hAT-Charlie	1649	+	202	23433807	5307
chr8	23428500	23628500	harbor1	chr8	23508419	23508518	DNA/hAT-Charlie	511	+	50	23508469	79969
chr8	23428500	23628500	harbor1	chr8	23512241	23512398	DNA/hAT-Charlie	723	+	78	23512319	83819
chr8	23428500	23628500	harbor1	chr8	23512395	23512524	DNA/hAT-Charlie	723	+	64	23512459	83959
chr8	23428500	23628500	harbor1	chr8	23514644	23514749	DNA/hAT-Charlie	621	+	52	23514696	86196
chr8	23409692	23609692	harbor1	chr8	23417110	23417239	DNA/hAT-Charlie	641	+	64	23417174	7482
chr8	23409692	23609692	harbor1	chr8	23422576	23422683	DNA/hAT-Charlie	454	+	54	23422630	12938
chr8	23409692	23609692	harbor1	chr8	23433605	23434009	DNA/hAT-Charlie	1649	+	202	23433807	24115
chr8	23409692	23609692	harbor1	chr8	23508419	23508518	DNA/hAT-Charlie	511	+	50	23508469	98777
chr8	42040638	42240638	harbor1	chr8	42122180	42122279	DNA/hAT-Charlie	489	+	50	42122230	81592
chr8	38169386	38369386	harbor1	chr8	38180680	38180835	DNA/hAT-Charlie	811	+	78	38180758	11372
chr8	38169386	38369386	harbor1	chr8	38227898	38228102	DNA/hAT-Charlie	778	+	102	38228000	58614
chr8	38169386	38369386	harbor1	chr8	38229016	38229501	DNA/hAT-Charlie	2335	+	242	38229258	59872
chr8	38169386	38369386	harbor1	chr8	38229589	38229680	DNA/hAT-Charlie	432	+	46	38229635	60249
chr8	23428873	23628873	harbor1	chr8	23433605	23434009	DNA/hAT-Charlie	1649	+	202	23433807	4934
chr8	23428873	23628873	harbor1	chr8	23508419	23508518	DNA/hAT-Charlie	511	+	50	23508469	79596
chr8	23428873	23628873	harbor1	chr8	23512241	23512398	DNA/hAT-Charlie	723	+	78	23512319	83446
chr8	23428873	23628873	harbor1	chr8	23512395	23512524	DNA/hAT-Charlie	723	+	64	23512459	83586
chr8	23428873	23628873	harbor1	chr8	23514644	23514749	DNA/hAT-Charlie	621	+	52	23514696	85823
chr8	141207362	141407362	harbor1	chr8	141215180	141215412	DNA/hAT-Charlie	540	+	116	141215296	7934
chr8	141207362	141407362	harbor1	chr8	141257654	141257870	DNA/hAT-Charlie	828	+	108	141257762	50400
chr8	141207362	141407362	harbor1	chr8	141302000	141302256	DNA/hAT-Charlie	597	+	128	141302128	94766
chr8	23407606	23607606	harbor1	chr8	23417110	23417239	DNA/hAT-Charlie	641	+	64	23417174	9568
chr8	23407606	23607606	harbor1	chr8	23422576	23422683	DNA/hAT-Charlie	454	+	54	23422630	15024
chr8	23407606	23607606	harbor1	chr8	23433605	23434009	DNA/hAT-Charlie	1649	+	202	23433807	26201
chr8	23428431	23628431	harbor1	chr8	23433605	23434009	DNA/hAT-Charlie	1649	+	202	23433807	5376
chr8	23428431	23628431	harbor1	chr8	23508419	23508518	DNA/hAT-Charlie	511	+	50	23508469	80038
chr8	23428431	23628431	harbor1	chr8	23512241	23512398	DNA/hAT-Charlie	723	+	78	23512319	83888
chr8	23428431	23628431	harbor1	chr8	23512395	23512524	DNA/hAT-Charlie	723	+	64	23512459	84028
chr8	23428431	23628431	harbor1	chr8	23514644	23514749	DNA/hAT-Charlie	621	+	52	23514696	86265
chr8	129907115	130107115	harbor1	chr8	129982258	129982459	DNA/hAT-Charlie	1139	+	100	129982358	75243
chr8	23398445	23598445	harbor1	chr8	23417110	23417239	DNA/hAT-Charlie	641	+	64	23417174	18729
chr8	23398445	23598445	harbor1	chr8	23422576	23422683	DNA/hAT-Charlie	454	+	54	23422630	24185
chr8	23398445	23598445	harbor1	chr8	23433605	23434009	DNA/hAT-Charlie	1649	+	202	23433807	35362
chr8	23428857	23628857	harbor1	chr8	23433605	23434009	DNA/hAT-Charlie	1649	+	202	23433807	4950
chr8	23428857	23628857	harbor1	chr8	23508419	23508518	DNA/hAT-Charlie	511	+	50	23508469	79612
chr8	23428857	23628857	harbor1	chr8	23512241	23512398	DNA/hAT-Charlie	723	+	78	23512319	83462
chr8	23428857	23628857	harbor1	chr8	23512395	23512524	DNA/hAT-Charlie	723	+	64	23512459	83602
chr8	23428857	23628857	harbor1	chr8	23514644	23514749	DNA/hAT-Charlie	621	+	52	23514696	85839
chr8	8665132	8865132	harbor1	chr8	8665518	8665667	DNA/hAT-Charlie	853	+	74	8665592	460
chr8	8665132	8865132	harbor1	chr8	8688555	8688865	DNA/hAT-Charlie	1123	+	155	8688710	23578
chr8	8665132	8865132	harbor1	chr8	8697965	8698279	DNA/hAT-Charlie	1909	+	157	8698122	32990
chr8	8665132	8865132	harbor1	chr8	8758846	8758988	DNA/hAT-Charlie	609	+	71	8758917	93785
chr8	8665132	8865132	harbor1	chr8	8759285	8759313	DNA/hAT-Charlie	609	+	14	8759299	94167
chr8	8665132	8865132	harbor1	chr8	8716214	8716406	DNA/hAT-Charlie	710	+	96	8716310	51178
chr8	23412840	23612840	harbor1	chr8	23417110	23417239	DNA/hAT-Charlie	641	+	64	23417174	4334
chr8	23412840	23612840	harbor1	chr8	23422576	23422683	DNA/hAT-Charlie	454	+	54	23422630	9790
chr8	23412840	23612840	harbor1	chr8	23433605	23434009	DNA/hAT-Charlie	1649	+	202	23433807	20967
chr8	23412840	23612840	harbor1	chr8	23508419	23508518	DNA/hAT-Charlie	511	+	50	23508469	95629
chr8	23412840	23612840	harbor1	chr8	23512241	23512398	DNA/hAT-Charlie	723	+	78	23512319	99479
chr8	23412840	23612840	harbor1	chr8	23512395	23512524	DNA/hAT-Charlie	723	+	64	23512459	99619
chr8	23428958	23628958	harbor1	chr8	23433605	23434009	DNA/hAT-Charlie	1649	+	202	23433807	4849
chr8	23428958	23628958	harbor1	chr8	23508419	23508518	DNA/hAT-Charlie	511	+	50	23508469	79511
chr8	23428958	23628958	harbor1	chr8	23512241	23512398	DNA/hAT-Charlie	723	+	78	23512319	83361
chr8	23428958	23628958	harbor1	chr8	23512395	23512524	DNA/hAT-Charlie	723	+	64	23512459	83501
chr8	23428958	23628958	harbor1	chr8	23514644	23514749	DNA/hAT-Charlie	621	+	52	23514696	85738
chr8	23409094	23609094	harbor1	chr8	23417110	23417239	DNA/hAT-Charlie	641	+	64	23417174	8080
chr8	23409094	23609094	harbor1	chr8	23422576	23422683	DNA/hAT-Charlie	454	+	54	23422630	13536
chr8	23409094	23609094	harbor1	chr8	23433605	23434009	DNA/hAT-Charlie	1649	+	202	23433807	24713
chr8	23409094	23609094	harbor1	chr8	23508419	23508518	DNA/hAT-Charlie	511	+	50	23508469	99375
chr8	96274034	96474034	harbor1	chr8	96308565	96308855	DNA/hAT-Charlie	1064	+	145	96308710	34676
chr8	96274034	96474034	harbor1	chr8	96357009	96357742	DNA/hAT-Charlie	1895	+	366	96357375	83341
chr8	23380409	23580409	harbor1	chr8	23417110	23417239	DNA/hAT-Charlie	641	+	64	23417174	36765
chr8	23380409	23580409	harbor1	chr8	23422576	23422683	DNA/hAT-Charlie	454	+	54	23422630	42221
chr8	23380409	23580409	harbor1	chr8	23433605	23434009	DNA/hAT-Charlie	1649	+	202	23433807	53398
chr8	38169249	38369249	harbor1	chr8	38180680	38180835	DNA/hAT-Charlie	811	+	78	38180758	11509
chr8	38169249	38369249	harbor1	chr8	38227898	38228102	DNA/hAT-Charlie	778	+	102	38228000	58751
chr8	38169249	38369249	harbor1	chr8	38229016	38229501	DNA/hAT-Charlie	2335	+	242	38229258	60009
chr8	38169249	38369249	harbor1	chr8	38229589	38229680	DNA/hAT-Charlie	432	+	46	38229635	60386
chr8	23428835	23628835	harbor1	chr8	23433605	23434009	DNA/hAT-Charlie	1649	+	202	23433807	4972
chr8	23428835	23628835	harbor1	chr8	23508419	23508518	DNA/hAT-Charlie	511	+	50	23508469	79634
chr8	23428835	23628835	harbor1	chr8	23512241	23512398	DNA/hAT-Charlie	723	+	78	23512319	83484
chr8	23428835	23628835	harbor1	chr8	23512395	23512524	DNA/hAT-Charlie	723	+	64	23512459	83624
chr8	23428835	23628835	harbor1	chr8	23514644	23514749	DNA/hAT-Charlie	621	+	52	23514696	85861
chr8	23428925	23628925	harbor1	chr8	23433605	23434009	DNA/hAT-Charlie	1649	+	202	23433807	4882
chr8	23428925	23628925	harbor1	chr8	23508419	23508518	DNA/hAT-Charlie	511	+	50	23508469	79544
chr8	23428925	23628925	harbor1	chr8	23512241	23512398	DNA/hAT-Charlie	723	+	78	23512319	83394
chr8	23428925	23628925	harbor1	chr8	23512395	23512524	DNA/hAT-Charlie	723	+	64	23512459	83534
chr8	23428925	23628925	harbor1	chr8	23514644	23514749	DNA/hAT-Charlie	621	+	52	23514696	85771
chr8	23372590	23572590	harbor1	chr8	23417110	23417239	DNA/hAT-Charlie	641	+	64	23417174	44584
chr8	23372590	23572590	harbor1	chr8	23422576	23422683	DNA/hAT-Charlie	454	+	54	23422630	50040
chr8	23372590	23572590	harbor1	chr8	23433605	23434009	DNA/hAT-Charlie	1649	+	202	23433807	61217
chr8	23428499	23628499	harbor1	chr8	23433605	23434009	DNA/hAT-Charlie	1649	+	202	23433807	5308
chr8	23428499	23628499	harbor1	chr8	23508419	23508518	DNA/hAT-Charlie	511	+	50	23508469	79970
chr8	23428499	23628499	harbor1	chr8	23512241	23512398	DNA/hAT-Charlie	723	+	78	23512319	83820
chr8	23428499	23628499	harbor1	chr8	23512395	23512524	DNA/hAT-Charlie	723	+	64	23512459	83960
chr8	23428499	23628499	harbor1	chr8	23514644	23514749	DNA/hAT-Charlie	621	+	52	23514696	86197
chr8	38169207	38369207	harbor1	chr8	38180680	38180835	DNA/hAT-Charlie	811	+	78	38180758	11551
chr8	38169207	38369207	harbor1	chr8	38227898	38228102	DNA/hAT-Charlie	778	+	102	38228000	58793
chr8	38169207	38369207	harbor1	chr8	38229016	38229501	DNA/hAT-Charlie	2335	+	242	38229258	60051
chr8	38169207	38369207	harbor1	chr8	38229589	38229680	DNA/hAT-Charlie	432	+	46	38229635	60428
chr8	23428888	23628888	harbor1	chr8	23433605	23434009	DNA/hAT-Charlie	1649	+	202	23433807	4919
chr8	23428888	23628888	harbor1	chr8	23508419	23508518	DNA/hAT-Charlie	511	+	50	23508469	79581
chr8	23428888	23628888	harbor1	chr8	23512241	23512398	DNA/hAT-Charlie	723	+	78	23512319	83431
chr8	23428888	23628888	harbor1	chr8	23512395	23512524	DNA/hAT-Charlie	723	+	64	23512459	83571
chr8	23428888	23628888	harbor1	chr8	23514644	23514749	DNA/hAT-Charlie	621	+	52	23514696	85808
chr8	22757824	22957824	harbor1	chr8	22767259	22767472	DNA/hAT-Charlie	636	+	106	22767365	9541
chr8	23380336	23580336	harbor1	chr8	23417110	23417239	DNA/hAT-Charlie	641	+	64	23417174	36838
chr8	23380336	23580336	harbor1	chr8	23422576	23422683	DNA/hAT-Charlie	454	+	54	23422630	42294
chr8	23380336	23580336	harbor1	chr8	23433605	23434009	DNA/hAT-Charlie	1649	+	202	23433807	53471
chr8	142240188	142440188	harbor1	chr8	142328883	142329145	DNA/hAT-Charlie	562	+	131	142329014	88826
chr8	38169250	38369250	harbor1	chr8	38180680	38180835	DNA/hAT-Charlie	811	+	78	38180758	11508
chr8	38169250	38369250	harbor1	chr8	38227898	38228102	DNA/hAT-Charlie	778	+	102	38228000	58750
chr8	38169250	38369250	harbor1	chr8	38229016	38229501	DNA/hAT-Charlie	2335	+	242	38229258	60008
chr8	38169250	38369250	harbor1	chr8	38229589	38229680	DNA/hAT-Charlie	432	+	46	38229635	60385
chr8	66077981	66277981	harbor1	chr8	66117352	66117499	DNA/hAT-Charlie	515	+	74	66117426	39445
chr8	23423555	23623555	harbor1	chr8	23433605	23434009	DNA/hAT-Charlie	1649	+	202	23433807	10252
chr8	23423555	23623555	harbor1	chr8	23508419	23508518	DNA/hAT-Charlie	511	+	50	23508469	84914
chr8	23423555	23623555	harbor1	chr8	23512241	23512398	DNA/hAT-Charlie	723	+	78	23512319	88764
chr8	23423555	23623555	harbor1	chr8	23512395	23512524	DNA/hAT-Charlie	723	+	64	23512459	88904
chr8	23423555	23623555	harbor1	chr8	23514644	23514749	DNA/hAT-Charlie	621	+	52	23514696	91141
chr8	23428893	23628893	harbor1	chr8	23433605	23434009	DNA/hAT-Charlie	1649	+	202	23433807	4914
chr8	23428893	23628893	harbor1	chr8	23508419	23508518	DNA/hAT-Charlie	511	+	50	23508469	79576
chr8	23428893	23628893	harbor1	chr8	23512241	23512398	DNA/hAT-Charlie	723	+	78	23512319	83426
chr8	23428893	23628893	harbor1	chr8	23512395	23512524	DNA/hAT-Charlie	723	+	64	23512459	83566
chr8	23428893	23628893	harbor1	chr8	23514644	23514749	DNA/hAT-Charlie	621	+	52	23514696	85803
chr8	141166248	141366248	harbor1	chr8	141177669	141177868	DNA/hAT-Charlie	583	+	100	141177769	11521
chr8	141166248	141366248	harbor1	chr8	141180109	141180311	DNA/hAT-Charlie	494	+	101	141180210	13962
chr8	141166248	141366248	harbor1	chr8	141186415	141186640	DNA/hAT-Charlie	1552	+	112	141186527	20279
chr8	141166248	141366248	harbor1	chr8	141215180	141215412	DNA/hAT-Charlie	540	+	116	141215296	49048
chr8	141166248	141366248	harbor1	chr8	141257654	141257870	DNA/hAT-Charlie	828	+	108	141257762	91514
chr8	23419596	23619596	harbor1	chr8	23422576	23422683	DNA/hAT-Charlie	454	+	54	23422630	3034
chr8	23419596	23619596	harbor1	chr8	23433605	23434009	DNA/hAT-Charlie	1649	+	202	23433807	14211
chr8	23419596	23619596	harbor1	chr8	23508419	23508518	DNA/hAT-Charlie	511	+	50	23508469	88873
chr8	23419596	23619596	harbor1	chr8	23512241	23512398	DNA/hAT-Charlie	723	+	78	23512319	92723
chr8	23419596	23619596	harbor1	chr8	23512395	23512524	DNA/hAT-Charlie	723	+	64	23512459	92863
chr8	23419596	23619596	harbor1	chr8	23514644	23514749	DNA/hAT-Charlie	621	+	52	23514696	95100
chr8	599963	799963	harbor1	chr8	632782	632971	DNA/hAT-Charlie	637	+	94	632876	32913
chr8	60552749	60752749	harbor1	chr8	60560635	60560727	DNA/hAT-Charlie	1040	+	46	60560681	7932
chr8	60552749	60752749	harbor1	chr8	60560761	60560857	DNA/hAT-Charlie	1040	+	48	60560809	8060
chr8	60552749	60752749	harbor1	chr8	60563324	60563480	DNA/hAT-Charlie	617	+	78	60563402	10653
chr8	38019471	38219471	harbor1	chr8	38038808	38038906	DNA/hAT-Charlie	1033	+	49	38038857	19386
chr8	38019471	38219471	harbor1	chr8	38039192	38039271	DNA/hAT-Charlie	1033	+	40	38039232	19761
chr8	23392919	23592919	harbor1	chr8	23417110	23417239	DNA/hAT-Charlie	641	+	64	23417174	24255
chr8	23392919	23592919	harbor1	chr8	23422576	23422683	DNA/hAT-Charlie	454	+	54	23422630	29711
chr8	23392919	23592919	harbor1	chr8	23433605	23434009	DNA/hAT-Charlie	1649	+	202	23433807	40888
chr8	23398382	23598382	harbor1	chr8	23417110	23417239	DNA/hAT-Charlie	641	+	64	23417174	18792
chr8	23398382	23598382	harbor1	chr8	23422576	23422683	DNA/hAT-Charlie	454	+	54	23422630	24248
chr8	23398382	23598382	harbor1	chr8	23433605	23434009	DNA/hAT-Charlie	1649	+	202	23433807	35425
chr8	10625860	10825860	harbor1	chr8	10651166	10651315	DNA/hAT-Charlie	563	+	74	10651240	25380
chr8	10625860	10825860	harbor1	chr8	10657331	10657519	DNA/hAT-Charlie	1088	+	94	10657425	31565
chr8	23428533	23628533	harbor1	chr8	23433605	23434009	DNA/hAT-Charlie	1649	+	202	23433807	5274
chr8	23428533	23628533	harbor1	chr8	23508419	23508518	DNA/hAT-Charlie	511	+	50	23508469	79936
chr8	23428533	23628533	harbor1	chr8	23512241	23512398	DNA/hAT-Charlie	723	+	78	23512319	83786
chr8	23428533	23628533	harbor1	chr8	23512395	23512524	DNA/hAT-Charlie	723	+	64	23512459	83926
chr8	23428533	23628533	harbor1	chr8	23514644	23514749	DNA/hAT-Charlie	621	+	52	23514696	86163
chr8	23393307	23593307	harbor1	chr8	23417110	23417239	DNA/hAT-Charlie	641	+	64	23417174	23867
chr8	23393307	23593307	harbor1	chr8	23422576	23422683	DNA/hAT-Charlie	454	+	54	23422630	29323
chr8	23393307	23593307	harbor1	chr8	23433605	23434009	DNA/hAT-Charlie	1649	+	202	23433807	40500
chr8	29995437	30195437	harbor1	chr8	30068131	30068649	DNA/hAT-Charlie	3569	+	259	30068390	72953
chr8	29995437	30195437	harbor1	chr8	30081472	30081633	DNA/hAT-Charlie	450	+	80	30081552	86115
chr8	66405191	66605191	harbor1	chr8	66484571	66484636	DNA/hAT-Charlie	425	+	32	66484603	79412
chr8	66405191	66605191	harbor1	chr8	66486853	66486936	DNA/hAT-Charlie	453	+	42	66486895	81704
chr8	143417559	143617559	harbor1	chr8	143442669	143442933	DNA/hAT-Charlie	553	+	132	143442801	25242
chr8	23428940	23628940	harbor1	chr8	23433605	23434009	DNA/hAT-Charlie	1649	+	202	23433807	4867
chr8	23428940	23628940	harbor1	chr8	23508419	23508518	DNA/hAT-Charlie	511	+	50	23508469	79529
chr8	23428940	23628940	harbor1	chr8	23512241	23512398	DNA/hAT-Charlie	723	+	78	23512319	83379
chr8	23428940	23628940	harbor1	chr8	23512395	23512524	DNA/hAT-Charlie	723	+	64	23512459	83519
chr8	23428940	23628940	harbor1	chr8	23514644	23514749	DNA/hAT-Charlie	621	+	52	23514696	85756
chr8	124796482	124996482	harbor1	chr8	124806347	124806579	DNA/hAT-Charlie	1071	+	116	124806463	9981
chr8	124796482	124996482	harbor1	chr8	124881005	124881320	DNA/hAT-Charlie	555	+	158	124881163	84681
chr8	23428850	23628850	harbor1	chr8	23433605	23434009	DNA/hAT-Charlie	1649	+	202	23433807	4957
chr8	23428850	23628850	harbor1	chr8	23508419	23508518	DNA/hAT-Charlie	511	+	50	23508469	79619
chr8	23428850	23628850	harbor1	chr8	23512241	23512398	DNA/hAT-Charlie	723	+	78	23512319	83469
chr8	23428850	23628850	harbor1	chr8	23512395	23512524	DNA/hAT-Charlie	723	+	64	23512459	83609
chr8	23428850	23628850	harbor1	chr8	23514644	23514749	DNA/hAT-Charlie	621	+	52	23514696	85846
chr8	42040276	42240276	harbor1	chr8	42122180	42122279	DNA/hAT-Charlie	489	+	50	42122230	81954
chr8	23428530	23628530	harbor1	chr8	23433605	23434009	DNA/hAT-Charlie	1649	+	202	23433807	5277
chr8	23428530	23628530	harbor1	chr8	23508419	23508518	DNA/hAT-Charlie	511	+	50	23508469	79939
chr8	23428530	23628530	harbor1	chr8	23512241	23512398	DNA/hAT-Charlie	723	+	78	23512319	83789
chr8	23428530	23628530	harbor1	chr8	23512395	23512524	DNA/hAT-Charlie	723	+	64	23512459	83929
chr8	23428530	23628530	harbor1	chr8	23514644	23514749	DNA/hAT-Charlie	621	+	52	23514696	86166
chr8	23429026	23629026	harbor1	chr8	23433605	23434009	DNA/hAT-Charlie	1649	+	202	23433807	4781
chr8	23429026	23629026	harbor1	chr8	23508419	23508518	DNA/hAT-Charlie	511	+	50	23508469	79443
chr8	23429026	23629026	harbor1	chr8	23512241	23512398	DNA/hAT-Charlie	723	+	78	23512319	83293
chr8	23429026	23629026	harbor1	chr8	23512395	23512524	DNA/hAT-Charlie	723	+	64	23512459	83433
chr8	23429026	23629026	harbor1	chr8	23514644	23514749	DNA/hAT-Charlie	621	+	52	23514696	85670
chr8	98847692	99047692	harbor1	chr8	98929869	98930032	DNA/hAT-Charlie	560	+	82	98929951	82259
chr8	23428510	23628510	harbor1	chr8	23433605	23434009	DNA/hAT-Charlie	1649	+	202	23433807	5297
chr8	23428510	23628510	harbor1	chr8	23508419	23508518	DNA/hAT-Charlie	511	+	50	23508469	79959
chr8	23428510	23628510	harbor1	chr8	23512241	23512398	DNA/hAT-Charlie	723	+	78	23512319	83809
chr8	23428510	23628510	harbor1	chr8	23512395	23512524	DNA/hAT-Charlie	723	+	64	23512459	83949
chr8	23428510	23628510	harbor1	chr8	23514644	23514749	DNA/hAT-Charlie	621	+	52	23514696	86186
chr8	129839917	130039917	harbor1	chr8	129842514	129842863	DNA/hAT-Charlie	1100	+	174	129842688	2771
chr8	129839917	130039917	harbor1	chr8	129901603	129902109	DNA/hAT-Charlie	1189	+	253	129901856	61939
chr8	141231066	141431066	harbor1	chr8	141257654	141257870	DNA/hAT-Charlie	828	+	108	141257762	26696
chr8	141231066	141431066	harbor1	chr8	141302000	141302256	DNA/hAT-Charlie	597	+	128	141302128	71062
chr8	81559422	81759422	harbor1	chr8	81589986	81590374	DNA/hAT-Charlie	529	+	194	81590180	30758
chr8	81559422	81759422	harbor1	chr8	81602543	81602708	DNA/hAT-Charlie	463	+	82	81602625	43203
chr8	81559422	81759422	harbor1	chr8	81649264	81649488	DNA/hAT-Charlie	1410	+	112	81649376	89954
chr8	81559422	81759422	harbor1	chr8	81575774	81575988	DNA/hAT-Charlie	1165	+	107	81575881	16459
chr8	143958376	144158376	harbor1	chr8	144038716	144038957	DNA/hAT-Charlie	794	+	120	144038836	80460
chr8	23380964	23580964	harbor1	chr8	23417110	23417239	DNA/hAT-Charlie	641	+	64	23417174	36210
chr8	23380964	23580964	harbor1	chr8	23422576	23422683	DNA/hAT-Charlie	454	+	54	23422630	41666
chr8	23380964	23580964	harbor1	chr8	23433605	23434009	DNA/hAT-Charlie	1649	+	202	23433807	52843
chr8	57161177	57361177	harbor1	chr8	57188882	57189372	DNA/hAT-Charlie	3070	+	245	57189127	27950
chr8	57161177	57361177	harbor1	chr8	57253483	57253641	DNA/hAT-Charlie	510	+	79	57253562	92385
chr8	53743525	53943525	harbor1	chr8	53751647	53751669	DNA/hAT-Charlie	1498	+	11	53751658	8133
chr8	53743525	53943525	harbor1	chr8	53751968	53752548	DNA/hAT-Charlie	1498	+	290	53752258	8733
chr8	53743525	53943525	harbor1	chr8	53752849	53753030	DNA/hAT-Charlie	1498	+	90	53752939	9414
chr8	53743525	53943525	harbor1	chr8	53758737	53758951	DNA/hAT-Charlie	808	+	107	53758844	15319
chr8	53743525	53943525	harbor1	chr8	53758999	53759141	DNA/hAT-Charlie	593	+	71	53759070	15545
chr8	53743525	53943525	harbor1	chr8	53815593	53815816	DNA/hAT-Charlie	715	+	112	53815705	72180
chr8	27322694	27522694	harbor1	chr8	27372791	27373127	DNA/hAT-Charlie	451	+	168	27372959	50265
chr8	27322694	27522694	harbor1	chr8	27400152	27400370	DNA/hAT-Charlie	547	+	109	27400261	77567
chr8	85145876	85345876	harbor1	chr8	85159829	85160040	DNA/hAT-Charlie	850	+	106	85159935	14059
chr8	85145876	85345876	harbor1	chr8	85167608	85167710	DNA/hAT-Charlie	513	+	51	85167659	21783
chr8	85145876	85345876	harbor1	chr8	85168008	85168067	DNA/hAT-Charlie	513	+	30	85168038	22162
chr8	85145876	85345876	harbor1	chr8	85223835	85224142	DNA/hAT-Charlie	1291	+	154	85223989	78113
chr8	85145876	85345876	harbor1	chr8	85233279	85233419	DNA/hAT-Charlie	703	+	70	85233349	87473
chr8	85145876	85345876	harbor1	chr8	85234618	85234770	DNA/hAT-Charlie	512	+	76	85234694	88818
chr8	85144970	85344970	harbor1	chr8	85159829	85160040	DNA/hAT-Charlie	850	+	106	85159935	14965
chr8	85144970	85344970	harbor1	chr8	85167608	85167710	DNA/hAT-Charlie	513	+	51	85167659	22689
chr8	85144970	85344970	harbor1	chr8	85168008	85168067	DNA/hAT-Charlie	513	+	30	85168038	23068
chr8	85144970	85344970	harbor1	chr8	85223835	85224142	DNA/hAT-Charlie	1291	+	154	85223989	79019
chr8	85144970	85344970	harbor1	chr8	85233279	85233419	DNA/hAT-Charlie	703	+	70	85233349	88379
chr8	85144970	85344970	harbor1	chr8	85234618	85234770	DNA/hAT-Charlie	512	+	76	85234694	89724
chr8	599952	799952	harbor1	chr8	632782	632971	DNA/hAT-Charlie	637	+	94	632876	32924
chr8	42040690	42240690	harbor1	chr8	42122180	42122279	DNA/hAT-Charlie	489	+	50	42122230	81540
chr8	141296156	141496156	harbor1	chr8	141302000	141302256	DNA/hAT-Charlie	597	+	128	141302128	5972
chr8	23428435	23628435	harbor1	chr8	23433605	23434009	DNA/hAT-Charlie	1649	+	202	23433807	5372
chr8	23428435	23628435	harbor1	chr8	23508419	23508518	DNA/hAT-Charlie	511	+	50	23508469	80034
chr8	23428435	23628435	harbor1	chr8	23512241	23512398	DNA/hAT-Charlie	723	+	78	23512319	83884
chr8	23428435	23628435	harbor1	chr8	23512395	23512524	DNA/hAT-Charlie	723	+	64	23512459	84024
chr8	23428435	23628435	harbor1	chr8	23514644	23514749	DNA/hAT-Charlie	621	+	52	23514696	86261
chr8	78034557	78234557	harbor1	chr8	78063676	78063976	DNA/hAT-Charlie	1844	+	150	78063826	29269
chr8	78034557	78234557	harbor1	chr8	78064387	78064629	DNA/hAT-Charlie	1621	+	121	78064508	29951
chr8	78034557	78234557	harbor1	chr8	78134030	78134203	DNA/hAT-Charlie	482	+	86	78134116	99559
chr8	38168585	38368585	harbor1	chr8	38180680	38180835	DNA/hAT-Charlie	811	+	78	38180758	12173
chr8	38168585	38368585	harbor1	chr8	38227898	38228102	DNA/hAT-Charlie	778	+	102	38228000	59415
chr8	38168585	38368585	harbor1	chr8	38229016	38229501	DNA/hAT-Charlie	2335	+	242	38229258	60673
chr8	38168585	38368585	harbor1	chr8	38229589	38229680	DNA/hAT-Charlie	432	+	46	38229635	61050
chr8	23429035	23629035	harbor1	chr8	23433605	23434009	DNA/hAT-Charlie	1649	+	202	23433807	4772
chr8	23429035	23629035	harbor1	chr8	23508419	23508518	DNA/hAT-Charlie	511	+	50	23508469	79434
chr8	23429035	23629035	harbor1	chr8	23512241	23512398	DNA/hAT-Charlie	723	+	78	23512319	83284
chr8	23429035	23629035	harbor1	chr8	23512395	23512524	DNA/hAT-Charlie	723	+	64	23512459	83424
chr8	23429035	23629035	harbor1	chr8	23514644	23514749	DNA/hAT-Charlie	621	+	52	23514696	85661
chr8	23388472	23588472	harbor1	chr8	23417110	23417239	DNA/hAT-Charlie	641	+	64	23417174	28702
chr8	23388472	23588472	harbor1	chr8	23422576	23422683	DNA/hAT-Charlie	454	+	54	23422630	34158
chr8	23388472	23588472	harbor1	chr8	23433605	23434009	DNA/hAT-Charlie	1649	+	202	23433807	45335
chr8	17984183	18184183	harbor1	chr8	17987741	17987917	DNA/hAT-Charlie	841	+	88	17987829	3646
chr8	17984183	18184183	harbor1	chr8	18005688	18005855	DNA/hAT-Charlie	680	+	84	18005772	21589
chr8	17984183	18184183	harbor1	chr8	18006925	18007065	DNA/hAT-Charlie	730	+	70	18006995	22812
chr8	17984183	18184183	harbor1	chr8	18008133	18008574	DNA/hAT-Charlie	2976	+	220	18008353	24170
chr8	17984183	18184183	harbor1	chr8	18051763	18051893	DNA/hAT-Charlie	463	+	65	18051828	67645
chr8	17984183	18184183	harbor1	chr8	18068544	18068717	DNA/hAT-Charlie	816	+	86	18068630	84447
chr8	129839623	130039623	harbor1	chr8	129842514	129842863	DNA/hAT-Charlie	1100	+	174	129842688	3065
chr8	129839623	130039623	harbor1	chr8	129901603	129902109	DNA/hAT-Charlie	1189	+	253	129901856	62233
chr8	38169173	38369173	harbor1	chr8	38180680	38180835	DNA/hAT-Charlie	811	+	78	38180758	11585
chr8	38169173	38369173	harbor1	chr8	38227898	38228102	DNA/hAT-Charlie	778	+	102	38228000	58827
chr8	38169173	38369173	harbor1	chr8	38229016	38229501	DNA/hAT-Charlie	2335	+	242	38229258	60085
chr8	38169173	38369173	harbor1	chr8	38229589	38229680	DNA/hAT-Charlie	432	+	46	38229635	60462
chr8	38167320	38367320	harbor1	chr8	38180680	38180835	DNA/hAT-Charlie	811	+	78	38180758	13438
chr8	38167320	38367320	harbor1	chr8	38227898	38228102	DNA/hAT-Charlie	778	+	102	38228000	60680
chr8	38167320	38367320	harbor1	chr8	38229016	38229501	DNA/hAT-Charlie	2335	+	242	38229258	61938
chr8	38167320	38367320	harbor1	chr8	38229589	38229680	DNA/hAT-Charlie	432	+	46	38229635	62315
chr8	100618244	100818244	harbor1	chr8	100619724	100619884	DNA/hAT-Charlie	933	+	80	100619804	1560
chr8	100618244	100818244	harbor1	chr8	100636424	100636712	DNA/hAT-Charlie	1705	+	144	100636568	18324
chr8	100618244	100818244	harbor1	chr8	100637021	100637057	DNA/hAT-Charlie	1705	+	18	100637039	18795
chr8	100618244	100818244	harbor1	chr8	100666242	100666889	DNA/hAT-Charlie	2361	+	324	100666566	48322
chr8	100618244	100818244	harbor1	chr8	100671473	100671635	DNA/hAT-Charlie	691	+	81	100671554	53310
chr8	100618244	100818244	harbor1	chr8	100703410	100703619	DNA/hAT-Charlie	630	+	104	100703514	85270
chr8	54002046	54202046	harbor1	chr8	54091733	54091806	DNA/hAT-Charlie	453	+	36	54091769	89723
chr8	54002046	54202046	harbor1	chr8	54092410	54092515	DNA/hAT-Charlie	503	+	52	54092462	90416
chr8	29891739	30091739	harbor1	chr8	29899536	29900071	DNA/hAT-Charlie	3715	+	268	29899804	8065
chr8	29983337	30183337	harbor1	chr8	30068131	30068649	DNA/hAT-Charlie	3569	+	259	30068390	85053
chr8	29983337	30183337	harbor1	chr8	30081472	30081633	DNA/hAT-Charlie	450	+	80	30081552	98215
chr8	23393297	23593297	harbor1	chr8	23417110	23417239	DNA/hAT-Charlie	641	+	64	23417174	23877
chr8	23393297	23593297	harbor1	chr8	23422576	23422683	DNA/hAT-Charlie	454	+	54	23422630	29333
chr8	23393297	23593297	harbor1	chr8	23433605	23434009	DNA/hAT-Charlie	1649	+	202	23433807	40510
chr8	65059279	65259279	harbor1	chr8	65141377	65141530	DNA/hAT-Charlie	474	+	76	65141453	82174
chr8	65059279	65259279	harbor1	chr8	65156920	65157202	DNA/hAT-Charlie	944	+	141	65157061	97782
chr8	65059279	65259279	harbor1	chr8	65158467	65158687	DNA/hAT-Charlie	1559	+	110	65158577	99298
chr8	38169375	38369375	harbor1	chr8	38180680	38180835	DNA/hAT-Charlie	811	+	78	38180758	11383
chr8	38169375	38369375	harbor1	chr8	38227898	38228102	DNA/hAT-Charlie	778	+	102	38228000	58625
chr8	38169375	38369375	harbor1	chr8	38229016	38229501	DNA/hAT-Charlie	2335	+	242	38229258	59883
chr8	38169375	38369375	harbor1	chr8	38229589	38229680	DNA/hAT-Charlie	432	+	46	38229635	60260
chr8	17057584	17257584	harbor1	chr8	17073250	17073695	DNA/hAT-Charlie	3195	+	222	17073472	15888
chr8	17057584	17257584	harbor1	chr8	17073939	17074042	DNA/hAT-Charlie	587	+	52	17073991	16407
chr8	17057584	17257584	harbor1	chr8	17074186	17074274	DNA/hAT-Charlie	437	+	44	17074230	16646
chr8	17057584	17257584	harbor1	chr8	17074269	17074379	DNA/hAT-Charlie	467	+	55	17074324	16740
chr8	17057584	17257584	harbor1	chr8	17079191	17079338	DNA/hAT-Charlie	812	+	74	17079265	21681
chr8	17057584	17257584	harbor1	chr8	17107568	17107760	DNA/hAT-Charlie	870	+	96	17107664	50080
chr8	17057584	17257584	harbor1	chr8	17151113	17151318	DNA/hAT-Charlie	947	+	102	17151215	93631
chr8	144366341	144566341	harbor1	chr8	144386985	144387187	DNA/hAT-Charlie	430	+	101	144387086	20745
chr8	23382752	23582752	harbor1	chr8	23417110	23417239	DNA/hAT-Charlie	641	+	64	23417174	34422
chr8	23382752	23582752	harbor1	chr8	23422576	23422683	DNA/hAT-Charlie	454	+	54	23422630	39878
chr8	23382752	23582752	harbor1	chr8	23433605	23434009	DNA/hAT-Charlie	1649	+	202	23433807	51055
chr8	23398575	23598575	harbor1	chr8	23417110	23417239	DNA/hAT-Charlie	641	+	64	23417174	18599
chr8	23398575	23598575	harbor1	chr8	23422576	23422683	DNA/hAT-Charlie	454	+	54	23422630	24055
chr8	23398575	23598575	harbor1	chr8	23433605	23434009	DNA/hAT-Charlie	1649	+	202	23433807	35232
chr8	144374989	144574989	harbor1	chr8	144386985	144387187	DNA/hAT-Charlie	430	+	101	144387086	12097
chr8	23382836	23582836	harbor1	chr8	23417110	23417239	DNA/hAT-Charlie	641	+	64	23417174	34338
chr8	23382836	23582836	harbor1	chr8	23422576	23422683	DNA/hAT-Charlie	454	+	54	23422630	39794
chr8	23382836	23582836	harbor1	chr8	23433605	23434009	DNA/hAT-Charlie	1649	+	202	23433807	50971
chr8	38167968	38367968	harbor1	chr8	38180680	38180835	DNA/hAT-Charlie	811	+	78	38180758	12790
chr8	38167968	38367968	harbor1	chr8	38227898	38228102	DNA/hAT-Charlie	778	+	102	38228000	60032
chr8	38167968	38367968	harbor1	chr8	38229016	38229501	DNA/hAT-Charlie	2335	+	242	38229258	61290
chr8	38167968	38367968	harbor1	chr8	38229589	38229680	DNA/hAT-Charlie	432	+	46	38229635	61667
chr8	29983014	30183014	harbor1	chr8	30068131	30068649	DNA/hAT-Charlie	3569	+	259	30068390	85376
chr8	29983014	30183014	harbor1	chr8	30081472	30081633	DNA/hAT-Charlie	450	+	80	30081552	98538
chr8	23146666	23346666	harbor1	chr8	23197358	23197768	DNA/hAT-Charlie	2947	+	205	23197563	50897
chr8	8665131	8865131	harbor1	chr8	8665518	8665667	DNA/hAT-Charlie	853	+	74	8665592	461
chr8	8665131	8865131	harbor1	chr8	8688555	8688865	DNA/hAT-Charlie	1123	+	155	8688710	23579
chr8	8665131	8865131	harbor1	chr8	8697965	8698279	DNA/hAT-Charlie	1909	+	157	8698122	32991
chr8	8665131	8865131	harbor1	chr8	8758846	8758988	DNA/hAT-Charlie	609	+	71	8758917	93786
chr8	8665131	8865131	harbor1	chr8	8759285	8759313	DNA/hAT-Charlie	609	+	14	8759299	94168
chr8	8665131	8865131	harbor1	chr8	8716214	8716406	DNA/hAT-Charlie	710	+	96	8716310	51179
chr8	102556522	102756522	harbor1	chr8	102587124	102587369	DNA/hAT-Charlie	779	+	122	102587246	30724
chr8	102556522	102756522	harbor1	chr8	102646031	102646154	DNA/hAT-Charlie	446	+	62	102646093	89571
chr8	143960625	144160625	harbor1	chr8	144038716	144038957	DNA/hAT-Charlie	794	+	120	144038836	78211
chr8	144006082	144206082	harbor1	chr8	144038716	144038957	DNA/hAT-Charlie	794	+	120	144038836	32754
chr8	21682210	21882210	harbor1	chr8	21685130	21685349	DNA/hAT-Charlie	1185	+	110	21685240	3030
chr8	21682210	21882210	harbor1	chr8	21713627	21713826	DNA/hAT-Charlie	786	+	100	21713727	31517
chr8	21682210	21882210	harbor1	chr8	21753190	21753325	DNA/hAT-Charlie	887	+	68	21753258	71048
chr8	21682210	21882210	harbor1	chr8	21753649	21753824	DNA/hAT-Charlie	887	+	88	21753737	71527
chr8	21682210	21882210	harbor1	chr8	21773490	21773718	DNA/hAT-Charlie	602	+	114	21773604	91394
chr8	21682210	21882210	harbor1	chr8	21773791	21773999	DNA/hAT-Charlie	1005	+	104	21773895	91685
chr8	42040636	42240636	harbor1	chr8	42122180	42122279	DNA/hAT-Charlie	489	+	50	42122230	81594
chr8	96960816	97160816	harbor1	chr8	96962740	96962878	DNA/hAT-Charlie	445	+	69	96962809	1993
chr8	96960816	97160816	harbor1	chr8	97033269	97033449	DNA/hAT-Charlie	578	+	90	97033359	72543
chr8	23428962	23628962	harbor1	chr8	23433605	23434009	DNA/hAT-Charlie	1649	+	202	23433807	4845
chr8	23428962	23628962	harbor1	chr8	23508419	23508518	DNA/hAT-Charlie	511	+	50	23508469	79507
chr8	23428962	23628962	harbor1	chr8	23512241	23512398	DNA/hAT-Charlie	723	+	78	23512319	83357
chr8	23428962	23628962	harbor1	chr8	23512395	23512524	DNA/hAT-Charlie	723	+	64	23512459	83497
chr8	23428962	23628962	harbor1	chr8	23514644	23514749	DNA/hAT-Charlie	621	+	52	23514696	85734
chr8	41443390	41643390	harbor1	chr8	41467205	41467338	DNA/hAT-Charlie	515	+	66	41467271	23881
chr8	41443390	41643390	harbor1	chr8	41533651	41533716	DNA/hAT-Charlie	479	+	32	41533683	90293
chr8	41443390	41643390	harbor1	chr8	41534085	41534120	DNA/hAT-Charlie	479	+	18	41534103	90713
chr8	41443390	41643390	harbor1	chr8	41534371	41534636	DNA/hAT-Charlie	582	+	132	41534503	91113
chr8	41443390	41643390	harbor1	chr8	41536504	41536812	DNA/hAT-Charlie	585	+	154	41536658	93268
chr8	3258304	3458304	harbor1	chr8	3259754	3260039	DNA/hAT-Charlie	543	+	142	3259896	1592
chr8	100621232	100821232	harbor1	chr8	100636424	100636712	DNA/hAT-Charlie	1705	+	144	100636568	15336
chr8	100621232	100821232	harbor1	chr8	100637021	100637057	DNA/hAT-Charlie	1705	+	18	100637039	15807
chr8	100621232	100821232	harbor1	chr8	100666242	100666889	DNA/hAT-Charlie	2361	+	324	100666566	45334
chr8	100621232	100821232	harbor1	chr8	100671473	100671635	DNA/hAT-Charlie	691	+	81	100671554	50322
chr8	100621232	100821232	harbor1	chr8	100703410	100703619	DNA/hAT-Charlie	630	+	104	100703514	82282
chr8	38169193	38369193	harbor1	chr8	38180680	38180835	DNA/hAT-Charlie	811	+	78	38180758	11565
chr8	38169193	38369193	harbor1	chr8	38227898	38228102	DNA/hAT-Charlie	778	+	102	38228000	58807
chr8	38169193	38369193	harbor1	chr8	38229016	38229501	DNA/hAT-Charlie	2335	+	242	38229258	60065
chr8	38169193	38369193	harbor1	chr8	38229589	38229680	DNA/hAT-Charlie	432	+	46	38229635	60442
chr8	29983347	30183347	harbor1	chr8	30068131	30068649	DNA/hAT-Charlie	3569	+	259	30068390	85043
chr8	29983347	30183347	harbor1	chr8	30081472	30081633	DNA/hAT-Charlie	450	+	80	30081552	98205
chr8	72661683	72861683	harbor1	chr8	72691849	72691954	DNA/hAT-Charlie	583	+	52	72691901	30218
chr8	72661683	72861683	harbor1	chr8	72692259	72692400	DNA/hAT-Charlie	583	+	70	72692329	30646
chr8	72661683	72861683	harbor1	chr8	72697834	72698001	DNA/hAT-Charlie	643	+	84	72697918	36235
chr8	72661683	72861683	harbor1	chr8	72756453	72756626	DNA/hAT-Charlie	662	+	86	72756539	94856
chr8	72661683	72861683	harbor1	chr8	72760482	72760637	DNA/hAT-Charlie	568	+	78	72760560	98877
chr8	143420517	143620517	harbor1	chr8	143442669	143442933	DNA/hAT-Charlie	553	+	132	143442801	22284
chr8	23428892	23628892	harbor1	chr8	23433605	23434009	DNA/hAT-Charlie	1649	+	202	23433807	4915
chr8	23428892	23628892	harbor1	chr8	23508419	23508518	DNA/hAT-Charlie	511	+	50	23508469	79577
chr8	23428892	23628892	harbor1	chr8	23512241	23512398	DNA/hAT-Charlie	723	+	78	23512319	83427
chr8	23428892	23628892	harbor1	chr8	23512395	23512524	DNA/hAT-Charlie	723	+	64	23512459	83567
chr8	23428892	23628892	harbor1	chr8	23514644	23514749	DNA/hAT-Charlie	621	+	52	23514696	85804
chr8	66405141	66605141	harbor1	chr8	66484571	66484636	DNA/hAT-Charlie	425	+	32	66484603	79462
chr8	66405141	66605141	harbor1	chr8	66486853	66486936	DNA/hAT-Charlie	453	+	42	66486895	81754
chr8	23384163	23584163	harbor1	chr8	23417110	23417239	DNA/hAT-Charlie	641	+	64	23417174	33011
chr8	23384163	23584163	harbor1	chr8	23422576	23422683	DNA/hAT-Charlie	454	+	54	23422630	38467
chr8	23384163	23584163	harbor1	chr8	23433605	23434009	DNA/hAT-Charlie	1649	+	202	23433807	49644
chr8	58719745	58919745	harbor1	chr8	58762537	58762801	DNA/hAT-Charlie	963	+	132	58762669	42924
chr8	58719745	58919745	harbor1	chr8	58763181	58763360	DNA/hAT-Charlie	682	+	90	58763271	43526
chr9	4663254	4863254	harbor1	chr9	4686769	4687076	DNA/hAT-Charlie	1632	+	154	4686923	23669
chr9	4663254	4863254	harbor1	chr9	4698684	4698821	DNA/hAT-Charlie	633	+	68	4698752	35498
chr9	4663254	4863254	harbor1	chr9	4698820	4699116	DNA/hAT-Charlie	1208	+	148	4698968	35714
chr9	4692931	4892931	harbor1	chr9	4698684	4698821	DNA/hAT-Charlie	633	+	68	4698752	5821
chr9	4692931	4892931	harbor1	chr9	4698820	4699116	DNA/hAT-Charlie	1208	+	148	4698968	6037
chr9	4692931	4892931	harbor1	chr9	4775769	4775927	DNA/hAT-Charlie	621	+	79	4775848	82917
chr9	4692160	4892160	harbor1	chr9	4698684	4698821	DNA/hAT-Charlie	633	+	68	4698752	6592
chr9	4692160	4892160	harbor1	chr9	4698820	4699116	DNA/hAT-Charlie	1208	+	148	4698968	6808
chr9	4692160	4892160	harbor1	chr9	4775769	4775927	DNA/hAT-Charlie	621	+	79	4775848	83688
chr9	4692665	4892665	harbor1	chr9	4698684	4698821	DNA/hAT-Charlie	633	+	68	4698752	6087
chr9	4692665	4892665	harbor1	chr9	4698820	4699116	DNA/hAT-Charlie	1208	+	148	4698968	6303
chr9	4692665	4892665	harbor1	chr9	4775769	4775927	DNA/hAT-Charlie	621	+	79	4775848	83183
chr9	4883814	5083814	harbor1	chr9	4924597	4924796	DNA/hAT-Charlie	888	+	100	4924697	40883
chr9	4883814	5083814	harbor1	chr9	4930783	4930938	DNA/hAT-Charlie	808	+	78	4930861	47047
chr9	4883814	5083814	harbor1	chr9	4967764	4967895	DNA/hAT-Charlie	663	+	66	4967830	84016
chr9	4692207	4892207	harbor1	chr9	4698684	4698821	DNA/hAT-Charlie	633	+	68	4698752	6545
chr9	4692207	4892207	harbor1	chr9	4698820	4699116	DNA/hAT-Charlie	1208	+	148	4698968	6761
chr9	4692207	4892207	harbor1	chr9	4775769	4775927	DNA/hAT-Charlie	621	+	79	4775848	83641
chr9	4692981	4892981	harbor1	chr9	4698684	4698821	DNA/hAT-Charlie	633	+	68	4698752	5771
chr9	4692981	4892981	harbor1	chr9	4698820	4699116	DNA/hAT-Charlie	1208	+	148	4698968	5987
chr9	4692981	4892981	harbor1	chr9	4775769	4775927	DNA/hAT-Charlie	621	+	79	4775848	82867
chr9	4692827	4892827	harbor1	chr9	4698684	4698821	DNA/hAT-Charlie	633	+	68	4698752	5925
chr9	4692827	4892827	harbor1	chr9	4698820	4699116	DNA/hAT-Charlie	1208	+	148	4698968	6141
chr9	4692827	4892827	harbor1	chr9	4775769	4775927	DNA/hAT-Charlie	621	+	79	4775848	83021
chr9	4693009	4893009	harbor1	chr9	4698684	4698821	DNA/hAT-Charlie	633	+	68	4698752	5743
chr9	4693009	4893009	harbor1	chr9	4698820	4699116	DNA/hAT-Charlie	1208	+	148	4698968	5959
chr9	4693009	4893009	harbor1	chr9	4775769	4775927	DNA/hAT-Charlie	621	+	79	4775848	82839
chr9	4663492	4863492	harbor1	chr9	4686769	4687076	DNA/hAT-Charlie	1632	+	154	4686923	23431
chr9	4663492	4863492	harbor1	chr9	4698684	4698821	DNA/hAT-Charlie	633	+	68	4698752	35260
chr9	4663492	4863492	harbor1	chr9	4698820	4699116	DNA/hAT-Charlie	1208	+	148	4698968	35476
chr9	4692473	4892473	harbor1	chr9	4698684	4698821	DNA/hAT-Charlie	633	+	68	4698752	6279
chr9	4692473	4892473	harbor1	chr9	4698820	4699116	DNA/hAT-Charlie	1208	+	148	4698968	6495
chr9	4692473	4892473	harbor1	chr9	4775769	4775927	DNA/hAT-Charlie	621	+	79	4775848	83375
chr9	1955525	2155525	harbor1	chr9	1974245	1974398	DNA/hAT-Charlie	732	+	76	1974321	18796
chr9	1955525	2155525	harbor1	chr9	1993976	1994131	DNA/hAT-Charlie	688	+	78	1994054	38529
chr9	1955525	2155525	harbor1	chr9	2039038	2039291	DNA/hAT-Charlie	1233	+	126	2039164	83639
chr9	4766620	4966620	harbor1	chr9	4775769	4775927	DNA/hAT-Charlie	621	+	79	4775848	9228
chr9	4766620	4966620	harbor1	chr9	4797454	4797665	DNA/hAT-Charlie	1206	+	106	4797560	30940
chr9	4766620	4966620	harbor1	chr9	4829821	4829972	DNA/hAT-Charlie	517	+	76	4829897	63277
chr9	4766620	4966620	harbor1	chr9	4838691	4838848	DNA/hAT-Charlie	655	+	78	4838769	72149
chr9	4663979	4863979	harbor1	chr9	4686769	4687076	DNA/hAT-Charlie	1632	+	154	4686923	22944
chr9	4663979	4863979	harbor1	chr9	4698684	4698821	DNA/hAT-Charlie	633	+	68	4698752	34773
chr9	4663979	4863979	harbor1	chr9	4698820	4699116	DNA/hAT-Charlie	1208	+	148	4698968	34989
chr9	4779222	4979222	harbor1	chr9	4797454	4797665	DNA/hAT-Charlie	1206	+	106	4797560	18338
chr9	4779222	4979222	harbor1	chr9	4829821	4829972	DNA/hAT-Charlie	517	+	76	4829897	50675
chr9	4779222	4979222	harbor1	chr9	4838691	4838848	DNA/hAT-Charlie	655	+	78	4838769	59547
chr9	132805611	133005611	harbor1	chr9	132849286	132849505	DNA/hAT-Charlie	946	+	110	132849396	43785
chr9	132805611	133005611	harbor1	chr9	132876241	132876443	DNA/hAT-Charlie	586	+	101	132876342	70731
chr9	132805611	133005611	harbor1	chr9	132901916	132902432	DNA/hAT-Charlie	1866	+	258	132902174	96563
chr9	100252658	100452658	harbor1	chr9	100282855	100283008	DNA/hAT-Charlie	562	+	76	100282931	30273
chr9	100252658	100452658	harbor1	chr9	100283880	100284038	DNA/hAT-Charlie	547	+	79	100283959	31301
chr9	100252658	100452658	harbor1	chr9	100307231	100307443	DNA/hAT-Charlie	990	+	106	100307337	54679
chr9	100252658	100452658	harbor1	chr9	100336253	100336773	DNA/hAT-Charlie	3565	+	260	100336513	83855
chr9	100252658	100452658	harbor1	chr9	100342423	100342574	DNA/hAT-Charlie	832	+	76	100342499	89841
chr9	4879874	5079874	harbor1	chr9	4924597	4924796	DNA/hAT-Charlie	888	+	100	4924697	44823
chr9	4879874	5079874	harbor1	chr9	4930783	4930938	DNA/hAT-Charlie	808	+	78	4930861	50987
chr9	4879874	5079874	harbor1	chr9	4967764	4967895	DNA/hAT-Charlie	663	+	66	4967830	87956
chr9	4883151	5083151	harbor1	chr9	4924597	4924796	DNA/hAT-Charlie	888	+	100	4924697	41546
chr9	4883151	5083151	harbor1	chr9	4930783	4930938	DNA/hAT-Charlie	808	+	78	4930861	47710
chr9	4883151	5083151	harbor1	chr9	4967764	4967895	DNA/hAT-Charlie	663	+	66	4967830	84679
chr9	4692614	4892614	harbor1	chr9	4698684	4698821	DNA/hAT-Charlie	633	+	68	4698752	6138
chr9	4692614	4892614	harbor1	chr9	4698820	4699116	DNA/hAT-Charlie	1208	+	148	4698968	6354
chr9	4692614	4892614	harbor1	chr9	4775769	4775927	DNA/hAT-Charlie	621	+	79	4775848	83234
chr9	4692270	4892270	harbor1	chr9	4698684	4698821	DNA/hAT-Charlie	633	+	68	4698752	6482
chr9	4692270	4892270	harbor1	chr9	4698820	4699116	DNA/hAT-Charlie	1208	+	148	4698968	6698
chr9	4692270	4892270	harbor1	chr9	4775769	4775927	DNA/hAT-Charlie	621	+	79	4775848	83578
chr9	4669979	4869979	harbor1	chr9	4686769	4687076	DNA/hAT-Charlie	1632	+	154	4686923	16944
chr9	4669979	4869979	harbor1	chr9	4698684	4698821	DNA/hAT-Charlie	633	+	68	4698752	28773
chr9	4669979	4869979	harbor1	chr9	4698820	4699116	DNA/hAT-Charlie	1208	+	148	4698968	28989
chr9	34027018	34227018	harbor1	chr9	34040743	34040906	DNA/hAT-Charlie	647	+	82	34040825	13807
chr9	4692437	4892437	harbor1	chr9	4698684	4698821	DNA/hAT-Charlie	633	+	68	4698752	6315
chr9	4692437	4892437	harbor1	chr9	4698820	4699116	DNA/hAT-Charlie	1208	+	148	4698968	6531
chr9	4692437	4892437	harbor1	chr9	4775769	4775927	DNA/hAT-Charlie	621	+	79	4775848	83411
chr9	4693668	4893668	harbor1	chr9	4698684	4698821	DNA/hAT-Charlie	633	+	68	4698752	5084
chr9	4693668	4893668	harbor1	chr9	4698820	4699116	DNA/hAT-Charlie	1208	+	148	4698968	5300
chr9	4693668	4893668	harbor1	chr9	4775769	4775927	DNA/hAT-Charlie	621	+	79	4775848	82180
chr9	4884822	5084822	harbor1	chr9	4924597	4924796	DNA/hAT-Charlie	888	+	100	4924697	39875
chr9	4884822	5084822	harbor1	chr9	4930783	4930938	DNA/hAT-Charlie	808	+	78	4930861	46039
chr9	4884822	5084822	harbor1	chr9	4967764	4967895	DNA/hAT-Charlie	663	+	66	4967830	83008
chr9	132382125	132582125	harbor1	chr9	132415805	132416329	DNA/hAT-Charlie	508	+	262	132416067	33942
chr9	132382125	132582125	harbor1	chr9	132416936	132417083	DNA/hAT-Charlie	508	+	74	132417010	34885
chr9	132382125	132582125	harbor1	chr9	132418168	132418392	DNA/hAT-Charlie	1089	+	112	132418280	36155
chr9	132382125	132582125	harbor1	chr9	132441803	132441968	DNA/hAT-Charlie	635	+	82	132441885	59760
chr9	68605581	68805581	harbor1	chr9	68633315	68633556	DNA/hAT-Charlie	957	+	120	68633435	27854
chr9	68605581	68805581	harbor1	chr9	68670724	68670994	DNA/hAT-Charlie	754	+	135	68670859	65278
chr9	68605581	68805581	harbor1	chr9	68688590	68688815	DNA/hAT-Charlie	1143	+	112	68688702	83121
chr9	4669278	4869278	harbor1	chr9	4686769	4687076	DNA/hAT-Charlie	1632	+	154	4686923	17645
chr9	4669278	4869278	harbor1	chr9	4698684	4698821	DNA/hAT-Charlie	633	+	68	4698752	29474
chr9	4669278	4869278	harbor1	chr9	4698820	4699116	DNA/hAT-Charlie	1208	+	148	4698968	29690
chr9	4755861	4955861	harbor1	chr9	4775769	4775927	DNA/hAT-Charlie	621	+	79	4775848	19987
chr9	4755861	4955861	harbor1	chr9	4797454	4797665	DNA/hAT-Charlie	1206	+	106	4797560	41699
chr9	4755861	4955861	harbor1	chr9	4829821	4829972	DNA/hAT-Charlie	517	+	76	4829897	74036
chr9	4755861	4955861	harbor1	chr9	4838691	4838848	DNA/hAT-Charlie	655	+	78	4838769	82908
chr9	4884838	5084838	harbor1	chr9	4924597	4924796	DNA/hAT-Charlie	888	+	100	4924697	39859
chr9	4884838	5084838	harbor1	chr9	4930783	4930938	DNA/hAT-Charlie	808	+	78	4930861	46023
chr9	4884838	5084838	harbor1	chr9	4967764	4967895	DNA/hAT-Charlie	663	+	66	4967830	82992
chr9	4703727	4903727	harbor1	chr9	4775769	4775927	DNA/hAT-Charlie	621	+	79	4775848	72121
chr9	4703727	4903727	harbor1	chr9	4797454	4797665	DNA/hAT-Charlie	1206	+	106	4797560	93833
chr9	19130921	19330921	harbor1	chr9	19133215	19133399	DNA/hAT-Charlie	1025	+	92	19133307	2386
chr9	19130921	19330921	harbor1	chr9	19156094	19156306	DNA/hAT-Charlie	830	+	106	19156200	25279
chr9	19130921	19330921	harbor1	chr9	19159729	19159839	DNA/hAT-Charlie	519	+	55	19159784	28863
chr9	4567404	4767404	harbor1	chr9	4620380	4620545	DNA/hAT-Charlie	1063	+	82	4620462	53058
chr9	4567404	4767404	harbor1	chr9	4621279	4621488	DNA/hAT-Charlie	1047	+	104	4621383	53979
chr9	4567404	4767404	harbor1	chr9	4621788	4621807	DNA/hAT-Charlie	1047	+	10	4621798	54394
chr9	4567404	4767404	harbor1	chr9	4621801	4621933	DNA/hAT-Charlie	593	+	66	4621867	54463
chr9	4567404	4767404	harbor1	chr9	4635845	4636237	DNA/hAT-Charlie	910	+	196	4636041	68637
chr9	4567404	4767404	harbor1	chr9	4636257	4636465	DNA/hAT-Charlie	590	+	104	4636361	68957
chr9	4747782	4947782	harbor1	chr9	4775769	4775927	DNA/hAT-Charlie	621	+	79	4775848	28066
chr9	4747782	4947782	harbor1	chr9	4797454	4797665	DNA/hAT-Charlie	1206	+	106	4797560	49778
chr9	4747782	4947782	harbor1	chr9	4829821	4829972	DNA/hAT-Charlie	517	+	76	4829897	82115
chr9	4747782	4947782	harbor1	chr9	4838691	4838848	DNA/hAT-Charlie	655	+	78	4838769	90987
chr9	4884786	5084786	harbor1	chr9	4924597	4924796	DNA/hAT-Charlie	888	+	100	4924697	39911
chr9	4884786	5084786	harbor1	chr9	4930783	4930938	DNA/hAT-Charlie	808	+	78	4930861	46075
chr9	4884786	5084786	harbor1	chr9	4967764	4967895	DNA/hAT-Charlie	663	+	66	4967830	83044
chr9	4692442	4892442	harbor1	chr9	4698684	4698821	DNA/hAT-Charlie	633	+	68	4698752	6310
chr9	4692442	4892442	harbor1	chr9	4698820	4699116	DNA/hAT-Charlie	1208	+	148	4698968	6526
chr9	4692442	4892442	harbor1	chr9	4775769	4775927	DNA/hAT-Charlie	621	+	79	4775848	83406
chr9	4692263	4892263	harbor1	chr9	4698684	4698821	DNA/hAT-Charlie	633	+	68	4698752	6489
chr9	4692263	4892263	harbor1	chr9	4698820	4699116	DNA/hAT-Charlie	1208	+	148	4698968	6705
chr9	4692263	4892263	harbor1	chr9	4775769	4775927	DNA/hAT-Charlie	621	+	79	4775848	83585
chr9	4884812	5084812	harbor1	chr9	4924597	4924796	DNA/hAT-Charlie	888	+	100	4924697	39885
chr9	4884812	5084812	harbor1	chr9	4930783	4930938	DNA/hAT-Charlie	808	+	78	4930861	46049
chr9	4884812	5084812	harbor1	chr9	4967764	4967895	DNA/hAT-Charlie	663	+	66	4967830	83018
chr9	4692767	4892767	harbor1	chr9	4698684	4698821	DNA/hAT-Charlie	633	+	68	4698752	5985
chr9	4692767	4892767	harbor1	chr9	4698820	4699116	DNA/hAT-Charlie	1208	+	148	4698968	6201
chr9	4692767	4892767	harbor1	chr9	4775769	4775927	DNA/hAT-Charlie	621	+	79	4775848	83081
chr9	4884794	5084794	harbor1	chr9	4924597	4924796	DNA/hAT-Charlie	888	+	100	4924697	39903
chr9	4884794	5084794	harbor1	chr9	4930783	4930938	DNA/hAT-Charlie	808	+	78	4930861	46067
chr9	4884794	5084794	harbor1	chr9	4967764	4967895	DNA/hAT-Charlie	663	+	66	4967830	83036
chr9	68603685	68803685	harbor1	chr9	68633315	68633556	DNA/hAT-Charlie	957	+	120	68633435	29750
chr9	68603685	68803685	harbor1	chr9	68670724	68670994	DNA/hAT-Charlie	754	+	135	68670859	67174
chr9	68603685	68803685	harbor1	chr9	68688590	68688815	DNA/hAT-Charlie	1143	+	112	68688702	85017
chr9	4663011	4863011	harbor1	chr9	4686769	4687076	DNA/hAT-Charlie	1632	+	154	4686923	23912
chr9	4663011	4863011	harbor1	chr9	4698684	4698821	DNA/hAT-Charlie	633	+	68	4698752	35741
chr9	4663011	4863011	harbor1	chr9	4698820	4699116	DNA/hAT-Charlie	1208	+	148	4698968	35957
chr9	4704642	4904642	harbor1	chr9	4775769	4775927	DNA/hAT-Charlie	621	+	79	4775848	71206
chr9	4704642	4904642	harbor1	chr9	4797454	4797665	DNA/hAT-Charlie	1206	+	106	4797560	92918
chr9	95414535	95614535	harbor1	chr9	95477115	95477287	DNA/hAT-Charlie	601	+	86	95477201	62666
chr9	95414535	95614535	harbor1	chr9	95501166	95501383	DNA/hAT-Charlie	1153	+	108	95501274	86739
chr9	35657186	35857186	harbor1	chr9	35683894	35684059	DNA/hAT-Charlie	624	+	82	35683976	26790
chr9	4698312	4898312	harbor1	chr9	4698684	4698821	DNA/hAT-Charlie	633	+	68	4698752	440
chr9	4698312	4898312	harbor1	chr9	4698820	4699116	DNA/hAT-Charlie	1208	+	148	4698968	656
chr9	4698312	4898312	harbor1	chr9	4775769	4775927	DNA/hAT-Charlie	621	+	79	4775848	77536
chr9	4698312	4898312	harbor1	chr9	4797454	4797665	DNA/hAT-Charlie	1206	+	106	4797560	99248
chr9	4883407	5083407	harbor1	chr9	4924597	4924796	DNA/hAT-Charlie	888	+	100	4924697	41290
chr9	4883407	5083407	harbor1	chr9	4930783	4930938	DNA/hAT-Charlie	808	+	78	4930861	47454
chr9	4883407	5083407	harbor1	chr9	4967764	4967895	DNA/hAT-Charlie	663	+	66	4967830	84423
chr9	133055213	133255213	harbor1	chr9	133068402	133068564	DNA/hAT-Charlie	670	+	81	133068483	13270
chr9	133055213	133255213	harbor1	chr9	133084186	133084348	DNA/hAT-Charlie	670	+	81	133084267	29054
chr9	133055213	133255213	harbor1	chr9	133126343	133126571	DNA/hAT-Charlie	726	+	114	133126457	71244
chr9	4766714	4966714	harbor1	chr9	4775769	4775927	DNA/hAT-Charlie	621	+	79	4775848	9134
chr9	4766714	4966714	harbor1	chr9	4797454	4797665	DNA/hAT-Charlie	1206	+	106	4797560	30846
chr9	4766714	4966714	harbor1	chr9	4829821	4829972	DNA/hAT-Charlie	517	+	76	4829897	63183
chr9	4766714	4966714	harbor1	chr9	4838691	4838848	DNA/hAT-Charlie	655	+	78	4838769	72055
chr9	133063758	133263758	harbor1	chr9	133068402	133068564	DNA/hAT-Charlie	670	+	81	133068483	4725
chr9	133063758	133263758	harbor1	chr9	133084186	133084348	DNA/hAT-Charlie	670	+	81	133084267	20509
chr9	133063758	133263758	harbor1	chr9	133126343	133126571	DNA/hAT-Charlie	726	+	114	133126457	62699
chr9	4883310	5083310	harbor1	chr9	4924597	4924796	DNA/hAT-Charlie	888	+	100	4924697	41387
chr9	4883310	5083310	harbor1	chr9	4930783	4930938	DNA/hAT-Charlie	808	+	78	4930861	47551
chr9	4883310	5083310	harbor1	chr9	4967764	4967895	DNA/hAT-Charlie	663	+	66	4967830	84520
chr9	135599708	135799708	harbor1	chr9	135640122	135640438	DNA/hAT-Charlie	888	+	158	135640280	40572
chr9	135599708	135799708	harbor1	chr9	135640750	135640789	DNA/hAT-Charlie	888	+	20	135640770	41062
chr9	4883306	5083306	harbor1	chr9	4924597	4924796	DNA/hAT-Charlie	888	+	100	4924697	41391
chr9	4883306	5083306	harbor1	chr9	4930783	4930938	DNA/hAT-Charlie	808	+	78	4930861	47555
chr9	4883306	5083306	harbor1	chr9	4967764	4967895	DNA/hAT-Charlie	663	+	66	4967830	84524
chr9	111796999	111996999	harbor1	chr9	111807781	111807872	DNA/hAT-Charlie	512	+	46	111807827	10828
chr9	111796999	111996999	harbor1	chr9	111878779	111878934	DNA/hAT-Charlie	915	+	78	111878857	81858
chr9	4663450	4863450	harbor1	chr9	4686769	4687076	DNA/hAT-Charlie	1632	+	154	4686923	23473
chr9	4663450	4863450	harbor1	chr9	4698684	4698821	DNA/hAT-Charlie	633	+	68	4698752	35302
chr9	4663450	4863450	harbor1	chr9	4698820	4699116	DNA/hAT-Charlie	1208	+	148	4698968	35518
chr9	126299438	126499438	harbor1	chr9	126325243	126325462	DNA/hAT-Charlie	651	+	110	126325353	25915
chr9	126299438	126499438	harbor1	chr9	126333925	126334100	DNA/hAT-Charlie	610	+	88	126334013	34575
chr9	3230875	3430875	harbor1	chr9	3265085	3265278	DNA/hAT-Charlie	807	+	96	3265181	34306
chr9	3230875	3430875	harbor1	chr9	3312006	3312202	DNA/hAT-Charlie	702	+	98	3312104	81229
chr9	3230875	3430875	harbor1	chr9	3319170	3319335	DNA/hAT-Charlie	649	+	82	3319252	88377
chr9	4739858	4939858	harbor1	chr9	4775769	4775927	DNA/hAT-Charlie	621	+	79	4775848	35990
chr9	4739858	4939858	harbor1	chr9	4797454	4797665	DNA/hAT-Charlie	1206	+	106	4797560	57702
chr9	4739858	4939858	harbor1	chr9	4829821	4829972	DNA/hAT-Charlie	517	+	76	4829897	90039
chr9	4739858	4939858	harbor1	chr9	4838691	4838848	DNA/hAT-Charlie	655	+	78	4838769	98911
chr9	4663900	4863900	harbor1	chr9	4686769	4687076	DNA/hAT-Charlie	1632	+	154	4686923	23023
chr9	4663900	4863900	harbor1	chr9	4698684	4698821	DNA/hAT-Charlie	633	+	68	4698752	34852
chr9	4663900	4863900	harbor1	chr9	4698820	4699116	DNA/hAT-Charlie	1208	+	148	4698968	35068
chr9	83716782	83916782	harbor1	chr9	83783299	83783484	DNA/hAT-Charlie	800	+	92	83783391	66609
chr9	83716782	83916782	harbor1	chr9	83793373	83793884	DNA/hAT-Charlie	2086	+	256	83793629	76847
chr9	83716782	83916782	harbor1	chr9	83794206	83794754	DNA/hAT-Charlie	2086	+	274	83794480	77698
chr9	83716782	83916782	harbor1	chr9	83809421	83809812	DNA/hAT-Charlie	2051	+	196	83809617	92835
chr9	83716782	83916782	harbor1	chr9	83810104	83810558	DNA/hAT-Charlie	2051	+	227	83810331	93549
chr9	4884859	5084859	harbor1	chr9	4924597	4924796	DNA/hAT-Charlie	888	+	100	4924697	39838
chr9	4884859	5084859	harbor1	chr9	4930783	4930938	DNA/hAT-Charlie	808	+	78	4930861	46002
chr9	4884859	5084859	harbor1	chr9	4967764	4967895	DNA/hAT-Charlie	663	+	66	4967830	82971
chr9	4692956	4892956	harbor1	chr9	4698684	4698821	DNA/hAT-Charlie	633	+	68	4698752	5796
chr9	4692956	4892956	harbor1	chr9	4698820	4699116	DNA/hAT-Charlie	1208	+	148	4698968	6012
chr9	4692956	4892956	harbor1	chr9	4775769	4775927	DNA/hAT-Charlie	621	+	79	4775848	82892
chr9	4694138	4894138	harbor1	chr9	4698684	4698821	DNA/hAT-Charlie	633	+	68	4698752	4614
chr9	4694138	4894138	harbor1	chr9	4698820	4699116	DNA/hAT-Charlie	1208	+	148	4698968	4830
chr9	4694138	4894138	harbor1	chr9	4775769	4775927	DNA/hAT-Charlie	621	+	79	4775848	81710
chr9	4692434	4892434	harbor1	chr9	4698684	4698821	DNA/hAT-Charlie	633	+	68	4698752	6318
chr9	4692434	4892434	harbor1	chr9	4698820	4699116	DNA/hAT-Charlie	1208	+	148	4698968	6534
chr9	4692434	4892434	harbor1	chr9	4775769	4775927	DNA/hAT-Charlie	621	+	79	4775848	83414
chr9	4663906	4863906	harbor1	chr9	4686769	4687076	DNA/hAT-Charlie	1632	+	154	4686923	23017
chr9	4663906	4863906	harbor1	chr9	4698684	4698821	DNA/hAT-Charlie	633	+	68	4698752	34846
chr9	4663906	4863906	harbor1	chr9	4698820	4699116	DNA/hAT-Charlie	1208	+	148	4698968	35062
chr9	4879900	5079900	harbor1	chr9	4924597	4924796	DNA/hAT-Charlie	888	+	100	4924697	44797
chr9	4879900	5079900	harbor1	chr9	4930783	4930938	DNA/hAT-Charlie	808	+	78	4930861	50961
chr9	4879900	5079900	harbor1	chr9	4967764	4967895	DNA/hAT-Charlie	663	+	66	4967830	87930
chr9	4877201	5077201	harbor1	chr9	4924597	4924796	DNA/hAT-Charlie	888	+	100	4924697	47496
chr9	4877201	5077201	harbor1	chr9	4930783	4930938	DNA/hAT-Charlie	808	+	78	4930861	53660
chr9	4877201	5077201	harbor1	chr9	4967764	4967895	DNA/hAT-Charlie	663	+	66	4967830	90629
chr9	1	114163	harbor1	chr9	27382	27631	DNA/hAT-Charlie	1303	+	124	27506	27505
chr9	1	114163	harbor1	chr9	36827	37213	DNA/hAT-Charlie	1562	+	193	37020	37019
chr9	1	114163	harbor1	chr9	53350	53510	DNA/hAT-Charlie	691	+	80	53430	53429
chr9	1	114163	harbor1	chr9	91533	91682	DNA/hAT-Charlie	749	+	74	91607	91606
chr9	4663278	4863278	harbor1	chr9	4686769	4687076	DNA/hAT-Charlie	1632	+	154	4686923	23645
chr9	4663278	4863278	harbor1	chr9	4698684	4698821	DNA/hAT-Charlie	633	+	68	4698752	35474
chr9	4663278	4863278	harbor1	chr9	4698820	4699116	DNA/hAT-Charlie	1208	+	148	4698968	35690
chr9	113066019	113266019	harbor1	chr9	113132249	113132462	DNA/hAT-Charlie	1179	+	106	113132355	66336
chr9	35598598	35798598	harbor1	chr9	35601742	35601953	DNA/hAT-Charlie	1318	+	106	35601848	3250
chr9	35598598	35798598	harbor1	chr9	35606484	35606686	DNA/hAT-Charlie	594	+	101	35606585	7987
chr9	35598598	35798598	harbor1	chr9	35656470	35656808	DNA/hAT-Charlie	2273	+	169	35656639	58041
chr9	35598598	35798598	harbor1	chr9	35683894	35684059	DNA/hAT-Charlie	624	+	82	35683976	85378
chr9	4755859	4955859	harbor1	chr9	4775769	4775927	DNA/hAT-Charlie	621	+	79	4775848	19989
chr9	4755859	4955859	harbor1	chr9	4797454	4797665	DNA/hAT-Charlie	1206	+	106	4797560	41701
chr9	4755859	4955859	harbor1	chr9	4829821	4829972	DNA/hAT-Charlie	517	+	76	4829897	74038
chr9	4755859	4955859	harbor1	chr9	4838691	4838848	DNA/hAT-Charlie	655	+	78	4838769	82910
chr9	1915302	2115302	harbor1	chr9	1974245	1974398	DNA/hAT-Charlie	732	+	76	1974321	59019
chr9	1915302	2115302	harbor1	chr9	1993976	1994131	DNA/hAT-Charlie	688	+	78	1994054	78752
chr9	133063183	133263183	harbor1	chr9	133068402	133068564	DNA/hAT-Charlie	670	+	81	133068483	5300
chr9	133063183	133263183	harbor1	chr9	133084186	133084348	DNA/hAT-Charlie	670	+	81	133084267	21084
chr9	133063183	133263183	harbor1	chr9	133126343	133126571	DNA/hAT-Charlie	726	+	114	133126457	63274
chr9	4692945	4892945	harbor1	chr9	4698684	4698821	DNA/hAT-Charlie	633	+	68	4698752	5807
chr9	4692945	4892945	harbor1	chr9	4698820	4699116	DNA/hAT-Charlie	1208	+	148	4698968	6023
chr9	4692945	4892945	harbor1	chr9	4775769	4775927	DNA/hAT-Charlie	621	+	79	4775848	82903
chr9	4663875	4863875	harbor1	chr9	4686769	4687076	DNA/hAT-Charlie	1632	+	154	4686923	23048
chr9	4663875	4863875	harbor1	chr9	4698684	4698821	DNA/hAT-Charlie	633	+	68	4698752	34877
chr9	4663875	4863875	harbor1	chr9	4698820	4699116	DNA/hAT-Charlie	1208	+	148	4698968	35093
chr9	1987488	2187488	harbor1	chr9	1993976	1994131	DNA/hAT-Charlie	688	+	78	1994054	6566
chr9	1987488	2187488	harbor1	chr9	2039038	2039291	DNA/hAT-Charlie	1233	+	126	2039164	51676
chr9	4692940	4892940	harbor1	chr9	4698684	4698821	DNA/hAT-Charlie	633	+	68	4698752	5812
chr9	4692940	4892940	harbor1	chr9	4698820	4699116	DNA/hAT-Charlie	1208	+	148	4698968	6028
chr9	4692940	4892940	harbor1	chr9	4775769	4775927	DNA/hAT-Charlie	621	+	79	4775848	82908
chr9	4669568	4869568	harbor1	chr9	4686769	4687076	DNA/hAT-Charlie	1632	+	154	4686923	17355
chr9	4669568	4869568	harbor1	chr9	4698684	4698821	DNA/hAT-Charlie	633	+	68	4698752	29184
chr9	4669568	4869568	harbor1	chr9	4698820	4699116	DNA/hAT-Charlie	1208	+	148	4698968	29400
chr9	4884854	5084854	harbor1	chr9	4924597	4924796	DNA/hAT-Charlie	888	+	100	4924697	39843
chr9	4884854	5084854	harbor1	chr9	4930783	4930938	DNA/hAT-Charlie	808	+	78	4930861	46007
chr9	4884854	5084854	harbor1	chr9	4967764	4967895	DNA/hAT-Charlie	663	+	66	4967830	82976
chr9	123332197	123532197	harbor1	chr9	123337252	123337409	DNA/hAT-Charlie	1130	+	78	123337330	5133
chr9	123332197	123532197	harbor1	chr9	123337719	123337835	DNA/hAT-Charlie	1130	+	58	123337777	5580
chr9	123332197	123532197	harbor1	chr9	123351434	123352016	DNA/hAT-Charlie	1393	+	291	123351725	19528
chr9	123332197	123532197	harbor1	chr9	123412897	123412927	DNA/hAT-Charlie	822	+	15	123412912	80715
chr9	123332197	123532197	harbor1	chr9	123413199	123413422	DNA/hAT-Charlie	832	+	112	123413311	81114
chr9	4884933	5084933	harbor1	chr9	4924597	4924796	DNA/hAT-Charlie	888	+	100	4924697	39764
chr9	4884933	5084933	harbor1	chr9	4930783	4930938	DNA/hAT-Charlie	808	+	78	4930861	45928
chr9	4884933	5084933	harbor1	chr9	4967764	4967895	DNA/hAT-Charlie	663	+	66	4967830	82897
chr9	4692448	4892448	harbor1	chr9	4698684	4698821	DNA/hAT-Charlie	633	+	68	4698752	6304
chr9	4692448	4892448	harbor1	chr9	4698820	4699116	DNA/hAT-Charlie	1208	+	148	4698968	6520
chr9	4692448	4892448	harbor1	chr9	4775769	4775927	DNA/hAT-Charlie	621	+	79	4775848	83400
chr9	4692452	4892452	harbor1	chr9	4698684	4698821	DNA/hAT-Charlie	633	+	68	4698752	6300
chr9	4692452	4892452	harbor1	chr9	4698820	4699116	DNA/hAT-Charlie	1208	+	148	4698968	6516
chr9	4692452	4892452	harbor1	chr9	4775769	4775927	DNA/hAT-Charlie	621	+	79	4775848	83396
chr9	4885046	5085046	harbor1	chr9	4924597	4924796	DNA/hAT-Charlie	888	+	100	4924697	39651
chr9	4885046	5085046	harbor1	chr9	4930783	4930938	DNA/hAT-Charlie	808	+	78	4930861	45815
chr9	4885046	5085046	harbor1	chr9	4967764	4967895	DNA/hAT-Charlie	663	+	66	4967830	82784
chr9	4692258	4892258	harbor1	chr9	4698684	4698821	DNA/hAT-Charlie	633	+	68	4698752	6494
chr9	4692258	4892258	harbor1	chr9	4698820	4699116	DNA/hAT-Charlie	1208	+	148	4698968	6710
chr9	4692258	4892258	harbor1	chr9	4775769	4775927	DNA/hAT-Charlie	621	+	79	4775848	83590
chr9	4747506	4947506	harbor1	chr9	4775769	4775927	DNA/hAT-Charlie	621	+	79	4775848	28342
chr9	4747506	4947506	harbor1	chr9	4797454	4797665	DNA/hAT-Charlie	1206	+	106	4797560	50054
chr9	4747506	4947506	harbor1	chr9	4829821	4829972	DNA/hAT-Charlie	517	+	76	4829897	82391
chr9	4747506	4947506	harbor1	chr9	4838691	4838848	DNA/hAT-Charlie	655	+	78	4838769	91263
chr9	35656433	35856433	harbor1	chr9	35656470	35656808	DNA/hAT-Charlie	2273	+	169	35656639	206
chr9	35656433	35856433	harbor1	chr9	35683894	35684059	DNA/hAT-Charlie	624	+	82	35683976	27543
chr9	4884905	5084905	harbor1	chr9	4924597	4924796	DNA/hAT-Charlie	888	+	100	4924697	39792
chr9	4884905	5084905	harbor1	chr9	4930783	4930938	DNA/hAT-Charlie	808	+	78	4930861	45956
chr9	4884905	5084905	harbor1	chr9	4967764	4967895	DNA/hAT-Charlie	663	+	66	4967830	82925
chr9	35580921	35780921	harbor1	chr9	35601742	35601953	DNA/hAT-Charlie	1318	+	106	35601848	20927
chr9	35580921	35780921	harbor1	chr9	35606484	35606686	DNA/hAT-Charlie	594	+	101	35606585	25664
chr9	35580921	35780921	harbor1	chr9	35656470	35656808	DNA/hAT-Charlie	2273	+	169	35656639	75718
chr9	1955526	2155526	harbor1	chr9	1974245	1974398	DNA/hAT-Charlie	732	+	76	1974321	18795
chr9	1955526	2155526	harbor1	chr9	1993976	1994131	DNA/hAT-Charlie	688	+	78	1994054	38528
chr9	1955526	2155526	harbor1	chr9	2039038	2039291	DNA/hAT-Charlie	1233	+	126	2039164	83638
chr9	89260220	89460220	harbor1	chr9	89356043	89356363	DNA/hAT-Charlie	2053	+	160	89356203	95983
chr9	4884994	5084994	harbor1	chr9	4924597	4924796	DNA/hAT-Charlie	888	+	100	4924697	39703
chr9	4884994	5084994	harbor1	chr9	4930783	4930938	DNA/hAT-Charlie	808	+	78	4930861	45867
chr9	4884994	5084994	harbor1	chr9	4967764	4967895	DNA/hAT-Charlie	663	+	66	4967830	82836
chr9	136878128	137078128	harbor1	chr9	136899031	136899233	DNA/hAT-Charlie	498	+	101	136899132	21004
chr9	4692158	4892158	harbor1	chr9	4698684	4698821	DNA/hAT-Charlie	633	+	68	4698752	6594
chr9	4692158	4892158	harbor1	chr9	4698820	4699116	DNA/hAT-Charlie	1208	+	148	4698968	6810
chr9	4692158	4892158	harbor1	chr9	4775769	4775927	DNA/hAT-Charlie	621	+	79	4775848	83690
chr9	134577518	134777518	harbor1	chr9	134621550	134621755	DNA/hAT-Charlie	952	+	102	134621652	44134
chr9	134577518	134777518	harbor1	chr9	134624045	134624248	DNA/hAT-Charlie	729	+	102	134624147	46629
chr9	134577518	134777518	harbor1	chr9	134652501	134652651	DNA/hAT-Charlie	589	+	75	134652576	75058
chr9	4669265	4869265	harbor1	chr9	4686769	4687076	DNA/hAT-Charlie	1632	+	154	4686923	17658
chr9	4669265	4869265	harbor1	chr9	4698684	4698821	DNA/hAT-Charlie	633	+	68	4698752	29487
chr9	4669265	4869265	harbor1	chr9	4698820	4699116	DNA/hAT-Charlie	1208	+	148	4698968	29703
chr9	136446465	136646465	harbor1	chr9	136485974	136486157	DNA/hAT-Charlie	660	+	92	136486066	39601
chr9	136446465	136646465	harbor1	chr9	136491092	136491231	DNA/hAT-Charlie	801	+	70	136491162	44697
chr9	136446465	136646465	harbor1	chr9	136491538	136491674	DNA/hAT-Charlie	801	+	68	136491606	45141
chr9	97885114	98085114	harbor1	chr9	97935308	97935535	DNA/hAT-Charlie	909	+	114	97935422	50308
chr9	97885114	98085114	harbor1	chr9	97937111	97937211	DNA/hAT-Charlie	1632	+	50	97937161	52047
chr9	97885114	98085114	harbor1	chr9	97937377	97937703	DNA/hAT-Charlie	1632	+	163	97937540	52426
chr9	97885114	98085114	harbor1	chr9	97960227	97960422	DNA/hAT-Charlie	1039	+	98	97960325	75211
chr9	97885114	98085114	harbor1	chr9	97962884	97963004	DNA/hAT-Charlie	536	+	60	97962944	77830
chr9	133586298	133786298	harbor1	chr9	133653120	133653299	DNA/hAT-Charlie	731	+	90	133653210	66912
chr9	133586298	133786298	harbor1	chr9	133684139	133684338	DNA/hAT-Charlie	762	+	100	133684239	97941
chr9	4748106	4948106	harbor1	chr9	4775769	4775927	DNA/hAT-Charlie	621	+	79	4775848	27742
chr9	4748106	4948106	harbor1	chr9	4797454	4797665	DNA/hAT-Charlie	1206	+	106	4797560	49454
chr9	4748106	4948106	harbor1	chr9	4829821	4829972	DNA/hAT-Charlie	517	+	76	4829897	81791
chr9	4748106	4948106	harbor1	chr9	4838691	4838848	DNA/hAT-Charlie	655	+	78	4838769	90663
chr9	136446547	136646547	harbor1	chr9	136485974	136486157	DNA/hAT-Charlie	660	+	92	136486066	39519
chr9	136446547	136646547	harbor1	chr9	136491092	136491231	DNA/hAT-Charlie	801	+	70	136491162	44615
chr9	136446547	136646547	harbor1	chr9	136491538	136491674	DNA/hAT-Charlie	801	+	68	136491606	45059
chr9	83553396	83753396	harbor1	chr9	83559795	83560048	DNA/hAT-Charlie	753	+	126	83559921	6525
chr9	83553396	83753396	harbor1	chr9	83590869	83591057	DNA/hAT-Charlie	610	+	94	83590963	37567
chr9	83553396	83753396	harbor1	chr9	83592064	83592315	DNA/hAT-Charlie	818	+	126	83592190	38794
chr9	83553396	83753396	harbor1	chr9	83592314	83592497	DNA/hAT-Charlie	842	+	92	83592406	39010
chr9	83553396	83753396	harbor1	chr9	83592799	83592998	DNA/hAT-Charlie	842	+	100	83592899	39503
chr9	83553396	83753396	harbor1	chr9	83593393	83593638	DNA/hAT-Charlie	547	+	122	83593515	40119
chr9	83553396	83753396	harbor1	chr9	83626854	83627251	DNA/hAT-Charlie	1033	+	198	83627052	73656
chr9	83553396	83753396	harbor1	chr9	83645302	83645720	DNA/hAT-Charlie	664	+	209	83645511	92115
chr9	83553396	83753396	harbor1	chr9	83648649	83648792	DNA/hAT-Charlie	662	+	72	83648721	95325
chr9	83553396	83753396	harbor1	chr9	83649078	83649244	DNA/hAT-Charlie	662	+	83	83649161	95765
chr9	83553396	83753396	harbor1	chr9	83556236	83558490	DNA/hAT-Charlie	5309	+	1127	83557363	3967
chr9	133605246	133805246	harbor1	chr9	133653120	133653299	DNA/hAT-Charlie	731	+	90	133653210	47964
chr9	133605246	133805246	harbor1	chr9	133684139	133684338	DNA/hAT-Charlie	762	+	100	133684239	78993
chr9	4884926	5084926	harbor1	chr9	4924597	4924796	DNA/hAT-Charlie	888	+	100	4924697	39771
chr9	4884926	5084926	harbor1	chr9	4930783	4930938	DNA/hAT-Charlie	808	+	78	4930861	45935
chr9	4884926	5084926	harbor1	chr9	4967764	4967895	DNA/hAT-Charlie	663	+	66	4967830	82904
chr9	4692312	4892312	harbor1	chr9	4698684	4698821	DNA/hAT-Charlie	633	+	68	4698752	6440
chr9	4692312	4892312	harbor1	chr9	4698820	4699116	DNA/hAT-Charlie	1208	+	148	4698968	6656
chr9	4692312	4892312	harbor1	chr9	4775769	4775927	DNA/hAT-Charlie	621	+	79	4775848	83536
chr9	4692909	4892909	harbor1	chr9	4698684	4698821	DNA/hAT-Charlie	633	+	68	4698752	5843
chr9	4692909	4892909	harbor1	chr9	4698820	4699116	DNA/hAT-Charlie	1208	+	148	4698968	6059
chr9	4692909	4892909	harbor1	chr9	4775769	4775927	DNA/hAT-Charlie	621	+	79	4775848	82939
chr9	4663127	4863127	harbor1	chr9	4686769	4687076	DNA/hAT-Charlie	1632	+	154	4686923	23796
chr9	4663127	4863127	harbor1	chr9	4698684	4698821	DNA/hAT-Charlie	633	+	68	4698752	35625
chr9	4663127	4863127	harbor1	chr9	4698820	4699116	DNA/hAT-Charlie	1208	+	148	4698968	35841
chr9	133904999	134104999	harbor1	chr9	133941021	133941125	DNA/hAT-Charlie	571	+	52	133941073	36074
chr9	133904999	134104999	harbor1	chr9	133941427	133941509	DNA/hAT-Charlie	571	+	41	133941468	36469
chr9	133904999	134104999	harbor1	chr9	133982707	133983016	DNA/hAT-Charlie	1193	+	154	133982861	77862
chr9	133904999	134104999	harbor1	chr9	133984925	133985047	DNA/hAT-Charlie	501	+	61	133984986	79987
chr9	68605563	68805563	harbor1	chr9	68633315	68633556	DNA/hAT-Charlie	957	+	120	68633435	27872
chr9	68605563	68805563	harbor1	chr9	68670724	68670994	DNA/hAT-Charlie	754	+	135	68670859	65296
chr9	68605563	68805563	harbor1	chr9	68688590	68688815	DNA/hAT-Charlie	1143	+	112	68688702	83139
chr9	4692971	4892971	harbor1	chr9	4698684	4698821	DNA/hAT-Charlie	633	+	68	4698752	5781
chr9	4692971	4892971	harbor1	chr9	4698820	4699116	DNA/hAT-Charlie	1208	+	148	4698968	5997
chr9	4692971	4892971	harbor1	chr9	4775769	4775927	DNA/hAT-Charlie	621	+	79	4775848	82877
chr9	132966900	133166900	harbor1	chr9	133043294	133043412	DNA/hAT-Charlie	488	+	59	133043353	76453
chr9	4884847	5084847	harbor1	chr9	4924597	4924796	DNA/hAT-Charlie	888	+	100	4924697	39850
chr9	4884847	5084847	harbor1	chr9	4930783	4930938	DNA/hAT-Charlie	808	+	78	4930861	46014
chr9	4884847	5084847	harbor1	chr9	4967764	4967895	DNA/hAT-Charlie	663	+	66	4967830	82983
chr9	112387221	112587221	harbor1	chr9	112410938	112411392	DNA/hAT-Charlie	1921	+	227	112411165	23944
chr9	112387221	112587221	harbor1	chr9	112411688	112412023	DNA/hAT-Charlie	1921	+	168	112411856	24635
chr9	112387221	112587221	harbor1	chr9	112412233	112412530	DNA/hAT-Charlie	853	+	148	112412381	25160
chr9	112387221	112587221	harbor1	chr9	112412652	112412804	DNA/hAT-Charlie	597	+	76	112412728	25507
chr9	4692946	4892946	harbor1	chr9	4698684	4698821	DNA/hAT-Charlie	633	+	68	4698752	5806
chr9	4692946	4892946	harbor1	chr9	4698820	4699116	DNA/hAT-Charlie	1208	+	148	4698968	6022
chr9	4692946	4892946	harbor1	chr9	4775769	4775927	DNA/hAT-Charlie	621	+	79	4775848	82902
chr9	4883816	5083816	harbor1	chr9	4924597	4924796	DNA/hAT-Charlie	888	+	100	4924697	40881
chr9	4883816	5083816	harbor1	chr9	4930783	4930938	DNA/hAT-Charlie	808	+	78	4930861	47045
chr9	4883816	5083816	harbor1	chr9	4967764	4967895	DNA/hAT-Charlie	663	+	66	4967830	84014
chr9	4663649	4863649	harbor1	chr9	4686769	4687076	DNA/hAT-Charlie	1632	+	154	4686923	23274
chr9	4663649	4863649	harbor1	chr9	4698684	4698821	DNA/hAT-Charlie	633	+	68	4698752	35103
chr9	4663649	4863649	harbor1	chr9	4698820	4699116	DNA/hAT-Charlie	1208	+	148	4698968	35319
chr9	35691958	35891958	harbor1	chr9	35762654	35762882	DNA/hAT-Charlie	557	+	114	35762768	70810
chr9	35691958	35891958	harbor1	chr9	35782159	35782316	DNA/hAT-Charlie	535	+	78	35782237	90279
chr9	35691958	35891958	harbor1	chr9	35785321	35785505	DNA/hAT-Charlie	545	+	92	35785413	93455
chr9	4663080	4863080	harbor1	chr9	4686769	4687076	DNA/hAT-Charlie	1632	+	154	4686923	23843
chr9	4663080	4863080	harbor1	chr9	4698684	4698821	DNA/hAT-Charlie	633	+	68	4698752	35672
chr9	4663080	4863080	harbor1	chr9	4698820	4699116	DNA/hAT-Charlie	1208	+	148	4698968	35888
chr9	125322076	125522076	harbor1	chr9	125334051	125335395	DNA/hAT-Charlie	2979	+	672	125334723	12647
chr9	125322076	125522076	harbor1	chr9	125335690	125335870	DNA/hAT-Charlie	2979	+	90	125335780	13704
chr9	125322076	125522076	harbor1	chr9	125336162	125336189	DNA/hAT-Charlie	2979	+	14	125336176	14100
chr9	125322076	125522076	harbor1	chr9	125343076	125343313	DNA/hAT-Charlie	1530	+	118	125343194	21118
chr9	4884823	5084823	harbor1	chr9	4924597	4924796	DNA/hAT-Charlie	888	+	100	4924697	39874
chr9	4884823	5084823	harbor1	chr9	4930783	4930938	DNA/hAT-Charlie	808	+	78	4930861	46038
chr9	4884823	5084823	harbor1	chr9	4967764	4967895	DNA/hAT-Charlie	663	+	66	4967830	83007
chr9	133063738	133263738	harbor1	chr9	133068402	133068564	DNA/hAT-Charlie	670	+	81	133068483	4745
chr9	133063738	133263738	harbor1	chr9	133084186	133084348	DNA/hAT-Charlie	670	+	81	133084267	20529
chr9	133063738	133263738	harbor1	chr9	133126343	133126571	DNA/hAT-Charlie	726	+	114	133126457	62719
chr9	126245605	126445605	harbor1	chr9	126252020	126252171	DNA/hAT-Charlie	1248	+	76	126252096	6491
chr9	126245605	126445605	harbor1	chr9	126252518	126252675	DNA/hAT-Charlie	1248	+	78	126252596	6991
chr9	126245605	126445605	harbor1	chr9	126257765	126257869	DNA/hAT-Charlie	561	+	52	126257817	12212
chr9	126245605	126445605	harbor1	chr9	126268018	126268190	DNA/hAT-Charlie	1005	+	86	126268104	22499
chr9	126245605	126445605	harbor1	chr9	126325243	126325462	DNA/hAT-Charlie	651	+	110	126325353	79748
chr9	126245605	126445605	harbor1	chr9	126333925	126334100	DNA/hAT-Charlie	610	+	88	126334013	88408
chr9	68605579	68805579	harbor1	chr9	68633315	68633556	DNA/hAT-Charlie	957	+	120	68633435	27856
chr9	68605579	68805579	harbor1	chr9	68670724	68670994	DNA/hAT-Charlie	754	+	135	68670859	65280
chr9	68605579	68805579	harbor1	chr9	68688590	68688815	DNA/hAT-Charlie	1143	+	112	68688702	83123
chr9	89262840	89462840	harbor1	chr9	89356043	89356363	DNA/hAT-Charlie	2053	+	160	89356203	93363
chr9	4883473	5083473	harbor1	chr9	4924597	4924796	DNA/hAT-Charlie	888	+	100	4924697	41224
chr9	4883473	5083473	harbor1	chr9	4930783	4930938	DNA/hAT-Charlie	808	+	78	4930861	47388
chr9	4883473	5083473	harbor1	chr9	4967764	4967895	DNA/hAT-Charlie	663	+	66	4967830	84357
chr9	35656293	35856293	harbor1	chr9	35656470	35656808	DNA/hAT-Charlie	2273	+	169	35656639	346
chr9	35656293	35856293	harbor1	chr9	35683894	35684059	DNA/hAT-Charlie	624	+	82	35683976	27683
chr9	4669986	4869986	harbor1	chr9	4686769	4687076	DNA/hAT-Charlie	1632	+	154	4686923	16937
chr9	4669986	4869986	harbor1	chr9	4698684	4698821	DNA/hAT-Charlie	633	+	68	4698752	28766
chr9	4669986	4869986	harbor1	chr9	4698820	4699116	DNA/hAT-Charlie	1208	+	148	4698968	28982
chr9	4884959	5084959	harbor1	chr9	4924597	4924796	DNA/hAT-Charlie	888	+	100	4924697	39738
chr9	4884959	5084959	harbor1	chr9	4930783	4930938	DNA/hAT-Charlie	808	+	78	4930861	45902
chr9	4884959	5084959	harbor1	chr9	4967764	4967895	DNA/hAT-Charlie	663	+	66	4967830	82871
chr9	4692882	4892882	harbor1	chr9	4698684	4698821	DNA/hAT-Charlie	633	+	68	4698752	5870
chr9	4692882	4892882	harbor1	chr9	4698820	4699116	DNA/hAT-Charlie	1208	+	148	4698968	6086
chr9	4692882	4892882	harbor1	chr9	4775769	4775927	DNA/hAT-Charlie	621	+	79	4775848	82966
chr9	3426384	3626384	harbor1	chr9	3426425	3426974	DNA/hAT-Charlie	3310	+	274	3426699	315
chr9	3426384	3626384	harbor1	chr9	3519206	3519463	DNA/hAT-Charlie	623	+	128	3519334	92950
chr9	4884897	5084897	harbor1	chr9	4924597	4924796	DNA/hAT-Charlie	888	+	100	4924697	39800
chr9	4884897	5084897	harbor1	chr9	4930783	4930938	DNA/hAT-Charlie	808	+	78	4930861	45964
chr9	4884897	5084897	harbor1	chr9	4967764	4967895	DNA/hAT-Charlie	663	+	66	4967830	82933
chr9	4884936	5084936	harbor1	chr9	4924597	4924796	DNA/hAT-Charlie	888	+	100	4924697	39761
chr9	4884936	5084936	harbor1	chr9	4930783	4930938	DNA/hAT-Charlie	808	+	78	4930861	45925
chr9	4884936	5084936	harbor1	chr9	4967764	4967895	DNA/hAT-Charlie	663	+	66	4967830	82894
chr9	4722331	4922331	harbor1	chr9	4775769	4775927	DNA/hAT-Charlie	621	+	79	4775848	53517
chr9	4722331	4922331	harbor1	chr9	4797454	4797665	DNA/hAT-Charlie	1206	+	106	4797560	75229
chr9	4883068	5083068	harbor1	chr9	4924597	4924796	DNA/hAT-Charlie	888	+	100	4924697	41629
chr9	4883068	5083068	harbor1	chr9	4930783	4930938	DNA/hAT-Charlie	808	+	78	4930861	47793
chr9	4883068	5083068	harbor1	chr9	4967764	4967895	DNA/hAT-Charlie	663	+	66	4967830	84762
chr9	4884790	5084790	harbor1	chr9	4924597	4924796	DNA/hAT-Charlie	888	+	100	4924697	39907
chr9	4884790	5084790	harbor1	chr9	4930783	4930938	DNA/hAT-Charlie	808	+	78	4930861	46071
chr9	4884790	5084790	harbor1	chr9	4967764	4967895	DNA/hAT-Charlie	663	+	66	4967830	83040
chr9	136402517	136602517	harbor1	chr9	136485974	136486157	DNA/hAT-Charlie	660	+	92	136486066	83549
chr9	136402517	136602517	harbor1	chr9	136491092	136491231	DNA/hAT-Charlie	801	+	70	136491162	88645
chr9	136402517	136602517	harbor1	chr9	136491538	136491674	DNA/hAT-Charlie	801	+	68	136491606	89089
chr9	127963374	128163374	harbor1	chr9	127988663	127988861	DNA/hAT-Charlie	1181	+	99	127988762	25388
chr9	127963374	128163374	harbor1	chr9	128052504	128052581	DNA/hAT-Charlie	932	+	38	128052542	89168
chr9	127963374	128163374	harbor1	chr9	128052882	128052988	DNA/hAT-Charlie	932	+	53	128052935	89561
chr9	127963374	128163374	harbor1	chr9	128053593	128053640	DNA/hAT-Charlie	932	+	24	128053617	90243
chr9	136446581	136646581	harbor1	chr9	136485974	136486157	DNA/hAT-Charlie	660	+	92	136486066	39485
chr9	136446581	136646581	harbor1	chr9	136491092	136491231	DNA/hAT-Charlie	801	+	70	136491162	44581
chr9	136446581	136646581	harbor1	chr9	136491538	136491674	DNA/hAT-Charlie	801	+	68	136491606	45025
chr9	4663076	4863076	harbor1	chr9	4686769	4687076	DNA/hAT-Charlie	1632	+	154	4686923	23847
chr9	4663076	4863076	harbor1	chr9	4698684	4698821	DNA/hAT-Charlie	633	+	68	4698752	35676
chr9	4663076	4863076	harbor1	chr9	4698820	4699116	DNA/hAT-Charlie	1208	+	148	4698968	35892
chr9	97533584	97733584	harbor1	chr9	97537908	97538145	DNA/hAT-Charlie	488	+	118	97538026	4442
chr9	97533584	97733584	harbor1	chr9	97542523	97542570	DNA/hAT-Charlie	1141	+	24	97542547	8963
chr9	97533584	97733584	harbor1	chr9	97542880	97543057	DNA/hAT-Charlie	1141	+	88	97542968	9384
chr9	97533584	97733584	harbor1	chr9	97579590	97579702	DNA/hAT-Charlie	550	+	56	97579646	46062
chr9	97533584	97733584	harbor1	chr9	97609039	97609298	DNA/hAT-Charlie	1015	+	130	97609169	75585
chr9	97533584	97733584	harbor1	chr9	97617403	97617561	DNA/hAT-Charlie	502	+	79	97617482	83898
chr9	35692023	35892023	harbor1	chr9	35762654	35762882	DNA/hAT-Charlie	557	+	114	35762768	70745
chr9	35692023	35892023	harbor1	chr9	35782159	35782316	DNA/hAT-Charlie	535	+	78	35782237	90214
chr9	35692023	35892023	harbor1	chr9	35785321	35785505	DNA/hAT-Charlie	545	+	92	35785413	93390
chr9	4663656	4863656	harbor1	chr9	4686769	4687076	DNA/hAT-Charlie	1632	+	154	4686923	23267
chr9	4663656	4863656	harbor1	chr9	4698684	4698821	DNA/hAT-Charlie	633	+	68	4698752	35096
chr9	4663656	4863656	harbor1	chr9	4698820	4699116	DNA/hAT-Charlie	1208	+	148	4698968	35312
chr9	19130894	19330894	harbor1	chr9	19133215	19133399	DNA/hAT-Charlie	1025	+	92	19133307	2413
chr9	19130894	19330894	harbor1	chr9	19156094	19156306	DNA/hAT-Charlie	830	+	106	19156200	25306
chr9	19130894	19330894	harbor1	chr9	19159729	19159839	DNA/hAT-Charlie	519	+	55	19159784	28890
chr9	418608	618608	harbor1	chr9	424207	424356	DNA/hAT-Charlie	740	+	74	424281	5673
chr9	418608	618608	harbor1	chr9	424886	425198	DNA/hAT-Charlie	1388	+	156	425042	6434
chr9	418608	618608	harbor1	chr9	435005	435223	DNA/hAT-Charlie	1189	+	109	435114	16506
chr9	418608	618608	harbor1	chr9	438207	438395	DNA/hAT-Charlie	725	+	94	438301	19693
chr9	418608	618608	harbor1	chr9	452152	452338	DNA/hAT-Charlie	1093	+	93	452245	33637
chr9	114075621	114275621	harbor1	chr9	114141281	114141479	DNA/hAT-Charlie	1022	+	99	114141380	65759
chr9	114075621	114275621	harbor1	chr9	114159560	114159726	DNA/hAT-Charlie	492	+	83	114159643	84022
chr9	35692027	35892027	harbor1	chr9	35762654	35762882	DNA/hAT-Charlie	557	+	114	35762768	70741
chr9	35692027	35892027	harbor1	chr9	35782159	35782316	DNA/hAT-Charlie	535	+	78	35782237	90210
chr9	35692027	35892027	harbor1	chr9	35785321	35785505	DNA/hAT-Charlie	545	+	92	35785413	93386
chr9	35654956	35854956	harbor1	chr9	35656470	35656808	DNA/hAT-Charlie	2273	+	169	35656639	1683
chr9	35654956	35854956	harbor1	chr9	35683894	35684059	DNA/hAT-Charlie	624	+	82	35683976	29020
chr9	4830107	5030107	harbor1	chr9	4838691	4838848	DNA/hAT-Charlie	655	+	78	4838769	8662
chr9	4830107	5030107	harbor1	chr9	4924597	4924796	DNA/hAT-Charlie	888	+	100	4924697	94590
chr9	79473211	79673211	harbor1	chr9	79486786	79486972	DNA/hAT-Charlie	940	+	93	79486879	13668
chr9	79473211	79673211	harbor1	chr9	79502503	79502710	DNA/hAT-Charlie	1038	+	104	79502607	29396
chr9	79473211	79673211	harbor1	chr9	79514176	79514485	DNA/hAT-Charlie	1822	+	154	79514330	41119
chr9	79473211	79673211	harbor1	chr9	79514784	79514984	DNA/hAT-Charlie	1822	+	100	79514884	41673
chr9	79473211	79673211	harbor1	chr9	79552479	79552641	DNA/hAT-Charlie	628	+	81	79552560	79349
chr9	4669933	4869933	harbor1	chr9	4686769	4687076	DNA/hAT-Charlie	1632	+	154	4686923	16990
chr9	4669933	4869933	harbor1	chr9	4698684	4698821	DNA/hAT-Charlie	633	+	68	4698752	28819
chr9	4669933	4869933	harbor1	chr9	4698820	4699116	DNA/hAT-Charlie	1208	+	148	4698968	29035
chr9	124761747	124961747	harbor1	chr9	124796736	124796959	DNA/hAT-Charlie	1160	+	112	124796848	35101
chr9	4751750	4951750	harbor1	chr9	4775769	4775927	DNA/hAT-Charlie	621	+	79	4775848	24098
chr9	4751750	4951750	harbor1	chr9	4797454	4797665	DNA/hAT-Charlie	1206	+	106	4797560	45810
chr9	4751750	4951750	harbor1	chr9	4829821	4829972	DNA/hAT-Charlie	517	+	76	4829897	78147
chr9	4751750	4951750	harbor1	chr9	4838691	4838848	DNA/hAT-Charlie	655	+	78	4838769	87019
chr9	133051398	133251398	harbor1	chr9	133068402	133068564	DNA/hAT-Charlie	670	+	81	133068483	17085
chr9	133051398	133251398	harbor1	chr9	133084186	133084348	DNA/hAT-Charlie	670	+	81	133084267	32869
chr9	133051398	133251398	harbor1	chr9	133126343	133126571	DNA/hAT-Charlie	726	+	114	133126457	75059
chr9	137179535	137379535	harbor1	chr9	137203109	137203299	DNA/hAT-Charlie	615	+	95	137203204	23669
chr9	126427098	126627098	harbor1	chr9	126465289	126465435	DNA/hAT-Charlie	599	+	73	126465362	38264
chr9	126427098	126627098	harbor1	chr9	126500512	126500652	DNA/hAT-Charlie	598	+	70	126500582	73484
chr9	126427098	126627098	harbor1	chr9	126510929	126511099	DNA/hAT-Charlie	712	+	85	126511014	83916
chr9	76918823	77118823	harbor1	chr9	76952600	76952792	DNA/hAT-Charlie	864	+	96	76952696	33873
chr9	76918823	77118823	harbor1	chr9	76961137	76961246	DNA/hAT-Charlie	823	+	54	76961191	42368
chr9	76918823	77118823	harbor1	chr9	76961606	76961689	DNA/hAT-Charlie	823	+	42	76961648	42825
chr9	76918823	77118823	harbor1	chr9	76999583	76999737	DNA/hAT-Charlie	615	+	77	76999660	80837
chr9	76918823	77118823	harbor1	chr9	77007393	77007548	DNA/hAT-Charlie	609	+	78	77007471	88648
chr9	76918823	77118823	harbor1	chr9	77007853	77008019	DNA/hAT-Charlie	609	+	83	77007936	89113
chr9	4663097	4863097	harbor1	chr9	4686769	4687076	DNA/hAT-Charlie	1632	+	154	4686923	23826
chr9	4663097	4863097	harbor1	chr9	4698684	4698821	DNA/hAT-Charlie	633	+	68	4698752	35655
chr9	4663097	4863097	harbor1	chr9	4698820	4699116	DNA/hAT-Charlie	1208	+	148	4698968	35871
chr9	68605569	68805569	harbor1	chr9	68633315	68633556	DNA/hAT-Charlie	957	+	120	68633435	27866
chr9	68605569	68805569	harbor1	chr9	68670724	68670994	DNA/hAT-Charlie	754	+	135	68670859	65290
chr9	68605569	68805569	harbor1	chr9	68688590	68688815	DNA/hAT-Charlie	1143	+	112	68688702	83133
chr9	97885166	98085166	harbor1	chr9	97935308	97935535	DNA/hAT-Charlie	909	+	114	97935422	50256
chr9	97885166	98085166	harbor1	chr9	97937111	97937211	DNA/hAT-Charlie	1632	+	50	97937161	51995
chr9	97885166	98085166	harbor1	chr9	97937377	97937703	DNA/hAT-Charlie	1632	+	163	97937540	52374
chr9	97885166	98085166	harbor1	chr9	97960227	97960422	DNA/hAT-Charlie	1039	+	98	97960325	75159
chr9	97885166	98085166	harbor1	chr9	97962884	97963004	DNA/hAT-Charlie	536	+	60	97962944	77778
chr9	111561650	111761650	harbor1	chr9	111605898	111605981	DNA/hAT-Charlie	507	+	42	111605940	44290
chr9	111561650	111761650	harbor1	chr9	111630680	111630836	DNA/hAT-Charlie	900	+	78	111630758	69108
chr9	4668976	4868976	harbor1	chr9	4686769	4687076	DNA/hAT-Charlie	1632	+	154	4686923	17947
chr9	4668976	4868976	harbor1	chr9	4698684	4698821	DNA/hAT-Charlie	633	+	68	4698752	29776
chr9	4668976	4868976	harbor1	chr9	4698820	4699116	DNA/hAT-Charlie	1208	+	148	4698968	29992
chr9	93084336	93284336	harbor1	chr9	93157371	93157540	DNA/hAT-Charlie	572	+	84	93157455	73119
chr9	4885042	5085042	harbor1	chr9	4924597	4924796	DNA/hAT-Charlie	888	+	100	4924697	39655
chr9	4885042	5085042	harbor1	chr9	4930783	4930938	DNA/hAT-Charlie	808	+	78	4930861	45819
chr9	4885042	5085042	harbor1	chr9	4967764	4967895	DNA/hAT-Charlie	663	+	66	4967830	82788
chr9	4883803	5083803	harbor1	chr9	4924597	4924796	DNA/hAT-Charlie	888	+	100	4924697	40894
chr9	4883803	5083803	harbor1	chr9	4930783	4930938	DNA/hAT-Charlie	808	+	78	4930861	47058
chr9	4883803	5083803	harbor1	chr9	4967764	4967895	DNA/hAT-Charlie	663	+	66	4967830	84027
chr9	4692784	4892784	harbor1	chr9	4698684	4698821	DNA/hAT-Charlie	633	+	68	4698752	5968
chr9	4692784	4892784	harbor1	chr9	4698820	4699116	DNA/hAT-Charlie	1208	+	148	4698968	6184
chr9	4692784	4892784	harbor1	chr9	4775769	4775927	DNA/hAT-Charlie	621	+	79	4775848	83064
chr9	4662994	4862994	harbor1	chr9	4686769	4687076	DNA/hAT-Charlie	1632	+	154	4686923	23929
chr9	4662994	4862994	harbor1	chr9	4698684	4698821	DNA/hAT-Charlie	633	+	68	4698752	35758
chr9	4662994	4862994	harbor1	chr9	4698820	4699116	DNA/hAT-Charlie	1208	+	148	4698968	35974
chr9	104717537	104917537	harbor1	chr9	104744066	104744576	DNA/hAT-Charlie	1399	+	255	104744321	26784
chr9	104717537	104917537	harbor1	chr9	104761115	104761424	DNA/hAT-Charlie	1134	+	154	104761269	43732
chr9	104717537	104917537	harbor1	chr9	104789519	104789776	DNA/hAT-Charlie	862	+	128	104789647	72110
chr9	111383307	111583307	harbor1	chr9	111430007	111430319	DNA/hAT-Charlie	1243	+	156	111430163	46856
chr9	4692921	4892921	harbor1	chr9	4698684	4698821	DNA/hAT-Charlie	633	+	68	4698752	5831
chr9	4692921	4892921	harbor1	chr9	4698820	4699116	DNA/hAT-Charlie	1208	+	148	4698968	6047
chr9	4692921	4892921	harbor1	chr9	4775769	4775927	DNA/hAT-Charlie	621	+	79	4775848	82927
chr9	133063669	133263669	harbor1	chr9	133068402	133068564	DNA/hAT-Charlie	670	+	81	133068483	4814
chr9	133063669	133263669	harbor1	chr9	133084186	133084348	DNA/hAT-Charlie	670	+	81	133084267	20598
chr9	133063669	133263669	harbor1	chr9	133126343	133126571	DNA/hAT-Charlie	726	+	114	133126457	62788
chr9	112387266	112587266	harbor1	chr9	112410938	112411392	DNA/hAT-Charlie	1921	+	227	112411165	23899
chr9	112387266	112587266	harbor1	chr9	112411688	112412023	DNA/hAT-Charlie	1921	+	168	112411856	24590
chr9	112387266	112587266	harbor1	chr9	112412233	112412530	DNA/hAT-Charlie	853	+	148	112412381	25115
chr9	112387266	112587266	harbor1	chr9	112412652	112412804	DNA/hAT-Charlie	597	+	76	112412728	25462
chr9	2521362	2721362	harbor1	chr9	2547315	2547522	DNA/hAT-Charlie	706	+	104	2547419	26057
chr9	2521362	2721362	harbor1	chr9	2565958	2566328	DNA/hAT-Charlie	1070	+	185	2566143	44781
chr9	2521362	2721362	harbor1	chr9	2605823	2605968	DNA/hAT-Charlie	1593	+	72	2605895	84533
chr9	2521362	2721362	harbor1	chr9	2606237	2606822	DNA/hAT-Charlie	1593	+	292	2606529	85167
chr9	2521362	2721362	harbor1	chr9	2616899	2617074	DNA/hAT-Charlie	1076	+	88	2616987	95625
chr9	4884820	5084820	harbor1	chr9	4924597	4924796	DNA/hAT-Charlie	888	+	100	4924697	39877
chr9	4884820	5084820	harbor1	chr9	4930783	4930938	DNA/hAT-Charlie	808	+	78	4930861	46041
chr9	4884820	5084820	harbor1	chr9	4967764	4967895	DNA/hAT-Charlie	663	+	66	4967830	83010
chr9	4692190	4892190	harbor1	chr9	4698684	4698821	DNA/hAT-Charlie	633	+	68	4698752	6562
chr9	4692190	4892190	harbor1	chr9	4698820	4699116	DNA/hAT-Charlie	1208	+	148	4698968	6778
chr9	4692190	4892190	harbor1	chr9	4775769	4775927	DNA/hAT-Charlie	621	+	79	4775848	83658
chr9	112387344	112587344	harbor1	chr9	112410938	112411392	DNA/hAT-Charlie	1921	+	227	112411165	23821
chr9	112387344	112587344	harbor1	chr9	112411688	112412023	DNA/hAT-Charlie	1921	+	168	112411856	24512
chr9	112387344	112587344	harbor1	chr9	112412233	112412530	DNA/hAT-Charlie	853	+	148	112412381	25037
chr9	112387344	112587344	harbor1	chr9	112412652	112412804	DNA/hAT-Charlie	597	+	76	112412728	25384
chr9	4658000	4858000	harbor1	chr9	4686769	4687076	DNA/hAT-Charlie	1632	+	154	4686923	28923
chr9	4658000	4858000	harbor1	chr9	4698684	4698821	DNA/hAT-Charlie	633	+	68	4698752	40752
chr9	4658000	4858000	harbor1	chr9	4698820	4699116	DNA/hAT-Charlie	1208	+	148	4698968	40968
chr9	34027036	34227036	harbor1	chr9	34040743	34040906	DNA/hAT-Charlie	647	+	82	34040825	13789
chr9	4883030	5083030	harbor1	chr9	4924597	4924796	DNA/hAT-Charlie	888	+	100	4924697	41667
chr9	4883030	5083030	harbor1	chr9	4930783	4930938	DNA/hAT-Charlie	808	+	78	4930861	47831
chr9	4883030	5083030	harbor1	chr9	4967764	4967895	DNA/hAT-Charlie	663	+	66	4967830	84800
chr9	1	129273	harbor1	chr9	27382	27631	DNA/hAT-Charlie	1303	+	124	27506	27505
chr9	1	129273	harbor1	chr9	36827	37213	DNA/hAT-Charlie	1562	+	193	37020	37019
chr9	1	129273	harbor1	chr9	53350	53510	DNA/hAT-Charlie	691	+	80	53430	53429
chr9	1	129273	harbor1	chr9	91533	91682	DNA/hAT-Charlie	749	+	74	91607	91606
chr9	133051983	133251983	harbor1	chr9	133068402	133068564	DNA/hAT-Charlie	670	+	81	133068483	16500
chr9	133051983	133251983	harbor1	chr9	133084186	133084348	DNA/hAT-Charlie	670	+	81	133084267	32284
chr9	133051983	133251983	harbor1	chr9	133126343	133126571	DNA/hAT-Charlie	726	+	114	133126457	74474
chr9	135905941	136105941	harbor1	chr9	135915446	135915773	DNA/hAT-Charlie	1151	+	164	135915610	9669
chr9	135905941	136105941	harbor1	chr9	135961603	135961836	DNA/hAT-Charlie	828	+	116	135961719	55778
chr9	4692910	4892910	harbor1	chr9	4698684	4698821	DNA/hAT-Charlie	633	+	68	4698752	5842
chr9	4692910	4892910	harbor1	chr9	4698820	4699116	DNA/hAT-Charlie	1208	+	148	4698968	6058
chr9	4692910	4892910	harbor1	chr9	4775769	4775927	DNA/hAT-Charlie	621	+	79	4775848	82938
chr9	4663850	4863850	harbor1	chr9	4686769	4687076	DNA/hAT-Charlie	1632	+	154	4686923	23073
chr9	4663850	4863850	harbor1	chr9	4698684	4698821	DNA/hAT-Charlie	633	+	68	4698752	34902
chr9	4663850	4863850	harbor1	chr9	4698820	4699116	DNA/hAT-Charlie	1208	+	148	4698968	35118
chr9	4669263	4869263	harbor1	chr9	4686769	4687076	DNA/hAT-Charlie	1632	+	154	4686923	17660
chr9	4669263	4869263	harbor1	chr9	4698684	4698821	DNA/hAT-Charlie	633	+	68	4698752	29489
chr9	4669263	4869263	harbor1	chr9	4698820	4699116	DNA/hAT-Charlie	1208	+	148	4698968	29705
chr9	4597199	4797199	harbor1	chr9	4620380	4620545	DNA/hAT-Charlie	1063	+	82	4620462	23263
chr9	4597199	4797199	harbor1	chr9	4621279	4621488	DNA/hAT-Charlie	1047	+	104	4621383	24184
chr9	4597199	4797199	harbor1	chr9	4621788	4621807	DNA/hAT-Charlie	1047	+	10	4621798	24599
chr9	4597199	4797199	harbor1	chr9	4621801	4621933	DNA/hAT-Charlie	593	+	66	4621867	24668
chr9	4597199	4797199	harbor1	chr9	4635845	4636237	DNA/hAT-Charlie	910	+	196	4636041	38842
chr9	4597199	4797199	harbor1	chr9	4636257	4636465	DNA/hAT-Charlie	590	+	104	4636361	39162
chr9	4597199	4797199	harbor1	chr9	4686769	4687076	DNA/hAT-Charlie	1632	+	154	4686923	89724
chr9	133968504	134168504	harbor1	chr9	133982707	133983016	DNA/hAT-Charlie	1193	+	154	133982861	14357
chr9	133968504	134168504	harbor1	chr9	133984925	133985047	DNA/hAT-Charlie	501	+	61	133984986	16482
chr9	133968504	134168504	harbor1	chr9	134017481	134017702	DNA/hAT-Charlie	1497	+	110	134017591	49087
chr9	35654325	35854325	harbor1	chr9	35656470	35656808	DNA/hAT-Charlie	2273	+	169	35656639	2314
chr9	35654325	35854325	harbor1	chr9	35683894	35684059	DNA/hAT-Charlie	624	+	82	35683976	29651
chr9	137337211	137537211	harbor1	chr9	137412316	137412456	DNA/hAT-Charlie	523	+	70	137412386	75175
chr9	127963377	128163377	harbor1	chr9	127988663	127988861	DNA/hAT-Charlie	1181	+	99	127988762	25385
chr9	127963377	128163377	harbor1	chr9	128052504	128052581	DNA/hAT-Charlie	932	+	38	128052542	89165
chr9	127963377	128163377	harbor1	chr9	128052882	128052988	DNA/hAT-Charlie	932	+	53	128052935	89558
chr9	127963377	128163377	harbor1	chr9	128053593	128053640	DNA/hAT-Charlie	932	+	24	128053617	90240
chr9	61551186	61751186	harbor1	chr9	61569206	61569305	DNA/hAT-Charlie	1752	+	50	61569256	18070
chr9	61551186	61751186	harbor1	chr9	61569602	61569698	DNA/hAT-Charlie	1752	+	48	61569650	18464
chr9	61551186	61751186	harbor1	chr9	61569995	61570275	DNA/hAT-Charlie	1752	+	140	61570135	18949
chr9	61551186	61751186	harbor1	chr9	61631115	61631253	DNA/hAT-Charlie	640	+	69	61631184	79998
chr9	136847554	137047554	harbor1	chr9	136899031	136899233	DNA/hAT-Charlie	498	+	101	136899132	51578
chr9	4692901	4892901	harbor1	chr9	4698684	4698821	DNA/hAT-Charlie	633	+	68	4698752	5851
chr9	4692901	4892901	harbor1	chr9	4698820	4699116	DNA/hAT-Charlie	1208	+	148	4698968	6067
chr9	4692901	4892901	harbor1	chr9	4775769	4775927	DNA/hAT-Charlie	621	+	79	4775848	82947
chr9	113807755	114007755	harbor1	chr9	113873577	113873735	DNA/hAT-Charlie	690	+	79	113873656	65901
chr9	113807755	114007755	harbor1	chr9	113880402	113880500	DNA/hAT-Charlie	526	+	49	113880451	72696
chr9	113807755	114007755	harbor1	chr9	113880604	113880824	DNA/hAT-Charlie	775	+	110	113880714	72959
chr9	113807755	114007755	harbor1	chr9	113886751	113886971	DNA/hAT-Charlie	1155	+	110	113886861	79106
chr9	113807755	114007755	harbor1	chr9	113887000	113887070	DNA/hAT-Charlie	1155	+	35	113887035	79280
chr9	113807755	114007755	harbor1	chr9	113899360	113899683	DNA/hAT-Charlie	2026	+	162	113899522	91767
chr9	113807755	114007755	harbor1	chr9	113905386	113905573	DNA/hAT-Charlie	715	+	94	113905480	97725
chr9	133063664	133263664	harbor1	chr9	133068402	133068564	DNA/hAT-Charlie	670	+	81	133068483	4819
chr9	133063664	133263664	harbor1	chr9	133084186	133084348	DNA/hAT-Charlie	670	+	81	133084267	20603
chr9	133063664	133263664	harbor1	chr9	133126343	133126571	DNA/hAT-Charlie	726	+	114	133126457	62793
chr9	4777664	4977664	harbor1	chr9	4797454	4797665	DNA/hAT-Charlie	1206	+	106	4797560	19896
chr9	4777664	4977664	harbor1	chr9	4829821	4829972	DNA/hAT-Charlie	517	+	76	4829897	52233
chr9	4777664	4977664	harbor1	chr9	4838691	4838848	DNA/hAT-Charlie	655	+	78	4838769	61105
chr9	133047949	133247949	harbor1	chr9	133068402	133068564	DNA/hAT-Charlie	670	+	81	133068483	20534
chr9	133047949	133247949	harbor1	chr9	133084186	133084348	DNA/hAT-Charlie	670	+	81	133084267	36318
chr9	133047949	133247949	harbor1	chr9	133126343	133126571	DNA/hAT-Charlie	726	+	114	133126457	78508
chr9	97885101	98085101	harbor1	chr9	97935308	97935535	DNA/hAT-Charlie	909	+	114	97935422	50321
chr9	97885101	98085101	harbor1	chr9	97937111	97937211	DNA/hAT-Charlie	1632	+	50	97937161	52060
chr9	97885101	98085101	harbor1	chr9	97937377	97937703	DNA/hAT-Charlie	1632	+	163	97937540	52439
chr9	97885101	98085101	harbor1	chr9	97960227	97960422	DNA/hAT-Charlie	1039	+	98	97960325	75224
chr9	97885101	98085101	harbor1	chr9	97962884	97963004	DNA/hAT-Charlie	536	+	60	97962944	77843
chr9	133934915	134134915	harbor1	chr9	133941021	133941125	DNA/hAT-Charlie	571	+	52	133941073	6158
chr9	133934915	134134915	harbor1	chr9	133941427	133941509	DNA/hAT-Charlie	571	+	41	133941468	6553
chr9	133934915	134134915	harbor1	chr9	133982707	133983016	DNA/hAT-Charlie	1193	+	154	133982861	47946
chr9	133934915	134134915	harbor1	chr9	133984925	133985047	DNA/hAT-Charlie	501	+	61	133984986	50071
chr9	133934915	134134915	harbor1	chr9	134017481	134017702	DNA/hAT-Charlie	1497	+	110	134017591	82676
chr9	4692868	4892868	harbor1	chr9	4698684	4698821	DNA/hAT-Charlie	633	+	68	4698752	5884
chr9	4692868	4892868	harbor1	chr9	4698820	4699116	DNA/hAT-Charlie	1208	+	148	4698968	6100
chr9	4692868	4892868	harbor1	chr9	4775769	4775927	DNA/hAT-Charlie	621	+	79	4775848	82980
chr9	4692205	4892205	harbor1	chr9	4698684	4698821	DNA/hAT-Charlie	633	+	68	4698752	6547
chr9	4692205	4892205	harbor1	chr9	4698820	4699116	DNA/hAT-Charlie	1208	+	148	4698968	6763
chr9	4692205	4892205	harbor1	chr9	4775769	4775927	DNA/hAT-Charlie	621	+	79	4775848	83643
chr9	83717816	83917816	harbor1	chr9	83783299	83783484	DNA/hAT-Charlie	800	+	92	83783391	65575
chr9	83717816	83917816	harbor1	chr9	83793373	83793884	DNA/hAT-Charlie	2086	+	256	83793629	75813
chr9	83717816	83917816	harbor1	chr9	83794206	83794754	DNA/hAT-Charlie	2086	+	274	83794480	76664
chr9	83717816	83917816	harbor1	chr9	83809421	83809812	DNA/hAT-Charlie	2051	+	196	83809617	91801
chr9	83717816	83917816	harbor1	chr9	83810104	83810558	DNA/hAT-Charlie	2051	+	227	83810331	92515
chr9	4884858	5084858	harbor1	chr9	4924597	4924796	DNA/hAT-Charlie	888	+	100	4924697	39839
chr9	4884858	5084858	harbor1	chr9	4930783	4930938	DNA/hAT-Charlie	808	+	78	4930861	46003
chr9	4884858	5084858	harbor1	chr9	4967764	4967895	DNA/hAT-Charlie	663	+	66	4967830	82972
chr9	4692961	4892961	harbor1	chr9	4698684	4698821	DNA/hAT-Charlie	633	+	68	4698752	5791
chr9	4692961	4892961	harbor1	chr9	4698820	4699116	DNA/hAT-Charlie	1208	+	148	4698968	6007
chr9	4692961	4892961	harbor1	chr9	4775769	4775927	DNA/hAT-Charlie	621	+	79	4775848	82887
chr9	4692661	4892661	harbor1	chr9	4698684	4698821	DNA/hAT-Charlie	633	+	68	4698752	6091
chr9	4692661	4892661	harbor1	chr9	4698820	4699116	DNA/hAT-Charlie	1208	+	148	4698968	6307
chr9	4692661	4892661	harbor1	chr9	4775769	4775927	DNA/hAT-Charlie	621	+	79	4775848	83187
chr10	70441215	70641215	harbor1	chr10	70527409	70527621	DNA/hAT-Charlie	965	+	106	70527515	86300
chr10	70441215	70641215	harbor1	chr10	70536533	70536748	DNA/hAT-Charlie	925	+	108	70536641	95426
chr10	102140008	102340008	harbor1	chr10	102164055	102164247	DNA/hAT-Charlie	928	+	96	102164151	24143
chr10	102140008	102340008	harbor1	chr10	102164256	102164320	DNA/hAT-Charlie	436	+	32	102164288	24280
chr10	102140008	102340008	harbor1	chr10	102165057	102165191	DNA/hAT-Charlie	436	+	67	102165124	25116
chr10	131310777	131510777	harbor1	chr10	131389324	131389673	DNA/hAT-Charlie	938	+	174	131389498	78721
chr10	78865729	79065729	harbor1	chr10	78895236	78895384	DNA/hAT-Charlie	672	+	74	78895310	29581
chr10	78865729	79065729	harbor1	chr10	78896551	78896708	DNA/hAT-Charlie	766	+	78	78896629	30900
chr10	78865729	79065729	harbor1	chr10	78915518	78915667	DNA/hAT-Charlie	475	+	74	78915592	49863
chr10	78865729	79065729	harbor1	chr10	78959160	78959298	DNA/hAT-Charlie	629	+	69	78959229	93500
chr10	97399009	97599009	harbor1	chr10	97399290	97399391	DNA/hAT-Charlie	1081	+	50	97399340	331
chr10	97399009	97599009	harbor1	chr10	97431290	97431442	DNA/hAT-Charlie	744	+	76	97431366	32357
chr10	97399009	97599009	harbor1	chr10	97439300	97439775	DNA/hAT-Charlie	3298	+	238	97439538	40529
chr10	97399009	97599009	harbor1	chr10	97442399	97442519	DNA/hAT-Charlie	649	+	60	97442459	43450
chr10	97399009	97599009	harbor1	chr10	97443125	97443170	DNA/hAT-Charlie	649	+	22	97443147	44138
chr10	97399009	97599009	harbor1	chr10	97473633	97473860	DNA/hAT-Charlie	973	+	114	97473747	74738
chr10	97399009	97599009	harbor1	chr10	97474163	97474176	DNA/hAT-Charlie	973	+	6	97474169	75160
chr10	560140	760140	harbor1	chr10	563458	564289	DNA/hAT-Charlie	2368	+	416	563874	3734
chr10	97398813	97598813	harbor1	chr10	97398688	97398991	DNA/hAT-Charlie	1081	+	152	97398840	27
chr10	97398813	97598813	harbor1	chr10	97399290	97399391	DNA/hAT-Charlie	1081	+	50	97399340	527
chr10	97398813	97598813	harbor1	chr10	97431290	97431442	DNA/hAT-Charlie	744	+	76	97431366	32553
chr10	97398813	97598813	harbor1	chr10	97439300	97439775	DNA/hAT-Charlie	3298	+	238	97439538	40725
chr10	97398813	97598813	harbor1	chr10	97442399	97442519	DNA/hAT-Charlie	649	+	60	97442459	43646
chr10	97398813	97598813	harbor1	chr10	97443125	97443170	DNA/hAT-Charlie	649	+	22	97443147	44334
chr10	97398813	97598813	harbor1	chr10	97473633	97473860	DNA/hAT-Charlie	973	+	114	97473747	74934
chr10	97398813	97598813	harbor1	chr10	97474163	97474176	DNA/hAT-Charlie	973	+	6	97474169	75356
chr10	49511878	49711878	harbor1	chr10	49558105	49558568	DNA/hAT-Charlie	1439	+	232	49558337	46459
chr10	49511878	49711878	harbor1	chr10	49558870	49558928	DNA/hAT-Charlie	1439	+	29	49558899	47021
chr10	49511878	49711878	harbor1	chr10	49594827	49594945	DNA/hAT-Charlie	641	+	59	49594886	83008
chr10	102141807	102341807	harbor1	chr10	102164055	102164247	DNA/hAT-Charlie	928	+	96	102164151	22344
chr10	102141807	102341807	harbor1	chr10	102164256	102164320	DNA/hAT-Charlie	436	+	32	102164288	22481
chr10	102141807	102341807	harbor1	chr10	102165057	102165191	DNA/hAT-Charlie	436	+	67	102165124	23317
chr10	14778677	14978677	harbor1	chr10	14816401	14816522	DNA/hAT-Charlie	714	+	60	14816461	37784
chr10	14778677	14978677	harbor1	chr10	14873202	14873411	DNA/hAT-Charlie	1011	+	104	14873306	94629
chr10	7958606	8158606	harbor1	chr10	7979847	7980001	DNA/hAT-Charlie	642	+	77	7979924	21318
chr10	7958606	8158606	harbor1	chr10	8003411	8004040	DNA/hAT-Charlie	1997	+	314	8003725	45119
chr10	7958606	8158606	harbor1	chr10	8004348	8004460	DNA/hAT-Charlie	1997	+	56	8004404	45798
chr10	7958606	8158606	harbor1	chr10	8023070	8023226	DNA/hAT-Charlie	780	+	78	8023148	64542
chr10	7958606	8158606	harbor1	chr10	8023549	8023602	DNA/hAT-Charlie	780	+	26	8023575	64969
chr10	7566933	7766933	harbor1	chr10	7607183	7607363	DNA/hAT-Charlie	606	+	90	7607273	40340
chr10	7566933	7766933	harbor1	chr10	7614370	7614592	DNA/hAT-Charlie	1533	+	111	7614481	47548
chr10	7566933	7766933	harbor1	chr10	7620930	7621090	DNA/hAT-Charlie	917	+	80	7621010	54077
chr10	7566933	7766933	harbor1	chr10	7645342	7645514	DNA/hAT-Charlie	943	+	86	7645428	78495
chr10	7566933	7766933	harbor1	chr10	7647232	7647323	DNA/hAT-Charlie	618	+	46	7647278	80345
chr10	7566933	7766933	harbor1	chr10	7660908	7661240	DNA/hAT-Charlie	1950	+	166	7661074	94141
chr10	6442674	6642674	harbor1	chr10	6493151	6493470	DNA/hAT-Charlie	1206	+	160	6493311	50637
chr10	6442674	6642674	harbor1	chr10	6531058	6531219	DNA/hAT-Charlie	503	+	80	6531138	88464
chr10	6442674	6642674	harbor1	chr10	6531315	6531522	DNA/hAT-Charlie	937	+	104	6531419	88745
chr10	6442674	6642674	harbor1	chr10	6539279	6539752	DNA/hAT-Charlie	3117	+	236	6539515	96841
chr10	69458832	69658832	harbor1	chr10	69466396	69466671	DNA/hAT-Charlie	587	+	138	69466534	7702
chr10	69458832	69658832	harbor1	chr10	69471219	69471626	DNA/hAT-Charlie	1149	+	204	69471423	12591
chr10	69458832	69658832	harbor1	chr10	69471892	69472056	DNA/hAT-Charlie	1149	+	82	69471974	13142
chr10	69458832	69658832	harbor1	chr10	69501703	69502055	DNA/hAT-Charlie	2127	+	176	69501879	43047
chr10	69458832	69658832	harbor1	chr10	69504969	69505044	DNA/hAT-Charlie	462	+	38	69505007	46175
chr10	69458832	69658832	harbor1	chr10	69522506	69522830	DNA/hAT-Charlie	2114	+	162	69522668	63836
chr10	69458832	69658832	harbor1	chr10	69551774	69552033	DNA/hAT-Charlie	608	+	130	69551904	93072
chr10	13709746	13909746	harbor1	chr10	13759935	13760270	DNA/hAT-Charlie	1553	+	168	13760103	50357
chr10	13709746	13909746	harbor1	chr10	13785121	13785360	DNA/hAT-Charlie	582	+	120	13785241	75495
chr10	13709746	13909746	harbor1	chr10	13806633	13806787	DNA/hAT-Charlie	660	+	77	13806710	96964
chr10	133103372	133303372	harbor1	chr10	133157282	133157706	DNA/hAT-Charlie	984	+	212	133157494	54122
chr10	92188891	92388891	harbor1	chr10	92212557	92212788	DNA/hAT-Charlie	1242	+	116	92212673	23782
chr10	92188891	92388891	harbor1	chr10	92212924	92213021	DNA/hAT-Charlie	444	+	48	92212972	24081
chr10	100897233	101097233	harbor1	chr10	100909224	100909436	DNA/hAT-Charlie	557	+	106	100909330	12097
chr10	100086018	100286018	harbor1	chr10	100178514	100178626	DNA/hAT-Charlie	805	+	56	100178570	92552
chr10	97398947	97598947	harbor1	chr10	97398688	97398991	DNA/hAT-Charlie	1081	+	152	97398840	107
chr10	97398947	97598947	harbor1	chr10	97399290	97399391	DNA/hAT-Charlie	1081	+	50	97399340	393
chr10	97398947	97598947	harbor1	chr10	97431290	97431442	DNA/hAT-Charlie	744	+	76	97431366	32419
chr10	97398947	97598947	harbor1	chr10	97439300	97439775	DNA/hAT-Charlie	3298	+	238	97439538	40591
chr10	97398947	97598947	harbor1	chr10	97442399	97442519	DNA/hAT-Charlie	649	+	60	97442459	43512
chr10	97398947	97598947	harbor1	chr10	97443125	97443170	DNA/hAT-Charlie	649	+	22	97443147	44200
chr10	97398947	97598947	harbor1	chr10	97473633	97473860	DNA/hAT-Charlie	973	+	114	97473747	74800
chr10	97398947	97598947	harbor1	chr10	97474163	97474176	DNA/hAT-Charlie	973	+	6	97474169	75222
chr10	14778710	14978710	harbor1	chr10	14816401	14816522	DNA/hAT-Charlie	714	+	60	14816461	37751
chr10	14778710	14978710	harbor1	chr10	14873202	14873411	DNA/hAT-Charlie	1011	+	104	14873306	94596
chr10	113669309	113869309	harbor1	chr10	113733104	113733266	DNA/hAT-Charlie	791	+	81	113733185	63876
chr10	113669309	113869309	harbor1	chr10	113738667	113738823	DNA/hAT-Charlie	708	+	78	113738745	69436
chr10	14673058	14873058	harbor1	chr10	14682102	14682245	DNA/hAT-Charlie	525	+	72	14682174	9116
chr10	14673058	14873058	harbor1	chr10	14734377	14734607	DNA/hAT-Charlie	1651	+	115	14734492	61434
chr10	14673058	14873058	harbor1	chr10	14735182	14735398	DNA/hAT-Charlie	1440	+	108	14735290	62232
chr10	14673058	14873058	harbor1	chr10	14758405	14758570	DNA/hAT-Charlie	453	+	82	14758487	85429
chr10	14778691	14978691	harbor1	chr10	14816401	14816522	DNA/hAT-Charlie	714	+	60	14816461	37770
chr10	14778691	14978691	harbor1	chr10	14873202	14873411	DNA/hAT-Charlie	1011	+	104	14873306	94615
chr10	102140695	102340695	harbor1	chr10	102164055	102164247	DNA/hAT-Charlie	928	+	96	102164151	23456
chr10	102140695	102340695	harbor1	chr10	102164256	102164320	DNA/hAT-Charlie	436	+	32	102164288	23593
chr10	102140695	102340695	harbor1	chr10	102165057	102165191	DNA/hAT-Charlie	436	+	67	102165124	24429
chr10	102141695	102341695	harbor1	chr10	102164055	102164247	DNA/hAT-Charlie	928	+	96	102164151	22456
chr10	102141695	102341695	harbor1	chr10	102164256	102164320	DNA/hAT-Charlie	436	+	32	102164288	22593
chr10	102141695	102341695	harbor1	chr10	102165057	102165191	DNA/hAT-Charlie	436	+	67	102165124	23429
chr10	100611262	100811262	harbor1	chr10	100637160	100637246	DNA/hAT-Charlie	501	+	43	100637203	25941
chr10	100611262	100811262	harbor1	chr10	100676227	100676388	DNA/hAT-Charlie	1110	+	80	100676307	65045
chr10	100611262	100811262	harbor1	chr10	100676414	100676525	DNA/hAT-Charlie	1110	+	56	100676470	65208
chr10	6020235	6220235	harbor1	chr10	6029086	6029122	DNA/hAT-Charlie	989	+	18	6029104	8869
chr10	6020235	6220235	harbor1	chr10	6029463	6029637	DNA/hAT-Charlie	989	+	87	6029550	9315
chr10	6020235	6220235	harbor1	chr10	6055066	6055229	DNA/hAT-Charlie	600	+	82	6055148	34913
chr10	102141682	102341682	harbor1	chr10	102164055	102164247	DNA/hAT-Charlie	928	+	96	102164151	22469
chr10	102141682	102341682	harbor1	chr10	102164256	102164320	DNA/hAT-Charlie	436	+	32	102164288	22606
chr10	102141682	102341682	harbor1	chr10	102165057	102165191	DNA/hAT-Charlie	436	+	67	102165124	23442
chr10	3072743	3272743	harbor1	chr10	3086447	3086644	DNA/hAT-Charlie	671	+	98	3086545	13802
chr10	3072743	3272743	harbor1	chr10	3166669	3166887	DNA/hAT-Charlie	1278	+	109	3166778	94035
chr10	79214909	79414909	harbor1	chr10	79262200	79262390	DNA/hAT-Charlie	1107	+	95	79262295	47386
chr10	7951418	8151418	harbor1	chr10	7979847	7980001	DNA/hAT-Charlie	642	+	77	7979924	28506
chr10	7951418	8151418	harbor1	chr10	8003411	8004040	DNA/hAT-Charlie	1997	+	314	8003725	52307
chr10	7951418	8151418	harbor1	chr10	8004348	8004460	DNA/hAT-Charlie	1997	+	56	8004404	52986
chr10	7951418	8151418	harbor1	chr10	8023070	8023226	DNA/hAT-Charlie	780	+	78	8023148	71730
chr10	7951418	8151418	harbor1	chr10	8023549	8023602	DNA/hAT-Charlie	780	+	26	8023575	72157
chr10	114721980	114921980	harbor1	chr10	114755043	114755378	DNA/hAT-Charlie	2166	+	168	114755211	33231
chr10	114721980	114921980	harbor1	chr10	114790867	114791005	DNA/hAT-Charlie	466	+	69	114790936	68956
chr10	114721980	114921980	harbor1	chr10	114797653	114797780	DNA/hAT-Charlie	563	+	64	114797717	75737
chr10	114721980	114921980	harbor1	chr10	114800271	114800405	DNA/hAT-Charlie	435	+	67	114800338	78358
chr10	114721980	114921980	harbor1	chr10	114800408	114800575	DNA/hAT-Charlie	664	+	84	114800492	78512
chr10	62704867	62904867	harbor1	chr10	62705144	62705294	DNA/hAT-Charlie	717	+	75	62705219	352
chr10	62704867	62904867	harbor1	chr10	62794740	62794964	DNA/hAT-Charlie	1130	+	112	62794852	89985
chr10	78346452	78546452	harbor1	chr10	78349518	78349751	DNA/hAT-Charlie	1092	+	116	78349634	3182
chr10	78346452	78546452	harbor1	chr10	78384583	78384768	DNA/hAT-Charlie	754	+	92	78384675	38223
chr10	96887352	97087352	harbor1	chr10	96887577	96887653	DNA/hAT-Charlie	1350	+	38	96887615	263
chr10	96887352	97087352	harbor1	chr10	96887641	96887681	DNA/hAT-Charlie	765	+	20	96887661	309
chr10	96887352	97087352	harbor1	chr10	96887981	96888084	DNA/hAT-Charlie	765	+	52	96888033	681
chr10	96887352	97087352	harbor1	chr10	96888392	96888652	DNA/hAT-Charlie	1568	+	130	96888522	1170
chr10	96887352	97087352	harbor1	chr10	96926172	96926541	DNA/hAT-Charlie	863	+	184	96926356	39004
chr10	96887352	97087352	harbor1	chr10	96948322	96948498	DNA/hAT-Charlie	800	+	88	96948410	61058
chr10	14778054	14978054	harbor1	chr10	14816401	14816522	DNA/hAT-Charlie	714	+	60	14816461	38407
chr10	14778054	14978054	harbor1	chr10	14873202	14873411	DNA/hAT-Charlie	1011	+	104	14873306	95252
chr10	89151734	89351734	harbor1	chr10	89154736	89154959	DNA/hAT-Charlie	717	+	112	89154848	3114
chr10	131255629	131455629	harbor1	chr10	131286855	131287158	DNA/hAT-Charlie	1136	+	152	131287007	31378
chr10	43100314	43300314	harbor1	chr10	43142120	43142170	DNA/hAT-Charlie	937	+	25	43142145	41831
chr10	43100314	43300314	harbor1	chr10	43142502	43142697	DNA/hAT-Charlie	937	+	98	43142600	42286
chr10	100897105	101097105	harbor1	chr10	100909224	100909436	DNA/hAT-Charlie	557	+	106	100909330	12225
chr10	48299633	48499633	harbor1	chr10	48330329	48330534	DNA/hAT-Charlie	861	+	102	48330431	30798
chr10	96974852	97174852	harbor1	chr10	96988808	96988990	DNA/hAT-Charlie	834	+	91	96988899	14047
chr10	96974852	97174852	harbor1	chr10	96990989	96991119	DNA/hAT-Charlie	436	+	65	96991054	16202
chr10	96974852	97174852	harbor1	chr10	97015015	97015161	DNA/hAT-Charlie	460	+	73	97015088	40236
chr10	96974852	97174852	harbor1	chr10	97015282	97016026	DNA/hAT-Charlie	2565	+	372	97015654	40802
chr10	96974852	97174852	harbor1	chr10	97016321	97016398	DNA/hAT-Charlie	2565	+	38	97016359	41507
chr10	96974852	97174852	harbor1	chr10	97016669	97016851	DNA/hAT-Charlie	2565	+	91	97016760	41908
chr10	96974852	97174852	harbor1	chr10	97065235	97065430	DNA/hAT-Charlie	566	+	98	97065333	90481
chr10	14778029	14978029	harbor1	chr10	14816401	14816522	DNA/hAT-Charlie	714	+	60	14816461	38432
chr10	14778029	14978029	harbor1	chr10	14873202	14873411	DNA/hAT-Charlie	1011	+	104	14873306	95277
chr10	68131746	68331746	harbor1	chr10	68150949	68151136	DNA/hAT-Charlie	772	+	94	68151043	19297
chr10	68131746	68331746	harbor1	chr10	68171382	68171555	DNA/hAT-Charlie	952	+	86	68171468	39722
chr10	68131746	68331746	harbor1	chr10	68186994	68187089	DNA/hAT-Charlie	611	+	48	68187042	55296
chr10	68131746	68331746	harbor1	chr10	68187322	68187494	DNA/hAT-Charlie	611	+	86	68187408	55662
chr10	68131746	68331746	harbor1	chr10	68195622	68195778	DNA/hAT-Charlie	872	+	78	68195700	63954
chr10	68131746	68331746	harbor1	chr10	68215079	68215251	DNA/hAT-Charlie	997	+	86	68215165	83419
chr10	97398990	97598990	harbor1	chr10	97398688	97398991	DNA/hAT-Charlie	1081	+	152	97398840	150
chr10	97398990	97598990	harbor1	chr10	97399290	97399391	DNA/hAT-Charlie	1081	+	50	97399340	350
chr10	97398990	97598990	harbor1	chr10	97431290	97431442	DNA/hAT-Charlie	744	+	76	97431366	32376
chr10	97398990	97598990	harbor1	chr10	97439300	97439775	DNA/hAT-Charlie	3298	+	238	97439538	40548
chr10	97398990	97598990	harbor1	chr10	97442399	97442519	DNA/hAT-Charlie	649	+	60	97442459	43469
chr10	97398990	97598990	harbor1	chr10	97443125	97443170	DNA/hAT-Charlie	649	+	22	97443147	44157
chr10	97398990	97598990	harbor1	chr10	97473633	97473860	DNA/hAT-Charlie	973	+	114	97473747	74757
chr10	97398990	97598990	harbor1	chr10	97474163	97474176	DNA/hAT-Charlie	973	+	6	97474169	75179
chr10	97398875	97598875	harbor1	chr10	97398688	97398991	DNA/hAT-Charlie	1081	+	152	97398840	35
chr10	97398875	97598875	harbor1	chr10	97399290	97399391	DNA/hAT-Charlie	1081	+	50	97399340	465
chr10	97398875	97598875	harbor1	chr10	97431290	97431442	DNA/hAT-Charlie	744	+	76	97431366	32491
chr10	97398875	97598875	harbor1	chr10	97439300	97439775	DNA/hAT-Charlie	3298	+	238	97439538	40663
chr10	97398875	97598875	harbor1	chr10	97442399	97442519	DNA/hAT-Charlie	649	+	60	97442459	43584
chr10	97398875	97598875	harbor1	chr10	97443125	97443170	DNA/hAT-Charlie	649	+	22	97443147	44272
chr10	97398875	97598875	harbor1	chr10	97473633	97473860	DNA/hAT-Charlie	973	+	114	97473747	74872
chr10	97398875	97598875	harbor1	chr10	97474163	97474176	DNA/hAT-Charlie	973	+	6	97474169	75294
chr10	22337593	22537593	harbor1	chr10	22375988	22376105	DNA/hAT-Charlie	478	+	58	22376046	38453
chr10	22337593	22537593	harbor1	chr10	22376102	22376472	DNA/hAT-Charlie	1545	+	185	22376287	38694
chr10	22337593	22537593	harbor1	chr10	22381242	22381599	DNA/hAT-Charlie	626	+	178	22381420	43827
chr10	7951458	8151458	harbor1	chr10	7979847	7980001	DNA/hAT-Charlie	642	+	77	7979924	28466
chr10	7951458	8151458	harbor1	chr10	8003411	8004040	DNA/hAT-Charlie	1997	+	314	8003725	52267
chr10	7951458	8151458	harbor1	chr10	8004348	8004460	DNA/hAT-Charlie	1997	+	56	8004404	52946
chr10	7951458	8151458	harbor1	chr10	8023070	8023226	DNA/hAT-Charlie	780	+	78	8023148	71690
chr10	7951458	8151458	harbor1	chr10	8023549	8023602	DNA/hAT-Charlie	780	+	26	8023575	72117
chr10	89151741	89351741	harbor1	chr10	89154736	89154959	DNA/hAT-Charlie	717	+	112	89154848	3107
chr10	133130641	133330641	harbor1	chr10	133157282	133157706	DNA/hAT-Charlie	984	+	212	133157494	26853
chr10	133130641	133330641	harbor1	chr10	133204233	133204370	DNA/hAT-Charlie	494	+	68	133204301	73660
chr10	95979828	96179828	harbor1	chr10	96021456	96021550	DNA/hAT-Charlie	479	+	47	96021503	41675
chr10	95979828	96179828	harbor1	chr10	96032320	96032493	DNA/hAT-Charlie	529	+	86	96032406	52578
chr10	95979828	96179828	harbor1	chr10	96050811	96051029	DNA/hAT-Charlie	1010	+	109	96050920	71092
chr10	46006427	46206427	harbor1	chr10	46039454	46039599	DNA/hAT-Charlie	484	+	72	46039526	33099
chr10	46006427	46206427	harbor1	chr10	46045617	46045784	DNA/hAT-Charlie	597	+	84	46045701	39274
chr10	46006427	46206427	harbor1	chr10	46058027	46058103	DNA/hAT-Charlie	532	+	38	46058065	51638
chr10	46006427	46206427	harbor1	chr10	46058401	46058498	DNA/hAT-Charlie	532	+	48	46058449	52022
chr10	43474486	43674486	harbor1	chr10	43565384	43565469	DNA/hAT-Charlie	633	+	42	43565426	90940
chr10	43474486	43674486	harbor1	chr10	43565013	43565079	DNA/hAT-Charlie	633	+	33	43565046	90560
chr10	101032219	101232219	harbor1	chr10	101100731	101100867	DNA/hAT-Charlie	593	+	68	101100799	68580
chr10	101032219	101232219	harbor1	chr10	101101137	101101236	DNA/hAT-Charlie	593	+	50	101101187	68968
chr10	131310773	131510773	harbor1	chr10	131389324	131389673	DNA/hAT-Charlie	938	+	174	131389498	78725
chr10	75302350	75502350	harbor1	chr10	75335399	75335568	DNA/hAT-Charlie	622	+	84	75335483	33133
chr10	75302350	75502350	harbor1	chr10	75363707	75364238	DNA/hAT-Charlie	1614	+	266	75363973	61623
chr10	75302350	75502350	harbor1	chr10	75375042	75375131	DNA/hAT-Charlie	509	+	44	75375086	72736
chr10	75302350	75502350	harbor1	chr10	75375422	75375513	DNA/hAT-Charlie	509	+	46	75375468	73118
chr10	75302350	75502350	harbor1	chr10	75375814	75375867	DNA/hAT-Charlie	509	+	26	75375840	73490
chr10	75302350	75502350	harbor1	chr10	75376999	75377180	DNA/hAT-Charlie	1074	+	90	75377089	74739
chr10	86532110	86732110	harbor1	chr10	86580155	86580376	DNA/hAT-Charlie	1318	+	110	86580265	48155
chr10	86532110	86732110	harbor1	chr10	86594790	86595007	DNA/hAT-Charlie	1535	+	108	86594898	62788
chr10	86532110	86732110	harbor1	chr10	86602379	86602479	DNA/hAT-Charlie	1324	+	50	86602429	70319
chr10	86532110	86732110	harbor1	chr10	86603188	86603447	DNA/hAT-Charlie	1324	+	130	86603318	71208
chr10	22219191	22419191	harbor1	chr10	22245235	22245355	DNA/hAT-Charlie	526	+	60	22245295	26104
chr10	47239932	47439932	harbor1	chr10	47262735	47263057	DNA/hAT-Charlie	1407	+	161	47262896	22964
chr10	47239932	47439932	harbor1	chr10	47284540	47284690	DNA/hAT-Charlie	642	+	75	47284615	44683
chr10	47239932	47439932	harbor1	chr10	47284181	47284261	DNA/hAT-Charlie	642	+	40	47284221	44289
chr10	4842408	5042408	harbor1	chr10	4883893	4884154	DNA/hAT-Charlie	604	+	130	4884023	41615
chr10	4842408	5042408	harbor1	chr10	4884665	4884821	DNA/hAT-Charlie	548	+	78	4884743	42335
chr10	4842408	5042408	harbor1	chr10	4891524	4891704	DNA/hAT-Charlie	508	+	90	4891614	49206
chr10	4842408	5042408	harbor1	chr10	4908969	4909120	DNA/hAT-Charlie	652	+	76	4909045	66637
chr10	4842408	5042408	harbor1	chr10	4911593	4911925	DNA/hAT-Charlie	1121	+	166	4911759	69351
chr10	47239964	47439964	harbor1	chr10	47262735	47263057	DNA/hAT-Charlie	1407	+	161	47262896	22932
chr10	47239964	47439964	harbor1	chr10	47284540	47284690	DNA/hAT-Charlie	642	+	75	47284615	44651
chr10	47239964	47439964	harbor1	chr10	47284181	47284261	DNA/hAT-Charlie	642	+	40	47284221	44257
chr10	131309416	131509416	harbor1	chr10	131389324	131389673	DNA/hAT-Charlie	938	+	174	131389498	80082
chr10	78865014	79065014	harbor1	chr10	78895236	78895384	DNA/hAT-Charlie	672	+	74	78895310	30296
chr10	78865014	79065014	harbor1	chr10	78896551	78896708	DNA/hAT-Charlie	766	+	78	78896629	31615
chr10	78865014	79065014	harbor1	chr10	78915518	78915667	DNA/hAT-Charlie	475	+	74	78915592	50578
chr10	78865014	79065014	harbor1	chr10	78959160	78959298	DNA/hAT-Charlie	629	+	69	78959229	94215
chr10	14778674	14978674	harbor1	chr10	14816401	14816522	DNA/hAT-Charlie	714	+	60	14816461	37787
chr10	14778674	14978674	harbor1	chr10	14873202	14873411	DNA/hAT-Charlie	1011	+	104	14873306	94632
chr10	77303746	77503746	harbor1	chr10	77313922	77314021	DNA/hAT-Charlie	438	+	50	77313972	10226
chr10	77303746	77503746	harbor1	chr10	77338978	77339184	DNA/hAT-Charlie	567	+	103	77339081	35335
chr10	77303746	77503746	harbor1	chr10	77352402	77352586	DNA/hAT-Charlie	887	+	92	77352494	48748
chr10	77303746	77503746	harbor1	chr10	77367453	77367541	DNA/hAT-Charlie	450	+	44	77367497	63751
chr10	77303746	77503746	harbor1	chr10	77369288	77369438	DNA/hAT-Charlie	441	+	75	77369363	65617
chr10	77303746	77503746	harbor1	chr10	77371468	77371703	DNA/hAT-Charlie	530	+	118	77371586	67840
chr10	77303746	77503746	harbor1	chr10	77395462	77395715	DNA/hAT-Charlie	563	+	126	77395588	91842
chr10	77303746	77503746	harbor1	chr10	77398638	77398789	DNA/hAT-Charlie	606	+	76	77398714	94968
chr10	62704945	62904945	harbor1	chr10	62705144	62705294	DNA/hAT-Charlie	717	+	75	62705219	274
chr10	62704945	62904945	harbor1	chr10	62794740	62794964	DNA/hAT-Charlie	1130	+	112	62794852	89907
chr10	7951431	8151431	harbor1	chr10	7979847	7980001	DNA/hAT-Charlie	642	+	77	7979924	28493
chr10	7951431	8151431	harbor1	chr10	8003411	8004040	DNA/hAT-Charlie	1997	+	314	8003725	52294
chr10	7951431	8151431	harbor1	chr10	8004348	8004460	DNA/hAT-Charlie	1997	+	56	8004404	52973
chr10	7951431	8151431	harbor1	chr10	8023070	8023226	DNA/hAT-Charlie	780	+	78	8023148	71717
chr10	7951431	8151431	harbor1	chr10	8023549	8023602	DNA/hAT-Charlie	780	+	26	8023575	72144
chr10	97672149	97872149	harbor1	chr10	97739974	97740114	DNA/hAT-Charlie	588	+	70	97740044	67895
chr10	14778680	14978680	harbor1	chr10	14816401	14816522	DNA/hAT-Charlie	714	+	60	14816461	37781
chr10	14778680	14978680	harbor1	chr10	14873202	14873411	DNA/hAT-Charlie	1011	+	104	14873306	94626
chr10	102141613	102341613	harbor1	chr10	102164055	102164247	DNA/hAT-Charlie	928	+	96	102164151	22538
chr10	102141613	102341613	harbor1	chr10	102164256	102164320	DNA/hAT-Charlie	436	+	32	102164288	22675
chr10	102141613	102341613	harbor1	chr10	102165057	102165191	DNA/hAT-Charlie	436	+	67	102165124	23511
chr10	79279347	79479347	harbor1	chr10	79325490	79325696	DNA/hAT-Charlie	552	+	103	79325593	46246
chr10	79279347	79479347	harbor1	chr10	79344365	79344723	DNA/hAT-Charlie	597	+	179	79344544	65197
chr10	110707741	110907741	harbor1	chr10	110744480	110744662	DNA/hAT-Charlie	842	+	91	110744571	36830
chr10	110707741	110907741	harbor1	chr10	110758650	110758807	DNA/hAT-Charlie	825	+	78	110758728	50987
chr10	110707741	110907741	harbor1	chr10	110769067	110769229	DNA/hAT-Charlie	544	+	81	110769148	61407
chr10	110707741	110907741	harbor1	chr10	110770071	110770257	DNA/hAT-Charlie	471	+	93	110770164	62423
chr10	89202972	89402972	harbor1	chr10	89262593	89262751	DNA/hAT-Charlie	593	+	79	89262672	59700
chr10	89202972	89402972	harbor1	chr10	89273835	89274036	DNA/hAT-Charlie	1013	+	100	89273935	70963
chr10	46006339	46206339	harbor1	chr10	46039454	46039599	DNA/hAT-Charlie	484	+	72	46039526	33187
chr10	46006339	46206339	harbor1	chr10	46045617	46045784	DNA/hAT-Charlie	597	+	84	46045701	39362
chr10	46006339	46206339	harbor1	chr10	46058027	46058103	DNA/hAT-Charlie	532	+	38	46058065	51726
chr10	46006339	46206339	harbor1	chr10	46058401	46058498	DNA/hAT-Charlie	532	+	48	46058449	52110
chr10	3621791	3821791	harbor1	chr10	3640973	3641109	DNA/hAT-Charlie	539	+	68	3641041	19250
chr10	47239866	47439866	harbor1	chr10	47262735	47263057	DNA/hAT-Charlie	1407	+	161	47262896	23030
chr10	47239866	47439866	harbor1	chr10	47284540	47284690	DNA/hAT-Charlie	642	+	75	47284615	44749
chr10	47239866	47439866	harbor1	chr10	47284181	47284261	DNA/hAT-Charlie	642	+	40	47284221	44355
chr10	62704875	62904875	harbor1	chr10	62705144	62705294	DNA/hAT-Charlie	717	+	75	62705219	344
chr10	62704875	62904875	harbor1	chr10	62794740	62794964	DNA/hAT-Charlie	1130	+	112	62794852	89977
chr10	7951465	8151465	harbor1	chr10	7979847	7980001	DNA/hAT-Charlie	642	+	77	7979924	28459
chr10	7951465	8151465	harbor1	chr10	8003411	8004040	DNA/hAT-Charlie	1997	+	314	8003725	52260
chr10	7951465	8151465	harbor1	chr10	8004348	8004460	DNA/hAT-Charlie	1997	+	56	8004404	52939
chr10	7951465	8151465	harbor1	chr10	8023070	8023226	DNA/hAT-Charlie	780	+	78	8023148	71683
chr10	7951465	8151465	harbor1	chr10	8023549	8023602	DNA/hAT-Charlie	780	+	26	8023575	72110
chr10	47239913	47439913	harbor1	chr10	47262735	47263057	DNA/hAT-Charlie	1407	+	161	47262896	22983
chr10	47239913	47439913	harbor1	chr10	47284540	47284690	DNA/hAT-Charlie	642	+	75	47284615	44702
chr10	47239913	47439913	harbor1	chr10	47284181	47284261	DNA/hAT-Charlie	642	+	40	47284221	44308
chr10	69472286	69672286	harbor1	chr10	69501703	69502055	DNA/hAT-Charlie	2127	+	176	69501879	29593
chr10	69472286	69672286	harbor1	chr10	69504969	69505044	DNA/hAT-Charlie	462	+	38	69505007	32721
chr10	69472286	69672286	harbor1	chr10	69522506	69522830	DNA/hAT-Charlie	2114	+	162	69522668	50382
chr10	69472286	69672286	harbor1	chr10	69551774	69552033	DNA/hAT-Charlie	608	+	130	69551904	79618
chr11	112678749	112878749	harbor1	chr11	112697156	112697345	DNA/hAT-Charlie	445	+	94	112697250	18501
chr11	112678749	112878749	harbor1	chr11	112729925	112730453	DNA/hAT-Charlie	3846	+	264	112730189	51440
chr11	5127157	5327157	harbor1	chr11	5149375	5149727	DNA/hAT-Charlie	1066	+	176	5149551	22394
chr11	5127157	5327157	harbor1	chr11	5188523	5188721	DNA/hAT-Charlie	1127	+	99	5188622	61465
chr11	5127157	5327157	harbor1	chr11	5196202	5196479	DNA/hAT-Charlie	1500	+	138	5196340	69183
chr11	5127156	5327156	harbor1	chr11	5149375	5149727	DNA/hAT-Charlie	1066	+	176	5149551	22395
chr11	5127156	5327156	harbor1	chr11	5188523	5188721	DNA/hAT-Charlie	1127	+	99	5188622	61466
chr11	5127156	5327156	harbor1	chr11	5196202	5196479	DNA/hAT-Charlie	1500	+	138	5196340	69184
chr11	5129450	5329450	harbor1	chr11	5149375	5149727	DNA/hAT-Charlie	1066	+	176	5149551	20101
chr11	5129450	5329450	harbor1	chr11	5188523	5188721	DNA/hAT-Charlie	1127	+	99	5188622	59172
chr11	5129450	5329450	harbor1	chr11	5196202	5196479	DNA/hAT-Charlie	1500	+	138	5196340	66890
chr11	5127277	5327277	harbor1	chr11	5149375	5149727	DNA/hAT-Charlie	1066	+	176	5149551	22274
chr11	5127277	5327277	harbor1	chr11	5188523	5188721	DNA/hAT-Charlie	1127	+	99	5188622	61345
chr11	5127277	5327277	harbor1	chr11	5196202	5196479	DNA/hAT-Charlie	1500	+	138	5196340	69063
chr11	5127135	5327135	harbor1	chr11	5149375	5149727	DNA/hAT-Charlie	1066	+	176	5149551	22416
chr11	5127135	5327135	harbor1	chr11	5188523	5188721	DNA/hAT-Charlie	1127	+	99	5188622	61487
chr11	5127135	5327135	harbor1	chr11	5196202	5196479	DNA/hAT-Charlie	1500	+	138	5196340	69205
chr11	5127181	5327181	harbor1	chr11	5149375	5149727	DNA/hAT-Charlie	1066	+	176	5149551	22370
chr11	5127181	5327181	harbor1	chr11	5188523	5188721	DNA/hAT-Charlie	1127	+	99	5188622	61441
chr11	5127181	5327181	harbor1	chr11	5196202	5196479	DNA/hAT-Charlie	1500	+	138	5196340	69159
chr11	5127341	5327341	harbor1	chr11	5149375	5149727	DNA/hAT-Charlie	1066	+	176	5149551	22210
chr11	5127341	5327341	harbor1	chr11	5188523	5188721	DNA/hAT-Charlie	1127	+	99	5188622	61281
chr11	5127341	5327341	harbor1	chr11	5196202	5196479	DNA/hAT-Charlie	1500	+	138	5196340	68999
chr11	5127230	5327230	harbor1	chr11	5149375	5149727	DNA/hAT-Charlie	1066	+	176	5149551	22321
chr11	5127230	5327230	harbor1	chr11	5188523	5188721	DNA/hAT-Charlie	1127	+	99	5188622	61392
chr11	5127230	5327230	harbor1	chr11	5196202	5196479	DNA/hAT-Charlie	1500	+	138	5196340	69110
chr11	68642659	68842659	harbor1	chr11	68652549	68652741	DNA/hAT-Charlie	564	+	96	68652645	9986
chr11	68642659	68842659	harbor1	chr11	68658191	68658371	DNA/hAT-Charlie	865	+	90	68658281	15622
chr11	68642659	68842659	harbor1	chr11	68658672	68658719	DNA/hAT-Charlie	865	+	24	68658696	16037
chr11	68642659	68842659	harbor1	chr11	68706589	68706858	DNA/hAT-Charlie	1004	+	134	68706723	64064
chr11	64537901	64737901	harbor1	chr11	64539863	64540158	DNA/hAT-Charlie	820	+	148	64540011	2110
chr11	64537901	64737901	harbor1	chr11	64624585	64624805	DNA/hAT-Charlie	711	+	110	64624695	86794
chr11	5134663	5334663	harbor1	chr11	5149375	5149727	DNA/hAT-Charlie	1066	+	176	5149551	14888
chr11	5134663	5334663	harbor1	chr11	5188523	5188721	DNA/hAT-Charlie	1127	+	99	5188622	53959
chr11	5134663	5334663	harbor1	chr11	5196202	5196479	DNA/hAT-Charlie	1500	+	138	5196340	61677
chr11	102246099	102446099	harbor1	chr11	102281369	102281417	DNA/hAT-Charlie	560	+	24	102281393	35294
chr11	102246099	102446099	harbor1	chr11	102281447	102281547	DNA/hAT-Charlie	560	+	50	102281497	35398
chr11	102246099	102446099	harbor1	chr11	102290823	102291020	DNA/hAT-Charlie	1056	+	98	102290921	44822
chr11	102246099	102446099	harbor1	chr11	102307620	102308435	DNA/hAT-Charlie	3678	+	408	102308028	61929
chr11	102246099	102446099	harbor1	chr11	102309189	102309639	DNA/hAT-Charlie	2317	+	225	102309414	63315
chr11	102246099	102446099	harbor1	chr11	102309637	102309876	DNA/hAT-Charlie	1208	+	120	102309757	63658
chr11	102246099	102446099	harbor1	chr11	102314538	102314868	DNA/hAT-Charlie	1022	+	165	102314703	68604
chr11	102246099	102446099	harbor1	chr11	102314861	102314892	DNA/hAT-Charlie	1853	+	16	102314877	68778
chr11	102246099	102446099	harbor1	chr11	102315082	102315535	DNA/hAT-Charlie	1853	+	226	102315308	69209
chr11	102246099	102446099	harbor1	chr11	102315834	102316282	DNA/hAT-Charlie	1853	+	224	102316058	69959
chr11	102246099	102446099	harbor1	chr11	102329086	102329218	DNA/hAT-Charlie	402	+	66	102329152	83053
chr11	2054543	2254543	harbor1	chr11	2088508	2088645	DNA/hAT-Charlie	498	+	68	2088576	34033
chr11	5126804	5326804	harbor1	chr11	5149375	5149727	DNA/hAT-Charlie	1066	+	176	5149551	22747
chr11	5126804	5326804	harbor1	chr11	5188523	5188721	DNA/hAT-Charlie	1127	+	99	5188622	61818
chr11	5126804	5326804	harbor1	chr11	5196202	5196479	DNA/hAT-Charlie	1500	+	138	5196340	69536
chr11	5127222	5327222	harbor1	chr11	5149375	5149727	DNA/hAT-Charlie	1066	+	176	5149551	22329
chr11	5127222	5327222	harbor1	chr11	5188523	5188721	DNA/hAT-Charlie	1127	+	99	5188622	61400
chr11	5127222	5327222	harbor1	chr11	5196202	5196479	DNA/hAT-Charlie	1500	+	138	5196340	69118
chr11	5127226	5327226	harbor1	chr11	5149375	5149727	DNA/hAT-Charlie	1066	+	176	5149551	22325
chr11	5127226	5327226	harbor1	chr11	5188523	5188721	DNA/hAT-Charlie	1127	+	99	5188622	61396
chr11	5127226	5327226	harbor1	chr11	5196202	5196479	DNA/hAT-Charlie	1500	+	138	5196340	69114
chr11	57399763	57599763	harbor1	chr11	57416766	57416918	DNA/hAT-Charlie	485	+	76	57416842	17079
chr11	57399763	57599763	harbor1	chr11	57451266	57451480	DNA/hAT-Charlie	427	+	107	57451373	51610
chr11	57399763	57599763	harbor1	chr11	57466768	57466972	DNA/hAT-Charlie	1175	+	102	57466870	67107
chr11	57399763	57599763	harbor1	chr11	57475791	57475961	DNA/hAT-Charlie	403	+	85	57475876	76113
chr11	57399763	57599763	harbor1	chr11	57489561	57489744	DNA/hAT-Charlie	401	+	92	57489653	89890
chr11	89682097	89882097	harbor1	chr11	89707058	89707220	DNA/hAT-Charlie	568	+	81	89707139	25042
chr11	119387210	119587210	harbor1	chr11	119435632	119435816	DNA/hAT-Charlie	1021	+	92	119435724	48514
chr11	5127150	5327150	harbor1	chr11	5149375	5149727	DNA/hAT-Charlie	1066	+	176	5149551	22401
chr11	5127150	5327150	harbor1	chr11	5188523	5188721	DNA/hAT-Charlie	1127	+	99	5188622	61472
chr11	5127150	5327150	harbor1	chr11	5196202	5196479	DNA/hAT-Charlie	1500	+	138	5196340	69190
chr11	5127250	5327250	harbor1	chr11	5149375	5149727	DNA/hAT-Charlie	1066	+	176	5149551	22301
chr11	5127250	5327250	harbor1	chr11	5188523	5188721	DNA/hAT-Charlie	1127	+	99	5188622	61372
chr11	5127250	5327250	harbor1	chr11	5196202	5196479	DNA/hAT-Charlie	1500	+	138	5196340	69090
chr11	2054521	2254521	harbor1	chr11	2088508	2088645	DNA/hAT-Charlie	498	+	68	2088576	34055
chr11	5126803	5326803	harbor1	chr11	5149375	5149727	DNA/hAT-Charlie	1066	+	176	5149551	22748
chr11	5126803	5326803	harbor1	chr11	5188523	5188721	DNA/hAT-Charlie	1127	+	99	5188622	61819
chr11	5126803	5326803	harbor1	chr11	5196202	5196479	DNA/hAT-Charlie	1500	+	138	5196340	69537
chr11	5134612	5334612	harbor1	chr11	5149375	5149727	DNA/hAT-Charlie	1066	+	176	5149551	14939
chr11	5134612	5334612	harbor1	chr11	5188523	5188721	DNA/hAT-Charlie	1127	+	99	5188622	54010
chr11	5134612	5334612	harbor1	chr11	5196202	5196479	DNA/hAT-Charlie	1500	+	138	5196340	61728
chr11	5134133	5334133	harbor1	chr11	5149375	5149727	DNA/hAT-Charlie	1066	+	176	5149551	15418
chr11	5134133	5334133	harbor1	chr11	5188523	5188721	DNA/hAT-Charlie	1127	+	99	5188622	54489
chr11	5134133	5334133	harbor1	chr11	5196202	5196479	DNA/hAT-Charlie	1500	+	138	5196340	62207
chr11	113773314	113973314	harbor1	chr11	113792007	113792184	DNA/hAT-Charlie	429	+	88	113792095	18781
chr11	113773314	113973314	harbor1	chr11	113804274	113804450	DNA/hAT-Charlie	435	+	88	113804362	31048
chr11	46034956	46234956	harbor1	chr11	46081730	46081952	DNA/hAT-Charlie	1054	+	111	46081841	46885
chr11	46034956	46234956	harbor1	chr11	46094927	46095081	DNA/hAT-Charlie	475	+	77	46095004	60048
chr11	46034956	46234956	harbor1	chr11	46134202	46134416	DNA/hAT-Charlie	581	+	107	46134309	99353
chr11	5125277	5325277	harbor1	chr11	5149375	5149727	DNA/hAT-Charlie	1066	+	176	5149551	24274
chr11	5125277	5325277	harbor1	chr11	5188523	5188721	DNA/hAT-Charlie	1127	+	99	5188622	63345
chr11	5125277	5325277	harbor1	chr11	5196202	5196479	DNA/hAT-Charlie	1500	+	138	5196340	71063
chr11	108021540	108221540	harbor1	chr11	108083882	108084100	DNA/hAT-Charlie	1511	+	109	108083991	62451
chr11	108021540	108221540	harbor1	chr11	108086558	108086851	DNA/hAT-Charlie	839	+	146	108086704	65164
chr11	108021540	108221540	harbor1	chr11	108087018	108087503	DNA/hAT-Charlie	868	+	242	108087260	65720
chr11	108021540	108221540	harbor1	chr11	108111192	108111368	DNA/hAT-Charlie	791	+	88	108111280	89740
chr11	5125978	5325978	harbor1	chr11	5149375	5149727	DNA/hAT-Charlie	1066	+	176	5149551	23573
chr11	5125978	5325978	harbor1	chr11	5188523	5188721	DNA/hAT-Charlie	1127	+	99	5188622	62644
chr11	5125978	5325978	harbor1	chr11	5196202	5196479	DNA/hAT-Charlie	1500	+	138	5196340	70362
chr11	57399760	57599760	harbor1	chr11	57416766	57416918	DNA/hAT-Charlie	485	+	76	57416842	17082
chr11	57399760	57599760	harbor1	chr11	57451266	57451480	DNA/hAT-Charlie	427	+	107	57451373	51613
chr11	57399760	57599760	harbor1	chr11	57466768	57466972	DNA/hAT-Charlie	1175	+	102	57466870	67110
chr11	57399760	57599760	harbor1	chr11	57475791	57475961	DNA/hAT-Charlie	403	+	85	57475876	76116
chr11	57399760	57599760	harbor1	chr11	57489561	57489744	DNA/hAT-Charlie	401	+	92	57489653	89893
chr11	5127141	5327141	harbor1	chr11	5149375	5149727	DNA/hAT-Charlie	1066	+	176	5149551	22410
chr11	5127141	5327141	harbor1	chr11	5188523	5188721	DNA/hAT-Charlie	1127	+	99	5188622	61481
chr11	5127141	5327141	harbor1	chr11	5196202	5196479	DNA/hAT-Charlie	1500	+	138	5196340	69199
chr11	5127172	5327172	harbor1	chr11	5149375	5149727	DNA/hAT-Charlie	1066	+	176	5149551	22379
chr11	5127172	5327172	harbor1	chr11	5188523	5188721	DNA/hAT-Charlie	1127	+	99	5188622	61450
chr11	5127172	5327172	harbor1	chr11	5196202	5196479	DNA/hAT-Charlie	1500	+	138	5196340	69168
chr11	5134086	5334086	harbor1	chr11	5149375	5149727	DNA/hAT-Charlie	1066	+	176	5149551	15465
chr11	5134086	5334086	harbor1	chr11	5188523	5188721	DNA/hAT-Charlie	1127	+	99	5188622	54536
chr11	5134086	5334086	harbor1	chr11	5196202	5196479	DNA/hAT-Charlie	1500	+	138	5196340	62254
chr11	5127261	5327261	harbor1	chr11	5149375	5149727	DNA/hAT-Charlie	1066	+	176	5149551	22290
chr11	5127261	5327261	harbor1	chr11	5188523	5188721	DNA/hAT-Charlie	1127	+	99	5188622	61361
chr11	5127261	5327261	harbor1	chr11	5196202	5196479	DNA/hAT-Charlie	1500	+	138	5196340	69079
chr11	5134533	5334533	harbor1	chr11	5149375	5149727	DNA/hAT-Charlie	1066	+	176	5149551	15018
chr11	5134533	5334533	harbor1	chr11	5188523	5188721	DNA/hAT-Charlie	1127	+	99	5188622	54089
chr11	5134533	5334533	harbor1	chr11	5196202	5196479	DNA/hAT-Charlie	1500	+	138	5196340	61807
chr11	5126745	5326745	harbor1	chr11	5149375	5149727	DNA/hAT-Charlie	1066	+	176	5149551	22806
chr11	5126745	5326745	harbor1	chr11	5188523	5188721	DNA/hAT-Charlie	1127	+	99	5188622	61877
chr11	5126745	5326745	harbor1	chr11	5196202	5196479	DNA/hAT-Charlie	1500	+	138	5196340	69595
chr11	46185687	46385687	harbor1	chr11	46207379	46207752	DNA/hAT-Charlie	3095	+	186	46207565	21878
chr11	46185687	46385687	harbor1	chr11	46208060	46208130	DNA/hAT-Charlie	3095	+	35	46208095	22408
chr11	46185687	46385687	harbor1	chr11	46208131	46208261	DNA/hAT-Charlie	774	+	65	46208196	22509
chr11	46185687	46385687	harbor1	chr11	46210560	46210680	DNA/hAT-Charlie	533	+	60	46210620	24933
chr11	5134641	5334641	harbor1	chr11	5149375	5149727	DNA/hAT-Charlie	1066	+	176	5149551	14910
chr11	5134641	5334641	harbor1	chr11	5188523	5188721	DNA/hAT-Charlie	1127	+	99	5188622	53981
chr11	5134641	5334641	harbor1	chr11	5196202	5196479	DNA/hAT-Charlie	1500	+	138	5196340	61699
chr11	57399762	57599762	harbor1	chr11	57416766	57416918	DNA/hAT-Charlie	485	+	76	57416842	17080
chr11	57399762	57599762	harbor1	chr11	57451266	57451480	DNA/hAT-Charlie	427	+	107	57451373	51611
chr11	57399762	57599762	harbor1	chr11	57466768	57466972	DNA/hAT-Charlie	1175	+	102	57466870	67108
chr11	57399762	57599762	harbor1	chr11	57475791	57475961	DNA/hAT-Charlie	403	+	85	57475876	76114
chr11	57399762	57599762	harbor1	chr11	57489561	57489744	DNA/hAT-Charlie	401	+	92	57489653	89891
chr11	108004348	108204348	harbor1	chr11	108083882	108084100	DNA/hAT-Charlie	1511	+	109	108083991	79643
chr11	108004348	108204348	harbor1	chr11	108086558	108086851	DNA/hAT-Charlie	839	+	146	108086704	82356
chr11	108004348	108204348	harbor1	chr11	108087018	108087503	DNA/hAT-Charlie	868	+	242	108087260	82912
chr11	2759442	2959442	harbor1	chr11	2762552	2762880	DNA/hAT-Charlie	1978	+	164	2762716	3274
chr11	2759442	2959442	harbor1	chr11	2805499	2805697	DNA/hAT-Charlie	821	+	99	2805598	46156
chr11	5127278	5327278	harbor1	chr11	5149375	5149727	DNA/hAT-Charlie	1066	+	176	5149551	22273
chr11	5127278	5327278	harbor1	chr11	5188523	5188721	DNA/hAT-Charlie	1127	+	99	5188622	61344
chr11	5127278	5327278	harbor1	chr11	5196202	5196479	DNA/hAT-Charlie	1500	+	138	5196340	69062
chr11	65968777	66168777	harbor1	chr11	66028915	66029028	DNA/hAT-Charlie	1518	+	56	66028971	60194
chr11	65968777	66168777	harbor1	chr11	66029329	66029769	DNA/hAT-Charlie	1518	+	220	66029549	60772
chr11	65968777	66168777	harbor1	chr11	66037006	66037247	DNA/hAT-Charlie	1404	+	120	66037126	68349
chr11	65968777	66168777	harbor1	chr11	66055740	66055926	DNA/hAT-Charlie	598	+	93	66055833	87056
chr11	5134115	5334115	harbor1	chr11	5149375	5149727	DNA/hAT-Charlie	1066	+	176	5149551	15436
chr11	5134115	5334115	harbor1	chr11	5188523	5188721	DNA/hAT-Charlie	1127	+	99	5188622	54507
chr11	5134115	5334115	harbor1	chr11	5196202	5196479	DNA/hAT-Charlie	1500	+	138	5196340	62225
chr11	5134546	5334546	harbor1	chr11	5149375	5149727	DNA/hAT-Charlie	1066	+	176	5149551	15005
chr11	5134546	5334546	harbor1	chr11	5188523	5188721	DNA/hAT-Charlie	1127	+	99	5188622	54076
chr11	5134546	5334546	harbor1	chr11	5196202	5196479	DNA/hAT-Charlie	1500	+	138	5196340	61794
chr11	5124980	5324980	harbor1	chr11	5149375	5149727	DNA/hAT-Charlie	1066	+	176	5149551	24571
chr11	5124980	5324980	harbor1	chr11	5188523	5188721	DNA/hAT-Charlie	1127	+	99	5188622	63642
chr11	5124980	5324980	harbor1	chr11	5196202	5196479	DNA/hAT-Charlie	1500	+	138	5196340	71360
chr11	5127317	5327317	harbor1	chr11	5149375	5149727	DNA/hAT-Charlie	1066	+	176	5149551	22234
chr11	5127317	5327317	harbor1	chr11	5188523	5188721	DNA/hAT-Charlie	1127	+	99	5188622	61305
chr11	5127317	5327317	harbor1	chr11	5196202	5196479	DNA/hAT-Charlie	1500	+	138	5196340	69023
chr11	5127257	5327257	harbor1	chr11	5149375	5149727	DNA/hAT-Charlie	1066	+	176	5149551	22294
chr11	5127257	5327257	harbor1	chr11	5188523	5188721	DNA/hAT-Charlie	1127	+	99	5188622	61365
chr11	5127257	5327257	harbor1	chr11	5196202	5196479	DNA/hAT-Charlie	1500	+	138	5196340	69083
chr11	86559546	86759546	harbor1	chr11	86567937	86568135	DNA/hAT-Charlie	519	+	99	86568036	8490
chr11	86559546	86759546	harbor1	chr11	86571447	86571625	DNA/hAT-Charlie	1054	+	89	86571536	11990
chr11	86559546	86759546	harbor1	chr11	86628404	86628579	DNA/hAT-Charlie	873	+	88	86628492	68946
chr11	86559546	86759546	harbor1	chr11	86629815	86630004	DNA/hAT-Charlie	575	+	94	86629909	70363
chr11	5100509	5300509	harbor1	chr11	5149375	5149727	DNA/hAT-Charlie	1066	+	176	5149551	49042
chr11	5100509	5300509	harbor1	chr11	5188523	5188721	DNA/hAT-Charlie	1127	+	99	5188622	88113
chr11	5100509	5300509	harbor1	chr11	5196202	5196479	DNA/hAT-Charlie	1500	+	138	5196340	95831
chr11	5127273	5327273	harbor1	chr11	5149375	5149727	DNA/hAT-Charlie	1066	+	176	5149551	22278
chr11	5127273	5327273	harbor1	chr11	5188523	5188721	DNA/hAT-Charlie	1127	+	99	5188622	61349
chr11	5127273	5327273	harbor1	chr11	5196202	5196479	DNA/hAT-Charlie	1500	+	138	5196340	69067
chr11	91718101	91918101	harbor1	chr11	91776239	91776494	DNA/hAT-Charlie	906	+	128	91776367	58266
chr11	91718101	91918101	harbor1	chr11	91813618	91813833	DNA/hAT-Charlie	494	+	108	91813726	95625
chr11	4695187	4895187	harbor1	chr11	4745310	4745442	DNA/hAT-Charlie	430	+	66	4745376	50189
chr11	5134560	5334560	harbor1	chr11	5149375	5149727	DNA/hAT-Charlie	1066	+	176	5149551	14991
chr11	5134560	5334560	harbor1	chr11	5188523	5188721	DNA/hAT-Charlie	1127	+	99	5188622	54062
chr11	5134560	5334560	harbor1	chr11	5196202	5196479	DNA/hAT-Charlie	1500	+	138	5196340	61780
chr11	108021573	108221573	harbor1	chr11	108083882	108084100	DNA/hAT-Charlie	1511	+	109	108083991	62418
chr11	108021573	108221573	harbor1	chr11	108086558	108086851	DNA/hAT-Charlie	839	+	146	108086704	65131
chr11	108021573	108221573	harbor1	chr11	108087018	108087503	DNA/hAT-Charlie	868	+	242	108087260	65687
chr11	108021573	108221573	harbor1	chr11	108111192	108111368	DNA/hAT-Charlie	791	+	88	108111280	89707
chr11	76580974	76780974	harbor1	chr11	76595957	76596041	DNA/hAT-Charlie	495	+	42	76595999	15025
chr11	76580974	76780974	harbor1	chr11	76598717	76599027	DNA/hAT-Charlie	1368	+	155	76598872	17898
chr11	76580974	76780974	harbor1	chr11	76607306	76607536	DNA/hAT-Charlie	452	+	115	76607421	26447
chr11	76580974	76780974	harbor1	chr11	76612271	76612410	DNA/hAT-Charlie	472	+	70	76612341	31367
chr11	76580974	76780974	harbor1	chr11	76612460	76612643	DNA/hAT-Charlie	986	+	92	76612552	31578
chr11	76580974	76780974	harbor1	chr11	76612669	76612700	DNA/hAT-Charlie	986	+	16	76612685	31711
chr11	76580974	76780974	harbor1	chr11	76612988	76613265	DNA/hAT-Charlie	986	+	138	76613126	32152
chr11	76580974	76780974	harbor1	chr11	76613362	76613889	DNA/hAT-Charlie	986	+	264	76613626	32652
chr11	76580974	76780974	harbor1	chr11	76649274	76649745	DNA/hAT-Charlie	1913	+	236	76649510	68536
chr11	5127126	5327126	harbor1	chr11	5149375	5149727	DNA/hAT-Charlie	1066	+	176	5149551	22425
chr11	5127126	5327126	harbor1	chr11	5188523	5188721	DNA/hAT-Charlie	1127	+	99	5188622	61496
chr11	5127126	5327126	harbor1	chr11	5196202	5196479	DNA/hAT-Charlie	1500	+	138	5196340	69214
chr11	65758060	65958060	harbor1	chr11	65785103	65785207	DNA/hAT-Charlie	410	+	52	65785155	27095
chr11	5125006	5325006	harbor1	chr11	5149375	5149727	DNA/hAT-Charlie	1066	+	176	5149551	24545
chr11	5125006	5325006	harbor1	chr11	5188523	5188721	DNA/hAT-Charlie	1127	+	99	5188622	63616
chr11	5125006	5325006	harbor1	chr11	5196202	5196479	DNA/hAT-Charlie	1500	+	138	5196340	71334
chr11	5134608	5334608	harbor1	chr11	5149375	5149727	DNA/hAT-Charlie	1066	+	176	5149551	14943
chr11	5134608	5334608	harbor1	chr11	5188523	5188721	DNA/hAT-Charlie	1127	+	99	5188622	54014
chr11	5134608	5334608	harbor1	chr11	5196202	5196479	DNA/hAT-Charlie	1500	+	138	5196340	61732
chr11	5126778	5326778	harbor1	chr11	5149375	5149727	DNA/hAT-Charlie	1066	+	176	5149551	22773
chr11	5126778	5326778	harbor1	chr11	5188523	5188721	DNA/hAT-Charlie	1127	+	99	5188622	61844
chr11	5126778	5326778	harbor1	chr11	5196202	5196479	DNA/hAT-Charlie	1500	+	138	5196340	69562
chr11	5134653	5334653	harbor1	chr11	5149375	5149727	DNA/hAT-Charlie	1066	+	176	5149551	14898
chr11	5134653	5334653	harbor1	chr11	5188523	5188721	DNA/hAT-Charlie	1127	+	99	5188622	53969
chr11	5134653	5334653	harbor1	chr11	5196202	5196479	DNA/hAT-Charlie	1500	+	138	5196340	61687
chr11	5134111	5334111	harbor1	chr11	5149375	5149727	DNA/hAT-Charlie	1066	+	176	5149551	15440
chr11	5134111	5334111	harbor1	chr11	5188523	5188721	DNA/hAT-Charlie	1127	+	99	5188622	54511
chr11	5134111	5334111	harbor1	chr11	5196202	5196479	DNA/hAT-Charlie	1500	+	138	5196340	62229
chr11	2054541	2254541	harbor1	chr11	2088508	2088645	DNA/hAT-Charlie	498	+	68	2088576	34035
chr11	57374327	57574327	harbor1	chr11	57379245	57379412	DNA/hAT-Charlie	939	+	84	57379329	5002
chr11	57374327	57574327	harbor1	chr11	57416766	57416918	DNA/hAT-Charlie	485	+	76	57416842	42515
chr11	57374327	57574327	harbor1	chr11	57451266	57451480	DNA/hAT-Charlie	427	+	107	57451373	77046
chr11	57374327	57574327	harbor1	chr11	57466768	57466972	DNA/hAT-Charlie	1175	+	102	57466870	92543
chr11	5127183	5327183	harbor1	chr11	5149375	5149727	DNA/hAT-Charlie	1066	+	176	5149551	22368
chr11	5127183	5327183	harbor1	chr11	5188523	5188721	DNA/hAT-Charlie	1127	+	99	5188622	61439
chr11	5127183	5327183	harbor1	chr11	5196202	5196479	DNA/hAT-Charlie	1500	+	138	5196340	69157
chr11	5127132	5327132	harbor1	chr11	5149375	5149727	DNA/hAT-Charlie	1066	+	176	5149551	22419
chr11	5127132	5327132	harbor1	chr11	5188523	5188721	DNA/hAT-Charlie	1127	+	99	5188622	61490
chr11	5127132	5327132	harbor1	chr11	5196202	5196479	DNA/hAT-Charlie	1500	+	138	5196340	69208
chr11	70336771	70536771	harbor1	chr11	70389580	70389760	DNA/hAT-Charlie	1259	+	90	70389670	52899
chr11	10401686	10601686	harbor1	chr11	10410011	10410262	DNA/hAT-Charlie	644	+	126	10410137	8451
chr11	10401686	10601686	harbor1	chr11	10446184	10446906	DNA/hAT-Charlie	2330	+	361	10446545	44859
chr11	10401686	10601686	harbor1	chr11	10447211	10447647	DNA/hAT-Charlie	2330	+	218	10447429	45743
chr11	10401686	10601686	harbor1	chr11	10448279	10448615	DNA/hAT-Charlie	2105	+	168	10448447	46761
chr11	10401686	10601686	harbor1	chr11	10448669	10449447	DNA/hAT-Charlie	2105	+	389	10449058	47372
chr11	10401686	10601686	harbor1	chr11	10454392	10454637	DNA/hAT-Charlie	621	+	122	10454514	52828
chr11	5126760	5326760	harbor1	chr11	5149375	5149727	DNA/hAT-Charlie	1066	+	176	5149551	22791
chr11	5126760	5326760	harbor1	chr11	5188523	5188721	DNA/hAT-Charlie	1127	+	99	5188622	61862
chr11	5126760	5326760	harbor1	chr11	5196202	5196479	DNA/hAT-Charlie	1500	+	138	5196340	69580
chr11	34816228	35016228	harbor1	chr11	34827889	34828042	DNA/hAT-Charlie	478	+	76	34827965	11737
chr11	34816228	35016228	harbor1	chr11	34837585	34837809	DNA/hAT-Charlie	1172	+	112	34837697	21469
chr11	34816228	35016228	harbor1	chr11	34844754	34844966	DNA/hAT-Charlie	908	+	106	34844860	28632
chr11	34816228	35016228	harbor1	chr11	34844952	34845091	DNA/hAT-Charlie	710	+	70	34845022	28794
chr11	34816228	35016228	harbor1	chr11	34851105	34851285	DNA/hAT-Charlie	515	+	90	34851195	34967
chr11	34816228	35016228	harbor1	chr11	34865938	34866332	DNA/hAT-Charlie	2884	+	197	34866135	49907
chr11	34816228	35016228	harbor1	chr11	34873019	34873355	DNA/hAT-Charlie	2471	+	168	34873187	56959
chr11	34816228	35016228	harbor1	chr11	34911514	34911729	DNA/hAT-Charlie	502	+	108	34911622	95394
chr11	5127108	5327108	harbor1	chr11	5149375	5149727	DNA/hAT-Charlie	1066	+	176	5149551	22443
chr11	5127108	5327108	harbor1	chr11	5188523	5188721	DNA/hAT-Charlie	1127	+	99	5188622	61514
chr11	5127108	5327108	harbor1	chr11	5196202	5196479	DNA/hAT-Charlie	1500	+	138	5196340	69232
chr11	2052793	2252793	harbor1	chr11	2088508	2088645	DNA/hAT-Charlie	498	+	68	2088576	35783
chr11	5127203	5327203	harbor1	chr11	5149375	5149727	DNA/hAT-Charlie	1066	+	176	5149551	22348
chr11	5127203	5327203	harbor1	chr11	5188523	5188721	DNA/hAT-Charlie	1127	+	99	5188622	61419
chr11	5127203	5327203	harbor1	chr11	5196202	5196479	DNA/hAT-Charlie	1500	+	138	5196340	69137
chr11	5127281	5327281	harbor1	chr11	5149375	5149727	DNA/hAT-Charlie	1066	+	176	5149551	22270
chr11	5127281	5327281	harbor1	chr11	5188523	5188721	DNA/hAT-Charlie	1127	+	99	5188622	61341
chr11	5127281	5327281	harbor1	chr11	5196202	5196479	DNA/hAT-Charlie	1500	+	138	5196340	69059
chr11	5134553	5334553	harbor1	chr11	5149375	5149727	DNA/hAT-Charlie	1066	+	176	5149551	14998
chr11	5134553	5334553	harbor1	chr11	5188523	5188721	DNA/hAT-Charlie	1127	+	99	5188622	54069
chr11	5134553	5334553	harbor1	chr11	5196202	5196479	DNA/hAT-Charlie	1500	+	138	5196340	61787
chr11	118508487	118708487	harbor1	chr11	118584299	118584422	DNA/hAT-Charlie	437	+	62	118584361	75874
chr11	86572150	86772150	harbor1	chr11	86628404	86628579	DNA/hAT-Charlie	873	+	88	86628492	56342
chr11	86572150	86772150	harbor1	chr11	86629815	86630004	DNA/hAT-Charlie	575	+	94	86629909	57759
chr11	5134570	5334570	harbor1	chr11	5149375	5149727	DNA/hAT-Charlie	1066	+	176	5149551	14981
chr11	5134570	5334570	harbor1	chr11	5188523	5188721	DNA/hAT-Charlie	1127	+	99	5188622	54052
chr11	5134570	5334570	harbor1	chr11	5196202	5196479	DNA/hAT-Charlie	1500	+	138	5196340	61770
chr11	123313642	123513642	harbor1	chr11	123395609	123395785	DNA/hAT-Charlie	909	+	88	123395697	82055
chr11	76580440	76780440	harbor1	chr11	76595957	76596041	DNA/hAT-Charlie	495	+	42	76595999	15559
chr11	76580440	76780440	harbor1	chr11	76598717	76599027	DNA/hAT-Charlie	1368	+	155	76598872	18432
chr11	76580440	76780440	harbor1	chr11	76607306	76607536	DNA/hAT-Charlie	452	+	115	76607421	26981
chr11	76580440	76780440	harbor1	chr11	76612271	76612410	DNA/hAT-Charlie	472	+	70	76612341	31901
chr11	76580440	76780440	harbor1	chr11	76612460	76612643	DNA/hAT-Charlie	986	+	92	76612552	32112
chr11	76580440	76780440	harbor1	chr11	76612669	76612700	DNA/hAT-Charlie	986	+	16	76612685	32245
chr11	76580440	76780440	harbor1	chr11	76612988	76613265	DNA/hAT-Charlie	986	+	138	76613126	32686
chr11	76580440	76780440	harbor1	chr11	76613362	76613889	DNA/hAT-Charlie	986	+	264	76613626	33186
chr11	76580440	76780440	harbor1	chr11	76649274	76649745	DNA/hAT-Charlie	1913	+	236	76649510	69070
chr11	5126802	5326802	harbor1	chr11	5149375	5149727	DNA/hAT-Charlie	1066	+	176	5149551	22749
chr11	5126802	5326802	harbor1	chr11	5188523	5188721	DNA/hAT-Charlie	1127	+	99	5188622	61820
chr11	5126802	5326802	harbor1	chr11	5196202	5196479	DNA/hAT-Charlie	1500	+	138	5196340	69538
chr11	133733693	133933693	harbor1	chr11	133780487	133780648	DNA/hAT-Charlie	603	+	80	133780567	46874
chr11	5125241	5325241	harbor1	chr11	5149375	5149727	DNA/hAT-Charlie	1066	+	176	5149551	24310
chr11	5125241	5325241	harbor1	chr11	5188523	5188721	DNA/hAT-Charlie	1127	+	99	5188622	63381
chr11	5125241	5325241	harbor1	chr11	5196202	5196479	DNA/hAT-Charlie	1500	+	138	5196340	71099
chr11	5134190	5334190	harbor1	chr11	5149375	5149727	DNA/hAT-Charlie	1066	+	176	5149551	15361
chr11	5134190	5334190	harbor1	chr11	5188523	5188721	DNA/hAT-Charlie	1127	+	99	5188622	54432
chr11	5134190	5334190	harbor1	chr11	5196202	5196479	DNA/hAT-Charlie	1500	+	138	5196340	62150
chr11	5125737	5325737	harbor1	chr11	5149375	5149727	DNA/hAT-Charlie	1066	+	176	5149551	23814
chr11	5125737	5325737	harbor1	chr11	5188523	5188721	DNA/hAT-Charlie	1127	+	99	5188622	62885
chr11	5125737	5325737	harbor1	chr11	5196202	5196479	DNA/hAT-Charlie	1500	+	138	5196340	70603
chr11	5127241	5327241	harbor1	chr11	5149375	5149727	DNA/hAT-Charlie	1066	+	176	5149551	22310
chr11	5127241	5327241	harbor1	chr11	5188523	5188721	DNA/hAT-Charlie	1127	+	99	5188622	61381
chr11	5127241	5327241	harbor1	chr11	5196202	5196479	DNA/hAT-Charlie	1500	+	138	5196340	69099
chr11	5126766	5326766	harbor1	chr11	5149375	5149727	DNA/hAT-Charlie	1066	+	176	5149551	22785
chr11	5126766	5326766	harbor1	chr11	5188523	5188721	DNA/hAT-Charlie	1127	+	99	5188622	61856
chr11	5126766	5326766	harbor1	chr11	5196202	5196479	DNA/hAT-Charlie	1500	+	138	5196340	69574
chr11	5134609	5334609	harbor1	chr11	5149375	5149727	DNA/hAT-Charlie	1066	+	176	5149551	14942
chr11	5134609	5334609	harbor1	chr11	5188523	5188721	DNA/hAT-Charlie	1127	+	99	5188622	54013
chr11	5134609	5334609	harbor1	chr11	5196202	5196479	DNA/hAT-Charlie	1500	+	138	5196340	61731
chr11	5134091	5334091	harbor1	chr11	5149375	5149727	DNA/hAT-Charlie	1066	+	176	5149551	15460
chr11	5134091	5334091	harbor1	chr11	5188523	5188721	DNA/hAT-Charlie	1127	+	99	5188622	54531
chr11	5134091	5334091	harbor1	chr11	5196202	5196479	DNA/hAT-Charlie	1500	+	138	5196340	62249
chr11	5127300	5327300	harbor1	chr11	5149375	5149727	DNA/hAT-Charlie	1066	+	176	5149551	22251
chr11	5127300	5327300	harbor1	chr11	5188523	5188721	DNA/hAT-Charlie	1127	+	99	5188622	61322
chr11	5127300	5327300	harbor1	chr11	5196202	5196479	DNA/hAT-Charlie	1500	+	138	5196340	69040
chr11	5127229	5327229	harbor1	chr11	5149375	5149727	DNA/hAT-Charlie	1066	+	176	5149551	22322
chr11	5127229	5327229	harbor1	chr11	5188523	5188721	DNA/hAT-Charlie	1127	+	99	5188622	61393
chr11	5127229	5327229	harbor1	chr11	5196202	5196479	DNA/hAT-Charlie	1500	+	138	5196340	69111
chr11	107465643	107665643	harbor1	chr11	107478688	107478890	DNA/hAT-Charlie	1213	+	101	107478789	13146
chr11	108021539	108221539	harbor1	chr11	108083882	108084100	DNA/hAT-Charlie	1511	+	109	108083991	62452
chr11	108021539	108221539	harbor1	chr11	108086558	108086851	DNA/hAT-Charlie	839	+	146	108086704	65165
chr11	108021539	108221539	harbor1	chr11	108087018	108087503	DNA/hAT-Charlie	868	+	242	108087260	65721
chr11	108021539	108221539	harbor1	chr11	108111192	108111368	DNA/hAT-Charlie	791	+	88	108111280	89741
chr11	5126785	5326785	harbor1	chr11	5149375	5149727	DNA/hAT-Charlie	1066	+	176	5149551	22766
chr11	5126785	5326785	harbor1	chr11	5188523	5188721	DNA/hAT-Charlie	1127	+	99	5188622	61837
chr11	5126785	5326785	harbor1	chr11	5196202	5196479	DNA/hAT-Charlie	1500	+	138	5196340	69555
chr11	64538073	64738073	harbor1	chr11	64539863	64540158	DNA/hAT-Charlie	820	+	148	64540011	1938
chr11	64538073	64738073	harbor1	chr11	64624585	64624805	DNA/hAT-Charlie	711	+	110	64624695	86622
chr11	5127144	5327144	harbor1	chr11	5149375	5149727	DNA/hAT-Charlie	1066	+	176	5149551	22407
chr11	5127144	5327144	harbor1	chr11	5188523	5188721	DNA/hAT-Charlie	1127	+	99	5188622	61478
chr11	5127144	5327144	harbor1	chr11	5196202	5196479	DNA/hAT-Charlie	1500	+	138	5196340	69196
chr11	5127200	5327200	harbor1	chr11	5149375	5149727	DNA/hAT-Charlie	1066	+	176	5149551	22351
chr11	5127200	5327200	harbor1	chr11	5188523	5188721	DNA/hAT-Charlie	1127	+	99	5188622	61422
chr11	5127200	5327200	harbor1	chr11	5196202	5196479	DNA/hAT-Charlie	1500	+	138	5196340	69140
chr11	117886632	118086632	harbor1	chr11	117891421	117892055	DNA/hAT-Charlie	2971	+	317	117891738	5106
chr11	117886632	118086632	harbor1	chr11	117892369	117892459	DNA/hAT-Charlie	2971	+	45	117892414	5782
chr11	117886632	118086632	harbor1	chr11	117894521	117895085	DNA/hAT-Charlie	2403	+	282	117894803	8171
chr11	117886632	118086632	harbor1	chr11	117912120	117912259	DNA/hAT-Charlie	536	+	70	117912190	25558
chr11	117886632	118086632	harbor1	chr11	117912270	117912396	DNA/hAT-Charlie	464	+	63	117912333	25701
chr11	117886632	118086632	harbor1	chr11	117950303	117950479	DNA/hAT-Charlie	869	+	88	117950391	63759
chr11	5103484	5303484	harbor1	chr11	5149375	5149727	DNA/hAT-Charlie	1066	+	176	5149551	46067
chr11	5103484	5303484	harbor1	chr11	5188523	5188721	DNA/hAT-Charlie	1127	+	99	5188622	85138
chr11	5103484	5303484	harbor1	chr11	5196202	5196479	DNA/hAT-Charlie	1500	+	138	5196340	92856
chr11	69539230	69739230	harbor1	chr11	69546157	69546302	DNA/hAT-Charlie	445	+	72	69546229	6999
chr11	69539230	69739230	harbor1	chr11	69569341	69569561	DNA/hAT-Charlie	605	+	110	69569451	30221
chr11	69539230	69739230	harbor1	chr11	69626241	69626457	DNA/hAT-Charlie	1490	+	108	69626349	87119
chr11	5127304	5327304	harbor1	chr11	5149375	5149727	DNA/hAT-Charlie	1066	+	176	5149551	22247
chr11	5127304	5327304	harbor1	chr11	5188523	5188721	DNA/hAT-Charlie	1127	+	99	5188622	61318
chr11	5127304	5327304	harbor1	chr11	5196202	5196479	DNA/hAT-Charlie	1500	+	138	5196340	69036
chr11	57394202	57594202	harbor1	chr11	57416766	57416918	DNA/hAT-Charlie	485	+	76	57416842	22640
chr11	57394202	57594202	harbor1	chr11	57451266	57451480	DNA/hAT-Charlie	427	+	107	57451373	57171
chr11	57394202	57594202	harbor1	chr11	57466768	57466972	DNA/hAT-Charlie	1175	+	102	57466870	72668
chr11	57394202	57594202	harbor1	chr11	57475791	57475961	DNA/hAT-Charlie	403	+	85	57475876	81674
chr11	57394202	57594202	harbor1	chr11	57489561	57489744	DNA/hAT-Charlie	401	+	92	57489653	95451
chr11	6201318	6401318	harbor1	chr11	6204647	6204824	DNA/hAT-Charlie	851	+	88	6204735	3417
chr11	6201318	6401318	harbor1	chr11	6291721	6291842	DNA/hAT-Charlie	586	+	60	6291781	90463
chr11	46138065	46338065	harbor1	chr11	46142512	46142683	DNA/hAT-Charlie	923	+	86	46142598	4533
chr11	46138065	46338065	harbor1	chr11	46145967	46146189	DNA/hAT-Charlie	992	+	111	46146078	8013
chr11	46138065	46338065	harbor1	chr11	46163425	46163735	DNA/hAT-Charlie	740	+	155	46163580	25515
chr11	46138065	46338065	harbor1	chr11	46172418	46172607	DNA/hAT-Charlie	810	+	94	46172512	34447
chr11	46138065	46338065	harbor1	chr11	46180312	46180564	DNA/hAT-Charlie	822	+	126	46180438	42373
chr11	46138065	46338065	harbor1	chr11	46207379	46207752	DNA/hAT-Charlie	3095	+	186	46207565	69500
chr11	46138065	46338065	harbor1	chr11	46208060	46208130	DNA/hAT-Charlie	3095	+	35	46208095	70030
chr11	46138065	46338065	harbor1	chr11	46208131	46208261	DNA/hAT-Charlie	774	+	65	46208196	70131
chr11	46138065	46338065	harbor1	chr11	46210560	46210680	DNA/hAT-Charlie	533	+	60	46210620	72555
chr11	57246770	57446770	harbor1	chr11	57246761	57246841	DNA/hAT-Charlie	1274	+	40	57246801	31
chr11	57246770	57446770	harbor1	chr11	57289660	57290067	DNA/hAT-Charlie	1337	+	204	57289864	43094
chr11	57246770	57446770	harbor1	chr11	57346171	57346374	DNA/hAT-Charlie	752	+	102	57346273	99503
chr11	57383305	57583305	harbor1	chr11	57416766	57416918	DNA/hAT-Charlie	485	+	76	57416842	33537
chr11	57383305	57583305	harbor1	chr11	57451266	57451480	DNA/hAT-Charlie	427	+	107	57451373	68068
chr11	57383305	57583305	harbor1	chr11	57466768	57466972	DNA/hAT-Charlie	1175	+	102	57466870	83565
chr11	57383305	57583305	harbor1	chr11	57475791	57475961	DNA/hAT-Charlie	403	+	85	57475876	92571
chr11	12139700	12339700	harbor1	chr11	12181855	12182136	DNA/hAT-Charlie	988	+	140	12181995	42295
chr11	12139700	12339700	harbor1	chr11	12182162	12182263	DNA/hAT-Charlie	447	+	50	12182212	42512
chr11	12139700	12339700	harbor1	chr11	12188060	12188358	DNA/hAT-Charlie	1401	+	149	12188209	48509
chr11	12139700	12339700	harbor1	chr11	12188359	12188579	DNA/hAT-Charlie	975	+	110	12188469	48769
chr11	12139700	12339700	harbor1	chr11	12214554	12214827	DNA/hAT-Charlie	874	+	136	12214690	74990
chr11	12139700	12339700	harbor1	chr11	12233464	12233712	DNA/hAT-Charlie	628	+	124	12233588	93888
chr11	12139700	12339700	harbor1	chr11	12237720	12237884	DNA/hAT-Charlie	632	+	82	12237802	98102
chr11	107914515	108114515	harbor1	chr11	107941135	107941336	DNA/hAT-Charlie	692	+	100	107941235	26720
chr11	107914515	108114515	harbor1	chr11	107992663	107993002	DNA/hAT-Charlie	2310	+	170	107992833	78318
chr11	68332127	68532127	harbor1	chr11	68380174	68380476	DNA/hAT-Charlie	939	+	151	68380325	48198
chr11	68332127	68532127	harbor1	chr11	68398549	68398747	DNA/hAT-Charlie	777	+	99	68398648	66521
chr11	68332127	68532127	harbor1	chr11	68399017	68399045	DNA/hAT-Charlie	777	+	14	68399031	66904
chr11	68332127	68532127	harbor1	chr11	68399394	68399521	DNA/hAT-Charlie	777	+	64	68399458	67331
chr11	68332127	68532127	harbor1	chr11	68407498	68407558	DNA/hAT-Charlie	656	+	30	68407528	75401
chr11	68332127	68532127	harbor1	chr11	68407860	68408009	DNA/hAT-Charlie	656	+	74	68407934	75807
chr11	731095	931095	harbor1	chr11	733950	734172	DNA/hAT-Charlie	619	+	111	734061	2966
chr11	731095	931095	harbor1	chr11	743872	744047	DNA/hAT-Charlie	756	+	88	743960	12865
chr11	64537994	64737994	harbor1	chr11	64539863	64540158	DNA/hAT-Charlie	820	+	148	64540011	2017
chr11	64537994	64737994	harbor1	chr11	64624585	64624805	DNA/hAT-Charlie	711	+	110	64624695	86701
chr11	76580499	76780499	harbor1	chr11	76595957	76596041	DNA/hAT-Charlie	495	+	42	76595999	15500
chr11	76580499	76780499	harbor1	chr11	76598717	76599027	DNA/hAT-Charlie	1368	+	155	76598872	18373
chr11	76580499	76780499	harbor1	chr11	76607306	76607536	DNA/hAT-Charlie	452	+	115	76607421	26922
chr11	76580499	76780499	harbor1	chr11	76612271	76612410	DNA/hAT-Charlie	472	+	70	76612341	31842
chr11	76580499	76780499	harbor1	chr11	76612460	76612643	DNA/hAT-Charlie	986	+	92	76612552	32053
chr11	76580499	76780499	harbor1	chr11	76612669	76612700	DNA/hAT-Charlie	986	+	16	76612685	32186
chr11	76580499	76780499	harbor1	chr11	76612988	76613265	DNA/hAT-Charlie	986	+	138	76613126	32627
chr11	76580499	76780499	harbor1	chr11	76613362	76613889	DNA/hAT-Charlie	986	+	264	76613626	33127
chr11	76580499	76780499	harbor1	chr11	76649274	76649745	DNA/hAT-Charlie	1913	+	236	76649510	69011
chr11	76580347	76780347	harbor1	chr11	76595957	76596041	DNA/hAT-Charlie	495	+	42	76595999	15652
chr11	76580347	76780347	harbor1	chr11	76598717	76599027	DNA/hAT-Charlie	1368	+	155	76598872	18525
chr11	76580347	76780347	harbor1	chr11	76607306	76607536	DNA/hAT-Charlie	452	+	115	76607421	27074
chr11	76580347	76780347	harbor1	chr11	76612271	76612410	DNA/hAT-Charlie	472	+	70	76612341	31994
chr11	76580347	76780347	harbor1	chr11	76612460	76612643	DNA/hAT-Charlie	986	+	92	76612552	32205
chr11	76580347	76780347	harbor1	chr11	76612669	76612700	DNA/hAT-Charlie	986	+	16	76612685	32338
chr11	76580347	76780347	harbor1	chr11	76612988	76613265	DNA/hAT-Charlie	986	+	138	76613126	32779
chr11	76580347	76780347	harbor1	chr11	76613362	76613889	DNA/hAT-Charlie	986	+	264	76613626	33279
chr11	76580347	76780347	harbor1	chr11	76649274	76649745	DNA/hAT-Charlie	1913	+	236	76649510	69163
chr11	5127117	5327117	harbor1	chr11	5149375	5149727	DNA/hAT-Charlie	1066	+	176	5149551	22434
chr11	5127117	5327117	harbor1	chr11	5188523	5188721	DNA/hAT-Charlie	1127	+	99	5188622	61505
chr11	5127117	5327117	harbor1	chr11	5196202	5196479	DNA/hAT-Charlie	1500	+	138	5196340	69223
chr11	76580972	76780972	harbor1	chr11	76595957	76596041	DNA/hAT-Charlie	495	+	42	76595999	15027
chr11	76580972	76780972	harbor1	chr11	76598717	76599027	DNA/hAT-Charlie	1368	+	155	76598872	17900
chr11	76580972	76780972	harbor1	chr11	76607306	76607536	DNA/hAT-Charlie	452	+	115	76607421	26449
chr11	76580972	76780972	harbor1	chr11	76612271	76612410	DNA/hAT-Charlie	472	+	70	76612341	31369
chr11	76580972	76780972	harbor1	chr11	76612460	76612643	DNA/hAT-Charlie	986	+	92	76612552	31580
chr11	76580972	76780972	harbor1	chr11	76612669	76612700	DNA/hAT-Charlie	986	+	16	76612685	31713
chr11	76580972	76780972	harbor1	chr11	76612988	76613265	DNA/hAT-Charlie	986	+	138	76613126	32154
chr11	76580972	76780972	harbor1	chr11	76613362	76613889	DNA/hAT-Charlie	986	+	264	76613626	32654
chr11	76580972	76780972	harbor1	chr11	76649274	76649745	DNA/hAT-Charlie	1913	+	236	76649510	68538
chr11	5134657	5334657	harbor1	chr11	5149375	5149727	DNA/hAT-Charlie	1066	+	176	5149551	14894
chr11	5134657	5334657	harbor1	chr11	5188523	5188721	DNA/hAT-Charlie	1127	+	99	5188622	53965
chr11	5134657	5334657	harbor1	chr11	5196202	5196479	DNA/hAT-Charlie	1500	+	138	5196340	61683
chr11	3044411	3244411	harbor1	chr11	3123265	3123577	DNA/hAT-Charlie	1158	+	156	3123421	79010
chr11	6201420	6401420	harbor1	chr11	6204647	6204824	DNA/hAT-Charlie	851	+	88	6204735	3315
chr11	6201420	6401420	harbor1	chr11	6291721	6291842	DNA/hAT-Charlie	586	+	60	6291781	90361
chr11	108021633	108221633	harbor1	chr11	108083882	108084100	DNA/hAT-Charlie	1511	+	109	108083991	62358
chr11	108021633	108221633	harbor1	chr11	108086558	108086851	DNA/hAT-Charlie	839	+	146	108086704	65071
chr11	108021633	108221633	harbor1	chr11	108087018	108087503	DNA/hAT-Charlie	868	+	242	108087260	65627
chr11	108021633	108221633	harbor1	chr11	108111192	108111368	DNA/hAT-Charlie	791	+	88	108111280	89647
chr11	5127276	5327276	harbor1	chr11	5149375	5149727	DNA/hAT-Charlie	1066	+	176	5149551	22275
chr11	5127276	5327276	harbor1	chr11	5188523	5188721	DNA/hAT-Charlie	1127	+	99	5188622	61346
chr11	5127276	5327276	harbor1	chr11	5196202	5196479	DNA/hAT-Charlie	1500	+	138	5196340	69064
chr11	19099393	19299393	harbor1	chr11	19099806	19100024	DNA/hAT-Charlie	1511	+	109	19099915	522
chr11	19099393	19299393	harbor1	chr11	19190311	19190595	DNA/hAT-Charlie	1138	+	142	19190453	91060
chr11	5134554	5334554	harbor1	chr11	5149375	5149727	DNA/hAT-Charlie	1066	+	176	5149551	14997
chr11	5134554	5334554	harbor1	chr11	5188523	5188721	DNA/hAT-Charlie	1127	+	99	5188622	54068
chr11	5134554	5334554	harbor1	chr11	5196202	5196479	DNA/hAT-Charlie	1500	+	138	5196340	61786
chr11	6201346	6401346	harbor1	chr11	6204647	6204824	DNA/hAT-Charlie	851	+	88	6204735	3389
chr11	6201346	6401346	harbor1	chr11	6291721	6291842	DNA/hAT-Charlie	586	+	60	6291781	90435
chr11	5134601	5334601	harbor1	chr11	5149375	5149727	DNA/hAT-Charlie	1066	+	176	5149551	14950
chr11	5134601	5334601	harbor1	chr11	5188523	5188721	DNA/hAT-Charlie	1127	+	99	5188622	54021
chr11	5134601	5334601	harbor1	chr11	5196202	5196479	DNA/hAT-Charlie	1500	+	138	5196340	61739
chr11	67369231	67569231	harbor1	chr11	67429748	67429812	DNA/hAT-Charlie	1208	+	32	67429780	60549
chr11	67369231	67569231	harbor1	chr11	67430733	67430895	DNA/hAT-Charlie	1208	+	81	67430814	61583
chr11	67369231	67569231	harbor1	chr11	67462219	67462356	DNA/hAT-Charlie	526	+	68	67462287	93056
chr11	67369231	67569231	harbor1	chr11	67462653	67462690	DNA/hAT-Charlie	526	+	18	67462671	93440
chr11	67369231	67569231	harbor1	chr11	67462992	67463074	DNA/hAT-Charlie	526	+	41	67463033	93802
chr11	5127104	5327104	harbor1	chr11	5149375	5149727	DNA/hAT-Charlie	1066	+	176	5149551	22447
chr11	5127104	5327104	harbor1	chr11	5188523	5188721	DNA/hAT-Charlie	1127	+	99	5188622	61518
chr11	5127104	5327104	harbor1	chr11	5196202	5196479	DNA/hAT-Charlie	1500	+	138	5196340	69236
chr11	66158708	66358708	harbor1	chr11	66195834	66196055	DNA/hAT-Charlie	990	+	110	66195944	37236
chr11	66158708	66358708	harbor1	chr11	66196240	66196614	DNA/hAT-Charlie	2623	+	187	66196427	37719
chr11	66158708	66358708	harbor1	chr11	66196898	66197139	DNA/hAT-Charlie	2623	+	120	66197018	38310
chr11	66158708	66358708	harbor1	chr11	66197363	66197511	DNA/hAT-Charlie	2027	+	74	66197437	38729
chr11	66158708	66358708	harbor1	chr11	66197822	66198022	DNA/hAT-Charlie	2027	+	100	66197922	39214
chr11	66158708	66358708	harbor1	chr11	66198793	66198971	DNA/hAT-Charlie	2027	+	89	66198882	40174
chr11	66158708	66358708	harbor1	chr11	66226356	66226576	DNA/hAT-Charlie	1285	+	110	66226466	67758
chr11	66158708	66358708	harbor1	chr11	66236032	66236230	DNA/hAT-Charlie	832	+	99	66236131	77423
chr11	5127078	5327078	harbor1	chr11	5149375	5149727	DNA/hAT-Charlie	1066	+	176	5149551	22473
chr11	5127078	5327078	harbor1	chr11	5188523	5188721	DNA/hAT-Charlie	1127	+	99	5188622	61544
chr11	5127078	5327078	harbor1	chr11	5196202	5196479	DNA/hAT-Charlie	1500	+	138	5196340	69262
chr11	22725288	22925288	harbor1	chr11	22760289	22760473	DNA/hAT-Charlie	980	+	92	22760381	35093
chr11	22725288	22925288	harbor1	chr11	22824747	22824916	DNA/hAT-Charlie	445	+	84	22824831	99543
chr11	5132790	5332790	harbor1	chr11	5149375	5149727	DNA/hAT-Charlie	1066	+	176	5149551	16761
chr11	5132790	5332790	harbor1	chr11	5188523	5188721	DNA/hAT-Charlie	1127	+	99	5188622	55832
chr11	5132790	5332790	harbor1	chr11	5196202	5196479	DNA/hAT-Charlie	1500	+	138	5196340	63550
chr11	75668477	75868477	harbor1	chr11	75741917	75742128	DNA/hAT-Charlie	1200	+	106	75742023	73546
chr11	75668477	75868477	harbor1	chr11	75742763	75742844	DNA/hAT-Charlie	1200	+	40	75742803	74326
chr11	75668477	75868477	harbor1	chr11	75760813	75760962	DNA/hAT-Charlie	913	+	74	75760887	92410
chr11	5134186	5334186	harbor1	chr11	5149375	5149727	DNA/hAT-Charlie	1066	+	176	5149551	15365
chr11	5134186	5334186	harbor1	chr11	5188523	5188721	DNA/hAT-Charlie	1127	+	99	5188622	54436
chr11	5134186	5334186	harbor1	chr11	5196202	5196479	DNA/hAT-Charlie	1500	+	138	5196340	62154
chr11	4514263	4714263	harbor1	chr11	4603671	4603836	DNA/hAT-Charlie	854	+	82	4603753	89490
chr11	73042808	73242808	harbor1	chr11	73050906	73050991	DNA/hAT-Charlie	521	+	42	73050948	8140
chr11	73042808	73242808	harbor1	chr11	73051340	73051618	DNA/hAT-Charlie	860	+	139	73051479	8671
chr11	73042808	73242808	harbor1	chr11	73051615	73051868	DNA/hAT-Charlie	7566	+	126	73051741	8933
chr11	73042808	73242808	harbor1	chr11	73051928	73052844	DNA/hAT-Charlie	7566	+	458	73052386	9578
chr11	73042808	73242808	harbor1	chr11	73053146	73054035	DNA/hAT-Charlie	7566	+	444	73053590	10782
chr11	73042808	73242808	harbor1	chr11	73054046	73054251	DNA/hAT-Charlie	1038	+	102	73054148	11340
chr11	73042808	73242808	harbor1	chr11	73129276	73129808	DNA/hAT-Charlie	3723	+	266	73129542	86734
chr11	5126808	5326808	harbor1	chr11	5149375	5149727	DNA/hAT-Charlie	1066	+	176	5149551	22743
chr11	5126808	5326808	harbor1	chr11	5188523	5188721	DNA/hAT-Charlie	1127	+	99	5188622	61814
chr11	5126808	5326808	harbor1	chr11	5196202	5196479	DNA/hAT-Charlie	1500	+	138	5196340	69532
chr11	119007536	119207536	harbor1	chr11	119076699	119076858	DNA/hAT-Charlie	880	+	80	119076779	69243
chr11	69539219	69739219	harbor1	chr11	69546157	69546302	DNA/hAT-Charlie	445	+	72	69546229	7010
chr11	69539219	69739219	harbor1	chr11	69569341	69569561	DNA/hAT-Charlie	605	+	110	69569451	30232
chr11	69539219	69739219	harbor1	chr11	69626241	69626457	DNA/hAT-Charlie	1490	+	108	69626349	87130
chr11	66808278	67008278	harbor1	chr11	66812741	66812962	DNA/hAT-Charlie	1215	+	110	66812851	4573
chr11	76581035	76781035	harbor1	chr11	76595957	76596041	DNA/hAT-Charlie	495	+	42	76595999	14964
chr11	76581035	76781035	harbor1	chr11	76598717	76599027	DNA/hAT-Charlie	1368	+	155	76598872	17837
chr11	76581035	76781035	harbor1	chr11	76607306	76607536	DNA/hAT-Charlie	452	+	115	76607421	26386
chr11	76581035	76781035	harbor1	chr11	76612271	76612410	DNA/hAT-Charlie	472	+	70	76612341	31306
chr11	76581035	76781035	harbor1	chr11	76612460	76612643	DNA/hAT-Charlie	986	+	92	76612552	31517
chr11	76581035	76781035	harbor1	chr11	76612669	76612700	DNA/hAT-Charlie	986	+	16	76612685	31650
chr11	76581035	76781035	harbor1	chr11	76612988	76613265	DNA/hAT-Charlie	986	+	138	76613126	32091
chr11	76581035	76781035	harbor1	chr11	76613362	76613889	DNA/hAT-Charlie	986	+	264	76613626	32591
chr11	76581035	76781035	harbor1	chr11	76649274	76649745	DNA/hAT-Charlie	1913	+	236	76649510	68475
chr11	305556	505556	harbor1	chr11	327537	327730	DNA/hAT-Charlie	493	+	96	327633	22077
chr11	32073529	32273529	harbor1	chr11	32089966	32090105	DNA/hAT-Charlie	429	+	70	32090036	16507
chr11	32073529	32273529	harbor1	chr11	32096786	32096946	DNA/hAT-Charlie	566	+	80	32096866	23337
chr11	32073529	32273529	harbor1	chr11	32154488	32154711	DNA/hAT-Charlie	1224	+	112	32154600	81071
chr11	32073529	32273529	harbor1	chr11	32157393	32157589	DNA/hAT-Charlie	1023	+	98	32157491	83962
chr11	5127131	5327131	harbor1	chr11	5149375	5149727	DNA/hAT-Charlie	1066	+	176	5149551	22420
chr11	5127131	5327131	harbor1	chr11	5188523	5188721	DNA/hAT-Charlie	1127	+	99	5188622	61491
chr11	5127131	5327131	harbor1	chr11	5196202	5196479	DNA/hAT-Charlie	1500	+	138	5196340	69209
chr11	63803202	64003202	harbor1	chr11	63851982	63853117	DNA/hAT-Charlie	10090	+	568	63852550	49348
chr11	63803202	64003202	harbor1	chr11	63853408	63853859	DNA/hAT-Charlie	10090	+	226	63853634	50432
chr11	63803202	64003202	harbor1	chr11	63854173	63854186	DNA/hAT-Charlie	10090	+	6	63854179	50977
chr11	63803202	64003202	harbor1	chr11	63854517	63854552	DNA/hAT-Charlie	10090	+	18	63854535	51333
chr11	63803202	64003202	harbor1	chr11	63854832	63855236	DNA/hAT-Charlie	10090	+	202	63855034	51832
chr11	63803202	64003202	harbor1	chr11	63855543	63856061	DNA/hAT-Charlie	10090	+	259	63855802	52600
chr11	63803202	64003202	harbor1	chr11	63857550	63857785	DNA/hAT-Charlie	788	+	118	63857668	54466
chr11	69539220	69739220	harbor1	chr11	69546157	69546302	DNA/hAT-Charlie	445	+	72	69546229	7009
chr11	69539220	69739220	harbor1	chr11	69569341	69569561	DNA/hAT-Charlie	605	+	110	69569451	30231
chr11	69539220	69739220	harbor1	chr11	69626241	69626457	DNA/hAT-Charlie	1490	+	108	69626349	87129
chr11	5125969	5325969	harbor1	chr11	5149375	5149727	DNA/hAT-Charlie	1066	+	176	5149551	23582
chr11	5125969	5325969	harbor1	chr11	5188523	5188721	DNA/hAT-Charlie	1127	+	99	5188622	62653
chr11	5125969	5325969	harbor1	chr11	5196202	5196479	DNA/hAT-Charlie	1500	+	138	5196340	70371
chr11	68332185	68532185	harbor1	chr11	68380174	68380476	DNA/hAT-Charlie	939	+	151	68380325	48140
chr11	68332185	68532185	harbor1	chr11	68398549	68398747	DNA/hAT-Charlie	777	+	99	68398648	66463
chr11	68332185	68532185	harbor1	chr11	68399017	68399045	DNA/hAT-Charlie	777	+	14	68399031	66846
chr11	68332185	68532185	harbor1	chr11	68399394	68399521	DNA/hAT-Charlie	777	+	64	68399458	67273
chr11	68332185	68532185	harbor1	chr11	68407498	68407558	DNA/hAT-Charlie	656	+	30	68407528	75343
chr11	68332185	68532185	harbor1	chr11	68407860	68408009	DNA/hAT-Charlie	656	+	74	68407934	75749
chr11	682053	882053	harbor1	chr11	733950	734172	DNA/hAT-Charlie	619	+	111	734061	52008
chr11	682053	882053	harbor1	chr11	743872	744047	DNA/hAT-Charlie	756	+	88	743960	61907
chr11	1448331	1648331	harbor1	chr11	1530092	1530355	DNA/hAT-Charlie	516	+	132	1530224	81893
chr11	1448331	1648331	harbor1	chr11	1530650	1530694	DNA/hAT-Charlie	516	+	22	1530672	82341
chr11	2062911	2262911	harbor1	chr11	2088508	2088645	DNA/hAT-Charlie	498	+	68	2088576	25665
chr11	3125267	3325267	harbor1	chr11	3167804	3168016	DNA/hAT-Charlie	807	+	106	3167910	42643
chr11	3125267	3325267	harbor1	chr11	3173196	3173673	DNA/hAT-Charlie	1904	+	238	3173434	48167
chr11	3125267	3325267	harbor1	chr11	3184028	3184213	DNA/hAT-Charlie	499	+	92	3184120	58853
chr11	47075637	47275637	harbor1	chr11	47102426	47102639	DNA/hAT-Charlie	801	+	106	47102532	26895
chr11	5126984	5326984	harbor1	chr11	5149375	5149727	DNA/hAT-Charlie	1066	+	176	5149551	22567
chr11	5126984	5326984	harbor1	chr11	5188523	5188721	DNA/hAT-Charlie	1127	+	99	5188622	61638
chr11	5126984	5326984	harbor1	chr11	5196202	5196479	DNA/hAT-Charlie	1500	+	138	5196340	69356
chr11	69498462	69698462	harbor1	chr11	69546157	69546302	DNA/hAT-Charlie	445	+	72	69546229	47767
chr11	69498462	69698462	harbor1	chr11	69569341	69569561	DNA/hAT-Charlie	605	+	110	69569451	70989
chr11	5127187	5327187	harbor1	chr11	5149375	5149727	DNA/hAT-Charlie	1066	+	176	5149551	22364
chr11	5127187	5327187	harbor1	chr11	5188523	5188721	DNA/hAT-Charlie	1127	+	99	5188622	61435
chr11	5127187	5327187	harbor1	chr11	5196202	5196479	DNA/hAT-Charlie	1500	+	138	5196340	69153
chr11	65969885	66169885	harbor1	chr11	66028915	66029028	DNA/hAT-Charlie	1518	+	56	66028971	59086
chr11	65969885	66169885	harbor1	chr11	66029329	66029769	DNA/hAT-Charlie	1518	+	220	66029549	59664
chr11	65969885	66169885	harbor1	chr11	66037006	66037247	DNA/hAT-Charlie	1404	+	120	66037126	67241
chr11	65969885	66169885	harbor1	chr11	66055740	66055926	DNA/hAT-Charlie	598	+	93	66055833	85948
chr11	69575154	69775154	harbor1	chr11	69626241	69626457	DNA/hAT-Charlie	1490	+	108	69626349	51195
chr11	69575154	69775154	harbor1	chr11	69663008	69663348	DNA/hAT-Charlie	2389	+	170	69663178	88024
chr11	33157309	33357309	harbor1	chr11	33197402	33197564	DNA/hAT-Charlie	856	+	81	33197483	40174
chr11	33157309	33357309	harbor1	chr11	33229458	33229742	DNA/hAT-Charlie	1143	+	142	33229600	72291
chr11	33157309	33357309	harbor1	chr11	33230071	33230232	DNA/hAT-Charlie	1143	+	80	33230151	72842
chr11	77964208	78164208	harbor1	chr11	77993782	77993897	DNA/hAT-Charlie	439	+	58	77993840	29632
chr11	77964208	78164208	harbor1	chr11	78011671	78011836	DNA/hAT-Charlie	450	+	82	78011753	47545
chr11	64537959	64737959	harbor1	chr11	64539863	64540158	DNA/hAT-Charlie	820	+	148	64540011	2052
chr11	64537959	64737959	harbor1	chr11	64624585	64624805	DNA/hAT-Charlie	711	+	110	64624695	86736
chr11	5132879	5332879	harbor1	chr11	5149375	5149727	DNA/hAT-Charlie	1066	+	176	5149551	16672
chr11	5132879	5332879	harbor1	chr11	5188523	5188721	DNA/hAT-Charlie	1127	+	99	5188622	55743
chr11	5132879	5332879	harbor1	chr11	5196202	5196479	DNA/hAT-Charlie	1500	+	138	5196340	63461
chr11	6201311	6401311	harbor1	chr11	6204647	6204824	DNA/hAT-Charlie	851	+	88	6204735	3424
chr11	6201311	6401311	harbor1	chr11	6291721	6291842	DNA/hAT-Charlie	586	+	60	6291781	90470
chr11	113773432	113973432	harbor1	chr11	113792007	113792184	DNA/hAT-Charlie	429	+	88	113792095	18663
chr11	113773432	113973432	harbor1	chr11	113804274	113804450	DNA/hAT-Charlie	435	+	88	113804362	30930
chr11	68880548	69080548	harbor1	chr11	68906408	68906631	DNA/hAT-Charlie	1065	+	112	68906520	25972
chr11	68880548	69080548	harbor1	chr11	68906942	68906997	DNA/hAT-Charlie	1065	+	28	68906970	26422
chr11	68880548	69080548	harbor1	chr11	68907285	68907324	DNA/hAT-Charlie	1065	+	20	68907305	26757
chr11	68880548	69080548	harbor1	chr11	68924851	68925077	DNA/hAT-Charlie	1476	+	113	68924964	44416
chr11	68880548	69080548	harbor1	chr11	68948994	68949500	DNA/hAT-Charlie	3497	+	253	68949247	68699
chr11	5126814	5326814	harbor1	chr11	5149375	5149727	DNA/hAT-Charlie	1066	+	176	5149551	22737
chr11	5126814	5326814	harbor1	chr11	5188523	5188721	DNA/hAT-Charlie	1127	+	99	5188622	61808
chr11	5126814	5326814	harbor1	chr11	5196202	5196479	DNA/hAT-Charlie	1500	+	138	5196340	69526
chr11	2705362	2905362	harbor1	chr11	2762552	2762880	DNA/hAT-Charlie	1978	+	164	2762716	57354
chr11	5132579	5332579	harbor1	chr11	5149375	5149727	DNA/hAT-Charlie	1066	+	176	5149551	16972
chr11	5132579	5332579	harbor1	chr11	5188523	5188721	DNA/hAT-Charlie	1127	+	99	5188622	56043
chr11	5132579	5332579	harbor1	chr11	5196202	5196479	DNA/hAT-Charlie	1500	+	138	5196340	63761
chr11	9360652	9560652	harbor1	chr11	9368197	9368355	DNA/hAT-Charlie	1101	+	79	9368276	7624
chr11	9360652	9560652	harbor1	chr11	9368678	9368839	DNA/hAT-Charlie	1101	+	80	9368758	8106
chr11	3984543	4184543	harbor1	chr11	3989605	3989859	DNA/hAT-Charlie	1375	+	127	3989732	5189
chr11	3984543	4184543	harbor1	chr11	4044830	4045026	DNA/hAT-Charlie	942	+	98	4044928	60385
chr11	3984543	4184543	harbor1	chr11	4053927	4054130	DNA/hAT-Charlie	1248	+	102	4054029	69486
chr11	3984543	4184543	harbor1	chr11	4054392	4054731	DNA/hAT-Charlie	2436	+	170	4054562	70019
chr11	3984543	4184543	harbor1	chr11	4079803	4079935	DNA/hAT-Charlie	641	+	66	4079869	95326
chr11	3984543	4184543	harbor1	chr11	4080267	4080308	DNA/hAT-Charlie	641	+	20	4080287	95744
chr11	5127120	5327120	harbor1	chr11	5149375	5149727	DNA/hAT-Charlie	1066	+	176	5149551	22431
chr11	5127120	5327120	harbor1	chr11	5188523	5188721	DNA/hAT-Charlie	1127	+	99	5188622	61502
chr11	5127120	5327120	harbor1	chr11	5196202	5196479	DNA/hAT-Charlie	1500	+	138	5196340	69220
chr11	76580334	76780334	harbor1	chr11	76595957	76596041	DNA/hAT-Charlie	495	+	42	76595999	15665
chr11	76580334	76780334	harbor1	chr11	76598717	76599027	DNA/hAT-Charlie	1368	+	155	76598872	18538
chr11	76580334	76780334	harbor1	chr11	76607306	76607536	DNA/hAT-Charlie	452	+	115	76607421	27087
chr11	76580334	76780334	harbor1	chr11	76612271	76612410	DNA/hAT-Charlie	472	+	70	76612341	32007
chr11	76580334	76780334	harbor1	chr11	76612460	76612643	DNA/hAT-Charlie	986	+	92	76612552	32218
chr11	76580334	76780334	harbor1	chr11	76612669	76612700	DNA/hAT-Charlie	986	+	16	76612685	32351
chr11	76580334	76780334	harbor1	chr11	76612988	76613265	DNA/hAT-Charlie	986	+	138	76613126	32792
chr11	76580334	76780334	harbor1	chr11	76613362	76613889	DNA/hAT-Charlie	986	+	264	76613626	33292
chr11	76580334	76780334	harbor1	chr11	76649274	76649745	DNA/hAT-Charlie	1913	+	236	76649510	69176
chr11	64538041	64738041	harbor1	chr11	64539863	64540158	DNA/hAT-Charlie	820	+	148	64540011	1970
chr11	64538041	64738041	harbor1	chr11	64624585	64624805	DNA/hAT-Charlie	711	+	110	64624695	86654
chr11	69539244	69739244	harbor1	chr11	69546157	69546302	DNA/hAT-Charlie	445	+	72	69546229	6985
chr11	69539244	69739244	harbor1	chr11	69569341	69569561	DNA/hAT-Charlie	605	+	110	69569451	30207
chr11	69539244	69739244	harbor1	chr11	69626241	69626457	DNA/hAT-Charlie	1490	+	108	69626349	87105
chr11	68332140	68532140	harbor1	chr11	68380174	68380476	DNA/hAT-Charlie	939	+	151	68380325	48185
chr11	68332140	68532140	harbor1	chr11	68398549	68398747	DNA/hAT-Charlie	777	+	99	68398648	66508
chr11	68332140	68532140	harbor1	chr11	68399017	68399045	DNA/hAT-Charlie	777	+	14	68399031	66891
chr11	68332140	68532140	harbor1	chr11	68399394	68399521	DNA/hAT-Charlie	777	+	64	68399458	67318
chr11	68332140	68532140	harbor1	chr11	68407498	68407558	DNA/hAT-Charlie	656	+	30	68407528	75388
chr11	68332140	68532140	harbor1	chr11	68407860	68408009	DNA/hAT-Charlie	656	+	74	68407934	75794
chr11	3116372	3316372	harbor1	chr11	3123265	3123577	DNA/hAT-Charlie	1158	+	156	3123421	7049
chr11	3116372	3316372	harbor1	chr11	3167804	3168016	DNA/hAT-Charlie	807	+	106	3167910	51538
chr11	3116372	3316372	harbor1	chr11	3173196	3173673	DNA/hAT-Charlie	1904	+	238	3173434	57062
chr11	3116372	3316372	harbor1	chr11	3184028	3184213	DNA/hAT-Charlie	499	+	92	3184120	67748
chr11	7933373	8133373	harbor1	chr11	8020038	8020203	DNA/hAT-Charlie	435	+	82	8020120	86747
chr11	7933373	8133373	harbor1	chr11	8032459	8032549	DNA/hAT-Charlie	405	+	45	8032504	99131
chr11	122556267	122756267	harbor1	chr11	122574714	122574879	DNA/hAT-Charlie	1336	+	82	122574796	18529
chr11	122556267	122756267	harbor1	chr11	122575476	122575638	DNA/hAT-Charlie	1336	+	81	122575557	19290
chr11	122556267	122756267	harbor1	chr11	122579667	122579810	DNA/hAT-Charlie	459	+	72	122579739	23472
chr11	122556267	122756267	harbor1	chr11	122603330	122603376	DNA/hAT-Charlie	587	+	23	122603353	47086
chr11	122556267	122756267	harbor1	chr11	122603692	122603787	DNA/hAT-Charlie	587	+	48	122603740	47473
chr11	122556267	122756267	harbor1	chr11	122605384	122605593	DNA/hAT-Charlie	898	+	104	122605488	49221
chr11	76580627	76780627	harbor1	chr11	76595957	76596041	DNA/hAT-Charlie	495	+	42	76595999	15372
chr11	76580627	76780627	harbor1	chr11	76598717	76599027	DNA/hAT-Charlie	1368	+	155	76598872	18245
chr11	76580627	76780627	harbor1	chr11	76607306	76607536	DNA/hAT-Charlie	452	+	115	76607421	26794
chr11	76580627	76780627	harbor1	chr11	76612271	76612410	DNA/hAT-Charlie	472	+	70	76612341	31714
chr11	76580627	76780627	harbor1	chr11	76612460	76612643	DNA/hAT-Charlie	986	+	92	76612552	31925
chr11	76580627	76780627	harbor1	chr11	76612669	76612700	DNA/hAT-Charlie	986	+	16	76612685	32058
chr11	76580627	76780627	harbor1	chr11	76612988	76613265	DNA/hAT-Charlie	986	+	138	76613126	32499
chr11	76580627	76780627	harbor1	chr11	76613362	76613889	DNA/hAT-Charlie	986	+	264	76613626	32999
chr11	76580627	76780627	harbor1	chr11	76649274	76649745	DNA/hAT-Charlie	1913	+	236	76649510	68883
chr11	5127220	5327220	harbor1	chr11	5149375	5149727	DNA/hAT-Charlie	1066	+	176	5149551	22331
chr11	5127220	5327220	harbor1	chr11	5188523	5188721	DNA/hAT-Charlie	1127	+	99	5188622	61402
chr11	5127220	5327220	harbor1	chr11	5196202	5196479	DNA/hAT-Charlie	1500	+	138	5196340	69120
chr11	5127275	5327275	harbor1	chr11	5149375	5149727	DNA/hAT-Charlie	1066	+	176	5149551	22276
chr11	5127275	5327275	harbor1	chr11	5188523	5188721	DNA/hAT-Charlie	1127	+	99	5188622	61347
chr11	5127275	5327275	harbor1	chr11	5196202	5196479	DNA/hAT-Charlie	1500	+	138	5196340	69065
chr11	76575076	76775076	harbor1	chr11	76595957	76596041	DNA/hAT-Charlie	495	+	42	76595999	20923
chr11	76575076	76775076	harbor1	chr11	76598717	76599027	DNA/hAT-Charlie	1368	+	155	76598872	23796
chr11	76575076	76775076	harbor1	chr11	76607306	76607536	DNA/hAT-Charlie	452	+	115	76607421	32345
chr11	76575076	76775076	harbor1	chr11	76612271	76612410	DNA/hAT-Charlie	472	+	70	76612341	37265
chr11	76575076	76775076	harbor1	chr11	76612460	76612643	DNA/hAT-Charlie	986	+	92	76612552	37476
chr11	76575076	76775076	harbor1	chr11	76612669	76612700	DNA/hAT-Charlie	986	+	16	76612685	37609
chr11	76575076	76775076	harbor1	chr11	76612988	76613265	DNA/hAT-Charlie	986	+	138	76613126	38050
chr11	76575076	76775076	harbor1	chr11	76613362	76613889	DNA/hAT-Charlie	986	+	264	76613626	38550
chr11	76575076	76775076	harbor1	chr11	76649274	76649745	DNA/hAT-Charlie	1913	+	236	76649510	74434
chr11	7520537	7720537	harbor1	chr11	7558944	7559103	DNA/hAT-Charlie	691	+	80	7559024	38487
chr11	7520537	7720537	harbor1	chr11	7567774	7567917	DNA/hAT-Charlie	574	+	72	7567846	47309
chr11	7520537	7720537	harbor1	chr11	7573112	7573238	DNA/hAT-Charlie	637	+	63	7573175	52638
chr11	7520537	7720537	harbor1	chr11	7573286	7573601	DNA/hAT-Charlie	1323	+	158	7573444	52907
chr11	32939956	33139956	harbor1	chr11	32949257	32949483	DNA/hAT-Charlie	659	+	113	32949370	9414
chr11	32939956	33139956	harbor1	chr11	32959118	32959326	DNA/hAT-Charlie	906	+	104	32959222	19266
chr11	32939956	33139956	harbor1	chr11	32987929	32988309	DNA/hAT-Charlie	1983	+	190	32988119	48163
chr11	5127188	5327188	harbor1	chr11	5149375	5149727	DNA/hAT-Charlie	1066	+	176	5149551	22363
chr11	5127188	5327188	harbor1	chr11	5188523	5188721	DNA/hAT-Charlie	1127	+	99	5188622	61434
chr11	5127188	5327188	harbor1	chr11	5196202	5196479	DNA/hAT-Charlie	1500	+	138	5196340	69152
chr11	76580968	76780968	harbor1	chr11	76595957	76596041	DNA/hAT-Charlie	495	+	42	76595999	15031
chr11	76580968	76780968	harbor1	chr11	76598717	76599027	DNA/hAT-Charlie	1368	+	155	76598872	17904
chr11	76580968	76780968	harbor1	chr11	76607306	76607536	DNA/hAT-Charlie	452	+	115	76607421	26453
chr11	76580968	76780968	harbor1	chr11	76612271	76612410	DNA/hAT-Charlie	472	+	70	76612341	31373
chr11	76580968	76780968	harbor1	chr11	76612460	76612643	DNA/hAT-Charlie	986	+	92	76612552	31584
chr11	76580968	76780968	harbor1	chr11	76612669	76612700	DNA/hAT-Charlie	986	+	16	76612685	31717
chr11	76580968	76780968	harbor1	chr11	76612988	76613265	DNA/hAT-Charlie	986	+	138	76613126	32158
chr11	76580968	76780968	harbor1	chr11	76613362	76613889	DNA/hAT-Charlie	986	+	264	76613626	32658
chr11	76580968	76780968	harbor1	chr11	76649274	76649745	DNA/hAT-Charlie	1913	+	236	76649510	68542
chr11	9413280	9613280	harbor1	chr11	9482725	9482974	DNA/hAT-Charlie	1386	+	124	9482849	69569
chr11	64001831	64201831	harbor1	chr11	64092866	64092966	DNA/hAT-Charlie	458	+	50	64092916	91085
chr11	16505283	16705283	harbor1	chr11	16512189	16512754	DNA/hAT-Charlie	2570	+	282	16512471	7188
chr11	16505283	16705283	harbor1	chr11	16561641	16561756	DNA/hAT-Charlie	566	+	58	16561699	56416
chr11	16505283	16705283	harbor1	chr11	16562027	16562143	DNA/hAT-Charlie	566	+	58	16562085	56802
chr11	16505283	16705283	harbor1	chr11	16565777	16565814	DNA/hAT-Charlie	486	+	18	16565795	60512
chr11	16505283	16705283	harbor1	chr11	16566118	16566205	DNA/hAT-Charlie	486	+	44	16566162	60879
chr11	16505283	16705283	harbor1	chr11	16580067	16580230	DNA/hAT-Charlie	441	+	82	16580149	74866
chr11	16505283	16705283	harbor1	chr11	16589428	16590559	DNA/hAT-Charlie	4549	+	566	16589994	84711
chr11	16505283	16705283	harbor1	chr11	16591091	16591311	DNA/hAT-Charlie	4549	+	110	16591201	85918
chr11	16505283	16705283	harbor1	chr11	16591377	16592197	DNA/hAT-Charlie	4549	+	410	16591787	86504
chr11	5127127	5327127	harbor1	chr11	5149375	5149727	DNA/hAT-Charlie	1066	+	176	5149551	22424
chr11	5127127	5327127	harbor1	chr11	5188523	5188721	DNA/hAT-Charlie	1127	+	99	5188622	61495
chr11	5127127	5327127	harbor1	chr11	5196202	5196479	DNA/hAT-Charlie	1500	+	138	5196340	69213
chr11	3160998	3360998	harbor1	chr11	3167804	3168016	DNA/hAT-Charlie	807	+	106	3167910	6912
chr11	3160998	3360998	harbor1	chr11	3173196	3173673	DNA/hAT-Charlie	1904	+	238	3173434	12436
chr11	3160998	3360998	harbor1	chr11	3184028	3184213	DNA/hAT-Charlie	499	+	92	3184120	23122
chr11	3160998	3360998	harbor1	chr11	3245408	3245921	DNA/hAT-Charlie	3751	+	256	3245664	84666
chr11	3160998	3360998	harbor1	chr11	3260007	3260126	DNA/hAT-Charlie	612	+	60	3260067	99069
chr11	2054535	2254535	harbor1	chr11	2088508	2088645	DNA/hAT-Charlie	498	+	68	2088576	34041
chr11	65286790	65486790	harbor1	chr11	65369013	65369189	DNA/hAT-Charlie	639	+	88	65369101	82311
chr11	64537966	64737966	harbor1	chr11	64539863	64540158	DNA/hAT-Charlie	820	+	148	64540011	2045
chr11	64537966	64737966	harbor1	chr11	64624585	64624805	DNA/hAT-Charlie	711	+	110	64624695	86729
chr11	66158664	66358664	harbor1	chr11	66195834	66196055	DNA/hAT-Charlie	990	+	110	66195944	37280
chr11	66158664	66358664	harbor1	chr11	66196240	66196614	DNA/hAT-Charlie	2623	+	187	66196427	37763
chr11	66158664	66358664	harbor1	chr11	66196898	66197139	DNA/hAT-Charlie	2623	+	120	66197018	38354
chr11	66158664	66358664	harbor1	chr11	66197363	66197511	DNA/hAT-Charlie	2027	+	74	66197437	38773
chr11	66158664	66358664	harbor1	chr11	66197822	66198022	DNA/hAT-Charlie	2027	+	100	66197922	39258
chr11	66158664	66358664	harbor1	chr11	66198793	66198971	DNA/hAT-Charlie	2027	+	89	66198882	40218
chr11	66158664	66358664	harbor1	chr11	66226356	66226576	DNA/hAT-Charlie	1285	+	110	66226466	67802
chr11	66158664	66358664	harbor1	chr11	66236032	66236230	DNA/hAT-Charlie	832	+	99	66236131	77467
chr11	67172339	67372339	harbor1	chr11	67218440	67218591	DNA/hAT-Charlie	1460	+	76	67218516	46177
chr11	67172339	67372339	harbor1	chr11	67218909	67218988	DNA/hAT-Charlie	1460	+	40	67218949	46610
chr11	67172339	67372339	harbor1	chr11	67251549	67251706	DNA/hAT-Charlie	654	+	78	67251627	79288
chr11	67172318	67372318	harbor1	chr11	67218440	67218591	DNA/hAT-Charlie	1460	+	76	67218516	46198
chr11	67172318	67372318	harbor1	chr11	67218909	67218988	DNA/hAT-Charlie	1460	+	40	67218949	46631
chr11	67172318	67372318	harbor1	chr11	67251549	67251706	DNA/hAT-Charlie	654	+	78	67251627	79309
chr11	64348428	64548428	harbor1	chr11	64375780	64375836	DNA/hAT-Charlie	781	+	28	64375808	27380
chr11	64348428	64548428	harbor1	chr11	64376125	64376373	DNA/hAT-Charlie	781	+	124	64376249	27821
chr11	64348428	64548428	harbor1	chr11	64400808	64401021	DNA/hAT-Charlie	928	+	106	64400914	52486
chr11	64348428	64548428	harbor1	chr11	64416511	64416670	DNA/hAT-Charlie	406	+	80	64416591	68163
chr11	64348428	64548428	harbor1	chr11	64428959	64429155	DNA/hAT-Charlie	778	+	98	64429057	80629
chr11	1472008	1672008	harbor1	chr11	1530092	1530355	DNA/hAT-Charlie	516	+	132	1530224	58216
chr11	1472008	1672008	harbor1	chr11	1530650	1530694	DNA/hAT-Charlie	516	+	22	1530672	58664
chr11	69112726	69312726	harbor1	chr11	69162244	69162494	DNA/hAT-Charlie	845	+	125	69162369	49643
chr11	69112726	69312726	harbor1	chr11	69162895	69162984	DNA/hAT-Charlie	743	+	44	69162939	50213
chr11	69539269	69739269	harbor1	chr11	69546157	69546302	DNA/hAT-Charlie	445	+	72	69546229	6960
chr11	69539269	69739269	harbor1	chr11	69569341	69569561	DNA/hAT-Charlie	605	+	110	69569451	30182
chr11	69539269	69739269	harbor1	chr11	69626241	69626457	DNA/hAT-Charlie	1490	+	108	69626349	87080
chr11	47452991	47652991	harbor1	chr11	47460199	47460293	DNA/hAT-Charlie	477	+	47	47460246	7255
chr11	47452991	47652991	harbor1	chr11	47460572	47460661	DNA/hAT-Charlie	477	+	44	47460616	7625
chr11	5127170	5327170	harbor1	chr11	5149375	5149727	DNA/hAT-Charlie	1066	+	176	5149551	22381
chr11	5127170	5327170	harbor1	chr11	5188523	5188721	DNA/hAT-Charlie	1127	+	99	5188622	61452
chr11	5127170	5327170	harbor1	chr11	5196202	5196479	DNA/hAT-Charlie	1500	+	138	5196340	69170
chr11	5127159	5327159	harbor1	chr11	5149375	5149727	DNA/hAT-Charlie	1066	+	176	5149551	22392
chr11	5127159	5327159	harbor1	chr11	5188523	5188721	DNA/hAT-Charlie	1127	+	99	5188622	61463
chr11	5127159	5327159	harbor1	chr11	5196202	5196479	DNA/hAT-Charlie	1500	+	138	5196340	69181
chr11	46818647	47018647	harbor1	chr11	46894225	46894518	DNA/hAT-Charlie	895	+	146	46894371	75724
chr11	46818647	47018647	harbor1	chr11	46905428	46905585	DNA/hAT-Charlie	924	+	78	46905506	86859
chr11	46818647	47018647	harbor1	chr11	46905870	46905944	DNA/hAT-Charlie	924	+	37	46905907	87260
chr11	46818647	47018647	harbor1	chr11	46907445	46907655	DNA/hAT-Charlie	1333	+	105	46907550	88903
chr11	19613809	19813809	harbor1	chr11	19640217	19640351	DNA/hAT-Charlie	453	+	67	19640284	26475
chr11	19613809	19813809	harbor1	chr11	19666786	19666956	DNA/hAT-Charlie	660	+	85	19666871	53062
chr11	19613809	19813809	harbor1	chr11	19677709	19677929	DNA/hAT-Charlie	1445	+	110	19677819	64010
chr11	19613809	19813809	harbor1	chr11	19710271	19710431	DNA/hAT-Charlie	808	+	80	19710351	96542
chr11	5125968	5325968	harbor1	chr11	5149375	5149727	DNA/hAT-Charlie	1066	+	176	5149551	23583
chr11	5125968	5325968	harbor1	chr11	5188523	5188721	DNA/hAT-Charlie	1127	+	99	5188622	62654
chr11	5125968	5325968	harbor1	chr11	5196202	5196479	DNA/hAT-Charlie	1500	+	138	5196340	70372
chr11	680085	880085	harbor1	chr11	733950	734172	DNA/hAT-Charlie	619	+	111	734061	53976
chr11	680085	880085	harbor1	chr11	743872	744047	DNA/hAT-Charlie	756	+	88	743960	63875
chr11	5127290	5327290	harbor1	chr11	5149375	5149727	DNA/hAT-Charlie	1066	+	176	5149551	22261
chr11	5127290	5327290	harbor1	chr11	5188523	5188721	DNA/hAT-Charlie	1127	+	99	5188622	61332
chr11	5127290	5327290	harbor1	chr11	5196202	5196479	DNA/hAT-Charlie	1500	+	138	5196340	69050
chr11	5126787	5326787	harbor1	chr11	5149375	5149727	DNA/hAT-Charlie	1066	+	176	5149551	22764
chr11	5126787	5326787	harbor1	chr11	5188523	5188721	DNA/hAT-Charlie	1127	+	99	5188622	61835
chr11	5126787	5326787	harbor1	chr11	5196202	5196479	DNA/hAT-Charlie	1500	+	138	5196340	69553
chr11	64538002	64738002	harbor1	chr11	64539863	64540158	DNA/hAT-Charlie	820	+	148	64540011	2009
chr11	64538002	64738002	harbor1	chr11	64624585	64624805	DNA/hAT-Charlie	711	+	110	64624695	86693
chr11	67368631	67568631	harbor1	chr11	67429748	67429812	DNA/hAT-Charlie	1208	+	32	67429780	61149
chr11	67368631	67568631	harbor1	chr11	67430733	67430895	DNA/hAT-Charlie	1208	+	81	67430814	62183
chr11	67368631	67568631	harbor1	chr11	67462219	67462356	DNA/hAT-Charlie	526	+	68	67462287	93656
chr11	67368631	67568631	harbor1	chr11	67462653	67462690	DNA/hAT-Charlie	526	+	18	67462671	94040
chr11	67368631	67568631	harbor1	chr11	67462992	67463074	DNA/hAT-Charlie	526	+	41	67463033	94402
chr11	64032759	64232759	harbor1	chr11	64092866	64092966	DNA/hAT-Charlie	458	+	50	64092916	60157
chr11	5134597	5334597	harbor1	chr11	5149375	5149727	DNA/hAT-Charlie	1066	+	176	5149551	14954
chr11	5134597	5334597	harbor1	chr11	5188523	5188721	DNA/hAT-Charlie	1127	+	99	5188622	54025
chr11	5134597	5334597	harbor1	chr11	5196202	5196479	DNA/hAT-Charlie	1500	+	138	5196340	61743
chr11	86572183	86772183	harbor1	chr11	86628404	86628579	DNA/hAT-Charlie	873	+	88	86628492	56309
chr11	86572183	86772183	harbor1	chr11	86629815	86630004	DNA/hAT-Charlie	575	+	94	86629909	57726
chr11	47085613	47285613	harbor1	chr11	47102426	47102639	DNA/hAT-Charlie	801	+	106	47102532	16919
chr12	49266683	49466683	harbor1	chr12	49276078	49276298	DNA/hAT-Charlie	634	+	110	49276188	9505
chr12	132647891	132847891	harbor1	chr12	132697316	132697393	DNA/hAT-Charlie	772	+	38	132697354	49463
chr12	132647891	132847891	harbor1	chr12	132697706	132697803	DNA/hAT-Charlie	772	+	48	132697754	49863
chr12	113085240	113285240	harbor1	chr12	113088223	113088411	DNA/hAT-Charlie	744	+	94	113088317	3077
chr12	113085240	113285240	harbor1	chr12	113166215	113166414	DNA/hAT-Charlie	649	+	100	113166315	81075
chr12	113085240	113285240	harbor1	chr12	113170334	113170359	DNA/hAT-Charlie	971	+	12	113170346	85106
chr12	113085240	113285240	harbor1	chr12	113170633	113170827	DNA/hAT-Charlie	971	+	97	113170730	85490
chr12	113085240	113285240	harbor1	chr12	113182309	113182474	DNA/hAT-Charlie	593	+	82	113182391	97151
chr12	49267301	49467301	harbor1	chr12	49276078	49276298	DNA/hAT-Charlie	634	+	110	49276188	8887
chr12	49267230	49467230	harbor1	chr12	49276078	49276298	DNA/hAT-Charlie	634	+	110	49276188	8958
chr12	6863305	7063305	harbor1	chr12	6865405	6865432	DNA/hAT-Charlie	778	+	14	6865419	2114
chr12	6863305	7063305	harbor1	chr12	6865563	6865741	DNA/hAT-Charlie	778	+	89	6865652	2347
chr12	49267240	49467240	harbor1	chr12	49276078	49276298	DNA/hAT-Charlie	634	+	110	49276188	8948
chr12	49267271	49467271	harbor1	chr12	49276078	49276298	DNA/hAT-Charlie	634	+	110	49276188	8917
chr12	1	131655	harbor1	chr12	29329	29578	DNA/hAT-Charlie	1297	+	124	29453	29452
chr12	1	131655	harbor1	chr12	39098	39482	DNA/hAT-Charlie	1575	+	192	39290	39289
chr12	1	131655	harbor1	chr12	98290	98469	DNA/hAT-Charlie	691	+	90	98380	98379
chr12	6863247	7063247	harbor1	chr12	6865405	6865432	DNA/hAT-Charlie	778	+	14	6865419	2172
chr12	6863247	7063247	harbor1	chr12	6865563	6865741	DNA/hAT-Charlie	778	+	89	6865652	2405
chr12	110180833	110380833	harbor1	chr12	110259539	110259941	DNA/hAT-Charlie	765	+	201	110259740	78907
chr12	110180833	110380833	harbor1	chr12	110274028	110274206	DNA/hAT-Charlie	865	+	89	110274117	93284
chr12	1	127337	harbor1	chr12	29329	29578	DNA/hAT-Charlie	1297	+	124	29453	29452
chr12	1	127337	harbor1	chr12	39098	39482	DNA/hAT-Charlie	1575	+	192	39290	39289
chr12	1	127337	harbor1	chr12	98290	98469	DNA/hAT-Charlie	691	+	90	98380	98379
chr12	123133097	123333097	harbor1	chr12	123167146	123167292	DNA/hAT-Charlie	759	+	73	123167219	34122
chr12	123133097	123333097	harbor1	chr12	123167713	123167766	DNA/hAT-Charlie	759	+	26	123167739	34642
chr12	123133097	123333097	harbor1	chr12	123224791	123225116	DNA/hAT-Charlie	1215	+	162	123224953	91856
chr12	6863232	7063232	harbor1	chr12	6865405	6865432	DNA/hAT-Charlie	778	+	14	6865419	2187
chr12	6863232	7063232	harbor1	chr12	6865563	6865741	DNA/hAT-Charlie	778	+	89	6865652	2420
chr12	10112880	10312880	harbor1	chr12	10161707	10161934	DNA/hAT-Charlie	891	+	114	10161821	48941
chr12	49267257	49467257	harbor1	chr12	49276078	49276298	DNA/hAT-Charlie	634	+	110	49276188	8931
chr12	49195916	49395916	harbor1	chr12	49276078	49276298	DNA/hAT-Charlie	634	+	110	49276188	80272
chr12	49267229	49467229	harbor1	chr12	49276078	49276298	DNA/hAT-Charlie	634	+	110	49276188	8959
chr12	12257335	12457335	harbor1	chr12	12283584	12283719	DNA/hAT-Charlie	785	+	68	12283652	26317
chr12	12257335	12457335	harbor1	chr12	12284331	12284361	DNA/hAT-Charlie	785	+	15	12284346	27011
chr12	12257335	12457335	harbor1	chr12	12332429	12332524	DNA/hAT-Charlie	702	+	48	12332477	75142
chr12	12257335	12457335	harbor1	chr12	12332821	12332923	DNA/hAT-Charlie	702	+	51	12332872	75537
chr12	49266901	49466901	harbor1	chr12	49276078	49276298	DNA/hAT-Charlie	634	+	110	49276188	9287
chr12	48880879	49080879	harbor1	chr12	48917876	48918167	DNA/hAT-Charlie	1022	+	146	48918022	37143
chr12	48880879	49080879	harbor1	chr12	48964819	48965033	DNA/hAT-Charlie	901	+	107	48964926	84047
chr12	49267266	49467266	harbor1	chr12	49276078	49276298	DNA/hAT-Charlie	634	+	110	49276188	8922
chr12	68421784	68621784	harbor1	chr12	68452707	68452841	DNA/hAT-Charlie	616	+	67	68452774	30990
chr12	68421784	68621784	harbor1	chr12	68475557	68475778	DNA/hAT-Charlie	1468	+	110	68475667	53883
chr12	68421784	68621784	harbor1	chr12	68502983	68503304	DNA/hAT-Charlie	1782	+	160	68503143	81359
chr12	6863318	7063318	harbor1	chr12	6865405	6865432	DNA/hAT-Charlie	778	+	14	6865419	2101
chr12	6863318	7063318	harbor1	chr12	6865563	6865741	DNA/hAT-Charlie	778	+	89	6865652	2334
chr12	130738919	130938919	harbor1	chr12	130741728	130741947	DNA/hAT-Charlie	1051	+	110	130741838	2919
chr12	130738919	130938919	harbor1	chr12	130813173	130813342	DNA/hAT-Charlie	603	+	84	130813257	74338
chr12	130738919	130938919	harbor1	chr12	130815449	130815976	DNA/hAT-Charlie	1217	+	264	130815713	76794
chr12	130061504	130261504	harbor1	chr12	130096217	130096515	DNA/hAT-Charlie	816	+	149	130096366	34862
chr12	6863293	7063293	harbor1	chr12	6865405	6865432	DNA/hAT-Charlie	778	+	14	6865419	2126
chr12	6863293	7063293	harbor1	chr12	6865563	6865741	DNA/hAT-Charlie	778	+	89	6865652	2359
chr12	69779300	69979300	harbor1	chr12	69792353	69792522	DNA/hAT-Charlie	733	+	84	69792437	13137
chr12	69779300	69979300	harbor1	chr12	69831188	69831397	DNA/hAT-Charlie	1128	+	104	69831292	51992
chr12	69779300	69979300	harbor1	chr12	69866816	69866998	DNA/hAT-Charlie	617	+	91	69866907	87607
chr12	69779300	69979300	harbor1	chr12	69875547	69875850	DNA/hAT-Charlie	1390	+	152	69875699	96399
chr12	92828990	93028990	harbor1	chr12	92838809	92839807	DNA/hAT-Charlie	4648	+	499	92839308	10318
chr12	92828990	93028990	harbor1	chr12	92927112	92927335	DNA/hAT-Charlie	1365	+	112	92927224	98234
chr12	53851036	54051036	harbor1	chr12	53882051	53882212	DNA/hAT-Charlie	702	+	80	53882131	31095
chr12	1496692	1696692	harbor1	chr12	1547969	1548174	DNA/hAT-Charlie	872	+	102	1548071	51379
chr12	6863233	7063233	harbor1	chr12	6865405	6865432	DNA/hAT-Charlie	778	+	14	6865419	2186
chr12	6863233	7063233	harbor1	chr12	6865563	6865741	DNA/hAT-Charlie	778	+	89	6865652	2419
chr12	47713189	47913189	harbor1	chr12	47779698	47779982	DNA/hAT-Charlie	1532	+	142	47779840	66651
chr12	49267212	49467212	harbor1	chr12	49276078	49276298	DNA/hAT-Charlie	634	+	110	49276188	8976
chr12	10623688	10823688	harbor1	chr12	10651997	10652142	DNA/hAT-Charlie	628	+	72	10652069	28381
chr12	10623688	10823688	harbor1	chr12	10672227	10672391	DNA/hAT-Charlie	753	+	82	10672309	48621
chr12	10623688	10823688	harbor1	chr12	10672538	10672728	DNA/hAT-Charlie	1151	+	95	10672633	48945
chr12	10623688	10823688	harbor1	chr12	10710582	10711015	DNA/hAT-Charlie	1307	+	216	10710798	87110
chr12	6248395	6448395	harbor1	chr12	6285373	6285620	DNA/hAT-Charlie	2117	+	124	6285497	37102
chr12	6248395	6448395	harbor1	chr12	6285923	6286642	DNA/hAT-Charlie	2117	+	360	6286283	37888
chr12	6248395	6448395	harbor1	chr12	6286937	6286991	DNA/hAT-Charlie	2117	+	27	6286964	38569
chr12	6248395	6448395	harbor1	chr12	6292631	6293120	DNA/hAT-Charlie	750	+	244	6292875	44480
chr12	6248395	6448395	harbor1	chr12	6299597	6299632	DNA/hAT-Charlie	1057	+	18	6299615	51220
chr12	6248395	6448395	harbor1	chr12	6299929	6300093	DNA/hAT-Charlie	1057	+	82	6300011	51616
chr12	6248395	6448395	harbor1	chr12	6300390	6300592	DNA/hAT-Charlie	1057	+	101	6300491	52096
chr12	96299297	96499297	harbor1	chr12	96322361	96322500	DNA/hAT-Charlie	614	+	70	96322431	23134
chr12	96299297	96499297	harbor1	chr12	96327947	96328466	DNA/hAT-Charlie	3628	+	260	96328207	28910
chr12	96299297	96499297	harbor1	chr12	96370536	96370852	DNA/hAT-Charlie	1077	+	158	96370694	71397
chr12	6863320	7063320	harbor1	chr12	6865405	6865432	DNA/hAT-Charlie	778	+	14	6865419	2099
chr12	6863320	7063320	harbor1	chr12	6865563	6865741	DNA/hAT-Charlie	778	+	89	6865652	2332
chr12	6863258	7063258	harbor1	chr12	6865405	6865432	DNA/hAT-Charlie	778	+	14	6865419	2161
chr12	6863258	7063258	harbor1	chr12	6865563	6865741	DNA/hAT-Charlie	778	+	89	6865652	2394
chr12	110178230	110378230	harbor1	chr12	110259539	110259941	DNA/hAT-Charlie	765	+	201	110259740	81510
chr12	110178230	110378230	harbor1	chr12	110274028	110274206	DNA/hAT-Charlie	865	+	89	110274117	95887
chr12	1	131656	harbor1	chr12	29329	29578	DNA/hAT-Charlie	1297	+	124	29453	29452
chr12	1	131656	harbor1	chr12	39098	39482	DNA/hAT-Charlie	1575	+	192	39290	39289
chr12	1	131656	harbor1	chr12	98290	98469	DNA/hAT-Charlie	691	+	90	98380	98379
chr12	64467190	64667190	harbor1	chr12	64493645	64493821	DNA/hAT-Charlie	756	+	88	64493733	26543
chr13	94612331	94812331	harbor1	chr13	94642820	94642993	DNA/hAT-Charlie	429	+	86	94642906	30575
chr13	36899468	37099468	harbor1	chr13	36905040	36905235	DNA/hAT-Charlie	945	+	98	36905138	5670
chr13	36899468	37099468	harbor1	chr13	36962752	36962951	DNA/hAT-Charlie	944	+	100	36962852	63384
chr13	36899468	37099468	harbor1	chr13	36963242	36963328	DNA/hAT-Charlie	944	+	43	36963285	63817
chr13	36899468	37099468	harbor1	chr13	36982422	36982612	DNA/hAT-Charlie	689	+	95	36982517	83049
chr13	36899468	37099468	harbor1	chr13	36983429	36983464	DNA/hAT-Charlie	435	+	18	36983447	83979
chr13	36899468	37099468	harbor1	chr13	36983584	36983684	DNA/hAT-Charlie	435	+	50	36983634	84166
chr13	36893557	37093557	harbor1	chr13	36905040	36905235	DNA/hAT-Charlie	945	+	98	36905138	11581
chr13	36893557	37093557	harbor1	chr13	36962752	36962951	DNA/hAT-Charlie	944	+	100	36962852	69295
chr13	36893557	37093557	harbor1	chr13	36963242	36963328	DNA/hAT-Charlie	944	+	43	36963285	69728
chr13	36893557	37093557	harbor1	chr13	36982422	36982612	DNA/hAT-Charlie	689	+	95	36982517	88960
chr13	36893557	37093557	harbor1	chr13	36983429	36983464	DNA/hAT-Charlie	435	+	18	36983447	89890
chr13	36893557	37093557	harbor1	chr13	36983584	36983684	DNA/hAT-Charlie	435	+	50	36983634	90077
chr13	100574884	100774884	harbor1	chr13	100585232	100585464	DNA/hAT-Charlie	838	+	116	100585348	10464
chr13	100574884	100774884	harbor1	chr13	100592263	100592519	DNA/hAT-Charlie	897	+	128	100592391	17507
chr13	100574884	100774884	harbor1	chr13	100609083	100609296	DNA/hAT-Charlie	578	+	106	100609189	34305
chr13	100574884	100774884	harbor1	chr13	100640151	100640358	DNA/hAT-Charlie	1074	+	104	100640255	65371
chr13	100574884	100774884	harbor1	chr13	100646047	100646180	DNA/hAT-Charlie	485	+	66	100646113	71229
chr13	100574884	100774884	harbor1	chr13	100648218	100648511	DNA/hAT-Charlie	1125	+	146	100648364	73480
chr13	44477883	44677883	harbor1	chr13	44479230	44479440	DNA/hAT-Charlie	1381	+	105	44479335	1452
chr13	44477883	44677883	harbor1	chr13	44488211	44488523	DNA/hAT-Charlie	1189	+	156	44488367	10484
chr13	44477883	44677883	harbor1	chr13	44553801	44553965	DNA/hAT-Charlie	518	+	82	44553883	76000
chr13	20315145	20515145	harbor1	chr13	20321259	20321497	DNA/hAT-Charlie	501	+	119	20321378	6233
chr13	20315145	20515145	harbor1	chr13	20340060	20340203	DNA/hAT-Charlie	443	+	72	20340132	24987
chr13	20315145	20515145	harbor1	chr13	20389781	20389868	DNA/hAT-Charlie	425	+	44	20389825	74680
chr13	20315145	20515145	harbor1	chr13	20395971	20396276	DNA/hAT-Charlie	1035	+	152	20396123	80978
chr13	27728634	27928634	harbor1	chr13	27749754	27749913	DNA/hAT-Charlie	826	+	80	27749834	21200
chr13	27728634	27928634	harbor1	chr13	27804685	27805020	DNA/hAT-Charlie	1470	+	168	27804853	76219
chr13	27728634	27928634	harbor1	chr13	27805326	27805430	DNA/hAT-Charlie	1470	+	52	27805378	76744
chr13	27728634	27928634	harbor1	chr13	27803436	27804422	DNA/hAT-Charlie	4174	+	493	27803929	75295
chr13	113718182	113918182	harbor1	chr13	113730961	113731114	DNA/hAT-Charlie	470	+	76	113731037	12855
chr13	113718182	113918182	harbor1	chr13	113750211	113750447	DNA/hAT-Charlie	712	+	118	113750329	32147
chr13	113718182	113918182	harbor1	chr13	113750445	113750540	DNA/hAT-Charlie	437	+	48	113750493	32311
chr13	113718182	113918182	harbor1	chr13	113766702	113766970	DNA/hAT-Charlie	436	+	134	113766836	48654
chr13	20314698	20514698	harbor1	chr13	20321259	20321497	DNA/hAT-Charlie	501	+	119	20321378	6680
chr13	20314698	20514698	harbor1	chr13	20340060	20340203	DNA/hAT-Charlie	443	+	72	20340132	25434
chr13	20314698	20514698	harbor1	chr13	20389781	20389868	DNA/hAT-Charlie	425	+	44	20389825	75127
chr13	20314698	20514698	harbor1	chr13	20395971	20396276	DNA/hAT-Charlie	1035	+	152	20396123	81425
chr13	113630011	113830011	harbor1	chr13	113664669	113664771	DNA/hAT-Charlie	433	+	51	113664720	34709
chr13	113713649	113913649	harbor1	chr13	113730961	113731114	DNA/hAT-Charlie	470	+	76	113731037	17388
chr13	113713649	113913649	harbor1	chr13	113750211	113750447	DNA/hAT-Charlie	712	+	118	113750329	36680
chr13	113713649	113913649	harbor1	chr13	113750445	113750540	DNA/hAT-Charlie	437	+	48	113750493	36844
chr13	113713649	113913649	harbor1	chr13	113766702	113766970	DNA/hAT-Charlie	436	+	134	113766836	53187
chr13	50025212	50225212	harbor1	chr13	50101592	50101782	DNA/hAT-Charlie	821	+	95	50101687	76475
chr13	20315192	20515192	harbor1	chr13	20321259	20321497	DNA/hAT-Charlie	501	+	119	20321378	6186
chr13	20315192	20515192	harbor1	chr13	20340060	20340203	DNA/hAT-Charlie	443	+	72	20340132	24940
chr13	20315192	20515192	harbor1	chr13	20389781	20389868	DNA/hAT-Charlie	425	+	44	20389825	74633
chr13	20315192	20515192	harbor1	chr13	20395971	20396276	DNA/hAT-Charlie	1035	+	152	20396123	80931
chr13	110254287	110454287	harbor1	chr13	110276828	110276934	DNA/hAT-Charlie	472	+	53	110276881	22594
chr13	100574881	100774881	harbor1	chr13	100585232	100585464	DNA/hAT-Charlie	838	+	116	100585348	10467
chr13	100574881	100774881	harbor1	chr13	100592263	100592519	DNA/hAT-Charlie	897	+	128	100592391	17510
chr13	100574881	100774881	harbor1	chr13	100609083	100609296	DNA/hAT-Charlie	578	+	106	100609189	34308
chr13	100574881	100774881	harbor1	chr13	100640151	100640358	DNA/hAT-Charlie	1074	+	104	100640255	65374
chr13	100574881	100774881	harbor1	chr13	100646047	100646180	DNA/hAT-Charlie	485	+	66	100646113	71232
chr13	100574881	100774881	harbor1	chr13	100648218	100648511	DNA/hAT-Charlie	1125	+	146	100648364	73483
chr13	100574914	100774914	harbor1	chr13	100585232	100585464	DNA/hAT-Charlie	838	+	116	100585348	10434
chr13	100574914	100774914	harbor1	chr13	100592263	100592519	DNA/hAT-Charlie	897	+	128	100592391	17477
chr13	100574914	100774914	harbor1	chr13	100609083	100609296	DNA/hAT-Charlie	578	+	106	100609189	34275
chr13	100574914	100774914	harbor1	chr13	100640151	100640358	DNA/hAT-Charlie	1074	+	104	100640255	65341
chr13	100574914	100774914	harbor1	chr13	100646047	100646180	DNA/hAT-Charlie	485	+	66	100646113	71199
chr13	100574914	100774914	harbor1	chr13	100648218	100648511	DNA/hAT-Charlie	1125	+	146	100648364	73450
chr13	113726184	113926184	harbor1	chr13	113730961	113731114	DNA/hAT-Charlie	470	+	76	113731037	4853
chr13	113726184	113926184	harbor1	chr13	113750211	113750447	DNA/hAT-Charlie	712	+	118	113750329	24145
chr13	113726184	113926184	harbor1	chr13	113750445	113750540	DNA/hAT-Charlie	437	+	48	113750493	24309
chr13	113726184	113926184	harbor1	chr13	113766702	113766970	DNA/hAT-Charlie	436	+	134	113766836	40652
chr13	113726144	113926144	harbor1	chr13	113730961	113731114	DNA/hAT-Charlie	470	+	76	113731037	4893
chr13	113726144	113926144	harbor1	chr13	113750211	113750447	DNA/hAT-Charlie	712	+	118	113750329	24185
chr13	113726144	113926144	harbor1	chr13	113750445	113750540	DNA/hAT-Charlie	437	+	48	113750493	24349
chr13	113726144	113926144	harbor1	chr13	113766702	113766970	DNA/hAT-Charlie	436	+	134	113766836	40692
chr13	20315123	20515123	harbor1	chr13	20321259	20321497	DNA/hAT-Charlie	501	+	119	20321378	6255
chr13	20315123	20515123	harbor1	chr13	20340060	20340203	DNA/hAT-Charlie	443	+	72	20340132	25009
chr13	20315123	20515123	harbor1	chr13	20389781	20389868	DNA/hAT-Charlie	425	+	44	20389825	74702
chr13	20315123	20515123	harbor1	chr13	20395971	20396276	DNA/hAT-Charlie	1035	+	152	20396123	81000
chr13	94612324	94812324	harbor1	chr13	94642820	94642993	DNA/hAT-Charlie	429	+	86	94642906	30582
chr13	98425553	98625553	harbor1	chr13	98443162	98443246	DNA/hAT-Charlie	475	+	42	98443204	17651
chr13	98425553	98625553	harbor1	chr13	98454992	98455242	DNA/hAT-Charlie	916	+	125	98455117	29564
chr13	98425553	98625553	harbor1	chr13	98455540	98455594	DNA/hAT-Charlie	916	+	27	98455567	30014
chr13	51810106	52010106	harbor1	chr13	51843910	51844105	DNA/hAT-Charlie	755	+	98	51844008	33902
chr13	51810106	52010106	harbor1	chr13	51847205	51847497	DNA/hAT-Charlie	1787	+	146	51847351	37245
chr13	51810106	52010106	harbor1	chr13	51876285	51876623	DNA/hAT-Charlie	790	+	169	51876454	66348
chr13	27707987	27907987	harbor1	chr13	27749754	27749913	DNA/hAT-Charlie	826	+	80	27749834	41847
chr13	27707987	27907987	harbor1	chr13	27804685	27805020	DNA/hAT-Charlie	1470	+	168	27804853	96866
chr13	27707987	27907987	harbor1	chr13	27805326	27805430	DNA/hAT-Charlie	1470	+	52	27805378	97391
chr13	27707987	27907987	harbor1	chr13	27803436	27804422	DNA/hAT-Charlie	4174	+	493	27803929	95942
chr13	28720365	28920365	harbor1	chr13	28724461	28724882	DNA/hAT-Charlie	763	+	210	28724671	4306
chr13	28720365	28920365	harbor1	chr13	28759928	28760315	DNA/hAT-Charlie	1611	+	194	28760122	39757
chr13	113726163	113926163	harbor1	chr13	113730961	113731114	DNA/hAT-Charlie	470	+	76	113731037	4874
chr13	113726163	113926163	harbor1	chr13	113750211	113750447	DNA/hAT-Charlie	712	+	118	113750329	24166
chr13	113726163	113926163	harbor1	chr13	113750445	113750540	DNA/hAT-Charlie	437	+	48	113750493	24330
chr13	113726163	113926163	harbor1	chr13	113766702	113766970	DNA/hAT-Charlie	436	+	134	113766836	40673
chr13	113725831	113925831	harbor1	chr13	113730961	113731114	DNA/hAT-Charlie	470	+	76	113731037	5206
chr13	113725831	113925831	harbor1	chr13	113750211	113750447	DNA/hAT-Charlie	712	+	118	113750329	24498
chr13	113725831	113925831	harbor1	chr13	113750445	113750540	DNA/hAT-Charlie	437	+	48	113750493	24662
chr13	113725831	113925831	harbor1	chr13	113766702	113766970	DNA/hAT-Charlie	436	+	134	113766836	41005
chr13	110254344	110454344	harbor1	chr13	110276828	110276934	DNA/hAT-Charlie	472	+	53	110276881	22537
chr13	27925914	28125914	harbor1	chr13	27938924	27939162	DNA/hAT-Charlie	650	+	119	27939043	13129
chr13	27925914	28125914	harbor1	chr13	27940168	27940388	DNA/hAT-Charlie	1529	+	110	27940278	14364
chr13	99473104	99673104	harbor1	chr13	99513665	99513958	DNA/hAT-Charlie	1304	+	146	99513811	40707
chr13	99473104	99673104	harbor1	chr13	99545072	99545292	DNA/hAT-Charlie	433	+	110	99545182	72078
chr13	19461422	19661422	harbor1	chr13	19465636	19465893	DNA/hAT-Charlie	729	+	128	19465764	4342
chr13	21574752	21774752	harbor1	chr13	21598879	21599190	DNA/hAT-Charlie	1845	+	156	21599035	24283
chr13	21574752	21774752	harbor1	chr13	21629132	21629314	DNA/hAT-Charlie	905	+	91	21629223	54471
chr13	21574752	21774752	harbor1	chr13	21637323	21637493	DNA/hAT-Charlie	679	+	85	21637408	62656
chr13	113726255	113926255	harbor1	chr13	113730961	113731114	DNA/hAT-Charlie	470	+	76	113731037	4782
chr13	113726255	113926255	harbor1	chr13	113750211	113750447	DNA/hAT-Charlie	712	+	118	113750329	24074
chr13	113726255	113926255	harbor1	chr13	113750445	113750540	DNA/hAT-Charlie	437	+	48	113750493	24238
chr13	113726255	113926255	harbor1	chr13	113766702	113766970	DNA/hAT-Charlie	436	+	134	113766836	40581
chr13	20315141	20515141	harbor1	chr13	20321259	20321497	DNA/hAT-Charlie	501	+	119	20321378	6237
chr13	20315141	20515141	harbor1	chr13	20340060	20340203	DNA/hAT-Charlie	443	+	72	20340132	24991
chr13	20315141	20515141	harbor1	chr13	20389781	20389868	DNA/hAT-Charlie	425	+	44	20389825	74684
chr13	20315141	20515141	harbor1	chr13	20395971	20396276	DNA/hAT-Charlie	1035	+	152	20396123	80982
chr13	113630075	113830075	harbor1	chr13	113664669	113664771	DNA/hAT-Charlie	433	+	51	113664720	34645
chr13	20315163	20515163	harbor1	chr13	20321259	20321497	DNA/hAT-Charlie	501	+	119	20321378	6215
chr13	20315163	20515163	harbor1	chr13	20340060	20340203	DNA/hAT-Charlie	443	+	72	20340132	24969
chr13	20315163	20515163	harbor1	chr13	20389781	20389868	DNA/hAT-Charlie	425	+	44	20389825	74662
chr13	20315163	20515163	harbor1	chr13	20395971	20396276	DNA/hAT-Charlie	1035	+	152	20396123	80960
chr13	100574912	100774912	harbor1	chr13	100585232	100585464	DNA/hAT-Charlie	838	+	116	100585348	10436
chr13	100574912	100774912	harbor1	chr13	100592263	100592519	DNA/hAT-Charlie	897	+	128	100592391	17479
chr13	100574912	100774912	harbor1	chr13	100609083	100609296	DNA/hAT-Charlie	578	+	106	100609189	34277
chr13	100574912	100774912	harbor1	chr13	100640151	100640358	DNA/hAT-Charlie	1074	+	104	100640255	65343
chr13	100574912	100774912	harbor1	chr13	100646047	100646180	DNA/hAT-Charlie	485	+	66	100646113	71201
chr13	100574912	100774912	harbor1	chr13	100648218	100648511	DNA/hAT-Charlie	1125	+	146	100648364	73452
chr13	72959194	73159194	harbor1	chr13	72967859	72967903	DNA/hAT-Charlie	468	+	22	72967881	8687
chr13	72959194	73159194	harbor1	chr13	72968198	72968261	DNA/hAT-Charlie	468	+	32	72968230	9036
chr13	72959194	73159194	harbor1	chr13	72998487	72998610	DNA/hAT-Charlie	458	+	62	72998549	39355
chr13	110254257	110454257	harbor1	chr13	110276828	110276934	DNA/hAT-Charlie	472	+	53	110276881	22624
chr13	113726358	113926358	harbor1	chr13	113730961	113731114	DNA/hAT-Charlie	470	+	76	113731037	4679
chr13	113726358	113926358	harbor1	chr13	113750211	113750447	DNA/hAT-Charlie	712	+	118	113750329	23971
chr13	113726358	113926358	harbor1	chr13	113750445	113750540	DNA/hAT-Charlie	437	+	48	113750493	24135
chr13	113726358	113926358	harbor1	chr13	113766702	113766970	DNA/hAT-Charlie	436	+	134	113766836	40478
chr13	113726286	113926286	harbor1	chr13	113730961	113731114	DNA/hAT-Charlie	470	+	76	113731037	4751
chr13	113726286	113926286	harbor1	chr13	113750211	113750447	DNA/hAT-Charlie	712	+	118	113750329	24043
chr13	113726286	113926286	harbor1	chr13	113750445	113750540	DNA/hAT-Charlie	437	+	48	113750493	24207
chr13	113726286	113926286	harbor1	chr13	113766702	113766970	DNA/hAT-Charlie	436	+	134	113766836	40550
chr13	19984869	20184869	harbor1	chr13	20078668	20078900	DNA/hAT-Charlie	478	+	116	20078784	93915
chr13	50026224	50226224	harbor1	chr13	50101592	50101782	DNA/hAT-Charlie	821	+	95	50101687	75463
chr13	75438285	75638285	harbor1	chr13	75447620	75448119	DNA/hAT-Charlie	3229	+	250	75447870	9585
chr13	75438285	75638285	harbor1	chr13	75470362	75470541	DNA/hAT-Charlie	713	+	90	75470452	32167
chr13	75438285	75638285	harbor1	chr13	75478875	75479153	DNA/hAT-Charlie	695	+	139	75479014	40729
chr13	75438285	75638285	harbor1	chr13	75501469	75501655	DNA/hAT-Charlie	685	+	93	75501562	63277
chr13	36899488	37099488	harbor1	chr13	36905040	36905235	DNA/hAT-Charlie	945	+	98	36905138	5650
chr13	36899488	37099488	harbor1	chr13	36962752	36962951	DNA/hAT-Charlie	944	+	100	36962852	63364
chr13	36899488	37099488	harbor1	chr13	36963242	36963328	DNA/hAT-Charlie	944	+	43	36963285	63797
chr13	36899488	37099488	harbor1	chr13	36982422	36982612	DNA/hAT-Charlie	689	+	95	36982517	83029
chr13	36899488	37099488	harbor1	chr13	36983429	36983464	DNA/hAT-Charlie	435	+	18	36983447	83959
chr13	36899488	37099488	harbor1	chr13	36983584	36983684	DNA/hAT-Charlie	435	+	50	36983634	84146
chr13	20315167	20515167	harbor1	chr13	20321259	20321497	DNA/hAT-Charlie	501	+	119	20321378	6211
chr13	20315167	20515167	harbor1	chr13	20340060	20340203	DNA/hAT-Charlie	443	+	72	20340132	24965
chr13	20315167	20515167	harbor1	chr13	20389781	20389868	DNA/hAT-Charlie	425	+	44	20389825	74658
chr13	20315167	20515167	harbor1	chr13	20395971	20396276	DNA/hAT-Charlie	1035	+	152	20396123	80956
chr14	99103274	99303274	harbor1	chr14	99158029	99158192	DNA/hAT-Charlie	750	+	82	99158111	54837
chr14	99103274	99303274	harbor1	chr14	99191123	99191347	DNA/hAT-Charlie	980	+	112	99191235	87961
chr14	67140824	67340824	harbor1	chr14	67148461	67148558	DNA/hAT-Charlie	1727	+	48	67148509	7685
chr14	67140824	67340824	harbor1	chr14	67148866	67149062	DNA/hAT-Charlie	1727	+	98	67148964	8140
chr14	67140824	67340824	harbor1	chr14	67149362	67149562	DNA/hAT-Charlie	1727	+	100	67149462	8638
chr14	67140824	67340824	harbor1	chr14	67212967	67213092	DNA/hAT-Charlie	629	+	62	67213029	72205
chr14	67140824	67340824	harbor1	chr14	67229385	67229586	DNA/hAT-Charlie	1007	+	100	67229485	88661
chr14	67140824	67340824	harbor1	chr14	67229585	67229856	DNA/hAT-Charlie	921	+	136	67229721	88897
chr14	67140824	67340824	harbor1	chr14	67239282	67239487	DNA/hAT-Charlie	1061	+	102	67239384	98560
chr14	99486023	99686023	harbor1	chr14	99505313	99505596	DNA/hAT-Charlie	875	+	142	99505455	19432
chr14	99486023	99686023	harbor1	chr14	99505868	99505933	DNA/hAT-Charlie	875	+	32	99505900	19877
chr14	24016236	24216236	harbor1	chr14	24085768	24085949	DNA/hAT-Charlie	962	+	90	24085858	69622
chr14	88724597	88924597	harbor1	chr14	88729352	88729558	DNA/hAT-Charlie	6188	+	103	88729455	4858
chr14	88724597	88924597	harbor1	chr14	88729890	88731035	DNA/hAT-Charlie	6188	+	572	88730462	5865
chr14	88724597	88924597	harbor1	chr14	88732659	88732822	DNA/hAT-Charlie	1680	+	82	88732741	8144
chr14	88724597	88924597	harbor1	chr14	88732917	88733208	DNA/hAT-Charlie	1680	+	146	88733063	8466
chr14	88724597	88924597	harbor1	chr14	88734385	88734600	DNA/hAT-Charlie	841	+	108	88734493	9896
chr14	88724597	88924597	harbor1	chr14	88742214	88742401	DNA/hAT-Charlie	600	+	94	88742308	17711
chr14	88724597	88924597	harbor1	chr14	88749929	88750125	DNA/hAT-Charlie	1023	+	98	88750027	25430
chr14	88724597	88924597	harbor1	chr14	88768979	88769136	DNA/hAT-Charlie	538	+	78	88769057	44460
chr14	88724597	88924597	harbor1	chr14	88769519	88769574	DNA/hAT-Charlie	538	+	28	88769547	44950
chr14	88724597	88924597	harbor1	chr14	88802687	88803209	DNA/hAT-Charlie	3585	+	261	88802948	78351
chr14	103423043	103623043	harbor1	chr14	103425995	103426203	DNA/hAT-Charlie	1090	+	104	103426099	3056
chr14	103423043	103623043	harbor1	chr14	103426203	103426398	DNA/hAT-Charlie	544	+	98	103426301	3258
chr14	103423043	103623043	harbor1	chr14	103469022	103469133	DNA/hAT-Charlie	502	+	56	103469078	46035
chr14	103423043	103623043	harbor1	chr14	103469739	103469780	DNA/hAT-Charlie	502	+	20	103469759	46716
chr14	103423043	103623043	harbor1	chr14	103470077	103470138	DNA/hAT-Charlie	502	+	30	103470107	47064
chr14	103423043	103623043	harbor1	chr14	103517175	103517353	DNA/hAT-Charlie	660	+	89	103517264	94221
chr14	64194243	64394243	harbor1	chr14	64222286	64222434	DNA/hAT-Charlie	778	+	74	64222360	28117
chr14	64194243	64394243	harbor1	chr14	64222741	64222772	DNA/hAT-Charlie	778	+	16	64222757	28514
chr14	64194243	64394243	harbor1	chr14	64247101	64247296	DNA/hAT-Charlie	692	+	98	64247199	52956
chr14	66383081	66583081	harbor1	chr14	66404588	66404774	DNA/hAT-Charlie	880	+	93	66404681	21600
chr14	66383081	66583081	harbor1	chr14	66464017	66464197	DNA/hAT-Charlie	628	+	90	66464107	81026
chr14	66383081	66583081	harbor1	chr14	66453391	66453607	DNA/hAT-Charlie	975	+	108	66453499	70418
chr14	67140760	67340760	harbor1	chr14	67148461	67148558	DNA/hAT-Charlie	1727	+	48	67148509	7749
chr14	67140760	67340760	harbor1	chr14	67148866	67149062	DNA/hAT-Charlie	1727	+	98	67148964	8204
chr14	67140760	67340760	harbor1	chr14	67149362	67149562	DNA/hAT-Charlie	1727	+	100	67149462	8702
chr14	67140760	67340760	harbor1	chr14	67212967	67213092	DNA/hAT-Charlie	629	+	62	67213029	72269
chr14	67140760	67340760	harbor1	chr14	67229385	67229586	DNA/hAT-Charlie	1007	+	100	67229485	88725
chr14	67140760	67340760	harbor1	chr14	67229585	67229856	DNA/hAT-Charlie	921	+	136	67229721	88961
chr14	67140760	67340760	harbor1	chr14	67239282	67239487	DNA/hAT-Charlie	1061	+	102	67239384	98624
chr14	67140882	67340882	harbor1	chr14	67148461	67148558	DNA/hAT-Charlie	1727	+	48	67148509	7627
chr14	67140882	67340882	harbor1	chr14	67148866	67149062	DNA/hAT-Charlie	1727	+	98	67148964	8082
chr14	67140882	67340882	harbor1	chr14	67149362	67149562	DNA/hAT-Charlie	1727	+	100	67149462	8580
chr14	67140882	67340882	harbor1	chr14	67212967	67213092	DNA/hAT-Charlie	629	+	62	67213029	72147
chr14	67140882	67340882	harbor1	chr14	67229385	67229586	DNA/hAT-Charlie	1007	+	100	67229485	88603
chr14	67140882	67340882	harbor1	chr14	67229585	67229856	DNA/hAT-Charlie	921	+	136	67229721	88839
chr14	67140882	67340882	harbor1	chr14	67239282	67239487	DNA/hAT-Charlie	1061	+	102	67239384	98502
chr14	100183362	100383362	harbor1	chr14	100213305	100213530	DNA/hAT-Charlie	1032	+	112	100213417	30055
chr14	100183362	100383362	harbor1	chr14	100213832	100213924	DNA/hAT-Charlie	1032	+	46	100213878	30516
chr14	75327984	75527984	harbor1	chr14	75375802	75375958	DNA/hAT-Charlie	860	+	78	75375880	47896
chr14	75327984	75527984	harbor1	chr14	75406334	75406428	DNA/hAT-Charlie	566	+	47	75406381	78397
chr14	100185484	100385484	harbor1	chr14	100213305	100213530	DNA/hAT-Charlie	1032	+	112	100213417	27933
chr14	100185484	100385484	harbor1	chr14	100213832	100213924	DNA/hAT-Charlie	1032	+	46	100213878	28394
chr14	63247906	63447906	harbor1	chr14	63255422	63255545	DNA/hAT-Charlie	479	+	62	63255484	7578
chr14	63247906	63447906	harbor1	chr14	63271958	63272111	DNA/hAT-Charlie	764	+	76	63272034	24128
chr14	63247906	63447906	harbor1	chr14	63286510	63286750	DNA/hAT-Charlie	485	+	120	63286630	38724
chr14	63247906	63447906	harbor1	chr14	63289121	63289425	DNA/hAT-Charlie	733	+	152	63289273	41367
chr14	63247906	63447906	harbor1	chr14	63297515	63297680	DNA/hAT-Charlie	920	+	82	63297597	49691
chr14	63247906	63447906	harbor1	chr14	63275004	63275123	DNA/hAT-Charlie	613	+	60	63275064	27158
chr14	90282762	90482762	harbor1	chr14	90293134	90293253	DNA/hAT-Charlie	846	+	60	90293194	10432
chr14	90282762	90482762	harbor1	chr14	90293550	90293618	DNA/hAT-Charlie	846	+	34	90293584	10822
chr14	90282762	90482762	harbor1	chr14	90296794	90296856	DNA/hAT-Charlie	1317	+	31	90296825	14063
chr14	90282762	90482762	harbor1	chr14	90297167	90297475	DNA/hAT-Charlie	1317	+	154	90297321	14559
chr14	90282762	90482762	harbor1	chr14	90343837	90344030	DNA/hAT-Charlie	1210	+	96	90343933	61171
chr14	90282762	90482762	harbor1	chr14	90380656	90380796	DNA/hAT-Charlie	756	+	70	90380726	97964
chr14	90283216	90483216	harbor1	chr14	90293134	90293253	DNA/hAT-Charlie	846	+	60	90293194	9978
chr14	90283216	90483216	harbor1	chr14	90293550	90293618	DNA/hAT-Charlie	846	+	34	90293584	10368
chr14	90283216	90483216	harbor1	chr14	90296794	90296856	DNA/hAT-Charlie	1317	+	31	90296825	13609
chr14	90283216	90483216	harbor1	chr14	90297167	90297475	DNA/hAT-Charlie	1317	+	154	90297321	14105
chr14	90283216	90483216	harbor1	chr14	90343837	90344030	DNA/hAT-Charlie	1210	+	96	90343933	60717
chr14	90283216	90483216	harbor1	chr14	90380656	90380796	DNA/hAT-Charlie	756	+	70	90380726	97510
chr14	99493319	99693319	harbor1	chr14	99505313	99505596	DNA/hAT-Charlie	875	+	142	99505455	12136
chr14	99493319	99693319	harbor1	chr14	99505868	99505933	DNA/hAT-Charlie	875	+	32	99505900	12581
chr14	57989413	58189413	harbor1	chr14	57989807	57990012	DNA/hAT-Charlie	1093	+	102	57989909	496
chr14	57989413	58189413	harbor1	chr14	58055588	58055756	DNA/hAT-Charlie	770	+	84	58055672	66259
chr14	57989413	58189413	harbor1	chr14	58081196	58081345	DNA/hAT-Charlie	576	+	74	58081270	91857
chr14	67488947	67688947	harbor1	chr14	67497533	67497951	DNA/hAT-Charlie	1639	+	209	67497742	8795
chr14	67488947	67688947	harbor1	chr14	67543463	67543645	DNA/hAT-Charlie	454	+	91	67543554	54607
chr14	67488947	67688947	harbor1	chr14	67585267	67585436	DNA/hAT-Charlie	465	+	84	67585351	96404
chr14	54388477	54588477	harbor1	chr14	54429215	54429429	DNA/hAT-Charlie	1127	+	107	54429322	40845
chr14	54388477	54588477	harbor1	chr14	54442520	54442704	DNA/hAT-Charlie	931	+	92	54442612	54135
chr14	73659272	73859272	harbor1	chr14	73670252	73670401	DNA/hAT-Charlie	861	+	74	73670326	11054
chr14	73659272	73859272	harbor1	chr14	73721965	73722423	DNA/hAT-Charlie	1538	+	229	73722194	62922
chr14	73659272	73859272	harbor1	chr14	73734322	73734403	DNA/hAT-Charlie	517	+	40	73734362	75090
chr14	73659272	73859272	harbor1	chr14	73734732	73734846	DNA/hAT-Charlie	517	+	57	73734789	75517
chr14	103462452	103662452	harbor1	chr14	103469022	103469133	DNA/hAT-Charlie	502	+	56	103469078	6626
chr14	103462452	103662452	harbor1	chr14	103469739	103469780	DNA/hAT-Charlie	502	+	20	103469759	7307
chr14	103462452	103662452	harbor1	chr14	103470077	103470138	DNA/hAT-Charlie	502	+	30	103470107	7655
chr14	103462452	103662452	harbor1	chr14	103517175	103517353	DNA/hAT-Charlie	660	+	89	103517264	54812
chr14	103462452	103662452	harbor1	chr14	103553761	103553871	DNA/hAT-Charlie	488	+	55	103553816	91364
chr14	75328384	75528384	harbor1	chr14	75375802	75375958	DNA/hAT-Charlie	860	+	78	75375880	47496
chr14	75328384	75528384	harbor1	chr14	75406334	75406428	DNA/hAT-Charlie	566	+	47	75406381	77997
chr14	51349924	51549924	harbor1	chr14	51367353	51367516	DNA/hAT-Charlie	871	+	82	51367435	17511
chr14	51349924	51549924	harbor1	chr14	51380456	51380635	DNA/hAT-Charlie	457	+	90	51380546	30622
chr14	65117756	65317756	harbor1	chr14	65143065	65143386	DNA/hAT-Charlie	1609	+	160	65143225	25469
chr14	65117756	65317756	harbor1	chr14	65143419	65143661	DNA/hAT-Charlie	478	+	121	65143540	25784
chr14	65117756	65317756	harbor1	chr14	65149838	65150170	DNA/hAT-Charlie	1589	+	166	65150004	32248
chr14	103423133	103623133	harbor1	chr14	103425995	103426203	DNA/hAT-Charlie	1090	+	104	103426099	2966
chr14	103423133	103623133	harbor1	chr14	103426203	103426398	DNA/hAT-Charlie	544	+	98	103426301	3168
chr14	103423133	103623133	harbor1	chr14	103469022	103469133	DNA/hAT-Charlie	502	+	56	103469078	45945
chr14	103423133	103623133	harbor1	chr14	103469739	103469780	DNA/hAT-Charlie	502	+	20	103469759	46626
chr14	103423133	103623133	harbor1	chr14	103470077	103470138	DNA/hAT-Charlie	502	+	30	103470107	46974
chr14	103423133	103623133	harbor1	chr14	103517175	103517353	DNA/hAT-Charlie	660	+	89	103517264	94131
chr14	93015942	93215942	harbor1	chr14	93053169	93053349	DNA/hAT-Charlie	702	+	90	93053259	37317
chr14	93015942	93215942	harbor1	chr14	93084274	93084464	DNA/hAT-Charlie	618	+	95	93084369	68427
chr14	99493150	99693150	harbor1	chr14	99505313	99505596	DNA/hAT-Charlie	875	+	142	99505455	12305
chr14	99493150	99693150	harbor1	chr14	99505868	99505933	DNA/hAT-Charlie	875	+	32	99505900	12750
chr14	90283244	90483244	harbor1	chr14	90293134	90293253	DNA/hAT-Charlie	846	+	60	90293194	9950
chr14	90283244	90483244	harbor1	chr14	90293550	90293618	DNA/hAT-Charlie	846	+	34	90293584	10340
chr14	90283244	90483244	harbor1	chr14	90296794	90296856	DNA/hAT-Charlie	1317	+	31	90296825	13581
chr14	90283244	90483244	harbor1	chr14	90297167	90297475	DNA/hAT-Charlie	1317	+	154	90297321	14077
chr14	90283244	90483244	harbor1	chr14	90343837	90344030	DNA/hAT-Charlie	1210	+	96	90343933	60689
chr14	90283244	90483244	harbor1	chr14	90380656	90380796	DNA/hAT-Charlie	756	+	70	90380726	97482
chr14	23419129	23619129	harbor1	chr14	23446966	23447124	DNA/hAT-Charlie	833	+	79	23447045	27916
chr14	23419129	23619129	harbor1	chr14	23451319	23451423	DNA/hAT-Charlie	518	+	52	23451371	32242
chr14	23419129	23619129	harbor1	chr14	23452789	23453197	DNA/hAT-Charlie	1726	+	204	23452993	33864
chr14	23419129	23619129	harbor1	chr14	23458496	23458971	DNA/hAT-Charlie	3728	+	238	23458734	39605
chr14	23419129	23619129	harbor1	chr14	23459268	23459667	DNA/hAT-Charlie	3728	+	200	23459468	40339
chr14	23419129	23619129	harbor1	chr14	23465259	23465443	DNA/hAT-Charlie	1233	+	92	23465351	46222
chr14	23419129	23619129	harbor1	chr14	23467638	23467649	DNA/hAT-Charlie	835	+	6	23467644	48515
chr14	23419129	23619129	harbor1	chr14	23468256	23468412	DNA/hAT-Charlie	835	+	78	23468334	49205
chr14	23419129	23619129	harbor1	chr14	23474744	23474904	DNA/hAT-Charlie	759	+	80	23474824	55695
chr14	23419129	23619129	harbor1	chr14	23511095	23511322	DNA/hAT-Charlie	780	+	114	23511209	92080
chr14	23477321	23677321	harbor1	chr14	23511095	23511322	DNA/hAT-Charlie	780	+	114	23511209	33888
chr14	23477321	23677321	harbor1	chr14	23574475	23574584	DNA/hAT-Charlie	453	+	54	23574529	97208
chr14	23477321	23677321	harbor1	chr14	23574659	23574823	DNA/hAT-Charlie	740	+	82	23574741	97420
chr14	23477321	23677321	harbor1	chr14	23574936	23575017	DNA/hAT-Charlie	740	+	40	23574976	97655
chr14	71625517	71825517	harbor1	chr14	71625952	71626234	DNA/hAT-Charlie	802	+	141	71626093	576
chr14	71625517	71825517	harbor1	chr14	71657738	71658205	DNA/hAT-Charlie	1702	+	234	71657972	32455
chr14	71625517	71825517	harbor1	chr14	71706324	71706479	DNA/hAT-Charlie	892	+	78	71706402	80885
chr14	75328363	75528363	harbor1	chr14	75375802	75375958	DNA/hAT-Charlie	860	+	78	75375880	47517
chr14	75328363	75528363	harbor1	chr14	75406334	75406428	DNA/hAT-Charlie	566	+	47	75406381	78018
chr14	75328401	75528401	harbor1	chr14	75375802	75375958	DNA/hAT-Charlie	860	+	78	75375880	47479
chr14	75328401	75528401	harbor1	chr14	75406334	75406428	DNA/hAT-Charlie	566	+	47	75406381	77980
chr14	49792466	49992466	harbor1	chr14	49838917	49839067	DNA/hAT-Charlie	848	+	75	49838992	46526
chr14	90282174	90482174	harbor1	chr14	90293134	90293253	DNA/hAT-Charlie	846	+	60	90293194	11020
chr14	90282174	90482174	harbor1	chr14	90293550	90293618	DNA/hAT-Charlie	846	+	34	90293584	11410
chr14	90282174	90482174	harbor1	chr14	90296794	90296856	DNA/hAT-Charlie	1317	+	31	90296825	14651
chr14	90282174	90482174	harbor1	chr14	90297167	90297475	DNA/hAT-Charlie	1317	+	154	90297321	15147
chr14	90282174	90482174	harbor1	chr14	90343837	90344030	DNA/hAT-Charlie	1210	+	96	90343933	61759
chr14	90282174	90482174	harbor1	chr14	90380656	90380796	DNA/hAT-Charlie	756	+	70	90380726	98552
chr14	104017094	104217094	harbor1	chr14	104040847	104041028	DNA/hAT-Charlie	533	+	90	104040937	23843
chr14	73660276	73860276	harbor1	chr14	73670252	73670401	DNA/hAT-Charlie	861	+	74	73670326	10050
chr14	73660276	73860276	harbor1	chr14	73721965	73722423	DNA/hAT-Charlie	1538	+	229	73722194	61918
chr14	73660276	73860276	harbor1	chr14	73734322	73734403	DNA/hAT-Charlie	517	+	40	73734362	74086
chr14	73660276	73860276	harbor1	chr14	73734732	73734846	DNA/hAT-Charlie	517	+	57	73734789	74513
chr14	24047678	24247678	harbor1	chr14	24085768	24085949	DNA/hAT-Charlie	962	+	90	24085858	38180
chr14	24047678	24247678	harbor1	chr14	24128397	24128508	DNA/hAT-Charlie	1189	+	56	24128453	80775
chr14	24047678	24247678	harbor1	chr14	24128826	24128852	DNA/hAT-Charlie	1189	+	13	24128839	81161
chr14	24047678	24247678	harbor1	chr14	24129152	24129442	DNA/hAT-Charlie	1189	+	145	24129297	81619
chr14	24047678	24247678	harbor1	chr14	24130020	24130056	DNA/hAT-Charlie	1189	+	18	24130038	82360
chr14	24047678	24247678	harbor1	chr14	24130337	24130360	DNA/hAT-Charlie	1189	+	12	24130349	82671
chr14	24047678	24247678	harbor1	chr14	24134597	24134821	DNA/hAT-Charlie	1000	+	112	24134709	87031
chr14	100185630	100385630	harbor1	chr14	100213305	100213530	DNA/hAT-Charlie	1032	+	112	100213417	27787
chr14	100185630	100385630	harbor1	chr14	100213832	100213924	DNA/hAT-Charlie	1032	+	46	100213878	28248
chr14	100118258	100318258	harbor1	chr14	100213305	100213530	DNA/hAT-Charlie	1032	+	112	100213417	95159
chr14	100118258	100318258	harbor1	chr14	100213832	100213924	DNA/hAT-Charlie	1032	+	46	100213878	95620
chr14	73640450	73840450	harbor1	chr14	73670252	73670401	DNA/hAT-Charlie	861	+	74	73670326	29876
chr14	73640450	73840450	harbor1	chr14	73721965	73722423	DNA/hAT-Charlie	1538	+	229	73722194	81744
chr14	73640450	73840450	harbor1	chr14	73734322	73734403	DNA/hAT-Charlie	517	+	40	73734362	93912
chr14	73640450	73840450	harbor1	chr14	73734732	73734846	DNA/hAT-Charlie	517	+	57	73734789	94339
chr14	103419639	103619639	harbor1	chr14	103425995	103426203	DNA/hAT-Charlie	1090	+	104	103426099	6460
chr14	103419639	103619639	harbor1	chr14	103426203	103426398	DNA/hAT-Charlie	544	+	98	103426301	6662
chr14	103419639	103619639	harbor1	chr14	103469022	103469133	DNA/hAT-Charlie	502	+	56	103469078	49439
chr14	103419639	103619639	harbor1	chr14	103469739	103469780	DNA/hAT-Charlie	502	+	20	103469759	50120
chr14	103419639	103619639	harbor1	chr14	103470077	103470138	DNA/hAT-Charlie	502	+	30	103470107	50468
chr14	103419639	103619639	harbor1	chr14	103517175	103517353	DNA/hAT-Charlie	660	+	89	103517264	97625
chr14	67482246	67682246	harbor1	chr14	67497533	67497951	DNA/hAT-Charlie	1639	+	209	67497742	15496
chr14	67482246	67682246	harbor1	chr14	67543463	67543645	DNA/hAT-Charlie	454	+	91	67543554	61308
chr14	72958440	73158440	harbor1	chr14	72980481	72980536	DNA/hAT-Charlie	740	+	28	72980509	22069
chr14	72958440	73158440	harbor1	chr14	72980856	72980992	DNA/hAT-Charlie	740	+	68	72980924	22484
chr14	72958440	73158440	harbor1	chr14	72981005	72981155	DNA/hAT-Charlie	675	+	75	72981080	22640
chr14	72958440	73158440	harbor1	chr14	72981168	72981319	DNA/hAT-Charlie	535	+	76	72981244	22804
chr14	75328399	75528399	harbor1	chr14	75375802	75375958	DNA/hAT-Charlie	860	+	78	75375880	47481
chr14	75328399	75528399	harbor1	chr14	75406334	75406428	DNA/hAT-Charlie	566	+	47	75406381	77982
chr14	88724593	88924593	harbor1	chr14	88729352	88729558	DNA/hAT-Charlie	6188	+	103	88729455	4862
chr14	88724593	88924593	harbor1	chr14	88729890	88731035	DNA/hAT-Charlie	6188	+	572	88730462	5869
chr14	88724593	88924593	harbor1	chr14	88732659	88732822	DNA/hAT-Charlie	1680	+	82	88732741	8148
chr14	88724593	88924593	harbor1	chr14	88732917	88733208	DNA/hAT-Charlie	1680	+	146	88733063	8470
chr14	88724593	88924593	harbor1	chr14	88734385	88734600	DNA/hAT-Charlie	841	+	108	88734493	9900
chr14	88724593	88924593	harbor1	chr14	88742214	88742401	DNA/hAT-Charlie	600	+	94	88742308	17715
chr14	88724593	88924593	harbor1	chr14	88749929	88750125	DNA/hAT-Charlie	1023	+	98	88750027	25434
chr14	88724593	88924593	harbor1	chr14	88768979	88769136	DNA/hAT-Charlie	538	+	78	88769057	44464
chr14	88724593	88924593	harbor1	chr14	88769519	88769574	DNA/hAT-Charlie	538	+	28	88769547	44954
chr14	88724593	88924593	harbor1	chr14	88802687	88803209	DNA/hAT-Charlie	3585	+	261	88802948	78355
chr14	73545047	73745047	harbor1	chr14	73613577	73613794	DNA/hAT-Charlie	1180	+	108	73613685	68638
chr14	67141311	67341311	harbor1	chr14	67148461	67148558	DNA/hAT-Charlie	1727	+	48	67148509	7198
chr14	67141311	67341311	harbor1	chr14	67148866	67149062	DNA/hAT-Charlie	1727	+	98	67148964	7653
chr14	67141311	67341311	harbor1	chr14	67149362	67149562	DNA/hAT-Charlie	1727	+	100	67149462	8151
chr14	67141311	67341311	harbor1	chr14	67212967	67213092	DNA/hAT-Charlie	629	+	62	67213029	71718
chr14	67141311	67341311	harbor1	chr14	67229385	67229586	DNA/hAT-Charlie	1007	+	100	67229485	88174
chr14	67141311	67341311	harbor1	chr14	67229585	67229856	DNA/hAT-Charlie	921	+	136	67229721	88410
chr14	67141311	67341311	harbor1	chr14	67239282	67239487	DNA/hAT-Charlie	1061	+	102	67239384	98073
chr14	24047662	24247662	harbor1	chr14	24085768	24085949	DNA/hAT-Charlie	962	+	90	24085858	38196
chr14	24047662	24247662	harbor1	chr14	24128397	24128508	DNA/hAT-Charlie	1189	+	56	24128453	80791
chr14	24047662	24247662	harbor1	chr14	24128826	24128852	DNA/hAT-Charlie	1189	+	13	24128839	81177
chr14	24047662	24247662	harbor1	chr14	24129152	24129442	DNA/hAT-Charlie	1189	+	145	24129297	81635
chr14	24047662	24247662	harbor1	chr14	24130020	24130056	DNA/hAT-Charlie	1189	+	18	24130038	82376
chr14	24047662	24247662	harbor1	chr14	24130337	24130360	DNA/hAT-Charlie	1189	+	12	24130349	82687
chr14	24047662	24247662	harbor1	chr14	24134597	24134821	DNA/hAT-Charlie	1000	+	112	24134709	87047
chr14	67108235	67308235	harbor1	chr14	67123700	67123914	DNA/hAT-Charlie	1535	+	107	67123807	15572
chr14	67108235	67308235	harbor1	chr14	67148461	67148558	DNA/hAT-Charlie	1727	+	48	67148509	40274
chr14	67108235	67308235	harbor1	chr14	67148866	67149062	DNA/hAT-Charlie	1727	+	98	67148964	40729
chr14	67108235	67308235	harbor1	chr14	67149362	67149562	DNA/hAT-Charlie	1727	+	100	67149462	41227
chr14	94469585	94669585	harbor1	chr14	94480987	94481400	DNA/hAT-Charlie	987	+	206	94481193	11608
chr14	94469585	94669585	harbor1	chr14	94540937	94541070	DNA/hAT-Charlie	571	+	66	94541003	71418
chr14	94469585	94669585	harbor1	chr14	94561951	94562312	DNA/hAT-Charlie	1207	+	180	94562131	92546
chr14	94469585	94669585	harbor1	chr14	94564553	94564770	DNA/hAT-Charlie	960	+	108	94564661	95076
chr14	100182074	100382074	harbor1	chr14	100213305	100213530	DNA/hAT-Charlie	1032	+	112	100213417	31343
chr14	100182074	100382074	harbor1	chr14	100213832	100213924	DNA/hAT-Charlie	1032	+	46	100213878	31804
chr14	105387228	105587228	harbor1	chr14	105430726	105430968	DNA/hAT-Charlie	989	+	121	105430847	43619
chr14	105387228	105587228	harbor1	chr14	105431494	105431617	DNA/hAT-Charlie	857	+	62	105431556	44328
chr14	105387228	105587228	harbor1	chr14	105431926	105432025	DNA/hAT-Charlie	857	+	50	105431976	44748
chr14	105387228	105587228	harbor1	chr14	105432153	105432228	DNA/hAT-Charlie	1805	+	38	105432191	44963
chr14	105387228	105587228	harbor1	chr14	105432539	105433003	DNA/hAT-Charlie	1805	+	232	105432771	45543
chr14	105387228	105587228	harbor1	chr14	105433596	105433840	DNA/hAT-Charlie	1107	+	122	105433718	46490
chr14	105387228	105587228	harbor1	chr14	105434117	105434242	DNA/hAT-Charlie	1107	+	62	105434179	46951
chr14	105388150	105588150	harbor1	chr14	105430726	105430968	DNA/hAT-Charlie	989	+	121	105430847	42697
chr14	105388150	105588150	harbor1	chr14	105431494	105431617	DNA/hAT-Charlie	857	+	62	105431556	43406
chr14	105388150	105588150	harbor1	chr14	105431926	105432025	DNA/hAT-Charlie	857	+	50	105431976	43826
chr14	105388150	105588150	harbor1	chr14	105432153	105432228	DNA/hAT-Charlie	1805	+	38	105432191	44041
chr14	105388150	105588150	harbor1	chr14	105432539	105433003	DNA/hAT-Charlie	1805	+	232	105432771	44621
chr14	105388150	105588150	harbor1	chr14	105433596	105433840	DNA/hAT-Charlie	1107	+	122	105433718	45568
chr14	105388150	105588150	harbor1	chr14	105434117	105434242	DNA/hAT-Charlie	1107	+	62	105434179	46029
chr14	21337357	21537357	harbor1	chr14	21338460	21338625	DNA/hAT-Charlie	461	+	82	21338542	1185
chr14	21337357	21537357	harbor1	chr14	21338703	21338831	DNA/hAT-Charlie	461	+	64	21338767	1410
chr14	21337357	21537357	harbor1	chr14	21372839	21372961	DNA/hAT-Charlie	485	+	61	21372900	35543
chr14	21337357	21537357	harbor1	chr14	21373246	21373288	DNA/hAT-Charlie	485	+	21	21373267	35910
chr14	21337357	21537357	harbor1	chr14	21376606	21376912	DNA/hAT-Charlie	1009	+	153	21376759	39402
chr14	21337357	21537357	harbor1	chr14	21402672	21402888	DNA/hAT-Charlie	904	+	108	21402780	65423
chr14	24047772	24247772	harbor1	chr14	24085768	24085949	DNA/hAT-Charlie	962	+	90	24085858	38086
chr14	24047772	24247772	harbor1	chr14	24128397	24128508	DNA/hAT-Charlie	1189	+	56	24128453	80681
chr14	24047772	24247772	harbor1	chr14	24128826	24128852	DNA/hAT-Charlie	1189	+	13	24128839	81067
chr14	24047772	24247772	harbor1	chr14	24129152	24129442	DNA/hAT-Charlie	1189	+	145	24129297	81525
chr14	24047772	24247772	harbor1	chr14	24130020	24130056	DNA/hAT-Charlie	1189	+	18	24130038	82266
chr14	24047772	24247772	harbor1	chr14	24130337	24130360	DNA/hAT-Charlie	1189	+	12	24130349	82577
chr14	24047772	24247772	harbor1	chr14	24134597	24134821	DNA/hAT-Charlie	1000	+	112	24134709	86937
chr14	100146444	100346444	harbor1	chr14	100213305	100213530	DNA/hAT-Charlie	1032	+	112	100213417	66973
chr14	100146444	100346444	harbor1	chr14	100213832	100213924	DNA/hAT-Charlie	1032	+	46	100213878	67434
chr14	99493157	99693157	harbor1	chr14	99505313	99505596	DNA/hAT-Charlie	875	+	142	99505455	12298
chr14	99493157	99693157	harbor1	chr14	99505868	99505933	DNA/hAT-Charlie	875	+	32	99505900	12743
chr14	90283172	90483172	harbor1	chr14	90293134	90293253	DNA/hAT-Charlie	846	+	60	90293194	10022
chr14	90283172	90483172	harbor1	chr14	90293550	90293618	DNA/hAT-Charlie	846	+	34	90293584	10412
chr14	90283172	90483172	harbor1	chr14	90296794	90296856	DNA/hAT-Charlie	1317	+	31	90296825	13653
chr14	90283172	90483172	harbor1	chr14	90297167	90297475	DNA/hAT-Charlie	1317	+	154	90297321	14149
chr14	90283172	90483172	harbor1	chr14	90343837	90344030	DNA/hAT-Charlie	1210	+	96	90343933	60761
chr14	90283172	90483172	harbor1	chr14	90380656	90380796	DNA/hAT-Charlie	756	+	70	90380726	97554
chr14	55014896	55214896	harbor1	chr14	55016600	55016772	DNA/hAT-Charlie	708	+	86	55016686	1790
chr14	55014896	55214896	harbor1	chr14	55106124	55106290	DNA/hAT-Charlie	462	+	83	55106207	91311
chr14	55014896	55214896	harbor1	chr14	55106567	55106699	DNA/hAT-Charlie	462	+	66	55106633	91737
chr14	55014896	55214896	harbor1	chr14	55106692	55106871	DNA/hAT-Charlie	674	+	90	55106782	91886
chr14	55014896	55214896	harbor1	chr14	55107489	55107559	DNA/hAT-Charlie	674	+	35	55107524	92628
chr14	92893583	93093583	harbor1	chr14	92955129	92955316	DNA/hAT-Charlie	617	+	94	92955223	61640
chr14	100185510	100385510	harbor1	chr14	100213305	100213530	DNA/hAT-Charlie	1032	+	112	100213417	27907
chr14	100185510	100385510	harbor1	chr14	100213832	100213924	DNA/hAT-Charlie	1032	+	46	100213878	28368
chr14	75328390	75528390	harbor1	chr14	75375802	75375958	DNA/hAT-Charlie	860	+	78	75375880	47490
chr14	75328390	75528390	harbor1	chr14	75406334	75406428	DNA/hAT-Charlie	566	+	47	75406381	77991
chr14	23251947	23451947	harbor1	chr14	23289767	23289979	DNA/hAT-Charlie	1186	+	106	23289873	37926
chr14	23251947	23451947	harbor1	chr14	23310712	23310927	DNA/hAT-Charlie	729	+	108	23310820	58873
chr14	73999218	74199218	harbor1	chr14	74013383	74013610	DNA/hAT-Charlie	1625	+	114	74013497	14279
chr14	73999218	74199218	harbor1	chr14	74066225	74066512	DNA/hAT-Charlie	1301	+	144	74066369	67151
chr14	71816792	72016792	harbor1	chr14	71852425	71852538	DNA/hAT-Charlie	499	+	56	71852481	35689
chr14	71816792	72016792	harbor1	chr14	71862978	71863872	DNA/hAT-Charlie	2615	+	447	71863425	46633
chr14	104542901	104742901	harbor1	chr14	104631638	104631764	DNA/hAT-Charlie	490	+	63	104631701	88800
chr14	104542901	104742901	harbor1	chr14	104632054	104632110	DNA/hAT-Charlie	490	+	28	104632082	89181
chr14	104017097	104217097	harbor1	chr14	104040847	104041028	DNA/hAT-Charlie	533	+	90	104040937	23840
chr14	100581636	100781636	harbor1	chr14	100608543	100608874	DNA/hAT-Charlie	1039	+	166	100608709	27073
chr14	100581636	100781636	harbor1	chr14	100612963	100613107	DNA/hAT-Charlie	716	+	72	100613035	31399
chr14	100581636	100781636	harbor1	chr14	100636391	100636517	DNA/hAT-Charlie	629	+	63	100636454	54818
chr14	100581636	100781636	harbor1	chr14	100662011	100662322	DNA/hAT-Charlie	1413	+	156	100662167	80531
chr14	100581636	100781636	harbor1	chr14	100662607	100662635	DNA/hAT-Charlie	1413	+	14	100662621	80985
chr14	20369071	20569071	harbor1	chr14	20416416	20416542	DNA/hAT-Charlie	840	+	63	20416479	47408
chr14	20369071	20569071	harbor1	chr14	20416898	20416937	DNA/hAT-Charlie	840	+	20	20416918	47847
chr14	20369071	20569071	harbor1	chr14	20416947	20417100	DNA/hAT-Charlie	829	+	76	20417023	47952
chr14	20369071	20569071	harbor1	chr14	20441396	20441558	DNA/hAT-Charlie	668	+	81	20441477	72406
chr14	20369071	20569071	harbor1	chr14	20466983	20467146	DNA/hAT-Charlie	697	+	82	20467065	97994
chr14	20369071	20569071	harbor1	chr14	20467527	20467706	DNA/hAT-Charlie	1467	+	90	20467617	98546
chr14	20369071	20569071	harbor1	chr14	20467994	20468272	DNA/hAT-Charlie	1467	+	139	20468133	99062
chr14	75328424	75528424	harbor1	chr14	75375802	75375958	DNA/hAT-Charlie	860	+	78	75375880	47456
chr14	75328424	75528424	harbor1	chr14	75406334	75406428	DNA/hAT-Charlie	566	+	47	75406381	77957
chr14	23252088	23452088	harbor1	chr14	23289767	23289979	DNA/hAT-Charlie	1186	+	106	23289873	37785
chr14	23252088	23452088	harbor1	chr14	23310712	23310927	DNA/hAT-Charlie	729	+	108	23310820	58732
chr14	21337368	21537368	harbor1	chr14	21338460	21338625	DNA/hAT-Charlie	461	+	82	21338542	1174
chr14	21337368	21537368	harbor1	chr14	21338703	21338831	DNA/hAT-Charlie	461	+	64	21338767	1399
chr14	21337368	21537368	harbor1	chr14	21372839	21372961	DNA/hAT-Charlie	485	+	61	21372900	35532
chr14	21337368	21537368	harbor1	chr14	21373246	21373288	DNA/hAT-Charlie	485	+	21	21373267	35899
chr14	21337368	21537368	harbor1	chr14	21376606	21376912	DNA/hAT-Charlie	1009	+	153	21376759	39391
chr14	21337368	21537368	harbor1	chr14	21402672	21402888	DNA/hAT-Charlie	904	+	108	21402780	65412
chr14	50142883	50342883	harbor1	chr14	50194120	50194325	DNA/hAT-Charlie	1090	+	102	50194222	51339
chr14	50142883	50342883	harbor1	chr14	50198481	50198634	DNA/hAT-Charlie	575	+	76	50198557	55674
chr14	50142883	50342883	harbor1	chr14	50211087	50211327	DNA/hAT-Charlie	861	+	120	50211207	68324
chr14	50142883	50342883	harbor1	chr14	50221348	50221576	DNA/hAT-Charlie	571	+	114	50221462	78579
chr14	50142883	50342883	harbor1	chr14	50221832	50222319	DNA/hAT-Charlie	1397	+	244	50222076	79193
chr14	50142883	50342883	harbor1	chr14	50233247	50233541	DNA/hAT-Charlie	1088	+	147	50233394	90511
chr14	20357270	20557270	harbor1	chr14	20416416	20416542	DNA/hAT-Charlie	840	+	63	20416479	59209
chr14	20357270	20557270	harbor1	chr14	20416898	20416937	DNA/hAT-Charlie	840	+	20	20416918	59648
chr14	20357270	20557270	harbor1	chr14	20416947	20417100	DNA/hAT-Charlie	829	+	76	20417023	59753
chr14	20357270	20557270	harbor1	chr14	20441396	20441558	DNA/hAT-Charlie	668	+	81	20441477	84207
chr14	104877001	105077001	harbor1	chr14	104964955	104965165	DNA/hAT-Charlie	1254	+	105	104965060	88059
chr14	99416276	99616276	harbor1	chr14	99433319	99433441	DNA/hAT-Charlie	459	+	61	99433380	17104
chr14	99416276	99616276	harbor1	chr14	99505313	99505596	DNA/hAT-Charlie	875	+	142	99505455	89179
chr14	99416276	99616276	harbor1	chr14	99505868	99505933	DNA/hAT-Charlie	875	+	32	99505900	89624
chr14	95435221	95635221	harbor1	chr14	95441826	95442193	DNA/hAT-Charlie	810	+	184	95442010	6789
chr14	95435221	95635221	harbor1	chr14	95444857	95445057	DNA/hAT-Charlie	783	+	100	95444957	9736
chr14	95435221	95635221	harbor1	chr14	95455880	95456284	DNA/hAT-Charlie	958	+	202	95456082	20861
chr14	95435221	95635221	harbor1	chr14	95475414	95475573	DNA/hAT-Charlie	660	+	80	95475494	40273
chr14	95435221	95635221	harbor1	chr14	95484632	95484855	DNA/hAT-Charlie	520	+	112	95484744	49523
chr14	95435221	95635221	harbor1	chr14	95504019	95504238	DNA/hAT-Charlie	1077	+	110	95504129	68908
chr14	100012246	100212246	harbor1	chr14	100035977	100036315	DNA/hAT-Charlie	2084	+	169	100036146	23900
chr14	100012246	100212246	harbor1	chr14	100051702	100051998	DNA/hAT-Charlie	672	+	148	100051850	39604
chr14	100012246	100212246	harbor1	chr14	100052002	100052105	DNA/hAT-Charlie	456	+	52	100052054	39808
chr14	100012246	100212246	harbor1	chr14	100052190	100052322	DNA/hAT-Charlie	658	+	66	100052256	40010
chr14	100012246	100212246	harbor1	chr14	100052392	100052469	DNA/hAT-Charlie	524	+	38	100052430	40184
chr14	100012246	100212246	harbor1	chr14	100052767	100052807	DNA/hAT-Charlie	524	+	20	100052787	40541
chr14	100012246	100212246	harbor1	chr14	100053195	100053208	DNA/hAT-Charlie	524	+	6	100053201	40955
chr14	100012246	100212246	harbor1	chr14	100071326	100071537	DNA/hAT-Charlie	844	+	106	100071432	59186
chr14	100012246	100212246	harbor1	chr14	100071524	100071658	DNA/hAT-Charlie	656	+	67	100071591	59345
chr14	100012246	100212246	harbor1	chr14	100106219	100106718	DNA/hAT-Charlie	1533	+	250	100106469	94223
chr14	54692460	54892460	harbor1	chr14	54699457	54699763	DNA/hAT-Charlie	898	+	153	54699610	7150
chr14	67500383	67700383	harbor1	chr14	67543463	67543645	DNA/hAT-Charlie	454	+	91	67543554	43171
chr14	67500383	67700383	harbor1	chr14	67585267	67585436	DNA/hAT-Charlie	465	+	84	67585351	84968
chr14	81336737	81536737	harbor1	chr14	81404233	81404505	DNA/hAT-Charlie	1106	+	136	81404369	67632
chr14	81336737	81536737	harbor1	chr14	81404807	81404831	DNA/hAT-Charlie	1106	+	12	81404819	68082
chr14	81336737	81536737	harbor1	chr14	81406356	81406600	DNA/hAT-Charlie	1021	+	122	81406478	69741
chr14	81336737	81536737	harbor1	chr14	81432940	81433121	DNA/hAT-Charlie	970	+	90	81433030	96293
chr14	55029359	55229359	harbor1	chr14	55106124	55106290	DNA/hAT-Charlie	462	+	83	55106207	76848
chr14	55029359	55229359	harbor1	chr14	55106567	55106699	DNA/hAT-Charlie	462	+	66	55106633	77274
chr14	55029359	55229359	harbor1	chr14	55106692	55106871	DNA/hAT-Charlie	674	+	90	55106782	77423
chr14	55029359	55229359	harbor1	chr14	55107489	55107559	DNA/hAT-Charlie	674	+	35	55107524	78165
chr14	55029359	55229359	harbor1	chr14	55120599	55120775	DNA/hAT-Charlie	814	+	88	55120687	91328
chr14	103445438	103645438	harbor1	chr14	103469022	103469133	DNA/hAT-Charlie	502	+	56	103469078	23640
chr14	103445438	103645438	harbor1	chr14	103469739	103469780	DNA/hAT-Charlie	502	+	20	103469759	24321
chr14	103445438	103645438	harbor1	chr14	103470077	103470138	DNA/hAT-Charlie	502	+	30	103470107	24669
chr14	103445438	103645438	harbor1	chr14	103517175	103517353	DNA/hAT-Charlie	660	+	89	103517264	71826
chr14	21306992	21506992	harbor1	chr14	21338460	21338625	DNA/hAT-Charlie	461	+	82	21338542	31550
chr14	21306992	21506992	harbor1	chr14	21338703	21338831	DNA/hAT-Charlie	461	+	64	21338767	31775
chr14	21306992	21506992	harbor1	chr14	21372839	21372961	DNA/hAT-Charlie	485	+	61	21372900	65908
chr14	21306992	21506992	harbor1	chr14	21373246	21373288	DNA/hAT-Charlie	485	+	21	21373267	66275
chr14	21306992	21506992	harbor1	chr14	21376606	21376912	DNA/hAT-Charlie	1009	+	153	21376759	69767
chr14	21306992	21506992	harbor1	chr14	21402672	21402888	DNA/hAT-Charlie	904	+	108	21402780	95788
chr14	91224876	91424876	harbor1	chr14	91245063	91245242	DNA/hAT-Charlie	475	+	90	91245153	20277
chr14	91224876	91424876	harbor1	chr14	91262560	91262823	DNA/hAT-Charlie	729	+	132	91262692	37816
chr14	91224876	91424876	harbor1	chr14	91276124	91276302	DNA/hAT-Charlie	717	+	89	91276213	51337
chr14	91224876	91424876	harbor1	chr14	91276906	91276961	DNA/hAT-Charlie	1140	+	28	91276934	52058
chr14	91224876	91424876	harbor1	chr14	91277314	91277579	DNA/hAT-Charlie	1140	+	132	91277446	52570
chr14	91224876	91424876	harbor1	chr14	91284705	91284926	DNA/hAT-Charlie	455	+	110	91284815	59939
chr14	91224876	91424876	harbor1	chr14	91298098	91298152	DNA/hAT-Charlie	503	+	27	91298125	73249
chr14	91224876	91424876	harbor1	chr14	91298545	91298802	DNA/hAT-Charlie	503	+	128	91298673	73797
chr14	69474346	69674346	harbor1	chr14	69536912	69537484	DNA/hAT-Charlie	1285	+	286	69537198	62852
chr14	69474346	69674346	harbor1	chr14	69538872	69539142	DNA/hAT-Charlie	688	+	135	69539007	64661
chr14	69474346	69674346	harbor1	chr14	69563427	69563667	DNA/hAT-Charlie	792	+	120	69563547	89201
chr15	31114834	31314834	harbor1	chr15	31150189	31150274	DNA/hAT-Charlie	465	+	42	31150231	35397
chr15	31114834	31314834	harbor1	chr15	31153990	31154282	DNA/hAT-Charlie	753	+	146	31154136	39302
chr15	31114834	31314834	harbor1	chr15	31205710	31205889	DNA/hAT-Charlie	848	+	90	31205800	90966
chr15	89279015	89479015	harbor1	chr15	89283453	89283735	DNA/hAT-Charlie	1135	+	141	89283594	4579
chr15	89279015	89479015	harbor1	chr15	89336232	89336580	DNA/hAT-Charlie	1183	+	174	89336406	57391
chr15	29169894	29369894	harbor1	chr15	29210365	29210706	DNA/hAT-Charlie	2294	+	170	29210535	40641
chr15	29169894	29369894	harbor1	chr15	29251432	29251647	DNA/hAT-Charlie	1504	+	108	29251540	81646
chr15	29169894	29369894	harbor1	chr15	29251682	29251863	DNA/hAT-Charlie	1324	+	90	29251772	81878
chr15	50319048	50519048	harbor1	chr15	50322564	50322742	DNA/hAT-Charlie	910	+	89	50322653	3605
chr15	50319048	50519048	harbor1	chr15	50353409	50353539	DNA/hAT-Charlie	640	+	65	50353474	34426
chr15	50319048	50519048	harbor1	chr15	50359118	50359301	DNA/hAT-Charlie	723	+	92	50359210	40162
chr15	50319048	50519048	harbor1	chr15	50359921	50359967	DNA/hAT-Charlie	723	+	23	50359944	40896
chr15	32313757	32513757	harbor1	chr15	32412265	32412406	DNA/hAT-Charlie	433	+	70	32412335	98578
chr15	32313757	32513757	harbor1	chr15	32412695	32412710	DNA/hAT-Charlie	433	+	8	32412703	98946
chr15	67421763	67621763	harbor1	chr15	67517756	67517913	DNA/hAT-Charlie	514	+	78	67517834	96071
chr15	67421763	67621763	harbor1	chr15	67518686	67518711	DNA/hAT-Charlie	514	+	12	67518698	96935
chr15	35446216	35646216	harbor1	chr15	35481023	35481223	DNA/hAT-Charlie	884	+	100	35481123	34907
chr15	35446216	35646216	harbor1	chr15	35511024	35511176	DNA/hAT-Charlie	714	+	76	35511100	64884
chr15	35446216	35646216	harbor1	chr15	35539346	35539566	DNA/hAT-Charlie	458	+	110	35539456	93240
chr15	35446299	35646299	harbor1	chr15	35481023	35481223	DNA/hAT-Charlie	884	+	100	35481123	34824
chr15	35446299	35646299	harbor1	chr15	35511024	35511176	DNA/hAT-Charlie	714	+	76	35511100	64801
chr15	35446299	35646299	harbor1	chr15	35539346	35539566	DNA/hAT-Charlie	458	+	110	35539456	93157
chr15	75330451	75530451	harbor1	chr15	75333702	75333865	DNA/hAT-Charlie	729	+	82	75333784	3333
chr15	75330451	75530451	harbor1	chr15	75376961	75377120	DNA/hAT-Charlie	777	+	80	75377041	46590
chr15	75330451	75530451	harbor1	chr15	75377267	75377342	DNA/hAT-Charlie	4001	+	38	75377305	46854
chr15	75330451	75530451	harbor1	chr15	75377648	75378282	DNA/hAT-Charlie	4001	+	317	75377965	47514
chr15	75330451	75530451	harbor1	chr15	75378589	75378908	DNA/hAT-Charlie	4001	+	160	75378749	48298
chr15	75330451	75530451	harbor1	chr15	75379198	75379349	DNA/hAT-Charlie	4001	+	76	75379274	48823
chr15	75330451	75530451	harbor1	chr15	75412133	75412301	DNA/hAT-Charlie	810	+	84	75412217	81766
chr15	74496627	74696627	harbor1	chr15	74549748	74549972	DNA/hAT-Charlie	1252	+	112	74549860	53233
chr15	67421715	67621715	harbor1	chr15	67517756	67517913	DNA/hAT-Charlie	514	+	78	67517834	96119
chr15	67421715	67621715	harbor1	chr15	67518686	67518711	DNA/hAT-Charlie	514	+	12	67518698	96983
chr15	67421806	67621806	harbor1	chr15	67517756	67517913	DNA/hAT-Charlie	514	+	78	67517834	96028
chr15	67421806	67621806	harbor1	chr15	67518686	67518711	DNA/hAT-Charlie	514	+	12	67518698	96892
chr15	35446212	35646212	harbor1	chr15	35481023	35481223	DNA/hAT-Charlie	884	+	100	35481123	34911
chr15	35446212	35646212	harbor1	chr15	35511024	35511176	DNA/hAT-Charlie	714	+	76	35511100	64888
chr15	35446212	35646212	harbor1	chr15	35539346	35539566	DNA/hAT-Charlie	458	+	110	35539456	93244
chr15	67421703	67621703	harbor1	chr15	67517756	67517913	DNA/hAT-Charlie	514	+	78	67517834	96131
chr15	67421703	67621703	harbor1	chr15	67518686	67518711	DNA/hAT-Charlie	514	+	12	67518698	96995
chr15	35446272	35646272	harbor1	chr15	35481023	35481223	DNA/hAT-Charlie	884	+	100	35481123	34851
chr15	35446272	35646272	harbor1	chr15	35511024	35511176	DNA/hAT-Charlie	714	+	76	35511100	64828
chr15	35446272	35646272	harbor1	chr15	35539346	35539566	DNA/hAT-Charlie	458	+	110	35539456	93184
chr15	35446324	35646324	harbor1	chr15	35481023	35481223	DNA/hAT-Charlie	884	+	100	35481123	34799
chr15	35446324	35646324	harbor1	chr15	35511024	35511176	DNA/hAT-Charlie	714	+	76	35511100	64776
chr15	35446324	35646324	harbor1	chr15	35539346	35539566	DNA/hAT-Charlie	458	+	110	35539456	93132
chr15	101861586	102061586	harbor1	chr15	101943852	101944051	DNA/hAT-Charlie	875	+	100	101943952	82366
chr15	74510960	74710960	harbor1	chr15	74549748	74549972	DNA/hAT-Charlie	1252	+	112	74549860	38900
chr15	35446318	35646318	harbor1	chr15	35481023	35481223	DNA/hAT-Charlie	884	+	100	35481123	34805
chr15	35446318	35646318	harbor1	chr15	35511024	35511176	DNA/hAT-Charlie	714	+	76	35511100	64782
chr15	35446318	35646318	harbor1	chr15	35539346	35539566	DNA/hAT-Charlie	458	+	110	35539456	93138
chr15	101858909	102058909	harbor1	chr15	101943852	101944051	DNA/hAT-Charlie	875	+	100	101943952	85043
chr15	35446271	35646271	harbor1	chr15	35481023	35481223	DNA/hAT-Charlie	884	+	100	35481123	34852
chr15	35446271	35646271	harbor1	chr15	35511024	35511176	DNA/hAT-Charlie	714	+	76	35511100	64829
chr15	35446271	35646271	harbor1	chr15	35539346	35539566	DNA/hAT-Charlie	458	+	110	35539456	93185
chr15	35446266	35646266	harbor1	chr15	35481023	35481223	DNA/hAT-Charlie	884	+	100	35481123	34857
chr15	35446266	35646266	harbor1	chr15	35511024	35511176	DNA/hAT-Charlie	714	+	76	35511100	64834
chr15	35446266	35646266	harbor1	chr15	35539346	35539566	DNA/hAT-Charlie	458	+	110	35539456	93190
chr15	35446252	35646252	harbor1	chr15	35481023	35481223	DNA/hAT-Charlie	884	+	100	35481123	34871
chr15	35446252	35646252	harbor1	chr15	35511024	35511176	DNA/hAT-Charlie	714	+	76	35511100	64848
chr15	35446252	35646252	harbor1	chr15	35539346	35539566	DNA/hAT-Charlie	458	+	110	35539456	93204
chr15	67421691	67621691	harbor1	chr15	67517756	67517913	DNA/hAT-Charlie	514	+	78	67517834	96143
chr15	67421691	67621691	harbor1	chr15	67518686	67518711	DNA/hAT-Charlie	514	+	12	67518698	97007
chr15	35446296	35646296	harbor1	chr15	35481023	35481223	DNA/hAT-Charlie	884	+	100	35481123	34827
chr15	35446296	35646296	harbor1	chr15	35511024	35511176	DNA/hAT-Charlie	714	+	76	35511100	64804
chr15	35446296	35646296	harbor1	chr15	35539346	35539566	DNA/hAT-Charlie	458	+	110	35539456	93160
chr15	75576188	75776188	harbor1	chr15	75634649	75634761	DNA/hAT-Charlie	858	+	56	75634705	58517
chr15	75576188	75776188	harbor1	chr15	75635073	75635157	DNA/hAT-Charlie	858	+	42	75635115	58927
chr15	79796978	79996978	harbor1	chr15	79822027	79822205	DNA/hAT-Charlie	623	+	89	79822116	25138
chr15	79796978	79996978	harbor1	chr15	79836010	79836218	DNA/hAT-Charlie	869	+	104	79836114	39136
chr15	79796978	79996978	harbor1	chr15	79836228	79836386	DNA/hAT-Charlie	623	+	79	79836307	39329
chr15	79796978	79996978	harbor1	chr15	79838166	79838508	DNA/hAT-Charlie	3539	+	171	79838337	41359
chr15	79796978	79996978	harbor1	chr15	79838810	79838850	DNA/hAT-Charlie	3539	+	20	79838830	41852
chr15	79796978	79996978	harbor1	chr15	79840286	79840524	DNA/hAT-Charlie	3539	+	119	79840405	43427
chr15	79796978	79996978	harbor1	chr15	79840825	79841219	DNA/hAT-Charlie	3539	+	197	79841022	44044
chr15	79796978	79996978	harbor1	chr15	79841329	79841639	DNA/hAT-Charlie	3539	+	155	79841484	44506
chr15	79796978	79996978	harbor1	chr15	79854951	79855150	DNA/hAT-Charlie	832	+	100	79855051	58073
chr15	79796978	79996978	harbor1	chr15	79870227	79870434	DNA/hAT-Charlie	813	+	104	79870331	73353
chr15	79796978	79996978	harbor1	chr15	79839086	79839874	DNA/hAT-Charlie	3539	+	394	79839480	42502
chr15	75247615	75447615	harbor1	chr15	75320304	75320607	DNA/hAT-Charlie	1848	+	152	75320456	72841
chr15	75247615	75447615	harbor1	chr15	75326220	75326381	DNA/hAT-Charlie	883	+	80	75326300	78685
chr15	75247615	75447615	harbor1	chr15	75333702	75333865	DNA/hAT-Charlie	729	+	82	75333784	86169
chr15	35446210	35646210	harbor1	chr15	35481023	35481223	DNA/hAT-Charlie	884	+	100	35481123	34913
chr15	35446210	35646210	harbor1	chr15	35511024	35511176	DNA/hAT-Charlie	714	+	76	35511100	64890
chr15	35446210	35646210	harbor1	chr15	35539346	35539566	DNA/hAT-Charlie	458	+	110	35539456	93246
chr15	25338180	25538180	harbor1	chr15	25361986	25362192	DNA/hAT-Charlie	614	+	103	25362089	23909
chr15	25338180	25538180	harbor1	chr15	25379735	25379945	DNA/hAT-Charlie	1102	+	105	25379840	41660
chr15	25338180	25538180	harbor1	chr15	25380300	25380417	DNA/hAT-Charlie	1102	+	58	25380358	42178
chr15	25338180	25538180	harbor1	chr15	25405912	25406138	DNA/hAT-Charlie	986	+	113	25406025	67845
chr15	29332904	29532904	harbor1	chr15	29392270	29392333	DNA/hAT-Charlie	447	+	32	29392302	59398
chr15	35446293	35646293	harbor1	chr15	35481023	35481223	DNA/hAT-Charlie	884	+	100	35481123	34830
chr15	35446293	35646293	harbor1	chr15	35511024	35511176	DNA/hAT-Charlie	714	+	76	35511100	64807
chr15	35446293	35646293	harbor1	chr15	35539346	35539566	DNA/hAT-Charlie	458	+	110	35539456	93163
chr15	69999125	70199125	harbor1	chr15	70036186	70036348	DNA/hAT-Charlie	532	+	81	70036267	37142
chr15	69999125	70199125	harbor1	chr15	70047352	70047553	DNA/hAT-Charlie	479	+	100	70047452	48327
chr15	69999125	70199125	harbor1	chr15	70072692	70072863	DNA/hAT-Charlie	739	+	86	70072778	73653
chr15	69999125	70199125	harbor1	chr15	70084237	70084439	DNA/hAT-Charlie	841	+	101	70084338	85213
chr15	29332913	29532913	harbor1	chr15	29392270	29392333	DNA/hAT-Charlie	447	+	32	29392302	59389
chr15	67421799	67621799	harbor1	chr15	67517756	67517913	DNA/hAT-Charlie	514	+	78	67517834	96035
chr15	67421799	67621799	harbor1	chr15	67518686	67518711	DNA/hAT-Charlie	514	+	12	67518698	96899
chr15	67421689	67621689	harbor1	chr15	67517756	67517913	DNA/hAT-Charlie	514	+	78	67517834	96145
chr15	67421689	67621689	harbor1	chr15	67518686	67518711	DNA/hAT-Charlie	514	+	12	67518698	97009
chr15	72131568	72331568	harbor1	chr15	72154077	72154241	DNA/hAT-Charlie	908	+	82	72154159	22591
chr15	99950832	100150832	harbor1	chr15	100027477	100027694	DNA/hAT-Charlie	1053	+	108	100027585	76753
chr15	99950832	100150832	harbor1	chr15	100029836	100029989	DNA/hAT-Charlie	664	+	76	100029912	79080
chr15	99950832	100150832	harbor1	chr15	100043563	100043763	DNA/hAT-Charlie	672	+	100	100043663	92831
chr15	31768267	31968267	harbor1	chr15	31772508	31772679	DNA/hAT-Charlie	589	+	86	31772594	4327
chr15	31768267	31968267	harbor1	chr15	31783333	31784684	DNA/hAT-Charlie	4881	+	676	31784009	15742
chr15	31768267	31968267	harbor1	chr15	31813540	31813748	DNA/hAT-Charlie	601	+	104	31813644	45377
chr15	35446228	35646228	harbor1	chr15	35481023	35481223	DNA/hAT-Charlie	884	+	100	35481123	34895
chr15	35446228	35646228	harbor1	chr15	35511024	35511176	DNA/hAT-Charlie	714	+	76	35511100	64872
chr15	35446228	35646228	harbor1	chr15	35539346	35539566	DNA/hAT-Charlie	458	+	110	35539456	93228
chr15	35446303	35646303	harbor1	chr15	35481023	35481223	DNA/hAT-Charlie	884	+	100	35481123	34820
chr15	35446303	35646303	harbor1	chr15	35511024	35511176	DNA/hAT-Charlie	714	+	76	35511100	64797
chr15	35446303	35646303	harbor1	chr15	35539346	35539566	DNA/hAT-Charlie	458	+	110	35539456	93153
chr15	35446298	35646298	harbor1	chr15	35481023	35481223	DNA/hAT-Charlie	884	+	100	35481123	34825
chr15	35446298	35646298	harbor1	chr15	35511024	35511176	DNA/hAT-Charlie	714	+	76	35511100	64802
chr15	35446298	35646298	harbor1	chr15	35539346	35539566	DNA/hAT-Charlie	458	+	110	35539456	93158
chr15	69999141	70199141	harbor1	chr15	70036186	70036348	DNA/hAT-Charlie	532	+	81	70036267	37126
chr15	69999141	70199141	harbor1	chr15	70047352	70047553	DNA/hAT-Charlie	479	+	100	70047452	48311
chr15	69999141	70199141	harbor1	chr15	70072692	70072863	DNA/hAT-Charlie	739	+	86	70072778	73637
chr15	69999141	70199141	harbor1	chr15	70084237	70084439	DNA/hAT-Charlie	841	+	101	70084338	85197
chr15	35446321	35646321	harbor1	chr15	35481023	35481223	DNA/hAT-Charlie	884	+	100	35481123	34802
chr15	35446321	35646321	harbor1	chr15	35511024	35511176	DNA/hAT-Charlie	714	+	76	35511100	64779
chr15	35446321	35646321	harbor1	chr15	35539346	35539566	DNA/hAT-Charlie	458	+	110	35539456	93135
chr15	98547489	98747489	harbor1	chr15	98560211	98560357	DNA/hAT-Charlie	494	+	73	98560284	12795
chr15	98547489	98747489	harbor1	chr15	98601938	98602281	DNA/hAT-Charlie	2201	+	172	98602110	54621
chr15	98547489	98747489	harbor1	chr15	98609563	98609738	DNA/hAT-Charlie	421	+	88	98609651	62162
chr15	35446273	35646273	harbor1	chr15	35481023	35481223	DNA/hAT-Charlie	884	+	100	35481123	34850
chr15	35446273	35646273	harbor1	chr15	35511024	35511176	DNA/hAT-Charlie	714	+	76	35511100	64827
chr15	35446273	35646273	harbor1	chr15	35539346	35539566	DNA/hAT-Charlie	458	+	110	35539456	93183
chr15	67421848	67621848	harbor1	chr15	67517756	67517913	DNA/hAT-Charlie	514	+	78	67517834	95986
chr15	67421848	67621848	harbor1	chr15	67518686	67518711	DNA/hAT-Charlie	514	+	12	67518698	96850
chr15	63405315	63605315	harbor1	chr15	63416046	63416259	DNA/hAT-Charlie	979	+	106	63416152	10837
chr15	63405315	63605315	harbor1	chr15	63454628	63454790	DNA/hAT-Charlie	853	+	81	63454709	49394
chr15	90133990	90333990	harbor1	chr15	90207880	90207970	DNA/hAT-Charlie	656	+	45	90207925	73935
chr15	90133990	90333990	harbor1	chr15	90208278	90208404	DNA/hAT-Charlie	656	+	63	90208341	74351
chr15	45302919	45502919	harbor1	chr15	45333877	45333945	DNA/hAT-Charlie	749	+	34	45333911	30992
chr15	45302919	45502919	harbor1	chr15	45334254	45334403	DNA/hAT-Charlie	749	+	74	45334328	31409
chr15	45302919	45502919	harbor1	chr15	45372082	45372307	DNA/hAT-Charlie	1159	+	112	45372194	69275
chr15	45302919	45502919	harbor1	chr15	45394066	45394412	DNA/hAT-Charlie	2250	+	173	45394239	91320
chr15	35446294	35646294	harbor1	chr15	35481023	35481223	DNA/hAT-Charlie	884	+	100	35481123	34829
chr15	35446294	35646294	harbor1	chr15	35511024	35511176	DNA/hAT-Charlie	714	+	76	35511100	64806
chr15	35446294	35646294	harbor1	chr15	35539346	35539566	DNA/hAT-Charlie	458	+	110	35539456	93162
chr15	98321796	98521796	harbor1	chr15	98391737	98391956	DNA/hAT-Charlie	1137	+	110	98391847	70051
chr15	98321796	98521796	harbor1	chr15	98392836	98392968	DNA/hAT-Charlie	585	+	66	98392902	71106
chr15	98321796	98521796	harbor1	chr15	98415329	98415545	DNA/hAT-Charlie	778	+	108	98415437	93641
chr15	69713052	69913052	harbor1	chr15	69730728	69730851	DNA/hAT-Charlie	576	+	62	69730790	17738
chr15	69713052	69913052	harbor1	chr15	69747527	69747862	DNA/hAT-Charlie	569	+	168	69747695	34643
chr15	69713052	69913052	harbor1	chr15	69780012	69780221	DNA/hAT-Charlie	1287	+	104	69780116	67064
chr15	69713052	69913052	harbor1	chr15	69789023	69789168	DNA/hAT-Charlie	466	+	72	69789095	76043
chr15	25338721	25538721	harbor1	chr15	25361986	25362192	DNA/hAT-Charlie	614	+	103	25362089	23368
chr15	25338721	25538721	harbor1	chr15	25379735	25379945	DNA/hAT-Charlie	1102	+	105	25379840	41119
chr15	25338721	25538721	harbor1	chr15	25380300	25380417	DNA/hAT-Charlie	1102	+	58	25380358	41637
chr15	25338721	25538721	harbor1	chr15	25405912	25406138	DNA/hAT-Charlie	986	+	113	25406025	67304
chr15	35446205	35646205	harbor1	chr15	35481023	35481223	DNA/hAT-Charlie	884	+	100	35481123	34918
chr15	35446205	35646205	harbor1	chr15	35511024	35511176	DNA/hAT-Charlie	714	+	76	35511100	64895
chr15	35446205	35646205	harbor1	chr15	35539346	35539566	DNA/hAT-Charlie	458	+	110	35539456	93251
chr15	67421758	67621758	harbor1	chr15	67517756	67517913	DNA/hAT-Charlie	514	+	78	67517834	96076
chr15	67421758	67621758	harbor1	chr15	67518686	67518711	DNA/hAT-Charlie	514	+	12	67518698	96940
chr15	35446313	35646313	harbor1	chr15	35481023	35481223	DNA/hAT-Charlie	884	+	100	35481123	34810
chr15	35446313	35646313	harbor1	chr15	35511024	35511176	DNA/hAT-Charlie	714	+	76	35511100	64787
chr15	35446313	35646313	harbor1	chr15	35539346	35539566	DNA/hAT-Charlie	458	+	110	35539456	93143
chr15	88185139	88385139	harbor1	chr15	88186584	88186847	DNA/hAT-Charlie	1185	+	132	88186716	1577
chr15	88185139	88385139	harbor1	chr15	88188306	88188522	DNA/hAT-Charlie	1196	+	108	88188414	3275
chr15	88185139	88385139	harbor1	chr15	88239885	88240000	DNA/hAT-Charlie	551	+	58	88239943	54804
chr15	88185139	88385139	harbor1	chr15	88259439	88259577	DNA/hAT-Charlie	646	+	69	88259508	74369
chr15	88185139	88385139	harbor1	chr15	88195018	88195219	DNA/hAT-Charlie	870	+	100	88195118	9979
chr15	41794702	41994702	harbor1	chr15	41796831	41797086	DNA/hAT-Charlie	795	+	128	41796959	2257
chr15	96225435	96425435	harbor1	chr15	96255710	96255877	DNA/hAT-Charlie	710	+	84	96255794	30359
chr15	20916532	21116532	harbor1	chr15	20934178	20934367	DNA/hAT-Charlie	801	+	94	20934272	17740
chr15	20916532	21116532	harbor1	chr15	21008304	21008432	DNA/hAT-Charlie	791	+	64	21008368	91836
chr15	31770669	31970669	harbor1	chr15	31772508	31772679	DNA/hAT-Charlie	589	+	86	31772594	1925
chr15	31770669	31970669	harbor1	chr15	31783333	31784684	DNA/hAT-Charlie	4881	+	676	31784009	13340
chr15	31770669	31970669	harbor1	chr15	31813540	31813748	DNA/hAT-Charlie	601	+	104	31813644	42975
chr15	35446401	35646401	harbor1	chr15	35481023	35481223	DNA/hAT-Charlie	884	+	100	35481123	34722
chr15	35446401	35646401	harbor1	chr15	35511024	35511176	DNA/hAT-Charlie	714	+	76	35511100	64699
chr15	35446401	35646401	harbor1	chr15	35539346	35539566	DNA/hAT-Charlie	458	+	110	35539456	93055
chr15	74496573	74696573	harbor1	chr15	74549748	74549972	DNA/hAT-Charlie	1252	+	112	74549860	53287
chr15	35446238	35646238	harbor1	chr15	35481023	35481223	DNA/hAT-Charlie	884	+	100	35481123	34885
chr15	35446238	35646238	harbor1	chr15	35511024	35511176	DNA/hAT-Charlie	714	+	76	35511100	64862
chr15	35446238	35646238	harbor1	chr15	35539346	35539566	DNA/hAT-Charlie	458	+	110	35539456	93218
chr15	67421764	67621764	harbor1	chr15	67517756	67517913	DNA/hAT-Charlie	514	+	78	67517834	96070
chr15	67421764	67621764	harbor1	chr15	67518686	67518711	DNA/hAT-Charlie	514	+	12	67518698	96934
chr15	35446427	35646427	harbor1	chr15	35481023	35481223	DNA/hAT-Charlie	884	+	100	35481123	34696
chr15	35446427	35646427	harbor1	chr15	35511024	35511176	DNA/hAT-Charlie	714	+	76	35511100	64673
chr15	35446427	35646427	harbor1	chr15	35539346	35539566	DNA/hAT-Charlie	458	+	110	35539456	93029
chr15	22459893	22659893	harbor1	chr15	22484009	22484216	DNA/hAT-Charlie	1337	+	104	22484113	24220
chr15	22459893	22659893	harbor1	chr15	22545213	22545535	DNA/hAT-Charlie	1029	+	161	22545374	85481
chr15	101859054	102059054	harbor1	chr15	101943852	101944051	DNA/hAT-Charlie	875	+	100	101943952	84898
chr15	74944603	75144603	harbor1	chr15	74973359	74973438	DNA/hAT-Charlie	984	+	40	74973399	28796
chr15	74944603	75144603	harbor1	chr15	74973702	74973839	DNA/hAT-Charlie	984	+	68	74973770	29167
chr15	74944603	75144603	harbor1	chr15	74974362	74974518	DNA/hAT-Charlie	811	+	78	74974440	29837
chr15	74944603	75144603	harbor1	chr15	74974824	74974866	DNA/hAT-Charlie	811	+	21	74974845	30242
chr15	74944603	75144603	harbor1	chr15	75032707	75032786	DNA/hAT-Charlie	1441	+	40	75032747	88144
chr15	74944603	75144603	harbor1	chr15	75033103	75033334	DNA/hAT-Charlie	1441	+	116	75033219	88616
chr15	74944603	75144603	harbor1	chr15	75035190	75035319	DNA/hAT-Charlie	695	+	64	75035254	90651
chr15	74947211	75147211	harbor1	chr15	74973359	74973438	DNA/hAT-Charlie	984	+	40	74973399	26188
chr15	74947211	75147211	harbor1	chr15	74973702	74973839	DNA/hAT-Charlie	984	+	68	74973770	26559
chr15	74947211	75147211	harbor1	chr15	74974362	74974518	DNA/hAT-Charlie	811	+	78	74974440	27229
chr15	74947211	75147211	harbor1	chr15	74974824	74974866	DNA/hAT-Charlie	811	+	21	74974845	27634
chr15	74947211	75147211	harbor1	chr15	75032707	75032786	DNA/hAT-Charlie	1441	+	40	75032747	85536
chr15	74947211	75147211	harbor1	chr15	75033103	75033334	DNA/hAT-Charlie	1441	+	116	75033219	86008
chr15	74947211	75147211	harbor1	chr15	75035190	75035319	DNA/hAT-Charlie	695	+	64	75035254	88043
chr15	35446269	35646269	harbor1	chr15	35481023	35481223	DNA/hAT-Charlie	884	+	100	35481123	34854
chr15	35446269	35646269	harbor1	chr15	35511024	35511176	DNA/hAT-Charlie	714	+	76	35511100	64831
chr15	35446269	35646269	harbor1	chr15	35539346	35539566	DNA/hAT-Charlie	458	+	110	35539456	93187
chr15	35445428	35645428	harbor1	chr15	35481023	35481223	DNA/hAT-Charlie	884	+	100	35481123	35695
chr15	35445428	35645428	harbor1	chr15	35511024	35511176	DNA/hAT-Charlie	714	+	76	35511100	65672
chr15	35445428	35645428	harbor1	chr15	35539346	35539566	DNA/hAT-Charlie	458	+	110	35539456	94028
chr15	20765866	20965866	harbor1	chr15	20791785	20791970	DNA/hAT-Charlie	1017	+	92	20791877	26011
chr15	20765866	20965866	harbor1	chr15	20844297	20844394	DNA/hAT-Charlie	541	+	48	20844345	78479
chr15	20765866	20965866	harbor1	chr15	20851548	20851761	DNA/hAT-Charlie	923	+	106	20851654	85788
chr15	20765866	20965866	harbor1	chr15	20853499	20854025	DNA/hAT-Charlie	3258	+	263	20853762	87896
chr15	75354646	75554646	harbor1	chr15	75376961	75377120	DNA/hAT-Charlie	777	+	80	75377041	22395
chr15	75354646	75554646	harbor1	chr15	75377267	75377342	DNA/hAT-Charlie	4001	+	38	75377305	22659
chr15	75354646	75554646	harbor1	chr15	75377648	75378282	DNA/hAT-Charlie	4001	+	317	75377965	23319
chr15	75354646	75554646	harbor1	chr15	75378589	75378908	DNA/hAT-Charlie	4001	+	160	75378749	24103
chr15	75354646	75554646	harbor1	chr15	75379198	75379349	DNA/hAT-Charlie	4001	+	76	75379274	24628
chr15	75354646	75554646	harbor1	chr15	75412133	75412301	DNA/hAT-Charlie	810	+	84	75412217	57571
chr15	75354646	75554646	harbor1	chr15	75439094	75439311	DNA/hAT-Charlie	1050	+	108	75439202	84556
chr15	52686084	52886084	harbor1	chr15	52696474	52696955	DNA/hAT-Charlie	1321	+	240	52696714	10630
chr15	52686084	52886084	harbor1	chr15	52763481	52763734	DNA/hAT-Charlie	750	+	126	52763607	77523
chr15	52686084	52886084	harbor1	chr15	52763739	52763993	DNA/hAT-Charlie	1069	+	127	52763866	77782
chr15	52686084	52886084	harbor1	chr15	52781671	52781843	DNA/hAT-Charlie	817	+	86	52781757	95673
chr15	52686084	52886084	harbor1	chr15	52723647	52723953	DNA/hAT-Charlie	1005	+	153	52723800	37716
chr15	101854375	102054375	harbor1	chr15	101943852	101944051	DNA/hAT-Charlie	875	+	100	101943952	89577
chr15	67421788	67621788	harbor1	chr15	67517756	67517913	DNA/hAT-Charlie	514	+	78	67517834	96046
chr15	67421788	67621788	harbor1	chr15	67518686	67518711	DNA/hAT-Charlie	514	+	12	67518698	96910
chr15	101861607	102061607	harbor1	chr15	101943852	101944051	DNA/hAT-Charlie	875	+	100	101943952	82345
chr15	57606922	57806922	harbor1	chr15	57652780	57653113	DNA/hAT-Charlie	554	+	166	57652946	46024
chr15	35446215	35646215	harbor1	chr15	35481023	35481223	DNA/hAT-Charlie	884	+	100	35481123	34908
chr15	35446215	35646215	harbor1	chr15	35511024	35511176	DNA/hAT-Charlie	714	+	76	35511100	64885
chr15	35446215	35646215	harbor1	chr15	35539346	35539566	DNA/hAT-Charlie	458	+	110	35539456	93241
chr15	31049451	31249451	harbor1	chr15	31097906	31098129	DNA/hAT-Charlie	953	+	112	31098018	48567
chr15	31049451	31249451	harbor1	chr15	31103301	31103538	DNA/hAT-Charlie	783	+	118	31103419	53968
chr15	66727112	66927112	harbor1	chr15	66736558	66736664	DNA/hAT-Charlie	427	+	53	66736611	9499
chr15	66727112	66927112	harbor1	chr15	66736967	66737028	DNA/hAT-Charlie	427	+	30	66736997	9885
chr15	66727112	66927112	harbor1	chr15	66803649	66803835	DNA/hAT-Charlie	1089	+	93	66803742	76630
chr15	66727112	66927112	harbor1	chr15	66804326	66804487	DNA/hAT-Charlie	918	+	80	66804406	77294
chr15	35446283	35646283	harbor1	chr15	35481023	35481223	DNA/hAT-Charlie	884	+	100	35481123	34840
chr15	35446283	35646283	harbor1	chr15	35511024	35511176	DNA/hAT-Charlie	714	+	76	35511100	64817
chr15	35446283	35646283	harbor1	chr15	35539346	35539566	DNA/hAT-Charlie	458	+	110	35539456	93173
chr16	1	167634	harbor1	chr16	39657	39830	DNA/hAT-Charlie	1042	+	86	39743	39742
chr16	1	167634	harbor1	chr16	40165	40288	DNA/hAT-Charlie	1042	+	62	40227	40226
chr16	1	167634	harbor1	chr16	40285	40459	DNA/hAT-Charlie	705	+	87	40372	40371
chr16	88702482	88902482	harbor1	chr16	88797555	88797674	DNA/hAT-Charlie	652	+	60	88797615	95133
chr16	88702482	88902482	harbor1	chr16	88797970	88798052	DNA/hAT-Charlie	652	+	41	88798011	95529
chr16	66189905	66389905	harbor1	chr16	66250085	66250215	DNA/hAT-Charlie	1456	+	65	66250150	60245
chr16	66189905	66389905	harbor1	chr16	66250520	66250689	DNA/hAT-Charlie	1456	+	84	66250604	60699
chr16	73380	273380	harbor1	chr16	127223	127235	DNA/hAT-Charlie	759	+	6	127229	53849
chr16	73380	273380	harbor1	chr16	127535	127654	DNA/hAT-Charlie	759	+	60	127595	54215
chr16	73380	273380	harbor1	chr16	127955	127986	DNA/hAT-Charlie	759	+	16	127971	54591
chr16	73380	273380	harbor1	chr16	128285	128348	DNA/hAT-Charlie	759	+	32	128317	54937
chr16	87260312	87460312	harbor1	chr16	87264009	87264204	DNA/hAT-Charlie	1179	+	98	87264107	3795
chr16	87260312	87460312	harbor1	chr16	87264523	87264612	DNA/hAT-Charlie	1179	+	44	87264567	4255
chr16	87260312	87460312	harbor1	chr16	87287752	87287992	DNA/hAT-Charlie	1504	+	120	87287872	27560
chr16	87260312	87460312	harbor1	chr16	87332928	87333080	DNA/hAT-Charlie	713	+	76	87333004	72692
chr16	2062817	2262817	harbor1	chr16	2098077	2098218	DNA/hAT-Charlie	567	+	70	2098147	35330
chr16	2062817	2262817	harbor1	chr16	2098511	2098555	DNA/hAT-Charlie	567	+	22	2098533	35716
chr16	79309359	79509359	harbor1	chr16	79367569	79367774	DNA/hAT-Charlie	1074	+	102	79367671	58312
chr16	79309359	79509359	harbor1	chr16	79382365	79382525	DNA/hAT-Charlie	955	+	80	79382445	73086
chr16	79309359	79509359	harbor1	chr16	79400052	79400243	DNA/hAT-Charlie	967	+	96	79400148	90789
chr16	88702456	88902456	harbor1	chr16	88797555	88797674	DNA/hAT-Charlie	652	+	60	88797615	95159
chr16	88702456	88902456	harbor1	chr16	88797970	88798052	DNA/hAT-Charlie	652	+	41	88798011	95555
chr16	87390013	87590013	harbor1	chr16	87456721	87456861	DNA/hAT-Charlie	703	+	70	87456791	66778
chr16	87390013	87590013	harbor1	chr16	87468664	87468870	DNA/hAT-Charlie	738	+	103	87468767	78754
chr16	89759369	89959369	harbor1	chr16	89823679	89823875	DNA/hAT-Charlie	1335	+	98	89823777	64408
chr16	1	167698	harbor1	chr16	39657	39830	DNA/hAT-Charlie	1042	+	86	39743	39742
chr16	1	167698	harbor1	chr16	40165	40288	DNA/hAT-Charlie	1042	+	62	40227	40226
chr16	1	167698	harbor1	chr16	40285	40459	DNA/hAT-Charlie	705	+	87	40372	40371
chr16	46873236	47073236	harbor1	chr16	46960224	46960397	DNA/hAT-Charlie	633	+	86	46960310	87074
chr16	2340233	2540233	harbor1	chr16	2361887	2362136	DNA/hAT-Charlie	586	+	124	2362011	21778
chr16	2340233	2540233	harbor1	chr16	2426896	2427078	DNA/hAT-Charlie	811	+	91	2426987	86754
chr16	4077581	4277581	harbor1	chr16	4085673	4085842	DNA/hAT-Charlie	592	+	84	4085757	8176
chr16	4077581	4277581	harbor1	chr16	4103264	4103547	DNA/hAT-Charlie	2563	+	142	4103406	25825
chr16	4077581	4277581	harbor1	chr16	4103857	4104450	DNA/hAT-Charlie	2563	+	296	4104153	26572
chr16	4077581	4277581	harbor1	chr16	4104631	4104788	DNA/hAT-Charlie	581	+	78	4104709	27128
chr16	4077581	4277581	harbor1	chr16	4105097	4105330	DNA/hAT-Charlie	994	+	116	4105213	27632
chr16	2823031	3023031	harbor1	chr16	2875917	2876200	DNA/hAT-Charlie	3238	+	142	2876059	53028
chr16	2823031	3023031	harbor1	chr16	2876509	2876588	DNA/hAT-Charlie	3238	+	40	2876549	53518
chr16	2823031	3023031	harbor1	chr16	2876882	2876913	DNA/hAT-Charlie	3238	+	16	2876898	53867
chr16	2823031	3023031	harbor1	chr16	2877214	2877385	DNA/hAT-Charlie	3238	+	86	2877300	54269
chr16	2823031	3023031	harbor1	chr16	2877991	2878287	DNA/hAT-Charlie	3238	+	148	2878139	55108
chr16	2823031	3023031	harbor1	chr16	2878889	2879008	DNA/hAT-Charlie	3238	+	60	2878949	55918
chr16	2823031	3023031	harbor1	chr16	2879311	2879325	DNA/hAT-Charlie	3238	+	7	2879318	56287
chr16	2823031	3023031	harbor1	chr16	2879584	2879666	DNA/hAT-Charlie	3238	+	41	2879625	56594
chr16	2823031	3023031	harbor1	chr16	2913479	2913659	DNA/hAT-Charlie	789	+	90	2913569	90538
chr16	2062311	2262311	harbor1	chr16	2098077	2098218	DNA/hAT-Charlie	567	+	70	2098147	35836
chr16	2062311	2262311	harbor1	chr16	2098511	2098555	DNA/hAT-Charlie	567	+	22	2098533	36222
chr16	54828777	55028777	harbor1	chr16	54833040	54833233	DNA/hAT-Charlie	995	+	96	54833136	4359
chr16	54828777	55028777	harbor1	chr16	54863582	54863698	DNA/hAT-Charlie	555	+	58	54863640	34863
chr16	54828777	55028777	harbor1	chr16	54897106	54897304	DNA/hAT-Charlie	642	+	99	54897205	68428
chr16	1	162150	harbor1	chr16	39657	39830	DNA/hAT-Charlie	1042	+	86	39743	39742
chr16	1	162150	harbor1	chr16	40165	40288	DNA/hAT-Charlie	1042	+	62	40227	40226
chr16	1	162150	harbor1	chr16	40285	40459	DNA/hAT-Charlie	705	+	87	40372	40371
chr16	31026123	31226123	harbor1	chr16	31122469	31122598	DNA/hAT-Charlie	715	+	64	31122533	96410
chr16	31026123	31226123	harbor1	chr16	31122892	31122903	DNA/hAT-Charlie	715	+	6	31122898	96775
chr16	31026123	31226123	harbor1	chr16	31123194	31123216	DNA/hAT-Charlie	715	+	11	31123205	97082
chr16	31026123	31226123	harbor1	chr16	31123805	31123867	DNA/hAT-Charlie	715	+	31	31123836	97713
chr16	1	162048	harbor1	chr16	39657	39830	DNA/hAT-Charlie	1042	+	86	39743	39742
chr16	1	162048	harbor1	chr16	40165	40288	DNA/hAT-Charlie	1042	+	62	40227	40226
chr16	1	162048	harbor1	chr16	40285	40459	DNA/hAT-Charlie	705	+	87	40372	40371
chr16	56526501	56726501	harbor1	chr16	56528652	56528885	DNA/hAT-Charlie	928	+	116	56528768	2267
chr16	56526501	56726501	harbor1	chr16	56549621	56549944	DNA/hAT-Charlie	930	+	162	56549783	23282
chr16	87282562	87482562	harbor1	chr16	87287752	87287992	DNA/hAT-Charlie	1504	+	120	87287872	5310
chr16	87282562	87482562	harbor1	chr16	87332928	87333080	DNA/hAT-Charlie	713	+	76	87333004	50442
chr16	2204139	2404139	harbor1	chr16	2241281	2241300	DNA/hAT-Charlie	852	+	10	2241291	37152
chr16	2204139	2404139	harbor1	chr16	2241596	2241692	DNA/hAT-Charlie	852	+	48	2241644	37505
chr16	2204139	2404139	harbor1	chr16	2242293	2242432	DNA/hAT-Charlie	852	+	70	2242363	38224
chr16	46871997	47071997	harbor1	chr16	46960224	46960397	DNA/hAT-Charlie	633	+	86	46960310	88313
chr16	27963715	28163715	harbor1	chr16	27966754	27966996	DNA/hAT-Charlie	838	+	121	27966875	3160
chr16	27963715	28163715	harbor1	chr16	27994320	27994772	DNA/hAT-Charlie	648	+	226	27994546	30831
chr16	27963715	28163715	harbor1	chr16	28028597	28028777	DNA/hAT-Charlie	799	+	90	28028687	64972
chr16	27963715	28163715	harbor1	chr16	28039078	28039267	DNA/hAT-Charlie	578	+	94	28039172	75457
chr16	27963715	28163715	harbor1	chr16	28039308	28039507	DNA/hAT-Charlie	889	+	100	28039408	75693
chr16	47360972	47560972	harbor1	chr16	47371663	47371873	DNA/hAT-Charlie	987	+	105	47371768	10796
chr16	47360972	47560972	harbor1	chr16	47397511	47397712	DNA/hAT-Charlie	919	+	100	47397611	36639
chr16	47360972	47560972	harbor1	chr16	47403910	47404148	DNA/hAT-Charlie	1472	+	119	47404029	43057
chr16	47360972	47560972	harbor1	chr16	47431201	47431549	DNA/hAT-Charlie	2230	+	174	47431375	70403
chr16	87292271	87492271	harbor1	chr16	87332928	87333080	DNA/hAT-Charlie	713	+	76	87333004	40733
chr16	1	167628	harbor1	chr16	39657	39830	DNA/hAT-Charlie	1042	+	86	39743	39742
chr16	1	167628	harbor1	chr16	40165	40288	DNA/hAT-Charlie	1042	+	62	40227	40226
chr16	1	167628	harbor1	chr16	40285	40459	DNA/hAT-Charlie	705	+	87	40372	40371
chr16	87292307	87492307	harbor1	chr16	87332928	87333080	DNA/hAT-Charlie	713	+	76	87333004	40697
chr16	88756404	88956404	harbor1	chr16	88797555	88797674	DNA/hAT-Charlie	652	+	60	88797615	41211
chr16	88756404	88956404	harbor1	chr16	88797970	88798052	DNA/hAT-Charlie	652	+	41	88798011	41607
chr16	66743175	66943175	harbor1	chr16	66834050	66834120	DNA/hAT-Charlie	750	+	35	66834085	90910
chr16	66743175	66943175	harbor1	chr16	66834417	66834427	DNA/hAT-Charlie	750	+	5	66834422	91247
chr16	66743175	66943175	harbor1	chr16	66834886	66834987	DNA/hAT-Charlie	750	+	50	66834936	91761
chr16	66743175	66943175	harbor1	chr16	66830274	66830476	DNA/hAT-Charlie	860	+	101	66830375	87200
chr16	70586095	70786095	harbor1	chr16	70613517	70613592	DNA/hAT-Charlie	686	+	38	70613555	27460
chr16	70586095	70786095	harbor1	chr16	70613896	70613906	DNA/hAT-Charlie	686	+	5	70613901	27806
chr16	70586095	70786095	harbor1	chr16	70614202	70614299	DNA/hAT-Charlie	686	+	48	70614250	28155
chr16	70586095	70786095	harbor1	chr16	70614314	70614492	DNA/hAT-Charlie	562	+	89	70614403	28308
chr16	1	167557	harbor1	chr16	39657	39830	DNA/hAT-Charlie	1042	+	86	39743	39742
chr16	1	167557	harbor1	chr16	40165	40288	DNA/hAT-Charlie	1042	+	62	40227	40226
chr16	1	167557	harbor1	chr16	40285	40459	DNA/hAT-Charlie	705	+	87	40372	40371
chr16	67352779	67552779	harbor1	chr16	67380809	67380941	DNA/hAT-Charlie	670	+	66	67380875	28096
chr16	57566222	57766222	harbor1	chr16	57589157	57589432	DNA/hAT-Charlie	1670	+	138	57589295	23073
chr16	57566222	57766222	harbor1	chr16	57603755	57604092	DNA/hAT-Charlie	2070	+	168	57603923	37701
chr16	57566222	57766222	harbor1	chr16	57608564	57608915	DNA/hAT-Charlie	710	+	176	57608740	42518
chr16	57566222	57766222	harbor1	chr16	57662420	57662579	DNA/hAT-Charlie	549	+	80	57662500	96278
chr16	70034	270034	harbor1	chr16	127223	127235	DNA/hAT-Charlie	759	+	6	127229	57195
chr16	70034	270034	harbor1	chr16	127535	127654	DNA/hAT-Charlie	759	+	60	127595	57561
chr16	70034	270034	harbor1	chr16	127955	127986	DNA/hAT-Charlie	759	+	16	127971	57937
chr16	70034	270034	harbor1	chr16	128285	128348	DNA/hAT-Charlie	759	+	32	128317	58283
chr16	1	167681	harbor1	chr16	39657	39830	DNA/hAT-Charlie	1042	+	86	39743	39742
chr16	1	167681	harbor1	chr16	40165	40288	DNA/hAT-Charlie	1042	+	62	40227	40226
chr16	1	167681	harbor1	chr16	40285	40459	DNA/hAT-Charlie	705	+	87	40372	40371
chr16	4084073	4284073	harbor1	chr16	4085673	4085842	DNA/hAT-Charlie	592	+	84	4085757	1684
chr16	4084073	4284073	harbor1	chr16	4103264	4103547	DNA/hAT-Charlie	2563	+	142	4103406	19333
chr16	4084073	4284073	harbor1	chr16	4103857	4104450	DNA/hAT-Charlie	2563	+	296	4104153	20080
chr16	4084073	4284073	harbor1	chr16	4104631	4104788	DNA/hAT-Charlie	581	+	78	4104709	20636
chr16	4084073	4284073	harbor1	chr16	4105097	4105330	DNA/hAT-Charlie	994	+	116	4105213	21140
chr16	2369786	2569786	harbor1	chr16	2426896	2427078	DNA/hAT-Charlie	811	+	91	2426987	57201
chr16	57884565	58084565	harbor1	chr16	57935080	57935397	DNA/hAT-Charlie	929	+	158	57935238	50673
chr16	57884565	58084565	harbor1	chr16	57935667	57935683	DNA/hAT-Charlie	929	+	8	57935675	51110
chr16	57884565	58084565	harbor1	chr16	57966724	57966936	DNA/hAT-Charlie	1110	+	106	57966830	82265
chr16	57884565	58084565	harbor1	chr16	57966460	57966695	DNA/hAT-Charlie	1187	+	118	57966578	82013
chr16	2865141	3065141	harbor1	chr16	2875917	2876200	DNA/hAT-Charlie	3238	+	142	2876059	10918
chr16	2865141	3065141	harbor1	chr16	2876509	2876588	DNA/hAT-Charlie	3238	+	40	2876549	11408
chr16	2865141	3065141	harbor1	chr16	2876882	2876913	DNA/hAT-Charlie	3238	+	16	2876898	11757
chr16	2865141	3065141	harbor1	chr16	2877214	2877385	DNA/hAT-Charlie	3238	+	86	2877300	12159
chr16	2865141	3065141	harbor1	chr16	2877991	2878287	DNA/hAT-Charlie	3238	+	148	2878139	12998
chr16	2865141	3065141	harbor1	chr16	2878889	2879008	DNA/hAT-Charlie	3238	+	60	2878949	13808
chr16	2865141	3065141	harbor1	chr16	2879311	2879325	DNA/hAT-Charlie	3238	+	7	2879318	14177
chr16	2865141	3065141	harbor1	chr16	2879584	2879666	DNA/hAT-Charlie	3238	+	41	2879625	14484
chr16	2865141	3065141	harbor1	chr16	2913479	2913659	DNA/hAT-Charlie	789	+	90	2913569	48428
chr16	67574619	67774619	harbor1	chr16	67603014	67603110	DNA/hAT-Charlie	685	+	48	67603062	28443
chr16	67574619	67774619	harbor1	chr16	67604311	67604332	DNA/hAT-Charlie	685	+	10	67604321	29702
chr16	67574619	67774619	harbor1	chr16	67604641	67604730	DNA/hAT-Charlie	685	+	44	67604685	30066
chr16	67574619	67774619	harbor1	chr16	67604765	67604851	DNA/hAT-Charlie	685	+	43	67604808	30189
chr16	78302994	78502994	harbor1	chr16	78334991	78335120	DNA/hAT-Charlie	614	+	64	78335055	32061
chr16	78302994	78502994	harbor1	chr16	78366544	78366758	DNA/hAT-Charlie	673	+	107	78366651	63657
chr16	78302994	78502994	harbor1	chr16	78367307	78367526	DNA/hAT-Charlie	1281	+	110	78367417	64423
chr16	78302994	78502994	harbor1	chr16	78392066	78392595	DNA/hAT-Charlie	3030	+	264	78392330	89336
chr16	47360990	47560990	harbor1	chr16	47371663	47371873	DNA/hAT-Charlie	987	+	105	47371768	10778
chr16	47360990	47560990	harbor1	chr16	47397511	47397712	DNA/hAT-Charlie	919	+	100	47397611	36621
chr16	47360990	47560990	harbor1	chr16	47403910	47404148	DNA/hAT-Charlie	1472	+	119	47404029	43039
chr16	47360990	47560990	harbor1	chr16	47431201	47431549	DNA/hAT-Charlie	2230	+	174	47431375	70385
chr16	47361018	47561018	harbor1	chr16	47371663	47371873	DNA/hAT-Charlie	987	+	105	47371768	10750
chr16	47361018	47561018	harbor1	chr16	47397511	47397712	DNA/hAT-Charlie	919	+	100	47397611	36593
chr16	47361018	47561018	harbor1	chr16	47403910	47404148	DNA/hAT-Charlie	1472	+	119	47404029	43011
chr16	47361018	47561018	harbor1	chr16	47431201	47431549	DNA/hAT-Charlie	2230	+	174	47431375	70357
chr16	2167697	2367697	harbor1	chr16	2241281	2241300	DNA/hAT-Charlie	852	+	10	2241291	73594
chr16	2167697	2367697	harbor1	chr16	2241596	2241692	DNA/hAT-Charlie	852	+	48	2241644	73947
chr16	2167697	2367697	harbor1	chr16	2242293	2242432	DNA/hAT-Charlie	852	+	70	2242363	74666
chr16	92247	292247	harbor1	chr16	127223	127235	DNA/hAT-Charlie	759	+	6	127229	34982
chr16	92247	292247	harbor1	chr16	127535	127654	DNA/hAT-Charlie	759	+	60	127595	35348
chr16	92247	292247	harbor1	chr16	127955	127986	DNA/hAT-Charlie	759	+	16	127971	35724
chr16	92247	292247	harbor1	chr16	128285	128348	DNA/hAT-Charlie	759	+	32	128317	36070
chr16	1001885	1201885	harbor1	chr16	1026321	1026495	DNA/hAT-Charlie	588	+	87	1026408	24523
chr16	73620	273620	harbor1	chr16	127223	127235	DNA/hAT-Charlie	759	+	6	127229	53609
chr16	73620	273620	harbor1	chr16	127535	127654	DNA/hAT-Charlie	759	+	60	127595	53975
chr16	73620	273620	harbor1	chr16	127955	127986	DNA/hAT-Charlie	759	+	16	127971	54351
chr16	73620	273620	harbor1	chr16	128285	128348	DNA/hAT-Charlie	759	+	32	128317	54697
chr16	70586052	70786052	harbor1	chr16	70613517	70613592	DNA/hAT-Charlie	686	+	38	70613555	27503
chr16	70586052	70786052	harbor1	chr16	70613896	70613906	DNA/hAT-Charlie	686	+	5	70613901	27849
chr16	70586052	70786052	harbor1	chr16	70614202	70614299	DNA/hAT-Charlie	686	+	48	70614250	28198
chr16	70586052	70786052	harbor1	chr16	70614314	70614492	DNA/hAT-Charlie	562	+	89	70614403	28351
chr16	47360574	47560574	harbor1	chr16	47371663	47371873	DNA/hAT-Charlie	987	+	105	47371768	11194
chr16	47360574	47560574	harbor1	chr16	47397511	47397712	DNA/hAT-Charlie	919	+	100	47397611	37037
chr16	47360574	47560574	harbor1	chr16	47403910	47404148	DNA/hAT-Charlie	1472	+	119	47404029	43455
chr16	47360574	47560574	harbor1	chr16	47431201	47431549	DNA/hAT-Charlie	2230	+	174	47431375	70801
chr16	2836839	3036839	harbor1	chr16	2875917	2876200	DNA/hAT-Charlie	3238	+	142	2876059	39220
chr16	2836839	3036839	harbor1	chr16	2876509	2876588	DNA/hAT-Charlie	3238	+	40	2876549	39710
chr16	2836839	3036839	harbor1	chr16	2876882	2876913	DNA/hAT-Charlie	3238	+	16	2876898	40059
chr16	2836839	3036839	harbor1	chr16	2877214	2877385	DNA/hAT-Charlie	3238	+	86	2877300	40461
chr16	2836839	3036839	harbor1	chr16	2877991	2878287	DNA/hAT-Charlie	3238	+	148	2878139	41300
chr16	2836839	3036839	harbor1	chr16	2878889	2879008	DNA/hAT-Charlie	3238	+	60	2878949	42110
chr16	2836839	3036839	harbor1	chr16	2879311	2879325	DNA/hAT-Charlie	3238	+	7	2879318	42479
chr16	2836839	3036839	harbor1	chr16	2879584	2879666	DNA/hAT-Charlie	3238	+	41	2879625	42786
chr16	2836839	3036839	harbor1	chr16	2913479	2913659	DNA/hAT-Charlie	789	+	90	2913569	76730
chr16	73663	273663	harbor1	chr16	127223	127235	DNA/hAT-Charlie	759	+	6	127229	53566
chr16	73663	273663	harbor1	chr16	127535	127654	DNA/hAT-Charlie	759	+	60	127595	53932
chr16	73663	273663	harbor1	chr16	127955	127986	DNA/hAT-Charlie	759	+	16	127971	54308
chr16	73663	273663	harbor1	chr16	128285	128348	DNA/hAT-Charlie	759	+	32	128317	54654
chr16	30253473	30453473	harbor1	chr16	30256885	30257271	DNA/hAT-Charlie	1910	+	193	30257078	3605
chr16	979342	1179342	harbor1	chr16	1026321	1026495	DNA/hAT-Charlie	588	+	87	1026408	47066
chr16	56535629	56735629	harbor1	chr16	56549621	56549944	DNA/hAT-Charlie	930	+	162	56549783	14154
chr16	73590	273590	harbor1	chr16	127223	127235	DNA/hAT-Charlie	759	+	6	127229	53639
chr16	73590	273590	harbor1	chr16	127535	127654	DNA/hAT-Charlie	759	+	60	127595	54005
chr16	73590	273590	harbor1	chr16	127955	127986	DNA/hAT-Charlie	759	+	16	127971	54381
chr16	73590	273590	harbor1	chr16	128285	128348	DNA/hAT-Charlie	759	+	32	128317	54727
chr16	47149798	47349798	harbor1	chr16	47191298	47191516	DNA/hAT-Charlie	1579	+	109	47191407	41609
chr16	47149798	47349798	harbor1	chr16	47200728	47200867	DNA/hAT-Charlie	586	+	70	47200798	51000
chr16	47149798	47349798	harbor1	chr16	47220210	47220371	DNA/hAT-Charlie	671	+	80	47220290	70492
chr16	47149798	47349798	harbor1	chr16	47220385	47220788	DNA/hAT-Charlie	2086	+	202	47220587	70789
chr16	47149798	47349798	harbor1	chr16	47226670	47227012	DNA/hAT-Charlie	1108	+	171	47226841	77043
chr16	31032745	31232745	harbor1	chr16	31122469	31122598	DNA/hAT-Charlie	715	+	64	31122533	89788
chr16	31032745	31232745	harbor1	chr16	31122892	31122903	DNA/hAT-Charlie	715	+	6	31122898	90153
chr16	31032745	31232745	harbor1	chr16	31123194	31123216	DNA/hAT-Charlie	715	+	11	31123205	90460
chr16	31032745	31232745	harbor1	chr16	31123805	31123867	DNA/hAT-Charlie	715	+	31	31123836	91091
chr16	1	162045	harbor1	chr16	39657	39830	DNA/hAT-Charlie	1042	+	86	39743	39742
chr16	1	162045	harbor1	chr16	40165	40288	DNA/hAT-Charlie	1042	+	62	40227	40226
chr16	1	162045	harbor1	chr16	40285	40459	DNA/hAT-Charlie	705	+	87	40372	40371
chr16	79500579	79700579	harbor1	chr16	79551620	79551916	DNA/hAT-Charlie	1005	+	148	79551768	51189
chr16	79500579	79700579	harbor1	chr16	79563244	79563454	DNA/hAT-Charlie	824	+	105	79563349	62770
chr16	79500579	79700579	harbor1	chr16	79563453	79563708	DNA/hAT-Charlie	827	+	128	79563581	63002
chr16	31042643	31242643	harbor1	chr16	31122469	31122598	DNA/hAT-Charlie	715	+	64	31122533	79890
chr16	31042643	31242643	harbor1	chr16	31122892	31122903	DNA/hAT-Charlie	715	+	6	31122898	80255
chr16	31042643	31242643	harbor1	chr16	31123194	31123216	DNA/hAT-Charlie	715	+	11	31123205	80562
chr16	31042643	31242643	harbor1	chr16	31123805	31123867	DNA/hAT-Charlie	715	+	31	31123836	81193
chr16	4718894	4918894	harbor1	chr16	4727466	4727636	DNA/hAT-Charlie	813	+	85	4727551	8657
chr16	4718894	4918894	harbor1	chr16	4753659	4753847	DNA/hAT-Charlie	618	+	94	4753753	34859
chr16	4718894	4918894	harbor1	chr16	4771931	4771992	DNA/hAT-Charlie	659	+	30	4771961	53067
chr16	4718894	4918894	harbor1	chr16	4772296	4772416	DNA/hAT-Charlie	659	+	60	4772356	53462
chr16	4718894	4918894	harbor1	chr16	4780389	4780566	DNA/hAT-Charlie	778	+	88	4780477	61583
chr16	4718894	4918894	harbor1	chr16	4806085	4806264	DNA/hAT-Charlie	706	+	90	4806175	87281
chr16	2184827	2384827	harbor1	chr16	2241281	2241300	DNA/hAT-Charlie	852	+	10	2241291	56464
chr16	2184827	2384827	harbor1	chr16	2241596	2241692	DNA/hAT-Charlie	852	+	48	2241644	56817
chr16	2184827	2384827	harbor1	chr16	2242293	2242432	DNA/hAT-Charlie	852	+	70	2242363	57536
chr16	71269697	71469697	harbor1	chr16	71277230	71278516	DNA/hAT-Charlie	5257	+	643	71277873	8176
chr16	71269697	71469697	harbor1	chr16	71343827	71343996	DNA/hAT-Charlie	907	+	84	71343911	74214
chr16	71269697	71469697	harbor1	chr16	71352224	71352403	DNA/hAT-Charlie	709	+	90	71352314	82617
chr16	57884912	58084912	harbor1	chr16	57935080	57935397	DNA/hAT-Charlie	929	+	158	57935238	50326
chr16	57884912	58084912	harbor1	chr16	57935667	57935683	DNA/hAT-Charlie	929	+	8	57935675	50763
chr16	57884912	58084912	harbor1	chr16	57966724	57966936	DNA/hAT-Charlie	1110	+	106	57966830	81918
chr16	57884912	58084912	harbor1	chr16	57966460	57966695	DNA/hAT-Charlie	1187	+	118	57966578	81666
chr16	73025	273025	harbor1	chr16	127223	127235	DNA/hAT-Charlie	759	+	6	127229	54204
chr16	73025	273025	harbor1	chr16	127535	127654	DNA/hAT-Charlie	759	+	60	127595	54570
chr16	73025	273025	harbor1	chr16	127955	127986	DNA/hAT-Charlie	759	+	16	127971	54946
chr16	73025	273025	harbor1	chr16	128285	128348	DNA/hAT-Charlie	759	+	32	128317	55292
chr16	18689988	18889988	harbor1	chr16	18691110	18691265	DNA/hAT-Charlie	553	+	78	18691188	1200
chr16	18689988	18889988	harbor1	chr16	18723302	18723393	DNA/hAT-Charlie	697	+	46	18723348	33360
chr16	18689988	18889988	harbor1	chr16	18723685	18723805	DNA/hAT-Charlie	697	+	60	18723745	33757
chr16	18689988	18889988	harbor1	chr16	18747316	18747749	DNA/hAT-Charlie	1473	+	216	18747532	57544
chr16	18689988	18889988	harbor1	chr16	18748379	18748448	DNA/hAT-Charlie	1473	+	34	18748413	58425
chr16	18689988	18889988	harbor1	chr16	18787240	18787423	DNA/hAT-Charlie	1498	+	92	18787332	97344
chr16	73598	273598	harbor1	chr16	127223	127235	DNA/hAT-Charlie	759	+	6	127229	53631
chr16	73598	273598	harbor1	chr16	127535	127654	DNA/hAT-Charlie	759	+	60	127595	53997
chr16	73598	273598	harbor1	chr16	127955	127986	DNA/hAT-Charlie	759	+	16	127971	54373
chr16	73598	273598	harbor1	chr16	128285	128348	DNA/hAT-Charlie	759	+	32	128317	54719
chr16	1578327	1778327	harbor1	chr16	1603289	1603479	DNA/hAT-Charlie	1773	+	95	1603384	25057
chr16	1578327	1778327	harbor1	chr16	1603781	1604103	DNA/hAT-Charlie	1773	+	161	1603942	25615
chr16	1578327	1778327	harbor1	chr16	1661949	1662159	DNA/hAT-Charlie	844	+	105	1662054	83727
chr16	4084077	4284077	harbor1	chr16	4085673	4085842	DNA/hAT-Charlie	592	+	84	4085757	1680
chr16	4084077	4284077	harbor1	chr16	4103264	4103547	DNA/hAT-Charlie	2563	+	142	4103406	19329
chr16	4084077	4284077	harbor1	chr16	4103857	4104450	DNA/hAT-Charlie	2563	+	296	4104153	20076
chr16	4084077	4284077	harbor1	chr16	4104631	4104788	DNA/hAT-Charlie	581	+	78	4104709	20632
chr16	4084077	4284077	harbor1	chr16	4105097	4105330	DNA/hAT-Charlie	994	+	116	4105213	21136
chr16	30599212	30799212	harbor1	chr16	30638032	30638264	DNA/hAT-Charlie	1195	+	116	30638148	38936
chr16	2721710	2921710	harbor1	chr16	2773182	2773378	DNA/hAT-Charlie	658	+	98	2773280	51570
chr16	28018013	28218013	harbor1	chr16	28028597	28028777	DNA/hAT-Charlie	799	+	90	28028687	10674
chr16	28018013	28218013	harbor1	chr16	28039078	28039267	DNA/hAT-Charlie	578	+	94	28039172	21159
chr16	28018013	28218013	harbor1	chr16	28039308	28039507	DNA/hAT-Charlie	889	+	100	28039408	21395
chr16	28018013	28218013	harbor1	chr16	28080840	28080963	DNA/hAT-Charlie	713	+	62	28080902	62889
chr16	28018013	28218013	harbor1	chr16	28081281	28081424	DNA/hAT-Charlie	713	+	72	28081353	63340
chr16	28018013	28218013	harbor1	chr16	28081836	28081953	DNA/hAT-Charlie	1460	+	58	28081894	63881
chr16	28018013	28218013	harbor1	chr16	28082262	28082321	DNA/hAT-Charlie	1460	+	30	28082292	64279
chr16	28018013	28218013	harbor1	chr16	28082633	28082793	DNA/hAT-Charlie	1460	+	80	28082713	64700
chr16	4084076	4284076	harbor1	chr16	4085673	4085842	DNA/hAT-Charlie	592	+	84	4085757	1681
chr16	4084076	4284076	harbor1	chr16	4103264	4103547	DNA/hAT-Charlie	2563	+	142	4103406	19330
chr16	4084076	4284076	harbor1	chr16	4103857	4104450	DNA/hAT-Charlie	2563	+	296	4104153	20077
chr16	4084076	4284076	harbor1	chr16	4104631	4104788	DNA/hAT-Charlie	581	+	78	4104709	20633
chr16	4084076	4284076	harbor1	chr16	4105097	4105330	DNA/hAT-Charlie	994	+	116	4105213	21137
chr16	88587269	88787269	harbor1	chr16	88593844	88594369	DNA/hAT-Charlie	1376	+	262	88594106	6837
chr16	88587269	88787269	harbor1	chr16	88602437	88602610	DNA/hAT-Charlie	595	+	86	88602523	15254
chr16	29349577	29549577	harbor1	chr16	29415103	29415492	DNA/hAT-Charlie	1938	+	194	29415297	65720
chr16	980073	1180073	harbor1	chr16	1026321	1026495	DNA/hAT-Charlie	588	+	87	1026408	46335
chr16	75147513	75347513	harbor1	chr16	75164632	75164809	DNA/hAT-Charlie	1039	+	88	75164720	17207
chr16	75147513	75347513	harbor1	chr16	75165105	75165281	DNA/hAT-Charlie	1039	+	88	75165193	17680
chr16	75147513	75347513	harbor1	chr16	75198593	75198850	DNA/hAT-Charlie	1209	+	128	75198721	51208
chr16	75147513	75347513	harbor1	chr16	75199164	75199193	DNA/hAT-Charlie	1209	+	14	75199178	51665
chr16	57884931	58084931	harbor1	chr16	57935080	57935397	DNA/hAT-Charlie	929	+	158	57935238	50307
chr16	57884931	58084931	harbor1	chr16	57935667	57935683	DNA/hAT-Charlie	929	+	8	57935675	50744
chr16	57884931	58084931	harbor1	chr16	57966724	57966936	DNA/hAT-Charlie	1110	+	106	57966830	81899
chr16	57884931	58084931	harbor1	chr16	57966460	57966695	DNA/hAT-Charlie	1187	+	118	57966578	81647
chr16	29715614	29915614	harbor1	chr16	29729346	29729535	DNA/hAT-Charlie	760	+	94	29729440	13826
chr16	29715614	29915614	harbor1	chr16	29742025	29742108	DNA/hAT-Charlie	1142	+	42	29742067	26453
chr16	29715614	29915614	harbor1	chr16	29742408	29742672	DNA/hAT-Charlie	1142	+	132	29742540	26926
chr16	29715614	29915614	harbor1	chr16	29788021	29788226	DNA/hAT-Charlie	946	+	102	29788123	72509
chr16	29715614	29915614	harbor1	chr16	29793576	29793781	DNA/hAT-Charlie	1004	+	102	29793678	78064
chr16	29715614	29915614	harbor1	chr16	29796572	29796696	DNA/hAT-Charlie	634	+	62	29796634	81020
chr16	29715614	29915614	harbor1	chr16	29797539	29797741	DNA/hAT-Charlie	889	+	101	29797640	82026
chr16	75364612	75564612	harbor1	chr16	75364385	75364891	DNA/hAT-Charlie	2013	+	253	75364638	26
chr16	75364612	75564612	harbor1	chr16	75391431	75391683	DNA/hAT-Charlie	637	+	126	75391557	26945
chr16	75364612	75564612	harbor1	chr16	75405001	75405340	DNA/hAT-Charlie	1259	+	170	75405171	40559
chr16	75364612	75564612	harbor1	chr16	75407339	75407394	DNA/hAT-Charlie	710	+	28	75407367	42755
chr16	75364612	75564612	harbor1	chr16	75407685	75407824	DNA/hAT-Charlie	710	+	70	75407755	43143
chr16	75364612	75564612	harbor1	chr16	75408196	75408497	DNA/hAT-Charlie	870	+	150	75408346	43734
chr16	75364612	75564612	harbor1	chr16	75408798	75408857	DNA/hAT-Charlie	870	+	30	75408828	44216
chr16	75364612	75564612	harbor1	chr16	75409159	75409318	DNA/hAT-Charlie	870	+	80	75409239	44627
chr16	75364612	75564612	harbor1	chr16	75442256	75442453	DNA/hAT-Charlie	717	+	98	75442354	77742
chr16	75364612	75564612	harbor1	chr16	75452942	75453084	DNA/hAT-Charlie	718	+	71	75453013	88401
chr16	85541766	85741766	harbor1	chr16	85543784	85543842	DNA/hAT-Charlie	1019	+	29	85543813	2047
chr16	85541766	85741766	harbor1	chr16	85544130	85544292	DNA/hAT-Charlie	1019	+	81	85544211	2445
chr16	85541766	85741766	harbor1	chr16	85591854	85592045	DNA/hAT-Charlie	648	+	96	85591950	50184
chr16	1	167574	harbor1	chr16	39657	39830	DNA/hAT-Charlie	1042	+	86	39743	39742
chr16	1	167574	harbor1	chr16	40165	40288	DNA/hAT-Charlie	1042	+	62	40227	40226
chr16	1	167574	harbor1	chr16	40285	40459	DNA/hAT-Charlie	705	+	87	40372	40371
chr16	57884956	58084956	harbor1	chr16	57935080	57935397	DNA/hAT-Charlie	929	+	158	57935238	50282
chr16	57884956	58084956	harbor1	chr16	57935667	57935683	DNA/hAT-Charlie	929	+	8	57935675	50719
chr16	57884956	58084956	harbor1	chr16	57966724	57966936	DNA/hAT-Charlie	1110	+	106	57966830	81874
chr16	57884956	58084956	harbor1	chr16	57966460	57966695	DNA/hAT-Charlie	1187	+	118	57966578	81622
chr16	2865156	3065156	harbor1	chr16	2875917	2876200	DNA/hAT-Charlie	3238	+	142	2876059	10903
chr16	2865156	3065156	harbor1	chr16	2876509	2876588	DNA/hAT-Charlie	3238	+	40	2876549	11393
chr16	2865156	3065156	harbor1	chr16	2876882	2876913	DNA/hAT-Charlie	3238	+	16	2876898	11742
chr16	2865156	3065156	harbor1	chr16	2877214	2877385	DNA/hAT-Charlie	3238	+	86	2877300	12144
chr16	2865156	3065156	harbor1	chr16	2877991	2878287	DNA/hAT-Charlie	3238	+	148	2878139	12983
chr16	2865156	3065156	harbor1	chr16	2878889	2879008	DNA/hAT-Charlie	3238	+	60	2878949	13793
chr16	2865156	3065156	harbor1	chr16	2879311	2879325	DNA/hAT-Charlie	3238	+	7	2879318	14162
chr16	2865156	3065156	harbor1	chr16	2879584	2879666	DNA/hAT-Charlie	3238	+	41	2879625	14469
chr16	2865156	3065156	harbor1	chr16	2913479	2913659	DNA/hAT-Charlie	789	+	90	2913569	48413
chr16	1	167633	harbor1	chr16	39657	39830	DNA/hAT-Charlie	1042	+	86	39743	39742
chr16	1	167633	harbor1	chr16	40165	40288	DNA/hAT-Charlie	1042	+	62	40227	40226
chr16	1	167633	harbor1	chr16	40285	40459	DNA/hAT-Charlie	705	+	87	40372	40371
chr16	54828772	55028772	harbor1	chr16	54833040	54833233	DNA/hAT-Charlie	995	+	96	54833136	4364
chr16	54828772	55028772	harbor1	chr16	54863582	54863698	DNA/hAT-Charlie	555	+	58	54863640	34868
chr16	54828772	55028772	harbor1	chr16	54897106	54897304	DNA/hAT-Charlie	642	+	99	54897205	68433
chr16	57884909	58084909	harbor1	chr16	57935080	57935397	DNA/hAT-Charlie	929	+	158	57935238	50329
chr16	57884909	58084909	harbor1	chr16	57935667	57935683	DNA/hAT-Charlie	929	+	8	57935675	50766
chr16	57884909	58084909	harbor1	chr16	57966724	57966936	DNA/hAT-Charlie	1110	+	106	57966830	81921
chr16	57884909	58084909	harbor1	chr16	57966460	57966695	DNA/hAT-Charlie	1187	+	118	57966578	81669
chr16	87748370	87948370	harbor1	chr16	87807559	87807583	DNA/hAT-Charlie	669	+	12	87807571	59201
chr16	87748370	87948370	harbor1	chr16	87808090	87808264	DNA/hAT-Charlie	669	+	87	87808177	59807
chr16	87284537	87484537	harbor1	chr16	87287752	87287992	DNA/hAT-Charlie	1504	+	120	87287872	3335
chr16	87284537	87484537	harbor1	chr16	87332928	87333080	DNA/hAT-Charlie	713	+	76	87333004	48467
chr16	70635515	70835515	harbor1	chr16	70729056	70729271	DNA/hAT-Charlie	983	+	108	70729164	93649
chr16	2865150	3065150	harbor1	chr16	2875917	2876200	DNA/hAT-Charlie	3238	+	142	2876059	10909
chr16	2865150	3065150	harbor1	chr16	2876509	2876588	DNA/hAT-Charlie	3238	+	40	2876549	11399
chr16	2865150	3065150	harbor1	chr16	2876882	2876913	DNA/hAT-Charlie	3238	+	16	2876898	11748
chr16	2865150	3065150	harbor1	chr16	2877214	2877385	DNA/hAT-Charlie	3238	+	86	2877300	12150
chr16	2865150	3065150	harbor1	chr16	2877991	2878287	DNA/hAT-Charlie	3238	+	148	2878139	12989
chr16	2865150	3065150	harbor1	chr16	2878889	2879008	DNA/hAT-Charlie	3238	+	60	2878949	13799
chr16	2865150	3065150	harbor1	chr16	2879311	2879325	DNA/hAT-Charlie	3238	+	7	2879318	14168
chr16	2865150	3065150	harbor1	chr16	2879584	2879666	DNA/hAT-Charlie	3238	+	41	2879625	14475
chr16	2865150	3065150	harbor1	chr16	2913479	2913659	DNA/hAT-Charlie	789	+	90	2913569	48419
chr16	1688539	1888539	harbor1	chr16	1713116	1713254	DNA/hAT-Charlie	747	+	69	1713185	24646
chr16	1688539	1888539	harbor1	chr16	1713383	1713438	DNA/hAT-Charlie	747	+	28	1713411	24872
chr17	79709440	79909440	harbor1	chr17	79748758	79749189	DNA/hAT-Charlie	1257	+	216	79748974	39534
chr17	79709440	79909440	harbor1	chr17	79788591	79788798	DNA/hAT-Charlie	773	+	104	79788695	79255
chr17	7461503	7661503	harbor1	chr17	7489329	7489784	DNA/hAT-Charlie	1746	+	228	7489557	28054
chr17	7461503	7661503	harbor1	chr17	7490077	7490165	DNA/hAT-Charlie	1746	+	44	7490121	28618
chr17	76637323	76837323	harbor1	chr17	76722089	76722256	DNA/hAT-Charlie	845	+	84	76722173	84850
chr17	76637252	76837252	harbor1	chr17	76722089	76722256	DNA/hAT-Charlie	845	+	84	76722173	84921
chr17	79702953	79902953	harbor1	chr17	79748758	79749189	DNA/hAT-Charlie	1257	+	216	79748974	46021
chr17	79702953	79902953	harbor1	chr17	79788591	79788798	DNA/hAT-Charlie	773	+	104	79788695	85742
chr17	55165220	55365220	harbor1	chr17	55172229	55172377	DNA/hAT-Charlie	646	+	74	55172303	7083
chr17	2838072	3038072	harbor1	chr17	2838697	2838984	DNA/hAT-Charlie	1093	+	144	2838841	769
chr17	2838072	3038072	harbor1	chr17	2849895	2849999	DNA/hAT-Charlie	778	+	52	2849947	11875
chr17	2838072	3038072	harbor1	chr17	2850300	2850467	DNA/hAT-Charlie	778	+	84	2850384	12312
chr17	2838072	3038072	harbor1	chr17	2851086	2851190	DNA/hAT-Charlie	778	+	52	2851138	13066
chr17	2838072	3038072	harbor1	chr17	2855236	2855603	DNA/hAT-Charlie	1553	+	184	2855420	17348
chr17	2838072	3038072	harbor1	chr17	2855913	2856005	DNA/hAT-Charlie	1553	+	46	2855959	17887
chr17	2838072	3038072	harbor1	chr17	2907703	2907811	DNA/hAT-Charlie	754	+	54	2907757	69685
chr17	2838072	3038072	harbor1	chr17	2908105	2908169	DNA/hAT-Charlie	754	+	32	2908137	70065
chr17	987890	1187890	harbor1	chr17	1085605	1085864	DNA/hAT-Charlie	1173	+	130	1085735	97845
chr17	987890	1187890	harbor1	chr17	1086163	1086223	DNA/hAT-Charlie	1173	+	30	1086193	98303
chr17	58388439	58588439	harbor1	chr17	58466410	58466589	DNA/hAT-Charlie	656	+	90	58466500	78061
chr17	58388439	58588439	harbor1	chr17	58466566	58466687	DNA/hAT-Charlie	753	+	60	58466626	78187
chr17	2838075	3038075	harbor1	chr17	2838697	2838984	DNA/hAT-Charlie	1093	+	144	2838841	766
chr17	2838075	3038075	harbor1	chr17	2849895	2849999	DNA/hAT-Charlie	778	+	52	2849947	11872
chr17	2838075	3038075	harbor1	chr17	2850300	2850467	DNA/hAT-Charlie	778	+	84	2850384	12309
chr17	2838075	3038075	harbor1	chr17	2851086	2851190	DNA/hAT-Charlie	778	+	52	2851138	13063
chr17	2838075	3038075	harbor1	chr17	2855236	2855603	DNA/hAT-Charlie	1553	+	184	2855420	17345
chr17	2838075	3038075	harbor1	chr17	2855913	2856005	DNA/hAT-Charlie	1553	+	46	2855959	17884
chr17	2838075	3038075	harbor1	chr17	2907703	2907811	DNA/hAT-Charlie	754	+	54	2907757	69682
chr17	2838075	3038075	harbor1	chr17	2908105	2908169	DNA/hAT-Charlie	754	+	32	2908137	70062
chr17	7461829	7661829	harbor1	chr17	7489329	7489784	DNA/hAT-Charlie	1746	+	228	7489557	27728
chr17	7461829	7661829	harbor1	chr17	7490077	7490165	DNA/hAT-Charlie	1746	+	44	7490121	28292
chr17	7461828	7661828	harbor1	chr17	7489329	7489784	DNA/hAT-Charlie	1746	+	228	7489557	27729
chr17	7461828	7661828	harbor1	chr17	7490077	7490165	DNA/hAT-Charlie	1746	+	44	7490121	28293
chr17	76768659	76968659	harbor1	chr17	76835668	76835768	DNA/hAT-Charlie	1142	+	50	76835718	67059
chr17	76768659	76968659	harbor1	chr17	76836059	76836328	DNA/hAT-Charlie	1142	+	134	76836193	67534
chr17	76768659	76968659	harbor1	chr17	76839406	76839510	DNA/hAT-Charlie	605	+	52	76839458	70799
chr17	76768659	76968659	harbor1	chr17	76839823	76839910	DNA/hAT-Charlie	605	+	44	76839867	71208
chr17	76637238	76837238	harbor1	chr17	76722089	76722256	DNA/hAT-Charlie	845	+	84	76722173	84935
chr17	29477937	29677937	harbor1	chr17	29480982	29481195	DNA/hAT-Charlie	1106	+	106	29481088	3151
chr17	7461853	7661853	harbor1	chr17	7489329	7489784	DNA/hAT-Charlie	1746	+	228	7489557	27704
chr17	7461853	7661853	harbor1	chr17	7490077	7490165	DNA/hAT-Charlie	1746	+	44	7490121	28268
chr17	76637301	76837301	harbor1	chr17	76722089	76722256	DNA/hAT-Charlie	845	+	84	76722173	84872
chr17	76637314	76837314	harbor1	chr17	76722089	76722256	DNA/hAT-Charlie	845	+	84	76722173	84859
chr17	7461830	7661830	harbor1	chr17	7489329	7489784	DNA/hAT-Charlie	1746	+	228	7489557	27727
chr17	7461830	7661830	harbor1	chr17	7490077	7490165	DNA/hAT-Charlie	1746	+	44	7490121	28291
chr17	80624434	80824434	harbor1	chr17	80642422	80643176	DNA/hAT-Charlie	3545	+	377	80642799	18365
chr17	80624434	80824434	harbor1	chr17	80641960	80642124	DNA/hAT-Charlie	3545	+	82	80642042	17608
chr17	79702897	79902897	harbor1	chr17	79748758	79749189	DNA/hAT-Charlie	1257	+	216	79748974	46077
chr17	79702897	79902897	harbor1	chr17	79788591	79788798	DNA/hAT-Charlie	773	+	104	79788695	85798
chr17	64956159	65156159	harbor1	chr17	64965414	64965718	DNA/hAT-Charlie	1500	+	152	64965566	9407
chr17	64956159	65156159	harbor1	chr17	65000900	65001425	DNA/hAT-Charlie	4042	+	262	65001162	45003
chr17	64956159	65156159	harbor1	chr17	65022034	65023974	DNA/hAT-Charlie	9929	+	970	65023004	66845
chr17	64956159	65156159	harbor1	chr17	65024264	65024580	DNA/hAT-Charlie	9929	+	158	65024422	68263
chr17	41209190	41409190	harbor1	chr17	41298182	41298206	DNA/hAT-Charlie	982	+	12	41298194	89004
chr17	41209190	41409190	harbor1	chr17	41298995	41299201	DNA/hAT-Charlie	982	+	103	41299098	89908
chr17	41209190	41409190	harbor1	chr17	41306097	41306310	DNA/hAT-Charlie	1165	+	106	41306203	97013
chr17	43299144	43499144	harbor1	chr17	43382879	43383037	DNA/hAT-Charlie	705	+	79	43382958	83814
chr17	18132683	18332683	harbor1	chr17	18215539	18215716	DNA/hAT-Charlie	779	+	88	18215627	82944
chr17	18132683	18332683	harbor1	chr17	18216010	18216031	DNA/hAT-Charlie	779	+	10	18216020	83337
chr17	79702898	79902898	harbor1	chr17	79748758	79749189	DNA/hAT-Charlie	1257	+	216	79748974	46076
chr17	79702898	79902898	harbor1	chr17	79788591	79788798	DNA/hAT-Charlie	773	+	104	79788695	85797
chr17	48339875	48539875	harbor1	chr17	48365839	48366036	DNA/hAT-Charlie	1486	+	98	48365937	26062
chr17	48339875	48539875	harbor1	chr17	48423513	48423665	DNA/hAT-Charlie	767	+	76	48423589	83714
chr17	48339875	48539875	harbor1	chr17	48398057	48398604	DNA/hAT-Charlie	3782	+	274	48398331	58456
chr17	39654933	39854933	harbor1	chr17	39699577	39699840	DNA/hAT-Charlie	672	+	132	39699709	44776
chr17	7461823	7661823	harbor1	chr17	7489329	7489784	DNA/hAT-Charlie	1746	+	228	7489557	27734
chr17	7461823	7661823	harbor1	chr17	7490077	7490165	DNA/hAT-Charlie	1746	+	44	7490121	28298
chr17	76637283	76837283	harbor1	chr17	76722089	76722256	DNA/hAT-Charlie	845	+	84	76722173	84890
chr17	76768658	76968658	harbor1	chr17	76835668	76835768	DNA/hAT-Charlie	1142	+	50	76835718	67060
chr17	76768658	76968658	harbor1	chr17	76836059	76836328	DNA/hAT-Charlie	1142	+	134	76836193	67535
chr17	76768658	76968658	harbor1	chr17	76839406	76839510	DNA/hAT-Charlie	605	+	52	76839458	70800
chr17	76768658	76968658	harbor1	chr17	76839823	76839910	DNA/hAT-Charlie	605	+	44	76839867	71209
chr17	7461898	7661898	harbor1	chr17	7489329	7489784	DNA/hAT-Charlie	1746	+	228	7489557	27659
chr17	7461898	7661898	harbor1	chr17	7490077	7490165	DNA/hAT-Charlie	1746	+	44	7490121	28223
chr17	39654786	39854786	harbor1	chr17	39699577	39699840	DNA/hAT-Charlie	672	+	132	39699709	44923
chr17	7461905	7661905	harbor1	chr17	7489329	7489784	DNA/hAT-Charlie	1746	+	228	7489557	27652
chr17	7461905	7661905	harbor1	chr17	7490077	7490165	DNA/hAT-Charlie	1746	+	44	7490121	28216
chr17	56020599	56220599	harbor1	chr17	56030089	56030316	DNA/hAT-Charlie	944	+	114	56030203	9604
chr17	56020599	56220599	harbor1	chr17	56066320	56066581	DNA/hAT-Charlie	1302	+	130	56066450	45851
chr17	56020599	56220599	harbor1	chr17	56067302	56067393	DNA/hAT-Charlie	1302	+	46	56067348	46749
chr17	56020599	56220599	harbor1	chr17	56087690	56087899	DNA/hAT-Charlie	904	+	104	56087794	67195
chr17	56020599	56220599	harbor1	chr17	56105806	56106018	DNA/hAT-Charlie	721	+	106	56105912	85313
chr17	7461897	7661897	harbor1	chr17	7489329	7489784	DNA/hAT-Charlie	1746	+	228	7489557	27660
chr17	7461897	7661897	harbor1	chr17	7490077	7490165	DNA/hAT-Charlie	1746	+	44	7490121	28224
chr17	78924128	79124128	harbor1	chr17	79002104	79002255	DNA/hAT-Charlie	983	+	76	79002180	78052
chr17	7142998	7342998	harbor1	chr17	7201328	7201532	DNA/hAT-Charlie	808	+	102	7201430	58432
chr17	79702899	79902899	harbor1	chr17	79748758	79749189	DNA/hAT-Charlie	1257	+	216	79748974	46075
chr17	79702899	79902899	harbor1	chr17	79788591	79788798	DNA/hAT-Charlie	773	+	104	79788695	85796
chr17	7461844	7661844	harbor1	chr17	7489329	7489784	DNA/hAT-Charlie	1746	+	228	7489557	27713
chr17	7461844	7661844	harbor1	chr17	7490077	7490165	DNA/hAT-Charlie	1746	+	44	7490121	28277
chr17	67266541	67466541	harbor1	chr17	67276937	67277328	DNA/hAT-Charlie	1372	+	196	67277133	10592
chr17	67266541	67466541	harbor1	chr17	67277503	67277599	DNA/hAT-Charlie	1372	+	48	67277551	11010
chr17	67266541	67466541	harbor1	chr17	67286154	67286231	DNA/hAT-Charlie	1093	+	38	67286192	19651
chr17	67266541	67466541	harbor1	chr17	67286535	67286573	DNA/hAT-Charlie	1093	+	19	67286554	20013
chr17	67266541	67466541	harbor1	chr17	67286873	67287008	DNA/hAT-Charlie	1093	+	68	67286941	20400
chr17	67266541	67466541	harbor1	chr17	67287298	67287490	DNA/hAT-Charlie	1093	+	96	67287394	20853
chr17	67266541	67466541	harbor1	chr17	67336878	67337054	DNA/hAT-Charlie	686	+	88	67336966	70425
chr17	67266541	67466541	harbor1	chr17	67357794	67357916	DNA/hAT-Charlie	603	+	61	67357855	91314
chr17	67266541	67466541	harbor1	chr17	67358221	67358285	DNA/hAT-Charlie	603	+	32	67358253	91712
chr17	67266541	67466541	harbor1	chr17	67358598	67358724	DNA/hAT-Charlie	603	+	63	67358661	92120
chr17	7461836	7661836	harbor1	chr17	7489329	7489784	DNA/hAT-Charlie	1746	+	228	7489557	27721
chr17	7461836	7661836	harbor1	chr17	7490077	7490165	DNA/hAT-Charlie	1746	+	44	7490121	28285
chr17	79689709	79889709	harbor1	chr17	79748758	79749189	DNA/hAT-Charlie	1257	+	216	79748974	59265
chr17	79689709	79889709	harbor1	chr17	79788591	79788798	DNA/hAT-Charlie	773	+	104	79788695	98986
chr17	2838074	3038074	harbor1	chr17	2838697	2838984	DNA/hAT-Charlie	1093	+	144	2838841	767
chr17	2838074	3038074	harbor1	chr17	2849895	2849999	DNA/hAT-Charlie	778	+	52	2849947	11873
chr17	2838074	3038074	harbor1	chr17	2850300	2850467	DNA/hAT-Charlie	778	+	84	2850384	12310
chr17	2838074	3038074	harbor1	chr17	2851086	2851190	DNA/hAT-Charlie	778	+	52	2851138	13064
chr17	2838074	3038074	harbor1	chr17	2855236	2855603	DNA/hAT-Charlie	1553	+	184	2855420	17346
chr17	2838074	3038074	harbor1	chr17	2855913	2856005	DNA/hAT-Charlie	1553	+	46	2855959	17885
chr17	2838074	3038074	harbor1	chr17	2907703	2907811	DNA/hAT-Charlie	754	+	54	2907757	69683
chr17	2838074	3038074	harbor1	chr17	2908105	2908169	DNA/hAT-Charlie	754	+	32	2908137	70063
chr17	82589285	82789285	harbor1	chr17	82642151	82642464	DNA/hAT-Charlie	1717	+	156	82642307	53022
chr17	79743478	79943478	harbor1	chr17	79748758	79749189	DNA/hAT-Charlie	1257	+	216	79748974	5496
chr17	79743478	79943478	harbor1	chr17	79788591	79788798	DNA/hAT-Charlie	773	+	104	79788695	45217
chr17	64956153	65156153	harbor1	chr17	64965414	64965718	DNA/hAT-Charlie	1500	+	152	64965566	9413
chr17	64956153	65156153	harbor1	chr17	65000900	65001425	DNA/hAT-Charlie	4042	+	262	65001162	45009
chr17	64956153	65156153	harbor1	chr17	65022034	65023974	DNA/hAT-Charlie	9929	+	970	65023004	66851
chr17	64956153	65156153	harbor1	chr17	65024264	65024580	DNA/hAT-Charlie	9929	+	158	65024422	68269
chr17	76283247	76483247	harbor1	chr17	76368530	76368731	DNA/hAT-Charlie	982	+	100	76368630	85383
chr17	58416995	58616995	harbor1	chr17	58466410	58466589	DNA/hAT-Charlie	656	+	90	58466500	49505
chr17	58416995	58616995	harbor1	chr17	58466566	58466687	DNA/hAT-Charlie	753	+	60	58466626	49631
chr17	58416995	58616995	harbor1	chr17	58493241	58493354	DNA/hAT-Charlie	1339	+	56	58493297	76302
chr17	58416995	58616995	harbor1	chr17	58493653	58493773	DNA/hAT-Charlie	1339	+	60	58493713	76718
chr17	44870431	45070431	harbor1	chr17	44888290	44888420	DNA/hAT-Charlie	722	+	65	44888355	17924
chr17	44870431	45070431	harbor1	chr17	44895021	44895213	DNA/hAT-Charlie	1505	+	96	44895117	24686
chr17	44870431	45070431	harbor1	chr17	44895517	44895670	DNA/hAT-Charlie	1505	+	76	44895593	25162
chr17	76637247	76837247	harbor1	chr17	76722089	76722256	DNA/hAT-Charlie	845	+	84	76722173	84926
chr17	17393446	17593446	harbor1	chr17	17419342	17419621	DNA/hAT-Charlie	1803	+	140	17419482	26036
chr17	17393446	17593446	harbor1	chr17	17451234	17451396	DNA/hAT-Charlie	633	+	81	17451315	57869
chr17	17393446	17593446	harbor1	chr17	17473577	17473807	DNA/hAT-Charlie	1292	+	115	17473692	80246
chr17	17393446	17593446	harbor1	chr17	17474106	17474165	DNA/hAT-Charlie	1292	+	30	17474136	80690
chr17	7461870	7661870	harbor1	chr17	7489329	7489784	DNA/hAT-Charlie	1746	+	228	7489557	27687
chr17	7461870	7661870	harbor1	chr17	7490077	7490165	DNA/hAT-Charlie	1746	+	44	7490121	28251
chr17	30610000	30810000	harbor1	chr17	30696089	30696276	DNA/hAT-Charlie	830	+	94	30696183	86183
chr17	1548006	1748006	harbor1	chr17	1641118	1641525	DNA/hAT-Charlie	2255	+	204	1641322	93316
chr17	63600181	63800181	harbor1	chr17	63634992	63635174	DNA/hAT-Charlie	1053	+	91	63635083	34902
chr17	63600181	63800181	harbor1	chr17	63644529	63644645	DNA/hAT-Charlie	670	+	58	63644587	44406
chr17	63600181	63800181	harbor1	chr17	63649003	63649154	DNA/hAT-Charlie	899	+	76	63649079	48898
chr17	63600181	63800181	harbor1	chr17	63649705	63649785	DNA/hAT-Charlie	899	+	40	63649745	49564
chr17	63600181	63800181	harbor1	chr17	63671184	63671252	DNA/hAT-Charlie	834	+	34	63671218	71037
chr17	63600181	63800181	harbor1	chr17	63671554	63671708	DNA/hAT-Charlie	834	+	77	63671631	71450
chr17	7461914	7661914	harbor1	chr17	7489329	7489784	DNA/hAT-Charlie	1746	+	228	7489557	27643
chr17	7461914	7661914	harbor1	chr17	7490077	7490165	DNA/hAT-Charlie	1746	+	44	7490121	28207
chr17	39654848	39854848	harbor1	chr17	39699577	39699840	DNA/hAT-Charlie	672	+	132	39699709	44861
chr17	79696398	79896398	harbor1	chr17	79748758	79749189	DNA/hAT-Charlie	1257	+	216	79748974	52576
chr17	79696398	79896398	harbor1	chr17	79788591	79788798	DNA/hAT-Charlie	773	+	104	79788695	92297
chr17	76768628	76968628	harbor1	chr17	76835668	76835768	DNA/hAT-Charlie	1142	+	50	76835718	67090
chr17	76768628	76968628	harbor1	chr17	76836059	76836328	DNA/hAT-Charlie	1142	+	134	76836193	67565
chr17	76768628	76968628	harbor1	chr17	76839406	76839510	DNA/hAT-Charlie	605	+	52	76839458	70830
chr17	76768628	76968628	harbor1	chr17	76839823	76839910	DNA/hAT-Charlie	605	+	44	76839867	71239
chr17	76768654	76968654	harbor1	chr17	76835668	76835768	DNA/hAT-Charlie	1142	+	50	76835718	67064
chr17	76768654	76968654	harbor1	chr17	76836059	76836328	DNA/hAT-Charlie	1142	+	134	76836193	67539
chr17	76768654	76968654	harbor1	chr17	76839406	76839510	DNA/hAT-Charlie	605	+	52	76839458	70804
chr17	76768654	76968654	harbor1	chr17	76839823	76839910	DNA/hAT-Charlie	605	+	44	76839867	71213
chr17	7461805	7661805	harbor1	chr17	7489329	7489784	DNA/hAT-Charlie	1746	+	228	7489557	27752
chr17	7461805	7661805	harbor1	chr17	7490077	7490165	DNA/hAT-Charlie	1746	+	44	7490121	28316
chr17	15555287	15755287	harbor1	chr17	15599238	15599454	DNA/hAT-Charlie	1156	+	108	15599346	44059
chr17	15555287	15755287	harbor1	chr17	15611325	15611623	DNA/hAT-Charlie	703	+	149	15611474	56187
chr17	15555287	15755287	harbor1	chr17	15617973	15618047	DNA/hAT-Charlie	699	+	37	15618010	62723
chr17	15555287	15755287	harbor1	chr17	15618341	15618455	DNA/hAT-Charlie	699	+	57	15618398	63111
chr17	76283501	76483501	harbor1	chr17	76368530	76368731	DNA/hAT-Charlie	982	+	100	76368630	85129
chr17	33191683	33391683	harbor1	chr17	33192670	33192988	DNA/hAT-Charlie	1085	+	159	33192829	1146
chr17	33191683	33391683	harbor1	chr17	33276973	33277120	DNA/hAT-Charlie	688	+	74	33277047	85364
chr17	33191683	33391683	harbor1	chr17	33283307	33283461	DNA/hAT-Charlie	672	+	77	33283384	91701
chr17	33191705	33391705	harbor1	chr17	33192670	33192988	DNA/hAT-Charlie	1085	+	159	33192829	1124
chr17	33191705	33391705	harbor1	chr17	33276973	33277120	DNA/hAT-Charlie	688	+	74	33277047	85342
chr17	33191705	33391705	harbor1	chr17	33283307	33283461	DNA/hAT-Charlie	672	+	77	33283384	91679
chr17	43590747	43790747	harbor1	chr17	43642888	43643026	DNA/hAT-Charlie	651	+	69	43642957	52210
chr17	43590747	43790747	harbor1	chr17	43643328	43643378	DNA/hAT-Charlie	651	+	25	43643353	52606
chr17	43590747	43790747	harbor1	chr17	43644031	43644194	DNA/hAT-Charlie	950	+	82	43644113	53366
chr17	8023310	8223310	harbor1	chr17	8027454	8027629	DNA/hAT-Charlie	591	+	88	8027542	4232
chr17	8023310	8223310	harbor1	chr17	8035231	8035378	DNA/hAT-Charlie	603	+	74	8035305	11995
chr17	8023310	8223310	harbor1	chr17	8040090	8040253	DNA/hAT-Charlie	612	+	82	8040172	16862
chr17	286286	486286	harbor1	chr17	343642	343841	DNA/hAT-Charlie	845	+	100	343742	57456
chr17	57767550	57967550	harbor1	chr17	57778343	57778559	DNA/hAT-Charlie	985	+	108	57778451	10901
chr17	57767550	57967550	harbor1	chr17	57808067	57808408	DNA/hAT-Charlie	2300	+	170	57808237	40687
chr17	57767550	57967550	harbor1	chr17	57859248	57859396	DNA/hAT-Charlie	679	+	74	57859322	91772
chr17	987847	1187847	harbor1	chr17	1085605	1085864	DNA/hAT-Charlie	1173	+	130	1085735	97888
chr17	987847	1187847	harbor1	chr17	1086163	1086223	DNA/hAT-Charlie	1173	+	30	1086193	98346
chr17	38631460	38831460	harbor1	chr17	38636141	38636513	DNA/hAT-Charlie	1934	+	186	38636327	4867
chr17	41516785	41716785	harbor1	chr17	41574318	41574349	DNA/hAT-Charlie	920	+	16	41574334	57549
chr17	41516785	41716785	harbor1	chr17	41574658	41574985	DNA/hAT-Charlie	920	+	164	41574822	58037
chr17	7461864	7661864	harbor1	chr17	7489329	7489784	DNA/hAT-Charlie	1746	+	228	7489557	27693
chr17	7461864	7661864	harbor1	chr17	7490077	7490165	DNA/hAT-Charlie	1746	+	44	7490121	28257
chr17	57827332	58027332	harbor1	chr17	57859248	57859396	DNA/hAT-Charlie	679	+	74	57859322	31990
chr17	57827332	58027332	harbor1	chr17	57918169	57918455	DNA/hAT-Charlie	706	+	143	57918312	90980
chr17	57827332	58027332	harbor1	chr17	57918598	57918780	DNA/hAT-Charlie	713	+	91	57918689	91357
chr17	57827332	58027332	harbor1	chr17	57920168	57920332	DNA/hAT-Charlie	783	+	82	57920250	92918
chr17	987852	1187852	harbor1	chr17	1085605	1085864	DNA/hAT-Charlie	1173	+	130	1085735	97883
chr17	987852	1187852	harbor1	chr17	1086163	1086223	DNA/hAT-Charlie	1173	+	30	1086193	98341
chr17	79702893	79902893	harbor1	chr17	79748758	79749189	DNA/hAT-Charlie	1257	+	216	79748974	46081
chr17	79702893	79902893	harbor1	chr17	79788591	79788798	DNA/hAT-Charlie	773	+	104	79788695	85802
chr17	79702970	79902970	harbor1	chr17	79748758	79749189	DNA/hAT-Charlie	1257	+	216	79748974	46004
chr17	79702970	79902970	harbor1	chr17	79788591	79788798	DNA/hAT-Charlie	773	+	104	79788695	85725
chr17	31921178	32121178	harbor1	chr17	31935484	31935667	DNA/hAT-Charlie	870	+	92	31935576	14398
chr17	31921178	32121178	harbor1	chr17	31987591	31987648	DNA/hAT-Charlie	676	+	28	31987619	66441
chr17	31921178	32121178	harbor1	chr17	31987953	31988200	DNA/hAT-Charlie	676	+	124	31988077	66899
chr17	78924157	79124157	harbor1	chr17	79002104	79002255	DNA/hAT-Charlie	983	+	76	79002180	78023
chr17	2829895	3029895	harbor1	chr17	2838697	2838984	DNA/hAT-Charlie	1093	+	144	2838841	8946
chr17	2829895	3029895	harbor1	chr17	2849895	2849999	DNA/hAT-Charlie	778	+	52	2849947	20052
chr17	2829895	3029895	harbor1	chr17	2850300	2850467	DNA/hAT-Charlie	778	+	84	2850384	20489
chr17	2829895	3029895	harbor1	chr17	2851086	2851190	DNA/hAT-Charlie	778	+	52	2851138	21243
chr17	2829895	3029895	harbor1	chr17	2855236	2855603	DNA/hAT-Charlie	1553	+	184	2855420	25525
chr17	2829895	3029895	harbor1	chr17	2855913	2856005	DNA/hAT-Charlie	1553	+	46	2855959	26064
chr17	2829895	3029895	harbor1	chr17	2907703	2907811	DNA/hAT-Charlie	754	+	54	2907757	77862
chr17	2829895	3029895	harbor1	chr17	2908105	2908169	DNA/hAT-Charlie	754	+	32	2908137	78242
chr17	7461894	7661894	harbor1	chr17	7489329	7489784	DNA/hAT-Charlie	1746	+	228	7489557	27663
chr17	7461894	7661894	harbor1	chr17	7490077	7490165	DNA/hAT-Charlie	1746	+	44	7490121	28227
chr17	76711222	76911222	harbor1	chr17	76722089	76722256	DNA/hAT-Charlie	845	+	84	76722173	10951
chr17	76768627	76968627	harbor1	chr17	76835668	76835768	DNA/hAT-Charlie	1142	+	50	76835718	67091
chr17	76768627	76968627	harbor1	chr17	76836059	76836328	DNA/hAT-Charlie	1142	+	134	76836193	67566
chr17	76768627	76968627	harbor1	chr17	76839406	76839510	DNA/hAT-Charlie	605	+	52	76839458	70831
chr17	76768627	76968627	harbor1	chr17	76839823	76839910	DNA/hAT-Charlie	605	+	44	76839867	71240
chr17	15134573	15334573	harbor1	chr17	15228414	15228570	DNA/hAT-Charlie	760	+	78	15228492	93919
chr17	1548969	1748969	harbor1	chr17	1641118	1641525	DNA/hAT-Charlie	2255	+	204	1641322	92353
chr17	2837929	3037929	harbor1	chr17	2838697	2838984	DNA/hAT-Charlie	1093	+	144	2838841	912
chr17	2837929	3037929	harbor1	chr17	2849895	2849999	DNA/hAT-Charlie	778	+	52	2849947	12018
chr17	2837929	3037929	harbor1	chr17	2850300	2850467	DNA/hAT-Charlie	778	+	84	2850384	12455
chr17	2837929	3037929	harbor1	chr17	2851086	2851190	DNA/hAT-Charlie	778	+	52	2851138	13209
chr17	2837929	3037929	harbor1	chr17	2855236	2855603	DNA/hAT-Charlie	1553	+	184	2855420	17491
chr17	2837929	3037929	harbor1	chr17	2855913	2856005	DNA/hAT-Charlie	1553	+	46	2855959	18030
chr17	2837929	3037929	harbor1	chr17	2907703	2907811	DNA/hAT-Charlie	754	+	54	2907757	69828
chr17	2837929	3037929	harbor1	chr17	2908105	2908169	DNA/hAT-Charlie	754	+	32	2908137	70208
chr17	31921150	32121150	harbor1	chr17	31935484	31935667	DNA/hAT-Charlie	870	+	92	31935576	14426
chr17	31921150	32121150	harbor1	chr17	31987591	31987648	DNA/hAT-Charlie	676	+	28	31987619	66469
chr17	31921150	32121150	harbor1	chr17	31987953	31988200	DNA/hAT-Charlie	676	+	124	31988077	66927
chr17	7461804	7661804	harbor1	chr17	7489329	7489784	DNA/hAT-Charlie	1746	+	228	7489557	27753
chr17	7461804	7661804	harbor1	chr17	7490077	7490165	DNA/hAT-Charlie	1746	+	44	7490121	28317
chr17	32166126	32366126	harbor1	chr17	32174143	32174420	DNA/hAT-Charlie	1175	+	138	32174281	8155
chr17	32166126	32366126	harbor1	chr17	32187534	32187574	DNA/hAT-Charlie	1305	+	20	32187554	21428
chr17	32166126	32366126	harbor1	chr17	32187869	32188217	DNA/hAT-Charlie	1305	+	174	32188043	21917
chr17	32166126	32366126	harbor1	chr17	32188233	32188845	DNA/hAT-Charlie	3122	+	306	32188539	22413
chr17	74649363	74849363	harbor1	chr17	74672719	74672866	DNA/hAT-Charlie	650	+	74	74672793	23430
chr17	79689289	79889289	harbor1	chr17	79748758	79749189	DNA/hAT-Charlie	1257	+	216	79748974	59685
chr17	79689289	79889289	harbor1	chr17	79788591	79788798	DNA/hAT-Charlie	773	+	104	79788695	99406
chr17	76636928	76836928	harbor1	chr17	76722089	76722256	DNA/hAT-Charlie	845	+	84	76722173	85245
chr17	76637263	76837263	harbor1	chr17	76722089	76722256	DNA/hAT-Charlie	845	+	84	76722173	84910
chr17	40256634	40456634	harbor1	chr17	40290324	40290498	DNA/hAT-Charlie	1004	+	87	40290411	33777
chr17	79689683	79889683	harbor1	chr17	79748758	79749189	DNA/hAT-Charlie	1257	+	216	79748974	59291
chr17	79689683	79889683	harbor1	chr17	79788591	79788798	DNA/hAT-Charlie	773	+	104	79788695	99012
chr17	76283274	76483274	harbor1	chr17	76368530	76368731	DNA/hAT-Charlie	982	+	100	76368630	85356
chr17	17071303	17271303	harbor1	chr17	17080518	17080714	DNA/hAT-Charlie	953	+	98	17080616	9313
chr17	17071303	17271303	harbor1	chr17	17100473	17100914	DNA/hAT-Charlie	2647	+	220	17100693	29390
chr17	17071303	17271303	harbor1	chr17	17108410	17108582	DNA/hAT-Charlie	659	+	86	17108496	37193
chr17	17071303	17271303	harbor1	chr17	17148379	17149213	DNA/hAT-Charlie	3393	+	417	17148796	77493
chr17	17071303	17271303	harbor1	chr17	17149507	17149922	DNA/hAT-Charlie	3393	+	208	17149715	78412
chr17	1548896	1748896	harbor1	chr17	1641118	1641525	DNA/hAT-Charlie	2255	+	204	1641322	92426
chr17	7397781	7597781	harbor1	chr17	7489329	7489784	DNA/hAT-Charlie	1746	+	228	7489557	91776
chr17	7397781	7597781	harbor1	chr17	7490077	7490165	DNA/hAT-Charlie	1746	+	44	7490121	92340
chr17	33191648	33391648	harbor1	chr17	33192670	33192988	DNA/hAT-Charlie	1085	+	159	33192829	1181
chr17	33191648	33391648	harbor1	chr17	33276973	33277120	DNA/hAT-Charlie	688	+	74	33277047	85399
chr17	33191648	33391648	harbor1	chr17	33283307	33283461	DNA/hAT-Charlie	672	+	77	33283384	91736
chr17	77858865	78058865	harbor1	chr17	77860109	77860415	DNA/hAT-Charlie	950	+	153	77860262	1397
chr17	44256633	44456633	harbor1	chr17	44331468	44331754	DNA/hAT-Charlie	687	+	143	44331611	74978
chr17	79689660	79889660	harbor1	chr17	79748758	79749189	DNA/hAT-Charlie	1257	+	216	79748974	59314
chr17	79689660	79889660	harbor1	chr17	79788591	79788798	DNA/hAT-Charlie	773	+	104	79788695	99035
chr17	40257301	40457301	harbor1	chr17	40290324	40290498	DNA/hAT-Charlie	1004	+	87	40290411	33110
chr17	30610045	30810045	harbor1	chr17	30696089	30696276	DNA/hAT-Charlie	830	+	94	30696183	86138
chr17	48808683	49008683	harbor1	chr17	48843768	48843889	DNA/hAT-Charlie	757	+	60	48843828	35145
chr17	48808683	49008683	harbor1	chr17	48844183	48844268	DNA/hAT-Charlie	757	+	42	48844225	35542
chr17	48808683	49008683	harbor1	chr17	48853681	48853992	DNA/hAT-Charlie	882	+	156	48853837	45154
chr17	48808683	49008683	harbor1	chr17	48893712	48893894	DNA/hAT-Charlie	1060	+	91	48893803	85120
chr17	30994986	31194986	harbor1	chr17	31060936	31061074	DNA/hAT-Charlie	759	+	69	31061005	66019
chr17	30994986	31194986	harbor1	chr17	31083439	31083695	DNA/hAT-Charlie	1318	+	128	31083567	88581
chr17	30994986	31194986	harbor1	chr17	31084007	31084239	DNA/hAT-Charlie	1318	+	116	31084123	89137
chr17	30994986	31194986	harbor1	chr17	31084548	31084640	DNA/hAT-Charlie	1318	+	46	31084594	89608
chr17	30994986	31194986	harbor1	chr17	31091284	31091508	DNA/hAT-Charlie	970	+	112	31091396	96410
chr17	987876	1187876	harbor1	chr17	1085605	1085864	DNA/hAT-Charlie	1173	+	130	1085735	97859
chr17	987876	1187876	harbor1	chr17	1086163	1086223	DNA/hAT-Charlie	1173	+	30	1086193	98317
chr17	76637321	76837321	harbor1	chr17	76722089	76722256	DNA/hAT-Charlie	845	+	84	76722173	84852
chr17	15161857	15361857	harbor1	chr17	15228414	15228570	DNA/hAT-Charlie	760	+	78	15228492	66635
chr17	1990653	2190653	harbor1	chr17	2038435	2038744	DNA/hAT-Charlie	1797	+	154	2038589	47936
chr17	9856590	10056590	harbor1	chr17	9864197	9864357	DNA/hAT-Charlie	794	+	80	9864277	7687
chr17	9856590	10056590	harbor1	chr17	9866270	9866500	DNA/hAT-Charlie	1190	+	115	9866385	9795
chr17	9856590	10056590	harbor1	chr17	9873478	9873682	DNA/hAT-Charlie	1219	+	102	9873580	16990
chr17	9856590	10056590	harbor1	chr17	9954588	9954813	DNA/hAT-Charlie	1102	+	112	9954700	98110
chr18	26126454	26326454	harbor1	chr18	26166249	26167483	DNA/hAT-Charlie	3858	+	617	26166866	40412
chr18	26126454	26326454	harbor1	chr18	26177173	26177385	DNA/hAT-Charlie	980	+	106	26177279	50825
chr18	26126454	26326454	harbor1	chr18	26209369	26209600	DNA/hAT-Charlie	4957	+	116	26209485	83031
chr18	26126454	26326454	harbor1	chr18	26209927	26209937	DNA/hAT-Charlie	4957	+	5	26209932	83478
chr18	26126454	26326454	harbor1	chr18	26210777	26211820	DNA/hAT-Charlie	4957	+	522	26211299	84845
chr18	26126454	26326454	harbor1	chr18	26213415	26213556	DNA/hAT-Charlie	482	+	70	26213485	87031
chr18	37465330	37665330	harbor1	chr18	37525858	37526051	DNA/hAT-Charlie	749	+	96	37525954	60624
chr18	37465330	37665330	harbor1	chr18	37531367	37531688	DNA/hAT-Charlie	1033	+	160	37531527	66197
chr18	37465330	37665330	harbor1	chr18	37539649	37539862	DNA/hAT-Charlie	632	+	106	37539755	74425
chr18	26126532	26326532	harbor1	chr18	26166249	26167483	DNA/hAT-Charlie	3858	+	617	26166866	40334
chr18	26126532	26326532	harbor1	chr18	26177173	26177385	DNA/hAT-Charlie	980	+	106	26177279	50747
chr18	26126532	26326532	harbor1	chr18	26209369	26209600	DNA/hAT-Charlie	4957	+	116	26209485	82953
chr18	26126532	26326532	harbor1	chr18	26209927	26209937	DNA/hAT-Charlie	4957	+	5	26209932	83400
chr18	26126532	26326532	harbor1	chr18	26210777	26211820	DNA/hAT-Charlie	4957	+	522	26211299	84767
chr18	26126532	26326532	harbor1	chr18	26213415	26213556	DNA/hAT-Charlie	482	+	70	26213485	86953
chr18	49713903	49913903	harbor1	chr18	49735267	49735426	DNA/hAT-Charlie	547	+	80	49735347	21444
chr18	49713903	49913903	harbor1	chr18	49798072	49798246	DNA/hAT-Charlie	568	+	87	49798159	84256
chr18	26126502	26326502	harbor1	chr18	26166249	26167483	DNA/hAT-Charlie	3858	+	617	26166866	40364
chr18	26126502	26326502	harbor1	chr18	26177173	26177385	DNA/hAT-Charlie	980	+	106	26177279	50777
chr18	26126502	26326502	harbor1	chr18	26209369	26209600	DNA/hAT-Charlie	4957	+	116	26209485	82983
chr18	26126502	26326502	harbor1	chr18	26209927	26209937	DNA/hAT-Charlie	4957	+	5	26209932	83430
chr18	26126502	26326502	harbor1	chr18	26210777	26211820	DNA/hAT-Charlie	4957	+	522	26211299	84797
chr18	26126502	26326502	harbor1	chr18	26213415	26213556	DNA/hAT-Charlie	482	+	70	26213485	86983
chr18	31997343	32197343	harbor1	chr18	31998850	31999010	DNA/hAT-Charlie	461	+	80	31998930	1587
chr18	31997343	32197343	harbor1	chr18	32073311	32073529	DNA/hAT-Charlie	1092	+	109	32073420	76077
chr18	26126451	26326451	harbor1	chr18	26166249	26167483	DNA/hAT-Charlie	3858	+	617	26166866	40415
chr18	26126451	26326451	harbor1	chr18	26177173	26177385	DNA/hAT-Charlie	980	+	106	26177279	50828
chr18	26126451	26326451	harbor1	chr18	26209369	26209600	DNA/hAT-Charlie	4957	+	116	26209485	83034
chr18	26126451	26326451	harbor1	chr18	26209927	26209937	DNA/hAT-Charlie	4957	+	5	26209932	83481
chr18	26126451	26326451	harbor1	chr18	26210777	26211820	DNA/hAT-Charlie	4957	+	522	26211299	84848
chr18	26126451	26326451	harbor1	chr18	26213415	26213556	DNA/hAT-Charlie	482	+	70	26213485	87034
chr18	26126452	26326452	harbor1	chr18	26166249	26167483	DNA/hAT-Charlie	3858	+	617	26166866	40414
chr18	26126452	26326452	harbor1	chr18	26177173	26177385	DNA/hAT-Charlie	980	+	106	26177279	50827
chr18	26126452	26326452	harbor1	chr18	26209369	26209600	DNA/hAT-Charlie	4957	+	116	26209485	83033
chr18	26126452	26326452	harbor1	chr18	26209927	26209937	DNA/hAT-Charlie	4957	+	5	26209932	83480
chr18	26126452	26326452	harbor1	chr18	26210777	26211820	DNA/hAT-Charlie	4957	+	522	26211299	84847
chr18	26126452	26326452	harbor1	chr18	26213415	26213556	DNA/hAT-Charlie	482	+	70	26213485	87033
chr18	42426133	42626133	harbor1	chr18	42498414	42498613	DNA/hAT-Charlie	897	+	100	42498514	72381
chr18	74356692	74556692	harbor1	chr18	74385460	74385511	DNA/hAT-Charlie	440	+	26	74385486	28794
chr18	74356692	74556692	harbor1	chr18	74386322	74386434	DNA/hAT-Charlie	440	+	56	74386378	29686
chr18	74356692	74556692	harbor1	chr18	74433767	74434141	DNA/hAT-Charlie	1166	+	187	74433954	77262
chr18	74356692	74556692	harbor1	chr18	74432230	74432739	DNA/hAT-Charlie	3528	+	254	74432484	75792
chr18	74356714	74556714	harbor1	chr18	74385460	74385511	DNA/hAT-Charlie	440	+	26	74385486	28772
chr18	74356714	74556714	harbor1	chr18	74386322	74386434	DNA/hAT-Charlie	440	+	56	74386378	29664
chr18	74356714	74556714	harbor1	chr18	74433767	74434141	DNA/hAT-Charlie	1166	+	187	74433954	77240
chr18	74356714	74556714	harbor1	chr18	74432230	74432739	DNA/hAT-Charlie	3528	+	254	74432484	75770
chr18	23734554	23934554	harbor1	chr18	23746409	23746809	DNA/hAT-Charlie	1962	+	200	23746609	12055
chr18	23734554	23934554	harbor1	chr18	23790225	23790494	DNA/hAT-Charlie	621	+	134	23790359	55805
chr18	74356712	74556712	harbor1	chr18	74385460	74385511	DNA/hAT-Charlie	440	+	26	74385486	28774
chr18	74356712	74556712	harbor1	chr18	74386322	74386434	DNA/hAT-Charlie	440	+	56	74386378	29666
chr18	74356712	74556712	harbor1	chr18	74433767	74434141	DNA/hAT-Charlie	1166	+	187	74433954	77242
chr18	74356712	74556712	harbor1	chr18	74432230	74432739	DNA/hAT-Charlie	3528	+	254	74432484	75772
chr18	25820834	26020834	harbor1	chr18	25864506	25864576	DNA/hAT-Charlie	609	+	35	25864541	43707
chr18	25820834	26020834	harbor1	chr18	25864816	25864948	DNA/hAT-Charlie	609	+	66	25864882	44048
chr18	25820834	26020834	harbor1	chr18	25865336	25865516	DNA/hAT-Charlie	907	+	90	25865426	44592
chr18	25820834	26020834	harbor1	chr18	25913002	25913179	DNA/hAT-Charlie	849	+	88	25913090	92256
chr18	25820834	26020834	harbor1	chr18	25917797	25918011	DNA/hAT-Charlie	575	+	107	25917904	97070
chr18	26126453	26326453	harbor1	chr18	26166249	26167483	DNA/hAT-Charlie	3858	+	617	26166866	40413
chr18	26126453	26326453	harbor1	chr18	26177173	26177385	DNA/hAT-Charlie	980	+	106	26177279	50826
chr18	26126453	26326453	harbor1	chr18	26209369	26209600	DNA/hAT-Charlie	4957	+	116	26209485	83032
chr18	26126453	26326453	harbor1	chr18	26209927	26209937	DNA/hAT-Charlie	4957	+	5	26209932	83479
chr18	26126453	26326453	harbor1	chr18	26210777	26211820	DNA/hAT-Charlie	4957	+	522	26211299	84846
chr18	26126453	26326453	harbor1	chr18	26213415	26213556	DNA/hAT-Charlie	482	+	70	26213485	87032
chr18	37465383	37665383	harbor1	chr18	37525858	37526051	DNA/hAT-Charlie	749	+	96	37525954	60571
chr18	37465383	37665383	harbor1	chr18	37531367	37531688	DNA/hAT-Charlie	1033	+	160	37531527	66144
chr18	37465383	37665383	harbor1	chr18	37539649	37539862	DNA/hAT-Charlie	632	+	106	37539755	74372
chr18	46333461	46533461	harbor1	chr18	46428568	46428887	DNA/hAT-Charlie	1311	+	160	46428728	95267
chr18	75105267	75305267	harbor1	chr18	75186088	75186239	DNA/hAT-Charlie	523	+	76	75186164	80897
chr18	57486434	57686434	harbor1	chr18	57492650	57492771	DNA/hAT-Charlie	445	+	60	57492710	6276
chr18	57486434	57686434	harbor1	chr18	57499601	57499753	DNA/hAT-Charlie	763	+	76	57499677	13243
chr18	57486434	57686434	harbor1	chr18	57530176	57530292	DNA/hAT-Charlie	492	+	58	57530234	43800
chr18	57486434	57686434	harbor1	chr18	57577197	57577432	DNA/hAT-Charlie	955	+	118	57577315	90881
chr18	59165754	59365754	harbor1	chr18	59214482	59214696	DNA/hAT-Charlie	923	+	107	59214589	48835
chr18	59165754	59365754	harbor1	chr18	59216070	59216206	DNA/hAT-Charlie	530	+	68	59216138	50384
chr18	59165754	59365754	harbor1	chr18	59238972	59239288	DNA/hAT-Charlie	829	+	158	59239130	73376
chr18	11589068	11789068	harbor1	chr18	11594466	11595053	DNA/hAT-Charlie	1289	+	294	11594760	5692
chr18	46488673	46688673	harbor1	chr18	46542346	46542434	DNA/hAT-Charlie	443	+	44	46542390	53717
chr18	46488673	46688673	harbor1	chr18	46555921	46556274	DNA/hAT-Charlie	1394	+	176	46556097	67424
chr18	25890292	26090292	harbor1	chr18	25913002	25913179	DNA/hAT-Charlie	849	+	88	25913090	22798
chr18	25890292	26090292	harbor1	chr18	25917797	25918011	DNA/hAT-Charlie	575	+	107	25917904	27612
chr18	25890292	26090292	harbor1	chr18	25938035	25938199	DNA/hAT-Charlie	398	+	82	25938117	47825
chr18	25890292	26090292	harbor1	chr18	25980284	25980447	DNA/hAT-Charlie	843	+	82	25980366	90074
chr18	12207967	12407967	harbor1	chr18	12267827	12268013	DNA/hAT-Charlie	896	+	93	12267920	59953
chr18	65651295	65851295	harbor1	chr18	65657228	65657353	DNA/hAT-Charlie	490	+	62	65657290	5995
chr18	65651295	65851295	harbor1	chr18	65657363	65657489	DNA/hAT-Charlie	476	+	63	65657426	6131
chr18	65651295	65851295	harbor1	chr18	65662724	65662902	DNA/hAT-Charlie	691	+	89	65662813	11518
chr18	65651295	65851295	harbor1	chr18	65679210	65679336	DNA/hAT-Charlie	545	+	63	65679273	27978
chr18	65651295	65851295	harbor1	chr18	65728872	65729074	DNA/hAT-Charlie	570	+	101	65728973	77678
chr18	75181752	75381752	harbor1	chr18	75186088	75186239	DNA/hAT-Charlie	523	+	76	75186164	4412
chr18	74356740	74556740	harbor1	chr18	74385460	74385511	DNA/hAT-Charlie	440	+	26	74385486	28746
chr18	74356740	74556740	harbor1	chr18	74386322	74386434	DNA/hAT-Charlie	440	+	56	74386378	29638
chr18	74356740	74556740	harbor1	chr18	74433767	74434141	DNA/hAT-Charlie	1166	+	187	74433954	77214
chr18	74356740	74556740	harbor1	chr18	74432230	74432739	DNA/hAT-Charlie	3528	+	254	74432484	75744
chr18	48702843	48902843	harbor1	chr18	48742823	48743863	DNA/hAT-Charlie	2731	+	520	48743343	40500
chr18	48702843	48902843	harbor1	chr18	48785777	48785920	DNA/hAT-Charlie	668	+	72	48785849	83006
chr18	48702843	48902843	harbor1	chr18	48798761	48798961	DNA/hAT-Charlie	799	+	100	48798861	96018
chr18	59165766	59365766	harbor1	chr18	59214482	59214696	DNA/hAT-Charlie	923	+	107	59214589	48823
chr18	59165766	59365766	harbor1	chr18	59216070	59216206	DNA/hAT-Charlie	530	+	68	59216138	50372
chr18	59165766	59365766	harbor1	chr18	59238972	59239288	DNA/hAT-Charlie	829	+	158	59239130	73364
chr18	59165800	59365800	harbor1	chr18	59214482	59214696	DNA/hAT-Charlie	923	+	107	59214589	48789
chr18	59165800	59365800	harbor1	chr18	59216070	59216206	DNA/hAT-Charlie	530	+	68	59216138	50338
chr18	59165800	59365800	harbor1	chr18	59238972	59239288	DNA/hAT-Charlie	829	+	158	59239130	73330
chr18	65651274	65851274	harbor1	chr18	65657228	65657353	DNA/hAT-Charlie	490	+	62	65657290	6016
chr18	65651274	65851274	harbor1	chr18	65657363	65657489	DNA/hAT-Charlie	476	+	63	65657426	6152
chr18	65651274	65851274	harbor1	chr18	65662724	65662902	DNA/hAT-Charlie	691	+	89	65662813	11539
chr18	65651274	65851274	harbor1	chr18	65679210	65679336	DNA/hAT-Charlie	545	+	63	65679273	27999
chr18	65651274	65851274	harbor1	chr18	65728872	65729074	DNA/hAT-Charlie	570	+	101	65728973	77699
chr19	5518771	5718771	harbor1	chr19	5603707	5603971	DNA/hAT-Charlie	1055	+	132	5603839	85068
chr19	5518771	5718771	harbor1	chr19	5617591	5617777	DNA/hAT-Charlie	744	+	93	5617684	98913
chr19	49751331	49951331	harbor1	chr19	49838175	49839413	DNA/hAT-Charlie	3934	+	619	49838794	87463
chr19	49751331	49951331	harbor1	chr19	49839486	49840475	DNA/hAT-Charlie	3257	+	494	49839980	88649
chr19	56021024	56221024	harbor1	chr19	56024830	56025326	DNA/hAT-Charlie	3395	+	248	56025078	4054
chr19	56021024	56221024	harbor1	chr19	56078481	56078667	DNA/hAT-Charlie	1419	+	93	56078574	57550
chr19	5510367	5710367	harbor1	chr19	5603707	5603971	DNA/hAT-Charlie	1055	+	132	5603839	93472
chr19	5521813	5721813	harbor1	chr19	5603707	5603971	DNA/hAT-Charlie	1055	+	132	5603839	82026
chr19	5521813	5721813	harbor1	chr19	5617591	5617777	DNA/hAT-Charlie	744	+	93	5617684	95871
chr19	10618449	10818449	harbor1	chr19	10674964	10675171	DNA/hAT-Charlie	671	+	104	10675068	56619
chr19	10618449	10818449	harbor1	chr19	10690379	10690577	DNA/hAT-Charlie	677	+	99	10690478	72029
chr19	1350382	1550382	harbor1	chr19	1372139	1372343	DNA/hAT-Charlie	647	+	102	1372241	21859
chr19	3965991	4165991	harbor1	chr19	4050564	4050815	DNA/hAT-Charlie	790	+	126	4050690	84699
chr19	10618445	10818445	harbor1	chr19	10674964	10675171	DNA/hAT-Charlie	671	+	104	10675068	56623
chr19	10618445	10818445	harbor1	chr19	10690379	10690577	DNA/hAT-Charlie	677	+	99	10690478	72033
chr19	3966097	4166097	harbor1	chr19	4050564	4050815	DNA/hAT-Charlie	790	+	126	4050690	84593
chr19	3963500	4163500	harbor1	chr19	4050564	4050815	DNA/hAT-Charlie	790	+	126	4050690	87190
chr19	1505428	1705428	harbor1	chr19	1538724	1538937	DNA/hAT-Charlie	773	+	106	1538830	33402
chr19	10618454	10818454	harbor1	chr19	10674964	10675171	DNA/hAT-Charlie	671	+	104	10675068	56614
chr19	10618454	10818454	harbor1	chr19	10690379	10690577	DNA/hAT-Charlie	677	+	99	10690478	72024
chr19	5521834	5721834	harbor1	chr19	5603707	5603971	DNA/hAT-Charlie	1055	+	132	5603839	82005
chr19	5521834	5721834	harbor1	chr19	5617591	5617777	DNA/hAT-Charlie	744	+	93	5617684	95850
chr19	1350427	1550427	harbor1	chr19	1372139	1372343	DNA/hAT-Charlie	647	+	102	1372241	21814
chr19	3283783	3483783	harbor1	chr19	3350291	3350540	DNA/hAT-Charlie	1045	+	124	3350415	66632
chr19	3283783	3483783	harbor1	chr19	3363705	3363907	DNA/hAT-Charlie	690	+	101	3363806	80023
chr19	49751333	49951333	harbor1	chr19	49838175	49839413	DNA/hAT-Charlie	3934	+	619	49838794	87461
chr19	49751333	49951333	harbor1	chr19	49839486	49840475	DNA/hAT-Charlie	3257	+	494	49839980	88647
chr19	5522118	5722118	harbor1	chr19	5603707	5603971	DNA/hAT-Charlie	1055	+	132	5603839	81721
chr19	5522118	5722118	harbor1	chr19	5617591	5617777	DNA/hAT-Charlie	744	+	93	5617684	95566
chr19	10073322	10273322	harbor1	chr19	10085197	10085392	DNA/hAT-Charlie	974	+	98	10085295	11973
chr19	5489614	5689614	harbor1	chr19	5491661	5491862	DNA/hAT-Charlie	793	+	100	5491761	2147
chr19	5522533	5722533	harbor1	chr19	5603707	5603971	DNA/hAT-Charlie	1055	+	132	5603839	81306
chr19	5522533	5722533	harbor1	chr19	5617591	5617777	DNA/hAT-Charlie	744	+	93	5617684	95151
chr19	2710214	2910214	harbor1	chr19	2787695	2787904	DNA/hAT-Charlie	834	+	104	2787799	77585
chr19	10618489	10818489	harbor1	chr19	10674964	10675171	DNA/hAT-Charlie	671	+	104	10675068	56579
chr19	10618489	10818489	harbor1	chr19	10690379	10690577	DNA/hAT-Charlie	677	+	99	10690478	71989
chr19	1505425	1705425	harbor1	chr19	1538724	1538937	DNA/hAT-Charlie	773	+	106	1538830	33405
chr19	49751330	49951330	harbor1	chr19	49838175	49839413	DNA/hAT-Charlie	3934	+	619	49838794	87464
chr19	49751330	49951330	harbor1	chr19	49839486	49840475	DNA/hAT-Charlie	3257	+	494	49839980	88650
chr19	54982219	55182219	harbor1	chr19	55024651	55024828	DNA/hAT-Charlie	759	+	88	55024739	42520
chr19	702847	902847	harbor1	chr19	707462	707683	DNA/hAT-Charlie	1285	+	110	707572	4725
chr19	10618492	10818492	harbor1	chr19	10674964	10675171	DNA/hAT-Charlie	671	+	104	10675068	56576
chr19	10618492	10818492	harbor1	chr19	10690379	10690577	DNA/hAT-Charlie	677	+	99	10690478	71986
chr19	49751332	49951332	harbor1	chr19	49838175	49839413	DNA/hAT-Charlie	3934	+	619	49838794	87462
chr19	49751332	49951332	harbor1	chr19	49839486	49840475	DNA/hAT-Charlie	3257	+	494	49839980	88648
chr19	2710232	2910232	harbor1	chr19	2787695	2787904	DNA/hAT-Charlie	834	+	104	2787799	77567
chr19	1464901	1664901	harbor1	chr19	1494296	1494528	DNA/hAT-Charlie	797	+	116	1494412	29511
chr19	1464901	1664901	harbor1	chr19	1538724	1538937	DNA/hAT-Charlie	773	+	106	1538830	73929
chr19	5522565	5722565	harbor1	chr19	5603707	5603971	DNA/hAT-Charlie	1055	+	132	5603839	81274
chr19	5522565	5722565	harbor1	chr19	5617591	5617777	DNA/hAT-Charlie	744	+	93	5617684	95119
chr19	7530548	7730548	harbor1	chr19	7583266	7583481	DNA/hAT-Charlie	1122	+	108	7583374	52826
chr19	7530548	7730548	harbor1	chr19	7600993	7601307	DNA/hAT-Charlie	1050	+	157	7601150	70602
chr19	7530548	7730548	harbor1	chr19	7602106	7602326	DNA/hAT-Charlie	946	+	110	7602216	71668
chr19	32305852	32505852	harbor1	chr19	32375147	32375363	DNA/hAT-Charlie	1101	+	108	32375255	69403
chr19	32305852	32505852	harbor1	chr19	32387546	32387746	DNA/hAT-Charlie	952	+	100	32387646	81794
chr19	32305852	32505852	harbor1	chr19	32387756	32387968	DNA/hAT-Charlie	929	+	106	32387862	82010
chr19	56018924	56218924	harbor1	chr19	56024830	56025326	DNA/hAT-Charlie	3395	+	248	56025078	6154
chr19	56018924	56218924	harbor1	chr19	56078481	56078667	DNA/hAT-Charlie	1419	+	93	56078574	59650
chr19	1505461	1705461	harbor1	chr19	1538724	1538937	DNA/hAT-Charlie	773	+	106	1538830	33369
chr19	39407220	39607220	harbor1	chr19	39465506	39465725	DNA/hAT-Charlie	1185	+	110	39465616	58396
chr19	39407220	39607220	harbor1	chr19	39491080	39491167	DNA/hAT-Charlie	670	+	44	39491124	83904
chr19	39407220	39607220	harbor1	chr19	39491467	39491537	DNA/hAT-Charlie	670	+	35	39491502	84282
chr19	41922838	42122838	harbor1	chr19	42012552	42012593	DNA/hAT-Charlie	978	+	20	42012572	89734
chr19	41922838	42122838	harbor1	chr19	42012885	42013069	DNA/hAT-Charlie	978	+	92	42012977	90139
chr19	41922838	42122838	harbor1	chr19	42016880	42017176	DNA/hAT-Charlie	876	+	148	42017028	94190
chr19	41922838	42122838	harbor1	chr19	42017273	42017534	DNA/hAT-Charlie	1065	+	130	42017403	94565
chr19	49751427	49951427	harbor1	chr19	49838175	49839413	DNA/hAT-Charlie	3934	+	619	49838794	87367
chr19	49751427	49951427	harbor1	chr19	49839486	49840475	DNA/hAT-Charlie	3257	+	494	49839980	88553
chr19	13726269	13926269	harbor1	chr19	13749305	13749571	DNA/hAT-Charlie	1138	+	133	13749438	23169
chr19	13726269	13926269	harbor1	chr19	13822298	13822557	DNA/hAT-Charlie	1157	+	130	13822428	96159
chr19	1350400	1550400	harbor1	chr19	1372139	1372343	DNA/hAT-Charlie	647	+	102	1372241	21841
chr19	10618444	10818444	harbor1	chr19	10674964	10675171	DNA/hAT-Charlie	671	+	104	10675068	56624
chr19	10618444	10818444	harbor1	chr19	10690379	10690577	DNA/hAT-Charlie	677	+	99	10690478	72034
chr19	664344	864344	harbor1	chr19	707462	707683	DNA/hAT-Charlie	1285	+	110	707572	43228
chr19	49750827	49950827	harbor1	chr19	49838175	49839413	DNA/hAT-Charlie	3934	+	619	49838794	87967
chr19	49750827	49950827	harbor1	chr19	49839486	49840475	DNA/hAT-Charlie	3257	+	494	49839980	89153
chr19	5522544	5722544	harbor1	chr19	5603707	5603971	DNA/hAT-Charlie	1055	+	132	5603839	81295
chr19	5522544	5722544	harbor1	chr19	5617591	5617777	DNA/hAT-Charlie	744	+	93	5617684	95140
chr19	9484484	9684484	harbor1	chr19	9484340	9484495	DNA/hAT-Charlie	817	+	78	9484418	66
chr19	48525128	48725128	harbor1	chr19	48525348	48525386	DNA/hAT-Charlie	655	+	19	48525367	239
chr19	48525128	48725128	harbor1	chr19	48525823	48525968	DNA/hAT-Charlie	655	+	72	48525895	767
chr19	48525128	48725128	harbor1	chr19	48526591	48526805	DNA/hAT-Charlie	864	+	107	48526698	1570
chr19	317396	517396	harbor1	chr19	320499	320808	DNA/hAT-Charlie	1935	+	154	320653	3257
chr19	317396	517396	harbor1	chr19	330857	331087	DNA/hAT-Charlie	814	+	115	330972	13576
chr19	317396	517396	harbor1	chr19	331682	331701	DNA/hAT-Charlie	814	+	10	331692	14296
chr19	317396	517396	harbor1	chr19	332001	332134	DNA/hAT-Charlie	814	+	66	332067	14671
chr19	8046259	8246259	harbor1	chr19	8078228	8078424	DNA/hAT-Charlie	726	+	98	8078326	32067
chr19	8046259	8246259	harbor1	chr19	8110389	8110599	DNA/hAT-Charlie	1061	+	105	8110494	64235
chr19	1960150	2160150	harbor1	chr19	2006631	2006691	DNA/hAT-Charlie	951	+	30	2006661	46511
chr19	1960150	2160150	harbor1	chr19	2007291	2007451	DNA/hAT-Charlie	951	+	80	2007371	47221
chr19	9986276	10186276	harbor1	chr19	10085197	10085392	DNA/hAT-Charlie	974	+	98	10085295	99019
chr19	1460984	1660984	harbor1	chr19	1494296	1494528	DNA/hAT-Charlie	797	+	116	1494412	33428
chr19	1460984	1660984	harbor1	chr19	1538724	1538937	DNA/hAT-Charlie	773	+	106	1538830	77846
chr19	5522573	5722573	harbor1	chr19	5603707	5603971	DNA/hAT-Charlie	1055	+	132	5603839	81266
chr19	5522573	5722573	harbor1	chr19	5617591	5617777	DNA/hAT-Charlie	744	+	93	5617684	95111
chr19	8877739	9077739	harbor1	chr19	8942177	8942388	DNA/hAT-Charlie	1145	+	106	8942283	64544
chr19	10618507	10818507	harbor1	chr19	10674964	10675171	DNA/hAT-Charlie	671	+	104	10675068	56561
chr19	10618507	10818507	harbor1	chr19	10690379	10690577	DNA/hAT-Charlie	677	+	99	10690478	71971
chr19	36005131	36205131	harbor1	chr19	36051766	36052030	DNA/hAT-Charlie	1896	+	132	36051898	46767
chr19	36005131	36205131	harbor1	chr19	36052343	36052485	DNA/hAT-Charlie	1896	+	71	36052414	47283
chr19	5521749	5721749	harbor1	chr19	5603707	5603971	DNA/hAT-Charlie	1055	+	132	5603839	82090
chr19	5521749	5721749	harbor1	chr19	5617591	5617777	DNA/hAT-Charlie	744	+	93	5617684	95935
chr19	1505441	1705441	harbor1	chr19	1538724	1538937	DNA/hAT-Charlie	773	+	106	1538830	33389
chr19	55254096	55454096	harbor1	chr19	55267977	55268148	DNA/hAT-Charlie	660	+	86	55268063	13967
chr19	55254096	55454096	harbor1	chr19	55310550	55310735	DNA/hAT-Charlie	824	+	92	55310642	56546
chr19	45397358	45597358	harbor1	chr19	45431177	45431301	DNA/hAT-Charlie	1171	+	62	45431239	33881
chr19	45397358	45597358	harbor1	chr19	45431899	45431967	DNA/hAT-Charlie	1171	+	34	45431933	34575
chr19	45397358	45597358	harbor1	chr19	45432270	45432283	DNA/hAT-Charlie	1171	+	6	45432276	34918
chr19	45397358	45597358	harbor1	chr19	45432435	45432547	DNA/hAT-Charlie	1171	+	56	45432491	35133
chr19	190676	390676	harbor1	chr19	244132	244351	DNA/hAT-Charlie	810	+	110	244242	53566
chr19	37894961	38094961	harbor1	chr19	37979116	37979267	DNA/hAT-Charlie	1507	+	76	37979192	84231
chr19	37894961	38094961	harbor1	chr19	37979574	37979760	DNA/hAT-Charlie	1507	+	93	37979667	84706
chr19	1467965	1667965	harbor1	chr19	1494296	1494528	DNA/hAT-Charlie	797	+	116	1494412	26447
chr19	1467965	1667965	harbor1	chr19	1538724	1538937	DNA/hAT-Charlie	773	+	106	1538830	70865
chr19	10887632	11087632	harbor1	chr19	10946991	10947190	DNA/hAT-Charlie	798	+	100	10947091	59459
chr19	14106923	14306923	harbor1	chr19	14200415	14200600	DNA/hAT-Charlie	810	+	92	14200507	93584
chr19	31989361	32189361	harbor1	chr19	32009711	32010186	DNA/hAT-Charlie	3071	+	238	32009949	20588
chr19	12938463	13138463	harbor1	chr19	13037729	13037924	DNA/hAT-Charlie	1021	+	98	13037827	99364
chr19	49751463	49951463	harbor1	chr19	49838175	49839413	DNA/hAT-Charlie	3934	+	619	49838794	87331
chr19	49751463	49951463	harbor1	chr19	49839486	49840475	DNA/hAT-Charlie	3257	+	494	49839980	88517
chr19	38117750	38317750	harbor1	chr19	38126379	38126538	DNA/hAT-Charlie	817	+	80	38126459	8709
chr19	38117750	38317750	harbor1	chr19	38126836	38126849	DNA/hAT-Charlie	817	+	6	38126842	9092
chr19	1505448	1705448	harbor1	chr19	1538724	1538937	DNA/hAT-Charlie	773	+	106	1538830	33382
chr19	58377455	58577455	harbor1	chr19	58468938	58469138	DNA/hAT-Charlie	1312	+	100	58469038	91583
chr19	2356892	2556892	harbor1	chr19	2416993	2417183	DNA/hAT-Charlie	804	+	95	2417088	60196
chr19	1467960	1667960	harbor1	chr19	1494296	1494528	DNA/hAT-Charlie	797	+	116	1494412	26452
chr19	1467960	1667960	harbor1	chr19	1538724	1538937	DNA/hAT-Charlie	773	+	106	1538830	70870
chr19	16789062	16989062	harbor1	chr19	16790409	16790460	DNA/hAT-Charlie	1010	+	26	16790435	1373
chr19	16789062	16989062	harbor1	chr19	16790674	16790893	DNA/hAT-Charlie	1010	+	110	16790784	1722
chr19	16789062	16989062	harbor1	chr19	16862975	16863188	DNA/hAT-Charlie	1057	+	106	16863081	74019
chr19	10617604	10817604	harbor1	chr19	10674964	10675171	DNA/hAT-Charlie	671	+	104	10675068	57464
chr19	10617604	10817604	harbor1	chr19	10690379	10690577	DNA/hAT-Charlie	677	+	99	10690478	72874
chr19	940126	1140126	harbor1	chr19	976415	976622	DNA/hAT-Charlie	677	+	104	976519	36393
chr19	2356895	2556895	harbor1	chr19	2416993	2417183	DNA/hAT-Charlie	804	+	95	2417088	60193
chr19	18674377	18874377	harbor1	chr19	18686817	18687011	DNA/hAT-Charlie	815	+	97	18686914	12537
chr19	18674377	18874377	harbor1	chr19	18695446	18695583	DNA/hAT-Charlie	821	+	68	18695514	21137
chr19	18674377	18874377	harbor1	chr19	18695892	18695972	DNA/hAT-Charlie	821	+	40	18695932	21555
chr19	5516401	5716401	harbor1	chr19	5603707	5603971	DNA/hAT-Charlie	1055	+	132	5603839	87438
chr19	41650423	41850423	harbor1	chr19	41746461	41746615	DNA/hAT-Charlie	692	+	77	41746538	96115
chr19	49750826	49950826	harbor1	chr19	49838175	49839413	DNA/hAT-Charlie	3934	+	619	49838794	87968
chr19	49750826	49950826	harbor1	chr19	49839486	49840475	DNA/hAT-Charlie	3257	+	494	49839980	89154
chr19	45691758	45891758	harbor1	chr19	45715289	45715488	DNA/hAT-Charlie	1020	+	100	45715389	23631
chr19	45691758	45891758	harbor1	chr19	45787175	45787505	DNA/hAT-Charlie	2076	+	165	45787340	95582
chr19	45691758	45891758	harbor1	chr19	45788273	45788453	DNA/hAT-Charlie	684	+	90	45788363	96605
chr19	32305891	32505891	harbor1	chr19	32375147	32375363	DNA/hAT-Charlie	1101	+	108	32375255	69364
chr19	32305891	32505891	harbor1	chr19	32387546	32387746	DNA/hAT-Charlie	952	+	100	32387646	81755
chr19	32305891	32505891	harbor1	chr19	32387756	32387968	DNA/hAT-Charlie	929	+	106	32387862	81971
chr19	2356896	2556896	harbor1	chr19	2416993	2417183	DNA/hAT-Charlie	804	+	95	2417088	60192
chr19	10618468	10818468	harbor1	chr19	10674964	10675171	DNA/hAT-Charlie	671	+	104	10675068	56600
chr19	10618468	10818468	harbor1	chr19	10690379	10690577	DNA/hAT-Charlie	677	+	99	10690478	72010
chr19	32305909	32505909	harbor1	chr19	32375147	32375363	DNA/hAT-Charlie	1101	+	108	32375255	69346
chr19	32305909	32505909	harbor1	chr19	32387546	32387746	DNA/hAT-Charlie	952	+	100	32387646	81737
chr19	32305909	32505909	harbor1	chr19	32387756	32387968	DNA/hAT-Charlie	929	+	106	32387862	81953
chr19	317267	517267	harbor1	chr19	320499	320808	DNA/hAT-Charlie	1935	+	154	320653	3386
chr19	317267	517267	harbor1	chr19	330857	331087	DNA/hAT-Charlie	814	+	115	330972	13705
chr19	317267	517267	harbor1	chr19	331682	331701	DNA/hAT-Charlie	814	+	10	331692	14425
chr19	317267	517267	harbor1	chr19	332001	332134	DNA/hAT-Charlie	814	+	66	332067	14800
chr19	1505429	1705429	harbor1	chr19	1538724	1538937	DNA/hAT-Charlie	773	+	106	1538830	33401
chr19	1	171208	harbor1	chr19	68877	69126	DNA/hAT-Charlie	1396	+	124	69001	69000
chr19	1	171208	harbor1	chr19	78654	79040	DNA/hAT-Charlie	1683	+	193	78847	78846
chr19	4691699	4891699	harbor1	chr19	4701509	4701827	DNA/hAT-Charlie	639	+	159	4701668	9969
chr19	4691699	4891699	harbor1	chr19	4713026	4713209	DNA/hAT-Charlie	652	+	92	4713118	21419
chr19	4691699	4891699	harbor1	chr19	4719476	4719682	DNA/hAT-Charlie	805	+	103	4719579	27880
chr19	4691699	4891699	harbor1	chr19	4720596	4720797	DNA/hAT-Charlie	883	+	100	4720696	28997
chr19	4691699	4891699	harbor1	chr19	4736508	4736709	DNA/hAT-Charlie	769	+	100	4736608	44909
chr19	1813169	2013169	harbor1	chr19	1859796	1860014	DNA/hAT-Charlie	829	+	109	1859905	46736
chr19	49239891	49439891	harbor1	chr19	49247966	49248028	DNA/hAT-Charlie	732	+	31	49247997	8106
chr19	49239891	49439891	harbor1	chr19	49248340	49248518	DNA/hAT-Charlie	732	+	89	49248429	8538
chr19	49239891	49439891	harbor1	chr19	49271153	49271410	DNA/hAT-Charlie	1494	+	128	49271281	31390
chr19	39990768	40190768	harbor1	chr19	40002576	40002698	DNA/hAT-Charlie	795	+	61	40002637	11869
chr19	39990768	40190768	harbor1	chr19	40003000	40003033	DNA/hAT-Charlie	795	+	16	40003016	12248
chr19	39990768	40190768	harbor1	chr19	40003336	40003378	DNA/hAT-Charlie	795	+	21	40003357	12589
chr19	39990768	40190768	harbor1	chr19	40013201	40013517	DNA/hAT-Charlie	1277	+	158	40013359	22591
chr19	39990768	40190768	harbor1	chr19	40017568	40017743	DNA/hAT-Charlie	915	+	88	40017656	26888
chr19	1413306	1613306	harbor1	chr19	1494296	1494528	DNA/hAT-Charlie	797	+	116	1494412	81106
chr19	32305831	32505831	harbor1	chr19	32375147	32375363	DNA/hAT-Charlie	1101	+	108	32375255	69424
chr19	32305831	32505831	harbor1	chr19	32387546	32387746	DNA/hAT-Charlie	952	+	100	32387646	81815
chr19	32305831	32505831	harbor1	chr19	32387756	32387968	DNA/hAT-Charlie	929	+	106	32387862	82031
chr19	1467959	1667959	harbor1	chr19	1494296	1494528	DNA/hAT-Charlie	797	+	116	1494412	26453
chr19	1467959	1667959	harbor1	chr19	1538724	1538937	DNA/hAT-Charlie	773	+	106	1538830	70871
chr19	5519194	5719194	harbor1	chr19	5603707	5603971	DNA/hAT-Charlie	1055	+	132	5603839	84645
chr19	5519194	5719194	harbor1	chr19	5617591	5617777	DNA/hAT-Charlie	744	+	93	5617684	98490
chr19	1466241	1666241	harbor1	chr19	1494296	1494528	DNA/hAT-Charlie	797	+	116	1494412	28171
chr19	1466241	1666241	harbor1	chr19	1538724	1538937	DNA/hAT-Charlie	773	+	106	1538830	72589
chr19	1	160441	harbor1	chr19	68877	69126	DNA/hAT-Charlie	1396	+	124	69001	69000
chr19	1	160441	harbor1	chr19	78654	79040	DNA/hAT-Charlie	1683	+	193	78847	78846
chr19	208646	408646	harbor1	chr19	244132	244351	DNA/hAT-Charlie	810	+	110	244242	35596
chr19	10618496	10818496	harbor1	chr19	10674964	10675171	DNA/hAT-Charlie	671	+	104	10675068	56572
chr19	10618496	10818496	harbor1	chr19	10690379	10690577	DNA/hAT-Charlie	677	+	99	10690478	71982
chr19	1544770	1744770	harbor1	chr19	1634754	1634969	DNA/hAT-Charlie	871	+	108	1634862	90092
chr19	5522745	5722745	harbor1	chr19	5603707	5603971	DNA/hAT-Charlie	1055	+	132	5603839	81094
chr19	5522745	5722745	harbor1	chr19	5617591	5617777	DNA/hAT-Charlie	744	+	93	5617684	94939
chr19	10612630	10812630	harbor1	chr19	10674964	10675171	DNA/hAT-Charlie	671	+	104	10675068	62438
chr19	10612630	10812630	harbor1	chr19	10690379	10690577	DNA/hAT-Charlie	677	+	99	10690478	77848
chr19	1763835	1963835	harbor1	chr19	1859796	1860014	DNA/hAT-Charlie	829	+	109	1859905	96070
chr19	3966072	4166072	harbor1	chr19	4050564	4050815	DNA/hAT-Charlie	790	+	126	4050690	84618
chr19	54981488	55181488	harbor1	chr19	55024651	55024828	DNA/hAT-Charlie	759	+	88	55024739	43251
chr19	6129382	6329382	harbor1	chr19	6191966	6192209	DNA/hAT-Charlie	669	+	122	6192088	62706
chr19	1625979	1825979	harbor1	chr19	1634754	1634969	DNA/hAT-Charlie	871	+	108	1634862	8883
chr19	1625979	1825979	harbor1	chr19	1696734	1696902	DNA/hAT-Charlie	683	+	84	1696818	70839
chr19	5522536	5722536	harbor1	chr19	5603707	5603971	DNA/hAT-Charlie	1055	+	132	5603839	81303
chr19	5522536	5722536	harbor1	chr19	5617591	5617777	DNA/hAT-Charlie	744	+	93	5617684	95148
chr19	5504847	5704847	harbor1	chr19	5603707	5603971	DNA/hAT-Charlie	1055	+	132	5603839	98992
chr19	5510368	5710368	harbor1	chr19	5603707	5603971	DNA/hAT-Charlie	1055	+	132	5603839	93471
chr19	1505435	1705435	harbor1	chr19	1538724	1538937	DNA/hAT-Charlie	773	+	106	1538830	33395
chr19	44993164	45193164	harbor1	chr19	45082921	45083072	DNA/hAT-Charlie	668	+	76	45082997	89833
chr19	44993164	45193164	harbor1	chr19	45085391	45085565	DNA/hAT-Charlie	685	+	87	45085478	92314
chr19	10618530	10818530	harbor1	chr19	10674964	10675171	DNA/hAT-Charlie	671	+	104	10675068	56538
chr19	10618530	10818530	harbor1	chr19	10690379	10690577	DNA/hAT-Charlie	677	+	99	10690478	71948
chr19	49751494	49951494	harbor1	chr19	49838175	49839413	DNA/hAT-Charlie	3934	+	619	49838794	87300
chr19	49751494	49951494	harbor1	chr19	49839486	49840475	DNA/hAT-Charlie	3257	+	494	49839980	88486
chr19	1350403	1550403	harbor1	chr19	1372139	1372343	DNA/hAT-Charlie	647	+	102	1372241	21838
chr19	3288086	3488086	harbor1	chr19	3350291	3350540	DNA/hAT-Charlie	1045	+	124	3350415	62329
chr19	3288086	3488086	harbor1	chr19	3363705	3363907	DNA/hAT-Charlie	690	+	101	3363806	75720
chr19	49751467	49951467	harbor1	chr19	49838175	49839413	DNA/hAT-Charlie	3934	+	619	49838794	87327
chr19	49751467	49951467	harbor1	chr19	49839486	49840475	DNA/hAT-Charlie	3257	+	494	49839980	88513
chr19	5521916	5721916	harbor1	chr19	5603707	5603971	DNA/hAT-Charlie	1055	+	132	5603839	81923
chr19	5521916	5721916	harbor1	chr19	5617591	5617777	DNA/hAT-Charlie	744	+	93	5617684	95768
chr19	15660032	15860032	harbor1	chr19	15733003	15733225	DNA/hAT-Charlie	874	+	111	15733114	73082
chr19	15660032	15860032	harbor1	chr19	15737048	15737295	DNA/hAT-Charlie	1097	+	124	15737172	77140
chr19	15660032	15860032	harbor1	chr19	15737584	15737731	DNA/hAT-Charlie	1097	+	74	15737658	77626
chr19	317228	517228	harbor1	chr19	320499	320808	DNA/hAT-Charlie	1935	+	154	320653	3425
chr19	317228	517228	harbor1	chr19	330857	331087	DNA/hAT-Charlie	814	+	115	330972	13744
chr19	317228	517228	harbor1	chr19	331682	331701	DNA/hAT-Charlie	814	+	10	331692	14464
chr19	317228	517228	harbor1	chr19	332001	332134	DNA/hAT-Charlie	814	+	66	332067	14839
chr19	1413296	1613296	harbor1	chr19	1494296	1494528	DNA/hAT-Charlie	797	+	116	1494412	81116
chr19	15010518	15210518	harbor1	chr19	15031187	15031407	DNA/hAT-Charlie	1035	+	110	15031297	20779
chr19	15010518	15210518	harbor1	chr19	15059343	15059562	DNA/hAT-Charlie	1055	+	110	15059453	48935
chr19	1544600	1744600	harbor1	chr19	1634754	1634969	DNA/hAT-Charlie	871	+	108	1634862	90262
chr19	12939121	13139121	harbor1	chr19	13037729	13037924	DNA/hAT-Charlie	1021	+	98	13037827	98706
chr19	1855242	2055242	harbor1	chr19	1859796	1860014	DNA/hAT-Charlie	829	+	109	1859905	4663
chr19	1299305	1499305	harbor1	chr19	1372139	1372343	DNA/hAT-Charlie	647	+	102	1372241	72936
chr19	49751344	49951344	harbor1	chr19	49838175	49839413	DNA/hAT-Charlie	3934	+	619	49838794	87450
chr19	49751344	49951344	harbor1	chr19	49839486	49840475	DNA/hAT-Charlie	3257	+	494	49839980	88636
chr19	5522548	5722548	harbor1	chr19	5603707	5603971	DNA/hAT-Charlie	1055	+	132	5603839	81291
chr19	5522548	5722548	harbor1	chr19	5617591	5617777	DNA/hAT-Charlie	744	+	93	5617684	95136
chr19	45369339	45569339	harbor1	chr19	45431177	45431301	DNA/hAT-Charlie	1171	+	62	45431239	61900
chr19	45369339	45569339	harbor1	chr19	45431899	45431967	DNA/hAT-Charlie	1171	+	34	45431933	62594
chr19	45369339	45569339	harbor1	chr19	45432270	45432283	DNA/hAT-Charlie	1171	+	6	45432276	62937
chr19	45369339	45569339	harbor1	chr19	45432435	45432547	DNA/hAT-Charlie	1171	+	56	45432491	63152
chr19	2537219	2737219	harbor1	chr19	2545135	2545327	DNA/hAT-Charlie	782	+	96	2545231	8012
chr19	2537219	2737219	harbor1	chr19	2551990	2552155	DNA/hAT-Charlie	1124	+	82	2552072	14853
chr19	2537219	2737219	harbor1	chr19	2552324	2552379	DNA/hAT-Charlie	1667	+	28	2552352	15133
chr19	2537219	2737219	harbor1	chr19	2552685	2552933	DNA/hAT-Charlie	1667	+	124	2552809	15590
chr19	2537219	2737219	harbor1	chr19	2561205	2561409	DNA/hAT-Charlie	662	+	102	2561307	24088
chr19	2537219	2737219	harbor1	chr19	2613640	2613840	DNA/hAT-Charlie	787	+	100	2613740	76521
chr19	2537219	2737219	harbor1	chr19	2619224	2619428	DNA/hAT-Charlie	1048	+	102	2619326	82107
chr19	2537219	2737219	harbor1	chr19	2635883	2636083	DNA/hAT-Charlie	703	+	100	2635983	98764
chr19	48342797	48542797	harbor1	chr19	48349817	48349983	DNA/hAT-Charlie	731	+	83	48349900	7103
chr19	48342797	48542797	harbor1	chr19	48374583	48374693	DNA/hAT-Charlie	805	+	55	48374638	31841
chr19	48342797	48542797	harbor1	chr19	48375002	48375025	DNA/hAT-Charlie	805	+	12	48375014	32217
chr19	48342797	48542797	harbor1	chr19	48375326	48375397	DNA/hAT-Charlie	805	+	36	48375362	32565
chr19	48342797	48542797	harbor1	chr19	48403294	48403532	DNA/hAT-Charlie	873	+	119	48403413	60616
chr19	16442283	16642283	harbor1	chr19	16507029	16507232	DNA/hAT-Charlie	730	+	102	16507131	64848
chr19	51194759	51394759	harbor1	chr19	51262255	51262603	DNA/hAT-Charlie	1115	+	174	51262429	67670
chr19	1939769	2139769	harbor1	chr19	2006631	2006691	DNA/hAT-Charlie	951	+	30	2006661	66892
chr19	1939769	2139769	harbor1	chr19	2007291	2007451	DNA/hAT-Charlie	951	+	80	2007371	67602
chr19	1598756	1798756	harbor1	chr19	1634754	1634969	DNA/hAT-Charlie	871	+	108	1634862	36106
chr19	1598756	1798756	harbor1	chr19	1696734	1696902	DNA/hAT-Charlie	683	+	84	1696818	98062
chr19	2356931	2556931	harbor1	chr19	2416993	2417183	DNA/hAT-Charlie	804	+	95	2417088	60157
chr19	54031600	54231600	harbor1	chr19	54040164	54040310	DNA/hAT-Charlie	682	+	73	54040237	8637
chr19	54031600	54231600	harbor1	chr19	54104554	54104728	DNA/hAT-Charlie	917	+	87	54104641	73041
chr19	54031600	54231600	harbor1	chr19	54105034	54105144	DNA/hAT-Charlie	917	+	55	54105089	73489
chr19	41252149	41452149	harbor1	chr19	41346605	41346719	DNA/hAT-Charlie	772	+	57	41346662	94513
chr19	41252149	41452149	harbor1	chr19	41347026	41347037	DNA/hAT-Charlie	772	+	6	41347032	94883
chr19	41252149	41452149	harbor1	chr19	41347323	41347399	DNA/hAT-Charlie	772	+	38	41347361	95212
chr19	12938763	13138763	harbor1	chr19	13037729	13037924	DNA/hAT-Charlie	1021	+	98	13037827	99064
chr19	1946248	2146248	harbor1	chr19	2006631	2006691	DNA/hAT-Charlie	951	+	30	2006661	60413
chr19	1946248	2146248	harbor1	chr19	2007291	2007451	DNA/hAT-Charlie	951	+	80	2007371	61123
chr19	46919957	47119957	harbor1	chr19	46982691	46982762	DNA/hAT-Charlie	789	+	36	46982727	62770
chr19	46919957	47119957	harbor1	chr19	46983085	46983196	DNA/hAT-Charlie	789	+	56	46983141	63184
chr19	46919998	47119998	harbor1	chr19	46982691	46982762	DNA/hAT-Charlie	789	+	36	46982727	62729
chr19	46919998	47119998	harbor1	chr19	46983085	46983196	DNA/hAT-Charlie	789	+	56	46983141	63143
chr19	5237563	5437563	harbor1	chr19	5307820	5308017	DNA/hAT-Charlie	1024	+	98	5307918	70355
chr19	48525162	48725162	harbor1	chr19	48525348	48525386	DNA/hAT-Charlie	655	+	19	48525367	205
chr19	48525162	48725162	harbor1	chr19	48525823	48525968	DNA/hAT-Charlie	655	+	72	48525895	733
chr19	48525162	48725162	harbor1	chr19	48526591	48526805	DNA/hAT-Charlie	864	+	107	48526698	1536
chr19	49750828	49950828	harbor1	chr19	49838175	49839413	DNA/hAT-Charlie	3934	+	619	49838794	87966
chr19	49750828	49950828	harbor1	chr19	49839486	49840475	DNA/hAT-Charlie	3257	+	494	49839980	89152
chr19	208555	408555	harbor1	chr19	244132	244351	DNA/hAT-Charlie	810	+	110	244242	35687
chr19	3966007	4166007	harbor1	chr19	4050564	4050815	DNA/hAT-Charlie	790	+	126	4050690	84683
chr19	5521997	5721997	harbor1	chr19	5603707	5603971	DNA/hAT-Charlie	1055	+	132	5603839	81842
chr19	5521997	5721997	harbor1	chr19	5617591	5617777	DNA/hAT-Charlie	744	+	93	5617684	95687
chr19	3963972	4163972	harbor1	chr19	4050564	4050815	DNA/hAT-Charlie	790	+	126	4050690	86718
chr19	5523058	5723058	harbor1	chr19	5603707	5603971	DNA/hAT-Charlie	1055	+	132	5603839	80781
chr19	5523058	5723058	harbor1	chr19	5617591	5617777	DNA/hAT-Charlie	744	+	93	5617684	94626
chr19	11406143	11606143	harbor1	chr19	11408724	11408771	DNA/hAT-Charlie	782	+	24	11408748	2605
chr19	11406143	11606143	harbor1	chr19	11409537	11409936	DNA/hAT-Charlie	782	+	200	11409737	3594
chr19	11406143	11606143	harbor1	chr19	11410301	11410411	DNA/hAT-Charlie	782	+	55	11410356	4213
chr19	58377396	58577396	harbor1	chr19	58468938	58469138	DNA/hAT-Charlie	1312	+	100	58469038	91642
chr19	18536609	18736609	harbor1	chr19	18562958	18563172	DNA/hAT-Charlie	1374	+	107	18563065	26456
chr19	58377122	58577122	harbor1	chr19	58468938	58469138	DNA/hAT-Charlie	1312	+	100	58469038	91916
chr19	12938709	13138709	harbor1	chr19	13037729	13037924	DNA/hAT-Charlie	1021	+	98	13037827	99118
chr19	5486695	5686695	harbor1	chr19	5491661	5491862	DNA/hAT-Charlie	793	+	100	5491761	5066
chr19	3946298	4146298	harbor1	chr19	3948690	3948889	DNA/hAT-Charlie	712	+	100	3948790	2492
chr19	1505449	1705449	harbor1	chr19	1538724	1538937	DNA/hAT-Charlie	773	+	106	1538830	33381
chr19	12938716	13138716	harbor1	chr19	13037729	13037924	DNA/hAT-Charlie	1021	+	98	13037827	99111
chr19	18319318	18519318	harbor1	chr19	18334118	18334508	DNA/hAT-Charlie	2163	+	195	18334313	14995
chr19	2483587	2683587	harbor1	chr19	2522045	2522245	DNA/hAT-Charlie	782	+	100	2522145	38558
chr19	2483587	2683587	harbor1	chr19	2545135	2545327	DNA/hAT-Charlie	782	+	96	2545231	61644
chr19	2483587	2683587	harbor1	chr19	2551990	2552155	DNA/hAT-Charlie	1124	+	82	2552072	68485
chr19	2483587	2683587	harbor1	chr19	2552324	2552379	DNA/hAT-Charlie	1667	+	28	2552352	68765
chr19	2483587	2683587	harbor1	chr19	2552685	2552933	DNA/hAT-Charlie	1667	+	124	2552809	69222
chr19	2483587	2683587	harbor1	chr19	2561205	2561409	DNA/hAT-Charlie	662	+	102	2561307	77720
chr19	56021112	56221112	harbor1	chr19	56024830	56025326	DNA/hAT-Charlie	3395	+	248	56025078	3966
chr19	56021112	56221112	harbor1	chr19	56078481	56078667	DNA/hAT-Charlie	1419	+	93	56078574	57462
chr19	1	171197	harbor1	chr19	68877	69126	DNA/hAT-Charlie	1396	+	124	69001	69000
chr19	1	171197	harbor1	chr19	78654	79040	DNA/hAT-Charlie	1683	+	193	78847	78846
chr19	5521801	5721801	harbor1	chr19	5603707	5603971	DNA/hAT-Charlie	1055	+	132	5603839	82038
chr19	5521801	5721801	harbor1	chr19	5617591	5617777	DNA/hAT-Charlie	744	+	93	5617684	95883
chr19	12938727	13138727	harbor1	chr19	13037729	13037924	DNA/hAT-Charlie	1021	+	98	13037827	99100
chr19	49767567	49967567	harbor1	chr19	49838175	49839413	DNA/hAT-Charlie	3934	+	619	49838794	71227
chr19	49767567	49967567	harbor1	chr19	49839486	49840475	DNA/hAT-Charlie	3257	+	494	49839980	72413
chr19	49751409	49951409	harbor1	chr19	49838175	49839413	DNA/hAT-Charlie	3934	+	619	49838794	87385
chr19	49751409	49951409	harbor1	chr19	49839486	49840475	DNA/hAT-Charlie	3257	+	494	49839980	88571
chr19	1350373	1550373	harbor1	chr19	1372139	1372343	DNA/hAT-Charlie	647	+	102	1372241	21868
chr19	13905974	14105974	harbor1	chr19	13915004	13915256	DNA/hAT-Charlie	679	+	126	13915130	9156
chr19	13905974	14105974	harbor1	chr19	13915548	13915574	DNA/hAT-Charlie	679	+	13	13915561	9587
chr19	13905974	14105974	harbor1	chr19	13915849	13915973	DNA/hAT-Charlie	679	+	62	13915911	9937
chr19	13905974	14105974	harbor1	chr19	13916267	13916283	DNA/hAT-Charlie	679	+	8	13916275	10301
chr19	13905974	14105974	harbor1	chr19	13916585	13916713	DNA/hAT-Charlie	679	+	64	13916649	10675
chr19	12938873	13138873	harbor1	chr19	13037729	13037924	DNA/hAT-Charlie	1021	+	98	13037827	98954
chr19	3288104	3488104	harbor1	chr19	3350291	3350540	DNA/hAT-Charlie	1045	+	124	3350415	62311
chr19	3288104	3488104	harbor1	chr19	3363705	3363907	DNA/hAT-Charlie	690	+	101	3363806	75702
chr19	48525086	48725086	harbor1	chr19	48525348	48525386	DNA/hAT-Charlie	655	+	19	48525367	281
chr19	48525086	48725086	harbor1	chr19	48525823	48525968	DNA/hAT-Charlie	655	+	72	48525895	809
chr19	48525086	48725086	harbor1	chr19	48526591	48526805	DNA/hAT-Charlie	864	+	107	48526698	1612
chr20	34725542	34925542	harbor1	chr20	34728399	34728601	DNA/hAT-Charlie	1135	+	101	34728500	2958
chr20	34725542	34925542	harbor1	chr20	34754285	34754494	DNA/hAT-Charlie	822	+	104	34754389	28847
chr20	34725542	34925542	harbor1	chr20	34758396	34758601	DNA/hAT-Charlie	734	+	102	34758498	32956
chr20	34725542	34925542	harbor1	chr20	34765588	34765799	DNA/hAT-Charlie	1245	+	106	34765694	40152
chr20	34725542	34925542	harbor1	chr20	34773039	34773256	DNA/hAT-Charlie	1064	+	108	34773147	47605
chr20	34725542	34925542	harbor1	chr20	34808412	34808436	DNA/hAT-Charlie	594	+	12	34808424	82882
chr20	34725542	34925542	harbor1	chr20	34808738	34808905	DNA/hAT-Charlie	594	+	84	34808822	83280
chr20	34725542	34925542	harbor1	chr20	34822763	34823191	DNA/hAT-Charlie	1732	+	214	34822977	97435
chr20	34725654	34925654	harbor1	chr20	34728399	34728601	DNA/hAT-Charlie	1135	+	101	34728500	2846
chr20	34725654	34925654	harbor1	chr20	34754285	34754494	DNA/hAT-Charlie	822	+	104	34754389	28735
chr20	34725654	34925654	harbor1	chr20	34758396	34758601	DNA/hAT-Charlie	734	+	102	34758498	32844
chr20	34725654	34925654	harbor1	chr20	34765588	34765799	DNA/hAT-Charlie	1245	+	106	34765694	40040
chr20	34725654	34925654	harbor1	chr20	34773039	34773256	DNA/hAT-Charlie	1064	+	108	34773147	47493
chr20	34725654	34925654	harbor1	chr20	34808412	34808436	DNA/hAT-Charlie	594	+	12	34808424	82770
chr20	34725654	34925654	harbor1	chr20	34808738	34808905	DNA/hAT-Charlie	594	+	84	34808822	83168
chr20	34725654	34925654	harbor1	chr20	34822763	34823191	DNA/hAT-Charlie	1732	+	214	34822977	97323
chr20	34725628	34925628	harbor1	chr20	34728399	34728601	DNA/hAT-Charlie	1135	+	101	34728500	2872
chr20	34725628	34925628	harbor1	chr20	34754285	34754494	DNA/hAT-Charlie	822	+	104	34754389	28761
chr20	34725628	34925628	harbor1	chr20	34758396	34758601	DNA/hAT-Charlie	734	+	102	34758498	32870
chr20	34725628	34925628	harbor1	chr20	34765588	34765799	DNA/hAT-Charlie	1245	+	106	34765694	40066
chr20	34725628	34925628	harbor1	chr20	34773039	34773256	DNA/hAT-Charlie	1064	+	108	34773147	47519
chr20	34725628	34925628	harbor1	chr20	34808412	34808436	DNA/hAT-Charlie	594	+	12	34808424	82796
chr20	34725628	34925628	harbor1	chr20	34808738	34808905	DNA/hAT-Charlie	594	+	84	34808822	83194
chr20	34725628	34925628	harbor1	chr20	34822763	34823191	DNA/hAT-Charlie	1732	+	214	34822977	97349
chr20	34725550	34925550	harbor1	chr20	34728399	34728601	DNA/hAT-Charlie	1135	+	101	34728500	2950
chr20	34725550	34925550	harbor1	chr20	34754285	34754494	DNA/hAT-Charlie	822	+	104	34754389	28839
chr20	34725550	34925550	harbor1	chr20	34758396	34758601	DNA/hAT-Charlie	734	+	102	34758498	32948
chr20	34725550	34925550	harbor1	chr20	34765588	34765799	DNA/hAT-Charlie	1245	+	106	34765694	40144
chr20	34725550	34925550	harbor1	chr20	34773039	34773256	DNA/hAT-Charlie	1064	+	108	34773147	47597
chr20	34725550	34925550	harbor1	chr20	34808412	34808436	DNA/hAT-Charlie	594	+	12	34808424	82874
chr20	34725550	34925550	harbor1	chr20	34808738	34808905	DNA/hAT-Charlie	594	+	84	34808822	83272
chr20	34725550	34925550	harbor1	chr20	34822763	34823191	DNA/hAT-Charlie	1732	+	214	34822977	97427
chr20	2740647	2940647	harbor1	chr20	2808049	2808121	DNA/hAT-Charlie	520	+	36	2808085	67438
chr20	2740647	2940647	harbor1	chr20	2808451	2808510	DNA/hAT-Charlie	520	+	30	2808481	67834
chr20	2740647	2940647	harbor1	chr20	2808743	2808778	DNA/hAT-Charlie	520	+	18	2808761	68114
chr20	2740647	2940647	harbor1	chr20	2819467	2819576	DNA/hAT-Charlie	693	+	54	2819521	78874
chr20	2740647	2940647	harbor1	chr20	2819876	2819931	DNA/hAT-Charlie	693	+	28	2819904	79257
chr20	2740647	2940647	harbor1	chr20	2830703	2830829	DNA/hAT-Charlie	994	+	63	2830766	90119
chr20	2740647	2940647	harbor1	chr20	2831801	2832316	DNA/hAT-Charlie	994	+	258	2832059	91412
chr20	2740647	2940647	harbor1	chr20	2832622	2832745	DNA/hAT-Charlie	994	+	62	2832684	92037
chr20	34725652	34925652	harbor1	chr20	34728399	34728601	DNA/hAT-Charlie	1135	+	101	34728500	2848
chr20	34725652	34925652	harbor1	chr20	34754285	34754494	DNA/hAT-Charlie	822	+	104	34754389	28737
chr20	34725652	34925652	harbor1	chr20	34758396	34758601	DNA/hAT-Charlie	734	+	102	34758498	32846
chr20	34725652	34925652	harbor1	chr20	34765588	34765799	DNA/hAT-Charlie	1245	+	106	34765694	40042
chr20	34725652	34925652	harbor1	chr20	34773039	34773256	DNA/hAT-Charlie	1064	+	108	34773147	47495
chr20	34725652	34925652	harbor1	chr20	34808412	34808436	DNA/hAT-Charlie	594	+	12	34808424	82772
chr20	34725652	34925652	harbor1	chr20	34808738	34808905	DNA/hAT-Charlie	594	+	84	34808822	83170
chr20	34725652	34925652	harbor1	chr20	34822763	34823191	DNA/hAT-Charlie	1732	+	214	34822977	97325
chr20	34903928	35103928	harbor1	chr20	34904878	34904905	DNA/hAT-Charlie	552	+	14	34904892	964
chr20	34903928	35103928	harbor1	chr20	34905217	34905262	DNA/hAT-Charlie	552	+	22	34905239	1311
chr20	34903928	35103928	harbor1	chr20	34905560	34905821	DNA/hAT-Charlie	552	+	130	34905690	1762
chr20	44866470	45066470	harbor1	chr20	44870636	44870838	DNA/hAT-Charlie	747	+	101	44870737	4267
chr20	44866470	45066470	harbor1	chr20	44922759	44922964	DNA/hAT-Charlie	939	+	102	44922861	56391
chr20	62322429	62522429	harbor1	chr20	62343028	62343244	DNA/hAT-Charlie	776	+	108	62343136	20707
chr20	34904026	35104026	harbor1	chr20	34904878	34904905	DNA/hAT-Charlie	552	+	14	34904892	866
chr20	34904026	35104026	harbor1	chr20	34905217	34905262	DNA/hAT-Charlie	552	+	22	34905239	1213
chr20	34904026	35104026	harbor1	chr20	34905560	34905821	DNA/hAT-Charlie	552	+	130	34905690	1664
chr20	330383	530383	harbor1	chr20	385528	385682	DNA/hAT-Charlie	744	+	77	385605	55222
chr20	330383	530383	harbor1	chr20	429153	429226	DNA/hAT-Charlie	1352	+	36	429189	98806
chr20	330383	530383	harbor1	chr20	429521	429759	DNA/hAT-Charlie	1352	+	119	429640	99257
chr20	1018818	1218818	harbor1	chr20	1040119	1040605	DNA/hAT-Charlie	648	+	243	1040362	21544
chr20	1018818	1218818	harbor1	chr20	1085118	1085243	DNA/hAT-Charlie	595	+	62	1085180	66362
chr20	3686183	3886183	harbor1	chr20	3762658	3762830	DNA/hAT-Charlie	633	+	86	3762744	76561
chr20	63472105	63672105	harbor1	chr20	63480368	63480581	DNA/hAT-Charlie	655	+	106	63480474	8369
chr20	4586429	4786429	harbor1	chr20	4588080	4588247	DNA/hAT-Charlie	1542	+	84	4588164	1735
chr20	4586429	4786429	harbor1	chr20	4640729	4641058	DNA/hAT-Charlie	2046	+	164	4640893	54464
chr20	4586429	4786429	harbor1	chr20	4650514	4650670	DNA/hAT-Charlie	880	+	78	4650592	64163
chr20	4586429	4786429	harbor1	chr20	4674030	4674148	DNA/hAT-Charlie	549	+	59	4674089	87660
chr20	4586429	4786429	harbor1	chr20	4682004	4682181	DNA/hAT-Charlie	975	+	88	4682092	95663
chr20	4586429	4786429	harbor1	chr20	4587464	4587785	DNA/hAT-Charlie	1542	+	160	4587624	1195
chr20	63471534	63671534	harbor1	chr20	63480368	63480581	DNA/hAT-Charlie	655	+	106	63480474	8940
chr20	22734563	22934563	harbor1	chr20	22769578	22769691	DNA/hAT-Charlie	611	+	56	22769634	35071
chr20	2739816	2939816	harbor1	chr20	2808049	2808121	DNA/hAT-Charlie	520	+	36	2808085	68269
chr20	2739816	2939816	harbor1	chr20	2808451	2808510	DNA/hAT-Charlie	520	+	30	2808481	68665
chr20	2739816	2939816	harbor1	chr20	2808743	2808778	DNA/hAT-Charlie	520	+	18	2808761	68945
chr20	2739816	2939816	harbor1	chr20	2819467	2819576	DNA/hAT-Charlie	693	+	54	2819521	79705
chr20	2739816	2939816	harbor1	chr20	2819876	2819931	DNA/hAT-Charlie	693	+	28	2819904	80088
chr20	2739816	2939816	harbor1	chr20	2830703	2830829	DNA/hAT-Charlie	994	+	63	2830766	90950
chr20	2739816	2939816	harbor1	chr20	2831801	2832316	DNA/hAT-Charlie	994	+	258	2832059	92243
chr20	2739816	2939816	harbor1	chr20	2832622	2832745	DNA/hAT-Charlie	994	+	62	2832684	92868
chr20	63429646	63629646	harbor1	chr20	63480368	63480581	DNA/hAT-Charlie	655	+	106	63480474	50828
chr20	49710583	49910583	harbor1	chr20	49744674	49744861	DNA/hAT-Charlie	667	+	94	49744768	34185
chr20	49710583	49910583	harbor1	chr20	49809930	49810127	DNA/hAT-Charlie	929	+	98	49810028	99445
chr20	34725660	34925660	harbor1	chr20	34728399	34728601	DNA/hAT-Charlie	1135	+	101	34728500	2840
chr20	34725660	34925660	harbor1	chr20	34754285	34754494	DNA/hAT-Charlie	822	+	104	34754389	28729
chr20	34725660	34925660	harbor1	chr20	34758396	34758601	DNA/hAT-Charlie	734	+	102	34758498	32838
chr20	34725660	34925660	harbor1	chr20	34765588	34765799	DNA/hAT-Charlie	1245	+	106	34765694	40034
chr20	34725660	34925660	harbor1	chr20	34773039	34773256	DNA/hAT-Charlie	1064	+	108	34773147	47487
chr20	34725660	34925660	harbor1	chr20	34808412	34808436	DNA/hAT-Charlie	594	+	12	34808424	82764
chr20	34725660	34925660	harbor1	chr20	34808738	34808905	DNA/hAT-Charlie	594	+	84	34808822	83162
chr20	34725660	34925660	harbor1	chr20	34822763	34823191	DNA/hAT-Charlie	1732	+	214	34822977	97317
chr20	2740637	2940637	harbor1	chr20	2808049	2808121	DNA/hAT-Charlie	520	+	36	2808085	67448
chr20	2740637	2940637	harbor1	chr20	2808451	2808510	DNA/hAT-Charlie	520	+	30	2808481	67844
chr20	2740637	2940637	harbor1	chr20	2808743	2808778	DNA/hAT-Charlie	520	+	18	2808761	68124
chr20	2740637	2940637	harbor1	chr20	2819467	2819576	DNA/hAT-Charlie	693	+	54	2819521	78884
chr20	2740637	2940637	harbor1	chr20	2819876	2819931	DNA/hAT-Charlie	693	+	28	2819904	79267
chr20	2740637	2940637	harbor1	chr20	2830703	2830829	DNA/hAT-Charlie	994	+	63	2830766	90129
chr20	2740637	2940637	harbor1	chr20	2831801	2832316	DNA/hAT-Charlie	994	+	258	2832059	91422
chr20	2740637	2940637	harbor1	chr20	2832622	2832745	DNA/hAT-Charlie	994	+	62	2832684	92047
chr20	2740649	2940649	harbor1	chr20	2808049	2808121	DNA/hAT-Charlie	520	+	36	2808085	67436
chr20	2740649	2940649	harbor1	chr20	2808451	2808510	DNA/hAT-Charlie	520	+	30	2808481	67832
chr20	2740649	2940649	harbor1	chr20	2808743	2808778	DNA/hAT-Charlie	520	+	18	2808761	68112
chr20	2740649	2940649	harbor1	chr20	2819467	2819576	DNA/hAT-Charlie	693	+	54	2819521	78872
chr20	2740649	2940649	harbor1	chr20	2819876	2819931	DNA/hAT-Charlie	693	+	28	2819904	79255
chr20	2740649	2940649	harbor1	chr20	2830703	2830829	DNA/hAT-Charlie	994	+	63	2830766	90117
chr20	2740649	2940649	harbor1	chr20	2831801	2832316	DNA/hAT-Charlie	994	+	258	2832059	91410
chr20	2740649	2940649	harbor1	chr20	2832622	2832745	DNA/hAT-Charlie	994	+	62	2832684	92035
chr20	38574510	38774510	harbor1	chr20	38580518	38580762	DNA/hAT-Charlie	623	+	122	38580640	6130
chr20	38574510	38774510	harbor1	chr20	38616727	38616935	DNA/hAT-Charlie	870	+	104	38616831	42321
chr20	38574510	38774510	harbor1	chr20	38625769	38625983	DNA/hAT-Charlie	539	+	107	38625876	51366
chr20	38574510	38774510	harbor1	chr20	38641999	38642279	DNA/hAT-Charlie	782	+	140	38642139	67629
chr20	38574510	38774510	harbor1	chr20	38669244	38669382	DNA/hAT-Charlie	601	+	69	38669313	94803
chr20	38574510	38774510	harbor1	chr20	38670114	38670237	DNA/hAT-Charlie	511	+	62	38670176	95666
chr20	63420408	63620408	harbor1	chr20	63480368	63480581	DNA/hAT-Charlie	655	+	106	63480474	60066
chr20	43583080	43783080	harbor1	chr20	43603338	43603476	DNA/hAT-Charlie	578	+	69	43603407	20327
chr20	43583080	43783080	harbor1	chr20	43648090	43648169	DNA/hAT-Charlie	1143	+	40	43648130	65050
chr20	43583080	43783080	harbor1	chr20	43648456	43648486	DNA/hAT-Charlie	1143	+	15	43648471	65391
chr20	43583080	43783080	harbor1	chr20	43649103	43649128	DNA/hAT-Charlie	1143	+	12	43649115	66035
chr20	43583080	43783080	harbor1	chr20	43649439	43649544	DNA/hAT-Charlie	1143	+	52	43649491	66411
chr20	34901268	35101268	harbor1	chr20	34904878	34904905	DNA/hAT-Charlie	552	+	14	34904892	3624
chr20	34901268	35101268	harbor1	chr20	34905217	34905262	DNA/hAT-Charlie	552	+	22	34905239	3971
chr20	34901268	35101268	harbor1	chr20	34905560	34905821	DNA/hAT-Charlie	552	+	130	34905690	4422
chr20	34725622	34925622	harbor1	chr20	34728399	34728601	DNA/hAT-Charlie	1135	+	101	34728500	2878
chr20	34725622	34925622	harbor1	chr20	34754285	34754494	DNA/hAT-Charlie	822	+	104	34754389	28767
chr20	34725622	34925622	harbor1	chr20	34758396	34758601	DNA/hAT-Charlie	734	+	102	34758498	32876
chr20	34725622	34925622	harbor1	chr20	34765588	34765799	DNA/hAT-Charlie	1245	+	106	34765694	40072
chr20	34725622	34925622	harbor1	chr20	34773039	34773256	DNA/hAT-Charlie	1064	+	108	34773147	47525
chr20	34725622	34925622	harbor1	chr20	34808412	34808436	DNA/hAT-Charlie	594	+	12	34808424	82802
chr20	34725622	34925622	harbor1	chr20	34808738	34808905	DNA/hAT-Charlie	594	+	84	34808822	83200
chr20	34725622	34925622	harbor1	chr20	34822763	34823191	DNA/hAT-Charlie	1732	+	214	34822977	97355
chr20	4799071	4999071	harbor1	chr20	4811370	4811494	DNA/hAT-Charlie	526	+	62	4811432	12361
chr20	4799071	4999071	harbor1	chr20	4848149	4848504	DNA/hAT-Charlie	2199	+	178	4848327	49256
chr20	4799071	4999071	harbor1	chr20	4888173	4888372	DNA/hAT-Charlie	780	+	100	4888273	89202
chr20	48275448	48475448	harbor1	chr20	48276432	48276544	DNA/hAT-Charlie	492	+	56	48276488	1040
chr20	48275448	48475448	harbor1	chr20	48277553	48278215	DNA/hAT-Charlie	1524	+	331	48277884	2436
chr20	48275448	48475448	harbor1	chr20	48355210	48355418	DNA/hAT-Charlie	958	+	104	48355314	79866
chr20	48275448	48475448	harbor1	chr20	48369583	48369672	DNA/hAT-Charlie	489	+	44	48369627	94179
chr20	48275448	48475448	harbor1	chr20	48370915	48371164	DNA/hAT-Charlie	659	+	124	48371039	95591
chr20	32720146	32920146	harbor1	chr20	32747022	32747093	DNA/hAT-Charlie	635	+	36	32747058	26912
chr20	32720146	32920146	harbor1	chr20	32747404	32747424	DNA/hAT-Charlie	635	+	10	32747414	27268
chr20	32720146	32920146	harbor1	chr20	32747706	32747800	DNA/hAT-Charlie	635	+	47	32747753	27607
chr20	3686190	3886190	harbor1	chr20	3762658	3762830	DNA/hAT-Charlie	633	+	86	3762744	76554
chr20	3074005	3274005	harbor1	chr20	3106468	3106602	DNA/hAT-Charlie	653	+	67	3106535	32530
chr20	3074005	3274005	harbor1	chr20	3127405	3127780	DNA/hAT-Charlie	1325	+	188	3127593	53588
chr20	3074005	3274005	harbor1	chr20	3135557	3135812	DNA/hAT-Charlie	676	+	128	3135685	61680
chr20	3074005	3274005	harbor1	chr20	3151249	3151463	DNA/hAT-Charlie	922	+	107	3151356	77351
chr20	3074005	3274005	harbor1	chr20	3159292	3159401	DNA/hAT-Charlie	498	+	54	3159346	85341
chr20	21818150	22018150	harbor1	chr20	21821540	21821721	DNA/hAT-Charlie	639	+	90	21821630	3480
chr20	21818150	22018150	harbor1	chr20	21875369	21875554	DNA/hAT-Charlie	882	+	92	21875461	57311
chr20	33594101	33794101	harbor1	chr20	33597415	33597687	DNA/hAT-Charlie	1663	+	136	33597551	3450
chr20	33594101	33794101	harbor1	chr20	33598950	33598978	DNA/hAT-Charlie	485	+	14	33598964	4863
chr20	33594101	33794101	harbor1	chr20	33599275	33599367	DNA/hAT-Charlie	485	+	46	33599321	5220
chr20	33594101	33794101	harbor1	chr20	33612399	33612789	DNA/hAT-Charlie	515	+	195	33612594	18493
chr20	33594101	33794101	harbor1	chr20	33621182	33621287	DNA/hAT-Charlie	472	+	52	33621234	27133
chr20	33594101	33794101	harbor1	chr20	33621600	33621646	DNA/hAT-Charlie	472	+	23	33621623	27522
chr20	40589402	40789402	harbor1	chr20	40618708	40619042	DNA/hAT-Charlie	1409	+	167	40618875	29473
chr20	40589402	40789402	harbor1	chr20	40634861	40635047	DNA/hAT-Charlie	915	+	93	40634954	45552
chr20	63452725	63652725	harbor1	chr20	63480368	63480581	DNA/hAT-Charlie	655	+	106	63480474	27749
chr20	34725651	34925651	harbor1	chr20	34728399	34728601	DNA/hAT-Charlie	1135	+	101	34728500	2849
chr20	34725651	34925651	harbor1	chr20	34754285	34754494	DNA/hAT-Charlie	822	+	104	34754389	28738
chr20	34725651	34925651	harbor1	chr20	34758396	34758601	DNA/hAT-Charlie	734	+	102	34758498	32847
chr20	34725651	34925651	harbor1	chr20	34765588	34765799	DNA/hAT-Charlie	1245	+	106	34765694	40043
chr20	34725651	34925651	harbor1	chr20	34773039	34773256	DNA/hAT-Charlie	1064	+	108	34773147	47496
chr20	34725651	34925651	harbor1	chr20	34808412	34808436	DNA/hAT-Charlie	594	+	12	34808424	82773
chr20	34725651	34925651	harbor1	chr20	34808738	34808905	DNA/hAT-Charlie	594	+	84	34808822	83171
chr20	34725651	34925651	harbor1	chr20	34822763	34823191	DNA/hAT-Charlie	1732	+	214	34822977	97326
chr20	2740727	2940727	harbor1	chr20	2808049	2808121	DNA/hAT-Charlie	520	+	36	2808085	67358
chr20	2740727	2940727	harbor1	chr20	2808451	2808510	DNA/hAT-Charlie	520	+	30	2808481	67754
chr20	2740727	2940727	harbor1	chr20	2808743	2808778	DNA/hAT-Charlie	520	+	18	2808761	68034
chr20	2740727	2940727	harbor1	chr20	2819467	2819576	DNA/hAT-Charlie	693	+	54	2819521	78794
chr20	2740727	2940727	harbor1	chr20	2819876	2819931	DNA/hAT-Charlie	693	+	28	2819904	79177
chr20	2740727	2940727	harbor1	chr20	2830703	2830829	DNA/hAT-Charlie	994	+	63	2830766	90039
chr20	2740727	2940727	harbor1	chr20	2831801	2832316	DNA/hAT-Charlie	994	+	258	2832059	91332
chr20	2740727	2940727	harbor1	chr20	2832622	2832745	DNA/hAT-Charlie	994	+	62	2832684	91957
chr20	50269813	50469813	harbor1	chr20	50281225	50281446	DNA/hAT-Charlie	1167	+	110	50281335	11522
chr20	50269813	50469813	harbor1	chr20	50304830	50305111	DNA/hAT-Charlie	619	+	140	50304970	35157
chr20	50269813	50469813	harbor1	chr20	50314174	50314427	DNA/hAT-Charlie	734	+	126	50314300	44487
chr20	50269813	50469813	harbor1	chr20	50315450	50315700	DNA/hAT-Charlie	796	+	125	50315575	45762
chr20	50269813	50469813	harbor1	chr20	50318911	50319191	DNA/hAT-Charlie	968	+	140	50319051	49238
chr20	50269813	50469813	harbor1	chr20	50341803	50342087	DNA/hAT-Charlie	813	+	142	50341945	72132
chr20	50269813	50469813	harbor1	chr20	50342261	50342478	DNA/hAT-Charlie	1030	+	108	50342369	72556
chr20	50269813	50469813	harbor1	chr20	50364935	50365152	DNA/hAT-Charlie	1390	+	108	50365043	95230
chr20	63472027	63672027	harbor1	chr20	63480368	63480581	DNA/hAT-Charlie	655	+	106	63480474	8447
chr20	4071169	4271169	harbor1	chr20	4108632	4108733	DNA/hAT-Charlie	533	+	50	4108682	37513
chr20	4071169	4271169	harbor1	chr20	4113050	4113234	DNA/hAT-Charlie	1010	+	92	4113142	41973
chr20	4071169	4271169	harbor1	chr20	4135029	4135204	DNA/hAT-Charlie	918	+	88	4135117	63948
chr20	4071169	4271169	harbor1	chr20	4140887	4140965	DNA/hAT-Charlie	574	+	39	4140926	69757
chr20	59839798	60039798	harbor1	chr20	59841698	59841905	DNA/hAT-Charlie	1111	+	104	59841802	2004
chr20	59839798	60039798	harbor1	chr20	59851860	59851956	DNA/hAT-Charlie	525	+	48	59851908	12110
chr20	59839798	60039798	harbor1	chr20	59917915	59919045	DNA/hAT-Charlie	5484	+	565	59918480	78682
chr20	43408519	43608519	harbor1	chr20	43431914	43432209	DNA/hAT-Charlie	1421	+	148	43432062	23543
chr20	43408519	43608519	harbor1	chr20	43432632	43432816	DNA/hAT-Charlie	958	+	92	43432724	24205
chr20	43408519	43608519	harbor1	chr20	43440609	43440730	DNA/hAT-Charlie	655	+	60	43440669	32150
chr20	32720119	32920119	harbor1	chr20	32747022	32747093	DNA/hAT-Charlie	635	+	36	32747058	26939
chr20	32720119	32920119	harbor1	chr20	32747404	32747424	DNA/hAT-Charlie	635	+	10	32747414	27295
chr20	32720119	32920119	harbor1	chr20	32747706	32747800	DNA/hAT-Charlie	635	+	47	32747753	27634
chr20	5027110	5227110	harbor1	chr20	5061345	5061494	DNA/hAT-Charlie	666	+	74	5061419	34309
chr20	5027110	5227110	harbor1	chr20	5080900	5081138	DNA/hAT-Charlie	848	+	119	5081019	53909
chr20	63471568	63671568	harbor1	chr20	63480368	63480581	DNA/hAT-Charlie	655	+	106	63480474	8906
chr20	63468216	63668216	harbor1	chr20	63480368	63480581	DNA/hAT-Charlie	655	+	106	63480474	12258
chr20	38574499	38774499	harbor1	chr20	38580518	38580762	DNA/hAT-Charlie	623	+	122	38580640	6141
chr20	38574499	38774499	harbor1	chr20	38616727	38616935	DNA/hAT-Charlie	870	+	104	38616831	42332
chr20	38574499	38774499	harbor1	chr20	38625769	38625983	DNA/hAT-Charlie	539	+	107	38625876	51377
chr20	38574499	38774499	harbor1	chr20	38641999	38642279	DNA/hAT-Charlie	782	+	140	38642139	67640
chr20	38574499	38774499	harbor1	chr20	38669244	38669382	DNA/hAT-Charlie	601	+	69	38669313	94814
chr20	38574499	38774499	harbor1	chr20	38670114	38670237	DNA/hAT-Charlie	511	+	62	38670176	95677
chr20	3914093	4114093	harbor1	chr20	3980712	3980929	DNA/hAT-Charlie	596	+	108	3980820	66727
chr20	61271130	61471130	harbor1	chr20	61320518	61320723	DNA/hAT-Charlie	703	+	102	61320620	49490
chr20	61271130	61471130	harbor1	chr20	61354044	61354217	DNA/hAT-Charlie	500	+	86	61354130	83000
chr20	61271130	61471130	harbor1	chr20	61292453	61292649	DNA/hAT-Charlie	620	+	98	61292551	21421
chr20	33574220	33774220	harbor1	chr20	33597415	33597687	DNA/hAT-Charlie	1663	+	136	33597551	23331
chr20	33574220	33774220	harbor1	chr20	33598950	33598978	DNA/hAT-Charlie	485	+	14	33598964	24744
chr20	33574220	33774220	harbor1	chr20	33599275	33599367	DNA/hAT-Charlie	485	+	46	33599321	25101
chr20	33574220	33774220	harbor1	chr20	33612399	33612789	DNA/hAT-Charlie	515	+	195	33612594	38374
chr20	33574220	33774220	harbor1	chr20	33621182	33621287	DNA/hAT-Charlie	472	+	52	33621234	47014
chr20	33574220	33774220	harbor1	chr20	33621600	33621646	DNA/hAT-Charlie	472	+	23	33621623	47403
chr20	54108072	54308072	harbor1	chr20	54111944	54112212	DNA/hAT-Charlie	835	+	134	54112078	4006
chr20	54108072	54308072	harbor1	chr20	54118429	54118647	DNA/hAT-Charlie	885	+	109	54118538	10466
chr20	54108072	54308072	harbor1	chr20	54141480	54141695	DNA/hAT-Charlie	1163	+	108	54141588	33516
chr20	54108072	54308072	harbor1	chr20	54156114	54156184	DNA/hAT-Charlie	933	+	35	54156149	48077
chr20	54108072	54308072	harbor1	chr20	54156724	54156868	DNA/hAT-Charlie	933	+	72	54156796	48724
chr20	54108072	54308072	harbor1	chr20	54170513	54170812	DNA/hAT-Charlie	626	+	150	54170663	62591
chr20	54108072	54308072	harbor1	chr20	54206673	54207067	DNA/hAT-Charlie	1806	+	197	54206870	98798
chr20	54108072	54308072	harbor1	chr20	54165104	54165570	DNA/hAT-Charlie	2858	+	233	54165337	57265
chr20	2740635	2940635	harbor1	chr20	2808049	2808121	DNA/hAT-Charlie	520	+	36	2808085	67450
chr20	2740635	2940635	harbor1	chr20	2808451	2808510	DNA/hAT-Charlie	520	+	30	2808481	67846
chr20	2740635	2940635	harbor1	chr20	2808743	2808778	DNA/hAT-Charlie	520	+	18	2808761	68126
chr20	2740635	2940635	harbor1	chr20	2819467	2819576	DNA/hAT-Charlie	693	+	54	2819521	78886
chr20	2740635	2940635	harbor1	chr20	2819876	2819931	DNA/hAT-Charlie	693	+	28	2819904	79269
chr20	2740635	2940635	harbor1	chr20	2830703	2830829	DNA/hAT-Charlie	994	+	63	2830766	90131
chr20	2740635	2940635	harbor1	chr20	2831801	2832316	DNA/hAT-Charlie	994	+	258	2832059	91424
chr20	2740635	2940635	harbor1	chr20	2832622	2832745	DNA/hAT-Charlie	994	+	62	2832684	92049
chr20	38705777	38905777	harbor1	chr20	38791360	38791532	DNA/hAT-Charlie	842	+	86	38791446	85669
chr20	1018817	1218817	harbor1	chr20	1040119	1040605	DNA/hAT-Charlie	648	+	243	1040362	21545
chr20	1018817	1218817	harbor1	chr20	1085118	1085243	DNA/hAT-Charlie	595	+	62	1085180	66363
chr20	37933379	38133379	harbor1	chr20	37956689	37957208	DNA/hAT-Charlie	2106	+	260	37956949	23570
chr20	37933379	38133379	harbor1	chr20	37959979	37960317	DNA/hAT-Charlie	1856	+	169	37960148	26769
chr20	37933379	38133379	harbor1	chr20	38007379	38007592	DNA/hAT-Charlie	501	+	106	38007485	74106
chr20	34992759	35192759	harbor1	chr20	35042488	35042813	DNA/hAT-Charlie	641	+	162	35042650	49891
chr20	34992759	35192759	harbor1	chr20	35049165	35049767	DNA/hAT-Charlie	1038	+	301	35049466	56707
chr20	34992759	35192759	harbor1	chr20	35053576	35053910	DNA/hAT-Charlie	1205	+	167	35053743	60984
chr20	34992759	35192759	harbor1	chr20	35077480	35077579	DNA/hAT-Charlie	580	+	50	35077530	84771
chr20	34992759	35192759	harbor1	chr20	35012215	35012622	DNA/hAT-Charlie	647	+	204	35012419	19660
chr20	59833005	60033005	harbor1	chr20	59841698	59841905	DNA/hAT-Charlie	1111	+	104	59841802	8797
chr20	59833005	60033005	harbor1	chr20	59851860	59851956	DNA/hAT-Charlie	525	+	48	59851908	18903
chr20	59833005	60033005	harbor1	chr20	59917915	59919045	DNA/hAT-Charlie	5484	+	565	59918480	85475
chr20	50269781	50469781	harbor1	chr20	50281225	50281446	DNA/hAT-Charlie	1167	+	110	50281335	11554
chr20	50269781	50469781	harbor1	chr20	50304830	50305111	DNA/hAT-Charlie	619	+	140	50304970	35189
chr20	50269781	50469781	harbor1	chr20	50314174	50314427	DNA/hAT-Charlie	734	+	126	50314300	44519
chr20	50269781	50469781	harbor1	chr20	50315450	50315700	DNA/hAT-Charlie	796	+	125	50315575	45794
chr20	50269781	50469781	harbor1	chr20	50318911	50319191	DNA/hAT-Charlie	968	+	140	50319051	49270
chr20	50269781	50469781	harbor1	chr20	50341803	50342087	DNA/hAT-Charlie	813	+	142	50341945	72164
chr20	50269781	50469781	harbor1	chr20	50342261	50342478	DNA/hAT-Charlie	1030	+	108	50342369	72588
chr20	50269781	50469781	harbor1	chr20	50364935	50365152	DNA/hAT-Charlie	1390	+	108	50365043	95262
chr20	36114483	36314483	harbor1	chr20	36145668	36145825	DNA/hAT-Charlie	567	+	78	36145746	31263
chr21	29198953	29398953	harbor1	chr21	29204820	29204990	DNA/hAT-Charlie	830	+	85	29204905	5952
chr21	29198953	29398953	harbor1	chr21	29207057	29207216	DNA/hAT-Charlie	643	+	80	29207137	8184
chr21	29198953	29398953	harbor1	chr21	29268249	29268416	DNA/hAT-Charlie	561	+	84	29268333	69380
chr21	29198953	29398953	harbor1	chr21	29272253	29272581	DNA/hAT-Charlie	863	+	164	29272417	73464
chr21	14337769	14537769	harbor1	chr21	14350811	14351056	DNA/hAT-Charlie	442	+	122	14350933	13164
chr21	14337769	14537769	harbor1	chr21	14376965	14377177	DNA/hAT-Charlie	1083	+	106	14377071	39302
chr21	5028567	5228567	harbor1	chr21	5068528	5068688	DNA/hAT-Charlie	575	+	80	5068608	40041
chr21	33070300	33270300	harbor1	chr21	33084974	33085290	DNA/hAT-Charlie	1293	+	158	33085132	14832
chr21	33070300	33270300	harbor1	chr21	33087753	33087884	DNA/hAT-Charlie	521	+	66	33087819	17519
chr21	33070300	33270300	harbor1	chr21	33108901	33109000	DNA/hAT-Charlie	596	+	50	33108951	38651
chr21	33070300	33270300	harbor1	chr21	33109311	33109369	DNA/hAT-Charlie	596	+	29	33109340	39040
chr21	33070300	33270300	harbor1	chr21	33138361	33138772	DNA/hAT-Charlie	1373	+	206	33138567	68267
chr21	14337822	14537822	harbor1	chr21	14350811	14351056	DNA/hAT-Charlie	442	+	122	14350933	13111
chr21	14337822	14537822	harbor1	chr21	14376965	14377177	DNA/hAT-Charlie	1083	+	106	14377071	39249
chr21	41771682	41971682	harbor1	chr21	41863243	41863429	DNA/hAT-Charlie	739	+	93	41863336	91654
chr21	29199129	29399129	harbor1	chr21	29204820	29204990	DNA/hAT-Charlie	830	+	85	29204905	5776
chr21	29199129	29399129	harbor1	chr21	29207057	29207216	DNA/hAT-Charlie	643	+	80	29207137	8008
chr21	29199129	29399129	harbor1	chr21	29268249	29268416	DNA/hAT-Charlie	561	+	84	29268333	69204
chr21	29199129	29399129	harbor1	chr21	29272253	29272581	DNA/hAT-Charlie	863	+	164	29272417	73288
chr21	29198948	29398948	harbor1	chr21	29204820	29204990	DNA/hAT-Charlie	830	+	85	29204905	5957
chr21	29198948	29398948	harbor1	chr21	29207057	29207216	DNA/hAT-Charlie	643	+	80	29207137	8189
chr21	29198948	29398948	harbor1	chr21	29268249	29268416	DNA/hAT-Charlie	561	+	84	29268333	69385
chr21	29198948	29398948	harbor1	chr21	29272253	29272581	DNA/hAT-Charlie	863	+	164	29272417	73469
chr21	39008447	39208447	harbor1	chr21	39009323	39009638	DNA/hAT-Charlie	606	+	158	39009481	1034
chr21	39008447	39208447	harbor1	chr21	39040973	39041487	DNA/hAT-Charlie	2032	+	257	39041230	32783
chr21	39008447	39208447	harbor1	chr21	39053863	39054076	DNA/hAT-Charlie	1152	+	106	39053969	45522
chr21	39008447	39208447	harbor1	chr21	39068232	39068342	DNA/hAT-Charlie	595	+	55	39068287	59840
chr21	39008447	39208447	harbor1	chr21	39070894	39071030	DNA/hAT-Charlie	481	+	68	39070962	62515
chr21	39008447	39208447	harbor1	chr21	39071310	39071422	DNA/hAT-Charlie	481	+	56	39071366	62919
chr21	39008447	39208447	harbor1	chr21	39081918	39082351	DNA/hAT-Charlie	1519	+	216	39082134	73687
chr21	39008447	39208447	harbor1	chr21	39085027	39085143	DNA/hAT-Charlie	680	+	58	39085085	76638
chr21	39008447	39208447	harbor1	chr21	39099802	39100240	DNA/hAT-Charlie	2699	+	219	39100021	91574
chr21	39008447	39208447	harbor1	chr21	39100235	39100691	DNA/hAT-Charlie	3352	+	228	39100463	92016
chr21	39008447	39208447	harbor1	chr21	39104499	39104722	DNA/hAT-Charlie	525	+	112	39104611	96164
chr21	39008447	39208447	harbor1	chr21	39104735	39104920	DNA/hAT-Charlie	1691	+	92	39104827	96380
chr21	39008447	39208447	harbor1	chr21	39105245	39105393	DNA/hAT-Charlie	1691	+	74	39105319	96872
chr21	42275771	42475771	harbor1	chr21	42320609	42320831	DNA/hAT-Charlie	1463	+	111	42320720	44949
chr21	5008533	5208533	harbor1	chr21	5068528	5068688	DNA/hAT-Charlie	575	+	80	5068608	60075
chr21	14337781	14537781	harbor1	chr21	14350811	14351056	DNA/hAT-Charlie	442	+	122	14350933	13152
chr21	14337781	14537781	harbor1	chr21	14376965	14377177	DNA/hAT-Charlie	1083	+	106	14377071	39290
chr21	46031163	46231163	harbor1	chr21	46051283	46051415	DNA/hAT-Charlie	586	+	66	46051349	20186
chr21	46031163	46231163	harbor1	chr21	46051411	46051931	DNA/hAT-Charlie	1355	+	260	46051671	20508
chr21	14337791	14537791	harbor1	chr21	14350811	14351056	DNA/hAT-Charlie	442	+	122	14350933	13142
chr21	14337791	14537791	harbor1	chr21	14376965	14377177	DNA/hAT-Charlie	1083	+	106	14377071	39280
chr21	29199041	29399041	harbor1	chr21	29204820	29204990	DNA/hAT-Charlie	830	+	85	29204905	5864
chr21	29199041	29399041	harbor1	chr21	29207057	29207216	DNA/hAT-Charlie	643	+	80	29207137	8096
chr21	29199041	29399041	harbor1	chr21	29268249	29268416	DNA/hAT-Charlie	561	+	84	29268333	69292
chr21	29199041	29399041	harbor1	chr21	29272253	29272581	DNA/hAT-Charlie	863	+	164	29272417	73376
chr21	14336442	14536442	harbor1	chr21	14350811	14351056	DNA/hAT-Charlie	442	+	122	14350933	14491
chr21	14336442	14536442	harbor1	chr21	14376965	14377177	DNA/hAT-Charlie	1083	+	106	14377071	40629
chr21	14337826	14537826	harbor1	chr21	14350811	14351056	DNA/hAT-Charlie	442	+	122	14350933	13107
chr21	14337826	14537826	harbor1	chr21	14376965	14377177	DNA/hAT-Charlie	1083	+	106	14377071	39245
chr21	39008502	39208502	harbor1	chr21	39009323	39009638	DNA/hAT-Charlie	606	+	158	39009481	979
chr21	39008502	39208502	harbor1	chr21	39040973	39041487	DNA/hAT-Charlie	2032	+	257	39041230	32728
chr21	39008502	39208502	harbor1	chr21	39053863	39054076	DNA/hAT-Charlie	1152	+	106	39053969	45467
chr21	39008502	39208502	harbor1	chr21	39068232	39068342	DNA/hAT-Charlie	595	+	55	39068287	59785
chr21	39008502	39208502	harbor1	chr21	39070894	39071030	DNA/hAT-Charlie	481	+	68	39070962	62460
chr21	39008502	39208502	harbor1	chr21	39071310	39071422	DNA/hAT-Charlie	481	+	56	39071366	62864
chr21	39008502	39208502	harbor1	chr21	39081918	39082351	DNA/hAT-Charlie	1519	+	216	39082134	73632
chr21	39008502	39208502	harbor1	chr21	39085027	39085143	DNA/hAT-Charlie	680	+	58	39085085	76583
chr21	39008502	39208502	harbor1	chr21	39099802	39100240	DNA/hAT-Charlie	2699	+	219	39100021	91519
chr21	39008502	39208502	harbor1	chr21	39100235	39100691	DNA/hAT-Charlie	3352	+	228	39100463	91961
chr21	39008502	39208502	harbor1	chr21	39104499	39104722	DNA/hAT-Charlie	525	+	112	39104611	96109
chr21	39008502	39208502	harbor1	chr21	39104735	39104920	DNA/hAT-Charlie	1691	+	92	39104827	96325
chr21	39008502	39208502	harbor1	chr21	39105245	39105393	DNA/hAT-Charlie	1691	+	74	39105319	96817
chr21	14337835	14537835	harbor1	chr21	14350811	14351056	DNA/hAT-Charlie	442	+	122	14350933	13098
chr21	14337835	14537835	harbor1	chr21	14376965	14377177	DNA/hAT-Charlie	1083	+	106	14377071	39236
chr21	42275718	42475718	harbor1	chr21	42320609	42320831	DNA/hAT-Charlie	1463	+	111	42320720	45002
chr21	29199063	29399063	harbor1	chr21	29204820	29204990	DNA/hAT-Charlie	830	+	85	29204905	5842
chr21	29199063	29399063	harbor1	chr21	29207057	29207216	DNA/hAT-Charlie	643	+	80	29207137	8074
chr21	29199063	29399063	harbor1	chr21	29268249	29268416	DNA/hAT-Charlie	561	+	84	29268333	69270
chr21	29199063	29399063	harbor1	chr21	29272253	29272581	DNA/hAT-Charlie	863	+	164	29272417	73354
chr21	29198984	29398984	harbor1	chr21	29204820	29204990	DNA/hAT-Charlie	830	+	85	29204905	5921
chr21	29198984	29398984	harbor1	chr21	29207057	29207216	DNA/hAT-Charlie	643	+	80	29207137	8153
chr21	29198984	29398984	harbor1	chr21	29268249	29268416	DNA/hAT-Charlie	561	+	84	29268333	69349
chr21	29198984	29398984	harbor1	chr21	29272253	29272581	DNA/hAT-Charlie	863	+	164	29272417	73433
chr21	39008480	39208480	harbor1	chr21	39009323	39009638	DNA/hAT-Charlie	606	+	158	39009481	1001
chr21	39008480	39208480	harbor1	chr21	39040973	39041487	DNA/hAT-Charlie	2032	+	257	39041230	32750
chr21	39008480	39208480	harbor1	chr21	39053863	39054076	DNA/hAT-Charlie	1152	+	106	39053969	45489
chr21	39008480	39208480	harbor1	chr21	39068232	39068342	DNA/hAT-Charlie	595	+	55	39068287	59807
chr21	39008480	39208480	harbor1	chr21	39070894	39071030	DNA/hAT-Charlie	481	+	68	39070962	62482
chr21	39008480	39208480	harbor1	chr21	39071310	39071422	DNA/hAT-Charlie	481	+	56	39071366	62886
chr21	39008480	39208480	harbor1	chr21	39081918	39082351	DNA/hAT-Charlie	1519	+	216	39082134	73654
chr21	39008480	39208480	harbor1	chr21	39085027	39085143	DNA/hAT-Charlie	680	+	58	39085085	76605
chr21	39008480	39208480	harbor1	chr21	39099802	39100240	DNA/hAT-Charlie	2699	+	219	39100021	91541
chr21	39008480	39208480	harbor1	chr21	39100235	39100691	DNA/hAT-Charlie	3352	+	228	39100463	91983
chr21	39008480	39208480	harbor1	chr21	39104499	39104722	DNA/hAT-Charlie	525	+	112	39104611	96131
chr21	39008480	39208480	harbor1	chr21	39104735	39104920	DNA/hAT-Charlie	1691	+	92	39104827	96347
chr21	39008480	39208480	harbor1	chr21	39105245	39105393	DNA/hAT-Charlie	1691	+	74	39105319	96839
chr21	33666298	33866298	harbor1	chr21	33666691	33666798	DNA/hAT-Charlie	619	+	54	33666745	447
chr21	33666298	33866298	harbor1	chr21	33667128	33667290	DNA/hAT-Charlie	542	+	81	33667209	911
chr21	33666298	33866298	harbor1	chr21	33667290	33667357	DNA/hAT-Charlie	472	+	34	33667324	1026
chr21	33666298	33866298	harbor1	chr21	33764987	33765202	DNA/hAT-Charlie	764	+	108	33765095	98797
chr21	46536367	46736367	harbor1	chr21	46546317	46546543	DNA/hAT-Charlie	759	+	113	46546430	10063
chr21	46536367	46736367	harbor1	chr21	46571001	46571334	DNA/hAT-Charlie	2020	+	166	46571167	34800
chr21	14173498	14373498	harbor1	chr21	14208502	14208762	DNA/hAT-Charlie	1176	+	130	14208632	35134
chr21	14173498	14373498	harbor1	chr21	14225992	14226336	DNA/hAT-Charlie	1549	+	172	14226164	52666
chr21	14173498	14373498	harbor1	chr21	14226646	14226666	DNA/hAT-Charlie	1549	+	10	14226656	53158
chr21	14173498	14373498	harbor1	chr21	14259426	14259584	DNA/hAT-Charlie	726	+	79	14259505	86007
chr21	14173498	14373498	harbor1	chr21	14268215	14268914	DNA/hAT-Charlie	2168	+	350	14268565	95067
chr21	42467105	42667105	harbor1	chr21	42537478	42537690	DNA/hAT-Charlie	1278	+	106	42537584	70479
chr21	14337834	14537834	harbor1	chr21	14350811	14351056	DNA/hAT-Charlie	442	+	122	14350933	13099
chr21	14337834	14537834	harbor1	chr21	14376965	14377177	DNA/hAT-Charlie	1083	+	106	14377071	39237
chr21	15625713	15825713	harbor1	chr21	15684604	15684766	DNA/hAT-Charlie	758	+	81	15684685	58972
chr21	15625713	15825713	harbor1	chr21	15689918	15690105	DNA/hAT-Charlie	820	+	94	15690012	64299
chr21	14337784	14537784	harbor1	chr21	14350811	14351056	DNA/hAT-Charlie	442	+	122	14350933	13149
chr21	14337784	14537784	harbor1	chr21	14376965	14377177	DNA/hAT-Charlie	1083	+	106	14377071	39287
chr21	33379496	33579496	harbor1	chr21	33396185	33396637	DNA/hAT-Charlie	2977	+	226	33396411	16915
chr21	33379496	33579496	harbor1	chr21	33405550	33405748	DNA/hAT-Charlie	551	+	99	33405649	26153
chr21	33379496	33579496	harbor1	chr21	33421867	33422077	DNA/hAT-Charlie	1120	+	105	33421972	42476
chr21	33379496	33579496	harbor1	chr21	33440144	33440299	DNA/hAT-Charlie	719	+	78	33440222	60726
chr21	33734948	33934948	harbor1	chr21	33764987	33765202	DNA/hAT-Charlie	764	+	108	33765095	30147
chr21	33734948	33934948	harbor1	chr21	33805504	33805621	DNA/hAT-Charlie	522	+	58	33805562	70614
chr22	24057065	24257065	harbor1	chr22	24076955	24077117	DNA/hAT-Charlie	832	+	81	24077036	19971
chr22	24057065	24257065	harbor1	chr22	24111281	24111613	DNA/hAT-Charlie	2076	+	166	24111447	54382
chr22	19075025	19275025	harbor1	chr22	19089534	19089576	DNA/hAT-Charlie	791	+	21	19089555	14530
chr22	19075025	19275025	harbor1	chr22	19089881	19090032	DNA/hAT-Charlie	791	+	76	19089957	14932
chr22	42772450	42972450	harbor1	chr22	42789348	42789623	DNA/hAT-Charlie	1180	+	138	42789486	17036
chr22	42772450	42972450	harbor1	chr22	42837994	42838204	DNA/hAT-Charlie	653	+	105	42838099	65649
chr22	24069874	24269874	harbor1	chr22	24076955	24077117	DNA/hAT-Charlie	832	+	81	24077036	7162
chr22	24069874	24269874	harbor1	chr22	24111281	24111613	DNA/hAT-Charlie	2076	+	166	24111447	41573
chr22	24069906	24269906	harbor1	chr22	24076955	24077117	DNA/hAT-Charlie	832	+	81	24077036	7130
chr22	24069906	24269906	harbor1	chr22	24111281	24111613	DNA/hAT-Charlie	2076	+	166	24111447	41541
chr22	38298285	38498285	harbor1	chr22	38354366	38354528	DNA/hAT-Charlie	666	+	81	38354447	56162
chr22	38298285	38498285	harbor1	chr22	38354827	38354862	DNA/hAT-Charlie	666	+	18	38354845	56560
chr22	24070023	24270023	harbor1	chr22	24076955	24077117	DNA/hAT-Charlie	832	+	81	24077036	7013
chr22	24070023	24270023	harbor1	chr22	24111281	24111613	DNA/hAT-Charlie	2076	+	166	24111447	41424
chr22	43896078	44096078	harbor1	chr22	43914736	43914948	DNA/hAT-Charlie	479	+	106	43914842	18764
chr22	43896078	44096078	harbor1	chr22	43915040	43915165	DNA/hAT-Charlie	591	+	62	43915102	19024
chr22	43896078	44096078	harbor1	chr22	43915407	43915542	DNA/hAT-Charlie	591	+	68	43915475	19397
chr22	43896078	44096078	harbor1	chr22	43928319	43928502	DNA/hAT-Charlie	578	+	92	43928411	32333
chr22	43896078	44096078	harbor1	chr22	43974121	43974250	DNA/hAT-Charlie	483	+	64	43974185	78107
chr22	26575728	26775728	harbor1	chr22	26578317	26578457	DNA/hAT-Charlie	437	+	70	26578387	2659
chr22	26575728	26775728	harbor1	chr22	26582032	26582145	DNA/hAT-Charlie	551	+	56	26582088	6360
chr22	26575728	26775728	harbor1	chr22	26582458	26582520	DNA/hAT-Charlie	551	+	31	26582489	6761
chr22	26575728	26775728	harbor1	chr22	26590621	26590826	DNA/hAT-Charlie	779	+	102	26590723	14995
chr22	26575728	26775728	harbor1	chr22	26597757	26597871	DNA/hAT-Charlie	488	+	57	26597814	22086
chr22	26575728	26775728	harbor1	chr22	26598183	26598319	DNA/hAT-Charlie	488	+	68	26598251	22523
chr22	26575728	26775728	harbor1	chr22	26598686	26598884	DNA/hAT-Charlie	525	+	99	26598785	23057
chr22	26575728	26775728	harbor1	chr22	26605912	26606129	DNA/hAT-Charlie	1389	+	108	26606020	30292
chr22	26575728	26775728	harbor1	chr22	26608410	26608745	DNA/hAT-Charlie	822	+	168	26608578	32850
chr22	26575728	26775728	harbor1	chr22	26622900	26623141	DNA/hAT-Charlie	597	+	120	26623020	47292
chr22	26575728	26775728	harbor1	chr22	26636448	26636560	DNA/hAT-Charlie	526	+	56	26636504	60776
chr22	26575728	26775728	harbor1	chr22	26623872	26624073	DNA/hAT-Charlie	860	+	100	26623972	48244
chr22	43426643	43626643	harbor1	chr22	43448223	43448427	DNA/hAT-Charlie	800	+	102	43448325	21682
chr22	24065808	24265808	harbor1	chr22	24076955	24077117	DNA/hAT-Charlie	832	+	81	24077036	11228
chr22	24065808	24265808	harbor1	chr22	24111281	24111613	DNA/hAT-Charlie	2076	+	166	24111447	45639
chr22	42989526	43189526	harbor1	chr22	43019482	43019727	DNA/hAT-Charlie	582	+	122	43019604	30078
chr22	42989526	43189526	harbor1	chr22	43075700	43075903	DNA/hAT-Charlie	977	+	102	43075802	86276
chr22	39374584	39574584	harbor1	chr22	39443776	39443830	DNA/hAT-Charlie	569	+	27	39443803	69219
chr22	39374584	39574584	harbor1	chr22	39444139	39444282	DNA/hAT-Charlie	569	+	72	39444211	69627
chr22	39374584	39574584	harbor1	chr22	39455613	39455876	DNA/hAT-Charlie	1282	+	132	39455745	81161
chr22	32075946	32275946	harbor1	chr22	32076921	32077109	DNA/hAT-Charlie	890	+	94	32077015	1069
chr22	32075946	32275946	harbor1	chr22	32083447	32083710	DNA/hAT-Charlie	617	+	132	32083579	7633
chr22	32075946	32275946	harbor1	chr22	32103739	32103848	DNA/hAT-Charlie	583	+	54	32103793	27847
chr22	32075946	32275946	harbor1	chr22	32113281	32113472	DNA/hAT-Charlie	1010	+	96	32113377	37431
chr22	32075946	32275946	harbor1	chr22	32165391	32165595	DNA/hAT-Charlie	617	+	102	32165493	89547
chr22	24069929	24269929	harbor1	chr22	24076955	24077117	DNA/hAT-Charlie	832	+	81	24077036	7107
chr22	24069929	24269929	harbor1	chr22	24111281	24111613	DNA/hAT-Charlie	2076	+	166	24111447	41518
chr22	24070054	24270054	harbor1	chr22	24076955	24077117	DNA/hAT-Charlie	832	+	81	24077036	6982
chr22	24070054	24270054	harbor1	chr22	24111281	24111613	DNA/hAT-Charlie	2076	+	166	24111447	41393
chr22	36675743	36875743	harbor1	chr22	36684130	36684330	DNA/hAT-Charlie	563	+	100	36684230	8487
chr22	36675743	36875743	harbor1	chr22	36688762	36688906	DNA/hAT-Charlie	596	+	72	36688834	13091
chr22	36675743	36875743	harbor1	chr22	36722548	36722705	DNA/hAT-Charlie	449	+	78	36722626	46883
chr22	36675743	36875743	harbor1	chr22	36741342	36741509	DNA/hAT-Charlie	755	+	84	36741426	65683
chr22	22997061	23197061	harbor1	chr22	23010294	23010471	DNA/hAT-Charlie	600	+	88	23010382	13321
chr22	22997061	23197061	harbor1	chr22	23077013	23077124	DNA/hAT-Charlie	422	+	56	23077069	80008
chr22	22997061	23197061	harbor1	chr22	23085860	23086211	DNA/hAT-Charlie	910	+	176	23086036	88975
chr22	49664026	49864026	harbor1	chr22	49729362	49729594	DNA/hAT-Charlie	656	+	116	49729478	65452
chr22	49664089	49864089	harbor1	chr22	49729362	49729594	DNA/hAT-Charlie	656	+	116	49729478	65389
chr22	38768951	38968951	harbor1	chr22	38815082	38815273	DNA/hAT-Charlie	911	+	96	38815178	46227
chr22	38768951	38968951	harbor1	chr22	38817461	38817714	DNA/hAT-Charlie	578	+	126	38817587	48636
chr22	44201115	44401115	harbor1	chr22	44279826	44279955	DNA/hAT-Charlie	447	+	64	44279890	78775
chr22	44201115	44401115	harbor1	chr22	44293346	44293537	DNA/hAT-Charlie	555	+	96	44293442	92327
chr22	44201115	44401115	harbor1	chr22	44298306	44298482	DNA/hAT-Charlie	611	+	88	44298394	97279
chr22	42989515	43189515	harbor1	chr22	43019482	43019727	DNA/hAT-Charlie	582	+	122	43019604	30089
chr22	42989515	43189515	harbor1	chr22	43075700	43075903	DNA/hAT-Charlie	977	+	102	43075802	86287
chr22	23366695	23566695	harbor1	chr22	23367050	23367192	DNA/hAT-Charlie	766	+	71	23367121	426
chr22	42989521	43189521	harbor1	chr22	43019482	43019727	DNA/hAT-Charlie	582	+	122	43019604	30083
chr22	42989521	43189521	harbor1	chr22	43075700	43075903	DNA/hAT-Charlie	977	+	102	43075802	86281
chr22	23017696	23217696	harbor1	chr22	23077013	23077124	DNA/hAT-Charlie	422	+	56	23077069	59373
chr22	23017696	23217696	harbor1	chr22	23085860	23086211	DNA/hAT-Charlie	910	+	176	23086036	68340
chr22	22295458	22495458	harbor1	chr22	22305884	22306057	DNA/hAT-Charlie	811	+	86	22305970	10512
chr22	30847282	31047282	harbor1	chr22	30918865	30919383	DNA/hAT-Charlie	3836	+	259	30919124	71842
chr22	30847282	31047282	harbor1	chr22	30931207	30931420	DNA/hAT-Charlie	1027	+	106	30931313	84031
chr22	24069894	24269894	harbor1	chr22	24076955	24077117	DNA/hAT-Charlie	832	+	81	24077036	7142
chr22	24069894	24269894	harbor1	chr22	24111281	24111613	DNA/hAT-Charlie	2076	+	166	24111447	41553
chr22	36186442	36386442	harbor1	chr22	36196167	36196310	DNA/hAT-Charlie	459	+	72	36196239	9797
chr22	42801583	43001583	harbor1	chr22	42837994	42838204	DNA/hAT-Charlie	653	+	105	42838099	36516
chr22	24007199	24207199	harbor1	chr22	24010696	24010884	DNA/hAT-Charlie	1183	+	94	24010790	3591
chr22	24007199	24207199	harbor1	chr22	24076955	24077117	DNA/hAT-Charlie	832	+	81	24077036	69837
chr22	18930100	19130100	harbor1	chr22	19006170	19006342	DNA/hAT-Charlie	703	+	86	19006256	76156
chr22	18930100	19130100	harbor1	chr22	19006628	19006727	DNA/hAT-Charlie	703	+	50	19006678	76578
chr22	18930100	19130100	harbor1	chr22	19020024	19020281	DNA/hAT-Charlie	447	+	128	19020152	90052
chr22	30996891	31196891	harbor1	chr22	31015288	31015497	DNA/hAT-Charlie	687	+	104	31015392	18501
chr22	30996891	31196891	harbor1	chr22	31036706	31036911	DNA/hAT-Charlie	903	+	102	31036808	39917
chr22	42597660	42797660	harbor1	chr22	42625743	42625986	DNA/hAT-Charlie	830	+	122	42625865	28205
chr22	42597660	42797660	harbor1	chr22	42656888	42656971	DNA/hAT-Charlie	489	+	42	42656930	59270
chr22	42597660	42797660	harbor1	chr22	42659629	42660162	DNA/hAT-Charlie	3858	+	266	42659895	62235
chr22	19075024	19275024	harbor1	chr22	19089534	19089576	DNA/hAT-Charlie	791	+	21	19089555	14531
chr22	19075024	19275024	harbor1	chr22	19089881	19090032	DNA/hAT-Charlie	791	+	76	19089957	14933
chr22	23366710	23566710	harbor1	chr22	23367050	23367192	DNA/hAT-Charlie	766	+	71	23367121	411
chr22	42204285	42404285	harbor1	chr22	42227888	42228006	DNA/hAT-Charlie	498	+	59	42227947	23662
chr22	42204285	42404285	harbor1	chr22	42228813	42228966	DNA/hAT-Charlie	667	+	76	42228889	24604
chr22	23023459	23223459	harbor1	chr22	23077013	23077124	DNA/hAT-Charlie	422	+	56	23077069	53610
chr22	23023459	23223459	harbor1	chr22	23085860	23086211	DNA/hAT-Charlie	910	+	176	23086036	62577
chr22	24069914	24269914	harbor1	chr22	24076955	24077117	DNA/hAT-Charlie	832	+	81	24077036	7122
chr22	24069914	24269914	harbor1	chr22	24111281	24111613	DNA/hAT-Charlie	2076	+	166	24111447	41533
chr22	45313205	45513205	harbor1	chr22	45313746	45313891	DNA/hAT-Charlie	433	+	72	45313818	613
chr22	45313205	45513205	harbor1	chr22	45324618	45324762	DNA/hAT-Charlie	654	+	72	45324690	11485
chr22	45313205	45513205	harbor1	chr22	45405713	45406193	DNA/hAT-Charlie	1847	+	240	45405953	92748
chr22	24069997	24269997	harbor1	chr22	24076955	24077117	DNA/hAT-Charlie	832	+	81	24077036	7039
chr22	24069997	24269997	harbor1	chr22	24111281	24111613	DNA/hAT-Charlie	2076	+	166	24111447	41450
chr22	50167794	50367794	harbor1	chr22	50242738	50242830	DNA/hAT-Charlie	519	+	46	50242784	74990
chr22	36918777	37118777	harbor1	chr22	37001120	37001276	DNA/hAT-Charlie	493	+	78	37001198	82421
chr22	36918807	37118807	harbor1	chr22	37001120	37001276	DNA/hAT-Charlie	493	+	78	37001198	82391
chr22	24062659	24262659	harbor1	chr22	24076955	24077117	DNA/hAT-Charlie	832	+	81	24077036	14377
chr22	24062659	24262659	harbor1	chr22	24111281	24111613	DNA/hAT-Charlie	2076	+	166	24111447	48788
chr22	42784441	42984441	harbor1	chr22	42789348	42789623	DNA/hAT-Charlie	1180	+	138	42789486	5045
chr22	42784441	42984441	harbor1	chr22	42837994	42838204	DNA/hAT-Charlie	653	+	105	42838099	53658
chr22	20568033	20768033	harbor1	chr22	20647183	20647367	DNA/hAT-Charlie	703	+	92	20647275	79242
chr22	36186432	36386432	harbor1	chr22	36196167	36196310	DNA/hAT-Charlie	459	+	72	36196239	9807
chr22	32529769	32729769	harbor1	chr22	32540109	32540204	DNA/hAT-Charlie	559	+	48	32540157	10388
chr22	32529769	32729769	harbor1	chr22	32570841	32570968	DNA/hAT-Charlie	526	+	64	32570905	41136
chr22	32529769	32729769	harbor1	chr22	32577010	32577184	DNA/hAT-Charlie	483	+	87	32577097	47328
chr22	32529769	32729769	harbor1	chr22	32578554	32578764	DNA/hAT-Charlie	601	+	105	32578659	48890
chr22	32529769	32729769	harbor1	chr22	32580187	32580275	DNA/hAT-Charlie	1529	+	44	32580231	50462
chr22	32529769	32729769	harbor1	chr22	32580614	32580855	DNA/hAT-Charlie	1529	+	120	32580734	50965
chr22	32529769	32729769	harbor1	chr22	32580863	32580991	DNA/hAT-Charlie	648	+	64	32580927	51158
chr22	32529769	32729769	harbor1	chr22	32619076	32619214	DNA/hAT-Charlie	719	+	69	32619145	89376
chr22	24017128	24217128	harbor1	chr22	24076955	24077117	DNA/hAT-Charlie	832	+	81	24077036	59908
chr22	24017128	24217128	harbor1	chr22	24111281	24111613	DNA/hAT-Charlie	2076	+	166	24111447	94319
chr22	23018534	23218534	harbor1	chr22	23077013	23077124	DNA/hAT-Charlie	422	+	56	23077069	58535
chr22	23018534	23218534	harbor1	chr22	23085860	23086211	DNA/hAT-Charlie	910	+	176	23086036	67502
chr22	36186441	36386441	harbor1	chr22	36196167	36196310	DNA/hAT-Charlie	459	+	72	36196239	9798
chr22	36186368	36386368	harbor1	chr22	36196167	36196310	DNA/hAT-Charlie	459	+	72	36196239	9871
chr22	36186428	36386428	harbor1	chr22	36196167	36196310	DNA/hAT-Charlie	459	+	72	36196239	9811
chrX	18253915	18453915	harbor1	chrX	18316647	18317005	DNA/hAT-Charlie	1567	+	179	18316826	62911
chrX	130071758	130271758	harbor1	chrX	130090669	130090803	DNA/hAT-Charlie	649	+	67	130090736	18978
chrX	130071758	130271758	harbor1	chrX	130138885	130139100	DNA/hAT-Charlie	996	+	108	130138993	67235
chrX	130071758	130271758	harbor1	chrX	130145743	130145959	DNA/hAT-Charlie	1158	+	108	130145851	74093
chrX	130071758	130271758	harbor1	chrX	130152804	130153041	DNA/hAT-Charlie	609	+	118	130152922	81164
chrX	72043976	72243976	harbor1	chrX	72057643	72058329	DNA/hAT-Charlie	3154	+	343	72057986	14010
chrX	72043976	72243976	harbor1	chrX	72062257	72062427	DNA/hAT-Charlie	566	+	85	72062342	18366
chrX	72043976	72243976	harbor1	chrX	72072101	72072391	DNA/hAT-Charlie	817	+	145	72072246	28270
chrX	72043976	72243976	harbor1	chrX	72083332	72083812	DNA/hAT-Charlie	1855	+	240	72083572	39596
chrX	72043976	72243976	harbor1	chrX	72100490	72100830	DNA/hAT-Charlie	2464	+	170	72100660	56684
chrX	72043976	72243976	harbor1	chrX	72104009	72104457	DNA/hAT-Charlie	1644	+	224	72104233	60257
chrX	72043976	72243976	harbor1	chrX	72110129	72110311	DNA/hAT-Charlie	701	+	91	72110220	66244
chrX	72043976	72243976	harbor1	chrX	72115836	72116029	DNA/hAT-Charlie	772	+	96	72115932	71956
chrX	72043976	72243976	harbor1	chrX	72121738	72122216	DNA/hAT-Charlie	2066	+	239	72121977	78001
chrX	129832695	130032695	harbor1	chrX	129863536	129863723	DNA/hAT-Charlie	819	+	94	129863630	30935
chrX	129832695	130032695	harbor1	chrX	129877629	129877849	DNA/hAT-Charlie	1640	+	110	129877739	45044
chrX	18253792	18453792	harbor1	chrX	18316647	18317005	DNA/hAT-Charlie	1567	+	179	18316826	63034
chrX	39996248	40196248	harbor1	chrX	40026487	40026783	DNA/hAT-Charlie	1171	+	148	40026635	30387
chrX	39996248	40196248	harbor1	chrX	40047235	40047464	DNA/hAT-Charlie	1087	+	114	40047349	51101
chrX	109902871	110102871	harbor1	chrX	109953120	109953347	DNA/hAT-Charlie	1467	+	114	109953234	50363
chrX	109902871	110102871	harbor1	chrX	109957716	109957939	DNA/hAT-Charlie	1205	+	112	109957828	54957
chrX	109902871	110102871	harbor1	chrX	109976549	109976656	DNA/hAT-Charlie	597	+	54	109976603	73732
chrX	37578419	37778419	harbor1	chrX	37598275	37598445	DNA/hAT-Charlie	810	+	85	37598360	19941
chrX	37578419	37778419	harbor1	chrX	37599066	37599318	DNA/hAT-Charlie	583	+	126	37599192	20773
chrX	37578419	37778419	harbor1	chrX	37614218	37614394	DNA/hAT-Charlie	829	+	88	37614306	35887
chrX	37578419	37778419	harbor1	chrX	37616796	37616963	DNA/hAT-Charlie	718	+	84	37616880	38461
chrX	37578419	37778419	harbor1	chrX	37644178	37644360	DNA/hAT-Charlie	741	+	91	37644269	65850
chrX	37578419	37778419	harbor1	chrX	37645741	37645922	DNA/hAT-Charlie	672	+	90	37645831	67412
chrX	37578419	37778419	harbor1	chrX	37660186	37660349	DNA/hAT-Charlie	861	+	82	37660268	81849
chrX	37578419	37778419	harbor1	chrX	37674187	37674527	DNA/hAT-Charlie	1106	+	170	37674357	95938
chrX	72029896	72229896	harbor1	chrX	72035822	72036146	DNA/hAT-Charlie	2263	+	162	72035984	6088
chrX	72029896	72229896	harbor1	chrX	72057643	72058329	DNA/hAT-Charlie	3154	+	343	72057986	28090
chrX	72029896	72229896	harbor1	chrX	72062257	72062427	DNA/hAT-Charlie	566	+	85	72062342	32446
chrX	72029896	72229896	harbor1	chrX	72072101	72072391	DNA/hAT-Charlie	817	+	145	72072246	42350
chrX	72029896	72229896	harbor1	chrX	72083332	72083812	DNA/hAT-Charlie	1855	+	240	72083572	53676
chrX	72029896	72229896	harbor1	chrX	72100490	72100830	DNA/hAT-Charlie	2464	+	170	72100660	70764
chrX	72029896	72229896	harbor1	chrX	72104009	72104457	DNA/hAT-Charlie	1644	+	224	72104233	74337
chrX	72029896	72229896	harbor1	chrX	72110129	72110311	DNA/hAT-Charlie	701	+	91	72110220	80324
chrX	72029896	72229896	harbor1	chrX	72115836	72116029	DNA/hAT-Charlie	772	+	96	72115932	86036
chrX	72029896	72229896	harbor1	chrX	72121738	72122216	DNA/hAT-Charlie	2066	+	239	72121977	92081
chrX	19445154	19645154	harbor1	chrX	19449440	19449661	DNA/hAT-Charlie	1195	+	110	19449550	4396
chrX	19445154	19645154	harbor1	chrX	19452747	19452949	DNA/hAT-Charlie	1353	+	101	19452848	7694
chrX	19445154	19645154	harbor1	chrX	19466890	19467109	DNA/hAT-Charlie	1411	+	110	19467000	21846
chrX	19445154	19645154	harbor1	chrX	19474550	19474926	DNA/hAT-Charlie	1909	+	188	19474738	29584
chrX	19445154	19645154	harbor1	chrX	19475434	19475517	DNA/hAT-Charlie	1909	+	42	19475476	30322
chrX	19445154	19645154	harbor1	chrX	19484109	19484446	DNA/hAT-Charlie	2430	+	168	19484277	39123
chrX	19445154	19645154	harbor1	chrX	19512385	19512484	DNA/hAT-Charlie	615	+	50	19512435	67281
chrX	19445154	19645154	harbor1	chrX	19512759	19512872	DNA/hAT-Charlie	615	+	56	19512815	67661
chrX	48792105	48992105	harbor1	chrX	48796815	48797151	DNA/hAT-Charlie	2531	+	168	48796983	4878
chrX	48792105	48992105	harbor1	chrX	48800231	48800400	DNA/hAT-Charlie	734	+	84	48800315	8210
chrX	7048274	7248274	harbor1	chrX	7064835	7065064	DNA/hAT-Charlie	664	+	114	7064949	16675
chrX	7048274	7248274	harbor1	chrX	7080555	7080748	DNA/hAT-Charlie	579	+	96	7080651	32377
chrX	7048274	7248274	harbor1	chrX	7113760	7113837	DNA/hAT-Charlie	747	+	38	7113798	65524
chrX	7048274	7248274	harbor1	chrX	7114596	7114708	DNA/hAT-Charlie	747	+	56	7114652	66378
chrX	7048274	7248274	harbor1	chrX	7145019	7145271	DNA/hAT-Charlie	945	+	126	7145145	96871
