H_chr	H_start	H_end	Harbor	TE_chr	TE_start	TE_end	TE	score	TE_strand	TE_half	TE_middle_pos	TE_dis
chr1	26400749	26600749	harbor1	chr1	26461859	26462055	DNA/TcMar-Tigger	855	-	98	26461957	61208
chr1	26400749	26600749	harbor1	chr1	26462321	26462755	DNA/TcMar-Tigger	855	-	217	26462538	61789
chr1	227441506	227641506	harbor1	chr1	227458259	227458437	DNA/TcMar-Tigger	608	-	89	227458348	16842
chr1	227441506	227641506	harbor1	chr1	227516446	227516780	DNA/TcMar-Tigger	1514	-	167	227516613	75107
chr1	108941871	109141871	harbor1	chr1	108944602	108944635	DNA/TcMar-Tigger	2872	-	16	108944618	2747
chr1	108941871	109141871	harbor1	chr1	108944929	108945620	DNA/TcMar-Tigger	2872	-	346	108945275	3404
chr1	211033794	211233794	harbor1	chr1	211066304	211066596	DNA/TcMar-Tigger	1373	-	146	211066450	32656
chr1	211033794	211233794	harbor1	chr1	211069719	211069898	DNA/TcMar-Tigger	826	-	90	211069809	36015
chr1	211033794	211233794	harbor1	chr1	211070885	211071858	DNA/TcMar-Tigger	5023	-	486	211071371	37577
chr1	211033794	211233794	harbor1	chr1	211101822	211102225	DNA/TcMar-Tigger	473	-	202	211102024	68230
chr1	6294371	6494371	harbor1	chr1	6365295	6365490	DNA/TcMar-Tigger	2387	-	98	6365393	71022
chr1	6294371	6494371	harbor1	chr1	6365784	6365898	DNA/TcMar-Tigger	2387	-	57	6365841	71470
chr1	6294371	6494371	harbor1	chr1	6366172	6366300	DNA/TcMar-Tigger	2387	-	64	6366236	71865
chr1	6294371	6494371	harbor1	chr1	6366608	6366659	DNA/TcMar-Tigger	2387	-	26	6366634	72263
chr1	6294371	6494371	harbor1	chr1	6366887	6366916	DNA/TcMar-Tigger	2387	-	14	6366901	72530
chr1	6294371	6494371	harbor1	chr1	6367215	6367282	DNA/TcMar-Tigger	2387	-	34	6367249	72878
chr1	6294371	6494371	harbor1	chr1	6369282	6369394	DNA/TcMar-Tigger	486	-	56	6369338	74967
chr1	6294371	6494371	harbor1	chr1	6369861	6369958	DNA/TcMar-Tigger	8394	-	48	6369909	75538
chr1	6294371	6494371	harbor1	chr1	6370367	6370457	DNA/TcMar-Tigger	8394	-	45	6370412	76041
chr1	6294371	6494371	harbor1	chr1	6370793	6370803	DNA/TcMar-Tigger	8394	-	5	6370798	76427
chr1	6294371	6494371	harbor1	chr1	6371109	6371362	DNA/TcMar-Tigger	8394	-	126	6371235	76864
chr1	6294371	6494371	harbor1	chr1	6371662	6371762	DNA/TcMar-Tigger	8394	-	50	6371712	77341
chr1	6294371	6494371	harbor1	chr1	6372066	6372547	DNA/TcMar-Tigger	8394	-	240	6372306	77935
chr1	6294371	6494371	harbor1	chr1	6372850	6373256	DNA/TcMar-Tigger	8394	-	203	6373053	78682
chr1	6294371	6494371	harbor1	chr1	6373551	6373582	DNA/TcMar-Tigger	8394	-	16	6373567	79196
chr1	6294371	6494371	harbor1	chr1	6373883	6373921	DNA/TcMar-Tigger	8394	-	19	6373902	79531
chr1	33156095	33356095	harbor1	chr1	33195417	33196097	DNA/TcMar-Tigger	7019	-	340	33195757	39662
chr1	33156095	33356095	harbor1	chr1	33196409	33196835	DNA/TcMar-Tigger	7019	-	213	33196622	40527
chr1	33156095	33356095	harbor1	chr1	33197413	33197526	DNA/TcMar-Tigger	764	-	56	33197469	41374
chr1	109183430	109383430	harbor1	chr1	109217161	109217387	DNA/TcMar-Tigger	1534	-	113	109217274	33844
chr1	717645	917645	harbor1	chr1	758556	758663	DNA/TcMar-Tigger	518	-	54	758610	40965
chr1	717645	917645	harbor1	chr1	796539	796837	DNA/TcMar-Tigger	1356	-	149	796688	79043
chr1	47316941	47516941	harbor1	chr1	47363085	47363157	DNA/TcMar-Tigger	431	-	36	47363121	46180
chr1	47316941	47516941	harbor1	chr1	47363235	47363312	DNA/TcMar-Tigger	489	-	38	47363273	46332
chr1	226479130	226679130	harbor1	chr1	226528997	226529305	DNA/TcMar-Tigger	1716	-	154	226529151	50021
chr1	226479130	226679130	harbor1	chr1	226567304	226567496	DNA/TcMar-Tigger	722	-	96	226567400	88270
chr1	211033705	211233705	harbor1	chr1	211066304	211066596	DNA/TcMar-Tigger	1373	-	146	211066450	32745
chr1	211033705	211233705	harbor1	chr1	211069719	211069898	DNA/TcMar-Tigger	826	-	90	211069809	36104
chr1	211033705	211233705	harbor1	chr1	211070885	211071858	DNA/TcMar-Tigger	5023	-	486	211071371	37666
chr1	211033705	211233705	harbor1	chr1	211101822	211102225	DNA/TcMar-Tigger	473	-	202	211102024	68319
chr1	47316928	47516928	harbor1	chr1	47363085	47363157	DNA/TcMar-Tigger	431	-	36	47363121	46193
chr1	47316928	47516928	harbor1	chr1	47363235	47363312	DNA/TcMar-Tigger	489	-	38	47363273	46345
chr1	211033814	211233814	harbor1	chr1	211066304	211066596	DNA/TcMar-Tigger	1373	-	146	211066450	32636
chr1	211033814	211233814	harbor1	chr1	211069719	211069898	DNA/TcMar-Tigger	826	-	90	211069809	35995
chr1	211033814	211233814	harbor1	chr1	211070885	211071858	DNA/TcMar-Tigger	5023	-	486	211071371	37557
chr1	211033814	211233814	harbor1	chr1	211101822	211102225	DNA/TcMar-Tigger	473	-	202	211102024	68210
chr1	17288486	17488486	harbor1	chr1	17329344	17329701	DNA/TcMar-Tigger	2302	-	178	17329522	41036
chr1	3246650	3446650	harbor1	chr1	3296792	3297087	DNA/TcMar-Tigger	1541	-	148	3296940	50290
chr1	3246650	3446650	harbor1	chr1	3302018	3302215	DNA/TcMar-Tigger	830	-	98	3302116	55466
chr1	3246650	3446650	harbor1	chr1	3302216	3302394	DNA/TcMar-Tigger	634	-	89	3302305	55655
chr1	3246650	3446650	harbor1	chr1	3302393	3302571	DNA/TcMar-Tigger	526	-	89	3302482	55832
chr1	3246650	3446650	harbor1	chr1	3302585	3302990	DNA/TcMar-Tigger	1438	-	202	3302787	56137
chr1	205330408	205530408	harbor1	chr1	205425186	205425512	DNA/TcMar-Tigger	823	-	163	205425349	94941
chr1	5895458	6095458	harbor1	chr1	5931262	5931457	DNA/TcMar-Tigger	2401	-	98	5931360	35902
chr1	5895458	6095458	harbor1	chr1	5931759	5931797	DNA/TcMar-Tigger	2401	-	19	5931778	36320
chr1	5895458	6095458	harbor1	chr1	5932086	5932390	DNA/TcMar-Tigger	2401	-	152	5932238	36780
chr1	5895458	6095458	harbor1	chr1	5985771	5986083	DNA/TcMar-Tigger	1522	-	156	5985927	90469
chr1	1	128757	harbor1	chr1	60379	60686	DNA/TcMar-Tigger	1529	-	154	60533	60532
chr1	39855348	40055348	harbor1	chr1	39855441	39855654	DNA/TcMar-Tigger	1315	-	106	39855547	199
chr1	2138120	2338120	harbor1	chr1	2151110	2151307	DNA/TcMar-Tigger	726	-	98	2151208	13088
chr1	755937	955937	harbor1	chr1	758556	758663	DNA/TcMar-Tigger	518	-	54	758610	2673
chr1	755937	955937	harbor1	chr1	796539	796837	DNA/TcMar-Tigger	1356	-	149	796688	40751
chr1	47234717	47434717	harbor1	chr1	47302685	47302991	DNA/TcMar-Tigger	1827	-	153	47302838	68121
chr1	2992772	3192772	harbor1	chr1	3043210	3043353	DNA/TcMar-Tigger	6653	-	72	3043282	50510
chr1	2992772	3192772	harbor1	chr1	3043664	3043984	DNA/TcMar-Tigger	6653	-	160	3043824	51052
chr1	2992772	3192772	harbor1	chr1	3044281	3044753	DNA/TcMar-Tigger	6653	-	236	3044517	51745
chr1	2992772	3192772	harbor1	chr1	3045125	3045654	DNA/TcMar-Tigger	6653	-	264	3045389	52617
chr1	29137918	29337918	harbor1	chr1	29219649	29219888	DNA/TcMar-Tigger	768	-	120	29219769	81851
chr1	2138503	2338503	harbor1	chr1	2151110	2151307	DNA/TcMar-Tigger	726	-	98	2151208	12705
chr1	28799072	28999072	harbor1	chr1	28826126	28826241	DNA/TcMar-Tigger	3909	-	58	28826184	27112
chr1	28799072	28999072	harbor1	chr1	28826536	28827012	DNA/TcMar-Tigger	3909	-	238	28826774	27702
chr1	28799072	28999072	harbor1	chr1	28827495	28827722	DNA/TcMar-Tigger	5139	-	114	28827609	28537
chr1	28799072	28999072	harbor1	chr1	28828036	28828540	DNA/TcMar-Tigger	5139	-	252	28828288	29216
chr1	28799072	28999072	harbor1	chr1	28829016	28829348	DNA/TcMar-Tigger	1656	-	166	28829182	30110
chr1	28799072	28999072	harbor1	chr1	28829669	28829705	DNA/TcMar-Tigger	2817	-	18	28829687	30615
chr1	28799072	28999072	harbor1	chr1	28830009	28830241	DNA/TcMar-Tigger	2817	-	116	28830125	31053
chr1	28799072	28999072	harbor1	chr1	28830553	28830751	DNA/TcMar-Tigger	2817	-	99	28830652	31580
chr1	87225746	87425746	harbor1	chr1	87238619	87239348	DNA/TcMar-Tigger	1740	-	364	87238983	13237
chr1	87225746	87425746	harbor1	chr1	87304614	87304850	DNA/TcMar-Tigger	1427	-	118	87304732	78986
chr1	211033766	211233766	harbor1	chr1	211066304	211066596	DNA/TcMar-Tigger	1373	-	146	211066450	32684
chr1	211033766	211233766	harbor1	chr1	211069719	211069898	DNA/TcMar-Tigger	826	-	90	211069809	36043
chr1	211033766	211233766	harbor1	chr1	211070885	211071858	DNA/TcMar-Tigger	5023	-	486	211071371	37605
chr1	211033766	211233766	harbor1	chr1	211101822	211102225	DNA/TcMar-Tigger	473	-	202	211102024	68258
chr1	26400777	26600777	harbor1	chr1	26461859	26462055	DNA/TcMar-Tigger	855	-	98	26461957	61180
chr1	26400777	26600777	harbor1	chr1	26462321	26462755	DNA/TcMar-Tigger	855	-	217	26462538	61761
chr1	51230780	51430780	harbor1	chr1	51258181	51258300	DNA/TcMar-Tigger	628	-	60	51258241	27461
chr1	51230780	51430780	harbor1	chr1	51278960	51279376	DNA/TcMar-Tigger	1834	-	208	51279168	48388
chr1	51230780	51430780	harbor1	chr1	51279371	51279418	DNA/TcMar-Tigger	1132	-	24	51279395	48615
chr1	51230780	51430780	harbor1	chr1	51279711	51279823	DNA/TcMar-Tigger	1132	-	56	51279767	48987
chr1	51230780	51430780	harbor1	chr1	51280122	51280213	DNA/TcMar-Tigger	1132	-	46	51280168	49388
chr1	244605801	244805801	harbor1	chr1	244615382	244615694	DNA/TcMar-Tigger	1491	-	156	244615538	9737
chr1	244605801	244805801	harbor1	chr1	244620048	244620456	DNA/TcMar-Tigger	1122	-	204	244620252	14451
chr1	244605801	244805801	harbor1	chr1	244623644	244623966	DNA/TcMar-Tigger	6950	-	161	244623805	18004
chr1	244605801	244805801	harbor1	chr1	244624271	244624519	DNA/TcMar-Tigger	6950	-	124	244624395	18594
chr1	244605801	244805801	harbor1	chr1	244624820	244625346	DNA/TcMar-Tigger	6950	-	263	244625083	19282
chr1	244605801	244805801	harbor1	chr1	244625890	244626204	DNA/TcMar-Tigger	7997	-	157	244626047	20246
chr1	244605801	244805801	harbor1	chr1	244626509	244627321	DNA/TcMar-Tigger	7997	-	406	244626915	21114
chr1	244605801	244805801	harbor1	chr1	244627586	244627752	DNA/TcMar-Tigger	7997	-	83	244627669	21868
chr1	39855400	40055400	harbor1	chr1	39855441	39855654	DNA/TcMar-Tigger	1315	-	106	39855547	147
chr1	54939721	55139721	harbor1	chr1	54941196	54941747	DNA/TcMar-Tigger	3625	-	276	54941472	1751
chr1	10110200	10310200	harbor1	chr1	10115641	10115994	DNA/TcMar-Tigger	2021	-	176	10115817	5617
chr1	205329486	205529486	harbor1	chr1	205425186	205425512	DNA/TcMar-Tigger	823	-	163	205425349	95863
chr1	51230829	51430829	harbor1	chr1	51258181	51258300	DNA/TcMar-Tigger	628	-	60	51258241	27412
chr1	51230829	51430829	harbor1	chr1	51278960	51279376	DNA/TcMar-Tigger	1834	-	208	51279168	48339
chr1	51230829	51430829	harbor1	chr1	51279371	51279418	DNA/TcMar-Tigger	1132	-	24	51279395	48566
chr1	51230829	51430829	harbor1	chr1	51279711	51279823	DNA/TcMar-Tigger	1132	-	56	51279767	48938
chr1	51230829	51430829	harbor1	chr1	51280122	51280213	DNA/TcMar-Tigger	1132	-	46	51280168	49339
chr1	154870697	155070697	harbor1	chr1	154921224	154921454	DNA/TcMar-Tigger	1416	-	115	154921339	50642
chr1	154870697	155070697	harbor1	chr1	154929386	154929511	DNA/TcMar-Tigger	590	-	62	154929448	58751
chr1	726325	926325	harbor1	chr1	758556	758663	DNA/TcMar-Tigger	518	-	54	758610	32285
chr1	726325	926325	harbor1	chr1	796539	796837	DNA/TcMar-Tigger	1356	-	149	796688	70363
chr1	86604779	86804779	harbor1	chr1	86688478	86688811	DNA/TcMar-Tigger	1034	-	166	86688644	83865
chr1	25518162	25718162	harbor1	chr1	25593704	25594098	DNA/TcMar-Tigger	2258	-	197	25593901	75739
chr1	244589301	244789301	harbor1	chr1	244615382	244615694	DNA/TcMar-Tigger	1491	-	156	244615538	26237
chr1	244589301	244789301	harbor1	chr1	244620048	244620456	DNA/TcMar-Tigger	1122	-	204	244620252	30951
chr1	244589301	244789301	harbor1	chr1	244623644	244623966	DNA/TcMar-Tigger	6950	-	161	244623805	34504
chr1	244589301	244789301	harbor1	chr1	244624271	244624519	DNA/TcMar-Tigger	6950	-	124	244624395	35094
chr1	244589301	244789301	harbor1	chr1	244624820	244625346	DNA/TcMar-Tigger	6950	-	263	244625083	35782
chr1	244589301	244789301	harbor1	chr1	244625890	244626204	DNA/TcMar-Tigger	7997	-	157	244626047	36746
chr1	244589301	244789301	harbor1	chr1	244626509	244627321	DNA/TcMar-Tigger	7997	-	406	244626915	37614
chr1	244589301	244789301	harbor1	chr1	244627586	244627752	DNA/TcMar-Tigger	7997	-	83	244627669	38368
chr1	227440888	227640888	harbor1	chr1	227458259	227458437	DNA/TcMar-Tigger	608	-	89	227458348	17460
chr1	227440888	227640888	harbor1	chr1	227516446	227516780	DNA/TcMar-Tigger	1514	-	167	227516613	75725
chr1	3679154	3879154	harbor1	chr1	3749613	3749879	DNA/TcMar-Tigger	1485	-	133	3749746	70592
chr1	3679154	3879154	harbor1	chr1	3750183	3750276	DNA/TcMar-Tigger	1485	-	46	3750229	71075
chr1	2136117	2336117	harbor1	chr1	2151110	2151307	DNA/TcMar-Tigger	726	-	98	2151208	15091
chr1	2138467	2338467	harbor1	chr1	2151110	2151307	DNA/TcMar-Tigger	726	-	98	2151208	12741
chr1	154400577	154600577	harbor1	chr1	154431379	154432021	DNA/TcMar-Tigger	3459	-	321	154431700	31123
chr1	154400577	154600577	harbor1	chr1	154489758	154490074	DNA/TcMar-Tigger	1535	-	158	154489916	89339
chr1	204585380	204785380	harbor1	chr1	204591644	204591790	DNA/TcMar-Tigger	482	-	73	204591717	6337
chr1	204585380	204785380	harbor1	chr1	204606806	204607289	DNA/TcMar-Tigger	1300	-	242	204607048	21668
chr1	1676051	1876051	harbor1	chr1	1684229	1684434	DNA/TcMar-Tigger	478	-	102	1684331	8280
chr1	1676051	1876051	harbor1	chr1	1722126	1722241	DNA/TcMar-Tigger	519	-	58	1722184	46133
chr1	211033792	211233792	harbor1	chr1	211066304	211066596	DNA/TcMar-Tigger	1373	-	146	211066450	32658
chr1	211033792	211233792	harbor1	chr1	211069719	211069898	DNA/TcMar-Tigger	826	-	90	211069809	36017
chr1	211033792	211233792	harbor1	chr1	211070885	211071858	DNA/TcMar-Tigger	5023	-	486	211071371	37579
chr1	211033792	211233792	harbor1	chr1	211101822	211102225	DNA/TcMar-Tigger	473	-	202	211102024	68232
chr1	244735088	244935088	harbor1	chr1	244804111	244804487	DNA/TcMar-Tigger	2212	-	188	244804299	69211
chr1	25516681	25716681	harbor1	chr1	25593704	25594098	DNA/TcMar-Tigger	2258	-	197	25593901	77220
chr1	116272513	116472513	harbor1	chr1	116320997	116321271	DNA/TcMar-Tigger	500	-	137	116321134	48621
chr1	116272513	116472513	harbor1	chr1	116323842	116324117	DNA/TcMar-Tigger	1891	-	138	116323980	51467
chr1	244605835	244805835	harbor1	chr1	244615382	244615694	DNA/TcMar-Tigger	1491	-	156	244615538	9703
chr1	244605835	244805835	harbor1	chr1	244620048	244620456	DNA/TcMar-Tigger	1122	-	204	244620252	14417
chr1	244605835	244805835	harbor1	chr1	244623644	244623966	DNA/TcMar-Tigger	6950	-	161	244623805	17970
chr1	244605835	244805835	harbor1	chr1	244624271	244624519	DNA/TcMar-Tigger	6950	-	124	244624395	18560
chr1	244605835	244805835	harbor1	chr1	244624820	244625346	DNA/TcMar-Tigger	6950	-	263	244625083	19248
chr1	244605835	244805835	harbor1	chr1	244625890	244626204	DNA/TcMar-Tigger	7997	-	157	244626047	20212
chr1	244605835	244805835	harbor1	chr1	244626509	244627321	DNA/TcMar-Tigger	7997	-	406	244626915	21080
chr1	244605835	244805835	harbor1	chr1	244627586	244627752	DNA/TcMar-Tigger	7997	-	83	244627669	21834
chr1	2138442	2338442	harbor1	chr1	2151110	2151307	DNA/TcMar-Tigger	726	-	98	2151208	12766
chr1	244605400	244805400	harbor1	chr1	244615382	244615694	DNA/TcMar-Tigger	1491	-	156	244615538	10138
chr1	244605400	244805400	harbor1	chr1	244620048	244620456	DNA/TcMar-Tigger	1122	-	204	244620252	14852
chr1	244605400	244805400	harbor1	chr1	244623644	244623966	DNA/TcMar-Tigger	6950	-	161	244623805	18405
chr1	244605400	244805400	harbor1	chr1	244624271	244624519	DNA/TcMar-Tigger	6950	-	124	244624395	18995
chr1	244605400	244805400	harbor1	chr1	244624820	244625346	DNA/TcMar-Tigger	6950	-	263	244625083	19683
chr1	244605400	244805400	harbor1	chr1	244625890	244626204	DNA/TcMar-Tigger	7997	-	157	244626047	20647
chr1	244605400	244805400	harbor1	chr1	244626509	244627321	DNA/TcMar-Tigger	7997	-	406	244626915	21515
chr1	244605400	244805400	harbor1	chr1	244627586	244627752	DNA/TcMar-Tigger	7997	-	83	244627669	22269
chr1	2138106	2338106	harbor1	chr1	2151110	2151307	DNA/TcMar-Tigger	726	-	98	2151208	13102
chr1	51419171	51619171	harbor1	chr1	51457436	51457510	DNA/TcMar-Tigger	1900	-	37	51457473	38302
chr1	51419171	51619171	harbor1	chr1	51457536	51457808	DNA/TcMar-Tigger	1900	-	136	51457672	38501
chr1	28814567	29014567	harbor1	chr1	28826126	28826241	DNA/TcMar-Tigger	3909	-	58	28826184	11617
chr1	28814567	29014567	harbor1	chr1	28826536	28827012	DNA/TcMar-Tigger	3909	-	238	28826774	12207
chr1	28814567	29014567	harbor1	chr1	28827495	28827722	DNA/TcMar-Tigger	5139	-	114	28827609	13042
chr1	28814567	29014567	harbor1	chr1	28828036	28828540	DNA/TcMar-Tigger	5139	-	252	28828288	13721
chr1	28814567	29014567	harbor1	chr1	28829016	28829348	DNA/TcMar-Tigger	1656	-	166	28829182	14615
chr1	28814567	29014567	harbor1	chr1	28829669	28829705	DNA/TcMar-Tigger	2817	-	18	28829687	15120
chr1	28814567	29014567	harbor1	chr1	28830009	28830241	DNA/TcMar-Tigger	2817	-	116	28830125	15558
chr1	28814567	29014567	harbor1	chr1	28830553	28830751	DNA/TcMar-Tigger	2817	-	99	28830652	16085
chr1	2138449	2338449	harbor1	chr1	2151110	2151307	DNA/TcMar-Tigger	726	-	98	2151208	12759
chr1	110112132	110312132	harbor1	chr1	110118360	110118602	DNA/TcMar-Tigger	1195	-	121	110118481	6349
chr1	179714840	179914840	harbor1	chr1	179733977	179734249	DNA/TcMar-Tigger	661	-	136	179734113	19273
chr1	31080007	31280007	harbor1	chr1	31084168	31084376	DNA/TcMar-Tigger	1110	-	104	31084272	4265
chr1	726411	926411	harbor1	chr1	758556	758663	DNA/TcMar-Tigger	518	-	54	758610	32199
chr1	726411	926411	harbor1	chr1	796539	796837	DNA/TcMar-Tigger	1356	-	149	796688	70277
chr1	2138451	2338451	harbor1	chr1	2151110	2151307	DNA/TcMar-Tigger	726	-	98	2151208	12757
chr1	24895887	25095887	harbor1	chr1	24968363	24968584	DNA/TcMar-Tigger	730	-	110	24968473	72586
chr1	24895887	25095887	harbor1	chr1	24969077	24969226	DNA/TcMar-Tigger	730	-	74	24969151	73264
chr1	32106047	32306047	harbor1	chr1	32112317	32112484	DNA/TcMar-Tigger	5126	-	84	32112401	6354
chr1	32106047	32306047	harbor1	chr1	32112795	32113109	DNA/TcMar-Tigger	5126	-	157	32112952	6905
chr1	32106047	32306047	harbor1	chr1	32113398	32113454	DNA/TcMar-Tigger	5126	-	28	32113426	7379
chr1	32106047	32306047	harbor1	chr1	32113739	32114158	DNA/TcMar-Tigger	5126	-	210	32113949	7902
chr1	32106047	32306047	harbor1	chr1	32114453	32114852	DNA/TcMar-Tigger	5126	-	200	32114653	8606
chr1	32106047	32306047	harbor1	chr1	32115725	32115754	DNA/TcMar-Tigger	5126	-	14	32115739	9692
chr1	32106047	32306047	harbor1	chr1	32116043	32116173	DNA/TcMar-Tigger	5126	-	65	32116108	10061
chr1	32106047	32306047	harbor1	chr1	32116300	32116376	DNA/TcMar-Tigger	5126	-	38	32116338	10291
chr1	32106047	32306047	harbor1	chr1	32116663	32117164	DNA/TcMar-Tigger	5126	-	250	32116913	10866
chr1	32106047	32306047	harbor1	chr1	32125722	32126025	DNA/TcMar-Tigger	897	-	152	32125874	19827
chr1	32106047	32306047	harbor1	chr1	32126186	32126232	DNA/TcMar-Tigger	897	-	23	32126209	20162
chr1	32106047	32306047	harbor1	chr1	32143956	32144451	DNA/TcMar-Tigger	2688	-	248	32144204	38157
chr1	32106047	32306047	harbor1	chr1	32156227	32156722	DNA/TcMar-Tigger	2317	-	248	32156475	50428
chr1	32106047	32306047	harbor1	chr1	32178228	32178341	DNA/TcMar-Tigger	589	-	56	32178284	72237
chr1	32106047	32306047	harbor1	chr1	32190449	32190734	DNA/TcMar-Tigger	686	-	142	32190591	84544
chr1	51229911	51429911	harbor1	chr1	51258181	51258300	DNA/TcMar-Tigger	628	-	60	51258241	28330
chr1	51229911	51429911	harbor1	chr1	51278960	51279376	DNA/TcMar-Tigger	1834	-	208	51279168	49257
chr1	51229911	51429911	harbor1	chr1	51279371	51279418	DNA/TcMar-Tigger	1132	-	24	51279395	49484
chr1	51229911	51429911	harbor1	chr1	51279711	51279823	DNA/TcMar-Tigger	1132	-	56	51279767	49856
chr1	51229911	51429911	harbor1	chr1	51280122	51280213	DNA/TcMar-Tigger	1132	-	46	51280168	50257
chr1	244605782	244805782	harbor1	chr1	244615382	244615694	DNA/TcMar-Tigger	1491	-	156	244615538	9756
chr1	244605782	244805782	harbor1	chr1	244620048	244620456	DNA/TcMar-Tigger	1122	-	204	244620252	14470
chr1	244605782	244805782	harbor1	chr1	244623644	244623966	DNA/TcMar-Tigger	6950	-	161	244623805	18023
chr1	244605782	244805782	harbor1	chr1	244624271	244624519	DNA/TcMar-Tigger	6950	-	124	244624395	18613
chr1	244605782	244805782	harbor1	chr1	244624820	244625346	DNA/TcMar-Tigger	6950	-	263	244625083	19301
chr1	244605782	244805782	harbor1	chr1	244625890	244626204	DNA/TcMar-Tigger	7997	-	157	244626047	20265
chr1	244605782	244805782	harbor1	chr1	244626509	244627321	DNA/TcMar-Tigger	7997	-	406	244626915	21133
chr1	244605782	244805782	harbor1	chr1	244627586	244627752	DNA/TcMar-Tigger	7997	-	83	244627669	21887
chr1	20048547	20248547	harbor1	chr1	20087288	20087386	DNA/TcMar-Tigger	584	-	49	20087337	38790
chr1	20048547	20248547	harbor1	chr1	20088693	20088802	DNA/TcMar-Tigger	1202	-	54	20088747	40200
chr1	20048547	20248547	harbor1	chr1	20089100	20089299	DNA/TcMar-Tigger	1202	-	100	20089200	40653
chr1	2138561	2338561	harbor1	chr1	2151110	2151307	DNA/TcMar-Tigger	726	-	98	2151208	12647
chr1	227983972	228183972	harbor1	chr1	228002653	228003088	DNA/TcMar-Tigger	2111	-	218	228002871	18899
chr1	194372730	194572730	harbor1	chr1	194396734	194397338	DNA/TcMar-Tigger	3174	-	302	194397036	24306
chr1	194372730	194572730	harbor1	chr1	194397337	194397876	DNA/TcMar-Tigger	2501	-	270	194397607	24877
chr1	230025255	230225255	harbor1	chr1	230052944	230053344	DNA/TcMar-Tigger	2341	-	200	230053144	27889
chr1	230025255	230225255	harbor1	chr1	230108363	230108441	DNA/TcMar-Tigger	449	-	39	230108402	83147
chr1	230025255	230225255	harbor1	chr1	230108549	230108978	DNA/TcMar-Tigger	2272	-	214	230108763	83508
chr1	230025255	230225255	harbor1	chr1	230115330	230116233	DNA/TcMar-Tigger	13919	-	452	230115782	90527
chr1	230025255	230225255	harbor1	chr1	230116528	230117920	DNA/TcMar-Tigger	13919	-	696	230117224	91969
chr1	28814559	29014559	harbor1	chr1	28826126	28826241	DNA/TcMar-Tigger	3909	-	58	28826184	11625
chr1	28814559	29014559	harbor1	chr1	28826536	28827012	DNA/TcMar-Tigger	3909	-	238	28826774	12215
chr1	28814559	29014559	harbor1	chr1	28827495	28827722	DNA/TcMar-Tigger	5139	-	114	28827609	13050
chr1	28814559	29014559	harbor1	chr1	28828036	28828540	DNA/TcMar-Tigger	5139	-	252	28828288	13729
chr1	28814559	29014559	harbor1	chr1	28829016	28829348	DNA/TcMar-Tigger	1656	-	166	28829182	14623
chr1	28814559	29014559	harbor1	chr1	28829669	28829705	DNA/TcMar-Tigger	2817	-	18	28829687	15128
chr1	28814559	29014559	harbor1	chr1	28830009	28830241	DNA/TcMar-Tigger	2817	-	116	28830125	15566
chr1	28814559	29014559	harbor1	chr1	28830553	28830751	DNA/TcMar-Tigger	2817	-	99	28830652	16093
chr1	47316981	47516981	harbor1	chr1	47363085	47363157	DNA/TcMar-Tigger	431	-	36	47363121	46140
chr1	47316981	47516981	harbor1	chr1	47363235	47363312	DNA/TcMar-Tigger	489	-	38	47363273	46292
chr1	165531488	165731488	harbor1	chr1	165559616	165560209	DNA/TcMar-Tigger	3447	-	296	165559912	28424
chr1	222687998	222887998	harbor1	chr1	222777614	222777741	DNA/TcMar-Tigger	839	-	64	222777678	89680
chr1	203028332	203228332	harbor1	chr1	203074141	203074469	DNA/TcMar-Tigger	1965	-	164	203074305	45973
chr1	53187531	53387531	harbor1	chr1	53215527	53215897	DNA/TcMar-Tigger	2224	-	185	53215712	28181
chr1	89721428	89921428	harbor1	chr1	89737191	89738420	DNA/TcMar-Tigger	7087	-	614	89737805	16377
chr1	89721428	89921428	harbor1	chr1	89787188	89787723	DNA/TcMar-Tigger	2099	-	268	89787456	66028
chr1	89721428	89921428	harbor1	chr1	89787998	89788323	DNA/TcMar-Tigger	1989	-	162	89788160	66732
chr1	9589512	9789512	harbor1	chr1	9656219	9656432	DNA/TcMar-Tigger	1114	-	106	9656325	66813
chr1	9589512	9789512	harbor1	chr1	9673704	9674098	DNA/TcMar-Tigger	481	-	197	9673901	84389
chr1	220687422	220887422	harbor1	chr1	220777807	220777873	DNA/TcMar-Tigger	438	-	33	220777840	90418
chr1	3672871	3872871	harbor1	chr1	3749613	3749879	DNA/TcMar-Tigger	1485	-	133	3749746	76875
chr1	3672871	3872871	harbor1	chr1	3750183	3750276	DNA/TcMar-Tigger	1485	-	46	3750229	77358
chr1	207924797	208124797	harbor1	chr1	207929513	207931909	DNA/TcMar-Tigger	15962	-	1198	207930711	5914
chr1	207924797	208124797	harbor1	chr1	207940934	207941596	DNA/TcMar-Tigger	1001	-	331	207941265	16468
chr1	207924797	208124797	harbor1	chr1	207992937	207993356	DNA/TcMar-Tigger	1604	-	210	207993147	68350
chr1	207924797	208124797	harbor1	chr1	207993469	207993692	DNA/TcMar-Tigger	436	-	112	207993581	68784
chr1	19565207	19765207	harbor1	chr1	19586786	19587040	DNA/TcMar-Tigger	1544	-	127	19586913	21706
chr1	19565207	19765207	harbor1	chr1	19587348	19587456	DNA/TcMar-Tigger	1544	-	54	19587402	22195
chr1	19565207	19765207	harbor1	chr1	19595788	19595933	DNA/TcMar-Tigger	690	-	72	19595860	30653
chr1	19565207	19765207	harbor1	chr1	19596033	19596114	DNA/TcMar-Tigger	591	-	40	19596073	30866
chr1	2138430	2338430	harbor1	chr1	2151110	2151307	DNA/TcMar-Tigger	726	-	98	2151208	12778
chr1	245603515	245803515	harbor1	chr1	245616451	245616783	DNA/TcMar-Tigger	2162	-	166	245616617	13102
chr1	245603515	245803515	harbor1	chr1	245620080	245620406	DNA/TcMar-Tigger	1178	-	163	245620243	16728
chr1	245603515	245803515	harbor1	chr1	245620702	245621018	DNA/TcMar-Tigger	1178	-	158	245620860	17345
chr1	3683862	3883862	harbor1	chr1	3749613	3749879	DNA/TcMar-Tigger	1485	-	133	3749746	65884
chr1	3683862	3883862	harbor1	chr1	3750183	3750276	DNA/TcMar-Tigger	1485	-	46	3750229	66367
chr1	3683862	3883862	harbor1	chr1	3780139	3780433	DNA/TcMar-Tigger	1178	-	147	3780286	96424
chr1	26400758	26600758	harbor1	chr1	26461859	26462055	DNA/TcMar-Tigger	855	-	98	26461957	61199
chr1	26400758	26600758	harbor1	chr1	26462321	26462755	DNA/TcMar-Tigger	855	-	217	26462538	61780
chr1	24195409	24395409	harbor1	chr1	24195070	24195450	DNA/TcMar-Tigger	1957	-	190	24195260	149
chr1	24195409	24395409	harbor1	chr1	24226304	24227251	DNA/TcMar-Tigger	16158	-	474	24226778	31369
chr1	24195409	24395409	harbor1	chr1	24227551	24228953	DNA/TcMar-Tigger	16158	-	701	24228252	32843
chr1	24195409	24395409	harbor1	chr1	24267569	24267700	DNA/TcMar-Tigger	1097	-	66	24267635	72226
chr1	24195409	24395409	harbor1	chr1	24267994	24268006	DNA/TcMar-Tigger	1097	-	6	24268000	72591
chr1	24195409	24395409	harbor1	chr1	24268298	24268404	DNA/TcMar-Tigger	1097	-	53	24268351	72942
chr1	24195409	24395409	harbor1	chr1	24288335	24288667	DNA/TcMar-Tigger	2975	-	166	24288501	93092
chr1	24195409	24395409	harbor1	chr1	24288989	24289288	DNA/TcMar-Tigger	2975	-	150	24289139	93730
chr1	2137893	2337893	harbor1	chr1	2151110	2151307	DNA/TcMar-Tigger	726	-	98	2151208	13315
chr1	205329484	205529484	harbor1	chr1	205425186	205425512	DNA/TcMar-Tigger	823	-	163	205425349	95865
chr1	248592141	248792141	harbor1	chr1	248643543	248644151	DNA/TcMar-Tigger	1569	-	304	248643847	51706
chr1	2138476	2338476	harbor1	chr1	2151110	2151307	DNA/TcMar-Tigger	726	-	98	2151208	12732
chr1	244605833	244805833	harbor1	chr1	244615382	244615694	DNA/TcMar-Tigger	1491	-	156	244615538	9705
chr1	244605833	244805833	harbor1	chr1	244620048	244620456	DNA/TcMar-Tigger	1122	-	204	244620252	14419
chr1	244605833	244805833	harbor1	chr1	244623644	244623966	DNA/TcMar-Tigger	6950	-	161	244623805	17972
chr1	244605833	244805833	harbor1	chr1	244624271	244624519	DNA/TcMar-Tigger	6950	-	124	244624395	18562
chr1	244605833	244805833	harbor1	chr1	244624820	244625346	DNA/TcMar-Tigger	6950	-	263	244625083	19250
chr1	244605833	244805833	harbor1	chr1	244625890	244626204	DNA/TcMar-Tigger	7997	-	157	244626047	20214
chr1	244605833	244805833	harbor1	chr1	244626509	244627321	DNA/TcMar-Tigger	7997	-	406	244626915	21082
chr1	244605833	244805833	harbor1	chr1	244627586	244627752	DNA/TcMar-Tigger	7997	-	83	244627669	21836
chr1	155154854	155354854	harbor1	chr1	155158068	155158226	DNA/TcMar-Tigger	1954	-	79	155158147	3293
chr1	155154854	155354854	harbor1	chr1	155158530	155158753	DNA/TcMar-Tigger	1954	-	112	155158642	3788
chr1	211033696	211233696	harbor1	chr1	211066304	211066596	DNA/TcMar-Tigger	1373	-	146	211066450	32754
chr1	211033696	211233696	harbor1	chr1	211069719	211069898	DNA/TcMar-Tigger	826	-	90	211069809	36113
chr1	211033696	211233696	harbor1	chr1	211070885	211071858	DNA/TcMar-Tigger	5023	-	486	211071371	37675
chr1	211033696	211233696	harbor1	chr1	211101822	211102225	DNA/TcMar-Tigger	473	-	202	211102024	68328
chr1	24895890	25095890	harbor1	chr1	24968363	24968584	DNA/TcMar-Tigger	730	-	110	24968473	72583
chr1	24895890	25095890	harbor1	chr1	24969077	24969226	DNA/TcMar-Tigger	730	-	74	24969151	73261
chr1	6351794	6551794	harbor1	chr1	6365295	6365490	DNA/TcMar-Tigger	2387	-	98	6365393	13599
chr1	6351794	6551794	harbor1	chr1	6365784	6365898	DNA/TcMar-Tigger	2387	-	57	6365841	14047
chr1	6351794	6551794	harbor1	chr1	6366172	6366300	DNA/TcMar-Tigger	2387	-	64	6366236	14442
chr1	6351794	6551794	harbor1	chr1	6366608	6366659	DNA/TcMar-Tigger	2387	-	26	6366634	14840
chr1	6351794	6551794	harbor1	chr1	6366887	6366916	DNA/TcMar-Tigger	2387	-	14	6366901	15107
chr1	6351794	6551794	harbor1	chr1	6367215	6367282	DNA/TcMar-Tigger	2387	-	34	6367249	15455
chr1	6351794	6551794	harbor1	chr1	6369282	6369394	DNA/TcMar-Tigger	486	-	56	6369338	17544
chr1	6351794	6551794	harbor1	chr1	6369861	6369958	DNA/TcMar-Tigger	8394	-	48	6369909	18115
chr1	6351794	6551794	harbor1	chr1	6370367	6370457	DNA/TcMar-Tigger	8394	-	45	6370412	18618
chr1	6351794	6551794	harbor1	chr1	6370793	6370803	DNA/TcMar-Tigger	8394	-	5	6370798	19004
chr1	6351794	6551794	harbor1	chr1	6371109	6371362	DNA/TcMar-Tigger	8394	-	126	6371235	19441
chr1	6351794	6551794	harbor1	chr1	6371662	6371762	DNA/TcMar-Tigger	8394	-	50	6371712	19918
chr1	6351794	6551794	harbor1	chr1	6372066	6372547	DNA/TcMar-Tigger	8394	-	240	6372306	20512
chr1	6351794	6551794	harbor1	chr1	6372850	6373256	DNA/TcMar-Tigger	8394	-	203	6373053	21259
chr1	6351794	6551794	harbor1	chr1	6373551	6373582	DNA/TcMar-Tigger	8394	-	16	6373567	21773
chr1	6351794	6551794	harbor1	chr1	6373883	6373921	DNA/TcMar-Tigger	8394	-	19	6373902	22108
chr1	148910670	149110670	harbor1	chr1	148912863	148913204	DNA/TcMar-Tigger	1840	-	170	148913033	2363
chr1	148910670	149110670	harbor1	chr1	148936245	148937264	DNA/TcMar-Tigger	3707	-	510	148936755	26085
chr1	226307818	226507818	harbor1	chr1	226380624	226380839	DNA/TcMar-Tigger	1065	-	108	226380732	72914
chr1	54786918	54986918	harbor1	chr1	54834546	54834896	DNA/TcMar-Tigger	2197	-	175	54834721	47803
chr1	54786918	54986918	harbor1	chr1	54870421	54870741	DNA/TcMar-Tigger	1934	-	160	54870581	83663
chr1	46503416	46703416	harbor1	chr1	46555493	46555799	DNA/TcMar-Tigger	1596	-	153	46555646	52230
chr1	2136208	2336208	harbor1	chr1	2151110	2151307	DNA/TcMar-Tigger	726	-	98	2151208	15000
chr1	54307464	54507464	harbor1	chr1	54346842	54347002	DNA/TcMar-Tigger	759	-	80	54346922	39458
chr1	54307464	54507464	harbor1	chr1	54347268	54347383	DNA/TcMar-Tigger	759	-	58	54347326	39862
chr1	54307464	54507464	harbor1	chr1	54347501	54347591	DNA/TcMar-Tigger	759	-	45	54347546	40082
chr1	25330942	25530942	harbor1	chr1	25372200	25372237	DNA/TcMar-Tigger	705	-	18	25372218	41276
chr1	25330942	25530942	harbor1	chr1	25372536	25372712	DNA/TcMar-Tigger	705	-	88	25372624	41682
chr2	26950219	27150219	harbor1	chr2	27001122	27001357	DNA/TcMar-Tigger	1541	-	118	27001240	51021
chr2	26950219	27150219	harbor1	chr2	27001702	27001829	DNA/TcMar-Tigger	570	-	64	27001766	51547
chr2	26950219	27150219	harbor1	chr2	27022427	27022777	DNA/TcMar-Tigger	1965	-	175	27022602	72383
chr2	152618051	152818051	harbor1	chr2	152630932	152631103	DNA/TcMar-Tigger	946	-	86	152631018	12967
chr2	152618051	152818051	harbor1	chr2	152631416	152631737	DNA/TcMar-Tigger	1326	-	160	152631576	13525
chr2	152618051	152818051	harbor1	chr2	152697583	152697917	DNA/TcMar-Tigger	1770	-	167	152697750	79699
chr2	152618051	152818051	harbor1	chr2	152709235	152709443	DNA/TcMar-Tigger	921	-	104	152709339	91288
chr2	26950237	27150237	harbor1	chr2	27001122	27001357	DNA/TcMar-Tigger	1541	-	118	27001240	51003
chr2	26950237	27150237	harbor1	chr2	27001702	27001829	DNA/TcMar-Tigger	570	-	64	27001766	51529
chr2	26950237	27150237	harbor1	chr2	27022427	27022777	DNA/TcMar-Tigger	1965	-	175	27022602	72365
chr2	219058841	219258841	harbor1	chr2	219067512	219067871	DNA/TcMar-Tigger	2261	-	180	219067692	8851
chr2	218221236	218421236	harbor1	chr2	218306879	218307066	DNA/TcMar-Tigger	1073	-	94	218306973	85737
chr2	152617998	152817998	harbor1	chr2	152630932	152631103	DNA/TcMar-Tigger	946	-	86	152631018	13020
chr2	152617998	152817998	harbor1	chr2	152631416	152631737	DNA/TcMar-Tigger	1326	-	160	152631576	13578
chr2	152617998	152817998	harbor1	chr2	152697583	152697917	DNA/TcMar-Tigger	1770	-	167	152697750	79752
chr2	152617998	152817998	harbor1	chr2	152709235	152709443	DNA/TcMar-Tigger	921	-	104	152709339	91341
chr2	86976337	87176337	harbor1	chr2	87023901	87024920	DNA/TcMar-Tigger	5643	-	510	87024411	48074
chr2	86976337	87176337	harbor1	chr2	87064038	87064635	DNA/TcMar-Tigger	717	-	298	87064336	87999
chr2	53759964	53959964	harbor1	chr2	53800075	53800386	DNA/TcMar-Tigger	1685	-	156	53800231	40267
chr2	15464442	15664442	harbor1	chr2	15487354	15487576	DNA/TcMar-Tigger	994	-	111	15487465	23023
chr2	15464442	15664442	harbor1	chr2	15502351	15503289	DNA/TcMar-Tigger	5406	-	469	15502820	38378
chr2	15464442	15664442	harbor1	chr2	15517625	15518004	DNA/TcMar-Tigger	1378	-	190	15517815	53373
chr2	15464442	15664442	harbor1	chr2	15522710	15523264	DNA/TcMar-Tigger	3456	-	277	15522987	58545
chr2	15464442	15664442	harbor1	chr2	15535142	15535239	DNA/TcMar-Tigger	1671	-	48	15535190	70748
chr2	15464442	15664442	harbor1	chr2	15535586	15535823	DNA/TcMar-Tigger	1671	-	118	15535704	71262
chr2	158868018	159068018	harbor1	chr2	158939277	158939486	DNA/TcMar-Tigger	1294	-	104	158939381	71363
chr2	85228519	85428519	harbor1	chr2	85308017	85308295	DNA/TcMar-Tigger	678	-	139	85308156	79637
chr2	85228519	85428519	harbor1	chr2	85311625	85311863	DNA/TcMar-Tigger	3040	-	119	85311744	83225
chr2	85228519	85428519	harbor1	chr2	85312196	85312230	DNA/TcMar-Tigger	3040	-	17	85312213	83694
chr2	85228519	85428519	harbor1	chr2	85312544	85312855	DNA/TcMar-Tigger	3040	-	156	85312700	84181
chr2	85228519	85428519	harbor1	chr2	85313150	85313215	DNA/TcMar-Tigger	3040	-	32	85313182	84663
chr2	85228519	85428519	harbor1	chr2	85313186	85313252	DNA/TcMar-Tigger	573	-	33	85313219	84700
chr2	85228519	85428519	harbor1	chr2	85313545	85313600	DNA/TcMar-Tigger	573	-	28	85313573	85054
chr2	241405862	241605862	harbor1	chr2	241487305	241487389	DNA/TcMar-Tigger	1876	-	42	241487347	81485
chr2	241405862	241605862	harbor1	chr2	241487695	241487744	DNA/TcMar-Tigger	1876	-	24	241487719	81857
chr2	241405862	241605862	harbor1	chr2	241488036	241488251	DNA/TcMar-Tigger	1876	-	108	241488144	82282
chr2	219458053	219658053	harbor1	chr2	219478606	219478810	DNA/TcMar-Tigger	543	-	102	219478708	20655
chr2	175979735	176179735	harbor1	chr2	175985589	175985909	DNA/TcMar-Tigger	1555	-	160	175985749	6014
chr2	175979735	176179735	harbor1	chr2	176040020	176040379	DNA/TcMar-Tigger	1627	-	180	176040200	60465
chr2	26950242	27150242	harbor1	chr2	27001122	27001357	DNA/TcMar-Tigger	1541	-	118	27001240	50998
chr2	26950242	27150242	harbor1	chr2	27001702	27001829	DNA/TcMar-Tigger	570	-	64	27001766	51524
chr2	26950242	27150242	harbor1	chr2	27022427	27022777	DNA/TcMar-Tigger	1965	-	175	27022602	72360
chr2	219383264	219583264	harbor1	chr2	219478606	219478810	DNA/TcMar-Tigger	543	-	102	219478708	95444
chr2	85461791	85661791	harbor1	chr2	85464660	85464777	DNA/TcMar-Tigger	1177	-	58	85464718	2927
chr2	85461791	85661791	harbor1	chr2	85465702	85465745	DNA/TcMar-Tigger	1177	-	22	85465724	3933
chr2	85461791	85661791	harbor1	chr2	85465897	85465987	DNA/TcMar-Tigger	1177	-	45	85465942	4151
chr2	85461791	85661791	harbor1	chr2	85465985	85466086	DNA/TcMar-Tigger	576	-	50	85466035	4244
chr2	207648472	207848472	harbor1	chr2	207680759	207680886	DNA/TcMar-Tigger	565	-	64	207680823	32351
chr2	237867399	238067399	harbor1	chr2	237867247	237867427	DNA/TcMar-Tigger	754	-	90	237867337	62
chr2	237867399	238067399	harbor1	chr2	237939649	237939675	DNA/TcMar-Tigger	1348	-	13	237939662	72263
chr2	237867399	238067399	harbor1	chr2	237940489	237940741	DNA/TcMar-Tigger	1348	-	126	237940615	73216
chr2	53759991	53959991	harbor1	chr2	53800075	53800386	DNA/TcMar-Tigger	1685	-	156	53800231	40240
chr2	219335190	219535190	harbor1	chr2	219341366	219341701	DNA/TcMar-Tigger	1869	-	168	219341534	6344
chr2	219335190	219535190	harbor1	chr2	219370854	219371001	DNA/TcMar-Tigger	1588	-	74	219370928	35738
chr2	219335190	219535190	harbor1	chr2	219371280	219371486	DNA/TcMar-Tigger	1588	-	103	219371383	36193
chr2	46198512	46398512	harbor1	chr2	46223307	46223429	DNA/TcMar-Tigger	456	-	61	46223368	24856
chr2	46198512	46398512	harbor1	chr2	46258247	46258627	DNA/TcMar-Tigger	2011	-	190	46258437	59925
chr2	70453429	70653429	harbor1	chr2	70487306	70487667	DNA/TcMar-Tigger	2205	-	180	70487486	34057
chr2	111955709	112155709	harbor1	chr2	111990612	111990831	DNA/TcMar-Tigger	1225	-	110	111990722	35013
chr2	111955709	112155709	harbor1	chr2	112035646	112035995	DNA/TcMar-Tigger	1976	-	174	112035820	80111
chr2	207668782	207868782	harbor1	chr2	207680759	207680886	DNA/TcMar-Tigger	565	-	64	207680823	12041
chr2	46198543	46398543	harbor1	chr2	46223307	46223429	DNA/TcMar-Tigger	456	-	61	46223368	24825
chr2	46198543	46398543	harbor1	chr2	46258247	46258627	DNA/TcMar-Tigger	2011	-	190	46258437	59894
chr2	27018955	27218955	harbor1	chr2	27022427	27022777	DNA/TcMar-Tigger	1965	-	175	27022602	3647
chr2	46198523	46398523	harbor1	chr2	46223307	46223429	DNA/TcMar-Tigger	456	-	61	46223368	24845
chr2	46198523	46398523	harbor1	chr2	46258247	46258627	DNA/TcMar-Tigger	2011	-	190	46258437	59914
chr2	26403762	26603762	harbor1	chr2	26428251	26428516	DNA/TcMar-Tigger	2173	-	132	26428383	24621
chr2	26403762	26603762	harbor1	chr2	26428810	26428890	DNA/TcMar-Tigger	2173	-	40	26428850	25088
chr2	86976362	87176362	harbor1	chr2	87023901	87024920	DNA/TcMar-Tigger	5643	-	510	87024411	48049
chr2	86976362	87176362	harbor1	chr2	87064038	87064635	DNA/TcMar-Tigger	717	-	298	87064336	87974
chr2	26403771	26603771	harbor1	chr2	26428251	26428516	DNA/TcMar-Tigger	2173	-	132	26428383	24612
chr2	26403771	26603771	harbor1	chr2	26428810	26428890	DNA/TcMar-Tigger	2173	-	40	26428850	25079
chr2	129830912	130030912	harbor1	chr2	129878716	129879041	DNA/TcMar-Tigger	1872	-	162	129878878	47966
chr2	129830912	130030912	harbor1	chr2	129921357	129921938	DNA/TcMar-Tigger	2563	-	290	129921647	90735
chr2	26950298	27150298	harbor1	chr2	27001122	27001357	DNA/TcMar-Tigger	1541	-	118	27001240	50942
chr2	26950298	27150298	harbor1	chr2	27001702	27001829	DNA/TcMar-Tigger	570	-	64	27001766	51468
chr2	26950298	27150298	harbor1	chr2	27022427	27022777	DNA/TcMar-Tigger	1965	-	175	27022602	72304
chr2	130256054	130456054	harbor1	chr2	130257180	130257536	DNA/TcMar-Tigger	2023	-	178	130257358	1304
chr2	130256054	130456054	harbor1	chr2	130289757	130289959	DNA/TcMar-Tigger	13667	-	101	130289858	33804
chr2	130256054	130456054	harbor1	chr2	130290270	130290725	DNA/TcMar-Tigger	13667	-	228	130290498	34444
chr2	130256054	130456054	harbor1	chr2	130291030	130292130	DNA/TcMar-Tigger	13667	-	550	130291580	35526
chr2	130256054	130456054	harbor1	chr2	130292443	130293124	DNA/TcMar-Tigger	13667	-	340	130292783	36729
chr2	130256054	130456054	harbor1	chr2	130319683	130319952	DNA/TcMar-Tigger	1335	-	134	130319817	63763
chr2	9301841	9501841	harbor1	chr2	9303115	9303499	DNA/TcMar-Tigger	467	-	192	9303307	1466
chr2	9301841	9501841	harbor1	chr2	9372436	9372997	DNA/TcMar-Tigger	2685	-	280	9372716	70875
chr2	60880293	61080293	harbor1	chr2	60966754	60967158	DNA/TcMar-Tigger	607	-	202	60966956	86663
chr2	152618050	152818050	harbor1	chr2	152630932	152631103	DNA/TcMar-Tigger	946	-	86	152631018	12968
chr2	152618050	152818050	harbor1	chr2	152631416	152631737	DNA/TcMar-Tigger	1326	-	160	152631576	13526
chr2	152618050	152818050	harbor1	chr2	152697583	152697917	DNA/TcMar-Tigger	1770	-	167	152697750	79700
chr2	152618050	152818050	harbor1	chr2	152709235	152709443	DNA/TcMar-Tigger	921	-	104	152709339	91289
chr2	30046187	30246187	harbor1	chr2	30094838	30095148	DNA/TcMar-Tigger	1265	-	155	30094993	48806
chr2	30046187	30246187	harbor1	chr2	30095679	30095933	DNA/TcMar-Tigger	1236	-	127	30095806	49619
chr2	30046187	30246187	harbor1	chr2	30110520	30110610	DNA/TcMar-Tigger	555	-	45	30110565	64378
chr2	30046187	30246187	harbor1	chr2	30110932	30111154	DNA/TcMar-Tigger	1049	-	111	30111043	64856
chr2	30046187	30246187	harbor1	chr2	30136774	30136878	DNA/TcMar-Tigger	682	-	52	30136826	90639
chr2	30046187	30246187	harbor1	chr2	30136880	30137084	DNA/TcMar-Tigger	703	-	102	30136982	90795
chr2	72971135	73171135	harbor1	chr2	73016782	73017130	DNA/TcMar-Tigger	1458	-	174	73016956	45821
chr2	72971135	73171135	harbor1	chr2	73038021	73038489	DNA/TcMar-Tigger	2820	-	234	73038255	67120
chr2	72971135	73171135	harbor1	chr2	73038638	73038895	DNA/TcMar-Tigger	1228	-	128	73038766	67631
chr2	72971135	73171135	harbor1	chr2	73038896	73038939	DNA/TcMar-Tigger	568	-	22	73038918	67783
chr2	72971135	73171135	harbor1	chr2	73039228	73039305	DNA/TcMar-Tigger	568	-	38	73039266	68131
chr2	152617972	152817972	harbor1	chr2	152630932	152631103	DNA/TcMar-Tigger	946	-	86	152631018	13046
chr2	152617972	152817972	harbor1	chr2	152631416	152631737	DNA/TcMar-Tigger	1326	-	160	152631576	13604
chr2	152617972	152817972	harbor1	chr2	152697583	152697917	DNA/TcMar-Tigger	1770	-	167	152697750	79778
chr2	152617972	152817972	harbor1	chr2	152709235	152709443	DNA/TcMar-Tigger	921	-	104	152709339	91367
chr2	72046074	72246074	harbor1	chr2	72106210	72106426	DNA/TcMar-Tigger	967	-	108	72106318	60244
chr2	72046074	72246074	harbor1	chr2	72125627	72126021	DNA/TcMar-Tigger	1142	-	197	72125824	79750
chr2	152250414	152450414	harbor1	chr2	152257125	152257442	DNA/TcMar-Tigger	1016	-	158	152257283	6869
chr2	152250414	152450414	harbor1	chr2	152257731	152257867	DNA/TcMar-Tigger	1016	-	68	152257799	7385
chr2	152250414	152450414	harbor1	chr2	152321181	152321272	DNA/TcMar-Tigger	557	-	46	152321227	70813
chr2	66333430	66533430	harbor1	chr2	66398879	66399146	DNA/TcMar-Tigger	1490	-	134	66399013	65583
chr2	59821692	60021692	harbor1	chr2	59827376	59828035	DNA/TcMar-Tigger	1656	-	330	59827706	6014
chr2	59821692	60021692	harbor1	chr2	59866094	59866291	DNA/TcMar-Tigger	1327	-	98	59866192	44500
chr2	59821692	60021692	harbor1	chr2	59866494	59867031	DNA/TcMar-Tigger	2720	-	268	59866762	45070
chr2	59821692	60021692	harbor1	chr2	59900960	59901125	DNA/TcMar-Tigger	752	-	82	59901042	79350
chr2	59821692	60021692	harbor1	chr2	59867032	59867137	DNA/TcMar-Tigger	633	-	52	59867084	45392
chr2	241050336	241250336	harbor1	chr2	241089705	241090027	DNA/TcMar-Tigger	1559	-	161	241089866	39530
chr2	241050336	241250336	harbor1	chr2	241090895	241090968	DNA/TcMar-Tigger	3192	-	36	241090931	40595
chr2	241050336	241250336	harbor1	chr2	241129336	241129644	DNA/TcMar-Tigger	567	-	154	241129490	79154
chr2	241050336	241250336	harbor1	chr2	241135277	241135501	DNA/TcMar-Tigger	1047	-	112	241135389	85053
chr2	241050336	241250336	harbor1	chr2	241090043	241090611	DNA/TcMar-Tigger	3192	-	284	241090327	39991
chr2	131392202	131592202	harbor1	chr2	131451742	131452170	DNA/TcMar-Tigger	2848	-	214	131451956	59754
chr2	131392202	131592202	harbor1	chr2	131452201	131453068	DNA/TcMar-Tigger	2848	-	434	131452635	60433
chr2	131392202	131592202	harbor1	chr2	131453372	131453633	DNA/TcMar-Tigger	2848	-	130	131453502	61300
chr2	113177630	113377630	harbor1	chr2	113194495	113194812	DNA/TcMar-Tigger	1692	-	158	113194653	17023
chr2	22969090	23169090	harbor1	chr2	23028764	23029084	DNA/TcMar-Tigger	1646	-	160	23028924	59834
chr2	219458132	219658132	harbor1	chr2	219478606	219478810	DNA/TcMar-Tigger	543	-	102	219478708	20576
chr2	217888302	218088302	harbor1	chr2	217896669	217897037	DNA/TcMar-Tigger	1059	-	184	217896853	8551
chr2	26403748	26603748	harbor1	chr2	26428251	26428516	DNA/TcMar-Tigger	2173	-	132	26428383	24635
chr2	26403748	26603748	harbor1	chr2	26428810	26428890	DNA/TcMar-Tigger	2173	-	40	26428850	25102
chr2	46198453	46398453	harbor1	chr2	46223307	46223429	DNA/TcMar-Tigger	456	-	61	46223368	24915
chr2	46198453	46398453	harbor1	chr2	46258247	46258627	DNA/TcMar-Tigger	2011	-	190	46258437	59984
chr2	46198517	46398517	harbor1	chr2	46223307	46223429	DNA/TcMar-Tigger	456	-	61	46223368	24851
chr2	46198517	46398517	harbor1	chr2	46258247	46258627	DNA/TcMar-Tigger	2011	-	190	46258437	59920
chr2	45443610	45643610	harbor1	chr2	45465051	45465385	DNA/TcMar-Tigger	1908	-	167	45465218	21608
chr2	45443610	45643610	harbor1	chr2	45482741	45482942	DNA/TcMar-Tigger	1265	-	100	45482841	39231
chr2	45443610	45643610	harbor1	chr2	45527884	45528117	DNA/TcMar-Tigger	658	-	116	45528000	84390
chr2	200971419	201171419	harbor1	chr2	201007192	201007562	DNA/TcMar-Tigger	2092	-	185	201007377	35958
chr2	46198560	46398560	harbor1	chr2	46223307	46223429	DNA/TcMar-Tigger	456	-	61	46223368	24808
chr2	46198560	46398560	harbor1	chr2	46258247	46258627	DNA/TcMar-Tigger	2011	-	190	46258437	59877
chr2	72971209	73171209	harbor1	chr2	73016782	73017130	DNA/TcMar-Tigger	1458	-	174	73016956	45747
chr2	72971209	73171209	harbor1	chr2	73038021	73038489	DNA/TcMar-Tigger	2820	-	234	73038255	67046
chr2	72971209	73171209	harbor1	chr2	73038638	73038895	DNA/TcMar-Tigger	1228	-	128	73038766	67557
chr2	72971209	73171209	harbor1	chr2	73038896	73038939	DNA/TcMar-Tigger	568	-	22	73038918	67709
chr2	72971209	73171209	harbor1	chr2	73039228	73039305	DNA/TcMar-Tigger	568	-	38	73039266	68057
chr2	26950213	27150213	harbor1	chr2	27001122	27001357	DNA/TcMar-Tigger	1541	-	118	27001240	51027
chr2	26950213	27150213	harbor1	chr2	27001702	27001829	DNA/TcMar-Tigger	570	-	64	27001766	51553
chr2	26950213	27150213	harbor1	chr2	27022427	27022777	DNA/TcMar-Tigger	1965	-	175	27022602	72389
chr2	72043426	72243426	harbor1	chr2	72106210	72106426	DNA/TcMar-Tigger	967	-	108	72106318	62892
chr2	72043426	72243426	harbor1	chr2	72125627	72126021	DNA/TcMar-Tigger	1142	-	197	72125824	82398
chr2	231861900	232061900	harbor1	chr2	231937372	231937607	DNA/TcMar-Tigger	1404	-	118	231937490	75590
chr2	72787358	72987358	harbor1	chr2	72830400	72831188	DNA/TcMar-Tigger	4337	-	394	72830794	43436
chr2	111023146	111223146	harbor1	chr2	111064057	111064154	DNA/TcMar-Tigger	1615	-	48	111064105	40959
chr2	111023146	111223146	harbor1	chr2	111064457	111064707	DNA/TcMar-Tigger	1615	-	125	111064582	41436
chr2	66131385	66331385	harbor1	chr2	66155760	66156113	DNA/TcMar-Tigger	1909	-	176	66155936	24551
chr2	72787359	72987359	harbor1	chr2	72830400	72831188	DNA/TcMar-Tigger	4337	-	394	72830794	43435
chr2	112640558	112840558	harbor1	chr2	112664503	112664897	DNA/TcMar-Tigger	2110	-	197	112664700	24142
chr2	112640558	112840558	harbor1	chr2	112719011	112719164	DNA/TcMar-Tigger	954	-	76	112719087	78529
chr2	112640558	112840558	harbor1	chr2	112719165	112719319	DNA/TcMar-Tigger	723	-	77	112719242	78684
chr2	219392988	219592988	harbor1	chr2	219478606	219478810	DNA/TcMar-Tigger	543	-	102	219478708	85720
chr2	64294495	64494495	harbor1	chr2	64302259	64302598	DNA/TcMar-Tigger	2216	-	170	64302429	7934
chr2	64294495	64494495	harbor1	chr2	64342875	64343211	DNA/TcMar-Tigger	1934	-	168	64343043	48548
chr2	64294495	64494495	harbor1	chr2	64346696	64346792	DNA/TcMar-Tigger	587	-	48	64346744	52249
chr2	64294495	64494495	harbor1	chr2	64346794	64347067	DNA/TcMar-Tigger	1228	-	136	64346930	52435
chr2	2132316	2332316	harbor1	chr2	2151572	2151746	DNA/TcMar-Tigger	1075	-	87	2151659	19343
chr2	2132316	2332316	harbor1	chr2	2152081	2152456	DNA/TcMar-Tigger	1741	-	188	2152269	19953
chr2	219060085	219260085	harbor1	chr2	219067512	219067871	DNA/TcMar-Tigger	2261	-	180	219067692	7607
chr2	43054951	43254951	harbor1	chr2	43093124	43093515	DNA/TcMar-Tigger	969	-	196	43093320	38369
chr2	43054951	43254951	harbor1	chr2	43093828	43094092	DNA/TcMar-Tigger	969	-	132	43093960	39009
chr2	43054951	43254951	harbor1	chr2	43141121	43141288	DNA/TcMar-Tigger	930	-	84	43141205	86254
chr2	43054951	43254951	harbor1	chr2	43141855	43141922	DNA/TcMar-Tigger	930	-	34	43141889	86938
chr2	204956154	205156154	harbor1	chr2	205014982	205015430	DNA/TcMar-Tigger	2559	-	224	205015206	59052
chr2	175979808	176179808	harbor1	chr2	175985589	175985909	DNA/TcMar-Tigger	1555	-	160	175985749	5941
chr2	175979808	176179808	harbor1	chr2	176040020	176040379	DNA/TcMar-Tigger	1627	-	180	176040200	60392
chr2	11244853	11444853	harbor1	chr2	11265987	11266295	DNA/TcMar-Tigger	1892	-	154	11266141	21288
chr2	11244853	11444853	harbor1	chr2	11266292	11266454	DNA/TcMar-Tigger	728	-	81	11266373	21520
chr2	11244853	11444853	harbor1	chr2	11274802	11274974	DNA/TcMar-Tigger	1641	-	86	11274888	30035
chr2	11244853	11444853	harbor1	chr2	11275277	11275437	DNA/TcMar-Tigger	1641	-	80	11275357	30504
chr2	11244853	11444853	harbor1	chr2	11340121	11340405	DNA/TcMar-Tigger	904	-	142	11340263	95410
chr2	239594717	239794717	harbor1	chr2	239654058	239655936	DNA/TcMar-Tigger	16504	-	939	239654997	60280
chr2	239594717	239794717	harbor1	chr2	239656237	239657067	DNA/TcMar-Tigger	16504	-	415	239656652	61935
chr2	239594717	239794717	harbor1	chr2	239686535	239686874	DNA/TcMar-Tigger	1910	-	170	239686705	91988
chr2	219060809	219260809	harbor1	chr2	219067512	219067871	DNA/TcMar-Tigger	2261	-	180	219067692	6883
chr2	119120408	119320408	harbor1	chr2	119187589	119188711	DNA/TcMar-Tigger	5370	-	561	119188150	67742
chr2	60966422	61166422	harbor1	chr2	60966754	60967158	DNA/TcMar-Tigger	607	-	202	60966956	534
chr2	237867415	238067415	harbor1	chr2	237867247	237867427	DNA/TcMar-Tigger	754	-	90	237867337	78
chr2	237867415	238067415	harbor1	chr2	237939649	237939675	DNA/TcMar-Tigger	1348	-	13	237939662	72247
chr2	237867415	238067415	harbor1	chr2	237940489	237940741	DNA/TcMar-Tigger	1348	-	126	237940615	73200
chr2	232203322	232403322	harbor1	chr2	232277683	232278021	DNA/TcMar-Tigger	1781	-	169	232277852	74530
chr2	53759983	53959983	harbor1	chr2	53800075	53800386	DNA/TcMar-Tigger	1685	-	156	53800231	40248
chr2	158868003	159068003	harbor1	chr2	158939277	158939486	DNA/TcMar-Tigger	1294	-	104	158939381	71378
chr2	43126586	43326586	harbor1	chr2	43141121	43141288	DNA/TcMar-Tigger	930	-	84	43141205	14619
chr2	43126586	43326586	harbor1	chr2	43141855	43141922	DNA/TcMar-Tigger	930	-	34	43141889	15303
chr2	72971106	73171106	harbor1	chr2	73016782	73017130	DNA/TcMar-Tigger	1458	-	174	73016956	45850
chr2	72971106	73171106	harbor1	chr2	73038021	73038489	DNA/TcMar-Tigger	2820	-	234	73038255	67149
chr2	72971106	73171106	harbor1	chr2	73038638	73038895	DNA/TcMar-Tigger	1228	-	128	73038766	67660
chr2	72971106	73171106	harbor1	chr2	73038896	73038939	DNA/TcMar-Tigger	568	-	22	73038918	67812
chr2	72971106	73171106	harbor1	chr2	73039228	73039305	DNA/TcMar-Tigger	568	-	38	73039266	68160
chr2	27395167	27595167	harbor1	chr2	27452475	27452843	DNA/TcMar-Tigger	1330	-	184	27452659	57492
chr2	26957504	27157504	harbor1	chr2	27001122	27001357	DNA/TcMar-Tigger	1541	-	118	27001240	43736
chr2	26957504	27157504	harbor1	chr2	27001702	27001829	DNA/TcMar-Tigger	570	-	64	27001766	44262
chr2	26957504	27157504	harbor1	chr2	27022427	27022777	DNA/TcMar-Tigger	1965	-	175	27022602	65098
chr2	28770576	28970576	harbor1	chr2	28772660	28772887	DNA/TcMar-Tigger	1435	-	114	28772774	2198
chr2	43055485	43255485	harbor1	chr2	43093124	43093515	DNA/TcMar-Tigger	969	-	196	43093320	37835
chr2	43055485	43255485	harbor1	chr2	43093828	43094092	DNA/TcMar-Tigger	969	-	132	43093960	38475
chr2	43055485	43255485	harbor1	chr2	43141121	43141288	DNA/TcMar-Tigger	930	-	84	43141205	85720
chr2	43055485	43255485	harbor1	chr2	43141855	43141922	DNA/TcMar-Tigger	930	-	34	43141889	86404
chr2	46198514	46398514	harbor1	chr2	46223307	46223429	DNA/TcMar-Tigger	456	-	61	46223368	24854
chr2	46198514	46398514	harbor1	chr2	46258247	46258627	DNA/TcMar-Tigger	2011	-	190	46258437	59923
chr2	219458026	219658026	harbor1	chr2	219478606	219478810	DNA/TcMar-Tigger	543	-	102	219478708	20682
chr2	43118487	43318487	harbor1	chr2	43141121	43141288	DNA/TcMar-Tigger	930	-	84	43141205	22718
chr2	43118487	43318487	harbor1	chr2	43141855	43141922	DNA/TcMar-Tigger	930	-	34	43141889	23402
chr2	60966462	61166462	harbor1	chr2	60966754	60967158	DNA/TcMar-Tigger	607	-	202	60966956	494
chr2	236586213	236786213	harbor1	chr2	236652577	236653585	DNA/TcMar-Tigger	4606	-	504	236653081	66868
chr2	24693648	24893648	harbor1	chr2	24740256	24740578	DNA/TcMar-Tigger	1629	-	161	24740417	46769
chr2	217614103	217814103	harbor1	chr2	217689449	217689530	DNA/TcMar-Tigger	590	-	40	217689489	75386
chr2	160393135	160593135	harbor1	chr2	160452304	160452614	DNA/TcMar-Tigger	1299	-	155	160452459	59324
chr2	160393135	160593135	harbor1	chr2	160456486	160456744	DNA/TcMar-Tigger	472	-	129	160456615	63480
chr2	94934942	95134942	harbor1	chr2	94992941	94993304	DNA/TcMar-Tigger	1596	-	182	94993123	58181
chr2	111955759	112155759	harbor1	chr2	111990612	111990831	DNA/TcMar-Tigger	1225	-	110	111990722	34963
chr2	111955759	112155759	harbor1	chr2	112035646	112035995	DNA/TcMar-Tigger	1976	-	174	112035820	80061
chr2	217374869	217574869	harbor1	chr2	217441395	217441725	DNA/TcMar-Tigger	2163	-	165	217441560	66691
chr2	112779792	112979792	harbor1	chr2	112802156	112802305	DNA/TcMar-Tigger	3591	-	74	112802230	22438
chr2	112779792	112979792	harbor1	chr2	112802597	112802701	DNA/TcMar-Tigger	3591	-	52	112802649	22857
chr2	112779792	112979792	harbor1	chr2	112803000	112803417	DNA/TcMar-Tigger	3591	-	208	112803208	23416
chr2	26403834	26603834	harbor1	chr2	26428251	26428516	DNA/TcMar-Tigger	2173	-	132	26428383	24549
chr2	26403834	26603834	harbor1	chr2	26428810	26428890	DNA/TcMar-Tigger	2173	-	40	26428850	25016
chr2	26950239	27150239	harbor1	chr2	27001122	27001357	DNA/TcMar-Tigger	1541	-	118	27001240	51001
chr2	26950239	27150239	harbor1	chr2	27001702	27001829	DNA/TcMar-Tigger	570	-	64	27001766	51527
chr2	26950239	27150239	harbor1	chr2	27022427	27022777	DNA/TcMar-Tigger	1965	-	175	27022602	72363
chr3	138334620	138534620	harbor1	chr3	138412900	138413029	DNA/TcMar-Tigger	428	-	64	138412964	78344
chr3	156989205	157189205	harbor1	chr3	157023859	157024233	DNA/TcMar-Tigger	1752	-	187	157024046	34841
chr3	156989205	157189205	harbor1	chr3	157038708	157039000	DNA/TcMar-Tigger	830	-	146	157038854	49649
chr3	46799563	46999563	harbor1	chr3	46804959	46805302	DNA/TcMar-Tigger	2982	-	172	46805131	5568
chr3	46799563	46999563	harbor1	chr3	46805600	46805889	DNA/TcMar-Tigger	2982	-	144	46805744	6181
chr3	49775590	49975590	harbor1	chr3	49776201	49776234	DNA/TcMar-Tigger	1261	-	16	49776217	627
chr3	49775590	49975590	harbor1	chr3	49776549	49776791	DNA/TcMar-Tigger	1261	-	121	49776670	1080
chr3	129021155	129221155	harbor1	chr3	129028431	129028631	DNA/TcMar-Tigger	551	-	100	129028531	7376
chr3	129021155	129221155	harbor1	chr3	129028941	129029180	DNA/TcMar-Tigger	551	-	120	129029061	7906
chr3	129021155	129221155	harbor1	chr3	129029214	129029325	DNA/TcMar-Tigger	413	-	56	129029270	8115
chr3	161005424	161205424	harbor1	chr3	161082995	161084119	DNA/TcMar-Tigger	5895	-	562	161083557	78133
chr3	43899206	44099206	harbor1	chr3	43905123	43905296	DNA/TcMar-Tigger	492	-	86	43905209	6003
chr3	47681961	47881961	harbor1	chr3	47684762	47685400	DNA/TcMar-Tigger	1889	-	319	47685081	3120
chr3	47681961	47881961	harbor1	chr3	47729792	47729902	DNA/TcMar-Tigger	12745	-	55	47729847	47886
chr3	47681961	47881961	harbor1	chr3	47730497	47730583	DNA/TcMar-Tigger	12745	-	43	47730540	48579
chr3	47681961	47881961	harbor1	chr3	47730883	47732828	DNA/TcMar-Tigger	12745	-	972	47731855	49894
chr3	47681961	47881961	harbor1	chr3	47733134	47733265	DNA/TcMar-Tigger	12745	-	66	47733200	51239
chr3	17061072	17261072	harbor1	chr3	17073183	17075595	DNA/TcMar-Tigger	14622	-	1206	17074389	13317
chr3	43899195	44099195	harbor1	chr3	43905123	43905296	DNA/TcMar-Tigger	492	-	86	43905209	6014
chr3	123349837	123549837	harbor1	chr3	123355424	123355488	DNA/TcMar-Tigger	421	-	32	123355456	5619
chr3	123349837	123549837	harbor1	chr3	123361650	123361981	DNA/TcMar-Tigger	1894	-	166	123361816	11979
chr3	185838095	186038095	harbor1	chr3	185880683	185880777	DNA/TcMar-Tigger	616	-	47	185880730	42635
chr3	185838095	186038095	harbor1	chr3	185880777	185880940	DNA/TcMar-Tigger	1253	-	82	185880859	42764
chr3	185838095	186038095	harbor1	chr3	185881243	185881365	DNA/TcMar-Tigger	1253	-	61	185881304	43209
chr3	185838095	186038095	harbor1	chr3	185913653	185913815	DNA/TcMar-Tigger	789	-	81	185913734	75639
chr3	142754359	142954359	harbor1	chr3	142783409	142783649	DNA/TcMar-Tigger	1473	-	120	142783529	29170
chr3	142754359	142954359	harbor1	chr3	142796636	142796750	DNA/TcMar-Tigger	573	-	57	142796693	42334
chr3	196916565	197116565	harbor1	chr3	196921051	196921405	DNA/TcMar-Tigger	1804	-	177	196921228	4663
chr3	39004795	39204795	harbor1	chr3	39064860	39065065	DNA/TcMar-Tigger	418	-	102	39064962	60167
chr3	39004795	39204795	harbor1	chr3	39102004	39102327	DNA/TcMar-Tigger	2014	-	162	39102166	97371
chr3	127581151	127781151	harbor1	chr3	127620018	127620540	DNA/TcMar-Tigger	751	-	261	127620279	39128
chr3	123544681	123744681	harbor1	chr3	123604896	123605033	DNA/TcMar-Tigger	900	-	68	123604964	60283
chr3	123544681	123744681	harbor1	chr3	123605324	123605466	DNA/TcMar-Tigger	900	-	71	123605395	60714
chr3	123544681	123744681	harbor1	chr3	123607100	123607345	DNA/TcMar-Tigger	1741	-	122	123607222	62541
chr3	16431951	16631951	harbor1	chr3	16451534	16452217	DNA/TcMar-Tigger	3859	-	342	16451876	19925
chr3	128328692	128528692	harbor1	chr3	128332310	128332457	DNA/TcMar-Tigger	864	-	74	128332384	3692
chr3	128328692	128528692	harbor1	chr3	128353011	128353243	DNA/TcMar-Tigger	872	-	116	128353127	24435
chr3	123349752	123549752	harbor1	chr3	123355424	123355488	DNA/TcMar-Tigger	421	-	32	123355456	5704
chr3	123349752	123549752	harbor1	chr3	123361650	123361981	DNA/TcMar-Tigger	1894	-	166	123361816	12064
chr3	52121829	52321829	harbor1	chr3	52210812	52211148	DNA/TcMar-Tigger	2302	-	168	52210980	89151
chr3	46771747	46971747	harbor1	chr3	46804959	46805302	DNA/TcMar-Tigger	2982	-	172	46805131	33384
chr3	46771747	46971747	harbor1	chr3	46805600	46805889	DNA/TcMar-Tigger	2982	-	144	46805744	33997
chr3	138334619	138534619	harbor1	chr3	138412900	138413029	DNA/TcMar-Tigger	428	-	64	138412964	78345
chr3	113647007	113847007	harbor1	chr3	113701081	113701194	DNA/TcMar-Tigger	638	-	56	113701137	54130
chr3	113647007	113847007	harbor1	chr3	113701764	113701929	DNA/TcMar-Tigger	2796	-	82	113701846	54839
chr3	113647007	113847007	harbor1	chr3	113702224	113702456	DNA/TcMar-Tigger	2796	-	116	113702340	55333
chr3	113647007	113847007	harbor1	chr3	113703066	113703090	DNA/TcMar-Tigger	2796	-	12	113703078	56071
chr3	113647007	113847007	harbor1	chr3	113703393	113703466	DNA/TcMar-Tigger	2796	-	36	113703429	56422
chr3	113647007	113847007	harbor1	chr3	113705448	113706739	DNA/TcMar-Tigger	8455	-	646	113706094	59087
chr3	113647007	113847007	harbor1	chr3	113709020	113709203	DNA/TcMar-Tigger	1106	-	92	113709112	62105
chr3	179842465	180042465	harbor1	chr3	179876827	179877146	DNA/TcMar-Tigger	1892	-	160	179876987	34522
chr3	179842465	180042465	harbor1	chr3	179916149	179916678	DNA/TcMar-Tigger	6971	-	264	179916413	73948
chr3	179842465	180042465	harbor1	chr3	179916970	179917657	DNA/TcMar-Tigger	6971	-	344	179917314	74849
chr3	179842465	180042465	harbor1	chr3	179917959	179917987	DNA/TcMar-Tigger	6971	-	14	179917973	75508
chr3	190413906	190613906	harbor1	chr3	190461531	190461915	DNA/TcMar-Tigger	1867	-	192	190461723	47817
chr3	52945185	53145185	harbor1	chr3	52986172	52986484	DNA/TcMar-Tigger	3406	-	156	52986328	41143
chr3	52945185	53145185	harbor1	chr3	52986947	52987532	DNA/TcMar-Tigger	3038	-	292	52987239	42054
chr3	52945185	53145185	harbor1	chr3	53009614	53010032	DNA/TcMar-Tigger	2338	-	209	53009823	64638
chr3	52945185	53145185	harbor1	chr3	53025283	53025326	DNA/TcMar-Tigger	411	-	22	53025305	80120
chr3	52945185	53145185	harbor1	chr3	53025636	53025735	DNA/TcMar-Tigger	411	-	50	53025686	80501
chr3	52945185	53145185	harbor1	chr3	53035496	53035607	DNA/TcMar-Tigger	521	-	56	53035552	90367
chr3	52945185	53145185	harbor1	chr3	53035893	53036054	DNA/TcMar-Tigger	521	-	80	53035973	90788
chr3	52945185	53145185	harbor1	chr3	52985597	52985860	DNA/TcMar-Tigger	3406	-	132	52985729	40544
chr3	128328699	128528699	harbor1	chr3	128332310	128332457	DNA/TcMar-Tigger	864	-	74	128332384	3685
chr3	128328699	128528699	harbor1	chr3	128353011	128353243	DNA/TcMar-Tigger	872	-	116	128353127	24428
chr3	128328755	128528755	harbor1	chr3	128332310	128332457	DNA/TcMar-Tigger	864	-	74	128332384	3629
chr3	128328755	128528755	harbor1	chr3	128353011	128353243	DNA/TcMar-Tigger	872	-	116	128353127	24372
chr3	184199369	184399369	harbor1	chr3	184217478	184217510	DNA/TcMar-Tigger	760	-	16	184217494	18125
chr3	184199369	184399369	harbor1	chr3	184217824	184217897	DNA/TcMar-Tigger	760	-	36	184217860	18491
chr3	184199369	184399369	harbor1	chr3	184218220	184218396	DNA/TcMar-Tigger	760	-	88	184218308	18939
chr3	123544677	123744677	harbor1	chr3	123604896	123605033	DNA/TcMar-Tigger	900	-	68	123604964	60287
chr3	123544677	123744677	harbor1	chr3	123605324	123605466	DNA/TcMar-Tigger	900	-	71	123605395	60718
chr3	123544677	123744677	harbor1	chr3	123607100	123607345	DNA/TcMar-Tigger	1741	-	122	123607222	62545
chr3	50169366	50369366	harbor1	chr3	50178258	50178438	DNA/TcMar-Tigger	8161	-	90	50178348	8982
chr3	50169366	50369366	harbor1	chr3	50178736	50178820	DNA/TcMar-Tigger	8161	-	42	50178778	9412
chr3	50169366	50369366	harbor1	chr3	50179119	50179316	DNA/TcMar-Tigger	8161	-	98	50179217	9851
chr3	50169366	50369366	harbor1	chr3	50179626	50180137	DNA/TcMar-Tigger	8161	-	256	50179882	10516
chr3	50169366	50369366	harbor1	chr3	50180456	50180784	DNA/TcMar-Tigger	8161	-	164	50180620	11254
chr3	50169366	50369366	harbor1	chr3	50181088	50181244	DNA/TcMar-Tigger	8161	-	78	50181166	11800
chr3	128581053	128781053	harbor1	chr3	128624045	128624202	DNA/TcMar-Tigger	692	-	78	128624123	43070
chr3	128581053	128781053	harbor1	chr3	128624512	128624541	DNA/TcMar-Tigger	692	-	14	128624526	43473
chr3	128581053	128781053	harbor1	chr3	128640921	128641061	DNA/TcMar-Tigger	447	-	70	128640991	59938
chr3	47681964	47881964	harbor1	chr3	47684762	47685400	DNA/TcMar-Tigger	1889	-	319	47685081	3117
chr3	47681964	47881964	harbor1	chr3	47729792	47729902	DNA/TcMar-Tigger	12745	-	55	47729847	47883
chr3	47681964	47881964	harbor1	chr3	47730497	47730583	DNA/TcMar-Tigger	12745	-	43	47730540	48576
chr3	47681964	47881964	harbor1	chr3	47730883	47732828	DNA/TcMar-Tigger	12745	-	972	47731855	49891
chr3	47681964	47881964	harbor1	chr3	47733134	47733265	DNA/TcMar-Tigger	12745	-	66	47733200	51236
chr3	122414401	122614401	harbor1	chr3	122464593	122464876	DNA/TcMar-Tigger	543	-	142	122464735	50334
chr3	122414401	122614401	harbor1	chr3	122465218	122465582	DNA/TcMar-Tigger	2080	-	182	122465400	50999
chr3	122414401	122614401	harbor1	chr3	122475601	122476037	DNA/TcMar-Tigger	2497	-	218	122475819	61418
chr3	122414401	122614401	harbor1	chr3	122482051	122482371	DNA/TcMar-Tigger	1703	-	160	122482211	67810
chr3	138087580	138287580	harbor1	chr3	138092729	138094376	DNA/TcMar-Tigger	9716	-	824	138093553	5973
chr3	138087580	138287580	harbor1	chr3	138105387	138105725	DNA/TcMar-Tigger	2102	-	169	138105556	17976
chr3	138087580	138287580	harbor1	chr3	138165232	138165425	DNA/TcMar-Tigger	950	-	96	138165328	77748
chr3	51571820	51771820	harbor1	chr3	51589095	51589238	DNA/TcMar-Tigger	966	-	72	51589167	17347
chr3	51571820	51771820	harbor1	chr3	51589429	51589653	DNA/TcMar-Tigger	1046	-	112	51589541	17721
chr3	19954840	20154840	harbor1	chr3	19959541	19959625	DNA/TcMar-Tigger	437	-	42	19959583	4743
chr3	19954840	20154840	harbor1	chr3	19959924	19959963	DNA/TcMar-Tigger	437	-	20	19959944	5104
chr3	19954840	20154840	harbor1	chr3	20006390	20006514	DNA/TcMar-Tigger	1014	-	62	20006452	51612
chr3	19954840	20154840	harbor1	chr3	20006766	20006776	DNA/TcMar-Tigger	1014	-	5	20006771	51931
chr3	19954840	20154840	harbor1	chr3	20007170	20007383	DNA/TcMar-Tigger	1014	-	106	20007276	52436
chr3	52946732	53146732	harbor1	chr3	52986172	52986484	DNA/TcMar-Tigger	3406	-	156	52986328	39596
chr3	52946732	53146732	harbor1	chr3	52986947	52987532	DNA/TcMar-Tigger	3038	-	292	52987239	40507
chr3	52946732	53146732	harbor1	chr3	53009614	53010032	DNA/TcMar-Tigger	2338	-	209	53009823	63091
chr3	52946732	53146732	harbor1	chr3	53025283	53025326	DNA/TcMar-Tigger	411	-	22	53025305	78573
chr3	52946732	53146732	harbor1	chr3	53025636	53025735	DNA/TcMar-Tigger	411	-	50	53025686	78954
chr3	52946732	53146732	harbor1	chr3	53035496	53035607	DNA/TcMar-Tigger	521	-	56	53035552	88820
chr3	52946732	53146732	harbor1	chr3	53035893	53036054	DNA/TcMar-Tigger	521	-	80	53035973	89241
chr3	52946732	53146732	harbor1	chr3	52985597	52985860	DNA/TcMar-Tigger	3406	-	132	52985729	38997
chr3	47725179	47925179	harbor1	chr3	47729792	47729902	DNA/TcMar-Tigger	12745	-	55	47729847	4668
chr3	47725179	47925179	harbor1	chr3	47730497	47730583	DNA/TcMar-Tigger	12745	-	43	47730540	5361
chr3	47725179	47925179	harbor1	chr3	47730883	47732828	DNA/TcMar-Tigger	12745	-	972	47731855	6676
chr3	47725179	47925179	harbor1	chr3	47733134	47733265	DNA/TcMar-Tigger	12745	-	66	47733200	8021
chr3	58016450	58216450	harbor1	chr3	58090097	58090679	DNA/TcMar-Tigger	2934	-	291	58090388	73938
chr3	156989217	157189217	harbor1	chr3	157023859	157024233	DNA/TcMar-Tigger	1752	-	187	157024046	34829
chr3	156989217	157189217	harbor1	chr3	157038708	157039000	DNA/TcMar-Tigger	830	-	146	157038854	49637
chr3	123544615	123744615	harbor1	chr3	123604896	123605033	DNA/TcMar-Tigger	900	-	68	123604964	60349
chr3	123544615	123744615	harbor1	chr3	123605324	123605466	DNA/TcMar-Tigger	900	-	71	123605395	60780
chr3	123544615	123744615	harbor1	chr3	123607100	123607345	DNA/TcMar-Tigger	1741	-	122	123607222	62607
chr3	46799778	46999778	harbor1	chr3	46804959	46805302	DNA/TcMar-Tigger	2982	-	172	46805131	5353
chr3	46799778	46999778	harbor1	chr3	46805600	46805889	DNA/TcMar-Tigger	2982	-	144	46805744	5966
chr3	38066121	38266121	harbor1	chr3	38103570	38104133	DNA/TcMar-Tigger	3084	-	282	38103852	37731
chr3	38066121	38266121	harbor1	chr3	38159253	38159686	DNA/TcMar-Tigger	2392	-	216	38159469	93348
chr3	129021082	129221082	harbor1	chr3	129028431	129028631	DNA/TcMar-Tigger	551	-	100	129028531	7449
chr3	129021082	129221082	harbor1	chr3	129028941	129029180	DNA/TcMar-Tigger	551	-	120	129029061	7979
chr3	129021082	129221082	harbor1	chr3	129029214	129029325	DNA/TcMar-Tigger	413	-	56	129029270	8188
chr3	47725235	47925235	harbor1	chr3	47729792	47729902	DNA/TcMar-Tigger	12745	-	55	47729847	4612
chr3	47725235	47925235	harbor1	chr3	47730497	47730583	DNA/TcMar-Tigger	12745	-	43	47730540	5305
chr3	47725235	47925235	harbor1	chr3	47730883	47732828	DNA/TcMar-Tigger	12745	-	972	47731855	6620
chr3	47725235	47925235	harbor1	chr3	47733134	47733265	DNA/TcMar-Tigger	12745	-	66	47733200	7965
chr3	128328747	128528747	harbor1	chr3	128332310	128332457	DNA/TcMar-Tigger	864	-	74	128332384	3637
chr3	128328747	128528747	harbor1	chr3	128353011	128353243	DNA/TcMar-Tigger	872	-	116	128353127	24380
chr3	126256502	126456502	harbor1	chr3	126277778	126278097	DNA/TcMar-Tigger	817	-	160	126277938	21436
chr3	126256502	126456502	harbor1	chr3	126283421	126283887	DNA/TcMar-Tigger	3027	-	233	126283654	27152
chr3	126256502	126456502	harbor1	chr3	126284111	126284837	DNA/TcMar-Tigger	3874	-	363	126284474	27972
chr3	128328796	128528796	harbor1	chr3	128332310	128332457	DNA/TcMar-Tigger	864	-	74	128332384	3588
chr3	128328796	128528796	harbor1	chr3	128353011	128353243	DNA/TcMar-Tigger	872	-	116	128353127	24331
chr3	51571305	51771305	harbor1	chr3	51589095	51589238	DNA/TcMar-Tigger	966	-	72	51589167	17862
chr3	51571305	51771305	harbor1	chr3	51589429	51589653	DNA/TcMar-Tigger	1046	-	112	51589541	18236
chr3	138334857	138534857	harbor1	chr3	138412900	138413029	DNA/TcMar-Tigger	428	-	64	138412964	78107
chr3	127581163	127781163	harbor1	chr3	127620018	127620540	DNA/TcMar-Tigger	751	-	261	127620279	39116
chr4	2656082	2856082	harbor1	chr4	2734096	2734322	DNA/TcMar-Tigger	1187	-	113	2734209	78127
chr4	145080529	145280529	harbor1	chr4	145090107	145090399	DNA/TcMar-Tigger	847	-	146	145090253	9724
chr4	910346	1110346	harbor1	chr4	986296	986596	DNA/TcMar-Tigger	1150	-	150	986446	76100
chr4	551216	751216	harbor1	chr4	551493	551848	DNA/TcMar-Tigger	1888	-	178	551671	455
chr4	903149	1103149	harbor1	chr4	986296	986596	DNA/TcMar-Tigger	1150	-	150	986446	83297
chr4	893424	1093424	harbor1	chr4	986296	986596	DNA/TcMar-Tigger	1150	-	150	986446	93022
chr4	150914523	151114523	harbor1	chr4	150999887	151000000	DNA/TcMar-Tigger	647	-	56	150999943	85420
chr4	150914523	151114523	harbor1	chr4	151000001	151000085	DNA/TcMar-Tigger	636	-	42	151000043	85520
chr4	150914523	151114523	harbor1	chr4	151000309	151000708	DNA/TcMar-Tigger	2072	-	200	151000509	85986
chr4	150914523	151114523	harbor1	chr4	151004292	151004616	DNA/TcMar-Tigger	1571	-	162	151004454	89931
chr4	150914523	151114523	harbor1	chr4	151008413	151008657	DNA/TcMar-Tigger	1257	-	122	151008535	94012
chr4	145080526	145280526	harbor1	chr4	145090107	145090399	DNA/TcMar-Tigger	847	-	146	145090253	9727
chr4	1420272	1620272	harbor1	chr4	1485707	1486035	DNA/TcMar-Tigger	1831	-	164	1485871	65599
chr4	70739795	70939795	harbor1	chr4	70768951	70769072	DNA/TcMar-Tigger	3186	-	60	70769011	29216
chr4	70739795	70939795	harbor1	chr4	70769339	70769757	DNA/TcMar-Tigger	3186	-	209	70769548	29753
chr4	70739795	70939795	harbor1	chr4	70769749	70769803	DNA/TcMar-Tigger	7668	-	27	70769776	29981
chr4	70739795	70939795	harbor1	chr4	70770122	70771306	DNA/TcMar-Tigger	7668	-	592	70770714	30919
chr4	70739795	70939795	harbor1	chr4	70771343	70771532	DNA/TcMar-Tigger	1550	-	94	70771437	31642
chr4	70739795	70939795	harbor1	chr4	70771830	70772059	DNA/TcMar-Tigger	1550	-	114	70771944	32149
chr4	70739795	70939795	harbor1	chr4	70776088	70776361	DNA/TcMar-Tigger	1436	-	136	70776224	36429
chr4	70739795	70939795	harbor1	chr4	70777169	70777265	DNA/TcMar-Tigger	552	-	48	70777217	37422
chr4	70739795	70939795	harbor1	chr4	70783523	70784141	DNA/TcMar-Tigger	777	-	309	70783832	44037
chr4	70739795	70939795	harbor1	chr4	70807928	70808271	DNA/TcMar-Tigger	1997	-	172	70808100	68305
chr4	139456023	139656023	harbor1	chr4	139526989	139527272	DNA/TcMar-Tigger	1805	-	142	139527131	71108
chr4	139456023	139656023	harbor1	chr4	139527588	139527648	DNA/TcMar-Tigger	1805	-	30	139527618	71595
chr4	39598067	39798067	harbor1	chr4	39636713	39636987	DNA/TcMar-Tigger	1426	-	137	39636850	38783
chr4	145080585	145280585	harbor1	chr4	145090107	145090399	DNA/TcMar-Tigger	847	-	146	145090253	9668
chr4	158917337	159117337	harbor1	chr4	158951205	158951514	DNA/TcMar-Tigger	1883	-	154	158951359	34022
chr4	910850	1110850	harbor1	chr4	986296	986596	DNA/TcMar-Tigger	1150	-	150	986446	75596
chr4	1107423	1307423	harbor1	chr4	1124576	1124899	DNA/TcMar-Tigger	1416	-	162	1124738	17315
chr4	1107423	1307423	harbor1	chr4	1157088	1158896	DNA/TcMar-Tigger	15437	-	904	1157992	50569
chr4	1107423	1307423	harbor1	chr4	1159183	1159753	DNA/TcMar-Tigger	15437	-	285	1159468	52045
chr4	1402290	1602290	harbor1	chr4	1485707	1486035	DNA/TcMar-Tigger	1831	-	164	1485871	83581
chr4	551200	751200	harbor1	chr4	551493	551848	DNA/TcMar-Tigger	1888	-	178	551671	471
chr4	150608140	150808140	harbor1	chr4	150700304	150700753	DNA/TcMar-Tigger	5818	-	224	150700528	92388
chr4	150608140	150808140	harbor1	chr4	150701033	150701619	DNA/TcMar-Tigger	5818	-	293	150701326	93186
chr4	910370	1110370	harbor1	chr4	986296	986596	DNA/TcMar-Tigger	1150	-	150	986446	76076
chr4	128711743	128911743	harbor1	chr4	128753922	128754111	DNA/TcMar-Tigger	826	-	94	128754016	42273
chr4	120822653	121022653	harbor1	chr4	120868254	120868514	DNA/TcMar-Tigger	836	-	130	120868384	45731
chr4	120822653	121022653	harbor1	chr4	120905006	120905312	DNA/TcMar-Tigger	539	-	153	120905159	82506
chr4	1420361	1620361	harbor1	chr4	1485707	1486035	DNA/TcMar-Tigger	1831	-	164	1485871	65510
chr4	2363119	2563119	harbor1	chr4	2377796	2378057	DNA/TcMar-Tigger	1268	-	130	2377926	14807
chr4	2363119	2563119	harbor1	chr4	2378356	2378402	DNA/TcMar-Tigger	1268	-	23	2378379	15260
chr4	120822725	121022725	harbor1	chr4	120868254	120868514	DNA/TcMar-Tigger	836	-	130	120868384	45659
chr4	120822725	121022725	harbor1	chr4	120905006	120905312	DNA/TcMar-Tigger	539	-	153	120905159	82434
chr4	148339554	148539554	harbor1	chr4	148348464	148348745	DNA/TcMar-Tigger	551	-	140	148348604	9050
chr4	148339554	148539554	harbor1	chr4	148364761	148365162	DNA/TcMar-Tigger	2592	-	200	148364961	25407
chr4	148339554	148539554	harbor1	chr4	148365165	148365392	DNA/TcMar-Tigger	1439	-	114	148365279	25725
chr4	148339554	148539554	harbor1	chr4	148388228	148388461	DNA/TcMar-Tigger	1107	-	116	148388344	48790
chr4	55295888	55495888	harbor1	chr4	55308258	55308510	DNA/TcMar-Tigger	6547	-	126	55308384	12496
chr4	55295888	55495888	harbor1	chr4	55308814	55309536	DNA/TcMar-Tigger	6547	-	361	55309175	13287
chr4	55295888	55495888	harbor1	chr4	55309846	55310141	DNA/TcMar-Tigger	6547	-	148	55309994	14106
chr4	70739714	70939714	harbor1	chr4	70768951	70769072	DNA/TcMar-Tigger	3186	-	60	70769011	29297
chr4	70739714	70939714	harbor1	chr4	70769339	70769757	DNA/TcMar-Tigger	3186	-	209	70769548	29834
chr4	70739714	70939714	harbor1	chr4	70769749	70769803	DNA/TcMar-Tigger	7668	-	27	70769776	30062
chr4	70739714	70939714	harbor1	chr4	70770122	70771306	DNA/TcMar-Tigger	7668	-	592	70770714	31000
chr4	70739714	70939714	harbor1	chr4	70771343	70771532	DNA/TcMar-Tigger	1550	-	94	70771437	31723
chr4	70739714	70939714	harbor1	chr4	70771830	70772059	DNA/TcMar-Tigger	1550	-	114	70771944	32230
chr4	70739714	70939714	harbor1	chr4	70776088	70776361	DNA/TcMar-Tigger	1436	-	136	70776224	36510
chr4	70739714	70939714	harbor1	chr4	70777169	70777265	DNA/TcMar-Tigger	552	-	48	70777217	37503
chr4	70739714	70939714	harbor1	chr4	70783523	70784141	DNA/TcMar-Tigger	777	-	309	70783832	44118
chr4	70739714	70939714	harbor1	chr4	70807928	70808271	DNA/TcMar-Tigger	1997	-	172	70808100	68386
chr4	70588818	70788818	harbor1	chr4	70632969	70633798	DNA/TcMar-Tigger	1399	-	414	70633383	44565
chr4	551205	751205	harbor1	chr4	551493	551848	DNA/TcMar-Tigger	1888	-	178	551671	466
chr4	153364398	153564398	harbor1	chr4	153369394	153369999	DNA/TcMar-Tigger	14546	-	302	153369696	5298
chr4	153364398	153564398	harbor1	chr4	153370292	153370521	DNA/TcMar-Tigger	14546	-	114	153370406	6008
chr4	153364398	153564398	harbor1	chr4	153370819	153372334	DNA/TcMar-Tigger	14546	-	758	153371577	7179
chr4	153364398	153564398	harbor1	chr4	153415786	153416058	DNA/TcMar-Tigger	6532	-	136	153415922	51524
chr4	153364398	153564398	harbor1	chr4	153416338	153416420	DNA/TcMar-Tigger	6532	-	41	153416379	51981
chr4	153364398	153564398	harbor1	chr4	153416723	153417002	DNA/TcMar-Tigger	6532	-	140	153416863	52465
chr4	153364398	153564398	harbor1	chr4	153417608	153417816	DNA/TcMar-Tigger	6532	-	104	153417712	53314
chr4	153364398	153564398	harbor1	chr4	153418131	153418444	DNA/TcMar-Tigger	6532	-	156	153418287	53889
chr4	15581883	15781883	harbor1	chr4	15602016	15602582	DNA/TcMar-Tigger	14510	-	283	15602299	20416
chr4	15581883	15781883	harbor1	chr4	15602869	15604675	DNA/TcMar-Tigger	14510	-	903	15603772	21889
chr4	15581883	15781883	harbor1	chr4	15607938	15608119	DNA/TcMar-Tigger	706	-	90	15608028	26145
chr4	15581883	15781883	harbor1	chr4	15669116	15669421	DNA/TcMar-Tigger	1342	-	152	15669268	87385
chr4	15581883	15781883	harbor1	chr4	15672321	15673159	DNA/TcMar-Tigger	4476	-	419	15672740	90857
chr4	15581883	15781883	harbor1	chr4	15673460	15673623	DNA/TcMar-Tigger	4476	-	82	15673542	91659
chr4	139076181	139276181	harbor1	chr4	139077132	139077308	DNA/TcMar-Tigger	778	-	88	139077220	1039
chr4	139076181	139276181	harbor1	chr4	139156972	139157328	DNA/TcMar-Tigger	1717	-	178	139157150	80969
chr4	120822783	121022783	harbor1	chr4	120868254	120868514	DNA/TcMar-Tigger	836	-	130	120868384	45601
chr4	120822783	121022783	harbor1	chr4	120905006	120905312	DNA/TcMar-Tigger	539	-	153	120905159	82376
chr4	55295797	55495797	harbor1	chr4	55308258	55308510	DNA/TcMar-Tigger	6547	-	126	55308384	12587
chr4	55295797	55495797	harbor1	chr4	55308814	55309536	DNA/TcMar-Tigger	6547	-	361	55309175	13378
chr4	55295797	55495797	harbor1	chr4	55309846	55310141	DNA/TcMar-Tigger	6547	-	148	55309994	14197
chr5	9549845	9749845	harbor1	chr5	9567356	9567620	DNA/TcMar-Tigger	1393	-	132	9567488	17643
chr5	9549845	9749845	harbor1	chr5	9632089	9633235	DNA/TcMar-Tigger	6464	-	573	9632662	82817
chr5	9549845	9749845	harbor1	chr5	9639660	9640579	DNA/TcMar-Tigger	4991	-	460	9640120	90275
chr5	9549845	9749845	harbor1	chr5	9643132	9643736	DNA/TcMar-Tigger	3430	-	302	9643434	93589
chr5	10661237	10861237	harbor1	chr5	10704114	10704349	DNA/TcMar-Tigger	956	-	118	10704232	42995
chr5	10661237	10861237	harbor1	chr5	10727744	10728103	DNA/TcMar-Tigger	2096	-	180	10727924	66687
chr5	9114326	9314326	harbor1	chr5	9117371	9117727	DNA/TcMar-Tigger	1835	-	178	9117549	3223
chr5	10341920	10541920	harbor1	chr5	10341891	10342079	DNA/TcMar-Tigger	1427	-	94	10341985	65
chr5	10341920	10541920	harbor1	chr5	10342367	10342500	DNA/TcMar-Tigger	1427	-	66	10342433	513
chr5	10341920	10541920	harbor1	chr5	10359494	10359667	DNA/TcMar-Tigger	771	-	86	10359580	17660
chr5	10150551	10350551	harbor1	chr5	10241737	10243203	DNA/TcMar-Tigger	15381	-	733	10242470	91919
chr5	10150551	10350551	harbor1	chr5	10243499	10244415	DNA/TcMar-Tigger	15381	-	458	10243957	93406
chr5	10150551	10350551	harbor1	chr5	10244546	10244586	DNA/TcMar-Tigger	15381	-	20	10244566	94015
chr5	150532654	150732654	harbor1	chr5	150544100	150544406	DNA/TcMar-Tigger	1145	-	153	150544253	11599
chr5	37007782	37207782	harbor1	chr5	37053004	37053088	DNA/TcMar-Tigger	1749	-	42	37053046	45264
chr5	37007782	37207782	harbor1	chr5	37053089	37053409	DNA/TcMar-Tigger	1972	-	160	37053249	45467
chr5	37007782	37207782	harbor1	chr5	37053410	37053659	DNA/TcMar-Tigger	1749	-	124	37053534	45752
chr5	37007782	37207782	harbor1	chr5	37061299	37061395	DNA/TcMar-Tigger	1185	-	48	37061347	53565
chr5	37007782	37207782	harbor1	chr5	37061687	37061845	DNA/TcMar-Tigger	1185	-	79	37061766	53984
chr5	37007782	37207782	harbor1	chr5	37062136	37062228	DNA/TcMar-Tigger	1185	-	46	37062182	54400
chr5	10296849	10496849	harbor1	chr5	10340369	10340487	DNA/TcMar-Tigger	466	-	59	10340428	43579
chr5	10296849	10496849	harbor1	chr5	10341891	10342079	DNA/TcMar-Tigger	1427	-	94	10341985	45136
chr5	10296849	10496849	harbor1	chr5	10342367	10342500	DNA/TcMar-Tigger	1427	-	66	10342433	45584
chr5	10296849	10496849	harbor1	chr5	10359494	10359667	DNA/TcMar-Tigger	771	-	86	10359580	62731
chr5	10661256	10861256	harbor1	chr5	10704114	10704349	DNA/TcMar-Tigger	956	-	118	10704232	42976
chr5	10661256	10861256	harbor1	chr5	10727744	10728103	DNA/TcMar-Tigger	2096	-	180	10727924	66668
chr5	139560781	139760781	harbor1	chr5	139565450	139565664	DNA/TcMar-Tigger	673	-	107	139565557	4776
chr5	139560781	139760781	harbor1	chr5	139581464	139581657	DNA/TcMar-Tigger	1175	-	96	139581560	20779
chr5	139560781	139760781	harbor1	chr5	139582511	139582662	DNA/TcMar-Tigger	783	-	76	139582587	21806
chr5	139560781	139760781	harbor1	chr5	139594801	139595108	DNA/TcMar-Tigger	1832	-	154	139594955	34174
chr5	40697590	40897590	harbor1	chr5	40749630	40749808	DNA/TcMar-Tigger	15090	-	89	40749719	52129
chr5	40697590	40897590	harbor1	chr5	40750104	40750287	DNA/TcMar-Tigger	15090	-	92	40750196	52606
chr5	40697590	40897590	harbor1	chr5	40750577	40751676	DNA/TcMar-Tigger	15090	-	550	40751127	53537
chr5	40697590	40897590	harbor1	chr5	40751984	40752902	DNA/TcMar-Tigger	15090	-	459	40752443	54853
chr5	139559543	139759543	harbor1	chr5	139565450	139565664	DNA/TcMar-Tigger	673	-	107	139565557	6014
chr5	139559543	139759543	harbor1	chr5	139581464	139581657	DNA/TcMar-Tigger	1175	-	96	139581560	22017
chr5	139559543	139759543	harbor1	chr5	139582511	139582662	DNA/TcMar-Tigger	783	-	76	139582587	23044
chr5	139559543	139759543	harbor1	chr5	139594801	139595108	DNA/TcMar-Tigger	1832	-	154	139594955	35412
chr5	10661135	10861135	harbor1	chr5	10704114	10704349	DNA/TcMar-Tigger	956	-	118	10704232	43097
chr5	10661135	10861135	harbor1	chr5	10727744	10728103	DNA/TcMar-Tigger	2096	-	180	10727924	66789
chr5	10184404	10384404	harbor1	chr5	10241737	10243203	DNA/TcMar-Tigger	15381	-	733	10242470	58066
chr5	10184404	10384404	harbor1	chr5	10243499	10244415	DNA/TcMar-Tigger	15381	-	458	10243957	59553
chr5	10184404	10384404	harbor1	chr5	10244546	10244586	DNA/TcMar-Tigger	15381	-	20	10244566	60162
chr5	10184404	10384404	harbor1	chr5	10266609	10266884	DNA/TcMar-Tigger	1334	-	138	10266747	82343
chr5	135008188	135208188	harbor1	chr5	135098498	135098937	DNA/TcMar-Tigger	2948	-	220	135098718	90530
chr5	135008188	135208188	harbor1	chr5	135099218	135099327	DNA/TcMar-Tigger	2948	-	54	135099272	91084
chr5	169913062	170113062	harbor1	chr5	169938286	169938892	DNA/TcMar-Tigger	6391	-	303	169938589	25527
chr5	169913062	170113062	harbor1	chr5	169939204	169939681	DNA/TcMar-Tigger	6391	-	238	169939442	26380
chr5	109788598	109988598	harbor1	chr5	109802325	109802471	DNA/TcMar-Tigger	438	-	73	109802398	13800
chr5	109788598	109988598	harbor1	chr5	109818892	109818989	DNA/TcMar-Tigger	1362	-	48	109818940	30342
chr5	109788598	109988598	harbor1	chr5	109819344	109819555	DNA/TcMar-Tigger	1362	-	106	109819450	30852
chr5	109788598	109988598	harbor1	chr5	109824897	109825211	DNA/TcMar-Tigger	681	-	157	109825054	36456
chr5	134969039	135169039	harbor1	chr5	134988009	134990118	DNA/TcMar-Tigger	14795	-	1054	134989063	20024
chr5	134969039	135169039	harbor1	chr5	134990563	134990806	DNA/TcMar-Tigger	14795	-	122	134990685	21646
chr5	9749157	9949157	harbor1	chr5	9776802	9777877	DNA/TcMar-Tigger	15500	-	538	9777340	28183
chr5	9749157	9949157	harbor1	chr5	9778179	9778997	DNA/TcMar-Tigger	15500	-	409	9778588	29431
chr5	9749157	9949157	harbor1	chr5	9779418	9779916	DNA/TcMar-Tigger	15500	-	249	9779667	30510
chr5	10341913	10541913	harbor1	chr5	10341891	10342079	DNA/TcMar-Tigger	1427	-	94	10341985	72
chr5	10341913	10541913	harbor1	chr5	10342367	10342500	DNA/TcMar-Tigger	1427	-	66	10342433	520
chr5	10341913	10541913	harbor1	chr5	10359494	10359667	DNA/TcMar-Tigger	771	-	86	10359580	17667
chr5	10661236	10861236	harbor1	chr5	10704114	10704349	DNA/TcMar-Tigger	956	-	118	10704232	42996
chr5	10661236	10861236	harbor1	chr5	10727744	10728103	DNA/TcMar-Tigger	2096	-	180	10727924	66688
chr5	176525237	176725237	harbor1	chr5	176547912	176548246	DNA/TcMar-Tigger	1598	-	167	176548079	22842
chr5	176525237	176725237	harbor1	chr5	176574527	176574871	DNA/TcMar-Tigger	1856	-	172	176574699	49462
chr5	135008281	135208281	harbor1	chr5	135098498	135098937	DNA/TcMar-Tigger	2948	-	220	135098718	90437
chr5	135008281	135208281	harbor1	chr5	135099218	135099327	DNA/TcMar-Tigger	2948	-	54	135099272	90991
chr5	135830655	136030655	harbor1	chr5	135852956	135855333	DNA/TcMar-Tigger	15714	-	1188	135854144	23489
chr5	135830655	136030655	harbor1	chr5	135922103	135924449	DNA/TcMar-Tigger	14342	-	1173	135923276	92621
chr5	10341778	10541778	harbor1	chr5	10341891	10342079	DNA/TcMar-Tigger	1427	-	94	10341985	207
chr5	10341778	10541778	harbor1	chr5	10342367	10342500	DNA/TcMar-Tigger	1427	-	66	10342433	655
chr5	10341778	10541778	harbor1	chr5	10359494	10359667	DNA/TcMar-Tigger	771	-	86	10359580	17802
chr5	71628508	71828508	harbor1	chr5	71637283	71637724	DNA/TcMar-Tigger	10755	-	220	71637503	8995
chr5	71628508	71828508	harbor1	chr5	71638012	71638525	DNA/TcMar-Tigger	10755	-	256	71638268	9760
chr5	71628508	71828508	harbor1	chr5	71638821	71639605	DNA/TcMar-Tigger	10755	-	392	71639213	10705
chr5	135297931	135497931	harbor1	chr5	135312410	135312729	DNA/TcMar-Tigger	1837	-	160	135312570	14639
chr5	372623	572623	harbor1	chr5	456101	456406	DNA/TcMar-Tigger	1088	-	152	456253	83630
chr5	10661301	10861301	harbor1	chr5	10704114	10704349	DNA/TcMar-Tigger	956	-	118	10704232	42931
chr5	10661301	10861301	harbor1	chr5	10727744	10728103	DNA/TcMar-Tigger	2096	-	180	10727924	66623
chr5	175976844	176176844	harbor1	chr5	176064191	176064618	DNA/TcMar-Tigger	2310	-	214	176064405	87561
chr5	175976844	176176844	harbor1	chr5	176068675	176068923	DNA/TcMar-Tigger	1288	-	124	176068799	91955
chr5	175976844	176176844	harbor1	chr5	176069210	176069554	DNA/TcMar-Tigger	1288	-	172	176069382	92538
chr5	9111212	9311212	harbor1	chr5	9117371	9117727	DNA/TcMar-Tigger	1835	-	178	9117549	6337
chr5	73177858	73377858	harbor1	chr5	73178109	73178283	DNA/TcMar-Tigger	1426	-	87	73178196	338
chr5	141125589	141325589	harbor1	chr5	141165529	141165916	DNA/TcMar-Tigger	1514	-	194	141165723	40134
chr5	421781	621781	harbor1	chr5	456101	456406	DNA/TcMar-Tigger	1088	-	152	456253	34472
chr5	10341929	10541929	harbor1	chr5	10341891	10342079	DNA/TcMar-Tigger	1427	-	94	10341985	56
chr5	10341929	10541929	harbor1	chr5	10342367	10342500	DNA/TcMar-Tigger	1427	-	66	10342433	504
chr5	10341929	10541929	harbor1	chr5	10359494	10359667	DNA/TcMar-Tigger	771	-	86	10359580	17651
chr5	4034239	4234239	harbor1	chr5	4078743	4079087	DNA/TcMar-Tigger	2000	-	172	4078915	44676
chr5	4034239	4234239	harbor1	chr5	4115106	4115564	DNA/TcMar-Tigger	1202	-	229	4115335	81096
chr5	10660380	10860380	harbor1	chr5	10704114	10704349	DNA/TcMar-Tigger	956	-	118	10704232	43852
chr5	10660380	10860380	harbor1	chr5	10727744	10728103	DNA/TcMar-Tigger	2096	-	180	10727924	67544
chr5	9114356	9314356	harbor1	chr5	9117371	9117727	DNA/TcMar-Tigger	1835	-	178	9117549	3193
chr5	9114296	9314296	harbor1	chr5	9117371	9117727	DNA/TcMar-Tigger	1835	-	178	9117549	3253
chr5	135980228	136180228	harbor1	chr5	136044782	136045088	DNA/TcMar-Tigger	1269	-	153	136044935	64707
chr5	10661235	10861235	harbor1	chr5	10704114	10704349	DNA/TcMar-Tigger	956	-	118	10704232	42997
chr5	10661235	10861235	harbor1	chr5	10727744	10728103	DNA/TcMar-Tigger	2096	-	180	10727924	66689
chr5	9114331	9314331	harbor1	chr5	9117371	9117727	DNA/TcMar-Tigger	1835	-	178	9117549	3218
chr5	9114252	9314252	harbor1	chr5	9117371	9117727	DNA/TcMar-Tigger	1835	-	178	9117549	3297
chr5	9114320	9314320	harbor1	chr5	9117371	9117727	DNA/TcMar-Tigger	1835	-	178	9117549	3229
chr5	93472721	93672721	harbor1	chr5	93557378	93558315	DNA/TcMar-Tigger	14686	-	468	93557846	85125
chr5	93472721	93672721	harbor1	chr5	93558611	93560054	DNA/TcMar-Tigger	14686	-	722	93559333	86612
chr5	9057233	9257233	harbor1	chr5	9117371	9117727	DNA/TcMar-Tigger	1835	-	178	9117549	60316
chr5	9114329	9314329	harbor1	chr5	9117371	9117727	DNA/TcMar-Tigger	1835	-	178	9117549	3220
chr5	10311688	10511688	harbor1	chr5	10340369	10340487	DNA/TcMar-Tigger	466	-	59	10340428	28740
chr5	10311688	10511688	harbor1	chr5	10341891	10342079	DNA/TcMar-Tigger	1427	-	94	10341985	30297
chr5	10311688	10511688	harbor1	chr5	10342367	10342500	DNA/TcMar-Tigger	1427	-	66	10342433	30745
chr5	10311688	10511688	harbor1	chr5	10359494	10359667	DNA/TcMar-Tigger	771	-	86	10359580	47892
chr5	74950541	75150541	harbor1	chr5	74997961	74998187	DNA/TcMar-Tigger	1106	-	113	74998074	47533
chr5	74950541	75150541	harbor1	chr5	75035983	75036224	DNA/TcMar-Tigger	1164	-	120	75036103	85562
chr5	143206591	143406591	harbor1	chr5	143262371	143262455	DNA/TcMar-Tigger	555	-	42	143262413	55822
chr5	143206591	143406591	harbor1	chr5	143262452	143262703	DNA/TcMar-Tigger	1352	-	126	143262578	55987
chr5	73114177	73314177	harbor1	chr5	73150361	73150499	DNA/TcMar-Tigger	515	-	69	73150430	36253
chr5	73114177	73314177	harbor1	chr5	73178109	73178283	DNA/TcMar-Tigger	1426	-	87	73178196	64019
chr5	10661175	10861175	harbor1	chr5	10704114	10704349	DNA/TcMar-Tigger	956	-	118	10704232	43057
chr5	10661175	10861175	harbor1	chr5	10727744	10728103	DNA/TcMar-Tigger	2096	-	180	10727924	66749
chr5	93221055	93421055	harbor1	chr5	93236962	93237457	DNA/TcMar-Tigger	2679	-	248	93237210	16155
chr5	93221055	93421055	harbor1	chr5	93313419	93313654	DNA/TcMar-Tigger	1319	-	118	93313537	92482
chr5	93221055	93421055	harbor1	chr5	93306585	93306916	DNA/TcMar-Tigger	1791	-	166	93306751	85696
chr5	10660536	10860536	harbor1	chr5	10704114	10704349	DNA/TcMar-Tigger	956	-	118	10704232	43696
chr5	10660536	10860536	harbor1	chr5	10727744	10728103	DNA/TcMar-Tigger	2096	-	180	10727924	67388
chr5	10024023	10224023	harbor1	chr5	10042770	10042933	DNA/TcMar-Tigger	1321	-	82	10042852	18829
chr5	10024023	10224023	harbor1	chr5	10043304	10043351	DNA/TcMar-Tigger	1321	-	24	10043328	19305
chr5	170538258	170738258	harbor1	chr5	170542566	170542911	DNA/TcMar-Tigger	2123	-	172	170542738	4480
chr5	170538258	170738258	harbor1	chr5	170543266	170544096	DNA/TcMar-Tigger	1786	-	415	170543681	5423
chr5	170538258	170738258	harbor1	chr5	170561838	170561942	DNA/TcMar-Tigger	412	-	52	170561890	23632
chr5	170538258	170738258	harbor1	chr5	170561978	170562074	DNA/TcMar-Tigger	611	-	48	170562026	23768
chr5	170538258	170738258	harbor1	chr5	170574147	170574985	DNA/TcMar-Tigger	4762	-	419	170574566	36308
chr5	2003356	2203356	harbor1	chr5	2043660	2044182	DNA/TcMar-Tigger	960	-	261	2043921	40565
chr5	64935093	65135093	harbor1	chr5	64946354	64946491	DNA/TcMar-Tigger	417	-	68	64946422	11329
chr5	64935093	65135093	harbor1	chr5	64951998	64952331	DNA/TcMar-Tigger	2050	-	166	64952164	17071
chr5	10661147	10861147	harbor1	chr5	10704114	10704349	DNA/TcMar-Tigger	956	-	118	10704232	43085
chr5	10661147	10861147	harbor1	chr5	10727744	10728103	DNA/TcMar-Tigger	2096	-	180	10727924	66777
chr5	135919218	136119218	harbor1	chr5	135922103	135924449	DNA/TcMar-Tigger	14342	-	1173	135923276	4058
chr5	135919218	136119218	harbor1	chr5	135969983	135970263	DNA/TcMar-Tigger	817	-	140	135970123	50905
chr5	10341894	10541894	harbor1	chr5	10341891	10342079	DNA/TcMar-Tigger	1427	-	94	10341985	91
chr5	10341894	10541894	harbor1	chr5	10342367	10342500	DNA/TcMar-Tigger	1427	-	66	10342433	539
chr5	10341894	10541894	harbor1	chr5	10359494	10359667	DNA/TcMar-Tigger	771	-	86	10359580	17686
chr5	10231669	10431669	harbor1	chr5	10241737	10243203	DNA/TcMar-Tigger	15381	-	733	10242470	10801
chr5	10231669	10431669	harbor1	chr5	10243499	10244415	DNA/TcMar-Tigger	15381	-	458	10243957	12288
chr5	10231669	10431669	harbor1	chr5	10244546	10244586	DNA/TcMar-Tigger	15381	-	20	10244566	12897
chr5	10231669	10431669	harbor1	chr5	10266609	10266884	DNA/TcMar-Tigger	1334	-	138	10266747	35078
chr5	93490732	93690732	harbor1	chr5	93557378	93558315	DNA/TcMar-Tigger	14686	-	468	93557846	67114
chr5	93490732	93690732	harbor1	chr5	93558611	93560054	DNA/TcMar-Tigger	14686	-	722	93559333	68601
chr5	10150998	10350998	harbor1	chr5	10241737	10243203	DNA/TcMar-Tigger	15381	-	733	10242470	91472
chr5	10150998	10350998	harbor1	chr5	10243499	10244415	DNA/TcMar-Tigger	15381	-	458	10243957	92959
chr5	10150998	10350998	harbor1	chr5	10244546	10244586	DNA/TcMar-Tigger	15381	-	20	10244566	93568
chr5	71628507	71828507	harbor1	chr5	71637283	71637724	DNA/TcMar-Tigger	10755	-	220	71637503	8996
chr5	71628507	71828507	harbor1	chr5	71638012	71638525	DNA/TcMar-Tigger	10755	-	256	71638268	9761
chr5	71628507	71828507	harbor1	chr5	71638821	71639605	DNA/TcMar-Tigger	10755	-	392	71639213	10706
chr5	78709775	78909775	harbor1	chr5	78764820	78765546	DNA/TcMar-Tigger	2110	-	363	78765183	55408
chr5	139559517	139759517	harbor1	chr5	139565450	139565664	DNA/TcMar-Tigger	673	-	107	139565557	6040
chr5	139559517	139759517	harbor1	chr5	139581464	139581657	DNA/TcMar-Tigger	1175	-	96	139581560	22043
chr5	139559517	139759517	harbor1	chr5	139582511	139582662	DNA/TcMar-Tigger	783	-	76	139582587	23070
chr5	139559517	139759517	harbor1	chr5	139594801	139595108	DNA/TcMar-Tigger	1832	-	154	139594955	35438
chr5	78410099	78610099	harbor1	chr5	78468899	78469112	DNA/TcMar-Tigger	1040	-	106	78469005	58906
chr5	10661144	10861144	harbor1	chr5	10704114	10704349	DNA/TcMar-Tigger	956	-	118	10704232	43088
chr5	10661144	10861144	harbor1	chr5	10727744	10728103	DNA/TcMar-Tigger	2096	-	180	10727924	66780
chr5	10661231	10861231	harbor1	chr5	10704114	10704349	DNA/TcMar-Tigger	956	-	118	10704232	43001
chr5	10661231	10861231	harbor1	chr5	10727744	10728103	DNA/TcMar-Tigger	2096	-	180	10727924	66693
chr5	10339015	10539015	harbor1	chr5	10340369	10340487	DNA/TcMar-Tigger	466	-	59	10340428	1413
chr5	10339015	10539015	harbor1	chr5	10341891	10342079	DNA/TcMar-Tigger	1427	-	94	10341985	2970
chr5	10339015	10539015	harbor1	chr5	10342367	10342500	DNA/TcMar-Tigger	1427	-	66	10342433	3418
chr5	10339015	10539015	harbor1	chr5	10359494	10359667	DNA/TcMar-Tigger	771	-	86	10359580	20565
chr5	137653913	137853913	harbor1	chr5	137663024	137663056	DNA/TcMar-Tigger	1423	-	16	137663040	9127
chr5	137653913	137853913	harbor1	chr5	137663357	137663739	DNA/TcMar-Tigger	1423	-	191	137663548	9635
chr5	78410150	78610150	harbor1	chr5	78468899	78469112	DNA/TcMar-Tigger	1040	-	106	78469005	58855
chr6	139275451	139475451	harbor1	chr6	139353526	139353979	DNA/TcMar-Tigger	612	-	226	139353752	78301
chr6	139275552	139475552	harbor1	chr6	139353526	139353979	DNA/TcMar-Tigger	612	-	226	139353752	78200
chr6	37070857	37270857	harbor1	chr6	37071868	37072177	DNA/TcMar-Tigger	894	-	154	37072022	1165
chr6	37070857	37270857	harbor1	chr6	37096894	37097111	DNA/TcMar-Tigger	857	-	108	37097002	26145
chr6	37070857	37270857	harbor1	chr6	37097387	37097468	DNA/TcMar-Tigger	857	-	40	37097427	26570
chr6	139268099	139468099	harbor1	chr6	139353526	139353979	DNA/TcMar-Tigger	612	-	226	139353752	85653
chr6	127167311	127367311	harbor1	chr6	127246455	127246781	DNA/TcMar-Tigger	1778	-	163	127246618	79307
chr6	89719728	89919728	harbor1	chr6	89778504	89778599	DNA/TcMar-Tigger	623	-	48	89778552	58824
chr6	37002869	37202869	harbor1	chr6	37036082	37036237	DNA/TcMar-Tigger	842	-	78	37036160	33291
chr6	37002869	37202869	harbor1	chr6	37036555	37036598	DNA/TcMar-Tigger	842	-	22	37036577	33708
chr6	37002869	37202869	harbor1	chr6	37037363	37037473	DNA/TcMar-Tigger	563	-	55	37037418	34549
chr6	37002869	37202869	harbor1	chr6	37071868	37072177	DNA/TcMar-Tigger	894	-	154	37072022	69153
chr6	37002869	37202869	harbor1	chr6	37096894	37097111	DNA/TcMar-Tigger	857	-	108	37097002	94133
chr6	37002869	37202869	harbor1	chr6	37097387	37097468	DNA/TcMar-Tigger	857	-	40	37097427	94558
chr6	37070851	37270851	harbor1	chr6	37071868	37072177	DNA/TcMar-Tigger	894	-	154	37072022	1171
chr6	37070851	37270851	harbor1	chr6	37096894	37097111	DNA/TcMar-Tigger	857	-	108	37097002	26151
chr6	37070851	37270851	harbor1	chr6	37097387	37097468	DNA/TcMar-Tigger	857	-	40	37097427	26576
chr6	37070872	37270872	harbor1	chr6	37071868	37072177	DNA/TcMar-Tigger	894	-	154	37072022	1150
chr6	37070872	37270872	harbor1	chr6	37096894	37097111	DNA/TcMar-Tigger	857	-	108	37097002	26130
chr6	37070872	37270872	harbor1	chr6	37097387	37097468	DNA/TcMar-Tigger	857	-	40	37097427	26555
chr6	139275170	139475170	harbor1	chr6	139353526	139353979	DNA/TcMar-Tigger	612	-	226	139353752	78582
chr6	124862435	125062435	harbor1	chr6	124929938	124930527	DNA/TcMar-Tigger	3597	-	294	124930232	67797
chr6	124862435	125062435	harbor1	chr6	124930947	124931527	DNA/TcMar-Tigger	3753	-	290	124931237	68802
chr6	11481954	11681954	harbor1	chr6	11539855	11542193	DNA/TcMar-Tigger	14182	-	1169	11541024	59070
chr6	11481954	11681954	harbor1	chr6	11545340	11545424	DNA/TcMar-Tigger	1574	-	42	11545382	63428
chr6	11481954	11681954	harbor1	chr6	11546879	11547102	DNA/TcMar-Tigger	1574	-	112	11546991	65037
chr6	11481954	11681954	harbor1	chr6	11553100	11553308	DNA/TcMar-Tigger	956	-	104	11553204	71250
chr6	37070827	37270827	harbor1	chr6	37071868	37072177	DNA/TcMar-Tigger	894	-	154	37072022	1195
chr6	37070827	37270827	harbor1	chr6	37096894	37097111	DNA/TcMar-Tigger	857	-	108	37097002	26175
chr6	37070827	37270827	harbor1	chr6	37097387	37097468	DNA/TcMar-Tigger	857	-	40	37097427	26600
chr6	7626957	7826957	harbor1	chr6	7637825	7638151	DNA/TcMar-Tigger	1572	-	163	7637988	11031
chr6	7626957	7826957	harbor1	chr6	7652325	7652525	DNA/TcMar-Tigger	633	-	100	7652425	25468
chr6	7626957	7826957	harbor1	chr6	7666449	7666767	DNA/TcMar-Tigger	2001	-	159	7666608	39651
chr6	7626957	7826957	harbor1	chr6	7723973	7724326	DNA/TcMar-Tigger	2358	-	176	7724149	97192
chr6	105894234	106094234	harbor1	chr6	105920901	105921229	DNA/TcMar-Tigger	1019	-	164	105921065	26831
chr6	105894234	106094234	harbor1	chr6	105921308	105922039	DNA/TcMar-Tigger	3945	-	366	105921674	27440
chr6	105894234	106094234	harbor1	chr6	105937604	105937794	DNA/TcMar-Tigger	940	-	95	105937699	43465
chr6	36992832	37192832	harbor1	chr6	37036082	37036237	DNA/TcMar-Tigger	842	-	78	37036160	43328
chr6	36992832	37192832	harbor1	chr6	37036555	37036598	DNA/TcMar-Tigger	842	-	22	37036577	43745
chr6	36992832	37192832	harbor1	chr6	37037363	37037473	DNA/TcMar-Tigger	563	-	55	37037418	44586
chr6	36992832	37192832	harbor1	chr6	37071868	37072177	DNA/TcMar-Tigger	894	-	154	37072022	79190
chr6	107387585	107587585	harbor1	chr6	107437556	107437795	DNA/TcMar-Tigger	1005	-	120	107437676	50091
chr6	107387585	107587585	harbor1	chr6	107445360	107445656	DNA/TcMar-Tigger	1218	-	148	107445508	57923
chr6	138673799	138873799	harbor1	chr6	138721019	138721358	DNA/TcMar-Tigger	1753	-	170	138721189	47390
chr6	35352746	35552746	harbor1	chr6	35447680	35447749	DNA/TcMar-Tigger	2004	-	34	35447714	94968
chr6	35352746	35552746	harbor1	chr6	35448041	35448393	DNA/TcMar-Tigger	2004	-	176	35448217	95471
chr6	99421500	99621500	harbor1	chr6	99509848	99510069	DNA/TcMar-Tigger	1012	-	110	99509958	88458
chr6	107722375	107922375	harbor1	chr6	107723165	107723528	DNA/TcMar-Tigger	2198	-	182	107723347	972
chr6	139274146	139474146	harbor1	chr6	139353526	139353979	DNA/TcMar-Tigger	612	-	226	139353752	79606
chr6	36493941	36693941	harbor1	chr6	36589686	36589861	DNA/TcMar-Tigger	1057	-	88	36589774	95833
chr6	77363005	77563005	harbor1	chr6	77393029	77393680	DNA/TcMar-Tigger	3229	-	326	77393355	30350
chr6	77363005	77563005	harbor1	chr6	77413898	77416021	DNA/TcMar-Tigger	12796	-	1062	77414960	51955
chr6	37002597	37202597	harbor1	chr6	37036082	37036237	DNA/TcMar-Tigger	842	-	78	37036160	33563
chr6	37002597	37202597	harbor1	chr6	37036555	37036598	DNA/TcMar-Tigger	842	-	22	37036577	33980
chr6	37002597	37202597	harbor1	chr6	37037363	37037473	DNA/TcMar-Tigger	563	-	55	37037418	34821
chr6	37002597	37202597	harbor1	chr6	37071868	37072177	DNA/TcMar-Tigger	894	-	154	37072022	69425
chr6	37002597	37202597	harbor1	chr6	37096894	37097111	DNA/TcMar-Tigger	857	-	108	37097002	94405
chr6	37002597	37202597	harbor1	chr6	37097387	37097468	DNA/TcMar-Tigger	857	-	40	37097427	94830
chr6	139274683	139474683	harbor1	chr6	139353526	139353979	DNA/TcMar-Tigger	612	-	226	139353752	79069
chr6	169864005	170064005	harbor1	chr6	169886477	169886709	DNA/TcMar-Tigger	492	-	116	169886593	22588
chr6	169864005	170064005	harbor1	chr6	169922950	169923523	DNA/TcMar-Tigger	743	-	286	169923236	59231
chr6	30784323	30984323	harbor1	chr6	30793827	30794180	DNA/TcMar-Tigger	966	-	176	30794003	9680
chr6	30784323	30984323	harbor1	chr6	30794479	30794738	DNA/TcMar-Tigger	966	-	130	30794609	10286
chr6	30784323	30984323	harbor1	chr6	30866149	30866948	DNA/TcMar-Tigger	5010	-	400	30866549	82226
chr6	30784323	30984323	harbor1	chr6	30867418	30868170	DNA/TcMar-Tigger	5130	-	376	30867794	83471
chr6	37070831	37270831	harbor1	chr6	37071868	37072177	DNA/TcMar-Tigger	894	-	154	37072022	1191
chr6	37070831	37270831	harbor1	chr6	37096894	37097111	DNA/TcMar-Tigger	857	-	108	37097002	26171
chr6	37070831	37270831	harbor1	chr6	37097387	37097468	DNA/TcMar-Tigger	857	-	40	37097427	26596
chr6	100355730	100555730	harbor1	chr6	100388179	100388418	DNA/TcMar-Tigger	1081	-	120	100388299	32569
chr6	100355730	100555730	harbor1	chr6	100404381	100404747	DNA/TcMar-Tigger	1142	-	183	100404564	48834
chr6	100355730	100555730	harbor1	chr6	100428656	100429016	DNA/TcMar-Tigger	1392	-	180	100428836	73106
chr6	37070836	37270836	harbor1	chr6	37071868	37072177	DNA/TcMar-Tigger	894	-	154	37072022	1186
chr6	37070836	37270836	harbor1	chr6	37096894	37097111	DNA/TcMar-Tigger	857	-	108	37097002	26166
chr6	37070836	37270836	harbor1	chr6	37097387	37097468	DNA/TcMar-Tigger	857	-	40	37097427	26591
chr6	167862748	168062748	harbor1	chr6	167883504	167885833	DNA/TcMar-Tigger	13660	-	1164	167884668	21920
chr6	167862748	168062748	harbor1	chr6	167902469	167902801	DNA/TcMar-Tigger	1729	-	166	167902635	39887
chr6	167862748	168062748	harbor1	chr6	167944570	167945723	DNA/TcMar-Tigger	5463	-	576	167945146	82398
chr6	10421300	10621300	harbor1	chr6	10442490	10442705	DNA/TcMar-Tigger	1614	-	108	10442598	21298
chr6	10421300	10621300	harbor1	chr6	10442822	10442981	DNA/TcMar-Tigger	1614	-	80	10442902	21602
chr6	10421300	10621300	harbor1	chr6	10509374	10509732	DNA/TcMar-Tigger	2375	-	179	10509553	88253
chr6	139275445	139475445	harbor1	chr6	139353526	139353979	DNA/TcMar-Tigger	612	-	226	139353752	78307
chr6	7626988	7826988	harbor1	chr6	7637825	7638151	DNA/TcMar-Tigger	1572	-	163	7637988	11000
chr6	7626988	7826988	harbor1	chr6	7652325	7652525	DNA/TcMar-Tigger	633	-	100	7652425	25437
chr6	7626988	7826988	harbor1	chr6	7666449	7666767	DNA/TcMar-Tigger	2001	-	159	7666608	39620
chr6	7626988	7826988	harbor1	chr6	7723973	7724326	DNA/TcMar-Tigger	2358	-	176	7724149	97161
chr6	37070816	37270816	harbor1	chr6	37071868	37072177	DNA/TcMar-Tigger	894	-	154	37072022	1206
chr6	37070816	37270816	harbor1	chr6	37096894	37097111	DNA/TcMar-Tigger	857	-	108	37097002	26186
chr6	37070816	37270816	harbor1	chr6	37097387	37097468	DNA/TcMar-Tigger	857	-	40	37097427	26611
chr6	167862786	168062786	harbor1	chr6	167883504	167885833	DNA/TcMar-Tigger	13660	-	1164	167884668	21882
chr6	167862786	168062786	harbor1	chr6	167902469	167902801	DNA/TcMar-Tigger	1729	-	166	167902635	39849
chr6	167862786	168062786	harbor1	chr6	167944570	167945723	DNA/TcMar-Tigger	5463	-	576	167945146	82360
chr6	30366671	30566671	harbor1	chr6	30399537	30400633	DNA/TcMar-Tigger	6738	-	548	30400085	33414
chr6	30366671	30566671	harbor1	chr6	30401522	30401888	DNA/TcMar-Tigger	1521	-	183	30401705	35034
chr6	139274657	139474657	harbor1	chr6	139353526	139353979	DNA/TcMar-Tigger	612	-	226	139353752	79095
chr6	37070849	37270849	harbor1	chr6	37071868	37072177	DNA/TcMar-Tigger	894	-	154	37072022	1173
chr6	37070849	37270849	harbor1	chr6	37096894	37097111	DNA/TcMar-Tigger	857	-	108	37097002	26153
chr6	37070849	37270849	harbor1	chr6	37097387	37097468	DNA/TcMar-Tigger	857	-	40	37097427	26578
chr6	81650363	81850363	harbor1	chr6	81671336	81671513	DNA/TcMar-Tigger	1032	-	88	81671424	21061
chr6	81650363	81850363	harbor1	chr6	81675269	81675365	DNA/TcMar-Tigger	480	-	48	81675317	24954
chr6	81650363	81850363	harbor1	chr6	81675363	81675631	DNA/TcMar-Tigger	1309	-	134	81675497	25134
chr6	147104160	147304160	harbor1	chr6	147121886	147122227	DNA/TcMar-Tigger	716	-	170	147122056	17896
chr6	37070846	37270846	harbor1	chr6	37071868	37072177	DNA/TcMar-Tigger	894	-	154	37072022	1176
chr6	37070846	37270846	harbor1	chr6	37096894	37097111	DNA/TcMar-Tigger	857	-	108	37097002	26156
chr6	37070846	37270846	harbor1	chr6	37097387	37097468	DNA/TcMar-Tigger	857	-	40	37097427	26581
chr6	37070848	37270848	harbor1	chr6	37071868	37072177	DNA/TcMar-Tigger	894	-	154	37072022	1174
chr6	37070848	37270848	harbor1	chr6	37096894	37097111	DNA/TcMar-Tigger	857	-	108	37097002	26154
chr6	37070848	37270848	harbor1	chr6	37097387	37097468	DNA/TcMar-Tigger	857	-	40	37097427	26579
chr6	37070843	37270843	harbor1	chr6	37071868	37072177	DNA/TcMar-Tigger	894	-	154	37072022	1179
chr6	37070843	37270843	harbor1	chr6	37096894	37097111	DNA/TcMar-Tigger	857	-	108	37097002	26159
chr6	37070843	37270843	harbor1	chr6	37097387	37097468	DNA/TcMar-Tigger	857	-	40	37097427	26584
chr6	52184786	52384786	harbor1	chr6	52239839	52240154	DNA/TcMar-Tigger	503	-	158	52239997	55211
chr6	52184786	52384786	harbor1	chr6	52240459	52240727	DNA/TcMar-Tigger	503	-	134	52240593	55807
chr6	52184744	52384744	harbor1	chr6	52239839	52240154	DNA/TcMar-Tigger	503	-	158	52239997	55253
chr6	52184744	52384744	harbor1	chr6	52240459	52240727	DNA/TcMar-Tigger	503	-	134	52240593	55849
chr6	169864011	170064011	harbor1	chr6	169886477	169886709	DNA/TcMar-Tigger	492	-	116	169886593	22582
chr6	169864011	170064011	harbor1	chr6	169922950	169923523	DNA/TcMar-Tigger	743	-	286	169923236	59225
chr6	149351029	149551029	harbor1	chr6	149358129	149358455	DNA/TcMar-Tigger	1440	-	163	149358292	7263
chr6	149351029	149551029	harbor1	chr6	149422412	149422506	DNA/TcMar-Tigger	1267	-	47	149422459	71430
chr6	149351029	149551029	harbor1	chr6	149421892	149422103	DNA/TcMar-Tigger	1267	-	106	149421998	70969
chr6	10422562	10622562	harbor1	chr6	10442490	10442705	DNA/TcMar-Tigger	1614	-	108	10442598	20036
chr6	10422562	10622562	harbor1	chr6	10442822	10442981	DNA/TcMar-Tigger	1614	-	80	10442902	20340
chr6	10422562	10622562	harbor1	chr6	10509374	10509732	DNA/TcMar-Tigger	2375	-	179	10509553	86991
chr6	42878982	43078982	harbor1	chr6	42881087	42881183	DNA/TcMar-Tigger	653	-	48	42881135	2153
chr6	42878982	43078982	harbor1	chr6	42881487	42881560	DNA/TcMar-Tigger	653	-	36	42881523	2541
chr6	42878982	43078982	harbor1	chr6	42945372	42945560	DNA/TcMar-Tigger	864	-	94	42945466	66484
chr6	147104106	147304106	harbor1	chr6	147121886	147122227	DNA/TcMar-Tigger	716	-	170	147122056	17950
chr6	7626967	7826967	harbor1	chr6	7637825	7638151	DNA/TcMar-Tigger	1572	-	163	7637988	11021
chr6	7626967	7826967	harbor1	chr6	7652325	7652525	DNA/TcMar-Tigger	633	-	100	7652425	25458
chr6	7626967	7826967	harbor1	chr6	7666449	7666767	DNA/TcMar-Tigger	2001	-	159	7666608	39641
chr6	7626967	7826967	harbor1	chr6	7723973	7724326	DNA/TcMar-Tigger	2358	-	176	7724149	97182
chr6	104840667	105040667	harbor1	chr6	104853794	104854092	DNA/TcMar-Tigger	1634	-	149	104853943	13276
chr6	52476539	52676539	harbor1	chr6	52479987	52480400	DNA/TcMar-Tigger	2352	-	206	52480193	3654
chr6	52476539	52676539	harbor1	chr6	52481965	52482061	DNA/TcMar-Tigger	4637	-	48	52482013	5474
chr6	52476539	52676539	harbor1	chr6	52482357	52483305	DNA/TcMar-Tigger	4637	-	474	52482831	6292
chr6	52476539	52676539	harbor1	chr6	52538813	52539450	DNA/TcMar-Tigger	3687	-	318	52539131	62592
chr6	139274673	139474673	harbor1	chr6	139353526	139353979	DNA/TcMar-Tigger	612	-	226	139353752	79079
chr6	30366631	30566631	harbor1	chr6	30399537	30400633	DNA/TcMar-Tigger	6738	-	548	30400085	33454
chr6	30366631	30566631	harbor1	chr6	30401522	30401888	DNA/TcMar-Tigger	1521	-	183	30401705	35074
chr6	127167329	127367329	harbor1	chr6	127246455	127246781	DNA/TcMar-Tigger	1778	-	163	127246618	79289
chr6	52184830	52384830	harbor1	chr6	52239839	52240154	DNA/TcMar-Tigger	503	-	158	52239997	55167
chr6	52184830	52384830	harbor1	chr6	52240459	52240727	DNA/TcMar-Tigger	503	-	134	52240593	55763
chr6	139274467	139474467	harbor1	chr6	139353526	139353979	DNA/TcMar-Tigger	612	-	226	139353752	79285
chr6	127167314	127367314	harbor1	chr6	127246455	127246781	DNA/TcMar-Tigger	1778	-	163	127246618	79304
chr6	33522121	33722121	harbor1	chr6	33539971	33540388	DNA/TcMar-Tigger	2687	-	208	33540179	18058
chr6	33522121	33722121	harbor1	chr6	33542495	33542530	DNA/TcMar-Tigger	2687	-	18	33542513	20392
chr6	33522121	33722121	harbor1	chr6	33542847	33542996	DNA/TcMar-Tigger	2687	-	74	33542921	20800
chr6	33522121	33722121	harbor1	chr6	33550202	33550246	DNA/TcMar-Tigger	941	-	22	33550224	28103
chr6	33522121	33722121	harbor1	chr6	33550558	33550716	DNA/TcMar-Tigger	941	-	79	33550637	28516
chr6	139274604	139474604	harbor1	chr6	139353526	139353979	DNA/TcMar-Tigger	612	-	226	139353752	79148
chr6	147104102	147304102	harbor1	chr6	147121886	147122227	DNA/TcMar-Tigger	716	-	170	147122056	17954
chr6	139275131	139475131	harbor1	chr6	139353526	139353979	DNA/TcMar-Tigger	612	-	226	139353752	78621
chr6	149351091	149551091	harbor1	chr6	149358129	149358455	DNA/TcMar-Tigger	1440	-	163	149358292	7201
chr6	149351091	149551091	harbor1	chr6	149422412	149422506	DNA/TcMar-Tigger	1267	-	47	149422459	71368
chr6	149351091	149551091	harbor1	chr6	149421892	149422103	DNA/TcMar-Tigger	1267	-	106	149421998	70907
chr6	79847089	80047089	harbor1	chr6	79920459	79920744	DNA/TcMar-Tigger	1669	-	142	79920601	73512
chr6	79847089	80047089	harbor1	chr6	79920755	79920948	DNA/TcMar-Tigger	1262	-	96	79920851	73762
chr6	165559697	165759697	harbor1	chr6	165570771	165570919	DNA/TcMar-Tigger	754	-	74	165570845	11148
chr6	165559697	165759697	harbor1	chr6	165570932	165571044	DNA/TcMar-Tigger	533	-	56	165570988	11291
chr6	165559697	165759697	harbor1	chr6	165622309	165622644	DNA/TcMar-Tigger	1980	-	168	165622477	62780
chr6	150799534	150999534	harbor1	chr6	150870452	150870630	DNA/TcMar-Tigger	1121	-	89	150870541	71007
chr6	150799534	150999534	harbor1	chr6	150871095	150871495	DNA/TcMar-Tigger	1473	-	200	150871295	71761
chr6	150799534	150999534	harbor1	chr6	150871799	150871833	DNA/TcMar-Tigger	1473	-	17	150871816	72282
chr6	150799534	150999534	harbor1	chr6	150872177	150872793	DNA/TcMar-Tigger	3680	-	308	150872485	72951
chr6	41091863	41291863	harbor1	chr6	41148256	41148616	DNA/TcMar-Tigger	1841	-	180	41148436	56573
chr6	139275443	139475443	harbor1	chr6	139353526	139353979	DNA/TcMar-Tigger	612	-	226	139353752	78309
chr6	139275520	139475520	harbor1	chr6	139353526	139353979	DNA/TcMar-Tigger	612	-	226	139353752	78232
chr6	37070864	37270864	harbor1	chr6	37071868	37072177	DNA/TcMar-Tigger	894	-	154	37072022	1158
chr6	37070864	37270864	harbor1	chr6	37096894	37097111	DNA/TcMar-Tigger	857	-	108	37097002	26138
chr6	37070864	37270864	harbor1	chr6	37097387	37097468	DNA/TcMar-Tigger	857	-	40	37097427	26563
chr6	146813054	147013054	harbor1	chr6	146836247	146836486	DNA/TcMar-Tigger	1098	-	120	146836367	23313
chr6	43815149	44015149	harbor1	chr6	43832195	43832350	DNA/TcMar-Tigger	786	-	78	43832273	17124
chr6	43815149	44015149	harbor1	chr6	43845791	43846940	DNA/TcMar-Tigger	7101	-	574	43846365	31216
chr6	43815149	44015149	harbor1	chr6	43894251	43894472	DNA/TcMar-Tigger	592	-	110	43894361	79212
chr6	139274545	139474545	harbor1	chr6	139353526	139353979	DNA/TcMar-Tigger	612	-	226	139353752	79207
chr6	7626958	7826958	harbor1	chr6	7637825	7638151	DNA/TcMar-Tigger	1572	-	163	7637988	11030
chr6	7626958	7826958	harbor1	chr6	7652325	7652525	DNA/TcMar-Tigger	633	-	100	7652425	25467
chr6	7626958	7826958	harbor1	chr6	7666449	7666767	DNA/TcMar-Tigger	2001	-	159	7666608	39650
chr6	7626958	7826958	harbor1	chr6	7723973	7724326	DNA/TcMar-Tigger	2358	-	176	7724149	97191
chr6	144187246	144387246	harbor1	chr6	144211164	144211254	DNA/TcMar-Tigger	528	-	45	144211209	23963
chr6	144187246	144387246	harbor1	chr6	144211248	144211505	DNA/TcMar-Tigger	1258	-	128	144211376	24130
chr6	127167324	127367324	harbor1	chr6	127246455	127246781	DNA/TcMar-Tigger	1778	-	163	127246618	79294
chr6	52184746	52384746	harbor1	chr6	52239839	52240154	DNA/TcMar-Tigger	503	-	158	52239997	55251
chr6	52184746	52384746	harbor1	chr6	52240459	52240727	DNA/TcMar-Tigger	503	-	134	52240593	55847
chr6	169863372	170063372	harbor1	chr6	169886477	169886709	DNA/TcMar-Tigger	492	-	116	169886593	23221
chr6	169863372	170063372	harbor1	chr6	169922950	169923523	DNA/TcMar-Tigger	743	-	286	169923236	59864
chr6	127167395	127367395	harbor1	chr6	127246455	127246781	DNA/TcMar-Tigger	1778	-	163	127246618	79223
chr6	324347	524347	harbor1	chr6	386222	386739	DNA/TcMar-Tigger	1715	-	258	386480	62133
chr6	56854700	57054700	harbor1	chr6	56855168	56856014	DNA/TcMar-Tigger	4972	-	423	56855591	891
chr6	56854700	57054700	harbor1	chr6	56930457	56930952	DNA/TcMar-Tigger	1277	-	248	56930705	76005
chr6	56854700	57054700	harbor1	chr6	56947848	56947988	DNA/TcMar-Tigger	712	-	70	56947918	93218
chr6	56854700	57054700	harbor1	chr6	56947991	56948650	DNA/TcMar-Tigger	3641	-	330	56948321	93621
chr6	139275141	139475141	harbor1	chr6	139353526	139353979	DNA/TcMar-Tigger	612	-	226	139353752	78611
chr6	151197903	151397903	harbor1	chr6	151228144	151228325	DNA/TcMar-Tigger	799	-	90	151228234	30331
chr6	149351013	149551013	harbor1	chr6	149358129	149358455	DNA/TcMar-Tigger	1440	-	163	149358292	7279
chr6	149351013	149551013	harbor1	chr6	149422412	149422506	DNA/TcMar-Tigger	1267	-	47	149422459	71446
chr6	149351013	149551013	harbor1	chr6	149421892	149422103	DNA/TcMar-Tigger	1267	-	106	149421998	70985
chr6	105894232	106094232	harbor1	chr6	105920901	105921229	DNA/TcMar-Tigger	1019	-	164	105921065	26833
chr6	105894232	106094232	harbor1	chr6	105921308	105922039	DNA/TcMar-Tigger	3945	-	366	105921674	27442
chr6	105894232	106094232	harbor1	chr6	105937604	105937794	DNA/TcMar-Tigger	940	-	95	105937699	43467
chr6	158436948	158636948	harbor1	chr6	158474681	158474904	DNA/TcMar-Tigger	1255	-	112	158474793	37845
chr6	158436948	158636948	harbor1	chr6	158517678	158518007	DNA/TcMar-Tigger	1480	-	164	158517842	80894
chr6	127167313	127367313	harbor1	chr6	127246455	127246781	DNA/TcMar-Tigger	1778	-	163	127246618	79305
chr6	2665182	2865182	harbor1	chr6	2683920	2684446	DNA/TcMar-Tigger	3002	-	263	2684183	19001
chr6	43521769	43721769	harbor1	chr6	43563486	43563928	DNA/TcMar-Tigger	3186	-	221	43563707	41938
chr6	43521769	43721769	harbor1	chr6	43564222	43564248	DNA/TcMar-Tigger	3186	-	13	43564235	42466
chr6	43521769	43721769	harbor1	chr6	43564543	43564608	DNA/TcMar-Tigger	3186	-	32	43564575	42806
chr6	107857147	108057147	harbor1	chr6	107927697	107928007	DNA/TcMar-Tigger	1161	-	155	107927852	70705
chr6	107857147	108057147	harbor1	chr6	107942593	107943572	DNA/TcMar-Tigger	3862	-	490	107943083	85936
chr6	35352842	35552842	harbor1	chr6	35447680	35447749	DNA/TcMar-Tigger	2004	-	34	35447714	94872
chr6	35352842	35552842	harbor1	chr6	35448041	35448393	DNA/TcMar-Tigger	2004	-	176	35448217	95375
chr6	13611912	13811912	harbor1	chr6	13666294	13666485	DNA/TcMar-Tigger	1657	-	96	13666390	54478
chr6	13611912	13811912	harbor1	chr6	13666779	13666997	DNA/TcMar-Tigger	1657	-	109	13666888	54976
chr6	13611912	13811912	harbor1	chr6	13699433	13699581	DNA/TcMar-Tigger	981	-	74	13699507	87595
chr6	13611912	13811912	harbor1	chr6	13699880	13699933	DNA/TcMar-Tigger	981	-	26	13699906	87994
chr6	13611912	13811912	harbor1	chr6	13631372	13631538	DNA/TcMar-Tigger	739	-	83	13631455	19543
chr6	52184768	52384768	harbor1	chr6	52239839	52240154	DNA/TcMar-Tigger	503	-	158	52239997	55229
chr6	52184768	52384768	harbor1	chr6	52240459	52240727	DNA/TcMar-Tigger	503	-	134	52240593	55825
chr6	167860893	168060893	harbor1	chr6	167883504	167885833	DNA/TcMar-Tigger	13660	-	1164	167884668	23775
chr6	167860893	168060893	harbor1	chr6	167902469	167902801	DNA/TcMar-Tigger	1729	-	166	167902635	41742
chr6	167860893	168060893	harbor1	chr6	167944570	167945723	DNA/TcMar-Tigger	5463	-	576	167945146	84253
chr6	124862446	125062446	harbor1	chr6	124929938	124930527	DNA/TcMar-Tigger	3597	-	294	124930232	67786
chr6	124862446	125062446	harbor1	chr6	124930947	124931527	DNA/TcMar-Tigger	3753	-	290	124931237	68791
chr6	139275129	139475129	harbor1	chr6	139353526	139353979	DNA/TcMar-Tigger	612	-	226	139353752	78623
chr6	111111942	111311942	harbor1	chr6	111198391	111198729	DNA/TcMar-Tigger	2184	-	169	111198560	86618
chr6	139275116	139475116	harbor1	chr6	139353526	139353979	DNA/TcMar-Tigger	612	-	226	139353752	78636
chr6	41091918	41291918	harbor1	chr6	41148256	41148616	DNA/TcMar-Tigger	1841	-	180	41148436	56518
chr6	169623052	169823052	harbor1	chr6	169642852	169643080	DNA/TcMar-Tigger	1195	-	114	169642966	19914
chr6	169623052	169823052	harbor1	chr6	169687667	169687903	DNA/TcMar-Tigger	1165	-	118	169687785	64733
chr6	169623052	169823052	harbor1	chr6	169717298	169717634	DNA/TcMar-Tigger	1895	-	168	169717466	94414
chr6	159069545	159269545	harbor1	chr6	159111448	159111861	DNA/TcMar-Tigger	2301	-	206	159111654	42109
chr6	159069545	159269545	harbor1	chr6	159112483	159112808	DNA/TcMar-Tigger	1582	-	162	159112645	43100
chr6	159069545	159269545	harbor1	chr6	159112817	159112916	DNA/TcMar-Tigger	574	-	50	159112867	43322
chr6	159069545	159269545	harbor1	chr6	159147863	159148509	DNA/TcMar-Tigger	3699	-	323	159148186	78641
chr6	73362002	73562002	harbor1	chr6	73390333	73390528	DNA/TcMar-Tigger	977	-	98	73390431	28429
chr6	208571	408571	harbor1	chr6	223688	224287	DNA/TcMar-Tigger	2554	-	300	223988	15417
chr6	63473420	63673420	harbor1	chr6	63518856	63519032	DNA/TcMar-Tigger	914	-	88	63518944	45524
chr6	63473420	63673420	harbor1	chr6	63519319	63519462	DNA/TcMar-Tigger	914	-	72	63519391	45971
chr6	63473420	63673420	harbor1	chr6	63565942	63566098	DNA/TcMar-Tigger	13698	-	78	63566020	92600
chr6	63473420	63673420	harbor1	chr6	63566560	63568698	DNA/TcMar-Tigger	13698	-	1069	63567629	94209
chr6	167863263	168063263	harbor1	chr6	167883504	167885833	DNA/TcMar-Tigger	13660	-	1164	167884668	21405
chr6	167863263	168063263	harbor1	chr6	167902469	167902801	DNA/TcMar-Tigger	1729	-	166	167902635	39372
chr6	167863263	168063263	harbor1	chr6	167944570	167945723	DNA/TcMar-Tigger	5463	-	576	167945146	81883
chr6	146812183	147012183	harbor1	chr6	146836247	146836486	DNA/TcMar-Tigger	1098	-	120	146836367	24184
chr6	145635082	145835082	harbor1	chr6	145714179	145714308	DNA/TcMar-Tigger	830	-	64	145714243	79161
chr6	145635082	145835082	harbor1	chr6	145714309	145714554	DNA/TcMar-Tigger	4336	-	122	145714431	79349
chr6	145635082	145835082	harbor1	chr6	145714913	145715514	DNA/TcMar-Tigger	4336	-	300	145715213	80131
chr6	145635082	145835082	harbor1	chr6	145716044	145716244	DNA/TcMar-Tigger	1047	-	100	145716144	81062
chr6	32752654	32952654	harbor1	chr6	32753428	32753753	DNA/TcMar-Tigger	1326	-	162	32753590	936
chr6	32752654	32952654	harbor1	chr6	32773489	32773855	DNA/TcMar-Tigger	1596	-	183	32773672	21018
chr6	32752654	32952654	harbor1	chr6	32800031	32800356	DNA/TcMar-Tigger	1557	-	162	32800193	47539
chr6	32752654	32952654	harbor1	chr6	32836474	32836797	DNA/TcMar-Tigger	2160	-	162	32836636	83982
chr6	63535819	63735819	harbor1	chr6	63565942	63566098	DNA/TcMar-Tigger	13698	-	78	63566020	30201
chr6	63535819	63735819	harbor1	chr6	63566560	63568698	DNA/TcMar-Tigger	13698	-	1069	63567629	31810
chr6	63535819	63735819	harbor1	chr6	63589658	63589926	DNA/TcMar-Tigger	850	-	134	63589792	53973
chr6	63535819	63735819	harbor1	chr6	63590374	63590466	DNA/TcMar-Tigger	850	-	46	63590420	54601
chr6	169863974	170063974	harbor1	chr6	169886477	169886709	DNA/TcMar-Tigger	492	-	116	169886593	22619
chr6	169863974	170063974	harbor1	chr6	169922950	169923523	DNA/TcMar-Tigger	743	-	286	169923236	59262
chr6	52184773	52384773	harbor1	chr6	52239839	52240154	DNA/TcMar-Tigger	503	-	158	52239997	55224
chr6	52184773	52384773	harbor1	chr6	52240459	52240727	DNA/TcMar-Tigger	503	-	134	52240593	55820
chr7	28080201	28280201	harbor1	chr7	28080090	28080913	DNA/TcMar-Tigger	5250	-	412	28080502	301
chr7	28080201	28280201	harbor1	chr7	28146431	28146681	DNA/TcMar-Tigger	533	-	125	28146556	66355
chr7	28080201	28280201	harbor1	chr7	28146770	28146854	DNA/TcMar-Tigger	1130	-	42	28146812	66611
chr7	28080201	28280201	harbor1	chr7	28147146	28147336	DNA/TcMar-Tigger	1130	-	95	28147241	67040
chr7	1801883	2001883	harbor1	chr7	1892398	1892652	DNA/TcMar-Tigger	985	-	127	1892525	90642
chr7	151420770	151620770	harbor1	chr7	151434571	151434696	DNA/TcMar-Tigger	1113	-	62	151434633	13863
chr7	151420770	151620770	harbor1	chr7	151434697	151434903	DNA/TcMar-Tigger	1246	-	103	151434800	14030
chr7	151420770	151620770	harbor1	chr7	151434904	151434992	DNA/TcMar-Tigger	1113	-	44	151434948	14178
chr7	151420770	151620770	harbor1	chr7	151484463	151484544	DNA/TcMar-Tigger	463	-	40	151484503	63733
chr7	151420770	151620770	harbor1	chr7	151504343	151504587	DNA/TcMar-Tigger	1144	-	122	151504465	83695
chr7	28080214	28280214	harbor1	chr7	28080090	28080913	DNA/TcMar-Tigger	5250	-	412	28080502	288
chr7	28080214	28280214	harbor1	chr7	28146431	28146681	DNA/TcMar-Tigger	533	-	125	28146556	66342
chr7	28080214	28280214	harbor1	chr7	28146770	28146854	DNA/TcMar-Tigger	1130	-	42	28146812	66598
chr7	28080214	28280214	harbor1	chr7	28147146	28147336	DNA/TcMar-Tigger	1130	-	95	28147241	67027
chr7	1312721	1512721	harbor1	chr7	1362030	1362198	DNA/TcMar-Tigger	567	-	84	1362114	49393
chr7	1136759	1336759	harbor1	chr7	1149548	1149773	DNA/TcMar-Tigger	770	-	112	1149660	12901
chr7	1136759	1336759	harbor1	chr7	1163241	1163484	DNA/TcMar-Tigger	1016	-	122	1163363	26604
chr7	39729557	39929557	harbor1	chr7	39825098	39825735	DNA/TcMar-Tigger	3451	-	318	39825416	95859
chr7	130568057	130768057	harbor1	chr7	130603788	130604199	DNA/TcMar-Tigger	2360	-	206	130603994	35937
chr7	1798159	1998159	harbor1	chr7	1892398	1892652	DNA/TcMar-Tigger	985	-	127	1892525	94366
chr7	50615299	50815299	harbor1	chr7	50623771	50623998	DNA/TcMar-Tigger	1308	-	114	50623885	8586
chr7	155708589	155908589	harbor1	chr7	155731320	155731783	DNA/TcMar-Tigger	2443	-	232	155731552	22963
chr7	155708589	155908589	harbor1	chr7	155734992	155735088	DNA/TcMar-Tigger	425	-	48	155735040	26451
chr7	155708589	155908589	harbor1	chr7	155745756	155746081	DNA/TcMar-Tigger	1772	-	162	155745918	37329
chr7	28080184	28280184	harbor1	chr7	28080090	28080913	DNA/TcMar-Tigger	5250	-	412	28080502	318
chr7	28080184	28280184	harbor1	chr7	28146431	28146681	DNA/TcMar-Tigger	533	-	125	28146556	66372
chr7	28080184	28280184	harbor1	chr7	28146770	28146854	DNA/TcMar-Tigger	1130	-	42	28146812	66628
chr7	28080184	28280184	harbor1	chr7	28147146	28147336	DNA/TcMar-Tigger	1130	-	95	28147241	67057
chr7	1293735	1493735	harbor1	chr7	1362030	1362198	DNA/TcMar-Tigger	567	-	84	1362114	68379
chr7	50283638	50483638	harbor1	chr7	50352294	50352519	DNA/TcMar-Tigger	579	-	112	50352406	68768
chr7	123649229	123849229	harbor1	chr7	123658938	123659114	DNA/TcMar-Tigger	916	-	88	123659026	9797
chr7	123649229	123849229	harbor1	chr7	123736534	123736641	DNA/TcMar-Tigger	594	-	54	123736588	87359
chr7	28080180	28280180	harbor1	chr7	28080090	28080913	DNA/TcMar-Tigger	5250	-	412	28080502	322
chr7	28080180	28280180	harbor1	chr7	28146431	28146681	DNA/TcMar-Tigger	533	-	125	28146556	66376
chr7	28080180	28280180	harbor1	chr7	28146770	28146854	DNA/TcMar-Tigger	1130	-	42	28146812	66632
chr7	28080180	28280180	harbor1	chr7	28147146	28147336	DNA/TcMar-Tigger	1130	-	95	28147241	67061
chr7	583630	783630	harbor1	chr7	677746	677988	DNA/TcMar-Tigger	1611	-	121	677867	94237
chr7	583630	783630	harbor1	chr7	678288	678397	DNA/TcMar-Tigger	1611	-	54	678342	94712
chr7	155708566	155908566	harbor1	chr7	155731320	155731783	DNA/TcMar-Tigger	2443	-	232	155731552	22986
chr7	155708566	155908566	harbor1	chr7	155734992	155735088	DNA/TcMar-Tigger	425	-	48	155735040	26474
chr7	155708566	155908566	harbor1	chr7	155745756	155746081	DNA/TcMar-Tigger	1772	-	162	155745918	37352
chr7	123649386	123849386	harbor1	chr7	123658938	123659114	DNA/TcMar-Tigger	916	-	88	123659026	9640
chr7	123649386	123849386	harbor1	chr7	123736534	123736641	DNA/TcMar-Tigger	594	-	54	123736588	87202
chr7	47246884	47446884	harbor1	chr7	47247061	47247234	DNA/TcMar-Tigger	935	-	86	47247147	263
chr7	47246884	47446884	harbor1	chr7	47271054	47271257	DNA/TcMar-Tigger	867	-	102	47271156	24272
chr7	28080194	28280194	harbor1	chr7	28080090	28080913	DNA/TcMar-Tigger	5250	-	412	28080502	308
chr7	28080194	28280194	harbor1	chr7	28146431	28146681	DNA/TcMar-Tigger	533	-	125	28146556	66362
chr7	28080194	28280194	harbor1	chr7	28146770	28146854	DNA/TcMar-Tigger	1130	-	42	28146812	66618
chr7	28080194	28280194	harbor1	chr7	28147146	28147336	DNA/TcMar-Tigger	1130	-	95	28147241	67047
chr7	47228348	47428348	harbor1	chr7	47247061	47247234	DNA/TcMar-Tigger	935	-	86	47247147	18799
chr7	47228348	47428348	harbor1	chr7	47271054	47271257	DNA/TcMar-Tigger	867	-	102	47271156	42808
chr7	123649293	123849293	harbor1	chr7	123658938	123659114	DNA/TcMar-Tigger	916	-	88	123659026	9733
chr7	123649293	123849293	harbor1	chr7	123736534	123736641	DNA/TcMar-Tigger	594	-	54	123736588	87295
chr7	155249500	155449500	harbor1	chr7	155293392	155293714	DNA/TcMar-Tigger	1521	-	161	155293553	44053
chr7	155249500	155449500	harbor1	chr7	155310375	155310600	DNA/TcMar-Tigger	1199	-	112	155310487	60987
chr7	155249500	155449500	harbor1	chr7	155323768	155323901	DNA/TcMar-Tigger	819	-	66	155323834	74334
chr7	140597158	140797158	harbor1	chr7	140620897	140621038	DNA/TcMar-Tigger	1500	-	70	140620967	23809
chr7	140597158	140797158	harbor1	chr7	140621338	140621484	DNA/TcMar-Tigger	1500	-	73	140621411	24253
chr7	140597158	140797158	harbor1	chr7	140621521	140621605	DNA/TcMar-Tigger	473	-	42	140621563	24405
chr7	28080212	28280212	harbor1	chr7	28080090	28080913	DNA/TcMar-Tigger	5250	-	412	28080502	290
chr7	28080212	28280212	harbor1	chr7	28146431	28146681	DNA/TcMar-Tigger	533	-	125	28146556	66344
chr7	28080212	28280212	harbor1	chr7	28146770	28146854	DNA/TcMar-Tigger	1130	-	42	28146812	66600
chr7	28080212	28280212	harbor1	chr7	28147146	28147336	DNA/TcMar-Tigger	1130	-	95	28147241	67029
chr7	1798568	1998568	harbor1	chr7	1892398	1892652	DNA/TcMar-Tigger	985	-	127	1892525	93957
chr7	65651047	65851047	harbor1	chr7	65670775	65671037	DNA/TcMar-Tigger	1469	-	131	65670906	19859
chr7	77912395	78112395	harbor1	chr7	77916581	77916941	DNA/TcMar-Tigger	1355	-	180	77916761	4366
chr7	77912395	78112395	harbor1	chr7	77928516	77928701	DNA/TcMar-Tigger	550	-	92	77928608	16213
chr7	28080187	28280187	harbor1	chr7	28080090	28080913	DNA/TcMar-Tigger	5250	-	412	28080502	315
chr7	28080187	28280187	harbor1	chr7	28146431	28146681	DNA/TcMar-Tigger	533	-	125	28146556	66369
chr7	28080187	28280187	harbor1	chr7	28146770	28146854	DNA/TcMar-Tigger	1130	-	42	28146812	66625
chr7	28080187	28280187	harbor1	chr7	28147146	28147336	DNA/TcMar-Tigger	1130	-	95	28147241	67054
chr7	65982514	66182514	harbor1	chr7	66038344	66038627	DNA/TcMar-Tigger	824	-	142	66038486	55972
chr7	155708581	155908581	harbor1	chr7	155731320	155731783	DNA/TcMar-Tigger	2443	-	232	155731552	22971
chr7	155708581	155908581	harbor1	chr7	155734992	155735088	DNA/TcMar-Tigger	425	-	48	155735040	26459
chr7	155708581	155908581	harbor1	chr7	155745756	155746081	DNA/TcMar-Tigger	1772	-	162	155745918	37337
chr7	123610933	123810933	harbor1	chr7	123658938	123659114	DNA/TcMar-Tigger	916	-	88	123659026	48093
chr7	1801969	2001969	harbor1	chr7	1892398	1892652	DNA/TcMar-Tigger	985	-	127	1892525	90556
chr7	123649263	123849263	harbor1	chr7	123658938	123659114	DNA/TcMar-Tigger	916	-	88	123659026	9763
chr7	123649263	123849263	harbor1	chr7	123736534	123736641	DNA/TcMar-Tigger	594	-	54	123736588	87325
chr7	155231815	155431815	harbor1	chr7	155293392	155293714	DNA/TcMar-Tigger	1521	-	161	155293553	61738
chr7	155231815	155431815	harbor1	chr7	155310375	155310600	DNA/TcMar-Tigger	1199	-	112	155310487	78672
chr7	155231815	155431815	harbor1	chr7	155323768	155323901	DNA/TcMar-Tigger	819	-	66	155323834	92019
chr7	1564241	1764241	harbor1	chr7	1573425	1573807	DNA/TcMar-Tigger	1262	-	191	1573616	9375
chr7	1564241	1764241	harbor1	chr7	1574116	1574303	DNA/TcMar-Tigger	1262	-	94	1574210	9969
chr7	1564241	1764241	harbor1	chr7	1574607	1574861	DNA/TcMar-Tigger	1262	-	127	1574734	10493
chr7	1564241	1764241	harbor1	chr7	1655169	1655502	DNA/TcMar-Tigger	1532	-	166	1655335	91094
chr7	101437983	101637983	harbor1	chr7	101452485	101452773	DNA/TcMar-Tigger	1820	-	144	101452629	14646
chr7	101437983	101637983	harbor1	chr7	101453051	101453088	DNA/TcMar-Tigger	1820	-	18	101453069	15086
chr7	101437983	101637983	harbor1	chr7	101453382	101453447	DNA/TcMar-Tigger	1820	-	32	101453414	15431
chr7	47228344	47428344	harbor1	chr7	47247061	47247234	DNA/TcMar-Tigger	935	-	86	47247147	18803
chr7	47228344	47428344	harbor1	chr7	47271054	47271257	DNA/TcMar-Tigger	867	-	102	47271156	42812
chr7	47228340	47428340	harbor1	chr7	47247061	47247234	DNA/TcMar-Tigger	935	-	86	47247147	18807
chr7	47228340	47428340	harbor1	chr7	47271054	47271257	DNA/TcMar-Tigger	867	-	102	47271156	42816
chr7	80035348	80235348	harbor1	chr7	80122280	80122609	DNA/TcMar-Tigger	1799	-	164	80122444	87096
chr7	90221478	90421478	harbor1	chr7	90231414	90231717	DNA/TcMar-Tigger	1800	-	152	90231566	10088
chr7	90221478	90421478	harbor1	chr7	90288390	90289106	DNA/TcMar-Tigger	3883	-	358	90288748	67270
chr7	47228502	47428502	harbor1	chr7	47247061	47247234	DNA/TcMar-Tigger	935	-	86	47247147	18645
chr7	47228502	47428502	harbor1	chr7	47271054	47271257	DNA/TcMar-Tigger	867	-	102	47271156	42654
chr7	123649244	123849244	harbor1	chr7	123658938	123659114	DNA/TcMar-Tigger	916	-	88	123659026	9782
chr7	123649244	123849244	harbor1	chr7	123736534	123736641	DNA/TcMar-Tigger	594	-	54	123736588	87344
chr7	128101419	128301419	harbor1	chr7	128128737	128128914	DNA/TcMar-Tigger	1207	-	88	128128825	27406
chr7	47174241	47374241	harbor1	chr7	47247061	47247234	DNA/TcMar-Tigger	935	-	86	47247147	72906
chr7	47174241	47374241	harbor1	chr7	47271054	47271257	DNA/TcMar-Tigger	867	-	102	47271156	96915
chr7	123649264	123849264	harbor1	chr7	123658938	123659114	DNA/TcMar-Tigger	916	-	88	123659026	9762
chr7	123649264	123849264	harbor1	chr7	123736534	123736641	DNA/TcMar-Tigger	594	-	54	123736588	87324
chr7	47228327	47428327	harbor1	chr7	47247061	47247234	DNA/TcMar-Tigger	935	-	86	47247147	18820
chr7	47228327	47428327	harbor1	chr7	47271054	47271257	DNA/TcMar-Tigger	867	-	102	47271156	42829
chr7	1801933	2001933	harbor1	chr7	1892398	1892652	DNA/TcMar-Tigger	985	-	127	1892525	90592
chr7	151420775	151620775	harbor1	chr7	151434571	151434696	DNA/TcMar-Tigger	1113	-	62	151434633	13858
chr7	151420775	151620775	harbor1	chr7	151434697	151434903	DNA/TcMar-Tigger	1246	-	103	151434800	14025
chr7	151420775	151620775	harbor1	chr7	151434904	151434992	DNA/TcMar-Tigger	1113	-	44	151434948	14173
chr7	151420775	151620775	harbor1	chr7	151484463	151484544	DNA/TcMar-Tigger	463	-	40	151484503	63728
chr7	151420775	151620775	harbor1	chr7	151504343	151504587	DNA/TcMar-Tigger	1144	-	122	151504465	83690
chr7	102325596	102525596	harbor1	chr7	102398676	102398847	DNA/TcMar-Tigger	807	-	86	102398762	73166
chr7	28080189	28280189	harbor1	chr7	28080090	28080913	DNA/TcMar-Tigger	5250	-	412	28080502	313
chr7	28080189	28280189	harbor1	chr7	28146431	28146681	DNA/TcMar-Tigger	533	-	125	28146556	66367
chr7	28080189	28280189	harbor1	chr7	28146770	28146854	DNA/TcMar-Tigger	1130	-	42	28146812	66623
chr7	28080189	28280189	harbor1	chr7	28147146	28147336	DNA/TcMar-Tigger	1130	-	95	28147241	67052
chr7	26995642	27195642	harbor1	chr7	27085112	27085446	DNA/TcMar-Tigger	1839	-	167	27085279	89637
chr7	102378973	102578973	harbor1	chr7	102398676	102398847	DNA/TcMar-Tigger	807	-	86	102398762	19789
chr7	102378973	102578973	harbor1	chr7	102441653	102441752	DNA/TcMar-Tigger	448	-	50	102441703	62730
chr7	105288909	105488909	harbor1	chr7	105289369	105289508	DNA/TcMar-Tigger	743	-	70	105289439	530
chr7	105288909	105488909	harbor1	chr7	105289626	105290270	DNA/TcMar-Tigger	3348	-	322	105289948	1039
chr7	105288909	105488909	harbor1	chr7	105357871	105357942	DNA/TcMar-Tigger	1272	-	36	105357907	68998
chr7	105288909	105488909	harbor1	chr7	105358246	105358403	DNA/TcMar-Tigger	1272	-	78	105358324	69415
chr7	105288909	105488909	harbor1	chr7	105358710	105358739	DNA/TcMar-Tigger	1272	-	14	105358724	69815
chr7	105288909	105488909	harbor1	chr7	105359458	105359514	DNA/TcMar-Tigger	1272	-	28	105359486	70577
chr7	105288909	105488909	harbor1	chr7	105359520	105359805	DNA/TcMar-Tigger	1681	-	142	105359662	70753
chr7	105288909	105488909	harbor1	chr7	105364212	105364405	DNA/TcMar-Tigger	4327	-	96	105364308	75399
chr7	105288909	105488909	harbor1	chr7	105364702	105365175	DNA/TcMar-Tigger	4327	-	236	105364938	76029
chr7	105288909	105488909	harbor1	chr7	105365819	105365850	DNA/TcMar-Tigger	3631	-	16	105365835	76926
chr7	105288909	105488909	harbor1	chr7	105366153	105366367	DNA/TcMar-Tigger	3631	-	107	105366260	77351
chr7	105288909	105488909	harbor1	chr7	105366669	105367261	DNA/TcMar-Tigger	3631	-	296	105366965	78056
chr7	105288909	105488909	harbor1	chr7	105367563	105367930	DNA/TcMar-Tigger	3631	-	184	105367747	78838
chr7	6060488	6260488	harbor1	chr7	6150889	6151428	DNA/TcMar-Tigger	2963	-	270	6151159	90671
chr7	6060488	6260488	harbor1	chr7	6151743	6151970	DNA/TcMar-Tigger	936	-	114	6151857	91369
chr7	25697532	25897532	harbor1	chr7	25735729	25736127	DNA/TcMar-Tigger	1809	-	199	25735928	38396
chr7	1312753	1512753	harbor1	chr7	1362030	1362198	DNA/TcMar-Tigger	567	-	84	1362114	49361
chr7	47227890	47427890	harbor1	chr7	47247061	47247234	DNA/TcMar-Tigger	935	-	86	47247147	19257
chr7	47227890	47427890	harbor1	chr7	47271054	47271257	DNA/TcMar-Tigger	867	-	102	47271156	43266
chr7	1312775	1512775	harbor1	chr7	1362030	1362198	DNA/TcMar-Tigger	567	-	84	1362114	49339
chr7	16531	216531	harbor1	chr7	95307	96214	DNA/TcMar-Tigger	13459	-	454	95761	79230
chr7	16531	216531	harbor1	chr7	96513	97941	DNA/TcMar-Tigger	13459	-	714	97227	80696
chr7	16531	216531	harbor1	chr7	98243	98298	DNA/TcMar-Tigger	13459	-	28	98271	81740
chr7	16531	216531	harbor1	chr7	104835	105522	DNA/TcMar-Tigger	2782	-	344	105179	88648
chr7	108470160	108670160	harbor1	chr7	108561976	108562129	DNA/TcMar-Tigger	887	-	76	108562052	91892
chr7	1312762	1512762	harbor1	chr7	1362030	1362198	DNA/TcMar-Tigger	567	-	84	1362114	49352
chr7	47228426	47428426	harbor1	chr7	47247061	47247234	DNA/TcMar-Tigger	935	-	86	47247147	18721
chr7	47228426	47428426	harbor1	chr7	47271054	47271257	DNA/TcMar-Tigger	867	-	102	47271156	42730
chr7	123649335	123849335	harbor1	chr7	123658938	123659114	DNA/TcMar-Tigger	916	-	88	123659026	9691
chr7	123649335	123849335	harbor1	chr7	123736534	123736641	DNA/TcMar-Tigger	594	-	54	123736588	87253
chr7	123649230	123849230	harbor1	chr7	123658938	123659114	DNA/TcMar-Tigger	916	-	88	123659026	9796
chr7	123649230	123849230	harbor1	chr7	123736534	123736641	DNA/TcMar-Tigger	594	-	54	123736588	87358
chr7	73478344	73678344	harbor1	chr7	73497316	73497775	DNA/TcMar-Tigger	2064	-	230	73497546	19202
chr7	73478344	73678344	harbor1	chr7	73513967	73514188	DNA/TcMar-Tigger	1293	-	110	73514077	35733
chr7	47227923	47427923	harbor1	chr7	47247061	47247234	DNA/TcMar-Tigger	935	-	86	47247147	19224
chr7	47227923	47427923	harbor1	chr7	47271054	47271257	DNA/TcMar-Tigger	867	-	102	47271156	43233
chr7	1795705	1995705	harbor1	chr7	1892398	1892652	DNA/TcMar-Tigger	985	-	127	1892525	96820
chr7	123481083	123681083	harbor1	chr7	123537449	123537762	DNA/TcMar-Tigger	1221	-	156	123537605	56522
chr7	123481083	123681083	harbor1	chr7	123561168	123561609	DNA/TcMar-Tigger	11511	-	220	123561388	80305
chr7	123481083	123681083	harbor1	chr7	123561895	123562786	DNA/TcMar-Tigger	11511	-	446	123562341	81258
chr7	123481083	123681083	harbor1	chr7	123563101	123563729	DNA/TcMar-Tigger	11511	-	314	123563415	82332
chr7	155196997	155396997	harbor1	chr7	155293392	155293714	DNA/TcMar-Tigger	1521	-	161	155293553	96556
chr7	32628791	32828791	harbor1	chr7	32644823	32645058	DNA/TcMar-Tigger	1385	-	118	32644941	16150
chr7	6059184	6259184	harbor1	chr7	6150889	6151428	DNA/TcMar-Tigger	2963	-	270	6151159	91975
chr7	6059184	6259184	harbor1	chr7	6151743	6151970	DNA/TcMar-Tigger	936	-	114	6151857	92673
chr7	30975839	31175839	harbor1	chr7	30990670	30991321	DNA/TcMar-Tigger	3124	-	326	30990996	15157
chr7	30975839	31175839	harbor1	chr7	31002171	31002420	DNA/TcMar-Tigger	653	-	124	31002295	26456
chr7	30579971	30779971	harbor1	chr7	30667526	30667720	DNA/TcMar-Tigger	695	-	97	30667623	87652
chr7	627133	827133	harbor1	chr7	677746	677988	DNA/TcMar-Tigger	1611	-	121	677867	50734
chr7	627133	827133	harbor1	chr7	678288	678397	DNA/TcMar-Tigger	1611	-	54	678342	51209
chr7	627133	827133	harbor1	chr7	708351	708484	DNA/TcMar-Tigger	768	-	66	708417	81284
chr7	1312948	1512948	harbor1	chr7	1362030	1362198	DNA/TcMar-Tigger	567	-	84	1362114	49166
chr7	140378858	140578858	harbor1	chr7	140415471	140415662	DNA/TcMar-Tigger	778	-	96	140415567	36709
chr7	44436448	44636448	harbor1	chr7	44471120	44471442	DNA/TcMar-Tigger	1099	-	161	44471281	34833
chr7	122786849	122986849	harbor1	chr7	122804601	122804864	DNA/TcMar-Tigger	436	-	132	122804733	17884
chr7	122786849	122986849	harbor1	chr7	122832497	122832740	DNA/TcMar-Tigger	482	-	122	122832619	45770
chr7	122786849	122986849	harbor1	chr7	122859621	122859912	DNA/TcMar-Tigger	1213	-	146	122859767	72918
chr7	122786849	122986849	harbor1	chr7	122871498	122871651	DNA/TcMar-Tigger	420	-	76	122871574	84725
chr7	90112306	90312306	harbor1	chr7	90157825	90158745	DNA/TcMar-Tigger	5506	-	460	90158285	45979
chr7	90112306	90312306	harbor1	chr7	90158744	90158842	DNA/TcMar-Tigger	581	-	49	90158793	46487
chr7	1801912	2001912	harbor1	chr7	1892398	1892652	DNA/TcMar-Tigger	985	-	127	1892525	90613
chr7	123648388	123848388	harbor1	chr7	123658938	123659114	DNA/TcMar-Tigger	916	-	88	123659026	10638
chr7	123648388	123848388	harbor1	chr7	123736534	123736641	DNA/TcMar-Tigger	594	-	54	123736588	88200
chr7	1799784	1999784	harbor1	chr7	1892398	1892652	DNA/TcMar-Tigger	985	-	127	1892525	92741
chr7	123649270	123849270	harbor1	chr7	123658938	123659114	DNA/TcMar-Tigger	916	-	88	123659026	9756
chr7	123649270	123849270	harbor1	chr7	123736534	123736641	DNA/TcMar-Tigger	594	-	54	123736588	87318
chr7	1312758	1512758	harbor1	chr7	1362030	1362198	DNA/TcMar-Tigger	567	-	84	1362114	49356
chr7	1801263	2001263	harbor1	chr7	1892398	1892652	DNA/TcMar-Tigger	985	-	127	1892525	91262
chr7	47228349	47428349	harbor1	chr7	47247061	47247234	DNA/TcMar-Tigger	935	-	86	47247147	18798
chr7	47228349	47428349	harbor1	chr7	47271054	47271257	DNA/TcMar-Tigger	867	-	102	47271156	42807
chr7	123457458	123657458	harbor1	chr7	123537449	123537762	DNA/TcMar-Tigger	1221	-	156	123537605	80147
chr7	123649311	123849311	harbor1	chr7	123658938	123659114	DNA/TcMar-Tigger	916	-	88	123659026	9715
chr7	123649311	123849311	harbor1	chr7	123736534	123736641	DNA/TcMar-Tigger	594	-	54	123736588	87277
chr7	1801911	2001911	harbor1	chr7	1892398	1892652	DNA/TcMar-Tigger	985	-	127	1892525	90614
chr7	47306156	47506156	harbor1	chr7	47382616	47382879	DNA/TcMar-Tigger	1052	-	132	47382748	76592
chr7	1801805	2001805	harbor1	chr7	1892398	1892652	DNA/TcMar-Tigger	985	-	127	1892525	90720
chr8	142524965	142724965	harbor1	chr8	142557866	142559182	DNA/TcMar-Tigger	5722	-	658	142558524	33559
chr8	38169171	38369171	harbor1	chr8	38197186	38197691	DNA/TcMar-Tigger	6505	-	252	38197438	28267
chr8	38169171	38369171	harbor1	chr8	38198004	38198102	DNA/TcMar-Tigger	6505	-	49	38198053	28882
chr8	38169171	38369171	harbor1	chr8	38198401	38198476	DNA/TcMar-Tigger	6505	-	38	38198439	29268
chr8	38169171	38369171	harbor1	chr8	38198786	38199328	DNA/TcMar-Tigger	6505	-	271	38199057	29886
chr8	38169174	38369174	harbor1	chr8	38197186	38197691	DNA/TcMar-Tigger	6505	-	252	38197438	28264
chr8	38169174	38369174	harbor1	chr8	38198004	38198102	DNA/TcMar-Tigger	6505	-	49	38198053	28879
chr8	38169174	38369174	harbor1	chr8	38198401	38198476	DNA/TcMar-Tigger	6505	-	38	38198439	29265
chr8	38169174	38369174	harbor1	chr8	38198786	38199328	DNA/TcMar-Tigger	6505	-	271	38199057	29883
chr8	18018925	18218925	harbor1	chr8	18032760	18032942	DNA/TcMar-Tigger	771	-	91	18032851	13926
chr8	85145898	85345898	harbor1	chr8	85209460	85209732	DNA/TcMar-Tigger	1396	-	136	85209596	63698
chr8	100620899	100820899	harbor1	chr8	100700309	100700357	DNA/TcMar-Tigger	1503	-	24	100700333	79434
chr8	100620899	100820899	harbor1	chr8	100700667	100700701	DNA/TcMar-Tigger	1503	-	17	100700684	79785
chr8	100620899	100820899	harbor1	chr8	100700978	100701295	DNA/TcMar-Tigger	1503	-	158	100701136	80237
chr8	100620899	100820899	harbor1	chr8	100701289	100701441	DNA/TcMar-Tigger	722	-	76	100701365	80466
chr8	38169283	38369283	harbor1	chr8	38197186	38197691	DNA/TcMar-Tigger	6505	-	252	38197438	28155
chr8	38169283	38369283	harbor1	chr8	38198004	38198102	DNA/TcMar-Tigger	6505	-	49	38198053	28770
chr8	38169283	38369283	harbor1	chr8	38198401	38198476	DNA/TcMar-Tigger	6505	-	38	38198439	29156
chr8	38169283	38369283	harbor1	chr8	38198786	38199328	DNA/TcMar-Tigger	6505	-	271	38199057	29774
chr8	90545266	90745266	harbor1	chr8	90630107	90630415	DNA/TcMar-Tigger	1162	-	154	90630261	84995
chr8	90545266	90745266	harbor1	chr8	90570638	90570766	DNA/TcMar-Tigger	606	-	64	90570702	25436
chr8	38168881	38368881	harbor1	chr8	38197186	38197691	DNA/TcMar-Tigger	6505	-	252	38197438	28557
chr8	38168881	38368881	harbor1	chr8	38198004	38198102	DNA/TcMar-Tigger	6505	-	49	38198053	29172
chr8	38168881	38368881	harbor1	chr8	38198401	38198476	DNA/TcMar-Tigger	6505	-	38	38198439	29558
chr8	38168881	38368881	harbor1	chr8	38198786	38199328	DNA/TcMar-Tigger	6505	-	271	38199057	30176
chr8	42040638	42240638	harbor1	chr8	42085935	42086134	DNA/TcMar-Tigger	6469	-	100	42086035	45397
chr8	42040638	42240638	harbor1	chr8	42086420	42087220	DNA/TcMar-Tigger	6469	-	400	42086820	46182
chr8	38169386	38369386	harbor1	chr8	38197186	38197691	DNA/TcMar-Tigger	6505	-	252	38197438	28052
chr8	38169386	38369386	harbor1	chr8	38198004	38198102	DNA/TcMar-Tigger	6505	-	49	38198053	28667
chr8	38169386	38369386	harbor1	chr8	38198401	38198476	DNA/TcMar-Tigger	6505	-	38	38198439	29053
chr8	38169386	38369386	harbor1	chr8	38198786	38199328	DNA/TcMar-Tigger	6505	-	271	38199057	29671
chr8	129907115	130107115	harbor1	chr8	129969505	129969964	DNA/TcMar-Tigger	1584	-	230	129969735	62620
chr8	8665132	8865132	harbor1	chr8	8730978	8731313	DNA/TcMar-Tigger	2054	-	168	8731146	66014
chr8	96274034	96474034	harbor1	chr8	96364554	96364864	DNA/TcMar-Tigger	1045	-	155	96364709	90675
chr8	38169249	38369249	harbor1	chr8	38197186	38197691	DNA/TcMar-Tigger	6505	-	252	38197438	28189
chr8	38169249	38369249	harbor1	chr8	38198004	38198102	DNA/TcMar-Tigger	6505	-	49	38198053	28804
chr8	38169249	38369249	harbor1	chr8	38198401	38198476	DNA/TcMar-Tigger	6505	-	38	38198439	29190
chr8	38169249	38369249	harbor1	chr8	38198786	38199328	DNA/TcMar-Tigger	6505	-	271	38199057	29808
chr8	142524970	142724970	harbor1	chr8	142557866	142559182	DNA/TcMar-Tigger	5722	-	658	142558524	33554
chr8	38169207	38369207	harbor1	chr8	38197186	38197691	DNA/TcMar-Tigger	6505	-	252	38197438	28231
chr8	38169207	38369207	harbor1	chr8	38198004	38198102	DNA/TcMar-Tigger	6505	-	49	38198053	28846
chr8	38169207	38369207	harbor1	chr8	38198401	38198476	DNA/TcMar-Tigger	6505	-	38	38198439	29232
chr8	38169207	38369207	harbor1	chr8	38198786	38199328	DNA/TcMar-Tigger	6505	-	271	38199057	29850
chr8	40746828	40946828	harbor1	chr8	40756673	40756927	DNA/TcMar-Tigger	1347	-	127	40756800	9972
chr8	40746828	40946828	harbor1	chr8	40756939	40757354	DNA/TcMar-Tigger	2141	-	208	40757147	10319
chr8	40746828	40946828	harbor1	chr8	40780112	40780445	DNA/TcMar-Tigger	1755	-	166	40780278	33450
chr8	40746828	40946828	harbor1	chr8	40787240	40787954	DNA/TcMar-Tigger	4101	-	357	40787597	40769
chr8	142240188	142440188	harbor1	chr8	142307392	142307728	DNA/TcMar-Tigger	1633	-	168	142307560	67372
chr8	142240188	142440188	harbor1	chr8	142311988	142312241	DNA/TcMar-Tigger	1339	-	126	142312114	71926
chr8	38169250	38369250	harbor1	chr8	38197186	38197691	DNA/TcMar-Tigger	6505	-	252	38197438	28188
chr8	38169250	38369250	harbor1	chr8	38198004	38198102	DNA/TcMar-Tigger	6505	-	49	38198053	28803
chr8	38169250	38369250	harbor1	chr8	38198401	38198476	DNA/TcMar-Tigger	6505	-	38	38198439	29189
chr8	38169250	38369250	harbor1	chr8	38198786	38199328	DNA/TcMar-Tigger	6505	-	271	38199057	29807
chr8	39955067	40155067	harbor1	chr8	40027525	40027858	DNA/TcMar-Tigger	929	-	166	40027691	72624
chr8	66077981	66277981	harbor1	chr8	66105657	66107166	DNA/TcMar-Tigger	8982	-	754	66106411	28430
chr8	60552749	60752749	harbor1	chr8	60581022	60581127	DNA/TcMar-Tigger	544	-	52	60581074	28325
chr8	60552749	60752749	harbor1	chr8	60581117	60581140	DNA/TcMar-Tigger	1533	-	12	60581129	28380
chr8	60552749	60752749	harbor1	chr8	60581335	60581587	DNA/TcMar-Tigger	1533	-	126	60581461	28712
chr8	60552749	60752749	harbor1	chr8	60593150	60593276	DNA/TcMar-Tigger	779	-	63	60593213	40464
chr8	142524135	142724135	harbor1	chr8	142557866	142559182	DNA/TcMar-Tigger	5722	-	658	142558524	34389
chr8	10625860	10825860	harbor1	chr8	10684575	10684687	DNA/TcMar-Tigger	421	-	56	10684631	58771
chr8	10625860	10825860	harbor1	chr8	10684665	10685183	DNA/TcMar-Tigger	2771	-	259	10684924	59064
chr8	10625860	10825860	harbor1	chr8	10689544	10689922	DNA/TcMar-Tigger	2058	-	189	10689733	63873
chr8	66405191	66605191	harbor1	chr8	66498500	66498597	DNA/TcMar-Tigger	610	-	48	66498548	93357
chr8	66405191	66605191	harbor1	chr8	66498630	66498858	DNA/TcMar-Tigger	1182	-	114	66498744	93553
chr8	124796482	124996482	harbor1	chr8	124845694	124846062	DNA/TcMar-Tigger	1892	-	184	124845878	49396
chr8	124796482	124996482	harbor1	chr8	124846300	124846325	DNA/TcMar-Tigger	1892	-	12	124846312	49830
chr8	124796482	124996482	harbor1	chr8	124846630	124846908	DNA/TcMar-Tigger	1847	-	139	124846769	50287
chr8	124796482	124996482	harbor1	chr8	124854766	124855124	DNA/TcMar-Tigger	2305	-	179	124854945	58463
chr8	124796482	124996482	harbor1	chr8	124871404	124871613	DNA/TcMar-Tigger	1210	-	104	124871508	75026
chr8	124796482	124996482	harbor1	chr8	124871908	124871961	DNA/TcMar-Tigger	1210	-	26	124871934	75452
chr8	42040276	42240276	harbor1	chr8	42085935	42086134	DNA/TcMar-Tigger	6469	-	100	42086035	45759
chr8	42040276	42240276	harbor1	chr8	42086420	42087220	DNA/TcMar-Tigger	6469	-	400	42086820	46544
chr8	98847692	99047692	harbor1	chr8	98879094	98879382	DNA/TcMar-Tigger	1844	-	144	98879238	31546
chr8	98847692	99047692	harbor1	chr8	98886678	98886815	DNA/TcMar-Tigger	1303	-	68	98886746	39054
chr8	98847692	99047692	harbor1	chr8	98887116	98887255	DNA/TcMar-Tigger	1303	-	70	98887186	39494
chr8	142524987	142724987	harbor1	chr8	142557866	142559182	DNA/TcMar-Tigger	5722	-	658	142558524	33537
chr8	142524957	142724957	harbor1	chr8	142557866	142559182	DNA/TcMar-Tigger	5722	-	658	142558524	33567
chr8	143958376	144158376	harbor1	chr8	143967548	143967639	DNA/TcMar-Tigger	550	-	46	143967594	9218
chr8	142482825	142682825	harbor1	chr8	142557866	142559182	DNA/TcMar-Tigger	5722	-	658	142558524	75699
chr8	57161177	57361177	harbor1	chr8	57177370	57178433	DNA/TcMar-Tigger	6454	-	532	57177902	16725
chr8	53743525	53943525	harbor1	chr8	53745543	53745992	DNA/TcMar-Tigger	1664	-	224	53745767	2242
chr8	53743525	53943525	harbor1	chr8	53750411	53750562	DNA/TcMar-Tigger	654	-	76	53750487	6962
chr8	53743525	53943525	harbor1	chr8	53806792	53806986	DNA/TcMar-Tigger	1065	-	97	53806889	63364
chr8	53743525	53943525	harbor1	chr8	53831148	53831484	DNA/TcMar-Tigger	1794	-	168	53831316	87791
chr8	27322694	27522694	harbor1	chr8	27394289	27395390	DNA/TcMar-Tigger	6442	-	550	27394839	72145
chr8	27322694	27522694	harbor1	chr8	27393950	27394131	DNA/TcMar-Tigger	834	-	90	27394040	71346
chr8	85145876	85345876	harbor1	chr8	85209460	85209732	DNA/TcMar-Tigger	1396	-	136	85209596	63720
chr8	85144970	85344970	harbor1	chr8	85209460	85209732	DNA/TcMar-Tigger	1396	-	136	85209596	64626
chr8	142523652	142723652	harbor1	chr8	142557866	142559182	DNA/TcMar-Tigger	5722	-	658	142558524	34872
chr8	42040690	42240690	harbor1	chr8	42085935	42086134	DNA/TcMar-Tigger	6469	-	100	42086035	45345
chr8	42040690	42240690	harbor1	chr8	42086420	42087220	DNA/TcMar-Tigger	6469	-	400	42086820	46130
chr8	78034557	78234557	harbor1	chr8	78110438	78110617	DNA/TcMar-Tigger	820	-	90	78110528	75971
chr8	38168585	38368585	harbor1	chr8	38197186	38197691	DNA/TcMar-Tigger	6505	-	252	38197438	28853
chr8	38168585	38368585	harbor1	chr8	38198004	38198102	DNA/TcMar-Tigger	6505	-	49	38198053	29468
chr8	38168585	38368585	harbor1	chr8	38198401	38198476	DNA/TcMar-Tigger	6505	-	38	38198439	29854
chr8	38168585	38368585	harbor1	chr8	38198786	38199328	DNA/TcMar-Tigger	6505	-	271	38199057	30472
chr8	17984183	18184183	harbor1	chr8	18032760	18032942	DNA/TcMar-Tigger	771	-	91	18032851	48668
chr8	38169173	38369173	harbor1	chr8	38197186	38197691	DNA/TcMar-Tigger	6505	-	252	38197438	28265
chr8	38169173	38369173	harbor1	chr8	38198004	38198102	DNA/TcMar-Tigger	6505	-	49	38198053	28880
chr8	38169173	38369173	harbor1	chr8	38198401	38198476	DNA/TcMar-Tigger	6505	-	38	38198439	29266
chr8	38169173	38369173	harbor1	chr8	38198786	38199328	DNA/TcMar-Tigger	6505	-	271	38199057	29884
chr8	38167320	38367320	harbor1	chr8	38197186	38197691	DNA/TcMar-Tigger	6505	-	252	38197438	30118
chr8	38167320	38367320	harbor1	chr8	38198004	38198102	DNA/TcMar-Tigger	6505	-	49	38198053	30733
chr8	38167320	38367320	harbor1	chr8	38198401	38198476	DNA/TcMar-Tigger	6505	-	38	38198439	31119
chr8	38167320	38367320	harbor1	chr8	38198786	38199328	DNA/TcMar-Tigger	6505	-	271	38199057	31737
chr8	100618244	100818244	harbor1	chr8	100700309	100700357	DNA/TcMar-Tigger	1503	-	24	100700333	82089
chr8	100618244	100818244	harbor1	chr8	100700667	100700701	DNA/TcMar-Tigger	1503	-	17	100700684	82440
chr8	100618244	100818244	harbor1	chr8	100700978	100701295	DNA/TcMar-Tigger	1503	-	158	100701136	82892
chr8	100618244	100818244	harbor1	chr8	100701289	100701441	DNA/TcMar-Tigger	722	-	76	100701365	83121
chr8	54002046	54202046	harbor1	chr8	54097706	54097940	DNA/TcMar-Tigger	2710	-	117	54097823	95777
chr8	54002046	54202046	harbor1	chr8	54098239	54098396	DNA/TcMar-Tigger	2710	-	78	54098317	96271
chr8	54002046	54202046	harbor1	chr8	54098709	54098832	DNA/TcMar-Tigger	2710	-	62	54098771	96725
chr8	38169375	38369375	harbor1	chr8	38197186	38197691	DNA/TcMar-Tigger	6505	-	252	38197438	28063
chr8	38169375	38369375	harbor1	chr8	38198004	38198102	DNA/TcMar-Tigger	6505	-	49	38198053	28678
chr8	38169375	38369375	harbor1	chr8	38198401	38198476	DNA/TcMar-Tigger	6505	-	38	38198439	29064
chr8	38169375	38369375	harbor1	chr8	38198786	38199328	DNA/TcMar-Tigger	6505	-	271	38199057	29682
chr8	142524862	142724862	harbor1	chr8	142557866	142559182	DNA/TcMar-Tigger	5722	-	658	142558524	33662
chr8	17057584	17257584	harbor1	chr8	17070778	17070875	DNA/TcMar-Tigger	485	-	48	17070826	13242
chr8	17057584	17257584	harbor1	chr8	17070874	17071140	DNA/TcMar-Tigger	1591	-	133	17071007	13423
chr8	35278099	35478099	harbor1	chr8	35292520	35292706	DNA/TcMar-Tigger	14910	-	93	35292613	14514
chr8	35278099	35478099	harbor1	chr8	35292987	35295490	DNA/TcMar-Tigger	14910	-	1252	35294239	16140
chr8	35278099	35478099	harbor1	chr8	35356326	35357069	DNA/TcMar-Tigger	3321	-	372	35356698	78599
chr8	142524984	142724984	harbor1	chr8	142557866	142559182	DNA/TcMar-Tigger	5722	-	658	142558524	33540
chr8	38167968	38367968	harbor1	chr8	38197186	38197691	DNA/TcMar-Tigger	6505	-	252	38197438	29470
chr8	38167968	38367968	harbor1	chr8	38198004	38198102	DNA/TcMar-Tigger	6505	-	49	38198053	30085
chr8	38167968	38367968	harbor1	chr8	38198401	38198476	DNA/TcMar-Tigger	6505	-	38	38198439	30471
chr8	38167968	38367968	harbor1	chr8	38198786	38199328	DNA/TcMar-Tigger	6505	-	271	38199057	31089
chr8	23146666	23346666	harbor1	chr8	23154376	23154628	DNA/TcMar-Tigger	727	-	126	23154502	7836
chr8	8665131	8865131	harbor1	chr8	8730978	8731313	DNA/TcMar-Tigger	2054	-	168	8731146	66015
chr8	143960625	144160625	harbor1	chr8	143967548	143967639	DNA/TcMar-Tigger	550	-	46	143967594	6969
chr8	142524964	142724964	harbor1	chr8	142557866	142559182	DNA/TcMar-Tigger	5722	-	658	142558524	33560
chr8	142524925	142724925	harbor1	chr8	142557866	142559182	DNA/TcMar-Tigger	5722	-	658	142558524	33599
chr8	42040636	42240636	harbor1	chr8	42085935	42086134	DNA/TcMar-Tigger	6469	-	100	42086035	45399
chr8	42040636	42240636	harbor1	chr8	42086420	42087220	DNA/TcMar-Tigger	6469	-	400	42086820	46184
chr8	41443390	41643390	harbor1	chr8	41450843	41451089	DNA/TcMar-Tigger	1563	-	123	41450966	7576
chr8	41443390	41643390	harbor1	chr8	41470021	41470240	DNA/TcMar-Tigger	1360	-	110	41470131	26741
chr8	41443390	41643390	harbor1	chr8	41495960	41496182	DNA/TcMar-Tigger	1357	-	111	41496071	52681
chr8	41443390	41643390	harbor1	chr8	41496167	41496445	DNA/TcMar-Tigger	1835	-	139	41496306	52916
chr8	41443390	41643390	harbor1	chr8	41520776	41520838	DNA/TcMar-Tigger	2233	-	31	41520807	77417
chr8	41443390	41643390	harbor1	chr8	41521375	41521620	DNA/TcMar-Tigger	2233	-	122	41521497	78107
chr8	41443390	41643390	harbor1	chr8	41521756	41521876	DNA/TcMar-Tigger	2233	-	60	41521816	78426
chr8	41443390	41643390	harbor1	chr8	41451415	41451536	DNA/TcMar-Tigger	634	-	60	41451475	8085
chr8	3258304	3458304	harbor1	chr8	3302216	3302891	DNA/TcMar-Tigger	2570	-	338	3302554	44250
chr8	3258304	3458304	harbor1	chr8	3311008	3311221	DNA/TcMar-Tigger	803	-	106	3311114	52810
chr8	3258304	3458304	harbor1	chr8	3311600	3311736	DNA/TcMar-Tigger	730	-	68	3311668	53364
chr8	100621232	100821232	harbor1	chr8	100700309	100700357	DNA/TcMar-Tigger	1503	-	24	100700333	79101
chr8	100621232	100821232	harbor1	chr8	100700667	100700701	DNA/TcMar-Tigger	1503	-	17	100700684	79452
chr8	100621232	100821232	harbor1	chr8	100700978	100701295	DNA/TcMar-Tigger	1503	-	158	100701136	79904
chr8	100621232	100821232	harbor1	chr8	100701289	100701441	DNA/TcMar-Tigger	722	-	76	100701365	80133
chr8	38169193	38369193	harbor1	chr8	38197186	38197691	DNA/TcMar-Tigger	6505	-	252	38197438	28245
chr8	38169193	38369193	harbor1	chr8	38198004	38198102	DNA/TcMar-Tigger	6505	-	49	38198053	28860
chr8	38169193	38369193	harbor1	chr8	38198401	38198476	DNA/TcMar-Tigger	6505	-	38	38198439	29246
chr8	38169193	38369193	harbor1	chr8	38198786	38199328	DNA/TcMar-Tigger	6505	-	271	38199057	29864
chr8	72661683	72861683	harbor1	chr8	72681338	72681906	DNA/TcMar-Tigger	3220	-	284	72681622	19939
chr8	72661683	72861683	harbor1	chr8	72704733	72705058	DNA/TcMar-Tigger	1221	-	162	72704895	43212
chr8	72661683	72861683	harbor1	chr8	72731202	72731466	DNA/TcMar-Tigger	657	-	132	72731334	69651
chr8	66405141	66605141	harbor1	chr8	66498500	66498597	DNA/TcMar-Tigger	610	-	48	66498548	93407
chr8	66405141	66605141	harbor1	chr8	66498630	66498858	DNA/TcMar-Tigger	1182	-	114	66498744	93603
chr8	144689776	144889776	harbor1	chr8	144702459	144702885	DNA/TcMar-Tigger	2489	-	213	144702672	12896
chr8	144689776	144889776	harbor1	chr8	144727290	144727817	DNA/TcMar-Tigger	6155	-	264	144727554	37778
chr8	144689776	144889776	harbor1	chr8	144727975	144728381	DNA/TcMar-Tigger	6155	-	203	144728178	38402
chr8	144689776	144889776	harbor1	chr8	144728680	144728808	DNA/TcMar-Tigger	6155	-	64	144728744	38968
chr8	144689776	144889776	harbor1	chr8	144729109	144729165	DNA/TcMar-Tigger	6155	-	28	144729137	39361
chr8	144689776	144889776	harbor1	chr8	144742771	144742975	DNA/TcMar-Tigger	981	-	102	144742873	53097
chr9	4663254	4863254	harbor1	chr9	4725912	4728263	DNA/TcMar-Tigger	16290	-	1176	4727088	63834
chr9	4692931	4892931	harbor1	chr9	4725912	4728263	DNA/TcMar-Tigger	16290	-	1176	4727088	34157
chr9	4692160	4892160	harbor1	chr9	4725912	4728263	DNA/TcMar-Tigger	16290	-	1176	4727088	34928
chr9	4692665	4892665	harbor1	chr9	4725912	4728263	DNA/TcMar-Tigger	16290	-	1176	4727088	34423
chr9	4692207	4892207	harbor1	chr9	4725912	4728263	DNA/TcMar-Tigger	16290	-	1176	4727088	34881
chr9	4692981	4892981	harbor1	chr9	4725912	4728263	DNA/TcMar-Tigger	16290	-	1176	4727088	34107
chr9	4692827	4892827	harbor1	chr9	4725912	4728263	DNA/TcMar-Tigger	16290	-	1176	4727088	34261
chr9	4693009	4893009	harbor1	chr9	4725912	4728263	DNA/TcMar-Tigger	16290	-	1176	4727088	34079
chr9	4663492	4863492	harbor1	chr9	4725912	4728263	DNA/TcMar-Tigger	16290	-	1176	4727088	63596
chr9	4692473	4892473	harbor1	chr9	4725912	4728263	DNA/TcMar-Tigger	16290	-	1176	4727088	34615
chr9	4663979	4863979	harbor1	chr9	4725912	4728263	DNA/TcMar-Tigger	16290	-	1176	4727088	63109
chr9	100252658	100452658	harbor1	chr9	100310998	100311115	DNA/TcMar-Tigger	732	-	58	100311056	58398
chr9	100252658	100452658	harbor1	chr9	100311407	100311488	DNA/TcMar-Tigger	732	-	40	100311447	58789
chr9	4692614	4892614	harbor1	chr9	4725912	4728263	DNA/TcMar-Tigger	16290	-	1176	4727088	34474
chr9	4692270	4892270	harbor1	chr9	4725912	4728263	DNA/TcMar-Tigger	16290	-	1176	4727088	34818
chr9	4669979	4869979	harbor1	chr9	4725912	4728263	DNA/TcMar-Tigger	16290	-	1176	4727088	57109
chr9	34027018	34227018	harbor1	chr9	34064253	34064381	DNA/TcMar-Tigger	602	-	64	34064317	37299
chr9	34027018	34227018	harbor1	chr9	34094468	34094531	DNA/TcMar-Tigger	1648	-	32	34094500	67482
chr9	34027018	34227018	harbor1	chr9	34094830	34095083	DNA/TcMar-Tigger	1648	-	126	34094956	67938
chr9	34027018	34227018	harbor1	chr9	34095685	34095726	DNA/TcMar-Tigger	1648	-	20	34095705	68687
chr9	4692437	4892437	harbor1	chr9	4725912	4728263	DNA/TcMar-Tigger	16290	-	1176	4727088	34651
chr9	4693668	4893668	harbor1	chr9	4725912	4728263	DNA/TcMar-Tigger	16290	-	1176	4727088	33420
chr9	4669278	4869278	harbor1	chr9	4725912	4728263	DNA/TcMar-Tigger	16290	-	1176	4727088	57810
chr9	4703727	4903727	harbor1	chr9	4725912	4728263	DNA/TcMar-Tigger	16290	-	1176	4727088	23361
chr9	19130921	19330921	harbor1	chr9	19220229	19220568	DNA/TcMar-Tigger	2477	-	170	19220399	89478
chr9	19130921	19330921	harbor1	chr9	19220870	19221011	DNA/TcMar-Tigger	2477	-	70	19220940	90019
chr9	4567404	4767404	harbor1	chr9	4569183	4569524	DNA/TcMar-Tigger	978	-	170	4569353	1949
chr9	4567404	4767404	harbor1	chr9	4598916	4599294	DNA/TcMar-Tigger	2078	-	189	4599105	31701
chr9	4567404	4767404	harbor1	chr9	4641262	4641359	DNA/TcMar-Tigger	538	-	48	4641310	73906
chr9	4567404	4767404	harbor1	chr9	4641417	4641672	DNA/TcMar-Tigger	1297	-	128	4641545	74141
chr9	4692442	4892442	harbor1	chr9	4725912	4728263	DNA/TcMar-Tigger	16290	-	1176	4727088	34646
chr9	4692263	4892263	harbor1	chr9	4725912	4728263	DNA/TcMar-Tigger	16290	-	1176	4727088	34825
chr9	4692767	4892767	harbor1	chr9	4725912	4728263	DNA/TcMar-Tigger	16290	-	1176	4727088	34321
chr9	4663011	4863011	harbor1	chr9	4725912	4728263	DNA/TcMar-Tigger	16290	-	1176	4727088	64077
chr9	4704642	4904642	harbor1	chr9	4725912	4728263	DNA/TcMar-Tigger	16290	-	1176	4727088	22446
chr9	95414535	95614535	harbor1	chr9	95440148	95440544	DNA/TcMar-Tigger	1826	-	198	95440346	25811
chr9	95414535	95614535	harbor1	chr9	95440572	95440692	DNA/TcMar-Tigger	619	-	60	95440632	26097
chr9	95414535	95614535	harbor1	chr9	95482251	95482579	DNA/TcMar-Tigger	916	-	164	95482415	67880
chr9	4698312	4898312	harbor1	chr9	4725912	4728263	DNA/TcMar-Tigger	16290	-	1176	4727088	28776
chr9	4663450	4863450	harbor1	chr9	4725912	4728263	DNA/TcMar-Tigger	16290	-	1176	4727088	63638
chr9	3230875	3430875	harbor1	chr9	3259535	3260259	DNA/TcMar-Tigger	1027	-	362	3259897	29022
chr9	4663900	4863900	harbor1	chr9	4725912	4728263	DNA/TcMar-Tigger	16290	-	1176	4727088	63188
chr9	83716782	83916782	harbor1	chr9	83746275	83746421	DNA/TcMar-Tigger	1459	-	73	83746348	29566
chr9	83716782	83916782	harbor1	chr9	83746716	83746916	DNA/TcMar-Tigger	1459	-	100	83746816	30034
chr9	83716782	83916782	harbor1	chr9	83810785	83811091	DNA/TcMar-Tigger	1545	-	153	83810938	94156
chr9	4692956	4892956	harbor1	chr9	4725912	4728263	DNA/TcMar-Tigger	16290	-	1176	4727088	34132
chr9	4694138	4894138	harbor1	chr9	4725912	4728263	DNA/TcMar-Tigger	16290	-	1176	4727088	32950
chr9	4692434	4892434	harbor1	chr9	4725912	4728263	DNA/TcMar-Tigger	16290	-	1176	4727088	34654
chr9	4663906	4863906	harbor1	chr9	4725912	4728263	DNA/TcMar-Tigger	16290	-	1176	4727088	63182
chr9	1	114163	harbor1	chr9	84334	84684	DNA/TcMar-Tigger	2174	-	175	84509	84508
chr9	4663278	4863278	harbor1	chr9	4725912	4728263	DNA/TcMar-Tigger	16290	-	1176	4727088	63810
chr9	35598598	35798598	harbor1	chr9	35633736	35633838	DNA/TcMar-Tigger	536	-	51	35633787	35189
chr9	4692945	4892945	harbor1	chr9	4725912	4728263	DNA/TcMar-Tigger	16290	-	1176	4727088	34143
chr9	4663875	4863875	harbor1	chr9	4725912	4728263	DNA/TcMar-Tigger	16290	-	1176	4727088	63213
chr9	4692940	4892940	harbor1	chr9	4725912	4728263	DNA/TcMar-Tigger	16290	-	1176	4727088	34148
chr9	4669568	4869568	harbor1	chr9	4725912	4728263	DNA/TcMar-Tigger	16290	-	1176	4727088	57520
chr9	4692448	4892448	harbor1	chr9	4725912	4728263	DNA/TcMar-Tigger	16290	-	1176	4727088	34640
chr9	4692452	4892452	harbor1	chr9	4725912	4728263	DNA/TcMar-Tigger	16290	-	1176	4727088	34636
chr9	4692258	4892258	harbor1	chr9	4725912	4728263	DNA/TcMar-Tigger	16290	-	1176	4727088	34830
chr9	35580921	35780921	harbor1	chr9	35633736	35633838	DNA/TcMar-Tigger	536	-	51	35633787	52866
chr9	89260220	89460220	harbor1	chr9	89307889	89308111	DNA/TcMar-Tigger	1187	-	111	89308000	47780
chr9	89260220	89460220	harbor1	chr9	89326641	89326888	DNA/TcMar-Tigger	6742	-	124	89326765	66545
chr9	89260220	89460220	harbor1	chr9	89327188	89327805	DNA/TcMar-Tigger	6742	-	308	89327496	67276
chr9	89260220	89460220	harbor1	chr9	89328101	89328405	DNA/TcMar-Tigger	6742	-	152	89328253	68033
chr9	4692158	4892158	harbor1	chr9	4725912	4728263	DNA/TcMar-Tigger	16290	-	1176	4727088	34930
chr9	4669265	4869265	harbor1	chr9	4725912	4728263	DNA/TcMar-Tigger	16290	-	1176	4727088	57823
chr9	97885114	98085114	harbor1	chr9	97885316	97885565	DNA/TcMar-Tigger	2891	-	124	97885440	326
chr9	97885114	98085114	harbor1	chr9	97894996	97895335	DNA/TcMar-Tigger	2002	-	170	97895166	10052
chr9	97885114	98085114	harbor1	chr9	97909260	97909460	DNA/TcMar-Tigger	609	-	100	97909360	24246
chr9	97885114	98085114	harbor1	chr9	97934622	97934783	DNA/TcMar-Tigger	510	-	80	97934702	49588
chr9	97885114	98085114	harbor1	chr9	97935126	97935236	DNA/TcMar-Tigger	649	-	55	97935181	50067
chr9	133586298	133786298	harbor1	chr9	133620812	133621291	DNA/TcMar-Tigger	2232	-	240	133621052	34754
chr9	133586298	133786298	harbor1	chr9	133647244	133647721	DNA/TcMar-Tigger	917	-	238	133647482	61184
chr9	133605246	133805246	harbor1	chr9	133620812	133621291	DNA/TcMar-Tigger	2232	-	240	133621052	15806
chr9	133605246	133805246	harbor1	chr9	133647244	133647721	DNA/TcMar-Tigger	917	-	238	133647482	42236
chr9	4692312	4892312	harbor1	chr9	4725912	4728263	DNA/TcMar-Tigger	16290	-	1176	4727088	34776
chr9	4692909	4892909	harbor1	chr9	4725912	4728263	DNA/TcMar-Tigger	16290	-	1176	4727088	34179
chr9	4663127	4863127	harbor1	chr9	4725912	4728263	DNA/TcMar-Tigger	16290	-	1176	4727088	63961
chr9	137734976	137934976	harbor1	chr9	137741618	137741854	DNA/TcMar-Tigger	945	-	118	137741736	6760
chr9	137734976	137934976	harbor1	chr9	137767412	137767531	DNA/TcMar-Tigger	1248	-	60	137767472	32496
chr9	137734976	137934976	harbor1	chr9	137767834	137767937	DNA/TcMar-Tigger	1248	-	52	137767886	32910
chr9	137734976	137934976	harbor1	chr9	137795050	137795401	DNA/TcMar-Tigger	2932	-	176	137795226	60250
chr9	137734976	137934976	harbor1	chr9	137795464	137795707	DNA/TcMar-Tigger	2932	-	122	137795586	60610
chr9	136008266	136208266	harbor1	chr9	136067427	136067555	DNA/TcMar-Tigger	2344	-	64	136067491	59225
chr9	136008266	136208266	harbor1	chr9	136067851	136068215	DNA/TcMar-Tigger	2344	-	182	136068033	59767
chr9	136008266	136208266	harbor1	chr9	136068519	136068639	DNA/TcMar-Tigger	2344	-	60	136068579	60313
chr9	94048912	94248912	harbor1	chr9	94069241	94069456	DNA/TcMar-Tigger	950	-	108	94069349	20437
chr9	4692971	4892971	harbor1	chr9	4725912	4728263	DNA/TcMar-Tigger	16290	-	1176	4727088	34117
chr9	112387221	112587221	harbor1	chr9	112408472	112408809	DNA/TcMar-Tigger	1805	-	168	112408640	21419
chr9	4692946	4892946	harbor1	chr9	4725912	4728263	DNA/TcMar-Tigger	16290	-	1176	4727088	34142
chr9	4663649	4863649	harbor1	chr9	4725912	4728263	DNA/TcMar-Tigger	16290	-	1176	4727088	63439
chr9	4663080	4863080	harbor1	chr9	4725912	4728263	DNA/TcMar-Tigger	16290	-	1176	4727088	64008
chr9	125322076	125522076	harbor1	chr9	125344987	125345168	DNA/TcMar-Tigger	1115	-	90	125345077	23001
chr9	125322076	125522076	harbor1	chr9	125345480	125345571	DNA/TcMar-Tigger	1115	-	46	125345526	23450
chr9	6658046	6858046	harbor1	chr9	6670162	6670469	DNA/TcMar-Tigger	810	-	154	6670316	12270
chr9	6658046	6858046	harbor1	chr9	6713577	6713832	DNA/TcMar-Tigger	1245	-	128	6713705	55659
chr9	89262840	89462840	harbor1	chr9	89307889	89308111	DNA/TcMar-Tigger	1187	-	111	89308000	45160
chr9	89262840	89462840	harbor1	chr9	89326641	89326888	DNA/TcMar-Tigger	6742	-	124	89326765	63925
chr9	89262840	89462840	harbor1	chr9	89327188	89327805	DNA/TcMar-Tigger	6742	-	308	89327496	64656
chr9	89262840	89462840	harbor1	chr9	89328101	89328405	DNA/TcMar-Tigger	6742	-	152	89328253	65413
chr9	4669986	4869986	harbor1	chr9	4725912	4728263	DNA/TcMar-Tigger	16290	-	1176	4727088	57102
chr9	4692882	4892882	harbor1	chr9	4725912	4728263	DNA/TcMar-Tigger	16290	-	1176	4727088	34206
chr9	3426384	3626384	harbor1	chr9	3432942	3433209	DNA/TcMar-Tigger	1116	-	134	3433076	6692
chr9	3426384	3626384	harbor1	chr9	3434771	3435482	DNA/TcMar-Tigger	4211	-	356	3435127	8743
chr9	3426384	3626384	harbor1	chr9	3435474	3435581	DNA/TcMar-Tigger	652	-	54	3435528	9144
chr9	3426384	3626384	harbor1	chr9	3483917	3484226	DNA/TcMar-Tigger	841	-	154	3484071	57687
chr9	3426384	3626384	harbor1	chr9	3507583	3507891	DNA/TcMar-Tigger	1179	-	154	3507737	81353
chr9	4722331	4922331	harbor1	chr9	4725912	4728263	DNA/TcMar-Tigger	16290	-	1176	4727088	4757
chr9	4663076	4863076	harbor1	chr9	4725912	4728263	DNA/TcMar-Tigger	16290	-	1176	4727088	64012
chr9	4663656	4863656	harbor1	chr9	4725912	4728263	DNA/TcMar-Tigger	16290	-	1176	4727088	63432
chr9	19130894	19330894	harbor1	chr9	19220229	19220568	DNA/TcMar-Tigger	2477	-	170	19220399	89505
chr9	19130894	19330894	harbor1	chr9	19220870	19221011	DNA/TcMar-Tigger	2477	-	70	19220940	90046
chr9	418608	618608	harbor1	chr9	447257	447917	DNA/TcMar-Tigger	2231	-	330	447587	28979
chr9	418608	618608	harbor1	chr9	480923	481274	DNA/TcMar-Tigger	2180	-	176	481099	62491
chr9	79473211	79673211	harbor1	chr9	79485181	79485541	DNA/TcMar-Tigger	682	-	180	79485361	12150
chr9	4669933	4869933	harbor1	chr9	4725912	4728263	DNA/TcMar-Tigger	16290	-	1176	4727088	57155
chr9	126427098	126627098	harbor1	chr9	126456230	126456498	DNA/TcMar-Tigger	665	-	134	126456364	29266
chr9	126427098	126627098	harbor1	chr9	126456496	126457397	DNA/TcMar-Tigger	734	-	450	126456946	29848
chr9	76918823	77118823	harbor1	chr9	76996375	76996511	DNA/TcMar-Tigger	758	-	68	76996443	77620
chr9	76918823	77118823	harbor1	chr9	77001203	77001480	DNA/TcMar-Tigger	589	-	138	77001341	82518
chr9	4663097	4863097	harbor1	chr9	4725912	4728263	DNA/TcMar-Tigger	16290	-	1176	4727088	63991
chr9	97885166	98085166	harbor1	chr9	97885316	97885565	DNA/TcMar-Tigger	2891	-	124	97885440	274
chr9	97885166	98085166	harbor1	chr9	97894996	97895335	DNA/TcMar-Tigger	2002	-	170	97895166	10000
chr9	97885166	98085166	harbor1	chr9	97909260	97909460	DNA/TcMar-Tigger	609	-	100	97909360	24194
chr9	97885166	98085166	harbor1	chr9	97934622	97934783	DNA/TcMar-Tigger	510	-	80	97934702	49536
chr9	97885166	98085166	harbor1	chr9	97935126	97935236	DNA/TcMar-Tigger	649	-	55	97935181	50015
chr9	4668976	4868976	harbor1	chr9	4725912	4728263	DNA/TcMar-Tigger	16290	-	1176	4727088	58112
chr9	93084336	93284336	harbor1	chr9	93103276	93103585	DNA/TcMar-Tigger	953	-	154	93103430	19094
chr9	4692784	4892784	harbor1	chr9	4725912	4728263	DNA/TcMar-Tigger	16290	-	1176	4727088	34304
chr9	4662994	4862994	harbor1	chr9	4725912	4728263	DNA/TcMar-Tigger	16290	-	1176	4727088	64094
chr9	104717537	104917537	harbor1	chr9	104767873	104768167	DNA/TcMar-Tigger	1112	-	147	104768020	50483
chr9	111383307	111583307	harbor1	chr9	111427503	111427854	DNA/TcMar-Tigger	2072	-	176	111427679	44372
chr9	4692921	4892921	harbor1	chr9	4725912	4728263	DNA/TcMar-Tigger	16290	-	1176	4727088	34167
chr9	112387266	112587266	harbor1	chr9	112408472	112408809	DNA/TcMar-Tigger	1805	-	168	112408640	21374
chr9	2521362	2721362	harbor1	chr9	2528741	2528941	DNA/TcMar-Tigger	540	-	100	2528841	7479
chr9	4692190	4892190	harbor1	chr9	4725912	4728263	DNA/TcMar-Tigger	16290	-	1176	4727088	34898
chr9	112387344	112587344	harbor1	chr9	112408472	112408809	DNA/TcMar-Tigger	1805	-	168	112408640	21296
chr9	4658000	4858000	harbor1	chr9	4725912	4728263	DNA/TcMar-Tigger	16290	-	1176	4727088	69088
chr9	34027036	34227036	harbor1	chr9	34064253	34064381	DNA/TcMar-Tigger	602	-	64	34064317	37281
chr9	34027036	34227036	harbor1	chr9	34094468	34094531	DNA/TcMar-Tigger	1648	-	32	34094500	67464
chr9	34027036	34227036	harbor1	chr9	34094830	34095083	DNA/TcMar-Tigger	1648	-	126	34094956	67920
chr9	34027036	34227036	harbor1	chr9	34095685	34095726	DNA/TcMar-Tigger	1648	-	20	34095705	68669
chr9	6658192	6858192	harbor1	chr9	6670162	6670469	DNA/TcMar-Tigger	810	-	154	6670316	12124
chr9	6658192	6858192	harbor1	chr9	6713577	6713832	DNA/TcMar-Tigger	1245	-	128	6713705	55513
chr9	1	129273	harbor1	chr9	84334	84684	DNA/TcMar-Tigger	2174	-	175	84509	84508
chr9	135905941	136105941	harbor1	chr9	135940157	135940297	DNA/TcMar-Tigger	708	-	70	135940227	34286
chr9	135905941	136105941	harbor1	chr9	135940598	135940893	DNA/TcMar-Tigger	708	-	148	135940746	34805
chr9	135905941	136105941	harbor1	chr9	135952696	135952899	DNA/TcMar-Tigger	988	-	102	135952798	46857
chr9	4692910	4892910	harbor1	chr9	4725912	4728263	DNA/TcMar-Tigger	16290	-	1176	4727088	34178
chr9	4663850	4863850	harbor1	chr9	4725912	4728263	DNA/TcMar-Tigger	16290	-	1176	4727088	63238
chr9	4669263	4869263	harbor1	chr9	4725912	4728263	DNA/TcMar-Tigger	16290	-	1176	4727088	57825
chr9	4597199	4797199	harbor1	chr9	4598916	4599294	DNA/TcMar-Tigger	2078	-	189	4599105	1906
chr9	4597199	4797199	harbor1	chr9	4641262	4641359	DNA/TcMar-Tigger	538	-	48	4641310	44111
chr9	4597199	4797199	harbor1	chr9	4641417	4641672	DNA/TcMar-Tigger	1297	-	128	4641545	44346
chr9	61551186	61751186	harbor1	chr9	61605963	61606099	DNA/TcMar-Tigger	3736	-	68	61606031	54845
chr9	61551186	61751186	harbor1	chr9	61606381	61606887	DNA/TcMar-Tigger	3736	-	253	61606634	55448
chr9	61551186	61751186	harbor1	chr9	61607818	61608500	DNA/TcMar-Tigger	4167	-	341	61608159	56973
chr9	4692901	4892901	harbor1	chr9	4725912	4728263	DNA/TcMar-Tigger	16290	-	1176	4727088	34187
chr9	113807755	114007755	harbor1	chr9	113864913	113865249	DNA/TcMar-Tigger	1978	-	168	113865081	57326
chr9	113807755	114007755	harbor1	chr9	113892159	113892470	DNA/TcMar-Tigger	1613	-	156	113892315	84560
chr9	97885101	98085101	harbor1	chr9	97885316	97885565	DNA/TcMar-Tigger	2891	-	124	97885440	339
chr9	97885101	98085101	harbor1	chr9	97894996	97895335	DNA/TcMar-Tigger	2002	-	170	97895166	10065
chr9	97885101	98085101	harbor1	chr9	97909260	97909460	DNA/TcMar-Tigger	609	-	100	97909360	24259
chr9	97885101	98085101	harbor1	chr9	97934622	97934783	DNA/TcMar-Tigger	510	-	80	97934702	49601
chr9	97885101	98085101	harbor1	chr9	97935126	97935236	DNA/TcMar-Tigger	649	-	55	97935181	50080
chr9	4692868	4892868	harbor1	chr9	4725912	4728263	DNA/TcMar-Tigger	16290	-	1176	4727088	34220
chr9	4692205	4892205	harbor1	chr9	4725912	4728263	DNA/TcMar-Tigger	16290	-	1176	4727088	34883
chr9	83717816	83917816	harbor1	chr9	83746275	83746421	DNA/TcMar-Tigger	1459	-	73	83746348	28532
chr9	83717816	83917816	harbor1	chr9	83746716	83746916	DNA/TcMar-Tigger	1459	-	100	83746816	29000
chr9	83717816	83917816	harbor1	chr9	83810785	83811091	DNA/TcMar-Tigger	1545	-	153	83810938	93122
chr9	4692961	4892961	harbor1	chr9	4725912	4728263	DNA/TcMar-Tigger	16290	-	1176	4727088	34127
chr9	4692661	4892661	harbor1	chr9	4725912	4728263	DNA/TcMar-Tigger	16290	-	1176	4727088	34427
chr10	102140008	102340008	harbor1	chr10	102178570	102178752	DNA/TcMar-Tigger	1046	-	91	102178661	38653
chr10	102140008	102340008	harbor1	chr10	102179525	102179683	DNA/TcMar-Tigger	1057	-	79	102179604	39596
chr10	102140008	102340008	harbor1	chr10	102180342	102180541	DNA/TcMar-Tigger	1096	-	100	102180442	40434
chr10	131310777	131510777	harbor1	chr10	131401362	131401692	DNA/TcMar-Tigger	1636	-	165	131401527	90750
chr10	97399009	97599009	harbor1	chr10	97488449	97488786	DNA/TcMar-Tigger	1897	-	168	97488617	89608
chr10	560140	760140	harbor1	chr10	595621	595838	DNA/TcMar-Tigger	614	-	108	595729	35589
chr10	560140	760140	harbor1	chr10	651880	652102	DNA/TcMar-Tigger	953	-	111	651991	91851
chr10	97398813	97598813	harbor1	chr10	97488449	97488786	DNA/TcMar-Tigger	1897	-	168	97488617	89804
chr10	49511878	49711878	harbor1	chr10	49512613	49512921	DNA/TcMar-Tigger	1998	-	154	49512767	889
chr10	49511878	49711878	harbor1	chr10	49567650	49568101	DNA/TcMar-Tigger	2730	-	226	49567876	55998
chr10	49511878	49711878	harbor1	chr10	49568086	49568154	DNA/TcMar-Tigger	456	-	34	49568120	56242
chr10	49511878	49711878	harbor1	chr10	49574290	49574721	DNA/TcMar-Tigger	5800	-	216	49574506	62628
chr10	49511878	49711878	harbor1	chr10	49574973	49575410	DNA/TcMar-Tigger	5800	-	218	49575191	63313
chr10	49511878	49711878	harbor1	chr10	49575694	49575905	DNA/TcMar-Tigger	5800	-	106	49575800	63922
chr10	102141807	102341807	harbor1	chr10	102178570	102178752	DNA/TcMar-Tigger	1046	-	91	102178661	36854
chr10	102141807	102341807	harbor1	chr10	102179525	102179683	DNA/TcMar-Tigger	1057	-	79	102179604	37797
chr10	102141807	102341807	harbor1	chr10	102180342	102180541	DNA/TcMar-Tigger	1096	-	100	102180442	38635
chr10	7566933	7766933	harbor1	chr10	7571265	7571406	DNA/TcMar-Tigger	1628	-	70	7571335	4402
chr10	7566933	7766933	harbor1	chr10	7571717	7571932	DNA/TcMar-Tigger	1628	-	108	7571825	4892
chr10	37911041	38111041	harbor1	chr10	37926413	37926612	DNA/TcMar-Tigger	903	-	100	37926513	15472
chr10	69458832	69658832	harbor1	chr10	69490262	69490438	DNA/TcMar-Tigger	1284	-	88	69490350	31518
chr10	69458832	69658832	harbor1	chr10	69490750	69490927	DNA/TcMar-Tigger	1284	-	88	69490838	32006
chr10	69458832	69658832	harbor1	chr10	69537197	69537410	DNA/TcMar-Tigger	1093	-	106	69537303	78471
chr10	13709746	13909746	harbor1	chr10	13748355	13748593	DNA/TcMar-Tigger	1388	-	119	13748474	38728
chr10	133103372	133303372	harbor1	chr10	133119270	133119743	DNA/TcMar-Tigger	2757	-	236	133119506	16134
chr10	133103372	133303372	harbor1	chr10	133120421	133121320	DNA/TcMar-Tigger	7010	-	450	133120871	17499
chr10	133103372	133303372	harbor1	chr10	133119738	133120121	DNA/TcMar-Tigger	7010	-	192	133119930	16558
chr10	92188891	92388891	harbor1	chr10	92219155	92219461	DNA/TcMar-Tigger	683	-	153	92219308	30417
chr10	92188891	92388891	harbor1	chr10	92248060	92248416	DNA/TcMar-Tigger	2053	-	178	92248238	59347
chr10	100897233	101097233	harbor1	chr10	100939887	100940220	DNA/TcMar-Tigger	1042	-	166	100940053	42820
chr10	100897233	101097233	harbor1	chr10	100941142	100941309	DNA/TcMar-Tigger	567	-	84	100941226	43993
chr10	97398947	97598947	harbor1	chr10	97488449	97488786	DNA/TcMar-Tigger	1897	-	168	97488617	89670
chr10	113669309	113869309	harbor1	chr10	113669805	113670128	DNA/TcMar-Tigger	1450	-	162	113669967	658
chr10	113669309	113869309	harbor1	chr10	113686624	113686983	DNA/TcMar-Tigger	1975	-	180	113686804	17495
chr10	113669309	113869309	harbor1	chr10	113757325	113758588	DNA/TcMar-Tigger	8628	-	632	113757957	88648
chr10	113669309	113869309	harbor1	chr10	113758585	113759075	DNA/TcMar-Tigger	2946	-	245	113758830	89521
chr10	102140695	102340695	harbor1	chr10	102178570	102178752	DNA/TcMar-Tigger	1046	-	91	102178661	37966
chr10	102140695	102340695	harbor1	chr10	102179525	102179683	DNA/TcMar-Tigger	1057	-	79	102179604	38909
chr10	102140695	102340695	harbor1	chr10	102180342	102180541	DNA/TcMar-Tigger	1096	-	100	102180442	39747
chr10	102141695	102341695	harbor1	chr10	102178570	102178752	DNA/TcMar-Tigger	1046	-	91	102178661	36966
chr10	102141695	102341695	harbor1	chr10	102179525	102179683	DNA/TcMar-Tigger	1057	-	79	102179604	37909
chr10	102141695	102341695	harbor1	chr10	102180342	102180541	DNA/TcMar-Tigger	1096	-	100	102180442	38747
chr10	6020235	6220235	harbor1	chr10	6093701	6093968	DNA/TcMar-Tigger	1813	-	134	6093835	73600
chr10	6020235	6220235	harbor1	chr10	6094278	6094362	DNA/TcMar-Tigger	1813	-	42	6094320	74085
chr10	6020235	6220235	harbor1	chr10	6099431	6099639	DNA/TcMar-Tigger	1295	-	104	6099535	79300
chr10	102141682	102341682	harbor1	chr10	102178570	102178752	DNA/TcMar-Tigger	1046	-	91	102178661	36979
chr10	102141682	102341682	harbor1	chr10	102179525	102179683	DNA/TcMar-Tigger	1057	-	79	102179604	37922
chr10	102141682	102341682	harbor1	chr10	102180342	102180541	DNA/TcMar-Tigger	1096	-	100	102180442	38760
chr10	3072743	3272743	harbor1	chr10	3132814	3133074	DNA/TcMar-Tigger	1301	-	130	3132944	60201
chr10	3072743	3272743	harbor1	chr10	3139998	3140432	DNA/TcMar-Tigger	979	-	217	3140215	67472
chr10	3072743	3272743	harbor1	chr10	3151504	3151735	DNA/TcMar-Tigger	741	-	116	3151620	78877
chr10	3072743	3272743	harbor1	chr10	3152047	3152156	DNA/TcMar-Tigger	741	-	54	3152101	79358
chr10	114721980	114921980	harbor1	chr10	114800576	114800630	DNA/TcMar-Tigger	1277	-	27	114800603	78623
chr10	114721980	114921980	harbor1	chr10	114800937	114801124	DNA/TcMar-Tigger	1277	-	94	114801031	79051
chr10	114721980	114921980	harbor1	chr10	114801253	114801474	DNA/TcMar-Tigger	1234	-	110	114801363	79383
chr10	62704867	62904867	harbor1	chr10	62751226	62751417	DNA/TcMar-Tigger	973	-	96	62751322	46455
chr10	78346452	78546452	harbor1	chr10	78400836	78400892	DNA/TcMar-Tigger	650	-	28	78400864	54412
chr10	78346452	78546452	harbor1	chr10	78401204	78401300	DNA/TcMar-Tigger	650	-	48	78401252	54800
chr10	2967276	3167276	harbor1	chr10	2982412	2982727	DNA/TcMar-Tigger	598	-	158	2982570	15294
chr10	2967276	3167276	harbor1	chr10	2991139	2991538	DNA/TcMar-Tigger	2534	-	200	2991339	24063
chr10	2967276	3167276	harbor1	chr10	2991830	2992057	DNA/TcMar-Tigger	2534	-	114	2991944	24668
chr10	2967276	3167276	harbor1	chr10	3057261	3057699	DNA/TcMar-Tigger	1897	-	219	3057480	90204
chr10	96887352	97087352	harbor1	chr10	96902824	96903416	DNA/TcMar-Tigger	3292	-	296	96903120	15768
chr10	96887352	97087352	harbor1	chr10	96927796	96930215	DNA/TcMar-Tigger	14361	-	1210	96929006	41654
chr10	96887352	97087352	harbor1	chr10	96936791	96937045	DNA/TcMar-Tigger	1417	-	127	96936918	49566
chr10	131255629	131455629	harbor1	chr10	131265547	131266391	DNA/TcMar-Tigger	5488	-	422	131265969	10340
chr10	131255629	131455629	harbor1	chr10	131266379	131266479	DNA/TcMar-Tigger	494	-	50	131266429	10800
chr10	131255629	131455629	harbor1	chr10	131269487	131269895	DNA/TcMar-Tigger	7789	-	204	131269691	14062
chr10	131255629	131455629	harbor1	chr10	131268256	131269176	DNA/TcMar-Tigger	7789	-	460	131268716	13087
chr10	43100314	43300314	harbor1	chr10	43178176	43178340	DNA/TcMar-Tigger	1011	-	82	43178258	77944
chr10	43100314	43300314	harbor1	chr10	43178637	43178791	DNA/TcMar-Tigger	1011	-	77	43178714	78400
chr10	100897105	101097105	harbor1	chr10	100939887	100940220	DNA/TcMar-Tigger	1042	-	166	100940053	42948
chr10	100897105	101097105	harbor1	chr10	100941142	100941309	DNA/TcMar-Tigger	567	-	84	100941226	44121
chr10	48299633	48499633	harbor1	chr10	48312976	48313144	DNA/TcMar-Tigger	507	-	84	48313060	13427
chr10	48299633	48499633	harbor1	chr10	48313453	48313642	DNA/TcMar-Tigger	553	-	94	48313547	13914
chr10	48299633	48499633	harbor1	chr10	48351752	48351977	DNA/TcMar-Tigger	1381	-	112	48351864	52231
chr10	96974852	97174852	harbor1	chr10	97013034	97013365	DNA/TcMar-Tigger	1024	-	166	97013200	38348
chr10	68131746	68331746	harbor1	chr10	68197759	68197854	DNA/TcMar-Tigger	565	-	48	68197807	66061
chr10	68131746	68331746	harbor1	chr10	68197860	68198081	DNA/TcMar-Tigger	1223	-	110	68197970	66224
chr10	97398990	97598990	harbor1	chr10	97488449	97488786	DNA/TcMar-Tigger	1897	-	168	97488617	89627
chr10	97398875	97598875	harbor1	chr10	97488449	97488786	DNA/TcMar-Tigger	1897	-	168	97488617	89742
chr10	95979828	96179828	harbor1	chr10	96029612	96029799	DNA/TcMar-Tigger	702	-	94	96029706	49878
chr10	95979828	96179828	harbor1	chr10	96030112	96030199	DNA/TcMar-Tigger	702	-	44	96030156	50328
chr10	43474486	43674486	harbor1	chr10	43500944	43501457	DNA/TcMar-Tigger	3353	-	256	43501200	26714
chr10	43474486	43674486	harbor1	chr10	43501766	43501786	DNA/TcMar-Tigger	3353	-	10	43501776	27290
chr10	43474486	43674486	harbor1	chr10	43521088	43521721	DNA/TcMar-Tigger	2936	-	316	43521404	46918
chr10	131310773	131510773	harbor1	chr10	131401362	131401692	DNA/TcMar-Tigger	1636	-	165	131401527	90754
chr10	22219191	22419191	harbor1	chr10	22249181	22249491	DNA/TcMar-Tigger	1581	-	155	22249336	30145
chr10	46184879	46384879	harbor1	chr10	46245407	46245543	DNA/TcMar-Tigger	539	-	68	46245475	60596
chr10	131309416	131509416	harbor1	chr10	131401362	131401692	DNA/TcMar-Tigger	1636	-	165	131401527	92111
chr10	62704945	62904945	harbor1	chr10	62751226	62751417	DNA/TcMar-Tigger	973	-	96	62751322	46377
chr10	35265	235265	harbor1	chr10	134051	134295	DNA/TcMar-Tigger	1220	-	122	134173	98908
chr10	102141613	102341613	harbor1	chr10	102178570	102178752	DNA/TcMar-Tigger	1046	-	91	102178661	37048
chr10	102141613	102341613	harbor1	chr10	102179525	102179683	DNA/TcMar-Tigger	1057	-	79	102179604	37991
chr10	102141613	102341613	harbor1	chr10	102180342	102180541	DNA/TcMar-Tigger	1096	-	100	102180442	38829
chr10	110707741	110907741	harbor1	chr10	110778310	110778428	DNA/TcMar-Tigger	506	-	59	110778369	70628
chr10	62704875	62904875	harbor1	chr10	62751226	62751417	DNA/TcMar-Tigger	973	-	96	62751322	46447
chr10	69472286	69672286	harbor1	chr10	69490262	69490438	DNA/TcMar-Tigger	1284	-	88	69490350	18064
chr10	69472286	69672286	harbor1	chr10	69490750	69490927	DNA/TcMar-Tigger	1284	-	88	69490838	18552
chr10	69472286	69672286	harbor1	chr10	69537197	69537410	DNA/TcMar-Tigger	1093	-	106	69537303	65017
chr11	112678749	112878749	harbor1	chr11	112729723	112729844	DNA/TcMar-Tigger	887	-	60	112729783	51034
chr11	112678749	112878749	harbor1	chr11	112729845	112729924	DNA/TcMar-Tigger	1848	-	40	112729885	51136
chr11	112678749	112878749	harbor1	chr11	112730454	112730653	DNA/TcMar-Tigger	1848	-	100	112730554	51805
chr11	112678749	112878749	harbor1	chr11	112730962	112731030	DNA/TcMar-Tigger	1848	-	34	112730996	52247
chr11	112678749	112878749	harbor1	chr11	112731031	112731227	DNA/TcMar-Tigger	437	-	98	112731129	52380
chr11	5127157	5327157	harbor1	chr11	5187925	5188097	DNA/TcMar-Tigger	428	-	86	5188011	60854
chr11	5127156	5327156	harbor1	chr11	5187925	5188097	DNA/TcMar-Tigger	428	-	86	5188011	60855
chr11	5129450	5329450	harbor1	chr11	5187925	5188097	DNA/TcMar-Tigger	428	-	86	5188011	58561
chr11	5127277	5327277	harbor1	chr11	5187925	5188097	DNA/TcMar-Tigger	428	-	86	5188011	60734
chr11	5127135	5327135	harbor1	chr11	5187925	5188097	DNA/TcMar-Tigger	428	-	86	5188011	60876
chr11	5127181	5327181	harbor1	chr11	5187925	5188097	DNA/TcMar-Tigger	428	-	86	5188011	60830
chr11	5127341	5327341	harbor1	chr11	5187925	5188097	DNA/TcMar-Tigger	428	-	86	5188011	60670
chr11	5127230	5327230	harbor1	chr11	5187925	5188097	DNA/TcMar-Tigger	428	-	86	5188011	60781
chr11	68642659	68842659	harbor1	chr11	68679959	68680097	DNA/TcMar-Tigger	1727	-	69	68680028	37369
chr11	68642659	68842659	harbor1	chr11	68680413	68680641	DNA/TcMar-Tigger	1727	-	114	68680527	37868
chr11	64537901	64737901	harbor1	chr11	64565915	64566011	DNA/TcMar-Tigger	607	-	48	64565963	28062
chr11	64537901	64737901	harbor1	chr11	64566262	64566715	DNA/TcMar-Tigger	607	-	226	64566488	28587
chr11	5134663	5334663	harbor1	chr11	5187925	5188097	DNA/TcMar-Tigger	428	-	86	5188011	53348
chr11	102246099	102446099	harbor1	chr11	102276437	102276596	DNA/TcMar-Tigger	477	-	80	102276517	30418
chr11	2054543	2254543	harbor1	chr11	2066423	2066742	DNA/TcMar-Tigger	1064	-	160	2066583	12040
chr11	2054543	2254543	harbor1	chr11	2066830	2069172	DNA/TcMar-Tigger	14403	-	1171	2068001	13458
chr11	2054543	2254543	harbor1	chr11	2069591	2069934	DNA/TcMar-Tigger	1569	-	172	2069763	15220
chr11	5126804	5326804	harbor1	chr11	5187925	5188097	DNA/TcMar-Tigger	428	-	86	5188011	61207
chr11	5127222	5327222	harbor1	chr11	5187925	5188097	DNA/TcMar-Tigger	428	-	86	5188011	60789
chr11	5127226	5327226	harbor1	chr11	5187925	5188097	DNA/TcMar-Tigger	428	-	86	5188011	60785
chr11	57399763	57599763	harbor1	chr11	57442707	57443096	DNA/TcMar-Tigger	6019	-	194	57442901	43138
chr11	57399763	57599763	harbor1	chr11	57443391	57443687	DNA/TcMar-Tigger	6019	-	148	57443539	43776
chr11	57399763	57599763	harbor1	chr11	57443996	57444276	DNA/TcMar-Tigger	4319	-	140	57444136	44373
chr11	57399763	57599763	harbor1	chr11	57441991	57442392	DNA/TcMar-Tigger	6019	-	200	57442191	42428
chr11	89682097	89882097	harbor1	chr11	89687691	89687906	DNA/TcMar-Tigger	1246	-	108	89687799	5702
chr11	89682097	89882097	harbor1	chr11	89687972	89688003	DNA/TcMar-Tigger	1246	-	16	89687988	5891
chr11	119387210	119587210	harbor1	chr11	119388703	119389112	DNA/TcMar-Tigger	942	-	204	119388907	1697
chr11	119387210	119587210	harbor1	chr11	119460796	119461144	DNA/TcMar-Tigger	2143	-	174	119460970	73760
chr11	119387210	119587210	harbor1	chr11	119473975	119474272	DNA/TcMar-Tigger	1533	-	148	119474123	86913
chr11	119387210	119587210	harbor1	chr11	119471987	119472390	DNA/TcMar-Tigger	2248	-	202	119472189	84979
chr11	5127150	5327150	harbor1	chr11	5187925	5188097	DNA/TcMar-Tigger	428	-	86	5188011	60861
chr11	5127250	5327250	harbor1	chr11	5187925	5188097	DNA/TcMar-Tigger	428	-	86	5188011	60761
chr11	2054521	2254521	harbor1	chr11	2066423	2066742	DNA/TcMar-Tigger	1064	-	160	2066583	12062
chr11	2054521	2254521	harbor1	chr11	2066830	2069172	DNA/TcMar-Tigger	14403	-	1171	2068001	13480
chr11	2054521	2254521	harbor1	chr11	2069591	2069934	DNA/TcMar-Tigger	1569	-	172	2069763	15242
chr11	5126803	5326803	harbor1	chr11	5187925	5188097	DNA/TcMar-Tigger	428	-	86	5188011	61208
chr11	5134612	5334612	harbor1	chr11	5187925	5188097	DNA/TcMar-Tigger	428	-	86	5188011	53399
chr11	5134133	5334133	harbor1	chr11	5187925	5188097	DNA/TcMar-Tigger	428	-	86	5188011	53878
chr11	113773314	113973314	harbor1	chr11	113774564	113774866	DNA/TcMar-Tigger	952	-	151	113774715	1401
chr11	113773314	113973314	harbor1	chr11	113809390	113809641	DNA/TcMar-Tigger	1123	-	126	113809516	36202
chr11	46034956	46234956	harbor1	chr11	46054858	46055465	DNA/TcMar-Tigger	1801	-	304	46055162	20206
chr11	119643315	119843315	harbor1	chr11	119717967	119718088	DNA/TcMar-Tigger	415	-	60	119718027	74712
chr11	119643315	119843315	harbor1	chr11	119718827	119719158	DNA/TcMar-Tigger	1948	-	166	119718993	75678
chr11	5125277	5325277	harbor1	chr11	5187925	5188097	DNA/TcMar-Tigger	428	-	86	5188011	62734
chr11	108021540	108221540	harbor1	chr11	108055303	108055396	DNA/TcMar-Tigger	426	-	46	108055349	33809
chr11	108021540	108221540	harbor1	chr11	108090833	108091040	DNA/TcMar-Tigger	604	-	104	108090937	69397
chr11	108021540	108221540	harbor1	chr11	108091351	108091381	DNA/TcMar-Tigger	604	-	15	108091366	69826
chr11	108021540	108221540	harbor1	chr11	108093169	108093719	DNA/TcMar-Tigger	2359	-	275	108093444	71904
chr11	108021540	108221540	harbor1	chr11	108093980	108094207	DNA/TcMar-Tigger	2359	-	114	108094094	72554
chr11	5125978	5325978	harbor1	chr11	5187925	5188097	DNA/TcMar-Tigger	428	-	86	5188011	62033
chr11	57399760	57599760	harbor1	chr11	57442707	57443096	DNA/TcMar-Tigger	6019	-	194	57442901	43141
chr11	57399760	57599760	harbor1	chr11	57443391	57443687	DNA/TcMar-Tigger	6019	-	148	57443539	43779
chr11	57399760	57599760	harbor1	chr11	57443996	57444276	DNA/TcMar-Tigger	4319	-	140	57444136	44376
chr11	57399760	57599760	harbor1	chr11	57441991	57442392	DNA/TcMar-Tigger	6019	-	200	57442191	42431
chr11	5127141	5327141	harbor1	chr11	5187925	5188097	DNA/TcMar-Tigger	428	-	86	5188011	60870
chr11	5127172	5327172	harbor1	chr11	5187925	5188097	DNA/TcMar-Tigger	428	-	86	5188011	60839
chr11	5134086	5334086	harbor1	chr11	5187925	5188097	DNA/TcMar-Tigger	428	-	86	5188011	53925
chr11	5127261	5327261	harbor1	chr11	5187925	5188097	DNA/TcMar-Tigger	428	-	86	5188011	60750
chr11	5134533	5334533	harbor1	chr11	5187925	5188097	DNA/TcMar-Tigger	428	-	86	5188011	53478
chr11	5126745	5326745	harbor1	chr11	5187925	5188097	DNA/TcMar-Tigger	428	-	86	5188011	61266
chr11	46185687	46385687	harbor1	chr11	46188174	46188438	DNA/TcMar-Tigger	1450	-	132	46188306	2619
chr11	46185687	46385687	harbor1	chr11	46197113	46197291	DNA/TcMar-Tigger	538	-	89	46197202	11515
chr11	5134641	5334641	harbor1	chr11	5187925	5188097	DNA/TcMar-Tigger	428	-	86	5188011	53370
chr11	57399762	57599762	harbor1	chr11	57442707	57443096	DNA/TcMar-Tigger	6019	-	194	57442901	43139
chr11	57399762	57599762	harbor1	chr11	57443391	57443687	DNA/TcMar-Tigger	6019	-	148	57443539	43777
chr11	57399762	57599762	harbor1	chr11	57443996	57444276	DNA/TcMar-Tigger	4319	-	140	57444136	44374
chr11	57399762	57599762	harbor1	chr11	57441991	57442392	DNA/TcMar-Tigger	6019	-	200	57442191	42429
chr11	108004348	108204348	harbor1	chr11	108055303	108055396	DNA/TcMar-Tigger	426	-	46	108055349	51001
chr11	108004348	108204348	harbor1	chr11	108090833	108091040	DNA/TcMar-Tigger	604	-	104	108090937	86589
chr11	108004348	108204348	harbor1	chr11	108091351	108091381	DNA/TcMar-Tigger	604	-	15	108091366	87018
chr11	108004348	108204348	harbor1	chr11	108093169	108093719	DNA/TcMar-Tigger	2359	-	275	108093444	89096
chr11	108004348	108204348	harbor1	chr11	108093980	108094207	DNA/TcMar-Tigger	2359	-	114	108094094	89746
chr11	2759442	2959442	harbor1	chr11	2839993	2840363	DNA/TcMar-Tigger	1994	-	185	2840178	80736
chr11	5127278	5327278	harbor1	chr11	5187925	5188097	DNA/TcMar-Tigger	428	-	86	5188011	60733
chr11	80398104	80598104	harbor1	chr11	80494823	80495522	DNA/TcMar-Tigger	2846	-	350	80495173	97069
chr11	5134115	5334115	harbor1	chr11	5187925	5188097	DNA/TcMar-Tigger	428	-	86	5188011	53896
chr11	5134546	5334546	harbor1	chr11	5187925	5188097	DNA/TcMar-Tigger	428	-	86	5188011	53465
chr11	5124980	5324980	harbor1	chr11	5187925	5188097	DNA/TcMar-Tigger	428	-	86	5188011	63031
chr11	5127317	5327317	harbor1	chr11	5187925	5188097	DNA/TcMar-Tigger	428	-	86	5188011	60694
chr11	5127257	5327257	harbor1	chr11	5187925	5188097	DNA/TcMar-Tigger	428	-	86	5188011	60754
chr11	5100509	5300509	harbor1	chr11	5108220	5108548	DNA/TcMar-Tigger	1403	-	164	5108384	7875
chr11	5100509	5300509	harbor1	chr11	5110771	5111052	DNA/TcMar-Tigger	1528	-	140	5110911	10402
chr11	5100509	5300509	harbor1	chr11	5187925	5188097	DNA/TcMar-Tigger	428	-	86	5188011	87502
chr11	5127273	5327273	harbor1	chr11	5187925	5188097	DNA/TcMar-Tigger	428	-	86	5188011	60738
chr11	91718101	91918101	harbor1	chr11	91788222	91788563	DNA/TcMar-Tigger	1768	-	170	91788392	70291
chr11	91718101	91918101	harbor1	chr11	91791270	91791860	DNA/TcMar-Tigger	2767	-	295	91791565	73464
chr11	4695187	4895187	harbor1	chr11	4762327	4762490	DNA/TcMar-Tigger	449	-	82	4762409	67222
chr11	5134560	5334560	harbor1	chr11	5187925	5188097	DNA/TcMar-Tigger	428	-	86	5188011	53451
chr11	5031868	5231868	harbor1	chr11	5088708	5088902	DNA/TcMar-Tigger	969	-	97	5088805	56937
chr11	5031868	5231868	harbor1	chr11	5108220	5108548	DNA/TcMar-Tigger	1403	-	164	5108384	76516
chr11	5031868	5231868	harbor1	chr11	5110771	5111052	DNA/TcMar-Tigger	1528	-	140	5110911	79043
chr11	108021573	108221573	harbor1	chr11	108055303	108055396	DNA/TcMar-Tigger	426	-	46	108055349	33776
chr11	108021573	108221573	harbor1	chr11	108090833	108091040	DNA/TcMar-Tigger	604	-	104	108090937	69364
chr11	108021573	108221573	harbor1	chr11	108091351	108091381	DNA/TcMar-Tigger	604	-	15	108091366	69793
chr11	108021573	108221573	harbor1	chr11	108093169	108093719	DNA/TcMar-Tigger	2359	-	275	108093444	71871
chr11	108021573	108221573	harbor1	chr11	108093980	108094207	DNA/TcMar-Tigger	2359	-	114	108094094	72521
chr11	5127126	5327126	harbor1	chr11	5187925	5188097	DNA/TcMar-Tigger	428	-	86	5188011	60885
chr11	5125006	5325006	harbor1	chr11	5187925	5188097	DNA/TcMar-Tigger	428	-	86	5188011	63005
chr11	5134608	5334608	harbor1	chr11	5187925	5188097	DNA/TcMar-Tigger	428	-	86	5188011	53403
chr11	70391186	70591186	harbor1	chr11	70439826	70439977	DNA/TcMar-Tigger	1106	-	76	70439902	48716
chr11	70391186	70591186	harbor1	chr11	70440282	70440369	DNA/TcMar-Tigger	1106	-	44	70440326	49140
chr11	5126778	5326778	harbor1	chr11	5187925	5188097	DNA/TcMar-Tigger	428	-	86	5188011	61233
chr11	5134653	5334653	harbor1	chr11	5187925	5188097	DNA/TcMar-Tigger	428	-	86	5188011	53358
chr11	5134111	5334111	harbor1	chr11	5187925	5188097	DNA/TcMar-Tigger	428	-	86	5188011	53900
chr11	2054541	2254541	harbor1	chr11	2066423	2066742	DNA/TcMar-Tigger	1064	-	160	2066583	12042
chr11	2054541	2254541	harbor1	chr11	2066830	2069172	DNA/TcMar-Tigger	14403	-	1171	2068001	13460
chr11	2054541	2254541	harbor1	chr11	2069591	2069934	DNA/TcMar-Tigger	1569	-	172	2069763	15222
chr11	57374327	57574327	harbor1	chr11	57442707	57443096	DNA/TcMar-Tigger	6019	-	194	57442901	68574
chr11	57374327	57574327	harbor1	chr11	57443391	57443687	DNA/TcMar-Tigger	6019	-	148	57443539	69212
chr11	57374327	57574327	harbor1	chr11	57443996	57444276	DNA/TcMar-Tigger	4319	-	140	57444136	69809
chr11	57374327	57574327	harbor1	chr11	57441991	57442392	DNA/TcMar-Tigger	6019	-	200	57442191	67864
chr11	5127183	5327183	harbor1	chr11	5187925	5188097	DNA/TcMar-Tigger	428	-	86	5188011	60828
chr11	5127132	5327132	harbor1	chr11	5187925	5188097	DNA/TcMar-Tigger	428	-	86	5188011	60879
chr11	70336771	70536771	harbor1	chr11	70351440	70351671	DNA/TcMar-Tigger	1369	-	116	70351556	14785
chr11	70336771	70536771	harbor1	chr11	70361224	70361518	DNA/TcMar-Tigger	1186	-	147	70361371	24600
chr11	10401686	10601686	harbor1	chr11	10403599	10403748	DNA/TcMar-Tigger	1900	-	74	10403673	1987
chr11	10401686	10601686	harbor1	chr11	10404967	10405152	DNA/TcMar-Tigger	1900	-	92	10405059	3373
chr11	5126760	5326760	harbor1	chr11	5187925	5188097	DNA/TcMar-Tigger	428	-	86	5188011	61251
chr11	34816228	35016228	harbor1	chr11	34873356	34874012	DNA/TcMar-Tigger	1987	-	328	34873684	57456
chr11	5127108	5327108	harbor1	chr11	5187925	5188097	DNA/TcMar-Tigger	428	-	86	5188011	60903
chr11	2052793	2252793	harbor1	chr11	2066423	2066742	DNA/TcMar-Tigger	1064	-	160	2066583	13790
chr11	2052793	2252793	harbor1	chr11	2066830	2069172	DNA/TcMar-Tigger	14403	-	1171	2068001	15208
chr11	2052793	2252793	harbor1	chr11	2069591	2069934	DNA/TcMar-Tigger	1569	-	172	2069763	16970
chr11	5127203	5327203	harbor1	chr11	5187925	5188097	DNA/TcMar-Tigger	428	-	86	5188011	60808
chr11	5127281	5327281	harbor1	chr11	5187925	5188097	DNA/TcMar-Tigger	428	-	86	5188011	60730
chr11	5134553	5334553	harbor1	chr11	5187925	5188097	DNA/TcMar-Tigger	428	-	86	5188011	53458
chr11	5030148	5230148	harbor1	chr11	5088708	5088902	DNA/TcMar-Tigger	969	-	97	5088805	58657
chr11	5030148	5230148	harbor1	chr11	5108220	5108548	DNA/TcMar-Tigger	1403	-	164	5108384	78236
chr11	5030148	5230148	harbor1	chr11	5110771	5111052	DNA/TcMar-Tigger	1528	-	140	5110911	80763
chr11	5134570	5334570	harbor1	chr11	5187925	5188097	DNA/TcMar-Tigger	428	-	86	5188011	53441
chr11	5126802	5326802	harbor1	chr11	5187925	5188097	DNA/TcMar-Tigger	428	-	86	5188011	61209
chr11	106768224	106968224	harbor1	chr11	106770167	106770439	DNA/TcMar-Tigger	1130	-	136	106770303	2079
chr11	106768224	106968224	harbor1	chr11	106836131	106836990	DNA/TcMar-Tigger	5998	-	430	106836561	68337
chr11	106768224	106968224	harbor1	chr11	106837583	106837748	DNA/TcMar-Tigger	5998	-	82	106837665	69441
chr11	106768224	106968224	harbor1	chr11	106860097	106860756	DNA/TcMar-Tigger	599	-	330	106860427	92203
chr11	133733693	133933693	harbor1	chr11	133759618	133759916	DNA/TcMar-Tigger	1140	-	149	133759767	26074
chr11	5030044	5230044	harbor1	chr11	5088708	5088902	DNA/TcMar-Tigger	969	-	97	5088805	58761
chr11	5030044	5230044	harbor1	chr11	5108220	5108548	DNA/TcMar-Tigger	1403	-	164	5108384	78340
chr11	5030044	5230044	harbor1	chr11	5110771	5111052	DNA/TcMar-Tigger	1528	-	140	5110911	80867
chr11	5125241	5325241	harbor1	chr11	5187925	5188097	DNA/TcMar-Tigger	428	-	86	5188011	62770
chr11	5134190	5334190	harbor1	chr11	5187925	5188097	DNA/TcMar-Tigger	428	-	86	5188011	53821
chr11	5125737	5325737	harbor1	chr11	5187925	5188097	DNA/TcMar-Tigger	428	-	86	5188011	62274
chr11	5127241	5327241	harbor1	chr11	5187925	5188097	DNA/TcMar-Tigger	428	-	86	5188011	60770
chr11	5126766	5326766	harbor1	chr11	5187925	5188097	DNA/TcMar-Tigger	428	-	86	5188011	61245
chr11	5134609	5334609	harbor1	chr11	5187925	5188097	DNA/TcMar-Tigger	428	-	86	5188011	53402
chr11	5134091	5334091	harbor1	chr11	5187925	5188097	DNA/TcMar-Tigger	428	-	86	5188011	53920
chr11	5127300	5327300	harbor1	chr11	5187925	5188097	DNA/TcMar-Tigger	428	-	86	5188011	60711
chr11	5127229	5327229	harbor1	chr11	5187925	5188097	DNA/TcMar-Tigger	428	-	86	5188011	60782
chr11	107465643	107665643	harbor1	chr11	107476679	107476930	DNA/TcMar-Tigger	551	-	126	107476805	11162
chr11	107465643	107665643	harbor1	chr11	107519549	107519784	DNA/TcMar-Tigger	1460	-	118	107519667	54024
chr11	108021539	108221539	harbor1	chr11	108055303	108055396	DNA/TcMar-Tigger	426	-	46	108055349	33810
chr11	108021539	108221539	harbor1	chr11	108090833	108091040	DNA/TcMar-Tigger	604	-	104	108090937	69398
chr11	108021539	108221539	harbor1	chr11	108091351	108091381	DNA/TcMar-Tigger	604	-	15	108091366	69827
chr11	108021539	108221539	harbor1	chr11	108093169	108093719	DNA/TcMar-Tigger	2359	-	275	108093444	71905
chr11	108021539	108221539	harbor1	chr11	108093980	108094207	DNA/TcMar-Tigger	2359	-	114	108094094	72555
chr11	5126785	5326785	harbor1	chr11	5187925	5188097	DNA/TcMar-Tigger	428	-	86	5188011	61226
chr11	64538073	64738073	harbor1	chr11	64565915	64566011	DNA/TcMar-Tigger	607	-	48	64565963	27890
chr11	64538073	64738073	harbor1	chr11	64566262	64566715	DNA/TcMar-Tigger	607	-	226	64566488	28415
chr11	5127144	5327144	harbor1	chr11	5187925	5188097	DNA/TcMar-Tigger	428	-	86	5188011	60867
chr11	5127200	5327200	harbor1	chr11	5187925	5188097	DNA/TcMar-Tigger	428	-	86	5188011	60811
chr11	5103484	5303484	harbor1	chr11	5108220	5108548	DNA/TcMar-Tigger	1403	-	164	5108384	4900
chr11	5103484	5303484	harbor1	chr11	5110771	5111052	DNA/TcMar-Tigger	1528	-	140	5110911	7427
chr11	5103484	5303484	harbor1	chr11	5187925	5188097	DNA/TcMar-Tigger	428	-	86	5188011	84527
chr11	69539230	69739230	harbor1	chr11	69559814	69559824	DNA/TcMar-Tigger	10752	-	5	69559819	20589
chr11	69539230	69739230	harbor1	chr11	69560129	69561616	DNA/TcMar-Tigger	10752	-	744	69560873	21643
chr11	69539230	69739230	harbor1	chr11	69561935	69562298	DNA/TcMar-Tigger	10752	-	182	69562117	22887
chr11	69539230	69739230	harbor1	chr11	69562293	69562472	DNA/TcMar-Tigger	1011	-	90	69562383	23153
chr11	69539230	69739230	harbor1	chr11	69583269	69583553	DNA/TcMar-Tigger	894	-	142	69583411	44181
chr11	5127304	5327304	harbor1	chr11	5187925	5188097	DNA/TcMar-Tigger	428	-	86	5188011	60707
chr11	6512326	6712326	harbor1	chr11	6540839	6541541	DNA/TcMar-Tigger	646	-	351	6541190	28864
chr11	6512326	6712326	harbor1	chr11	6573568	6573730	DNA/TcMar-Tigger	936	-	81	6573649	61323
chr11	6512326	6712326	harbor1	chr11	6573965	6576228	DNA/TcMar-Tigger	13937	-	1132	6575097	62771
chr11	57394202	57594202	harbor1	chr11	57442707	57443096	DNA/TcMar-Tigger	6019	-	194	57442901	48699
chr11	57394202	57594202	harbor1	chr11	57443391	57443687	DNA/TcMar-Tigger	6019	-	148	57443539	49337
chr11	57394202	57594202	harbor1	chr11	57443996	57444276	DNA/TcMar-Tigger	4319	-	140	57444136	49934
chr11	57394202	57594202	harbor1	chr11	57441991	57442392	DNA/TcMar-Tigger	6019	-	200	57442191	47989
chr11	6201318	6401318	harbor1	chr11	6204856	6205197	DNA/TcMar-Tigger	2077	-	170	6205026	3708
chr11	6201318	6401318	harbor1	chr11	6266751	6267833	DNA/TcMar-Tigger	6557	-	541	6267292	65974
chr11	6201318	6401318	harbor1	chr11	6268143	6268222	DNA/TcMar-Tigger	6557	-	40	6268183	66865
chr11	46138065	46338065	harbor1	chr11	46188174	46188438	DNA/TcMar-Tigger	1450	-	132	46188306	50241
chr11	46138065	46338065	harbor1	chr11	46197113	46197291	DNA/TcMar-Tigger	538	-	89	46197202	59137
chr11	57383305	57583305	harbor1	chr11	57442707	57443096	DNA/TcMar-Tigger	6019	-	194	57442901	59596
chr11	57383305	57583305	harbor1	chr11	57443391	57443687	DNA/TcMar-Tigger	6019	-	148	57443539	60234
chr11	57383305	57583305	harbor1	chr11	57443996	57444276	DNA/TcMar-Tigger	4319	-	140	57444136	60831
chr11	57383305	57583305	harbor1	chr11	57441991	57442392	DNA/TcMar-Tigger	6019	-	200	57442191	58886
chr11	6512331	6712331	harbor1	chr11	6540839	6541541	DNA/TcMar-Tigger	646	-	351	6541190	28859
chr11	6512331	6712331	harbor1	chr11	6573568	6573730	DNA/TcMar-Tigger	936	-	81	6573649	61318
chr11	6512331	6712331	harbor1	chr11	6573965	6576228	DNA/TcMar-Tigger	13937	-	1132	6575097	62766
chr11	107914515	108114515	harbor1	chr11	107968420	107968630	DNA/TcMar-Tigger	886	-	105	107968525	54010
chr11	107914515	108114515	harbor1	chr11	107988616	107989273	DNA/TcMar-Tigger	4117	-	328	107988944	74429
chr11	107914515	108114515	harbor1	chr11	107989419	107989470	DNA/TcMar-Tigger	2913	-	26	107989445	74930
chr11	107914515	108114515	harbor1	chr11	107989782	107990013	DNA/TcMar-Tigger	2913	-	116	107989898	75383
chr11	107914515	108114515	harbor1	chr11	107990322	107990604	DNA/TcMar-Tigger	2913	-	141	107990463	75948
chr11	107914515	108114515	harbor1	chr11	107993676	107993739	DNA/TcMar-Tigger	11434	-	32	107993708	79193
chr11	107914515	108114515	harbor1	chr11	107994329	107995541	DNA/TcMar-Tigger	11434	-	606	107994935	80420
chr11	107914515	108114515	harbor1	chr11	107995680	107996211	DNA/TcMar-Tigger	11434	-	266	107995946	81431
chr11	68332127	68532127	harbor1	chr11	68334915	68335074	DNA/TcMar-Tigger	1003	-	80	68334995	2868
chr11	68332127	68532127	harbor1	chr11	68335374	68335414	DNA/TcMar-Tigger	1003	-	20	68335394	3267
chr11	68332127	68532127	harbor1	chr11	68335571	68336017	DNA/TcMar-Tigger	1767	-	223	68335794	3667
chr11	68332127	68532127	harbor1	chr11	68416875	68417449	DNA/TcMar-Tigger	1759	-	287	68417162	85035
chr11	731095	931095	harbor1	chr11	780818	780901	DNA/TcMar-Tigger	1542	-	42	780860	49765
chr11	731095	931095	harbor1	chr11	781482	781718	DNA/TcMar-Tigger	1542	-	118	781600	50505
chr11	64537994	64737994	harbor1	chr11	64565915	64566011	DNA/TcMar-Tigger	607	-	48	64565963	27969
chr11	64537994	64737994	harbor1	chr11	64566262	64566715	DNA/TcMar-Tigger	607	-	226	64566488	28494
chr11	34936228	35136228	harbor1	chr11	34988980	34989279	DNA/TcMar-Tigger	1278	-	150	34989130	52902
chr11	34936228	35136228	harbor1	chr11	34994052	34994646	DNA/TcMar-Tigger	3156	-	297	34994349	58121
chr11	5127117	5327117	harbor1	chr11	5187925	5188097	DNA/TcMar-Tigger	428	-	86	5188011	60894
chr11	5134657	5334657	harbor1	chr11	5187925	5188097	DNA/TcMar-Tigger	428	-	86	5188011	53354
chr11	3044411	3244411	harbor1	chr11	3071000	3071152	DNA/TcMar-Tigger	760	-	76	3071076	26665
chr11	3044411	3244411	harbor1	chr11	3071193	3071369	DNA/TcMar-Tigger	833	-	88	3071281	26870
chr11	6201420	6401420	harbor1	chr11	6204856	6205197	DNA/TcMar-Tigger	2077	-	170	6205026	3606
chr11	6201420	6401420	harbor1	chr11	6266751	6267833	DNA/TcMar-Tigger	6557	-	541	6267292	65872
chr11	6201420	6401420	harbor1	chr11	6268143	6268222	DNA/TcMar-Tigger	6557	-	40	6268183	66763
chr11	108021633	108221633	harbor1	chr11	108055303	108055396	DNA/TcMar-Tigger	426	-	46	108055349	33716
chr11	108021633	108221633	harbor1	chr11	108090833	108091040	DNA/TcMar-Tigger	604	-	104	108090937	69304
chr11	108021633	108221633	harbor1	chr11	108091351	108091381	DNA/TcMar-Tigger	604	-	15	108091366	69733
chr11	108021633	108221633	harbor1	chr11	108093169	108093719	DNA/TcMar-Tigger	2359	-	275	108093444	71811
chr11	108021633	108221633	harbor1	chr11	108093980	108094207	DNA/TcMar-Tigger	2359	-	114	108094094	72461
chr11	119643264	119843264	harbor1	chr11	119717967	119718088	DNA/TcMar-Tigger	415	-	60	119718027	74763
chr11	119643264	119843264	harbor1	chr11	119718827	119719158	DNA/TcMar-Tigger	1948	-	166	119718993	75729
chr11	5127276	5327276	harbor1	chr11	5187925	5188097	DNA/TcMar-Tigger	428	-	86	5188011	60735
chr11	19099393	19299393	harbor1	chr11	19174029	19174127	DNA/TcMar-Tigger	629	-	49	19174078	74685
chr11	19099393	19299393	harbor1	chr11	19174139	19174363	DNA/TcMar-Tigger	1251	-	112	19174251	74858
chr11	5134554	5334554	harbor1	chr11	5187925	5188097	DNA/TcMar-Tigger	428	-	86	5188011	53457
chr11	6201346	6401346	harbor1	chr11	6204856	6205197	DNA/TcMar-Tigger	2077	-	170	6205026	3680
chr11	6201346	6401346	harbor1	chr11	6266751	6267833	DNA/TcMar-Tigger	6557	-	541	6267292	65946
chr11	6201346	6401346	harbor1	chr11	6268143	6268222	DNA/TcMar-Tigger	6557	-	40	6268183	66837
chr11	5134601	5334601	harbor1	chr11	5187925	5188097	DNA/TcMar-Tigger	428	-	86	5188011	53410
chr11	5036924	5236924	harbor1	chr11	5088708	5088902	DNA/TcMar-Tigger	969	-	97	5088805	51881
chr11	5036924	5236924	harbor1	chr11	5108220	5108548	DNA/TcMar-Tigger	1403	-	164	5108384	71460
chr11	5036924	5236924	harbor1	chr11	5110771	5111052	DNA/TcMar-Tigger	1528	-	140	5110911	73987
chr11	5127104	5327104	harbor1	chr11	5187925	5188097	DNA/TcMar-Tigger	428	-	86	5188011	60907
chr11	66158708	66358708	harbor1	chr11	66205579	66205659	DNA/TcMar-Tigger	1248	-	40	66205619	46911
chr11	66158708	66358708	harbor1	chr11	66205793	66205865	DNA/TcMar-Tigger	1248	-	36	66205829	47121
chr11	66158708	66358708	harbor1	chr11	66206166	66206446	DNA/TcMar-Tigger	1248	-	140	66206306	47598
chr11	66158708	66358708	harbor1	chr11	66206512	66206617	DNA/TcMar-Tigger	442	-	52	66206564	47856
chr11	5127078	5327078	harbor1	chr11	5187925	5188097	DNA/TcMar-Tigger	428	-	86	5188011	60933
chr11	5132790	5332790	harbor1	chr11	5187925	5188097	DNA/TcMar-Tigger	428	-	86	5188011	55221
chr11	75668477	75868477	harbor1	chr11	75677209	75677467	DNA/TcMar-Tigger	1833	-	129	75677338	8861
chr11	75668477	75868477	harbor1	chr11	75677796	75677878	DNA/TcMar-Tigger	1833	-	41	75677837	9360
chr11	75668477	75868477	harbor1	chr11	75726379	75726688	DNA/TcMar-Tigger	1487	-	154	75726533	58056
chr11	5134186	5334186	harbor1	chr11	5187925	5188097	DNA/TcMar-Tigger	428	-	86	5188011	53825
chr11	73042808	73242808	harbor1	chr11	73123539	73123782	DNA/TcMar-Tigger	472	-	122	73123661	80853
chr11	5126808	5326808	harbor1	chr11	5187925	5188097	DNA/TcMar-Tigger	428	-	86	5188011	61203
chr11	69539219	69739219	harbor1	chr11	69559814	69559824	DNA/TcMar-Tigger	10752	-	5	69559819	20600
chr11	69539219	69739219	harbor1	chr11	69560129	69561616	DNA/TcMar-Tigger	10752	-	744	69560873	21654
chr11	69539219	69739219	harbor1	chr11	69561935	69562298	DNA/TcMar-Tigger	10752	-	182	69562117	22898
chr11	69539219	69739219	harbor1	chr11	69562293	69562472	DNA/TcMar-Tigger	1011	-	90	69562383	23164
chr11	69539219	69739219	harbor1	chr11	69583269	69583553	DNA/TcMar-Tigger	894	-	142	69583411	44192
chr11	5127131	5327131	harbor1	chr11	5187925	5188097	DNA/TcMar-Tigger	428	-	86	5188011	60880
chr11	69539220	69739220	harbor1	chr11	69559814	69559824	DNA/TcMar-Tigger	10752	-	5	69559819	20599
chr11	69539220	69739220	harbor1	chr11	69560129	69561616	DNA/TcMar-Tigger	10752	-	744	69560873	21653
chr11	69539220	69739220	harbor1	chr11	69561935	69562298	DNA/TcMar-Tigger	10752	-	182	69562117	22897
chr11	69539220	69739220	harbor1	chr11	69562293	69562472	DNA/TcMar-Tigger	1011	-	90	69562383	23163
chr11	69539220	69739220	harbor1	chr11	69583269	69583553	DNA/TcMar-Tigger	894	-	142	69583411	44191
chr11	5125969	5325969	harbor1	chr11	5187925	5188097	DNA/TcMar-Tigger	428	-	86	5188011	62042
chr11	68332185	68532185	harbor1	chr11	68334915	68335074	DNA/TcMar-Tigger	1003	-	80	68334995	2810
chr11	68332185	68532185	harbor1	chr11	68335374	68335414	DNA/TcMar-Tigger	1003	-	20	68335394	3209
chr11	68332185	68532185	harbor1	chr11	68335571	68336017	DNA/TcMar-Tigger	1767	-	223	68335794	3609
chr11	68332185	68532185	harbor1	chr11	68416875	68417449	DNA/TcMar-Tigger	1759	-	287	68417162	84977
chr11	682053	882053	harbor1	chr11	780818	780901	DNA/TcMar-Tigger	1542	-	42	780860	98807
chr11	682053	882053	harbor1	chr11	781482	781718	DNA/TcMar-Tigger	1542	-	118	781600	99547
chr11	1448331	1648331	harbor1	chr11	1475339	1475461	DNA/TcMar-Tigger	597	-	61	1475400	27069
chr11	1448331	1648331	harbor1	chr11	1475620	1476228	DNA/TcMar-Tigger	1991	-	304	1475924	27593
chr11	2062911	2262911	harbor1	chr11	2066423	2066742	DNA/TcMar-Tigger	1064	-	160	2066583	3672
chr11	2062911	2262911	harbor1	chr11	2066830	2069172	DNA/TcMar-Tigger	14403	-	1171	2068001	5090
chr11	2062911	2262911	harbor1	chr11	2069591	2069934	DNA/TcMar-Tigger	1569	-	172	2069763	6852
chr11	5126984	5326984	harbor1	chr11	5187925	5188097	DNA/TcMar-Tigger	428	-	86	5188011	61027
chr11	69498462	69698462	harbor1	chr11	69502773	69502954	DNA/TcMar-Tigger	904	-	90	69502863	4401
chr11	69498462	69698462	harbor1	chr11	69559814	69559824	DNA/TcMar-Tigger	10752	-	5	69559819	61357
chr11	69498462	69698462	harbor1	chr11	69560129	69561616	DNA/TcMar-Tigger	10752	-	744	69560873	62411
chr11	69498462	69698462	harbor1	chr11	69561935	69562298	DNA/TcMar-Tigger	10752	-	182	69562117	63655
chr11	69498462	69698462	harbor1	chr11	69562293	69562472	DNA/TcMar-Tigger	1011	-	90	69562383	63921
chr11	69498462	69698462	harbor1	chr11	69583269	69583553	DNA/TcMar-Tigger	894	-	142	69583411	84949
chr11	5127187	5327187	harbor1	chr11	5187925	5188097	DNA/TcMar-Tigger	428	-	86	5188011	60824
chr11	69575154	69775154	harbor1	chr11	69583269	69583553	DNA/TcMar-Tigger	894	-	142	69583411	8257
chr11	33157309	33357309	harbor1	chr11	33163216	33163338	DNA/TcMar-Tigger	794	-	61	33163277	5968
chr11	77964208	78164208	harbor1	chr11	77967870	77968211	DNA/TcMar-Tigger	2259	-	170	77968040	3832
chr11	6512394	6712394	harbor1	chr11	6540839	6541541	DNA/TcMar-Tigger	646	-	351	6541190	28796
chr11	6512394	6712394	harbor1	chr11	6573568	6573730	DNA/TcMar-Tigger	936	-	81	6573649	61255
chr11	6512394	6712394	harbor1	chr11	6573965	6576228	DNA/TcMar-Tigger	13937	-	1132	6575097	62703
chr11	64537959	64737959	harbor1	chr11	64565915	64566011	DNA/TcMar-Tigger	607	-	48	64565963	28004
chr11	64537959	64737959	harbor1	chr11	64566262	64566715	DNA/TcMar-Tigger	607	-	226	64566488	28529
chr11	5132879	5332879	harbor1	chr11	5187925	5188097	DNA/TcMar-Tigger	428	-	86	5188011	55132
chr11	6201311	6401311	harbor1	chr11	6204856	6205197	DNA/TcMar-Tigger	2077	-	170	6205026	3715
chr11	6201311	6401311	harbor1	chr11	6266751	6267833	DNA/TcMar-Tigger	6557	-	541	6267292	65981
chr11	6201311	6401311	harbor1	chr11	6268143	6268222	DNA/TcMar-Tigger	6557	-	40	6268183	66872
chr11	113773432	113973432	harbor1	chr11	113774564	113774866	DNA/TcMar-Tigger	952	-	151	113774715	1283
chr11	113773432	113973432	harbor1	chr11	113809390	113809641	DNA/TcMar-Tigger	1123	-	126	113809516	36084
chr11	5126814	5326814	harbor1	chr11	5187925	5188097	DNA/TcMar-Tigger	428	-	86	5188011	61197
chr11	5132579	5332579	harbor1	chr11	5187925	5188097	DNA/TcMar-Tigger	428	-	86	5188011	55432
chr11	5022316	5222316	harbor1	chr11	5022737	5023679	DNA/TcMar-Tigger	4995	-	471	5023208	892
chr11	5022316	5222316	harbor1	chr11	5088708	5088902	DNA/TcMar-Tigger	969	-	97	5088805	66489
chr11	5022316	5222316	harbor1	chr11	5108220	5108548	DNA/TcMar-Tigger	1403	-	164	5108384	86068
chr11	5022316	5222316	harbor1	chr11	5110771	5111052	DNA/TcMar-Tigger	1528	-	140	5110911	88595
chr11	9360652	9560652	harbor1	chr11	9399957	9400277	DNA/TcMar-Tigger	1430	-	160	9400117	39465
chr11	3984543	4184543	harbor1	chr11	4008359	4008918	DNA/TcMar-Tigger	3565	-	280	4008639	24096
chr11	3984543	4184543	harbor1	chr11	4050649	4051095	DNA/TcMar-Tigger	2922	-	223	4050872	66329
chr11	5127120	5327120	harbor1	chr11	5187925	5188097	DNA/TcMar-Tigger	428	-	86	5188011	60891
chr11	64538041	64738041	harbor1	chr11	64565915	64566011	DNA/TcMar-Tigger	607	-	48	64565963	27922
chr11	64538041	64738041	harbor1	chr11	64566262	64566715	DNA/TcMar-Tigger	607	-	226	64566488	28447
chr11	69539244	69739244	harbor1	chr11	69559814	69559824	DNA/TcMar-Tigger	10752	-	5	69559819	20575
chr11	69539244	69739244	harbor1	chr11	69560129	69561616	DNA/TcMar-Tigger	10752	-	744	69560873	21629
chr11	69539244	69739244	harbor1	chr11	69561935	69562298	DNA/TcMar-Tigger	10752	-	182	69562117	22873
chr11	69539244	69739244	harbor1	chr11	69562293	69562472	DNA/TcMar-Tigger	1011	-	90	69562383	23139
chr11	69539244	69739244	harbor1	chr11	69583269	69583553	DNA/TcMar-Tigger	894	-	142	69583411	44167
chr11	68332140	68532140	harbor1	chr11	68334915	68335074	DNA/TcMar-Tigger	1003	-	80	68334995	2855
chr11	68332140	68532140	harbor1	chr11	68335374	68335414	DNA/TcMar-Tigger	1003	-	20	68335394	3254
chr11	68332140	68532140	harbor1	chr11	68335571	68336017	DNA/TcMar-Tigger	1767	-	223	68335794	3654
chr11	68332140	68532140	harbor1	chr11	68416875	68417449	DNA/TcMar-Tigger	1759	-	287	68417162	85022
chr11	7933373	8133373	harbor1	chr11	7980549	7980724	DNA/TcMar-Tigger	1173	-	88	7980637	47264
chr11	7933373	8133373	harbor1	chr11	7998106	7998689	DNA/TcMar-Tigger	2942	-	292	7998398	65025
chr11	7933373	8133373	harbor1	chr11	8007337	8007651	DNA/TcMar-Tigger	1745	-	157	8007494	74121
chr11	122556267	122756267	harbor1	chr11	122620050	122620282	DNA/TcMar-Tigger	1565	-	116	122620166	63899
chr11	5127220	5327220	harbor1	chr11	5187925	5188097	DNA/TcMar-Tigger	428	-	86	5188011	60791
chr11	5127275	5327275	harbor1	chr11	5187925	5188097	DNA/TcMar-Tigger	428	-	86	5188011	60736
chr11	32939956	33139956	harbor1	chr11	32967508	32967604	DNA/TcMar-Tigger	609	-	48	32967556	27600
chr11	32939956	33139956	harbor1	chr11	32978879	32979179	DNA/TcMar-Tigger	1807	-	150	32979029	39073
chr11	32939956	33139956	harbor1	chr11	33024453	33024801	DNA/TcMar-Tigger	1886	-	174	33024627	84671
chr11	32939956	33139956	harbor1	chr11	33027032	33027334	DNA/TcMar-Tigger	884	-	151	33027183	87227
chr11	5127188	5327188	harbor1	chr11	5187925	5188097	DNA/TcMar-Tigger	428	-	86	5188011	60823
chr11	5127127	5327127	harbor1	chr11	5187925	5188097	DNA/TcMar-Tigger	428	-	86	5188011	60884
chr11	2054535	2254535	harbor1	chr11	2066423	2066742	DNA/TcMar-Tigger	1064	-	160	2066583	12048
chr11	2054535	2254535	harbor1	chr11	2066830	2069172	DNA/TcMar-Tigger	14403	-	1171	2068001	13466
chr11	2054535	2254535	harbor1	chr11	2069591	2069934	DNA/TcMar-Tigger	1569	-	172	2069763	15228
chr11	64537966	64737966	harbor1	chr11	64565915	64566011	DNA/TcMar-Tigger	607	-	48	64565963	27997
chr11	64537966	64737966	harbor1	chr11	64566262	64566715	DNA/TcMar-Tigger	607	-	226	64566488	28522
chr11	66158664	66358664	harbor1	chr11	66205579	66205659	DNA/TcMar-Tigger	1248	-	40	66205619	46955
chr11	66158664	66358664	harbor1	chr11	66205793	66205865	DNA/TcMar-Tigger	1248	-	36	66205829	47165
chr11	66158664	66358664	harbor1	chr11	66206166	66206446	DNA/TcMar-Tigger	1248	-	140	66206306	47642
chr11	66158664	66358664	harbor1	chr11	66206512	66206617	DNA/TcMar-Tigger	442	-	52	66206564	47900
chr11	67172339	67372339	harbor1	chr11	67176529	67176975	DNA/TcMar-Tigger	6028	-	223	67176752	4413
chr11	67172339	67372339	harbor1	chr11	67177273	67178021	DNA/TcMar-Tigger	6028	-	374	67177647	5308
chr11	67172339	67372339	harbor1	chr11	67197797	67198198	DNA/TcMar-Tigger	2000	-	200	67197997	25658
chr11	67172318	67372318	harbor1	chr11	67176529	67176975	DNA/TcMar-Tigger	6028	-	223	67176752	4434
chr11	67172318	67372318	harbor1	chr11	67177273	67178021	DNA/TcMar-Tigger	6028	-	374	67177647	5329
chr11	67172318	67372318	harbor1	chr11	67197797	67198198	DNA/TcMar-Tigger	2000	-	200	67197997	25679
chr11	64348428	64548428	harbor1	chr11	64386490	64386736	DNA/TcMar-Tigger	1175	-	123	64386613	38185
chr11	1472008	1672008	harbor1	chr11	1475339	1475461	DNA/TcMar-Tigger	597	-	61	1475400	3392
chr11	1472008	1672008	harbor1	chr11	1475620	1476228	DNA/TcMar-Tigger	1991	-	304	1475924	3916
chr11	69112726	69312726	harbor1	chr11	69124324	69124769	DNA/TcMar-Tigger	2113	-	222	69124546	11820
chr11	69112726	69312726	harbor1	chr11	69138890	69139419	DNA/TcMar-Tigger	2064	-	264	69139154	26428
chr11	69539269	69739269	harbor1	chr11	69559814	69559824	DNA/TcMar-Tigger	10752	-	5	69559819	20550
chr11	69539269	69739269	harbor1	chr11	69560129	69561616	DNA/TcMar-Tigger	10752	-	744	69560873	21604
chr11	69539269	69739269	harbor1	chr11	69561935	69562298	DNA/TcMar-Tigger	10752	-	182	69562117	22848
chr11	69539269	69739269	harbor1	chr11	69562293	69562472	DNA/TcMar-Tigger	1011	-	90	69562383	23114
chr11	69539269	69739269	harbor1	chr11	69583269	69583553	DNA/TcMar-Tigger	894	-	142	69583411	44142
chr11	5127170	5327170	harbor1	chr11	5187925	5188097	DNA/TcMar-Tigger	428	-	86	5188011	60841
chr11	5127159	5327159	harbor1	chr11	5187925	5188097	DNA/TcMar-Tigger	428	-	86	5188011	60852
chr11	9513814	9713814	harbor1	chr11	9605005	9605176	DNA/TcMar-Tigger	438	-	86	9605091	91277
chr11	9513814	9713814	harbor1	chr11	9584529	9584692	DNA/TcMar-Tigger	550	-	82	9584611	70797
chr11	19613809	19813809	harbor1	chr11	19706770	19707945	DNA/TcMar-Tigger	6934	-	588	19707358	93549
chr11	5125968	5325968	harbor1	chr11	5187925	5188097	DNA/TcMar-Tigger	428	-	86	5188011	62043
chr11	5127290	5327290	harbor1	chr11	5187925	5188097	DNA/TcMar-Tigger	428	-	86	5188011	60721
chr11	5126787	5326787	harbor1	chr11	5187925	5188097	DNA/TcMar-Tigger	428	-	86	5188011	61224
chr11	64538002	64738002	harbor1	chr11	64565915	64566011	DNA/TcMar-Tigger	607	-	48	64565963	27961
chr11	64538002	64738002	harbor1	chr11	64566262	64566715	DNA/TcMar-Tigger	607	-	226	64566488	28486
chr11	5134597	5334597	harbor1	chr11	5187925	5188097	DNA/TcMar-Tigger	428	-	86	5188011	53414
chr12	113085240	113285240	harbor1	chr12	113117886	113117942	DNA/TcMar-Tigger	793	-	28	113117914	32674
chr12	113085240	113285240	harbor1	chr12	113118253	113118340	DNA/TcMar-Tigger	793	-	44	113118297	33057
chr12	113085240	113285240	harbor1	chr12	113171827	113172081	DNA/TcMar-Tigger	1231	-	127	113171954	86714
chr12	6863305	7063305	harbor1	chr12	6944852	6945194	DNA/TcMar-Tigger	1822	-	171	6945023	81718
chr12	6863247	7063247	harbor1	chr12	6944852	6945194	DNA/TcMar-Tigger	1822	-	171	6945023	81776
chr12	110180833	110380833	harbor1	chr12	110200165	110200667	DNA/TcMar-Tigger	6932	-	251	110200416	19583
chr12	110180833	110380833	harbor1	chr12	110200968	110201120	DNA/TcMar-Tigger	6932	-	76	110201044	20211
chr12	110180833	110380833	harbor1	chr12	110201745	110202286	DNA/TcMar-Tigger	6932	-	270	110202015	21182
chr12	6863232	7063232	harbor1	chr12	6944852	6945194	DNA/TcMar-Tigger	1822	-	171	6945023	81791
chr12	2940625	3140625	harbor1	chr12	2979342	2979680	DNA/TcMar-Tigger	1200	-	169	2979511	38886
chr12	2940625	3140625	harbor1	chr12	2984516	2985117	DNA/TcMar-Tigger	6675	-	300	2984816	44191
chr12	2940625	3140625	harbor1	chr12	2985412	2985499	DNA/TcMar-Tigger	6675	-	44	2985456	44831
chr12	2940625	3140625	harbor1	chr12	2985756	2985804	DNA/TcMar-Tigger	6675	-	24	2985780	45155
chr12	2940625	3140625	harbor1	chr12	2986119	2986355	DNA/TcMar-Tigger	6675	-	118	2986237	45612
chr12	2940625	3140625	harbor1	chr12	2986669	2986979	DNA/TcMar-Tigger	6675	-	155	2986824	46199
chr12	49195916	49395916	harbor1	chr12	49236606	49236958	DNA/TcMar-Tigger	1831	-	176	49236782	40866
chr12	12257335	12457335	harbor1	chr12	12279277	12279345	DNA/TcMar-Tigger	6003	-	34	12279311	21976
chr12	12257335	12457335	harbor1	chr12	12279943	12280963	DNA/TcMar-Tigger	6003	-	510	12280453	23118
chr12	12257335	12457335	harbor1	chr12	12307348	12307418	DNA/TcMar-Tigger	1986	-	35	12307383	50048
chr12	12257335	12457335	harbor1	chr12	12307727	12308017	DNA/TcMar-Tigger	1986	-	145	12307872	50537
chr12	48880879	49080879	harbor1	chr12	48887586	48887714	DNA/TcMar-Tigger	1538	-	64	48887650	6771
chr12	48880879	49080879	harbor1	chr12	48888006	48888137	DNA/TcMar-Tigger	1538	-	66	48888072	7193
chr12	48880879	49080879	harbor1	chr12	48888306	48888540	DNA/TcMar-Tigger	1596	-	117	48888423	7544
chr12	48880879	49080879	harbor1	chr12	48888852	48888885	DNA/TcMar-Tigger	1577	-	16	48888868	7989
chr12	49467542	49667542	harbor1	chr12	49505406	49505626	DNA/TcMar-Tigger	1133	-	110	49505516	37974
chr12	6863318	7063318	harbor1	chr12	6944852	6945194	DNA/TcMar-Tigger	1822	-	171	6945023	81705
chr12	130061504	130261504	harbor1	chr12	130065397	130065988	DNA/TcMar-Tigger	3478	-	296	130065693	4189
chr12	6863293	7063293	harbor1	chr12	6944852	6945194	DNA/TcMar-Tigger	1822	-	171	6945023	81730
chr12	69779300	69979300	harbor1	chr12	69788219	69788523	DNA/TcMar-Tigger	1568	-	152	69788371	9071
chr12	69779300	69979300	harbor1	chr12	69873366	69873804	DNA/TcMar-Tigger	2113	-	219	69873585	94285
chr12	92828990	93028990	harbor1	chr12	92879151	92879366	DNA/TcMar-Tigger	961	-	108	92879259	50269
chr12	92828990	93028990	harbor1	chr12	92885665	92885849	DNA/TcMar-Tigger	934	-	92	92885757	56767
chr12	1496692	1696692	harbor1	chr12	1521478	1521756	DNA/TcMar-Tigger	1252	-	139	1521617	24925
chr12	1496692	1696692	harbor1	chr12	1522367	1522430	DNA/TcMar-Tigger	1252	-	32	1522399	25707
chr12	6863233	7063233	harbor1	chr12	6944852	6945194	DNA/TcMar-Tigger	1822	-	171	6945023	81790
chr12	121711754	121911754	harbor1	chr12	121739415	121739477	DNA/TcMar-Tigger	2271	-	31	121739446	27692
chr12	121711754	121911754	harbor1	chr12	121739772	121739795	DNA/TcMar-Tigger	2271	-	12	121739784	28030
chr12	121711754	121911754	harbor1	chr12	121740078	121740202	DNA/TcMar-Tigger	2271	-	62	121740140	28386
chr12	121711754	121911754	harbor1	chr12	121740504	121740739	DNA/TcMar-Tigger	2271	-	118	121740622	28868
chr12	121711754	121911754	harbor1	chr12	121784870	121785041	DNA/TcMar-Tigger	738	-	86	121784956	73202
chr12	121711754	121911754	harbor1	chr12	121785141	121785370	DNA/TcMar-Tigger	1043	-	114	121785255	73501
chr12	131976411	132176411	harbor1	chr12	131993574	131993880	DNA/TcMar-Tigger	1318	-	153	131993727	17316
chr12	131976411	132176411	harbor1	chr12	131997090	131997261	DNA/TcMar-Tigger	2171	-	86	131997176	20765
chr12	131976411	132176411	harbor1	chr12	131997556	131997838	DNA/TcMar-Tigger	2171	-	141	131997697	21286
chr12	6248395	6448395	harbor1	chr12	6259797	6259846	DNA/TcMar-Tigger	14298	-	24	6259821	11426
chr12	6248395	6448395	harbor1	chr12	6277768	6278105	DNA/TcMar-Tigger	1517	-	168	6277936	29541
chr12	6248395	6448395	harbor1	chr12	6257134	6259496	DNA/TcMar-Tigger	14298	-	1181	6258315	9920
chr12	96299297	96499297	harbor1	chr12	96303860	96304185	DNA/TcMar-Tigger	1515	-	162	96304022	4725
chr12	123336747	123536747	harbor1	chr12	123358015	123358357	DNA/TcMar-Tigger	2089	-	171	123358186	21439
chr12	122759135	122959135	harbor1	chr12	122792981	122793255	DNA/TcMar-Tigger	1481	-	137	122793118	33983
chr12	6863320	7063320	harbor1	chr12	6944852	6945194	DNA/TcMar-Tigger	1822	-	171	6945023	81703
chr12	6863258	7063258	harbor1	chr12	6944852	6945194	DNA/TcMar-Tigger	1822	-	171	6945023	81765
chr12	110178230	110378230	harbor1	chr12	110200165	110200667	DNA/TcMar-Tigger	6932	-	251	110200416	22186
chr12	110178230	110378230	harbor1	chr12	110200968	110201120	DNA/TcMar-Tigger	6932	-	76	110201044	22814
chr12	110178230	110378230	harbor1	chr12	110201745	110202286	DNA/TcMar-Tigger	6932	-	270	110202015	23785
chr12	132333732	132533732	harbor1	chr12	132344362	132344911	DNA/TcMar-Tigger	1570	-	274	132344636	10904
chr13	36899468	37099468	harbor1	chr13	36943764	36944699	DNA/TcMar-Tigger	14257	-	468	36944232	44764
chr13	36899468	37099468	harbor1	chr13	36946252	36946639	DNA/TcMar-Tigger	14257	-	194	36946446	46978
chr13	36899468	37099468	harbor1	chr13	36946930	36947271	DNA/TcMar-Tigger	14257	-	170	36947100	47632
chr13	36899468	37099468	harbor1	chr13	36912884	36913180	DNA/TcMar-Tigger	1206	-	148	36913032	13564
chr13	36899468	37099468	harbor1	chr13	36945001	36945961	DNA/TcMar-Tigger	14257	-	480	36945481	46013
chr13	36893557	37093557	harbor1	chr13	36943764	36944699	DNA/TcMar-Tigger	14257	-	468	36944232	50675
chr13	36893557	37093557	harbor1	chr13	36946252	36946639	DNA/TcMar-Tigger	14257	-	194	36946446	52889
chr13	36893557	37093557	harbor1	chr13	36946930	36947271	DNA/TcMar-Tigger	14257	-	170	36947100	53543
chr13	36893557	37093557	harbor1	chr13	36912884	36913180	DNA/TcMar-Tigger	1206	-	148	36913032	19475
chr13	36893557	37093557	harbor1	chr13	36945001	36945961	DNA/TcMar-Tigger	14257	-	480	36945481	51924
chr13	100574884	100774884	harbor1	chr13	100613402	100613604	DNA/TcMar-Tigger	544	-	101	100613503	38619
chr13	100574884	100774884	harbor1	chr13	100633592	100633858	DNA/TcMar-Tigger	1835	-	133	100633725	58841
chr13	100574884	100774884	harbor1	chr13	100634156	100634236	DNA/TcMar-Tigger	1835	-	40	100634196	59312
chr13	44477883	44677883	harbor1	chr13	44492109	44492452	DNA/TcMar-Tigger	2090	-	172	44492281	14398
chr13	44477883	44677883	harbor1	chr13	44501986	44502280	DNA/TcMar-Tigger	748	-	147	44502133	24250
chr13	44477883	44677883	harbor1	chr13	44526701	44526760	DNA/TcMar-Tigger	435	-	30	44526731	48848
chr13	20315145	20515145	harbor1	chr13	20413504	20413831	DNA/TcMar-Tigger	1527	-	164	20413668	98523
chr13	27728634	27928634	harbor1	chr13	27811400	27811673	DNA/TcMar-Tigger	1400	-	136	27811536	82902
chr13	113718182	113918182	harbor1	chr13	113785864	113786097	DNA/TcMar-Tigger	480	-	116	113785980	67798
chr13	20314698	20514698	harbor1	chr13	20413504	20413831	DNA/TcMar-Tigger	1527	-	164	20413668	98970
chr13	113713649	113913649	harbor1	chr13	113785864	113786097	DNA/TcMar-Tigger	480	-	116	113785980	72331
chr13	50025212	50225212	harbor1	chr13	50030126	50030645	DNA/TcMar-Tigger	2419	-	260	50030386	5174
chr13	20315192	20515192	harbor1	chr13	20413504	20413831	DNA/TcMar-Tigger	1527	-	164	20413668	98476
chr13	48133654	48333654	harbor1	chr13	48225674	48226005	DNA/TcMar-Tigger	2265	-	166	48225840	92186
chr13	100574881	100774881	harbor1	chr13	100613402	100613604	DNA/TcMar-Tigger	544	-	101	100613503	38622
chr13	100574881	100774881	harbor1	chr13	100633592	100633858	DNA/TcMar-Tigger	1835	-	133	100633725	58844
chr13	100574881	100774881	harbor1	chr13	100634156	100634236	DNA/TcMar-Tigger	1835	-	40	100634196	59315
chr13	100574914	100774914	harbor1	chr13	100613402	100613604	DNA/TcMar-Tigger	544	-	101	100613503	38589
chr13	100574914	100774914	harbor1	chr13	100633592	100633858	DNA/TcMar-Tigger	1835	-	133	100633725	58811
chr13	100574914	100774914	harbor1	chr13	100634156	100634236	DNA/TcMar-Tigger	1835	-	40	100634196	59282
chr13	113726184	113926184	harbor1	chr13	113785864	113786097	DNA/TcMar-Tigger	480	-	116	113785980	59796
chr13	113726144	113926144	harbor1	chr13	113785864	113786097	DNA/TcMar-Tigger	480	-	116	113785980	59836
chr13	20315123	20515123	harbor1	chr13	20413504	20413831	DNA/TcMar-Tigger	1527	-	164	20413668	98545
chr13	98425553	98625553	harbor1	chr13	98453875	98454046	DNA/TcMar-Tigger	649	-	86	98453961	28408
chr13	51810106	52010106	harbor1	chr13	51824609	51824670	DNA/TcMar-Tigger	558	-	30	51824639	14533
chr13	51810106	52010106	harbor1	chr13	51824972	51825296	DNA/TcMar-Tigger	558	-	162	51825134	15028
chr13	51810106	52010106	harbor1	chr13	51852900	51853124	DNA/TcMar-Tigger	2223	-	112	51853012	42906
chr13	51810106	52010106	harbor1	chr13	51853439	51853630	DNA/TcMar-Tigger	2223	-	96	51853535	43429
chr13	113726163	113926163	harbor1	chr13	113785864	113786097	DNA/TcMar-Tigger	480	-	116	113785980	59817
chr13	113725831	113925831	harbor1	chr13	113785864	113786097	DNA/TcMar-Tigger	480	-	116	113785980	60149
chr13	99473104	99673104	harbor1	chr13	99528463	99528754	DNA/TcMar-Tigger	429	-	146	99528609	55505
chr13	99473104	99673104	harbor1	chr13	99529872	99530086	DNA/TcMar-Tigger	1167	-	107	99529979	56875
chr13	99473104	99673104	harbor1	chr13	99530096	99530148	DNA/TcMar-Tigger	877	-	26	99530122	57018
chr13	99473104	99673104	harbor1	chr13	99530447	99530557	DNA/TcMar-Tigger	877	-	55	99530502	57398
chr13	99473104	99673104	harbor1	chr13	99564506	99564822	DNA/TcMar-Tigger	1258	-	158	99564664	91560
chr13	19461422	19661422	harbor1	chr13	19482869	19483258	DNA/TcMar-Tigger	2318	-	194	19483063	21641
chr13	19461422	19661422	harbor1	chr13	19488235	19489396	DNA/TcMar-Tigger	7159	-	580	19488815	27393
chr13	19461422	19661422	harbor1	chr13	19534022	19534366	DNA/TcMar-Tigger	1792	-	172	19534194	72772
chr13	21574752	21774752	harbor1	chr13	21630401	21630726	DNA/TcMar-Tigger	1559	-	162	21630563	55811
chr13	21574752	21774752	harbor1	chr13	21657595	21657685	DNA/TcMar-Tigger	482	-	45	21657640	82888
chr13	21574752	21774752	harbor1	chr13	21657685	21657947	DNA/TcMar-Tigger	1423	-	131	21657816	83064
chr13	113726255	113926255	harbor1	chr13	113785864	113786097	DNA/TcMar-Tigger	480	-	116	113785980	59725
chr13	20315141	20515141	harbor1	chr13	20413504	20413831	DNA/TcMar-Tigger	1527	-	164	20413668	98527
chr13	20315163	20515163	harbor1	chr13	20413504	20413831	DNA/TcMar-Tigger	1527	-	164	20413668	98505
chr13	100574912	100774912	harbor1	chr13	100613402	100613604	DNA/TcMar-Tigger	544	-	101	100613503	38591
chr13	100574912	100774912	harbor1	chr13	100633592	100633858	DNA/TcMar-Tigger	1835	-	133	100633725	58813
chr13	100574912	100774912	harbor1	chr13	100634156	100634236	DNA/TcMar-Tigger	1835	-	40	100634196	59284
chr13	113726358	113926358	harbor1	chr13	113785864	113786097	DNA/TcMar-Tigger	480	-	116	113785980	59622
chr13	113726286	113926286	harbor1	chr13	113785864	113786097	DNA/TcMar-Tigger	480	-	116	113785980	59694
chr13	19984869	20184869	harbor1	chr13	20011252	20011480	DNA/TcMar-Tigger	1106	-	114	20011366	26497
chr13	19984869	20184869	harbor1	chr13	20025672	20025953	DNA/TcMar-Tigger	1512	-	140	20025812	40943
chr13	19984869	20184869	harbor1	chr13	20028542	20028872	DNA/TcMar-Tigger	1630	-	165	20028707	43838
chr13	19984869	20184869	harbor1	chr13	20066241	20066360	DNA/TcMar-Tigger	545	-	60	20066301	81432
chr13	19984869	20184869	harbor1	chr13	20066352	20066759	DNA/TcMar-Tigger	1805	-	204	20066556	81687
chr13	50026224	50226224	harbor1	chr13	50030126	50030645	DNA/TcMar-Tigger	2419	-	260	50030386	4162
chr13	75438285	75638285	harbor1	chr13	75449312	75449531	DNA/TcMar-Tigger	1223	-	110	75449422	11137
chr13	75438285	75638285	harbor1	chr13	75475813	75475960	DNA/TcMar-Tigger	1601	-	74	75475887	37602
chr13	75438285	75638285	harbor1	chr13	75476271	75476459	DNA/TcMar-Tigger	1601	-	94	75476365	38080
chr13	75438285	75638285	harbor1	chr13	75524679	75524859	DNA/TcMar-Tigger	524	-	90	75524769	86484
chr13	36899488	37099488	harbor1	chr13	36943764	36944699	DNA/TcMar-Tigger	14257	-	468	36944232	44744
chr13	36899488	37099488	harbor1	chr13	36946252	36946639	DNA/TcMar-Tigger	14257	-	194	36946446	46958
chr13	36899488	37099488	harbor1	chr13	36946930	36947271	DNA/TcMar-Tigger	14257	-	170	36947100	47612
chr13	36899488	37099488	harbor1	chr13	36912884	36913180	DNA/TcMar-Tigger	1206	-	148	36913032	13544
chr13	36899488	37099488	harbor1	chr13	36945001	36945961	DNA/TcMar-Tigger	14257	-	480	36945481	45993
chr13	20315167	20515167	harbor1	chr13	20413504	20413831	DNA/TcMar-Tigger	1527	-	164	20413668	98501
chr14	24016236	24216236	harbor1	chr14	24044669	24044947	DNA/TcMar-Tigger	9707	-	139	24044808	28572
chr14	24016236	24216236	harbor1	chr14	24045247	24046348	DNA/TcMar-Tigger	9707	-	550	24045797	29561
chr14	24016236	24216236	harbor1	chr14	24046339	24046955	DNA/TcMar-Tigger	3811	-	308	24046647	30411
chr14	88724597	88924597	harbor1	chr14	88728303	88728734	DNA/TcMar-Tigger	2458	-	216	88728519	3922
chr14	88724597	88924597	harbor1	chr14	88811072	88811353	DNA/TcMar-Tigger	1671	-	140	88811212	86615
chr14	103423043	103623043	harbor1	chr14	103513689	103513920	DNA/TcMar-Tigger	1202	-	116	103513805	90762
chr14	64194243	64394243	harbor1	chr14	64233566	64234154	DNA/TcMar-Tigger	3099	-	294	64233860	39617
chr14	64194243	64394243	harbor1	chr14	64243196	64243535	DNA/TcMar-Tigger	1926	-	170	64243366	49123
chr14	64194243	64394243	harbor1	chr14	64266556	64266900	DNA/TcMar-Tigger	1213	-	172	64266728	72485
chr14	64194243	64394243	harbor1	chr14	64267179	64267489	DNA/TcMar-Tigger	1213	-	155	64267334	73091
chr14	66383081	66583081	harbor1	chr14	66437472	66438114	DNA/TcMar-Tigger	3585	-	321	66437793	54712
chr14	100183362	100383362	harbor1	chr14	100271501	100271700	DNA/TcMar-Tigger	831	-	100	100271601	88239
chr14	100183362	100383362	harbor1	chr14	100271859	100271987	DNA/TcMar-Tigger	500	-	64	100271923	88561
chr14	75327984	75527984	harbor1	chr14	75356187	75356719	DNA/TcMar-Tigger	948	-	266	75356453	28469
chr14	100185484	100385484	harbor1	chr14	100271501	100271700	DNA/TcMar-Tigger	831	-	100	100271601	86117
chr14	100185484	100385484	harbor1	chr14	100271859	100271987	DNA/TcMar-Tigger	500	-	64	100271923	86439
chr14	23961782	24161782	harbor1	chr14	23961899	23964226	DNA/TcMar-Tigger	16078	-	1164	23963063	1281
chr14	23961782	24161782	harbor1	chr14	23997021	23999350	DNA/TcMar-Tigger	15973	-	1164	23998185	36403
chr14	23961782	24161782	harbor1	chr14	24044669	24044947	DNA/TcMar-Tigger	9707	-	139	24044808	83026
chr14	23961782	24161782	harbor1	chr14	24045247	24046348	DNA/TcMar-Tigger	9707	-	550	24045797	84015
chr14	23961782	24161782	harbor1	chr14	24046339	24046955	DNA/TcMar-Tigger	3811	-	308	24046647	84865
chr14	57989413	58189413	harbor1	chr14	58022806	58025175	DNA/TcMar-Tigger	15316	-	1184	58023990	34577
chr14	57989413	58189413	harbor1	chr14	58058084	58058332	DNA/TcMar-Tigger	1304	-	124	58058208	68795
chr14	67488947	67688947	harbor1	chr14	67501724	67501892	DNA/TcMar-Tigger	646	-	84	67501808	12861
chr14	67488947	67688947	harbor1	chr14	67543092	67543250	DNA/TcMar-Tigger	492	-	79	67543171	54224
chr14	54388477	54588477	harbor1	chr14	54421582	54421768	DNA/TcMar-Tigger	922	-	93	54421675	33198
chr14	73659272	73859272	harbor1	chr14	73680689	73681122	DNA/TcMar-Tigger	6625	-	216	73680905	21633
chr14	73659272	73859272	harbor1	chr14	73681433	73681486	DNA/TcMar-Tigger	6625	-	26	73681459	22187
chr14	73659272	73859272	harbor1	chr14	73681815	73681831	DNA/TcMar-Tigger	6625	-	8	73681823	22551
chr14	73659272	73859272	harbor1	chr14	73682118	73682171	DNA/TcMar-Tigger	6625	-	26	73682144	22872
chr14	73659272	73859272	harbor1	chr14	73682489	73682869	DNA/TcMar-Tigger	6625	-	190	73682679	23407
chr14	73659272	73859272	harbor1	chr14	73683176	73683501	DNA/TcMar-Tigger	6625	-	162	73683338	24066
chr14	103462452	103662452	harbor1	chr14	103513689	103513920	DNA/TcMar-Tigger	1202	-	116	103513805	51353
chr14	75328384	75528384	harbor1	chr14	75356187	75356719	DNA/TcMar-Tigger	948	-	266	75356453	28069
chr14	51349924	51549924	harbor1	chr14	51352970	51353201	DNA/TcMar-Tigger	537	-	116	51353086	3162
chr14	51349924	51549924	harbor1	chr14	51353504	51353670	DNA/TcMar-Tigger	537	-	83	51353587	3663
chr14	51349924	51549924	harbor1	chr14	51400458	51400827	DNA/TcMar-Tigger	1205	-	184	51400642	50718
chr14	65117756	65317756	harbor1	chr14	65195336	65195428	DNA/TcMar-Tigger	968	-	46	65195382	77626
chr14	65117756	65317756	harbor1	chr14	65195725	65195856	DNA/TcMar-Tigger	968	-	66	65195791	78035
chr14	103423133	103623133	harbor1	chr14	103513689	103513920	DNA/TcMar-Tigger	1202	-	116	103513805	90672
chr14	23419129	23619129	harbor1	chr14	23470404	23470479	DNA/TcMar-Tigger	461	-	38	23470442	51313
chr14	100224155	100424155	harbor1	chr14	100271501	100271700	DNA/TcMar-Tigger	831	-	100	100271601	47446
chr14	100224155	100424155	harbor1	chr14	100271859	100271987	DNA/TcMar-Tigger	500	-	64	100271923	47768
chr14	104833585	105033585	harbor1	chr14	104914942	104915346	DNA/TcMar-Tigger	2075	-	202	104915144	81559
chr14	104833585	105033585	harbor1	chr14	104916984	104917347	DNA/TcMar-Tigger	1881	-	182	104917166	83581
chr14	71625517	71825517	harbor1	chr14	71648501	71648792	DNA/TcMar-Tigger	789	-	146	71648647	23130
chr14	71625517	71825517	harbor1	chr14	71665701	71665993	DNA/TcMar-Tigger	1570	-	146	71665847	40330
chr14	71625517	71825517	harbor1	chr14	71693041	71693224	DNA/TcMar-Tigger	1033	-	92	71693133	67616
chr14	75328363	75528363	harbor1	chr14	75356187	75356719	DNA/TcMar-Tigger	948	-	266	75356453	28090
chr14	75328401	75528401	harbor1	chr14	75356187	75356719	DNA/TcMar-Tigger	948	-	266	75356453	28052
chr14	49792466	49992466	harbor1	chr14	49836723	49836992	DNA/TcMar-Tigger	1546	-	134	49836857	44391
chr14	49792466	49992466	harbor1	chr14	49837280	49837328	DNA/TcMar-Tigger	1546	-	24	49837304	44838
chr14	49792466	49992466	harbor1	chr14	49843535	49843816	DNA/TcMar-Tigger	2670	-	140	49843675	51209
chr14	49792466	49992466	harbor1	chr14	49844463	49844637	DNA/TcMar-Tigger	2670	-	87	49844550	52084
chr14	49792466	49992466	harbor1	chr14	49845426	49845721	DNA/TcMar-Tigger	1625	-	148	49845574	53108
chr14	49792466	49992466	harbor1	chr14	49845713	49845818	DNA/TcMar-Tigger	503	-	52	49845765	53299
chr14	104017094	104217094	harbor1	chr14	104068358	104068869	DNA/TcMar-Tigger	3672	-	256	104068614	51520
chr14	104017094	104217094	harbor1	chr14	104069389	104069919	DNA/TcMar-Tigger	3672	-	265	104069654	52560
chr14	104017094	104217094	harbor1	chr14	104074877	104075066	DNA/TcMar-Tigger	1581	-	94	104074971	57877
chr14	104017094	104217094	harbor1	chr14	104075374	104075505	DNA/TcMar-Tigger	1581	-	66	104075440	58346
chr14	73660276	73860276	harbor1	chr14	73680689	73681122	DNA/TcMar-Tigger	6625	-	216	73680905	20629
chr14	73660276	73860276	harbor1	chr14	73681433	73681486	DNA/TcMar-Tigger	6625	-	26	73681459	21183
chr14	73660276	73860276	harbor1	chr14	73681815	73681831	DNA/TcMar-Tigger	6625	-	8	73681823	21547
chr14	73660276	73860276	harbor1	chr14	73682118	73682171	DNA/TcMar-Tigger	6625	-	26	73682144	21868
chr14	73660276	73860276	harbor1	chr14	73682489	73682869	DNA/TcMar-Tigger	6625	-	190	73682679	22403
chr14	73660276	73860276	harbor1	chr14	73683176	73683501	DNA/TcMar-Tigger	6625	-	162	73683338	23062
chr14	100229913	100429913	harbor1	chr14	100271501	100271700	DNA/TcMar-Tigger	831	-	100	100271601	41688
chr14	100229913	100429913	harbor1	chr14	100271859	100271987	DNA/TcMar-Tigger	500	-	64	100271923	42010
chr14	24047678	24247678	harbor1	chr14	24125546	24125657	DNA/TcMar-Tigger	700	-	56	24125602	77924
chr14	24047678	24247678	harbor1	chr14	24126265	24126376	DNA/TcMar-Tigger	745	-	56	24126321	78643
chr14	24047678	24247678	harbor1	chr14	24126581	24126609	DNA/TcMar-Tigger	5615	-	14	24126595	78917
chr14	24047678	24247678	harbor1	chr14	24126913	24127587	DNA/TcMar-Tigger	5615	-	337	24127250	79572
chr14	24047678	24247678	harbor1	chr14	24127852	24128026	DNA/TcMar-Tigger	5615	-	87	24127939	80261
chr14	24047678	24247678	harbor1	chr14	24128259	24128360	DNA/TcMar-Tigger	704	-	50	24128309	80631
chr14	100185630	100385630	harbor1	chr14	100271501	100271700	DNA/TcMar-Tigger	831	-	100	100271601	85971
chr14	100185630	100385630	harbor1	chr14	100271859	100271987	DNA/TcMar-Tigger	500	-	64	100271923	86293
chr14	73640450	73840450	harbor1	chr14	73646256	73646462	DNA/TcMar-Tigger	1167	-	103	73646359	5909
chr14	73640450	73840450	harbor1	chr14	73646790	73646871	DNA/TcMar-Tigger	1167	-	40	73646830	6380
chr14	73640450	73840450	harbor1	chr14	73649774	73649977	DNA/TcMar-Tigger	1384	-	102	73649876	9426
chr14	73640450	73840450	harbor1	chr14	73650289	73650419	DNA/TcMar-Tigger	1384	-	65	73650354	9904
chr14	73640450	73840450	harbor1	chr14	73680689	73681122	DNA/TcMar-Tigger	6625	-	216	73680905	40455
chr14	73640450	73840450	harbor1	chr14	73681433	73681486	DNA/TcMar-Tigger	6625	-	26	73681459	41009
chr14	73640450	73840450	harbor1	chr14	73681815	73681831	DNA/TcMar-Tigger	6625	-	8	73681823	41373
chr14	73640450	73840450	harbor1	chr14	73682118	73682171	DNA/TcMar-Tigger	6625	-	26	73682144	41694
chr14	73640450	73840450	harbor1	chr14	73682489	73682869	DNA/TcMar-Tigger	6625	-	190	73682679	42229
chr14	73640450	73840450	harbor1	chr14	73683176	73683501	DNA/TcMar-Tigger	6625	-	162	73683338	42888
chr14	103419639	103619639	harbor1	chr14	103513689	103513920	DNA/TcMar-Tigger	1202	-	116	103513805	94166
chr14	67482246	67682246	harbor1	chr14	67501724	67501892	DNA/TcMar-Tigger	646	-	84	67501808	19562
chr14	67482246	67682246	harbor1	chr14	67543092	67543250	DNA/TcMar-Tigger	492	-	79	67543171	60925
chr14	75328399	75528399	harbor1	chr14	75356187	75356719	DNA/TcMar-Tigger	948	-	266	75356453	28054
chr14	88724593	88924593	harbor1	chr14	88728303	88728734	DNA/TcMar-Tigger	2458	-	216	88728519	3926
chr14	88724593	88924593	harbor1	chr14	88811072	88811353	DNA/TcMar-Tigger	1671	-	140	88811212	86619
chr14	24047662	24247662	harbor1	chr14	24125546	24125657	DNA/TcMar-Tigger	700	-	56	24125602	77940
chr14	24047662	24247662	harbor1	chr14	24126265	24126376	DNA/TcMar-Tigger	745	-	56	24126321	78659
chr14	24047662	24247662	harbor1	chr14	24126581	24126609	DNA/TcMar-Tigger	5615	-	14	24126595	78933
chr14	24047662	24247662	harbor1	chr14	24126913	24127587	DNA/TcMar-Tigger	5615	-	337	24127250	79588
chr14	24047662	24247662	harbor1	chr14	24127852	24128026	DNA/TcMar-Tigger	5615	-	87	24127939	80277
chr14	24047662	24247662	harbor1	chr14	24128259	24128360	DNA/TcMar-Tigger	704	-	50	24128309	80647
chr14	67108235	67308235	harbor1	chr14	67108910	67109226	DNA/TcMar-Tigger	1462	-	158	67109068	833
chr14	100182074	100382074	harbor1	chr14	100271501	100271700	DNA/TcMar-Tigger	831	-	100	100271601	89527
chr14	100182074	100382074	harbor1	chr14	100271859	100271987	DNA/TcMar-Tigger	500	-	64	100271923	89849
chr14	105387228	105587228	harbor1	chr14	105429024	105429290	DNA/TcMar-Tigger	1378	-	133	105429157	41929
chr14	105387228	105587228	harbor1	chr14	105430057	105430657	DNA/TcMar-Tigger	3047	-	300	105430357	43129
chr14	105388150	105588150	harbor1	chr14	105429024	105429290	DNA/TcMar-Tigger	1378	-	133	105429157	41007
chr14	105388150	105588150	harbor1	chr14	105430057	105430657	DNA/TcMar-Tigger	3047	-	300	105430357	42207
chr14	24047772	24247772	harbor1	chr14	24125546	24125657	DNA/TcMar-Tigger	700	-	56	24125602	77830
chr14	24047772	24247772	harbor1	chr14	24126265	24126376	DNA/TcMar-Tigger	745	-	56	24126321	78549
chr14	24047772	24247772	harbor1	chr14	24126581	24126609	DNA/TcMar-Tigger	5615	-	14	24126595	78823
chr14	24047772	24247772	harbor1	chr14	24126913	24127587	DNA/TcMar-Tigger	5615	-	337	24127250	79478
chr14	24047772	24247772	harbor1	chr14	24127852	24128026	DNA/TcMar-Tigger	5615	-	87	24127939	80167
chr14	24047772	24247772	harbor1	chr14	24128259	24128360	DNA/TcMar-Tigger	704	-	50	24128309	80537
chr14	55014896	55214896	harbor1	chr14	55020681	55021407	DNA/TcMar-Tigger	9050	-	363	55021044	6148
chr14	55014896	55214896	harbor1	chr14	55021686	55022482	DNA/TcMar-Tigger	9050	-	398	55022084	7188
chr14	55014896	55214896	harbor1	chr14	55022710	55022814	DNA/TcMar-Tigger	6727	-	52	55022762	7866
chr14	55014896	55214896	harbor1	chr14	55023114	55024174	DNA/TcMar-Tigger	6727	-	530	55023644	8748
chr14	55014896	55214896	harbor1	chr14	55032440	55032739	DNA/TcMar-Tigger	841	-	150	55032590	17694
chr14	55014896	55214896	harbor1	chr14	55034440	55034551	DNA/TcMar-Tigger	748	-	56	55034496	19600
chr14	55014896	55214896	harbor1	chr14	55034833	55034859	DNA/TcMar-Tigger	748	-	13	55034846	19950
chr14	55014896	55214896	harbor1	chr14	55035161	55035561	DNA/TcMar-Tigger	748	-	200	55035361	20465
chr14	55014896	55214896	harbor1	chr14	55040268	55040462	DNA/TcMar-Tigger	1243	-	97	55040365	25469
chr14	55014896	55214896	harbor1	chr14	55040754	55040867	DNA/TcMar-Tigger	1243	-	56	55040810	25914
chr14	55014896	55214896	harbor1	chr14	55052864	55053112	DNA/TcMar-Tigger	656	-	124	55052988	38092
chr14	55014896	55214896	harbor1	chr14	55053906	55054071	DNA/TcMar-Tigger	883	-	82	55053988	39092
chr14	55014896	55214896	harbor1	chr14	55055524	55055650	DNA/TcMar-Tigger	814	-	63	55055587	40691
chr14	55014896	55214896	harbor1	chr14	55055947	55056015	DNA/TcMar-Tigger	814	-	34	55055981	41085
chr14	55014896	55214896	harbor1	chr14	55057358	55057477	DNA/TcMar-Tigger	771	-	60	55057418	42522
chr14	55014896	55214896	harbor1	chr14	55057947	55058331	DNA/TcMar-Tigger	1996	-	192	55058139	43243
chr14	55014896	55214896	harbor1	chr14	55094982	55095371	DNA/TcMar-Tigger	1567	-	194	55095176	80280
chr14	55014896	55214896	harbor1	chr14	55082676	55083041	DNA/TcMar-Tigger	2564	-	182	55082858	67962
chr14	100185510	100385510	harbor1	chr14	100271501	100271700	DNA/TcMar-Tigger	831	-	100	100271601	86091
chr14	100185510	100385510	harbor1	chr14	100271859	100271987	DNA/TcMar-Tigger	500	-	64	100271923	86413
chr14	75328390	75528390	harbor1	chr14	75356187	75356719	DNA/TcMar-Tigger	948	-	266	75356453	28063
chr14	100229963	100429963	harbor1	chr14	100271501	100271700	DNA/TcMar-Tigger	831	-	100	100271601	41638
chr14	100229963	100429963	harbor1	chr14	100271859	100271987	DNA/TcMar-Tigger	500	-	64	100271923	41960
chr14	73999218	74199218	harbor1	chr14	74010616	74010761	DNA/TcMar-Tigger	563	-	72	74010688	11470
chr14	104017097	104217097	harbor1	chr14	104068358	104068869	DNA/TcMar-Tigger	3672	-	256	104068614	51517
chr14	104017097	104217097	harbor1	chr14	104069389	104069919	DNA/TcMar-Tigger	3672	-	265	104069654	52557
chr14	104017097	104217097	harbor1	chr14	104074877	104075066	DNA/TcMar-Tigger	1581	-	94	104074971	57874
chr14	104017097	104217097	harbor1	chr14	104075374	104075505	DNA/TcMar-Tigger	1581	-	66	104075440	58343
chr14	75328424	75528424	harbor1	chr14	75356187	75356719	DNA/TcMar-Tigger	948	-	266	75356453	28029
chr14	50142883	50342883	harbor1	chr14	50183849	50184172	DNA/TcMar-Tigger	1570	-	162	50184011	41128
chr14	50142883	50342883	harbor1	chr14	50206317	50206655	DNA/TcMar-Tigger	1945	-	169	50206486	63603
chr14	104877001	105077001	harbor1	chr14	104914942	104915346	DNA/TcMar-Tigger	2075	-	202	104915144	38143
chr14	104877001	105077001	harbor1	chr14	104916984	104917347	DNA/TcMar-Tigger	1881	-	182	104917166	40165
chr14	95435221	95635221	harbor1	chr14	95496837	95497037	DNA/TcMar-Tigger	491	-	100	95496937	61716
chr14	100012246	100212246	harbor1	chr14	100046135	100046283	DNA/TcMar-Tigger	923	-	74	100046209	33963
chr14	100012246	100212246	harbor1	chr14	100061593	100061967	DNA/TcMar-Tigger	2027	-	187	100061780	49534
chr14	100012246	100212246	harbor1	chr14	100088373	100088705	DNA/TcMar-Tigger	2120	-	166	100088539	76293
chr14	54692460	54892460	harbor1	chr14	54713964	54714664	DNA/TcMar-Tigger	1659	-	350	54714314	21854
chr14	54692460	54892460	harbor1	chr14	54726895	54727154	DNA/TcMar-Tigger	2549	-	130	54727025	34565
chr14	54692460	54892460	harbor1	chr14	54727489	54727787	DNA/TcMar-Tigger	2549	-	149	54727638	35178
chr14	54692460	54892460	harbor1	chr14	54771925	54772199	DNA/TcMar-Tigger	782	-	137	54772062	79602
chr14	67500383	67700383	harbor1	chr14	67501724	67501892	DNA/TcMar-Tigger	646	-	84	67501808	1425
chr14	67500383	67700383	harbor1	chr14	67543092	67543250	DNA/TcMar-Tigger	492	-	79	67543171	42788
chr14	67500383	67700383	harbor1	chr14	67594704	67594867	DNA/TcMar-Tigger	1403	-	82	67594786	94403
chr14	67500383	67700383	harbor1	chr14	67595166	67595409	DNA/TcMar-Tigger	1403	-	122	67595288	94905
chr14	105287660	105487660	harbor1	chr14	105360059	105360258	DNA/TcMar-Tigger	12455	-	100	105360159	72499
chr14	105287660	105487660	harbor1	chr14	105360570	105361211	DNA/TcMar-Tigger	12455	-	320	105360890	73230
chr14	105287660	105487660	harbor1	chr14	105362446	105362568	DNA/TcMar-Tigger	12455	-	61	105362507	74847
chr14	105287660	105487660	harbor1	chr14	105362865	105364256	DNA/TcMar-Tigger	12455	-	696	105363561	75901
chr14	55029359	55229359	harbor1	chr14	55032440	55032739	DNA/TcMar-Tigger	841	-	150	55032590	3231
chr14	55029359	55229359	harbor1	chr14	55034440	55034551	DNA/TcMar-Tigger	748	-	56	55034496	5137
chr14	55029359	55229359	harbor1	chr14	55034833	55034859	DNA/TcMar-Tigger	748	-	13	55034846	5487
chr14	55029359	55229359	harbor1	chr14	55035161	55035561	DNA/TcMar-Tigger	748	-	200	55035361	6002
chr14	55029359	55229359	harbor1	chr14	55040268	55040462	DNA/TcMar-Tigger	1243	-	97	55040365	11006
chr14	55029359	55229359	harbor1	chr14	55040754	55040867	DNA/TcMar-Tigger	1243	-	56	55040810	11451
chr14	55029359	55229359	harbor1	chr14	55052864	55053112	DNA/TcMar-Tigger	656	-	124	55052988	23629
chr14	55029359	55229359	harbor1	chr14	55053906	55054071	DNA/TcMar-Tigger	883	-	82	55053988	24629
chr14	55029359	55229359	harbor1	chr14	55055524	55055650	DNA/TcMar-Tigger	814	-	63	55055587	26228
chr14	55029359	55229359	harbor1	chr14	55055947	55056015	DNA/TcMar-Tigger	814	-	34	55055981	26622
chr14	55029359	55229359	harbor1	chr14	55057358	55057477	DNA/TcMar-Tigger	771	-	60	55057418	28059
chr14	55029359	55229359	harbor1	chr14	55057947	55058331	DNA/TcMar-Tigger	1996	-	192	55058139	28780
chr14	55029359	55229359	harbor1	chr14	55094982	55095371	DNA/TcMar-Tigger	1567	-	194	55095176	65817
chr14	55029359	55229359	harbor1	chr14	55082676	55083041	DNA/TcMar-Tigger	2564	-	182	55082858	53499
chr14	103445438	103645438	harbor1	chr14	103513689	103513920	DNA/TcMar-Tigger	1202	-	116	103513805	68367
chr14	91224876	91424876	harbor1	chr14	91298995	91299595	DNA/TcMar-Tigger	2906	-	300	91299295	74419
chr14	105819141	106019141	harbor1	chr14	105824648	105824916	DNA/TcMar-Tigger	1781	-	134	105824782	5641
chr15	89279015	89479015	harbor1	chr15	89285314	89285372	DNA/TcMar-Tigger	1068	-	29	89285343	6328
chr15	89279015	89479015	harbor1	chr15	89285624	89285986	DNA/TcMar-Tigger	1068	-	181	89285805	6790
chr15	89279015	89479015	harbor1	chr15	89286293	89286437	DNA/TcMar-Tigger	1068	-	72	89286365	7350
chr15	89279015	89479015	harbor1	chr15	89286440	89286977	DNA/TcMar-Tigger	9576	-	268	89286708	7693
chr15	89279015	89479015	harbor1	chr15	89287273	89288137	DNA/TcMar-Tigger	9576	-	432	89287705	8690
chr15	89279015	89479015	harbor1	chr15	89344850	89345463	DNA/TcMar-Tigger	3556	-	306	89345156	66141
chr15	50319048	50519048	harbor1	chr15	50394348	50394389	DNA/TcMar-Tigger	628	-	20	50394368	75320
chr15	50319048	50519048	harbor1	chr15	50394668	50394783	DNA/TcMar-Tigger	628	-	58	50394726	75678
chr15	35446216	35646216	harbor1	chr15	35457907	35458229	DNA/TcMar-Tigger	1158	-	161	35458068	11852
chr15	35446216	35646216	harbor1	chr15	35466617	35467282	DNA/TcMar-Tigger	4917	-	332	35466949	20733
chr15	35446216	35646216	harbor1	chr15	35467596	35467834	DNA/TcMar-Tigger	4917	-	119	35467715	21499
chr15	35446216	35646216	harbor1	chr15	35467835	35468017	DNA/TcMar-Tigger	1023	-	91	35467926	21710
chr15	35446299	35646299	harbor1	chr15	35457907	35458229	DNA/TcMar-Tigger	1158	-	161	35458068	11769
chr15	35446299	35646299	harbor1	chr15	35466617	35467282	DNA/TcMar-Tigger	4917	-	332	35466949	20650
chr15	35446299	35646299	harbor1	chr15	35467596	35467834	DNA/TcMar-Tigger	4917	-	119	35467715	21416
chr15	35446299	35646299	harbor1	chr15	35467835	35468017	DNA/TcMar-Tigger	1023	-	91	35467926	21627
chr15	74737065	74937065	harbor1	chr15	74741764	74741974	DNA/TcMar-Tigger	1819	-	105	74741869	4804
chr15	74737065	74937065	harbor1	chr15	74742277	74742428	DNA/TcMar-Tigger	1819	-	76	74742353	5288
chr15	74737065	74937065	harbor1	chr15	74795708	74795935	DNA/TcMar-Tigger	2168	-	114	74795822	58757
chr15	74737065	74937065	harbor1	chr15	74796243	74796445	DNA/TcMar-Tigger	2168	-	101	74796344	59279
chr15	74496627	74696627	harbor1	chr15	74550958	74551183	DNA/TcMar-Tigger	1285	-	112	74551070	54443
chr15	74496627	74696627	harbor1	chr15	74554793	74554990	DNA/TcMar-Tigger	1960	-	98	74554891	58264
chr15	74496627	74696627	harbor1	chr15	74555135	74555330	DNA/TcMar-Tigger	1960	-	98	74555233	58606
chr15	74496627	74696627	harbor1	chr15	74555635	74555782	DNA/TcMar-Tigger	1040	-	74	74555709	59082
chr15	74496627	74696627	harbor1	chr15	74556091	74556511	DNA/TcMar-Tigger	2715	-	210	74556301	59674
chr15	74496627	74696627	harbor1	chr15	74557598	74557728	DNA/TcMar-Tigger	842	-	65	74557663	61036
chr15	74496627	74696627	harbor1	chr15	74593586	74593758	DNA/TcMar-Tigger	522	-	86	74593672	97045
chr15	74496627	74696627	harbor1	chr15	74594066	74594120	DNA/TcMar-Tigger	522	-	27	74594093	97466
chr15	35446212	35646212	harbor1	chr15	35457907	35458229	DNA/TcMar-Tigger	1158	-	161	35458068	11856
chr15	35446212	35646212	harbor1	chr15	35466617	35467282	DNA/TcMar-Tigger	4917	-	332	35466949	20737
chr15	35446212	35646212	harbor1	chr15	35467596	35467834	DNA/TcMar-Tigger	4917	-	119	35467715	21503
chr15	35446212	35646212	harbor1	chr15	35467835	35468017	DNA/TcMar-Tigger	1023	-	91	35467926	21714
chr15	35446272	35646272	harbor1	chr15	35457907	35458229	DNA/TcMar-Tigger	1158	-	161	35458068	11796
chr15	35446272	35646272	harbor1	chr15	35466617	35467282	DNA/TcMar-Tigger	4917	-	332	35466949	20677
chr15	35446272	35646272	harbor1	chr15	35467596	35467834	DNA/TcMar-Tigger	4917	-	119	35467715	21443
chr15	35446272	35646272	harbor1	chr15	35467835	35468017	DNA/TcMar-Tigger	1023	-	91	35467926	21654
chr15	35446324	35646324	harbor1	chr15	35457907	35458229	DNA/TcMar-Tigger	1158	-	161	35458068	11744
chr15	35446324	35646324	harbor1	chr15	35466617	35467282	DNA/TcMar-Tigger	4917	-	332	35466949	20625
chr15	35446324	35646324	harbor1	chr15	35467596	35467834	DNA/TcMar-Tigger	4917	-	119	35467715	21391
chr15	35446324	35646324	harbor1	chr15	35467835	35468017	DNA/TcMar-Tigger	1023	-	91	35467926	21602
chr15	101861586	102061586	harbor1	chr15	101910446	101910905	DNA/TcMar-Tigger	2325	-	230	101910676	49090
chr15	101861586	102061586	harbor1	chr15	101910906	101911040	DNA/TcMar-Tigger	1033	-	67	101910973	49387
chr15	101861586	102061586	harbor1	chr15	101911333	101911425	DNA/TcMar-Tigger	1033	-	46	101911379	49793
chr15	74510960	74710960	harbor1	chr15	74550958	74551183	DNA/TcMar-Tigger	1285	-	112	74551070	40110
chr15	74510960	74710960	harbor1	chr15	74554793	74554990	DNA/TcMar-Tigger	1960	-	98	74554891	43931
chr15	74510960	74710960	harbor1	chr15	74555135	74555330	DNA/TcMar-Tigger	1960	-	98	74555233	44273
chr15	74510960	74710960	harbor1	chr15	74555635	74555782	DNA/TcMar-Tigger	1040	-	74	74555709	44749
chr15	74510960	74710960	harbor1	chr15	74556091	74556511	DNA/TcMar-Tigger	2715	-	210	74556301	45341
chr15	74510960	74710960	harbor1	chr15	74557598	74557728	DNA/TcMar-Tigger	842	-	65	74557663	46703
chr15	74510960	74710960	harbor1	chr15	74593586	74593758	DNA/TcMar-Tigger	522	-	86	74593672	82712
chr15	74510960	74710960	harbor1	chr15	74594066	74594120	DNA/TcMar-Tigger	522	-	27	74594093	83133
chr15	35446318	35646318	harbor1	chr15	35457907	35458229	DNA/TcMar-Tigger	1158	-	161	35458068	11750
chr15	35446318	35646318	harbor1	chr15	35466617	35467282	DNA/TcMar-Tigger	4917	-	332	35466949	20631
chr15	35446318	35646318	harbor1	chr15	35467596	35467834	DNA/TcMar-Tigger	4917	-	119	35467715	21397
chr15	35446318	35646318	harbor1	chr15	35467835	35468017	DNA/TcMar-Tigger	1023	-	91	35467926	21608
chr15	101858909	102058909	harbor1	chr15	101910446	101910905	DNA/TcMar-Tigger	2325	-	230	101910676	51767
chr15	101858909	102058909	harbor1	chr15	101910906	101911040	DNA/TcMar-Tigger	1033	-	67	101910973	52064
chr15	101858909	102058909	harbor1	chr15	101911333	101911425	DNA/TcMar-Tigger	1033	-	46	101911379	52470
chr15	35446271	35646271	harbor1	chr15	35457907	35458229	DNA/TcMar-Tigger	1158	-	161	35458068	11797
chr15	35446271	35646271	harbor1	chr15	35466617	35467282	DNA/TcMar-Tigger	4917	-	332	35466949	20678
chr15	35446271	35646271	harbor1	chr15	35467596	35467834	DNA/TcMar-Tigger	4917	-	119	35467715	21444
chr15	35446271	35646271	harbor1	chr15	35467835	35468017	DNA/TcMar-Tigger	1023	-	91	35467926	21655
chr15	35446266	35646266	harbor1	chr15	35457907	35458229	DNA/TcMar-Tigger	1158	-	161	35458068	11802
chr15	35446266	35646266	harbor1	chr15	35466617	35467282	DNA/TcMar-Tigger	4917	-	332	35466949	20683
chr15	35446266	35646266	harbor1	chr15	35467596	35467834	DNA/TcMar-Tigger	4917	-	119	35467715	21449
chr15	35446266	35646266	harbor1	chr15	35467835	35468017	DNA/TcMar-Tigger	1023	-	91	35467926	21660
chr15	35446252	35646252	harbor1	chr15	35457907	35458229	DNA/TcMar-Tigger	1158	-	161	35458068	11816
chr15	35446252	35646252	harbor1	chr15	35466617	35467282	DNA/TcMar-Tigger	4917	-	332	35466949	20697
chr15	35446252	35646252	harbor1	chr15	35467596	35467834	DNA/TcMar-Tigger	4917	-	119	35467715	21463
chr15	35446252	35646252	harbor1	chr15	35467835	35468017	DNA/TcMar-Tigger	1023	-	91	35467926	21674
chr15	35446296	35646296	harbor1	chr15	35457907	35458229	DNA/TcMar-Tigger	1158	-	161	35458068	11772
chr15	35446296	35646296	harbor1	chr15	35466617	35467282	DNA/TcMar-Tigger	4917	-	332	35466949	20653
chr15	35446296	35646296	harbor1	chr15	35467596	35467834	DNA/TcMar-Tigger	4917	-	119	35467715	21419
chr15	35446296	35646296	harbor1	chr15	35467835	35468017	DNA/TcMar-Tigger	1023	-	91	35467926	21630
chr15	79796978	79996978	harbor1	chr15	79849763	79849976	DNA/TcMar-Tigger	504	-	106	79849869	52891
chr15	35446210	35646210	harbor1	chr15	35457907	35458229	DNA/TcMar-Tigger	1158	-	161	35458068	11858
chr15	35446210	35646210	harbor1	chr15	35466617	35467282	DNA/TcMar-Tigger	4917	-	332	35466949	20739
chr15	35446210	35646210	harbor1	chr15	35467596	35467834	DNA/TcMar-Tigger	4917	-	119	35467715	21505
chr15	35446210	35646210	harbor1	chr15	35467835	35468017	DNA/TcMar-Tigger	1023	-	91	35467926	21716
chr15	25338180	25538180	harbor1	chr15	25349515	25349983	DNA/TcMar-Tigger	1942	-	234	25349749	11569
chr15	25338180	25538180	harbor1	chr15	25352347	25352553	DNA/TcMar-Tigger	1158	-	103	25352450	14270
chr15	25338180	25538180	harbor1	chr15	25352550	25352650	DNA/TcMar-Tigger	594	-	50	25352600	14420
chr15	25338180	25538180	harbor1	chr15	25353342	25353578	DNA/TcMar-Tigger	1108	-	118	25353460	15280
chr15	25338180	25538180	harbor1	chr15	25400240	25400549	DNA/TcMar-Tigger	1379	-	154	25400394	62214
chr15	25338180	25538180	harbor1	chr15	25417957	25418238	DNA/TcMar-Tigger	1369	-	140	25418097	79917
chr15	25338180	25538180	harbor1	chr15	25418856	25419061	DNA/TcMar-Tigger	1150	-	102	25418958	80778
chr15	29332904	29532904	harbor1	chr15	29351014	29351371	DNA/TcMar-Tigger	1708	-	178	29351192	18288
chr15	29332904	29532904	harbor1	chr15	29399586	29400027	DNA/TcMar-Tigger	2640	-	220	29399806	66902
chr15	29332904	29532904	harbor1	chr15	29407034	29407379	DNA/TcMar-Tigger	1972	-	172	29407206	74302
chr15	35446293	35646293	harbor1	chr15	35457907	35458229	DNA/TcMar-Tigger	1158	-	161	35458068	11775
chr15	35446293	35646293	harbor1	chr15	35466617	35467282	DNA/TcMar-Tigger	4917	-	332	35466949	20656
chr15	35446293	35646293	harbor1	chr15	35467596	35467834	DNA/TcMar-Tigger	4917	-	119	35467715	21422
chr15	35446293	35646293	harbor1	chr15	35467835	35468017	DNA/TcMar-Tigger	1023	-	91	35467926	21633
chr15	69999125	70199125	harbor1	chr15	70008320	70008604	DNA/TcMar-Tigger	1029	-	142	70008462	9337
chr15	69999125	70199125	harbor1	chr15	70043281	70043362	DNA/TcMar-Tigger	562	-	40	70043321	44196
chr15	69999125	70199125	harbor1	chr15	70043637	70043654	DNA/TcMar-Tigger	562	-	8	70043645	44520
chr15	29332913	29532913	harbor1	chr15	29351014	29351371	DNA/TcMar-Tigger	1708	-	178	29351192	18279
chr15	29332913	29532913	harbor1	chr15	29399586	29400027	DNA/TcMar-Tigger	2640	-	220	29399806	66893
chr15	29332913	29532913	harbor1	chr15	29407034	29407379	DNA/TcMar-Tigger	1972	-	172	29407206	74293
chr15	72131568	72331568	harbor1	chr15	72138279	72138349	DNA/TcMar-Tigger	628	-	35	72138314	6746
chr15	72131568	72331568	harbor1	chr15	72138650	72138681	DNA/TcMar-Tigger	628	-	16	72138666	7098
chr15	72131568	72331568	harbor1	chr15	72138986	72139064	DNA/TcMar-Tigger	628	-	39	72139025	7457
chr15	72131568	72331568	harbor1	chr15	72139182	72139483	DNA/TcMar-Tigger	1738	-	150	72139332	7764
chr15	99950832	100150832	harbor1	chr15	100042335	100042426	DNA/TcMar-Tigger	597	-	46	100042381	91549
chr15	99950832	100150832	harbor1	chr15	100042421	100042924	DNA/TcMar-Tigger	2855	-	252	100042673	91841
chr15	31768267	31968267	harbor1	chr15	31835839	31836064	DNA/TcMar-Tigger	1345	-	112	31835951	67684
chr15	35446228	35646228	harbor1	chr15	35457907	35458229	DNA/TcMar-Tigger	1158	-	161	35458068	11840
chr15	35446228	35646228	harbor1	chr15	35466617	35467282	DNA/TcMar-Tigger	4917	-	332	35466949	20721
chr15	35446228	35646228	harbor1	chr15	35467596	35467834	DNA/TcMar-Tigger	4917	-	119	35467715	21487
chr15	35446228	35646228	harbor1	chr15	35467835	35468017	DNA/TcMar-Tigger	1023	-	91	35467926	21698
chr15	35446303	35646303	harbor1	chr15	35457907	35458229	DNA/TcMar-Tigger	1158	-	161	35458068	11765
chr15	35446303	35646303	harbor1	chr15	35466617	35467282	DNA/TcMar-Tigger	4917	-	332	35466949	20646
chr15	35446303	35646303	harbor1	chr15	35467596	35467834	DNA/TcMar-Tigger	4917	-	119	35467715	21412
chr15	35446303	35646303	harbor1	chr15	35467835	35468017	DNA/TcMar-Tigger	1023	-	91	35467926	21623
chr15	45029667	45229667	harbor1	chr15	45033188	45033500	DNA/TcMar-Tigger	1197	-	156	45033344	3677
chr15	35446298	35646298	harbor1	chr15	35457907	35458229	DNA/TcMar-Tigger	1158	-	161	35458068	11770
chr15	35446298	35646298	harbor1	chr15	35466617	35467282	DNA/TcMar-Tigger	4917	-	332	35466949	20651
chr15	35446298	35646298	harbor1	chr15	35467596	35467834	DNA/TcMar-Tigger	4917	-	119	35467715	21417
chr15	35446298	35646298	harbor1	chr15	35467835	35468017	DNA/TcMar-Tigger	1023	-	91	35467926	21628
chr15	69999141	70199141	harbor1	chr15	70008320	70008604	DNA/TcMar-Tigger	1029	-	142	70008462	9321
chr15	69999141	70199141	harbor1	chr15	70043281	70043362	DNA/TcMar-Tigger	562	-	40	70043321	44180
chr15	69999141	70199141	harbor1	chr15	70043637	70043654	DNA/TcMar-Tigger	562	-	8	70043645	44504
chr15	35446321	35646321	harbor1	chr15	35457907	35458229	DNA/TcMar-Tigger	1158	-	161	35458068	11747
chr15	35446321	35646321	harbor1	chr15	35466617	35467282	DNA/TcMar-Tigger	4917	-	332	35466949	20628
chr15	35446321	35646321	harbor1	chr15	35467596	35467834	DNA/TcMar-Tigger	4917	-	119	35467715	21394
chr15	35446321	35646321	harbor1	chr15	35467835	35468017	DNA/TcMar-Tigger	1023	-	91	35467926	21605
chr15	98547489	98747489	harbor1	chr15	98583979	98584115	DNA/TcMar-Tigger	513	-	68	98584047	36558
chr15	98547489	98747489	harbor1	chr15	98629613	98629926	DNA/TcMar-Tigger	1501	-	156	98629769	82280
chr15	98547489	98747489	harbor1	chr15	98630233	98630407	DNA/TcMar-Tigger	1501	-	87	98630320	82831
chr15	98547489	98747489	harbor1	chr15	98630705	98630847	DNA/TcMar-Tigger	1501	-	71	98630776	83287
chr15	35446273	35646273	harbor1	chr15	35457907	35458229	DNA/TcMar-Tigger	1158	-	161	35458068	11795
chr15	35446273	35646273	harbor1	chr15	35466617	35467282	DNA/TcMar-Tigger	4917	-	332	35466949	20676
chr15	35446273	35646273	harbor1	chr15	35467596	35467834	DNA/TcMar-Tigger	4917	-	119	35467715	21442
chr15	35446273	35646273	harbor1	chr15	35467835	35468017	DNA/TcMar-Tigger	1023	-	91	35467926	21653
chr15	90133990	90333990	harbor1	chr15	90149092	90149527	DNA/TcMar-Tigger	655	-	218	90149310	15320
chr15	90133990	90333990	harbor1	chr15	90167761	90167923	DNA/TcMar-Tigger	873	-	81	90167842	33852
chr15	90133990	90333990	harbor1	chr15	90168418	90168768	DNA/TcMar-Tigger	2918	-	175	90168593	34603
chr15	90133990	90333990	harbor1	chr15	90169069	90169367	DNA/TcMar-Tigger	2918	-	149	90169218	35228
chr15	45302919	45502919	harbor1	chr15	45389116	45389301	DNA/TcMar-Tigger	583	-	92	45389208	86289
chr15	45302919	45502919	harbor1	chr15	45393640	45393874	DNA/TcMar-Tigger	1541	-	117	45393757	90838
chr15	35446294	35646294	harbor1	chr15	35457907	35458229	DNA/TcMar-Tigger	1158	-	161	35458068	11774
chr15	35446294	35646294	harbor1	chr15	35466617	35467282	DNA/TcMar-Tigger	4917	-	332	35466949	20655
chr15	35446294	35646294	harbor1	chr15	35467596	35467834	DNA/TcMar-Tigger	4917	-	119	35467715	21421
chr15	35446294	35646294	harbor1	chr15	35467835	35468017	DNA/TcMar-Tigger	1023	-	91	35467926	21632
chr15	98321796	98521796	harbor1	chr15	98358352	98358490	DNA/TcMar-Tigger	943	-	69	98358421	36625
chr15	98321796	98521796	harbor1	chr15	98358785	98358829	DNA/TcMar-Tigger	943	-	22	98358807	37011
chr15	98321796	98521796	harbor1	chr15	98359524	98359804	DNA/TcMar-Tigger	1705	-	140	98359664	37868
chr15	69713052	69913052	harbor1	chr15	69715729	69716052	DNA/TcMar-Tigger	15474	-	162	69715891	2839
chr15	69713052	69913052	harbor1	chr15	69716367	69717850	DNA/TcMar-Tigger	15474	-	742	69717109	4057
chr15	69713052	69913052	harbor1	chr15	69718152	69718742	DNA/TcMar-Tigger	15474	-	295	69718447	5395
chr15	25338721	25538721	harbor1	chr15	25349515	25349983	DNA/TcMar-Tigger	1942	-	234	25349749	11028
chr15	25338721	25538721	harbor1	chr15	25352347	25352553	DNA/TcMar-Tigger	1158	-	103	25352450	13729
chr15	25338721	25538721	harbor1	chr15	25352550	25352650	DNA/TcMar-Tigger	594	-	50	25352600	13879
chr15	25338721	25538721	harbor1	chr15	25353342	25353578	DNA/TcMar-Tigger	1108	-	118	25353460	14739
chr15	25338721	25538721	harbor1	chr15	25400240	25400549	DNA/TcMar-Tigger	1379	-	154	25400394	61673
chr15	25338721	25538721	harbor1	chr15	25417957	25418238	DNA/TcMar-Tigger	1369	-	140	25418097	79376
chr15	25338721	25538721	harbor1	chr15	25418856	25419061	DNA/TcMar-Tigger	1150	-	102	25418958	80237
chr15	35446205	35646205	harbor1	chr15	35457907	35458229	DNA/TcMar-Tigger	1158	-	161	35458068	11863
chr15	35446205	35646205	harbor1	chr15	35466617	35467282	DNA/TcMar-Tigger	4917	-	332	35466949	20744
chr15	35446205	35646205	harbor1	chr15	35467596	35467834	DNA/TcMar-Tigger	4917	-	119	35467715	21510
chr15	35446205	35646205	harbor1	chr15	35467835	35468017	DNA/TcMar-Tigger	1023	-	91	35467926	21721
chr15	35446313	35646313	harbor1	chr15	35457907	35458229	DNA/TcMar-Tigger	1158	-	161	35458068	11755
chr15	35446313	35646313	harbor1	chr15	35466617	35467282	DNA/TcMar-Tigger	4917	-	332	35466949	20636
chr15	35446313	35646313	harbor1	chr15	35467596	35467834	DNA/TcMar-Tigger	4917	-	119	35467715	21402
chr15	35446313	35646313	harbor1	chr15	35467835	35468017	DNA/TcMar-Tigger	1023	-	91	35467926	21613
chr15	88185139	88385139	harbor1	chr15	88190222	88190635	DNA/TcMar-Tigger	776	-	206	88190428	5289
chr15	41794702	41994702	harbor1	chr15	41801899	41802472	DNA/TcMar-Tigger	3764	-	286	41802185	7483
chr15	41794702	41994702	harbor1	chr15	41802774	41803015	DNA/TcMar-Tigger	3764	-	120	41802894	8192
chr15	20916532	21116532	harbor1	chr15	20945680	20945819	DNA/TcMar-Tigger	735	-	70	20945750	29218
chr15	31770669	31970669	harbor1	chr15	31835839	31836064	DNA/TcMar-Tigger	1345	-	112	31835951	65282
chr15	35446401	35646401	harbor1	chr15	35457907	35458229	DNA/TcMar-Tigger	1158	-	161	35458068	11667
chr15	35446401	35646401	harbor1	chr15	35466617	35467282	DNA/TcMar-Tigger	4917	-	332	35466949	20548
chr15	35446401	35646401	harbor1	chr15	35467596	35467834	DNA/TcMar-Tigger	4917	-	119	35467715	21314
chr15	35446401	35646401	harbor1	chr15	35467835	35468017	DNA/TcMar-Tigger	1023	-	91	35467926	21525
chr15	74496573	74696573	harbor1	chr15	74550958	74551183	DNA/TcMar-Tigger	1285	-	112	74551070	54497
chr15	74496573	74696573	harbor1	chr15	74554793	74554990	DNA/TcMar-Tigger	1960	-	98	74554891	58318
chr15	74496573	74696573	harbor1	chr15	74555135	74555330	DNA/TcMar-Tigger	1960	-	98	74555233	58660
chr15	74496573	74696573	harbor1	chr15	74555635	74555782	DNA/TcMar-Tigger	1040	-	74	74555709	59136
chr15	74496573	74696573	harbor1	chr15	74556091	74556511	DNA/TcMar-Tigger	2715	-	210	74556301	59728
chr15	74496573	74696573	harbor1	chr15	74557598	74557728	DNA/TcMar-Tigger	842	-	65	74557663	61090
chr15	74496573	74696573	harbor1	chr15	74593586	74593758	DNA/TcMar-Tigger	522	-	86	74593672	97099
chr15	74496573	74696573	harbor1	chr15	74594066	74594120	DNA/TcMar-Tigger	522	-	27	74594093	97520
chr15	35446238	35646238	harbor1	chr15	35457907	35458229	DNA/TcMar-Tigger	1158	-	161	35458068	11830
chr15	35446238	35646238	harbor1	chr15	35466617	35467282	DNA/TcMar-Tigger	4917	-	332	35466949	20711
chr15	35446238	35646238	harbor1	chr15	35467596	35467834	DNA/TcMar-Tigger	4917	-	119	35467715	21477
chr15	35446238	35646238	harbor1	chr15	35467835	35468017	DNA/TcMar-Tigger	1023	-	91	35467926	21688
chr15	35446427	35646427	harbor1	chr15	35457907	35458229	DNA/TcMar-Tigger	1158	-	161	35458068	11641
chr15	35446427	35646427	harbor1	chr15	35466617	35467282	DNA/TcMar-Tigger	4917	-	332	35466949	20522
chr15	35446427	35646427	harbor1	chr15	35467596	35467834	DNA/TcMar-Tigger	4917	-	119	35467715	21288
chr15	35446427	35646427	harbor1	chr15	35467835	35468017	DNA/TcMar-Tigger	1023	-	91	35467926	21499
chr15	22459893	22659893	harbor1	chr15	22498218	22498503	DNA/TcMar-Tigger	616	-	142	22498360	38467
chr15	101859054	102059054	harbor1	chr15	101910446	101910905	DNA/TcMar-Tigger	2325	-	230	101910676	51622
chr15	101859054	102059054	harbor1	chr15	101910906	101911040	DNA/TcMar-Tigger	1033	-	67	101910973	51919
chr15	101859054	102059054	harbor1	chr15	101911333	101911425	DNA/TcMar-Tigger	1033	-	46	101911379	52325
chr15	35446269	35646269	harbor1	chr15	35457907	35458229	DNA/TcMar-Tigger	1158	-	161	35458068	11799
chr15	35446269	35646269	harbor1	chr15	35466617	35467282	DNA/TcMar-Tigger	4917	-	332	35466949	20680
chr15	35446269	35646269	harbor1	chr15	35467596	35467834	DNA/TcMar-Tigger	4917	-	119	35467715	21446
chr15	35446269	35646269	harbor1	chr15	35467835	35468017	DNA/TcMar-Tigger	1023	-	91	35467926	21657
chr15	35445428	35645428	harbor1	chr15	35457907	35458229	DNA/TcMar-Tigger	1158	-	161	35458068	12640
chr15	35445428	35645428	harbor1	chr15	35466617	35467282	DNA/TcMar-Tigger	4917	-	332	35466949	21521
chr15	35445428	35645428	harbor1	chr15	35467596	35467834	DNA/TcMar-Tigger	4917	-	119	35467715	22287
chr15	35445428	35645428	harbor1	chr15	35467835	35468017	DNA/TcMar-Tigger	1023	-	91	35467926	22498
chr15	75354646	75554646	harbor1	chr15	75447485	75447593	DNA/TcMar-Tigger	444	-	54	75447539	92893
chr15	52686084	52886084	harbor1	chr15	52693776	52693967	DNA/TcMar-Tigger	522	-	96	52693872	7788
chr15	101854375	102054375	harbor1	chr15	101910446	101910905	DNA/TcMar-Tigger	2325	-	230	101910676	56301
chr15	101854375	102054375	harbor1	chr15	101910906	101911040	DNA/TcMar-Tigger	1033	-	67	101910973	56598
chr15	101854375	102054375	harbor1	chr15	101911333	101911425	DNA/TcMar-Tigger	1033	-	46	101911379	57004
chr15	101861607	102061607	harbor1	chr15	101910446	101910905	DNA/TcMar-Tigger	2325	-	230	101910676	49069
chr15	101861607	102061607	harbor1	chr15	101910906	101911040	DNA/TcMar-Tigger	1033	-	67	101910973	49366
chr15	101861607	102061607	harbor1	chr15	101911333	101911425	DNA/TcMar-Tigger	1033	-	46	101911379	49772
chr15	27433813	27633813	harbor1	chr15	27452378	27452793	DNA/TcMar-Tigger	2171	-	208	27452586	18773
chr15	35446215	35646215	harbor1	chr15	35457907	35458229	DNA/TcMar-Tigger	1158	-	161	35458068	11853
chr15	35446215	35646215	harbor1	chr15	35466617	35467282	DNA/TcMar-Tigger	4917	-	332	35466949	20734
chr15	35446215	35646215	harbor1	chr15	35467596	35467834	DNA/TcMar-Tigger	4917	-	119	35467715	21500
chr15	35446215	35646215	harbor1	chr15	35467835	35468017	DNA/TcMar-Tigger	1023	-	91	35467926	21711
chr15	35446283	35646283	harbor1	chr15	35457907	35458229	DNA/TcMar-Tigger	1158	-	161	35458068	11785
chr15	35446283	35646283	harbor1	chr15	35466617	35467282	DNA/TcMar-Tigger	4917	-	332	35466949	20666
chr15	35446283	35646283	harbor1	chr15	35467596	35467834	DNA/TcMar-Tigger	4917	-	119	35467715	21432
chr15	35446283	35646283	harbor1	chr15	35467835	35468017	DNA/TcMar-Tigger	1023	-	91	35467926	21643
chr16	88702482	88902482	harbor1	chr16	88769048	88769220	DNA/TcMar-Tigger	718	-	86	88769134	66652
chr16	73380	273380	harbor1	chr16	131621	131996	DNA/TcMar-Tigger	4341	-	188	131809	58429
chr16	73380	273380	harbor1	chr16	132307	132664	DNA/TcMar-Tigger	4341	-	178	132485	59105
chr16	73380	273380	harbor1	chr16	132969	133223	DNA/TcMar-Tigger	1565	-	127	133096	59716
chr16	73380	273380	harbor1	chr16	133663	134201	DNA/TcMar-Tigger	3010	-	269	133932	60552
chr16	2062817	2262817	harbor1	chr16	2068376	2068593	DNA/TcMar-Tigger	2012	-	108	2068484	5667
chr16	2062817	2262817	harbor1	chr16	2068894	2069096	DNA/TcMar-Tigger	2012	-	101	2068995	6178
chr16	2062817	2262817	harbor1	chr16	2096112	2096453	DNA/TcMar-Tigger	982	-	170	2096282	33465
chr16	79309359	79509359	harbor1	chr16	79363265	79363625	DNA/TcMar-Tigger	2124	-	180	79363445	54086
chr16	88702456	88902456	harbor1	chr16	88769048	88769220	DNA/TcMar-Tigger	718	-	86	88769134	66678
chr16	46873236	47073236	harbor1	chr16	46892862	46893118	DNA/TcMar-Tigger	1423	-	128	46892990	19754
chr16	46873236	47073236	harbor1	chr16	46893431	46893501	DNA/TcMar-Tigger	1423	-	35	46893466	20230
chr16	66906669	67106669	harbor1	chr16	66929455	66929729	DNA/TcMar-Tigger	1372	-	137	66929592	22923
chr16	2062311	2262311	harbor1	chr16	2068376	2068593	DNA/TcMar-Tigger	2012	-	108	2068484	6173
chr16	2062311	2262311	harbor1	chr16	2068894	2069096	DNA/TcMar-Tigger	2012	-	101	2068995	6684
chr16	2062311	2262311	harbor1	chr16	2096112	2096453	DNA/TcMar-Tigger	982	-	170	2096282	33971
chr16	1977315	2177315	harbor1	chr16	2068376	2068593	DNA/TcMar-Tigger	2012	-	108	2068484	91169
chr16	1977315	2177315	harbor1	chr16	2068894	2069096	DNA/TcMar-Tigger	2012	-	101	2068995	91680
chr16	67009887	67209887	harbor1	chr16	67039044	67039622	DNA/TcMar-Tigger	3128	-	289	67039333	29446
chr16	67009887	67209887	harbor1	chr16	67050347	67050512	DNA/TcMar-Tigger	1175	-	82	67050429	40542
chr16	67009887	67209887	harbor1	chr16	67050821	67051110	DNA/TcMar-Tigger	1175	-	144	67050965	41078
chr16	87282562	87482562	harbor1	chr16	87373904	87373961	DNA/TcMar-Tigger	1447	-	28	87373932	91370
chr16	87282562	87482562	harbor1	chr16	87374268	87374547	DNA/TcMar-Tigger	1447	-	140	87374408	91846
chr16	46871997	47071997	harbor1	chr16	46892862	46893118	DNA/TcMar-Tigger	1423	-	128	46892990	20993
chr16	46871997	47071997	harbor1	chr16	46893431	46893501	DNA/TcMar-Tigger	1423	-	35	46893466	21469
chr16	66877936	67077936	harbor1	chr16	66897768	66897979	DNA/TcMar-Tigger	2698	-	106	66897874	19938
chr16	66877936	67077936	harbor1	chr16	66898293	66898616	DNA/TcMar-Tigger	2698	-	162	66898455	20519
chr16	66877936	67077936	harbor1	chr16	66929455	66929729	DNA/TcMar-Tigger	1372	-	137	66929592	51656
chr16	89473666	89673666	harbor1	chr16	89516914	89517136	DNA/TcMar-Tigger	964	-	111	89517025	43359
chr16	89473666	89673666	harbor1	chr16	89526995	89527249	DNA/TcMar-Tigger	894	-	127	89527122	53456
chr16	67009935	67209935	harbor1	chr16	67039044	67039622	DNA/TcMar-Tigger	3128	-	289	67039333	29398
chr16	67009935	67209935	harbor1	chr16	67050347	67050512	DNA/TcMar-Tigger	1175	-	82	67050429	40494
chr16	67009935	67209935	harbor1	chr16	67050821	67051110	DNA/TcMar-Tigger	1175	-	144	67050965	41030
chr16	87292271	87492271	harbor1	chr16	87373904	87373961	DNA/TcMar-Tigger	1447	-	28	87373932	81661
chr16	87292271	87492271	harbor1	chr16	87374268	87374547	DNA/TcMar-Tigger	1447	-	140	87374408	82137
chr16	1721078	1921078	harbor1	chr16	1748871	1749176	DNA/TcMar-Tigger	1295	-	152	1749023	27945
chr16	87292307	87492307	harbor1	chr16	87373904	87373961	DNA/TcMar-Tigger	1447	-	28	87373932	81625
chr16	87292307	87492307	harbor1	chr16	87374268	87374547	DNA/TcMar-Tigger	1447	-	140	87374408	82101
chr16	88756404	88956404	harbor1	chr16	88769048	88769220	DNA/TcMar-Tigger	718	-	86	88769134	12730
chr16	66743175	66943175	harbor1	chr16	66792598	66793028	DNA/TcMar-Tigger	1964	-	215	66792813	49638
chr16	66743175	66943175	harbor1	chr16	66819539	66819768	DNA/TcMar-Tigger	1205	-	114	66819653	76478
chr16	70586095	70786095	harbor1	chr16	70629417	70629709	DNA/TcMar-Tigger	1743	-	146	70629563	43468
chr16	70586095	70786095	harbor1	chr16	70631040	70631111	DNA/TcMar-Tigger	1743	-	36	70631076	44981
chr16	66864287	67064287	harbor1	chr16	66897768	66897979	DNA/TcMar-Tigger	2698	-	106	66897874	33587
chr16	66864287	67064287	harbor1	chr16	66898293	66898616	DNA/TcMar-Tigger	2698	-	162	66898455	34168
chr16	66864287	67064287	harbor1	chr16	66929455	66929729	DNA/TcMar-Tigger	1372	-	137	66929592	65305
chr16	57566222	57766222	harbor1	chr16	57587110	57587269	DNA/TcMar-Tigger	863	-	80	57587190	20968
chr16	70034	270034	harbor1	chr16	131621	131996	DNA/TcMar-Tigger	4341	-	188	131809	61775
chr16	70034	270034	harbor1	chr16	132307	132664	DNA/TcMar-Tigger	4341	-	178	132485	62451
chr16	70034	270034	harbor1	chr16	132969	133223	DNA/TcMar-Tigger	1565	-	127	133096	63062
chr16	70034	270034	harbor1	chr16	133663	134201	DNA/TcMar-Tigger	3010	-	269	133932	63898
chr16	57884565	58084565	harbor1	chr16	57891208	57891346	DNA/TcMar-Tigger	742	-	69	57891277	6712
chr16	57884565	58084565	harbor1	chr16	57891516	57891555	DNA/TcMar-Tigger	2526	-	20	57891536	6971
chr16	57884565	58084565	harbor1	chr16	57891852	57892329	DNA/TcMar-Tigger	2526	-	238	57892090	7525
chr16	167411	367411	harbor1	chr16	204617	205184	DNA/TcMar-Tigger	3539	-	284	204901	37490
chr16	167411	367411	harbor1	chr16	205315	205436	DNA/TcMar-Tigger	3539	-	60	205375	37964
chr16	92247	292247	harbor1	chr16	131621	131996	DNA/TcMar-Tigger	4341	-	188	131809	39562
chr16	92247	292247	harbor1	chr16	132307	132664	DNA/TcMar-Tigger	4341	-	178	132485	40238
chr16	92247	292247	harbor1	chr16	132969	133223	DNA/TcMar-Tigger	1565	-	127	133096	40849
chr16	92247	292247	harbor1	chr16	133663	134201	DNA/TcMar-Tigger	3010	-	269	133932	41685
chr16	73620	273620	harbor1	chr16	131621	131996	DNA/TcMar-Tigger	4341	-	188	131809	58189
chr16	73620	273620	harbor1	chr16	132307	132664	DNA/TcMar-Tigger	4341	-	178	132485	58865
chr16	73620	273620	harbor1	chr16	132969	133223	DNA/TcMar-Tigger	1565	-	127	133096	59476
chr16	73620	273620	harbor1	chr16	133663	134201	DNA/TcMar-Tigger	3010	-	269	133932	60312
chr16	70586052	70786052	harbor1	chr16	70629417	70629709	DNA/TcMar-Tigger	1743	-	146	70629563	43511
chr16	70586052	70786052	harbor1	chr16	70631040	70631111	DNA/TcMar-Tigger	1743	-	36	70631076	45024
chr16	73663	273663	harbor1	chr16	131621	131996	DNA/TcMar-Tigger	4341	-	188	131809	58146
chr16	73663	273663	harbor1	chr16	132307	132664	DNA/TcMar-Tigger	4341	-	178	132485	58822
chr16	73663	273663	harbor1	chr16	132969	133223	DNA/TcMar-Tigger	1565	-	127	133096	59433
chr16	73663	273663	harbor1	chr16	133663	134201	DNA/TcMar-Tigger	3010	-	269	133932	60269
chr16	30253473	30453473	harbor1	chr16	30284019	30284357	DNA/TcMar-Tigger	1961	-	169	30284188	30715
chr16	73590	273590	harbor1	chr16	131621	131996	DNA/TcMar-Tigger	4341	-	188	131809	58219
chr16	73590	273590	harbor1	chr16	132307	132664	DNA/TcMar-Tigger	4341	-	178	132485	58895
chr16	73590	273590	harbor1	chr16	132969	133223	DNA/TcMar-Tigger	1565	-	127	133096	59506
chr16	73590	273590	harbor1	chr16	133663	134201	DNA/TcMar-Tigger	3010	-	269	133932	60342
chr16	67009915	67209915	harbor1	chr16	67039044	67039622	DNA/TcMar-Tigger	3128	-	289	67039333	29418
chr16	67009915	67209915	harbor1	chr16	67050347	67050512	DNA/TcMar-Tigger	1175	-	82	67050429	40514
chr16	67009915	67209915	harbor1	chr16	67050821	67051110	DNA/TcMar-Tigger	1175	-	144	67050965	41050
chr16	165471	365471	harbor1	chr16	204617	205184	DNA/TcMar-Tigger	3539	-	284	204901	39430
chr16	165471	365471	harbor1	chr16	205315	205436	DNA/TcMar-Tigger	3539	-	60	205375	39904
chr16	167367	367367	harbor1	chr16	204617	205184	DNA/TcMar-Tigger	3539	-	284	204901	37534
chr16	167367	367367	harbor1	chr16	205315	205436	DNA/TcMar-Tigger	3539	-	60	205375	38008
chr16	57884912	58084912	harbor1	chr16	57891208	57891346	DNA/TcMar-Tigger	742	-	69	57891277	6365
chr16	57884912	58084912	harbor1	chr16	57891516	57891555	DNA/TcMar-Tigger	2526	-	20	57891536	6624
chr16	57884912	58084912	harbor1	chr16	57891852	57892329	DNA/TcMar-Tigger	2526	-	238	57892090	7178
chr16	73025	273025	harbor1	chr16	131621	131996	DNA/TcMar-Tigger	4341	-	188	131809	58784
chr16	73025	273025	harbor1	chr16	132307	132664	DNA/TcMar-Tigger	4341	-	178	132485	59460
chr16	73025	273025	harbor1	chr16	132969	133223	DNA/TcMar-Tigger	1565	-	127	133096	60071
chr16	73025	273025	harbor1	chr16	133663	134201	DNA/TcMar-Tigger	3010	-	269	133932	60907
chr16	73598	273598	harbor1	chr16	131621	131996	DNA/TcMar-Tigger	4341	-	188	131809	58211
chr16	73598	273598	harbor1	chr16	132307	132664	DNA/TcMar-Tigger	4341	-	178	132485	58887
chr16	73598	273598	harbor1	chr16	132969	133223	DNA/TcMar-Tigger	1565	-	127	133096	59498
chr16	73598	273598	harbor1	chr16	133663	134201	DNA/TcMar-Tigger	3010	-	269	133932	60334
chr16	89474865	89674865	harbor1	chr16	89516914	89517136	DNA/TcMar-Tigger	964	-	111	89517025	42160
chr16	89474865	89674865	harbor1	chr16	89526995	89527249	DNA/TcMar-Tigger	894	-	127	89527122	52257
chr16	1578327	1778327	harbor1	chr16	1579017	1579377	DNA/TcMar-Tigger	1792	-	180	1579197	870
chr16	30599212	30799212	harbor1	chr16	30671735	30671794	DNA/TcMar-Tigger	1422	-	30	30671765	72553
chr16	30599212	30799212	harbor1	chr16	30672091	30672602	DNA/TcMar-Tigger	1422	-	256	30672347	73135
chr16	2721710	2921710	harbor1	chr16	2799976	2800278	DNA/TcMar-Tigger	3345	-	151	2800127	78417
chr16	2721710	2921710	harbor1	chr16	2800573	2800929	DNA/TcMar-Tigger	3345	-	178	2800751	79041
chr16	28018013	28218013	harbor1	chr16	28071125	28071262	DNA/TcMar-Tigger	1032	-	68	28071193	53180
chr16	28018013	28218013	harbor1	chr16	28071551	28071650	DNA/TcMar-Tigger	1032	-	50	28071601	53588
chr16	28018013	28218013	harbor1	chr16	28116496	28116990	DNA/TcMar-Tigger	14579	-	247	28116743	98730
chr16	28018013	28218013	harbor1	chr16	28114368	28116179	DNA/TcMar-Tigger	14579	-	906	28115274	97261
chr16	88587269	88787269	harbor1	chr16	88592983	88593539	DNA/TcMar-Tigger	2034	-	278	88593261	5992
chr16	29349577	29549577	harbor1	chr16	29442250	29442588	DNA/TcMar-Tigger	2111	-	169	29442419	92842
chr16	57884931	58084931	harbor1	chr16	57891208	57891346	DNA/TcMar-Tigger	742	-	69	57891277	6346
chr16	57884931	58084931	harbor1	chr16	57891516	57891555	DNA/TcMar-Tigger	2526	-	20	57891536	6605
chr16	57884931	58084931	harbor1	chr16	57891852	57892329	DNA/TcMar-Tigger	2526	-	238	57892090	7159
chr16	75364612	75564612	harbor1	chr16	75421813	75422088	DNA/TcMar-Tigger	1664	-	138	75421951	57339
chr16	57884956	58084956	harbor1	chr16	57891208	57891346	DNA/TcMar-Tigger	742	-	69	57891277	6321
chr16	57884956	58084956	harbor1	chr16	57891516	57891555	DNA/TcMar-Tigger	2526	-	20	57891536	6580
chr16	57884956	58084956	harbor1	chr16	57891852	57892329	DNA/TcMar-Tigger	2526	-	238	57892090	7134
chr16	89586911	89786911	harbor1	chr16	89608020	89608315	DNA/TcMar-Tigger	575	-	148	89608168	21257
chr16	57884909	58084909	harbor1	chr16	57891208	57891346	DNA/TcMar-Tigger	742	-	69	57891277	6368
chr16	57884909	58084909	harbor1	chr16	57891516	57891555	DNA/TcMar-Tigger	2526	-	20	57891536	6627
chr16	57884909	58084909	harbor1	chr16	57891852	57892329	DNA/TcMar-Tigger	2526	-	238	57892090	7181
chr16	87284537	87484537	harbor1	chr16	87373904	87373961	DNA/TcMar-Tigger	1447	-	28	87373932	89395
chr16	87284537	87484537	harbor1	chr16	87374268	87374547	DNA/TcMar-Tigger	1447	-	140	87374408	89871
chr16	1688539	1888539	harbor1	chr16	1748871	1749176	DNA/TcMar-Tigger	1295	-	152	1749023	60484
chr17	7461503	7661503	harbor1	chr17	7517675	7517939	DNA/TcMar-Tigger	1031	-	132	7517807	56304
chr17	7461503	7661503	harbor1	chr17	7531865	7532033	DNA/TcMar-Tigger	885	-	84	7531949	70446
chr17	7461503	7661503	harbor1	chr17	7534349	7534511	DNA/TcMar-Tigger	1063	-	81	7534430	72927
chr17	7461503	7661503	harbor1	chr17	7534812	7534865	DNA/TcMar-Tigger	1063	-	26	7534838	73335
chr17	76637323	76837323	harbor1	chr17	76652088	76652710	DNA/TcMar-Tigger	4082	-	311	76652399	15076
chr17	76637323	76837323	harbor1	chr17	76653343	76653539	DNA/TcMar-Tigger	1030	-	98	76653441	16118
chr17	76637252	76837252	harbor1	chr17	76652088	76652710	DNA/TcMar-Tigger	4082	-	311	76652399	15147
chr17	76637252	76837252	harbor1	chr17	76653343	76653539	DNA/TcMar-Tigger	1030	-	98	76653441	16189
chr17	63676342	63876342	harbor1	chr17	63683620	63683876	DNA/TcMar-Tigger	1746	-	128	63683748	7406
chr17	63676342	63876342	harbor1	chr17	63684145	63684650	DNA/TcMar-Tigger	1746	-	252	63684397	8055
chr17	2838072	3038072	harbor1	chr17	2881282	2881380	DNA/TcMar-Tigger	601	-	49	2881331	43259
chr17	58388439	58588439	harbor1	chr17	58430813	58430935	DNA/TcMar-Tigger	1748	-	61	58430874	42435
chr17	58388439	58588439	harbor1	chr17	58431276	58431482	DNA/TcMar-Tigger	1748	-	103	58431379	42940
chr17	2838075	3038075	harbor1	chr17	2881282	2881380	DNA/TcMar-Tigger	601	-	49	2881331	43256
chr17	7461829	7661829	harbor1	chr17	7517675	7517939	DNA/TcMar-Tigger	1031	-	132	7517807	55978
chr17	7461829	7661829	harbor1	chr17	7531865	7532033	DNA/TcMar-Tigger	885	-	84	7531949	70120
chr17	7461829	7661829	harbor1	chr17	7534349	7534511	DNA/TcMar-Tigger	1063	-	81	7534430	72601
chr17	7461829	7661829	harbor1	chr17	7534812	7534865	DNA/TcMar-Tigger	1063	-	26	7534838	73009
chr17	7461828	7661828	harbor1	chr17	7517675	7517939	DNA/TcMar-Tigger	1031	-	132	7517807	55979
chr17	7461828	7661828	harbor1	chr17	7531865	7532033	DNA/TcMar-Tigger	885	-	84	7531949	70121
chr17	7461828	7661828	harbor1	chr17	7534349	7534511	DNA/TcMar-Tigger	1063	-	81	7534430	72602
chr17	7461828	7661828	harbor1	chr17	7534812	7534865	DNA/TcMar-Tigger	1063	-	26	7534838	73010
chr17	76637238	76837238	harbor1	chr17	76652088	76652710	DNA/TcMar-Tigger	4082	-	311	76652399	15161
chr17	76637238	76837238	harbor1	chr17	76653343	76653539	DNA/TcMar-Tigger	1030	-	98	76653441	16203
chr17	29477937	29677937	harbor1	chr17	29488087	29488288	DNA/TcMar-Tigger	1031	-	100	29488187	10250
chr17	29477937	29677937	harbor1	chr17	29488610	29488726	DNA/TcMar-Tigger	1031	-	58	29488668	10731
chr17	7461853	7661853	harbor1	chr17	7517675	7517939	DNA/TcMar-Tigger	1031	-	132	7517807	55954
chr17	7461853	7661853	harbor1	chr17	7531865	7532033	DNA/TcMar-Tigger	885	-	84	7531949	70096
chr17	7461853	7661853	harbor1	chr17	7534349	7534511	DNA/TcMar-Tigger	1063	-	81	7534430	72577
chr17	7461853	7661853	harbor1	chr17	7534812	7534865	DNA/TcMar-Tigger	1063	-	26	7534838	72985
chr17	76637301	76837301	harbor1	chr17	76652088	76652710	DNA/TcMar-Tigger	4082	-	311	76652399	15098
chr17	76637301	76837301	harbor1	chr17	76653343	76653539	DNA/TcMar-Tigger	1030	-	98	76653441	16140
chr17	76637314	76837314	harbor1	chr17	76652088	76652710	DNA/TcMar-Tigger	4082	-	311	76652399	15085
chr17	76637314	76837314	harbor1	chr17	76653343	76653539	DNA/TcMar-Tigger	1030	-	98	76653441	16127
chr17	7461830	7661830	harbor1	chr17	7517675	7517939	DNA/TcMar-Tigger	1031	-	132	7517807	55977
chr17	7461830	7661830	harbor1	chr17	7531865	7532033	DNA/TcMar-Tigger	885	-	84	7531949	70119
chr17	7461830	7661830	harbor1	chr17	7534349	7534511	DNA/TcMar-Tigger	1063	-	81	7534430	72600
chr17	7461830	7661830	harbor1	chr17	7534812	7534865	DNA/TcMar-Tigger	1063	-	26	7534838	73008
chr17	80624434	80824434	harbor1	chr17	80641543	80641959	DNA/TcMar-Tigger	2125	-	208	80641751	17317
chr17	64956159	65156159	harbor1	chr17	65031125	65031395	DNA/TcMar-Tigger	1269	-	135	65031260	75101
chr17	64956159	65156159	harbor1	chr17	65038041	65038122	DNA/TcMar-Tigger	2039	-	40	65038081	81922
chr17	64956159	65156159	harbor1	chr17	65038727	65039024	DNA/TcMar-Tigger	2039	-	148	65038875	82716
chr17	64956159	65156159	harbor1	chr17	65053128	65053445	DNA/TcMar-Tigger	1332	-	158	65053286	97127
chr17	48339875	48539875	harbor1	chr17	48344291	48344528	DNA/TcMar-Tigger	677	-	118	48344409	4534
chr17	7461823	7661823	harbor1	chr17	7517675	7517939	DNA/TcMar-Tigger	1031	-	132	7517807	55984
chr17	7461823	7661823	harbor1	chr17	7531865	7532033	DNA/TcMar-Tigger	885	-	84	7531949	70126
chr17	7461823	7661823	harbor1	chr17	7534349	7534511	DNA/TcMar-Tigger	1063	-	81	7534430	72607
chr17	7461823	7661823	harbor1	chr17	7534812	7534865	DNA/TcMar-Tigger	1063	-	26	7534838	73015
chr17	76637283	76837283	harbor1	chr17	76652088	76652710	DNA/TcMar-Tigger	4082	-	311	76652399	15116
chr17	76637283	76837283	harbor1	chr17	76653343	76653539	DNA/TcMar-Tigger	1030	-	98	76653441	16158
chr17	7461898	7661898	harbor1	chr17	7517675	7517939	DNA/TcMar-Tigger	1031	-	132	7517807	55909
chr17	7461898	7661898	harbor1	chr17	7531865	7532033	DNA/TcMar-Tigger	885	-	84	7531949	70051
chr17	7461898	7661898	harbor1	chr17	7534349	7534511	DNA/TcMar-Tigger	1063	-	81	7534430	72532
chr17	7461898	7661898	harbor1	chr17	7534812	7534865	DNA/TcMar-Tigger	1063	-	26	7534838	72940
chr17	7461905	7661905	harbor1	chr17	7517675	7517939	DNA/TcMar-Tigger	1031	-	132	7517807	55902
chr17	7461905	7661905	harbor1	chr17	7531865	7532033	DNA/TcMar-Tigger	885	-	84	7531949	70044
chr17	7461905	7661905	harbor1	chr17	7534349	7534511	DNA/TcMar-Tigger	1063	-	81	7534430	72525
chr17	7461905	7661905	harbor1	chr17	7534812	7534865	DNA/TcMar-Tigger	1063	-	26	7534838	72933
chr17	56020599	56220599	harbor1	chr17	56054424	56054629	DNA/TcMar-Tigger	1651	-	102	56054526	33927
chr17	56020599	56220599	harbor1	chr17	56054906	56055055	DNA/TcMar-Tigger	1651	-	74	56054980	34381
chr17	56020599	56220599	harbor1	chr17	56056823	56057503	DNA/TcMar-Tigger	7915	-	340	56057163	36564
chr17	56020599	56220599	harbor1	chr17	56057797	56058473	DNA/TcMar-Tigger	7915	-	338	56058135	37536
chr17	56020599	56220599	harbor1	chr17	56065172	56066000	DNA/TcMar-Tigger	5208	-	414	56065586	44987
chr17	7461897	7661897	harbor1	chr17	7517675	7517939	DNA/TcMar-Tigger	1031	-	132	7517807	55910
chr17	7461897	7661897	harbor1	chr17	7531865	7532033	DNA/TcMar-Tigger	885	-	84	7531949	70052
chr17	7461897	7661897	harbor1	chr17	7534349	7534511	DNA/TcMar-Tigger	1063	-	81	7534430	72533
chr17	7461897	7661897	harbor1	chr17	7534812	7534865	DNA/TcMar-Tigger	1063	-	26	7534838	72941
chr17	8056331	8256331	harbor1	chr17	8128513	8128748	DNA/TcMar-Tigger	1115	-	118	8128631	72300
chr17	7461844	7661844	harbor1	chr17	7517675	7517939	DNA/TcMar-Tigger	1031	-	132	7517807	55963
chr17	7461844	7661844	harbor1	chr17	7531865	7532033	DNA/TcMar-Tigger	885	-	84	7531949	70105
chr17	7461844	7661844	harbor1	chr17	7534349	7534511	DNA/TcMar-Tigger	1063	-	81	7534430	72586
chr17	7461844	7661844	harbor1	chr17	7534812	7534865	DNA/TcMar-Tigger	1063	-	26	7534838	72994
chr17	7461836	7661836	harbor1	chr17	7517675	7517939	DNA/TcMar-Tigger	1031	-	132	7517807	55971
chr17	7461836	7661836	harbor1	chr17	7531865	7532033	DNA/TcMar-Tigger	885	-	84	7531949	70113
chr17	7461836	7661836	harbor1	chr17	7534349	7534511	DNA/TcMar-Tigger	1063	-	81	7534430	72594
chr17	7461836	7661836	harbor1	chr17	7534812	7534865	DNA/TcMar-Tigger	1063	-	26	7534838	73002
chr17	2838074	3038074	harbor1	chr17	2881282	2881380	DNA/TcMar-Tigger	601	-	49	2881331	43257
chr17	64956153	65156153	harbor1	chr17	65031125	65031395	DNA/TcMar-Tigger	1269	-	135	65031260	75107
chr17	64956153	65156153	harbor1	chr17	65038041	65038122	DNA/TcMar-Tigger	2039	-	40	65038081	81928
chr17	64956153	65156153	harbor1	chr17	65038727	65039024	DNA/TcMar-Tigger	2039	-	148	65038875	82722
chr17	64956153	65156153	harbor1	chr17	65053128	65053445	DNA/TcMar-Tigger	1332	-	158	65053286	97133
chr17	76283247	76483247	harbor1	chr17	76312082	76312158	DNA/TcMar-Tigger	1085	-	38	76312120	28873
chr17	76283247	76483247	harbor1	chr17	76312452	76312714	DNA/TcMar-Tigger	1085	-	131	76312583	29336
chr17	50408598	50608598	harbor1	chr17	50438066	50438290	DNA/TcMar-Tigger	1378	-	112	50438178	29580
chr17	50408598	50608598	harbor1	chr17	50438522	50438561	DNA/TcMar-Tigger	622	-	20	50438542	29944
chr17	50408598	50608598	harbor1	chr17	50438867	50438934	DNA/TcMar-Tigger	622	-	34	50438901	30303
chr17	50408598	50608598	harbor1	chr17	50448032	50448368	DNA/TcMar-Tigger	2010	-	168	50448200	39602
chr17	58416995	58616995	harbor1	chr17	58430813	58430935	DNA/TcMar-Tigger	1748	-	61	58430874	13879
chr17	58416995	58616995	harbor1	chr17	58431276	58431482	DNA/TcMar-Tigger	1748	-	103	58431379	14384
chr17	39087193	39287193	harbor1	chr17	39126309	39126901	DNA/TcMar-Tigger	3298	-	296	39126605	39412
chr17	76637247	76837247	harbor1	chr17	76652088	76652710	DNA/TcMar-Tigger	4082	-	311	76652399	15152
chr17	76637247	76837247	harbor1	chr17	76653343	76653539	DNA/TcMar-Tigger	1030	-	98	76653441	16194
chr17	7461870	7661870	harbor1	chr17	7517675	7517939	DNA/TcMar-Tigger	1031	-	132	7517807	55937
chr17	7461870	7661870	harbor1	chr17	7531865	7532033	DNA/TcMar-Tigger	885	-	84	7531949	70079
chr17	7461870	7661870	harbor1	chr17	7534349	7534511	DNA/TcMar-Tigger	1063	-	81	7534430	72560
chr17	7461870	7661870	harbor1	chr17	7534812	7534865	DNA/TcMar-Tigger	1063	-	26	7534838	72968
chr17	30610000	30810000	harbor1	chr17	30680938	30681065	DNA/TcMar-Tigger	695	-	64	30681002	71002
chr17	63600181	63800181	harbor1	chr17	63667556	63667862	DNA/TcMar-Tigger	1375	-	153	63667709	67528
chr17	63600181	63800181	harbor1	chr17	63683620	63683876	DNA/TcMar-Tigger	1746	-	128	63683748	83567
chr17	63600181	63800181	harbor1	chr17	63684145	63684650	DNA/TcMar-Tigger	1746	-	252	63684397	84216
chr17	7461914	7661914	harbor1	chr17	7517675	7517939	DNA/TcMar-Tigger	1031	-	132	7517807	55893
chr17	7461914	7661914	harbor1	chr17	7531865	7532033	DNA/TcMar-Tigger	885	-	84	7531949	70035
chr17	7461914	7661914	harbor1	chr17	7534349	7534511	DNA/TcMar-Tigger	1063	-	81	7534430	72516
chr17	7461914	7661914	harbor1	chr17	7534812	7534865	DNA/TcMar-Tigger	1063	-	26	7534838	72924
chr17	7461805	7661805	harbor1	chr17	7517675	7517939	DNA/TcMar-Tigger	1031	-	132	7517807	56002
chr17	7461805	7661805	harbor1	chr17	7531865	7532033	DNA/TcMar-Tigger	885	-	84	7531949	70144
chr17	7461805	7661805	harbor1	chr17	7534349	7534511	DNA/TcMar-Tigger	1063	-	81	7534430	72625
chr17	7461805	7661805	harbor1	chr17	7534812	7534865	DNA/TcMar-Tigger	1063	-	26	7534838	73033
chr17	76283501	76483501	harbor1	chr17	76312082	76312158	DNA/TcMar-Tigger	1085	-	38	76312120	28619
chr17	76283501	76483501	harbor1	chr17	76312452	76312714	DNA/TcMar-Tigger	1085	-	131	76312583	29082
chr17	43590747	43790747	harbor1	chr17	43671387	43671607	DNA/TcMar-Tigger	623	-	110	43671497	80750
chr17	8023310	8223310	harbor1	chr17	8053368	8053980	DNA/TcMar-Tigger	2713	-	306	8053674	30364
chr17	57767550	57967550	harbor1	chr17	57799274	57799656	DNA/TcMar-Tigger	2219	-	191	57799465	31915
chr17	41516785	41716785	harbor1	chr17	41604415	41604725	DNA/TcMar-Tigger	1998	-	155	41604570	87785
chr17	41516785	41716785	harbor1	chr17	41604766	41604811	DNA/TcMar-Tigger	1998	-	22	41604788	88003
chr17	7461864	7661864	harbor1	chr17	7517675	7517939	DNA/TcMar-Tigger	1031	-	132	7517807	55943
chr17	7461864	7661864	harbor1	chr17	7531865	7532033	DNA/TcMar-Tigger	885	-	84	7531949	70085
chr17	7461864	7661864	harbor1	chr17	7534349	7534511	DNA/TcMar-Tigger	1063	-	81	7534430	72566
chr17	7461864	7661864	harbor1	chr17	7534812	7534865	DNA/TcMar-Tigger	1063	-	26	7534838	72974
chr17	2829895	3029895	harbor1	chr17	2881282	2881380	DNA/TcMar-Tigger	601	-	49	2881331	51436
chr17	28254681	28454681	harbor1	chr17	28315795	28316021	DNA/TcMar-Tigger	1449	-	113	28315908	61227
chr17	28254681	28454681	harbor1	chr17	28316007	28316144	DNA/TcMar-Tigger	1264	-	68	28316075	61394
chr17	28254681	28454681	harbor1	chr17	28316414	28316508	DNA/TcMar-Tigger	1264	-	47	28316461	61780
chr17	7461894	7661894	harbor1	chr17	7517675	7517939	DNA/TcMar-Tigger	1031	-	132	7517807	55913
chr17	7461894	7661894	harbor1	chr17	7531865	7532033	DNA/TcMar-Tigger	885	-	84	7531949	70055
chr17	7461894	7661894	harbor1	chr17	7534349	7534511	DNA/TcMar-Tigger	1063	-	81	7534430	72536
chr17	7461894	7661894	harbor1	chr17	7534812	7534865	DNA/TcMar-Tigger	1063	-	26	7534838	72944
chr17	76711222	76911222	harbor1	chr17	76758793	76758963	DNA/TcMar-Tigger	2098	-	85	76758878	47656
chr17	76711222	76911222	harbor1	chr17	76759903	76759985	DNA/TcMar-Tigger	2098	-	41	76759944	48722
chr17	76711222	76911222	harbor1	chr17	76760298	76760491	DNA/TcMar-Tigger	2098	-	96	76760394	49172
chr17	76485502	76685502	harbor1	chr17	76575880	76575962	DNA/TcMar-Tigger	1751	-	41	76575921	90419
chr17	76485502	76685502	harbor1	chr17	76576272	76576688	DNA/TcMar-Tigger	1751	-	208	76576480	90978
chr17	76485502	76685502	harbor1	chr17	76576986	76577045	DNA/TcMar-Tigger	1751	-	30	76577016	91514
chr17	2837929	3037929	harbor1	chr17	2881282	2881380	DNA/TcMar-Tigger	601	-	49	2881331	43402
chr17	7461804	7661804	harbor1	chr17	7517675	7517939	DNA/TcMar-Tigger	1031	-	132	7517807	56003
chr17	7461804	7661804	harbor1	chr17	7531865	7532033	DNA/TcMar-Tigger	885	-	84	7531949	70145
chr17	7461804	7661804	harbor1	chr17	7534349	7534511	DNA/TcMar-Tigger	1063	-	81	7534430	72626
chr17	7461804	7661804	harbor1	chr17	7534812	7534865	DNA/TcMar-Tigger	1063	-	26	7534838	73034
chr17	32166126	32366126	harbor1	chr17	32166205	32167328	DNA/TcMar-Tigger	8245	-	562	32166767	641
chr17	32166126	32366126	harbor1	chr17	32167560	32167764	DNA/TcMar-Tigger	1200	-	102	32167662	1536
chr17	32166126	32366126	harbor1	chr17	32173228	32173448	DNA/TcMar-Tigger	1426	-	110	32173338	7212
chr17	32166126	32366126	harbor1	chr17	32173733	32173743	DNA/TcMar-Tigger	1426	-	5	32173738	7612
chr17	76636928	76836928	harbor1	chr17	76652088	76652710	DNA/TcMar-Tigger	4082	-	311	76652399	15471
chr17	76636928	76836928	harbor1	chr17	76653343	76653539	DNA/TcMar-Tigger	1030	-	98	76653441	16513
chr17	6918778	7118778	harbor1	chr17	6971136	6971417	DNA/TcMar-Tigger	3446	-	140	6971276	52498
chr17	6918778	7118778	harbor1	chr17	6971714	6971904	DNA/TcMar-Tigger	3446	-	95	6971809	53031
chr17	6918778	7118778	harbor1	chr17	6972207	6972373	DNA/TcMar-Tigger	3446	-	83	6972290	53512
chr17	6918778	7118778	harbor1	chr17	6982210	6982518	DNA/TcMar-Tigger	1338	-	154	6982364	63586
chr17	76637263	76837263	harbor1	chr17	76652088	76652710	DNA/TcMar-Tigger	4082	-	311	76652399	15136
chr17	76637263	76837263	harbor1	chr17	76653343	76653539	DNA/TcMar-Tigger	1030	-	98	76653441	16178
chr17	44209709	44409709	harbor1	chr17	44289282	44289396	DNA/TcMar-Tigger	1326	-	57	44289339	79630
chr17	44209709	44409709	harbor1	chr17	44289685	44289817	DNA/TcMar-Tigger	1326	-	66	44289751	80042
chr17	40256634	40456634	harbor1	chr17	40290556	40290652	DNA/TcMar-Tigger	676	-	48	40290604	33970
chr17	40256634	40456634	harbor1	chr17	40290651	40290864	DNA/TcMar-Tigger	1108	-	106	40290757	34123
chr17	76283274	76483274	harbor1	chr17	76312082	76312158	DNA/TcMar-Tigger	1085	-	38	76312120	28846
chr17	76283274	76483274	harbor1	chr17	76312452	76312714	DNA/TcMar-Tigger	1085	-	131	76312583	29309
chr17	17071303	17271303	harbor1	chr17	17121115	17121362	DNA/TcMar-Tigger	1090	-	124	17121239	49936
chr17	44256633	44456633	harbor1	chr17	44289282	44289396	DNA/TcMar-Tigger	1326	-	57	44289339	32706
chr17	44256633	44456633	harbor1	chr17	44289685	44289817	DNA/TcMar-Tigger	1326	-	66	44289751	33118
chr17	44256633	44456633	harbor1	chr17	44346675	44346833	DNA/TcMar-Tigger	1062	-	79	44346754	90121
chr17	44256633	44456633	harbor1	chr17	44347145	44347230	DNA/TcMar-Tigger	1062	-	42	44347187	90554
chr17	40257301	40457301	harbor1	chr17	40290556	40290652	DNA/TcMar-Tigger	676	-	48	40290604	33303
chr17	40257301	40457301	harbor1	chr17	40290651	40290864	DNA/TcMar-Tigger	1108	-	106	40290757	33456
chr17	45358313	45558313	harbor1	chr17	45429136	45429453	DNA/TcMar-Tigger	1232	-	158	45429294	70981
chr17	38349446	38549446	harbor1	chr17	38376042	38376455	DNA/TcMar-Tigger	2232	-	206	38376248	26802
chr17	38349446	38549446	harbor1	chr17	38376746	38376791	DNA/TcMar-Tigger	2232	-	22	38376768	27322
chr17	38349446	38549446	harbor1	chr17	38406078	38406387	DNA/TcMar-Tigger	3556	-	154	38406232	56786
chr17	38349446	38549446	harbor1	chr17	38406689	38406981	DNA/TcMar-Tigger	3556	-	146	38406835	57389
chr17	38349446	38549446	harbor1	chr17	38407096	38407359	DNA/TcMar-Tigger	2667	-	132	38407228	57782
chr17	38349446	38549446	harbor1	chr17	38407649	38407772	DNA/TcMar-Tigger	2667	-	62	38407711	58265
chr17	38349446	38549446	harbor1	chr17	38408080	38408111	DNA/TcMar-Tigger	2667	-	16	38408096	58650
chr17	38349446	38549446	harbor1	chr17	38408692	38408815	DNA/TcMar-Tigger	2667	-	62	38408754	59308
chr17	30610045	30810045	harbor1	chr17	30680938	30681065	DNA/TcMar-Tigger	695	-	64	30681002	70957
chr17	30994986	31194986	harbor1	chr17	31007826	31008104	DNA/TcMar-Tigger	1297	-	139	31007965	12979
chr17	76637321	76837321	harbor1	chr17	76652088	76652710	DNA/TcMar-Tigger	4082	-	311	76652399	15078
chr17	76637321	76837321	harbor1	chr17	76653343	76653539	DNA/TcMar-Tigger	1030	-	98	76653441	16120
chr17	9856590	10056590	harbor1	chr17	9903673	9903957	DNA/TcMar-Tigger	3380	-	142	9903815	47225
chr17	9856590	10056590	harbor1	chr17	9904263	9904566	DNA/TcMar-Tigger	3380	-	152	9904415	47825
chr18	26126454	26326454	harbor1	chr18	26217788	26218434	DNA/TcMar-Tigger	3632	-	323	26218111	91657
chr18	26126532	26326532	harbor1	chr18	26217788	26218434	DNA/TcMar-Tigger	3632	-	323	26218111	91579
chr18	26126502	26326502	harbor1	chr18	26217788	26218434	DNA/TcMar-Tigger	3632	-	323	26218111	91609
chr18	26126451	26326451	harbor1	chr18	26217788	26218434	DNA/TcMar-Tigger	3632	-	323	26218111	91660
chr18	26126452	26326452	harbor1	chr18	26217788	26218434	DNA/TcMar-Tigger	3632	-	323	26218111	91659
chr18	42426133	42626133	harbor1	chr18	42507767	42507852	DNA/TcMar-Tigger	430	-	42	42507809	81676
chr18	42426133	42626133	harbor1	chr18	42507847	42508383	DNA/TcMar-Tigger	2966	-	268	42508115	81982
chr18	74356692	74556692	harbor1	chr18	74451860	74452207	DNA/TcMar-Tigger	1834	-	174	74452034	95342
chr18	74356714	74556714	harbor1	chr18	74451860	74452207	DNA/TcMar-Tigger	1834	-	174	74452034	95320
chr18	23734554	23934554	harbor1	chr18	23808157	23808458	DNA/TcMar-Tigger	1119	-	150	23808307	73753
chr18	23734554	23934554	harbor1	chr18	23828943	23829158	DNA/TcMar-Tigger	835	-	108	23829051	94497
chr18	74356712	74556712	harbor1	chr18	74451860	74452207	DNA/TcMar-Tigger	1834	-	174	74452034	95322
chr18	25820834	26020834	harbor1	chr18	25856888	25857097	DNA/TcMar-Tigger	1334	-	104	25856992	36158
chr18	25820834	26020834	harbor1	chr18	25904665	25904796	DNA/TcMar-Tigger	747	-	66	25904731	83897
chr18	25820834	26020834	harbor1	chr18	25905048	25905228	DNA/TcMar-Tigger	1092	-	90	25905138	84304
chr18	26126453	26326453	harbor1	chr18	26217788	26218434	DNA/TcMar-Tigger	3632	-	323	26218111	91658
chr18	79688392	79888392	harbor1	chr18	79693459	79693626	DNA/TcMar-Tigger	917	-	84	79693543	5151
chr18	79688392	79888392	harbor1	chr18	79775190	79775584	DNA/TcMar-Tigger	1643	-	197	79775387	86995
chr18	75105267	75305267	harbor1	chr18	75172014	75172315	DNA/TcMar-Tigger	1724	-	150	75172164	66897
chr18	42910981	43110981	harbor1	chr18	42957063	42957522	DNA/TcMar-Tigger	919	-	230	42957293	46312
chr18	42910981	43110981	harbor1	chr18	42957790	42958063	DNA/TcMar-Tigger	919	-	136	42957926	46945
chr18	46488673	46688673	harbor1	chr18	46522630	46522841	DNA/TcMar-Tigger	583	-	106	46522736	34063
chr18	46488673	46688673	harbor1	chr18	46523735	46523992	DNA/TcMar-Tigger	560	-	128	46523863	35190
chr18	46488673	46688673	harbor1	chr18	46565553	46565878	DNA/TcMar-Tigger	2010	-	162	46565715	77042
chr18	25890292	26090292	harbor1	chr18	25904665	25904796	DNA/TcMar-Tigger	747	-	66	25904731	14439
chr18	25890292	26090292	harbor1	chr18	25905048	25905228	DNA/TcMar-Tigger	1092	-	90	25905138	14846
chr18	75181752	75381752	harbor1	chr18	75232708	75232927	DNA/TcMar-Tigger	780	-	110	75232818	51066
chr18	74356740	74556740	harbor1	chr18	74451860	74452207	DNA/TcMar-Tigger	1834	-	174	74452034	95294
chr19	49461215	49661215	harbor1	chr19	49498219	49498470	DNA/TcMar-Tigger	1017	-	126	49498345	37130
chr19	49461215	49661215	harbor1	chr19	49498750	49498815	DNA/TcMar-Tigger	745	-	32	49498782	37567
chr19	49751331	49951331	harbor1	chr19	49778142	49778300	DNA/TcMar-Tigger	1382	-	79	49778221	26890
chr19	49751331	49951331	harbor1	chr19	49778601	49778765	DNA/TcMar-Tigger	1382	-	82	49778683	27352
chr19	49751331	49951331	harbor1	chr19	49847561	49847628	DNA/TcMar-Tigger	833	-	34	49847595	96264
chr19	49751331	49951331	harbor1	chr19	49847982	49848095	DNA/TcMar-Tigger	833	-	56	49848038	96707
chr19	49751331	49951331	harbor1	chr19	49848388	49848565	DNA/TcMar-Tigger	833	-	88	49848476	97145
chr19	49751331	49951331	harbor1	chr19	49848862	49848954	DNA/TcMar-Tigger	833	-	46	49848908	97577
chr19	56021024	56221024	harbor1	chr19	56041314	56041666	DNA/TcMar-Tigger	2173	-	176	56041490	20466
chr19	56021024	56221024	harbor1	chr19	56041972	56042234	DNA/TcMar-Tigger	2173	-	131	56042103	21079
chr19	56021024	56221024	harbor1	chr19	56060364	56060562	DNA/TcMar-Tigger	1096	-	99	56060463	39439
chr19	56021024	56221024	harbor1	chr19	56072844	56073213	DNA/TcMar-Tigger	3965	-	184	56073028	52004
chr19	56021024	56221024	harbor1	chr19	56073513	56073582	DNA/TcMar-Tigger	3965	-	34	56073547	52523
chr19	56021024	56221024	harbor1	chr19	56073894	56074255	DNA/TcMar-Tigger	3965	-	180	56074074	53050
chr19	56021024	56221024	harbor1	chr19	56074549	56074624	DNA/TcMar-Tigger	3965	-	38	56074587	53563
chr19	56021024	56221024	harbor1	chr19	56075122	56075320	DNA/TcMar-Tigger	715	-	99	56075221	54197
chr19	5027258	5227258	harbor1	chr19	5042853	5043094	DNA/TcMar-Tigger	1252	-	120	5042973	15715
chr19	5034078	5234078	harbor1	chr19	5042853	5043094	DNA/TcMar-Tigger	1252	-	120	5042973	8895
chr19	3283783	3483783	harbor1	chr19	3287784	3288239	DNA/TcMar-Tigger	1367	-	228	3288012	4229
chr19	49751333	49951333	harbor1	chr19	49778142	49778300	DNA/TcMar-Tigger	1382	-	79	49778221	26888
chr19	49751333	49951333	harbor1	chr19	49778601	49778765	DNA/TcMar-Tigger	1382	-	82	49778683	27350
chr19	49751333	49951333	harbor1	chr19	49847561	49847628	DNA/TcMar-Tigger	833	-	34	49847595	96262
chr19	49751333	49951333	harbor1	chr19	49847982	49848095	DNA/TcMar-Tigger	833	-	56	49848038	96705
chr19	49751333	49951333	harbor1	chr19	49848388	49848565	DNA/TcMar-Tigger	833	-	88	49848476	97143
chr19	49751333	49951333	harbor1	chr19	49848862	49848954	DNA/TcMar-Tigger	833	-	46	49848908	97575
chr19	10073322	10273322	harbor1	chr19	10127814	10127907	DNA/TcMar-Tigger	1670	-	46	10127860	54538
chr19	10073322	10273322	harbor1	chr19	10128223	10128270	DNA/TcMar-Tigger	1670	-	24	10128247	54925
chr19	10073322	10273322	harbor1	chr19	10128547	10128755	DNA/TcMar-Tigger	1670	-	104	10128651	55329
chr19	35101286	35301286	harbor1	chr19	35164942	35165101	DNA/TcMar-Tigger	1109	-	80	35165022	63736
chr19	35101286	35301286	harbor1	chr19	35165712	35165781	DNA/TcMar-Tigger	1109	-	34	35165746	64460
chr19	2710214	2910214	harbor1	chr19	2809075	2809480	DNA/TcMar-Tigger	1009	-	202	2809277	99063
chr19	49751330	49951330	harbor1	chr19	49778142	49778300	DNA/TcMar-Tigger	1382	-	79	49778221	26891
chr19	49751330	49951330	harbor1	chr19	49778601	49778765	DNA/TcMar-Tigger	1382	-	82	49778683	27353
chr19	49751330	49951330	harbor1	chr19	49847561	49847628	DNA/TcMar-Tigger	833	-	34	49847595	96265
chr19	49751330	49951330	harbor1	chr19	49847982	49848095	DNA/TcMar-Tigger	833	-	56	49848038	96708
chr19	49751330	49951330	harbor1	chr19	49848388	49848565	DNA/TcMar-Tigger	833	-	88	49848476	97146
chr19	49751330	49951330	harbor1	chr19	49848862	49848954	DNA/TcMar-Tigger	833	-	46	49848908	97578
chr19	49751332	49951332	harbor1	chr19	49778142	49778300	DNA/TcMar-Tigger	1382	-	79	49778221	26889
chr19	49751332	49951332	harbor1	chr19	49778601	49778765	DNA/TcMar-Tigger	1382	-	82	49778683	27351
chr19	49751332	49951332	harbor1	chr19	49847561	49847628	DNA/TcMar-Tigger	833	-	34	49847595	96263
chr19	49751332	49951332	harbor1	chr19	49847982	49848095	DNA/TcMar-Tigger	833	-	56	49848038	96706
chr19	49751332	49951332	harbor1	chr19	49848388	49848565	DNA/TcMar-Tigger	833	-	88	49848476	97144
chr19	49751332	49951332	harbor1	chr19	49848862	49848954	DNA/TcMar-Tigger	833	-	46	49848908	97576
chr19	44719569	44919569	harbor1	chr19	44786100	44786309	DNA/TcMar-Tigger	1296	-	104	44786204	66635
chr19	44719569	44919569	harbor1	chr19	44786625	44786820	DNA/TcMar-Tigger	1296	-	98	44786723	67154
chr19	2710232	2910232	harbor1	chr19	2809075	2809480	DNA/TcMar-Tigger	1009	-	202	2809277	99045
chr19	7530548	7730548	harbor1	chr19	7548522	7548704	DNA/TcMar-Tigger	917	-	91	7548613	18065
chr19	32305852	32505852	harbor1	chr19	32373384	32374169	DNA/TcMar-Tigger	3207	-	392	32373776	67924
chr19	56018924	56218924	harbor1	chr19	56041314	56041666	DNA/TcMar-Tigger	2173	-	176	56041490	22566
chr19	56018924	56218924	harbor1	chr19	56041972	56042234	DNA/TcMar-Tigger	2173	-	131	56042103	23179
chr19	56018924	56218924	harbor1	chr19	56060364	56060562	DNA/TcMar-Tigger	1096	-	99	56060463	41539
chr19	56018924	56218924	harbor1	chr19	56072844	56073213	DNA/TcMar-Tigger	3965	-	184	56073028	54104
chr19	56018924	56218924	harbor1	chr19	56073513	56073582	DNA/TcMar-Tigger	3965	-	34	56073547	54623
chr19	56018924	56218924	harbor1	chr19	56073894	56074255	DNA/TcMar-Tigger	3965	-	180	56074074	55150
chr19	56018924	56218924	harbor1	chr19	56074549	56074624	DNA/TcMar-Tigger	3965	-	38	56074587	55663
chr19	56018924	56218924	harbor1	chr19	56075122	56075320	DNA/TcMar-Tigger	715	-	99	56075221	56297
chr19	39407220	39607220	harbor1	chr19	39430840	39431000	DNA/TcMar-Tigger	658	-	80	39430920	23700
chr19	39407220	39607220	harbor1	chr19	39451041	39451187	DNA/TcMar-Tigger	732	-	73	39451114	43894
chr19	39407220	39607220	harbor1	chr19	39451444	39451529	DNA/TcMar-Tigger	732	-	42	39451486	44266
chr19	39407220	39607220	harbor1	chr19	39451832	39451867	DNA/TcMar-Tigger	732	-	18	39451850	44630
chr19	39407220	39607220	harbor1	chr19	39465841	39466056	DNA/TcMar-Tigger	1096	-	108	39465949	58729
chr19	49751427	49951427	harbor1	chr19	49778142	49778300	DNA/TcMar-Tigger	1382	-	79	49778221	26794
chr19	49751427	49951427	harbor1	chr19	49778601	49778765	DNA/TcMar-Tigger	1382	-	82	49778683	27256
chr19	49751427	49951427	harbor1	chr19	49847561	49847628	DNA/TcMar-Tigger	833	-	34	49847595	96168
chr19	49751427	49951427	harbor1	chr19	49847982	49848095	DNA/TcMar-Tigger	833	-	56	49848038	96611
chr19	49751427	49951427	harbor1	chr19	49848388	49848565	DNA/TcMar-Tigger	833	-	88	49848476	97049
chr19	49751427	49951427	harbor1	chr19	49848862	49848954	DNA/TcMar-Tigger	833	-	46	49848908	97481
chr19	13726269	13926269	harbor1	chr19	13766886	13767008	DNA/TcMar-Tigger	1067	-	61	13766947	40678
chr19	13726269	13926269	harbor1	chr19	13767347	13767422	DNA/TcMar-Tigger	1067	-	38	13767385	41116
chr19	49750827	49950827	harbor1	chr19	49778142	49778300	DNA/TcMar-Tigger	1382	-	79	49778221	27394
chr19	49750827	49950827	harbor1	chr19	49778601	49778765	DNA/TcMar-Tigger	1382	-	82	49778683	27856
chr19	49750827	49950827	harbor1	chr19	49847561	49847628	DNA/TcMar-Tigger	833	-	34	49847595	96768
chr19	49750827	49950827	harbor1	chr19	49847982	49848095	DNA/TcMar-Tigger	833	-	56	49848038	97211
chr19	49750827	49950827	harbor1	chr19	49848388	49848565	DNA/TcMar-Tigger	833	-	88	49848476	97649
chr19	49750827	49950827	harbor1	chr19	49848862	49848954	DNA/TcMar-Tigger	833	-	46	49848908	98081
chr19	9484484	9684484	harbor1	chr19	9532097	9532264	DNA/TcMar-Tigger	1208	-	84	9532181	47697
chr19	9484484	9684484	harbor1	chr19	9532299	9532318	DNA/TcMar-Tigger	1208	-	10	9532309	47825
chr19	9484484	9684484	harbor1	chr19	9532597	9532684	DNA/TcMar-Tigger	1208	-	44	9532641	48157
chr19	48525128	48725128	harbor1	chr19	48535375	48535508	DNA/TcMar-Tigger	636	-	66	48535441	10313
chr19	48525128	48725128	harbor1	chr19	48536333	48536535	DNA/TcMar-Tigger	1244	-	101	48536434	11306
chr19	317396	517396	harbor1	chr19	320814	321265	DNA/TcMar-Tigger	1604	-	226	321040	3644
chr19	317396	517396	harbor1	chr19	340268	340691	DNA/TcMar-Tigger	2669	-	212	340480	23084
chr19	9986276	10186276	harbor1	chr19	9994609	9994907	DNA/TcMar-Tigger	1850	-	149	9994758	8482
chr19	9986276	10186276	harbor1	chr19	9995208	9995243	DNA/TcMar-Tigger	1850	-	18	9995226	8950
chr19	8877739	9077739	harbor1	chr19	8919347	8919404	DNA/TcMar-Tigger	1934	-	28	8919375	41636
chr19	8877739	9077739	harbor1	chr19	8920012	8920062	DNA/TcMar-Tigger	1934	-	25	8920037	42298
chr19	8877739	9077739	harbor1	chr19	8920377	8920663	DNA/TcMar-Tigger	1934	-	143	8920520	42781
chr19	10525987	10725987	harbor1	chr19	10614534	10614688	DNA/TcMar-Tigger	635	-	77	10614611	88624
chr19	10525987	10725987	harbor1	chr19	10615000	10615146	DNA/TcMar-Tigger	635	-	73	10615073	89086
chr19	44719429	44919429	harbor1	chr19	44786100	44786309	DNA/TcMar-Tigger	1296	-	104	44786204	66775
chr19	44719429	44919429	harbor1	chr19	44786625	44786820	DNA/TcMar-Tigger	1296	-	98	44786723	67294
chr19	37894961	38094961	harbor1	chr19	37923227	37923756	DNA/TcMar-Tigger	5177	-	264	37923491	28530
chr19	37894961	38094961	harbor1	chr19	37924074	37924480	DNA/TcMar-Tigger	5177	-	203	37924277	29316
chr19	37894961	38094961	harbor1	chr19	37924694	37924766	DNA/TcMar-Tigger	1467	-	36	37924730	29769
chr19	37894961	38094961	harbor1	chr19	37925065	37925301	DNA/TcMar-Tigger	1467	-	118	37925183	30222
chr19	37894961	38094961	harbor1	chr19	37944623	37944684	DNA/TcMar-Tigger	1108	-	30	37944653	49692
chr19	37894961	38094961	harbor1	chr19	37944972	37945128	DNA/TcMar-Tigger	1108	-	78	37945050	50089
chr19	10887632	11087632	harbor1	chr19	10965537	10965806	DNA/TcMar-Tigger	1480	-	134	10965671	78039
chr19	31989361	32189361	harbor1	chr19	32087768	32087946	DNA/TcMar-Tigger	2007	-	89	32087857	98496
chr19	31989361	32189361	harbor1	chr19	32088077	32088113	DNA/TcMar-Tigger	2007	-	18	32088095	98734
chr19	31989361	32189361	harbor1	chr19	32088428	32088583	DNA/TcMar-Tigger	2007	-	78	32088506	99145
chr19	49751463	49951463	harbor1	chr19	49778142	49778300	DNA/TcMar-Tigger	1382	-	79	49778221	26758
chr19	49751463	49951463	harbor1	chr19	49778601	49778765	DNA/TcMar-Tigger	1382	-	82	49778683	27220
chr19	49751463	49951463	harbor1	chr19	49847561	49847628	DNA/TcMar-Tigger	833	-	34	49847595	96132
chr19	49751463	49951463	harbor1	chr19	49847982	49848095	DNA/TcMar-Tigger	833	-	56	49848038	96575
chr19	49751463	49951463	harbor1	chr19	49848388	49848565	DNA/TcMar-Tigger	833	-	88	49848476	97013
chr19	49751463	49951463	harbor1	chr19	49848862	49848954	DNA/TcMar-Tigger	833	-	46	49848908	97445
chr19	10320198	10520198	harbor1	chr19	10411011	10411211	DNA/TcMar-Tigger	980	-	100	10411111	90913
chr19	10320198	10520198	harbor1	chr19	10411756	10411916	DNA/TcMar-Tigger	1044	-	80	10411836	91638
chr19	10320198	10520198	harbor1	chr19	10412230	10412676	DNA/TcMar-Tigger	2879	-	223	10412453	92255
chr19	10320198	10520198	harbor1	chr19	10413259	10413353	DNA/TcMar-Tigger	2879	-	47	10413306	93108
chr19	16789062	16989062	harbor1	chr19	16844553	16845149	DNA/TcMar-Tigger	1883	-	298	16844851	55789
chr19	30129079	30329079	harbor1	chr19	30209049	30209660	DNA/TcMar-Tigger	811	-	306	30209355	80276
chr19	30129079	30329079	harbor1	chr19	30220740	30221602	DNA/TcMar-Tigger	4398	-	431	30221171	92092
chr19	48639075	48839075	harbor1	chr19	48686352	48686611	DNA/TcMar-Tigger	1245	-	130	48686482	47407
chr19	49750826	49950826	harbor1	chr19	49778142	49778300	DNA/TcMar-Tigger	1382	-	79	49778221	27395
chr19	49750826	49950826	harbor1	chr19	49778601	49778765	DNA/TcMar-Tigger	1382	-	82	49778683	27857
chr19	49750826	49950826	harbor1	chr19	49847561	49847628	DNA/TcMar-Tigger	833	-	34	49847595	96769
chr19	49750826	49950826	harbor1	chr19	49847982	49848095	DNA/TcMar-Tigger	833	-	56	49848038	97212
chr19	49750826	49950826	harbor1	chr19	49848388	49848565	DNA/TcMar-Tigger	833	-	88	49848476	97650
chr19	49750826	49950826	harbor1	chr19	49848862	49848954	DNA/TcMar-Tigger	833	-	46	49848908	98082
chr19	32305891	32505891	harbor1	chr19	32373384	32374169	DNA/TcMar-Tigger	3207	-	392	32373776	67885
chr19	32305909	32505909	harbor1	chr19	32373384	32374169	DNA/TcMar-Tigger	3207	-	392	32373776	67867
chr19	317267	517267	harbor1	chr19	320814	321265	DNA/TcMar-Tigger	1604	-	226	321040	3773
chr19	317267	517267	harbor1	chr19	340268	340691	DNA/TcMar-Tigger	2669	-	212	340480	23213
chr19	4691699	4891699	harbor1	chr19	4757399	4757666	DNA/TcMar-Tigger	1802	-	134	4757533	65834
chr19	4691699	4891699	harbor1	chr19	4757956	4758021	DNA/TcMar-Tigger	1802	-	32	4757988	66289
chr19	6652741	6852741	harbor1	chr19	6655667	6655844	DNA/TcMar-Tigger	1260	-	88	6655755	3014
chr19	6652741	6852741	harbor1	chr19	6661866	6662043	DNA/TcMar-Tigger	918	-	88	6661954	9213
chr19	6652741	6852741	harbor1	chr19	6662331	6662369	DNA/TcMar-Tigger	918	-	19	6662350	9609
chr19	49239891	49439891	harbor1	chr19	49239967	49240227	DNA/TcMar-Tigger	7031	-	130	49240097	206
chr19	49239891	49439891	harbor1	chr19	49240532	49240743	DNA/TcMar-Tigger	7031	-	106	49240638	747
chr19	49239891	49439891	harbor1	chr19	49241050	49241485	DNA/TcMar-Tigger	7031	-	218	49241268	1377
chr19	49239891	49439891	harbor1	chr19	49241771	49241978	DNA/TcMar-Tigger	7031	-	104	49241875	1984
chr19	39990768	40190768	harbor1	chr19	40033052	40033357	DNA/TcMar-Tigger	1366	-	152	40033204	42436
chr19	39990768	40190768	harbor1	chr19	40073233	40073524	DNA/TcMar-Tigger	1439	-	146	40073379	82611
chr19	32305831	32505831	harbor1	chr19	32373384	32374169	DNA/TcMar-Tigger	3207	-	392	32373776	67945
chr19	10612630	10812630	harbor1	chr19	10614534	10614688	DNA/TcMar-Tigger	635	-	77	10614611	1981
chr19	10612630	10812630	harbor1	chr19	10615000	10615146	DNA/TcMar-Tigger	635	-	73	10615073	2443
chr19	49707032	49907032	harbor1	chr19	49778142	49778300	DNA/TcMar-Tigger	1382	-	79	49778221	71189
chr19	49707032	49907032	harbor1	chr19	49778601	49778765	DNA/TcMar-Tigger	1382	-	82	49778683	71651
chr19	15279126	15479126	harbor1	chr19	15305343	15306291	DNA/TcMar-Tigger	7514	-	474	15305817	26691
chr19	15279126	15479126	harbor1	chr19	15306572	15307028	DNA/TcMar-Tigger	7514	-	228	15306800	27674
chr19	49751494	49951494	harbor1	chr19	49778142	49778300	DNA/TcMar-Tigger	1382	-	79	49778221	26727
chr19	49751494	49951494	harbor1	chr19	49778601	49778765	DNA/TcMar-Tigger	1382	-	82	49778683	27189
chr19	49751494	49951494	harbor1	chr19	49847561	49847628	DNA/TcMar-Tigger	833	-	34	49847595	96101
chr19	49751494	49951494	harbor1	chr19	49847982	49848095	DNA/TcMar-Tigger	833	-	56	49848038	96544
chr19	49751494	49951494	harbor1	chr19	49848388	49848565	DNA/TcMar-Tigger	833	-	88	49848476	96982
chr19	49751494	49951494	harbor1	chr19	49848862	49848954	DNA/TcMar-Tigger	833	-	46	49848908	97414
chr19	3288086	3488086	harbor1	chr19	3287784	3288239	DNA/TcMar-Tigger	1367	-	228	3288012	74
chr19	49751467	49951467	harbor1	chr19	49778142	49778300	DNA/TcMar-Tigger	1382	-	79	49778221	26754
chr19	49751467	49951467	harbor1	chr19	49778601	49778765	DNA/TcMar-Tigger	1382	-	82	49778683	27216
chr19	49751467	49951467	harbor1	chr19	49847561	49847628	DNA/TcMar-Tigger	833	-	34	49847595	96128
chr19	49751467	49951467	harbor1	chr19	49847982	49848095	DNA/TcMar-Tigger	833	-	56	49848038	96571
chr19	49751467	49951467	harbor1	chr19	49848388	49848565	DNA/TcMar-Tigger	833	-	88	49848476	97009
chr19	49751467	49951467	harbor1	chr19	49848862	49848954	DNA/TcMar-Tigger	833	-	46	49848908	97441
chr19	15333247	15533247	harbor1	chr19	15382523	15382669	DNA/TcMar-Tigger	801	-	73	15382596	49349
chr19	317228	517228	harbor1	chr19	320814	321265	DNA/TcMar-Tigger	1604	-	226	321040	3812
chr19	317228	517228	harbor1	chr19	340268	340691	DNA/TcMar-Tigger	2669	-	212	340480	23252
chr19	15010518	15210518	harbor1	chr19	15076043	15076295	DNA/TcMar-Tigger	1983	-	126	15076169	65651
chr19	15010518	15210518	harbor1	chr19	15076590	15076705	DNA/TcMar-Tigger	1983	-	58	15076648	66130
chr19	1855242	2055242	harbor1	chr19	1948700	1949099	DNA/TcMar-Tigger	1040	-	200	1948900	93658
chr19	49751344	49951344	harbor1	chr19	49778142	49778300	DNA/TcMar-Tigger	1382	-	79	49778221	26877
chr19	49751344	49951344	harbor1	chr19	49778601	49778765	DNA/TcMar-Tigger	1382	-	82	49778683	27339
chr19	49751344	49951344	harbor1	chr19	49847561	49847628	DNA/TcMar-Tigger	833	-	34	49847595	96251
chr19	49751344	49951344	harbor1	chr19	49847982	49848095	DNA/TcMar-Tigger	833	-	56	49848038	96694
chr19	49751344	49951344	harbor1	chr19	49848388	49848565	DNA/TcMar-Tigger	833	-	88	49848476	97132
chr19	49751344	49951344	harbor1	chr19	49848862	49848954	DNA/TcMar-Tigger	833	-	46	49848908	97564
chr19	2537219	2737219	harbor1	chr19	2559811	2560235	DNA/TcMar-Tigger	1026	-	212	2560023	22804
chr19	48342797	48542797	harbor1	chr19	48351866	48351966	DNA/TcMar-Tigger	1847	-	50	48351916	9119
chr19	48342797	48542797	harbor1	chr19	48352263	48352303	DNA/TcMar-Tigger	1847	-	20	48352283	9486
chr19	48342797	48542797	harbor1	chr19	48352917	48353140	DNA/TcMar-Tigger	1847	-	112	48353029	10232
chr19	16442283	16642283	harbor1	chr19	16458860	16459194	DNA/TcMar-Tigger	1853	-	167	16459027	16744
chr19	1939769	2139769	harbor1	chr19	1948700	1949099	DNA/TcMar-Tigger	1040	-	200	1948900	9131
chr19	15279128	15479128	harbor1	chr19	15305343	15306291	DNA/TcMar-Tigger	7514	-	474	15305817	26689
chr19	15279128	15479128	harbor1	chr19	15306572	15307028	DNA/TcMar-Tigger	7514	-	228	15306800	27672
chr19	41252149	41452149	harbor1	chr19	41286119	41286338	DNA/TcMar-Tigger	800	-	110	41286229	34080
chr19	1946248	2146248	harbor1	chr19	1948700	1949099	DNA/TcMar-Tigger	1040	-	200	1948900	2652
chr19	48525162	48725162	harbor1	chr19	48535375	48535508	DNA/TcMar-Tigger	636	-	66	48535441	10279
chr19	48525162	48725162	harbor1	chr19	48536333	48536535	DNA/TcMar-Tigger	1244	-	101	48536434	11272
chr19	49750828	49950828	harbor1	chr19	49778142	49778300	DNA/TcMar-Tigger	1382	-	79	49778221	27393
chr19	49750828	49950828	harbor1	chr19	49778601	49778765	DNA/TcMar-Tigger	1382	-	82	49778683	27855
chr19	49750828	49950828	harbor1	chr19	49847561	49847628	DNA/TcMar-Tigger	833	-	34	49847595	96767
chr19	49750828	49950828	harbor1	chr19	49847982	49848095	DNA/TcMar-Tigger	833	-	56	49848038	97210
chr19	49750828	49950828	harbor1	chr19	49848388	49848565	DNA/TcMar-Tigger	833	-	88	49848476	97648
chr19	49750828	49950828	harbor1	chr19	49848862	49848954	DNA/TcMar-Tigger	833	-	46	49848908	98080
chr19	12690073	12890073	harbor1	chr19	12703984	12704083	DNA/TcMar-Tigger	1661	-	50	12704034	13961
chr19	12690073	12890073	harbor1	chr19	12704375	12704641	DNA/TcMar-Tigger	1661	-	133	12704508	14435
chr19	2483587	2683587	harbor1	chr19	2559811	2560235	DNA/TcMar-Tigger	1026	-	212	2560023	76436
chr19	56021112	56221112	harbor1	chr19	56041314	56041666	DNA/TcMar-Tigger	2173	-	176	56041490	20378
chr19	56021112	56221112	harbor1	chr19	56041972	56042234	DNA/TcMar-Tigger	2173	-	131	56042103	20991
chr19	56021112	56221112	harbor1	chr19	56060364	56060562	DNA/TcMar-Tigger	1096	-	99	56060463	39351
chr19	56021112	56221112	harbor1	chr19	56072844	56073213	DNA/TcMar-Tigger	3965	-	184	56073028	51916
chr19	56021112	56221112	harbor1	chr19	56073513	56073582	DNA/TcMar-Tigger	3965	-	34	56073547	52435
chr19	56021112	56221112	harbor1	chr19	56073894	56074255	DNA/TcMar-Tigger	3965	-	180	56074074	52962
chr19	56021112	56221112	harbor1	chr19	56074549	56074624	DNA/TcMar-Tigger	3965	-	38	56074587	53475
chr19	56021112	56221112	harbor1	chr19	56075122	56075320	DNA/TcMar-Tigger	715	-	99	56075221	54109
chr19	49767567	49967567	harbor1	chr19	49778142	49778300	DNA/TcMar-Tigger	1382	-	79	49778221	10654
chr19	49767567	49967567	harbor1	chr19	49778601	49778765	DNA/TcMar-Tigger	1382	-	82	49778683	11116
chr19	49767567	49967567	harbor1	chr19	49847561	49847628	DNA/TcMar-Tigger	833	-	34	49847595	80028
chr19	49767567	49967567	harbor1	chr19	49847982	49848095	DNA/TcMar-Tigger	833	-	56	49848038	80471
chr19	49767567	49967567	harbor1	chr19	49848388	49848565	DNA/TcMar-Tigger	833	-	88	49848476	80909
chr19	49767567	49967567	harbor1	chr19	49848862	49848954	DNA/TcMar-Tigger	833	-	46	49848908	81341
chr19	49751409	49951409	harbor1	chr19	49778142	49778300	DNA/TcMar-Tigger	1382	-	79	49778221	26812
chr19	49751409	49951409	harbor1	chr19	49778601	49778765	DNA/TcMar-Tigger	1382	-	82	49778683	27274
chr19	49751409	49951409	harbor1	chr19	49847561	49847628	DNA/TcMar-Tigger	833	-	34	49847595	96186
chr19	49751409	49951409	harbor1	chr19	49847982	49848095	DNA/TcMar-Tigger	833	-	56	49848038	96629
chr19	49751409	49951409	harbor1	chr19	49848388	49848565	DNA/TcMar-Tigger	833	-	88	49848476	97067
chr19	49751409	49951409	harbor1	chr19	49848862	49848954	DNA/TcMar-Tigger	833	-	46	49848908	97499
chr19	12581893	12781893	harbor1	chr19	12671356	12671370	DNA/TcMar-Tigger	753	-	7	12671363	89470
chr19	12581893	12781893	harbor1	chr19	12671677	12671702	DNA/TcMar-Tigger	753	-	12	12671689	89796
chr19	12581893	12781893	harbor1	chr19	12671994	12672182	DNA/TcMar-Tigger	753	-	94	12672088	90195
chr19	12596104	12796104	harbor1	chr19	12671356	12671370	DNA/TcMar-Tigger	753	-	7	12671363	75259
chr19	12596104	12796104	harbor1	chr19	12671677	12671702	DNA/TcMar-Tigger	753	-	12	12671689	75585
chr19	12596104	12796104	harbor1	chr19	12671994	12672182	DNA/TcMar-Tigger	753	-	94	12672088	75984
chr19	3288104	3488104	harbor1	chr19	3287784	3288239	DNA/TcMar-Tigger	1367	-	228	3288012	92
chr19	48525086	48725086	harbor1	chr19	48535375	48535508	DNA/TcMar-Tigger	636	-	66	48535441	10355
chr19	48525086	48725086	harbor1	chr19	48536333	48536535	DNA/TcMar-Tigger	1244	-	101	48536434	11348
chr20	34903928	35103928	harbor1	chr20	34944588	34944927	DNA/TcMar-Tigger	2341	-	170	34944758	40830
chr20	34903928	35103928	harbor1	chr20	34962432	34962531	DNA/TcMar-Tigger	639	-	50	34962482	58554
chr20	34903928	35103928	harbor1	chr20	34963112	34963272	DNA/TcMar-Tigger	945	-	80	34963192	59264
chr20	44866470	45066470	harbor1	chr20	44964347	44964519	DNA/TcMar-Tigger	645	-	86	44964433	97963
chr20	62322429	62522429	harbor1	chr20	62399885	62399980	DNA/TcMar-Tigger	480	-	48	62399933	77504
chr20	34904026	35104026	harbor1	chr20	34944588	34944927	DNA/TcMar-Tigger	2341	-	170	34944758	40732
chr20	34904026	35104026	harbor1	chr20	34962432	34962531	DNA/TcMar-Tigger	639	-	50	34962482	58456
chr20	34904026	35104026	harbor1	chr20	34963112	34963272	DNA/TcMar-Tigger	945	-	80	34963192	59166
chr20	330383	530383	harbor1	chr20	401241	401407	DNA/TcMar-Tigger	3189	-	83	401324	70941
chr20	330383	530383	harbor1	chr20	401715	402163	DNA/TcMar-Tigger	3189	-	224	401939	71556
chr20	1018818	1218818	harbor1	chr20	1023504	1023834	DNA/TcMar-Tigger	1806	-	165	1023669	4851
chr20	1018818	1218818	harbor1	chr20	1093107	1093140	DNA/TcMar-Tigger	3857	-	16	1093123	74305
chr20	1018818	1218818	harbor1	chr20	1093448	1094106	DNA/TcMar-Tigger	3857	-	329	1093777	74959
chr20	63939095	64139095	harbor1	chr20	64014295	64014372	DNA/TcMar-Tigger	1295	-	38	64014333	75238
chr20	63939095	64139095	harbor1	chr20	64014695	64014912	DNA/TcMar-Tigger	1295	-	108	64014803	75708
chr20	63939095	64139095	harbor1	chr20	64035125	64035319	DNA/TcMar-Tigger	681	-	97	64035222	96127
chr20	2370770	2570770	harbor1	chr20	2422427	2422648	DNA/TcMar-Tigger	15060	-	110	2422537	51767
chr20	2370770	2570770	harbor1	chr20	2425366	2425516	DNA/TcMar-Tigger	15060	-	75	2425441	54671
chr20	2370770	2570770	harbor1	chr20	2422967	2425051	DNA/TcMar-Tigger	15060	-	1042	2424009	53239
chr20	4586429	4786429	harbor1	chr20	4646112	4646193	DNA/TcMar-Tigger	531	-	40	4646152	59723
chr20	49710583	49910583	harbor1	chr20	49797848	49798080	DNA/TcMar-Tigger	1674	-	116	49797964	87381
chr20	57552168	57752168	harbor1	chr20	57599417	57599726	DNA/TcMar-Tigger	1838	-	154	57599571	47403
chr20	32383338	32583338	harbor1	chr20	32390013	32390335	DNA/TcMar-Tigger	1713	-	161	32390174	6836
chr20	32383338	32583338	harbor1	chr20	32401442	32401561	DNA/TcMar-Tigger	1325	-	60	32401502	18164
chr20	32383338	32583338	harbor1	chr20	32401856	32402049	DNA/TcMar-Tigger	1325	-	96	32401952	18614
chr20	32383338	32583338	harbor1	chr20	32410172	32410305	DNA/TcMar-Tigger	1565	-	66	32410238	26900
chr20	32383338	32583338	harbor1	chr20	32410441	32410650	DNA/TcMar-Tigger	1565	-	104	32410545	27207
chr20	34901268	35101268	harbor1	chr20	34944588	34944927	DNA/TcMar-Tigger	2341	-	170	34944758	43490
chr20	34901268	35101268	harbor1	chr20	34962432	34962531	DNA/TcMar-Tigger	639	-	50	34962482	61214
chr20	34901268	35101268	harbor1	chr20	34963112	34963272	DNA/TcMar-Tigger	945	-	80	34963192	61924
chr20	4799071	4999071	harbor1	chr20	4824334	4824472	DNA/TcMar-Tigger	575	-	69	4824403	25332
chr20	4799071	4999071	harbor1	chr20	4847712	4847970	DNA/TcMar-Tigger	1298	-	129	4847841	48770
chr20	4799071	4999071	harbor1	chr20	4847983	4848148	DNA/TcMar-Tigger	1032	-	82	4848065	48994
chr20	4799071	4999071	harbor1	chr20	4848505	4848538	DNA/TcMar-Tigger	1032	-	16	4848521	49450
chr20	4799071	4999071	harbor1	chr20	4865672	4865828	DNA/TcMar-Tigger	1256	-	78	4865750	66679
chr20	4799071	4999071	harbor1	chr20	4866133	4866353	DNA/TcMar-Tigger	1256	-	110	4866243	67172
chr20	48275448	48475448	harbor1	chr20	48284151	48284514	DNA/TcMar-Tigger	2258	-	182	48284333	8885
chr20	3074005	3274005	harbor1	chr20	3153747	3153984	DNA/TcMar-Tigger	1385	-	118	3153865	79860
chr20	21818150	22018150	harbor1	chr20	21829611	21830054	DNA/TcMar-Tigger	679	-	222	21829833	11683
chr20	33594101	33794101	harbor1	chr20	33602558	33602646	DNA/TcMar-Tigger	543	-	44	33602602	8501
chr20	33594101	33794101	harbor1	chr20	33602671	33603160	DNA/TcMar-Tigger	2754	-	244	33602915	8814
chr20	59839798	60039798	harbor1	chr20	59871624	59871927	DNA/TcMar-Tigger	1699	-	152	59871776	31978
chr20	59839798	60039798	harbor1	chr20	59873100	59873619	DNA/TcMar-Tigger	3036	-	260	59873360	33562
chr20	59839798	60039798	harbor1	chr20	59935944	59936279	DNA/TcMar-Tigger	1463	-	168	59936112	96314
chr20	43408519	43608519	harbor1	chr20	43476014	43476798	DNA/TcMar-Tigger	4695	-	392	43476406	67887
chr20	5027110	5227110	harbor1	chr20	5091531	5091609	DNA/TcMar-Tigger	497	-	39	5091570	64460
chr20	3914093	4114093	harbor1	chr20	3980362	3980615	DNA/TcMar-Tigger	1206	-	126	3980488	66395
chr20	61271130	61471130	harbor1	chr20	61328886	61329220	DNA/TcMar-Tigger	1699	-	167	61329053	57923
chr20	33574220	33774220	harbor1	chr20	33602558	33602646	DNA/TcMar-Tigger	543	-	44	33602602	28382
chr20	33574220	33774220	harbor1	chr20	33602671	33603160	DNA/TcMar-Tigger	2754	-	244	33602915	28695
chr20	1018817	1218817	harbor1	chr20	1023504	1023834	DNA/TcMar-Tigger	1806	-	165	1023669	4852
chr20	1018817	1218817	harbor1	chr20	1093107	1093140	DNA/TcMar-Tigger	3857	-	16	1093123	74306
chr20	1018817	1218817	harbor1	chr20	1093448	1094106	DNA/TcMar-Tigger	3857	-	329	1093777	74960
chr20	37933379	38133379	harbor1	chr20	38027407	38027643	DNA/TcMar-Tigger	2371	-	118	38027525	94146
chr20	37933379	38133379	harbor1	chr20	38027951	38028117	DNA/TcMar-Tigger	2371	-	83	38028034	94655
chr20	37933379	38133379	harbor1	chr20	38028118	38028180	DNA/TcMar-Tigger	1369	-	31	38028149	94770
chr20	37933379	38133379	harbor1	chr20	38027139	38027406	DNA/TcMar-Tigger	1369	-	134	38027273	93894
chr20	34992759	35192759	harbor1	chr20	35010896	35010978	DNA/TcMar-Tigger	1542	-	41	35010937	18178
chr20	34992759	35192759	harbor1	chr20	35011280	35011598	DNA/TcMar-Tigger	1542	-	159	35011439	18680
chr20	34992759	35192759	harbor1	chr20	35043566	35043875	DNA/TcMar-Tigger	1681	-	154	35043720	50961
chr20	59833005	60033005	harbor1	chr20	59871624	59871927	DNA/TcMar-Tigger	1699	-	152	59871776	38771
chr20	59833005	60033005	harbor1	chr20	59873100	59873619	DNA/TcMar-Tigger	3036	-	260	59873360	40355
chr21	29198953	29398953	harbor1	chr21	29262079	29264411	DNA/TcMar-Tigger	14049	-	1166	29263245	64292
chr21	44576686	44776686	harbor1	chr21	44595271	44595735	DNA/TcMar-Tigger	1683	-	232	44595503	18817
chr21	14337769	14537769	harbor1	chr21	14354247	14354504	DNA/TcMar-Tigger	751	-	128	14354375	16606
chr21	14337769	14537769	harbor1	chr21	14430903	14431206	DNA/TcMar-Tigger	1062	-	152	14431055	93286
chr21	5028567	5228567	harbor1	chr21	5053376	5053693	DNA/TcMar-Tigger	827	-	158	5053534	24967
chr21	14337822	14537822	harbor1	chr21	14354247	14354504	DNA/TcMar-Tigger	751	-	128	14354375	16553
chr21	14337822	14537822	harbor1	chr21	14430903	14431206	DNA/TcMar-Tigger	1062	-	152	14431055	93233
chr21	29199129	29399129	harbor1	chr21	29262079	29264411	DNA/TcMar-Tigger	14049	-	1166	29263245	64116
chr21	29198948	29398948	harbor1	chr21	29262079	29264411	DNA/TcMar-Tigger	14049	-	1166	29263245	64297
chr21	42275771	42475771	harbor1	chr21	42340627	42340873	DNA/TcMar-Tigger	6215	-	123	42340750	64979
chr21	42275771	42475771	harbor1	chr21	42341180	42341434	DNA/TcMar-Tigger	6215	-	127	42341307	65536
chr21	42275771	42475771	harbor1	chr21	42341744	42342418	DNA/TcMar-Tigger	6215	-	337	42342081	66310
chr21	42275771	42475771	harbor1	chr21	42368455	42368725	DNA/TcMar-Tigger	1469	-	135	42368590	92819
chr21	42275771	42475771	harbor1	chr21	42374767	42374972	DNA/TcMar-Tigger	928	-	102	42374869	99098
chr21	42275771	42475771	harbor1	chr21	42369018	42369093	DNA/TcMar-Tigger	1469	-	38	42369056	93285
chr21	5008533	5208533	harbor1	chr21	5053376	5053693	DNA/TcMar-Tigger	827	-	158	5053534	45001
chr21	14337781	14537781	harbor1	chr21	14354247	14354504	DNA/TcMar-Tigger	751	-	128	14354375	16594
chr21	14337781	14537781	harbor1	chr21	14430903	14431206	DNA/TcMar-Tigger	1062	-	152	14431055	93274
chr21	14337791	14537791	harbor1	chr21	14354247	14354504	DNA/TcMar-Tigger	751	-	128	14354375	16584
chr21	14337791	14537791	harbor1	chr21	14430903	14431206	DNA/TcMar-Tigger	1062	-	152	14431055	93264
chr21	29199041	29399041	harbor1	chr21	29262079	29264411	DNA/TcMar-Tigger	14049	-	1166	29263245	64204
chr21	44239294	44439294	harbor1	chr21	44243887	44244215	DNA/TcMar-Tigger	1534	-	164	44244051	4757
chr21	14336442	14536442	harbor1	chr21	14354247	14354504	DNA/TcMar-Tigger	751	-	128	14354375	17933
chr21	14336442	14536442	harbor1	chr21	14430903	14431206	DNA/TcMar-Tigger	1062	-	152	14431055	94613
chr21	14337826	14537826	harbor1	chr21	14354247	14354504	DNA/TcMar-Tigger	751	-	128	14354375	16549
chr21	14337826	14537826	harbor1	chr21	14430903	14431206	DNA/TcMar-Tigger	1062	-	152	14431055	93229
chr21	14337835	14537835	harbor1	chr21	14354247	14354504	DNA/TcMar-Tigger	751	-	128	14354375	16540
chr21	14337835	14537835	harbor1	chr21	14430903	14431206	DNA/TcMar-Tigger	1062	-	152	14431055	93220
chr21	42275718	42475718	harbor1	chr21	42340627	42340873	DNA/TcMar-Tigger	6215	-	123	42340750	65032
chr21	42275718	42475718	harbor1	chr21	42341180	42341434	DNA/TcMar-Tigger	6215	-	127	42341307	65589
chr21	42275718	42475718	harbor1	chr21	42341744	42342418	DNA/TcMar-Tigger	6215	-	337	42342081	66363
chr21	42275718	42475718	harbor1	chr21	42368455	42368725	DNA/TcMar-Tigger	1469	-	135	42368590	92872
chr21	42275718	42475718	harbor1	chr21	42374767	42374972	DNA/TcMar-Tigger	928	-	102	42374869	99151
chr21	42275718	42475718	harbor1	chr21	42369018	42369093	DNA/TcMar-Tigger	1469	-	38	42369056	93338
chr21	29199063	29399063	harbor1	chr21	29262079	29264411	DNA/TcMar-Tigger	14049	-	1166	29263245	64182
chr21	46358530	46558530	harbor1	chr21	46378146	46378685	DNA/TcMar-Tigger	1387	-	270	46378416	19886
chr21	46358530	46558530	harbor1	chr21	46439483	46439710	DNA/TcMar-Tigger	1104	-	114	46439597	81067
chr21	29198984	29398984	harbor1	chr21	29262079	29264411	DNA/TcMar-Tigger	14049	-	1166	29263245	64261
chr21	33666298	33866298	harbor1	chr21	33723847	33724083	DNA/TcMar-Tigger	636	-	118	33723965	57667
chr21	33666298	33866298	harbor1	chr21	33724117	33724340	DNA/TcMar-Tigger	636	-	112	33724229	57931
chr21	14173498	14373498	harbor1	chr21	14252628	14252977	DNA/TcMar-Tigger	1881	-	174	14252802	79304
chr21	14337834	14537834	harbor1	chr21	14354247	14354504	DNA/TcMar-Tigger	751	-	128	14354375	16541
chr21	14337834	14537834	harbor1	chr21	14430903	14431206	DNA/TcMar-Tigger	1062	-	152	14431055	93221
chr21	14337784	14537784	harbor1	chr21	14354247	14354504	DNA/TcMar-Tigger	751	-	128	14354375	16591
chr21	14337784	14537784	harbor1	chr21	14430903	14431206	DNA/TcMar-Tigger	1062	-	152	14431055	93271
chr21	33379496	33579496	harbor1	chr21	33386791	33387008	DNA/TcMar-Tigger	618	-	108	33386899	7403
chr21	33379496	33579496	harbor1	chr21	33459765	33460081	DNA/TcMar-Tigger	1089	-	158	33459923	80427
chr21	44215681	44415681	harbor1	chr21	44243887	44244215	DNA/TcMar-Tigger	1534	-	164	44244051	28370
chr22	24057065	24257065	harbor1	chr22	24111106	24111280	DNA/TcMar-Tigger	1695	-	87	24111193	54128
chr22	24057065	24257065	harbor1	chr22	24111614	24111805	DNA/TcMar-Tigger	1695	-	96	24111710	54645
chr22	24057065	24257065	harbor1	chr22	24122283	24122425	DNA/TcMar-Tigger	1191	-	71	24122354	65289
chr22	24057065	24257065	harbor1	chr22	24122735	24122824	DNA/TcMar-Tigger	1191	-	44	24122779	65714
chr22	42772450	42972450	harbor1	chr22	42822575	42822803	DNA/TcMar-Tigger	1172	-	114	42822689	50239
chr22	42772450	42972450	harbor1	chr22	42823110	42823194	DNA/TcMar-Tigger	1172	-	42	42823152	50702
chr22	24069874	24269874	harbor1	chr22	24111106	24111280	DNA/TcMar-Tigger	1695	-	87	24111193	41319
chr22	24069874	24269874	harbor1	chr22	24111614	24111805	DNA/TcMar-Tigger	1695	-	96	24111710	41836
chr22	24069874	24269874	harbor1	chr22	24122283	24122425	DNA/TcMar-Tigger	1191	-	71	24122354	52480
chr22	24069874	24269874	harbor1	chr22	24122735	24122824	DNA/TcMar-Tigger	1191	-	44	24122779	52905
chr22	24069906	24269906	harbor1	chr22	24111106	24111280	DNA/TcMar-Tigger	1695	-	87	24111193	41287
chr22	24069906	24269906	harbor1	chr22	24111614	24111805	DNA/TcMar-Tigger	1695	-	96	24111710	41804
chr22	24069906	24269906	harbor1	chr22	24122283	24122425	DNA/TcMar-Tigger	1191	-	71	24122354	52448
chr22	24069906	24269906	harbor1	chr22	24122735	24122824	DNA/TcMar-Tigger	1191	-	44	24122779	52873
chr22	38298285	38498285	harbor1	chr22	38355892	38356256	DNA/TcMar-Tigger	2523	-	182	38356074	57789
chr22	38298285	38498285	harbor1	chr22	38356560	38356616	DNA/TcMar-Tigger	2523	-	28	38356588	58303
chr22	38298285	38498285	harbor1	chr22	38356630	38356770	DNA/TcMar-Tigger	871	-	70	38356700	58415
chr22	38298285	38498285	harbor1	chr22	38370364	38370755	DNA/TcMar-Tigger	2417	-	196	38370560	72275
chr22	38298285	38498285	harbor1	chr22	38375712	38376316	DNA/TcMar-Tigger	7514	-	302	38376014	77729
chr22	38298285	38498285	harbor1	chr22	38376344	38376875	DNA/TcMar-Tigger	7514	-	266	38376610	78325
chr22	46476611	46676611	harbor1	chr22	46494956	46495151	DNA/TcMar-Tigger	845	-	98	46495054	18443
chr22	46476611	46676611	harbor1	chr22	46495188	46495553	DNA/TcMar-Tigger	5912	-	182	46495370	18759
chr22	46476611	46676611	harbor1	chr22	46495822	46495911	DNA/TcMar-Tigger	5912	-	44	46495866	19255
chr22	46476611	46676611	harbor1	chr22	46496219	46496285	DNA/TcMar-Tigger	5912	-	33	46496252	19641
chr22	46476611	46676611	harbor1	chr22	46496574	46497192	DNA/TcMar-Tigger	5912	-	309	46496883	20272
chr22	50579676	50779676	harbor1	chr22	50615819	50615928	DNA/TcMar-Tigger	622	-	54	50615873	36197
chr22	50579676	50779676	harbor1	chr22	50616047	50616057	DNA/TcMar-Tigger	622	-	5	50616052	36376
chr22	50579676	50779676	harbor1	chr22	50616320	50616400	DNA/TcMar-Tigger	423	-	40	50616360	36684
chr22	50579676	50779676	harbor1	chr22	50617414	50617720	DNA/TcMar-Tigger	2361	-	153	50617567	37891
chr22	50579676	50779676	harbor1	chr22	50618018	50618106	DNA/TcMar-Tigger	2361	-	44	50618062	38386
chr22	50579676	50779676	harbor1	chr22	50618259	50618519	DNA/TcMar-Tigger	1377	-	130	50618389	38713
chr22	50579676	50779676	harbor1	chr22	50618821	50618979	DNA/TcMar-Tigger	3137	-	79	50618900	39224
chr22	50579676	50779676	harbor1	chr22	50619278	50619626	DNA/TcMar-Tigger	3137	-	174	50619452	39776
chr22	24070023	24270023	harbor1	chr22	24111106	24111280	DNA/TcMar-Tigger	1695	-	87	24111193	41170
chr22	24070023	24270023	harbor1	chr22	24111614	24111805	DNA/TcMar-Tigger	1695	-	96	24111710	41687
chr22	24070023	24270023	harbor1	chr22	24122283	24122425	DNA/TcMar-Tigger	1191	-	71	24122354	52331
chr22	24070023	24270023	harbor1	chr22	24122735	24122824	DNA/TcMar-Tigger	1191	-	44	24122779	52756
chr22	43896078	44096078	harbor1	chr22	43919726	43919918	DNA/TcMar-Tigger	1242	-	96	43919822	23744
chr22	43896078	44096078	harbor1	chr22	43920212	43920307	DNA/TcMar-Tigger	1242	-	48	43920260	24182
chr22	43896078	44096078	harbor1	chr22	43962036	43962379	DNA/TcMar-Tigger	2174	-	172	43962208	66130
chr22	26575728	26775728	harbor1	chr22	26594731	26595049	DNA/TcMar-Tigger	650	-	159	26594890	19162
chr22	26575728	26775728	harbor1	chr22	26626553	26626783	DNA/TcMar-Tigger	1451	-	115	26626668	50940
chr22	24065808	24265808	harbor1	chr22	24111106	24111280	DNA/TcMar-Tigger	1695	-	87	24111193	45385
chr22	24065808	24265808	harbor1	chr22	24111614	24111805	DNA/TcMar-Tigger	1695	-	96	24111710	45902
chr22	24065808	24265808	harbor1	chr22	24122283	24122425	DNA/TcMar-Tigger	1191	-	71	24122354	56546
chr22	24065808	24265808	harbor1	chr22	24122735	24122824	DNA/TcMar-Tigger	1191	-	44	24122779	56971
chr22	42989526	43189526	harbor1	chr22	43062141	43062210	DNA/TcMar-Tigger	1653	-	34	43062175	72649
chr22	42989526	43189526	harbor1	chr22	43062521	43062548	DNA/TcMar-Tigger	1653	-	14	43062535	73009
chr22	42989526	43189526	harbor1	chr22	43062842	43063127	DNA/TcMar-Tigger	1653	-	142	43062984	73458
chr22	32075946	32275946	harbor1	chr22	32169111	32169232	DNA/TcMar-Tigger	1733	-	60	32169171	93225
chr22	32075946	32275946	harbor1	chr22	32169531	32169907	DNA/TcMar-Tigger	1733	-	188	32169719	93773
chr22	24069929	24269929	harbor1	chr22	24111106	24111280	DNA/TcMar-Tigger	1695	-	87	24111193	41264
chr22	24069929	24269929	harbor1	chr22	24111614	24111805	DNA/TcMar-Tigger	1695	-	96	24111710	41781
chr22	24069929	24269929	harbor1	chr22	24122283	24122425	DNA/TcMar-Tigger	1191	-	71	24122354	52425
chr22	24069929	24269929	harbor1	chr22	24122735	24122824	DNA/TcMar-Tigger	1191	-	44	24122779	52850
chr22	24070054	24270054	harbor1	chr22	24111106	24111280	DNA/TcMar-Tigger	1695	-	87	24111193	41139
chr22	24070054	24270054	harbor1	chr22	24111614	24111805	DNA/TcMar-Tigger	1695	-	96	24111710	41656
chr22	24070054	24270054	harbor1	chr22	24122283	24122425	DNA/TcMar-Tigger	1191	-	71	24122354	52300
chr22	24070054	24270054	harbor1	chr22	24122735	24122824	DNA/TcMar-Tigger	1191	-	44	24122779	52725
chr22	36675743	36875743	harbor1	chr22	36717588	36717916	DNA/TcMar-Tigger	1855	-	164	36717752	42009
chr22	22997061	23197061	harbor1	chr22	23014891	23015126	DNA/TcMar-Tigger	1246	-	118	23015009	17948
chr22	49664026	49864026	harbor1	chr22	49717142	49717449	DNA/TcMar-Tigger	859	-	154	49717296	53270
chr22	49664089	49864089	harbor1	chr22	49717142	49717449	DNA/TcMar-Tigger	859	-	154	49717296	53207
chr22	38768951	38968951	harbor1	chr22	38790645	38790885	DNA/TcMar-Tigger	7214	-	120	38790765	21814
chr22	38768951	38968951	harbor1	chr22	38791196	38791342	DNA/TcMar-Tigger	7214	-	73	38791269	22318
chr22	38768951	38968951	harbor1	chr22	38792005	38792269	DNA/TcMar-Tigger	7214	-	132	38792137	23186
chr22	38768951	38968951	harbor1	chr22	38792584	38793151	DNA/TcMar-Tigger	7214	-	284	38792868	23917
chr22	19804136	20004136	harbor1	chr22	19839339	19839461	DNA/TcMar-Tigger	706	-	61	19839400	35264
chr22	19804136	20004136	harbor1	chr22	19840078	19840215	DNA/TcMar-Tigger	748	-	68	19840146	36010
chr22	42989515	43189515	harbor1	chr22	43062141	43062210	DNA/TcMar-Tigger	1653	-	34	43062175	72660
chr22	42989515	43189515	harbor1	chr22	43062521	43062548	DNA/TcMar-Tigger	1653	-	14	43062535	73020
chr22	42989515	43189515	harbor1	chr22	43062842	43063127	DNA/TcMar-Tigger	1653	-	142	43062984	73469
chr22	23366695	23566695	harbor1	chr22	23442973	23443324	DNA/TcMar-Tigger	7482	-	176	23443149	76454
chr22	23366695	23566695	harbor1	chr22	23443635	23444521	DNA/TcMar-Tigger	7482	-	443	23444078	77383
chr22	23366695	23566695	harbor1	chr22	23444534	23445160	DNA/TcMar-Tigger	3384	-	313	23444847	78152
chr22	42989521	43189521	harbor1	chr22	43062141	43062210	DNA/TcMar-Tigger	1653	-	34	43062175	72654
chr22	42989521	43189521	harbor1	chr22	43062521	43062548	DNA/TcMar-Tigger	1653	-	14	43062535	73014
chr22	42989521	43189521	harbor1	chr22	43062842	43063127	DNA/TcMar-Tigger	1653	-	142	43062984	73463
chr22	30847282	31047282	harbor1	chr22	30888763	30889043	DNA/TcMar-Tigger	1617	-	140	30888903	41621
chr22	30847282	31047282	harbor1	chr22	30917173	30917619	DNA/TcMar-Tigger	2457	-	223	30917396	70114
chr22	24069894	24269894	harbor1	chr22	24111106	24111280	DNA/TcMar-Tigger	1695	-	87	24111193	41299
chr22	24069894	24269894	harbor1	chr22	24111614	24111805	DNA/TcMar-Tigger	1695	-	96	24111710	41816
chr22	24069894	24269894	harbor1	chr22	24122283	24122425	DNA/TcMar-Tigger	1191	-	71	24122354	52460
chr22	24069894	24269894	harbor1	chr22	24122735	24122824	DNA/TcMar-Tigger	1191	-	44	24122779	52885
chr22	36186442	36386442	harbor1	chr22	36196332	36196641	DNA/TcMar-Tigger	614	-	154	36196486	10044
chr22	42801583	43001583	harbor1	chr22	42822575	42822803	DNA/TcMar-Tigger	1172	-	114	42822689	21106
chr22	42801583	43001583	harbor1	chr22	42823110	42823194	DNA/TcMar-Tigger	1172	-	42	42823152	21569
chr22	24007199	24207199	harbor1	chr22	24027963	24028182	DNA/TcMar-Tigger	1479	-	110	24028073	20874
chr22	24007199	24207199	harbor1	chr22	24028172	24028327	DNA/TcMar-Tigger	741	-	78	24028250	21051
chr22	46292061	46492061	harbor1	chr22	46383918	46383960	DNA/TcMar-Tigger	576	-	21	46383939	91878
chr22	46292061	46492061	harbor1	chr22	46384236	46384363	DNA/TcMar-Tigger	576	-	64	46384300	92239
chr22	18930100	19130100	harbor1	chr22	18999750	19000000	DNA/TcMar-Tigger	1468	-	125	18999875	69775
chr22	18930100	19130100	harbor1	chr22	19000006	19001125	DNA/TcMar-Tigger	7154	-	560	19000566	70466
chr22	23366710	23566710	harbor1	chr22	23442973	23443324	DNA/TcMar-Tigger	7482	-	176	23443149	76439
chr22	23366710	23566710	harbor1	chr22	23443635	23444521	DNA/TcMar-Tigger	7482	-	443	23444078	77368
chr22	23366710	23566710	harbor1	chr22	23444534	23445160	DNA/TcMar-Tigger	3384	-	313	23444847	78137
chr22	42204285	42404285	harbor1	chr22	42239135	42239194	DNA/TcMar-Tigger	14359	-	30	42239165	34880
chr22	42204285	42404285	harbor1	chr22	42239492	42239505	DNA/TcMar-Tigger	14359	-	6	42239498	35213
chr22	42204285	42404285	harbor1	chr22	42239821	42240017	DNA/TcMar-Tigger	14359	-	98	42239919	35634
chr22	42204285	42404285	harbor1	chr22	42236720	42238835	DNA/TcMar-Tigger	14359	-	1058	42237778	33493
chr22	24069914	24269914	harbor1	chr22	24111106	24111280	DNA/TcMar-Tigger	1695	-	87	24111193	41279
chr22	24069914	24269914	harbor1	chr22	24111614	24111805	DNA/TcMar-Tigger	1695	-	96	24111710	41796
chr22	24069914	24269914	harbor1	chr22	24122283	24122425	DNA/TcMar-Tigger	1191	-	71	24122354	52440
chr22	24069914	24269914	harbor1	chr22	24122735	24122824	DNA/TcMar-Tigger	1191	-	44	24122779	52865
chr22	45313205	45513205	harbor1	chr22	45338606	45338826	DNA/TcMar-Tigger	453	-	110	45338716	25511
chr22	45313205	45513205	harbor1	chr22	45358809	45359131	DNA/TcMar-Tigger	1595	-	161	45358970	45765
chr22	24069997	24269997	harbor1	chr22	24111106	24111280	DNA/TcMar-Tigger	1695	-	87	24111193	41196
chr22	24069997	24269997	harbor1	chr22	24111614	24111805	DNA/TcMar-Tigger	1695	-	96	24111710	41713
chr22	24069997	24269997	harbor1	chr22	24122283	24122425	DNA/TcMar-Tigger	1191	-	71	24122354	52357
chr22	24069997	24269997	harbor1	chr22	24122735	24122824	DNA/TcMar-Tigger	1191	-	44	24122779	52782
chr22	43471950	43671950	harbor1	chr22	43567200	43567454	DNA/TcMar-Tigger	882	-	127	43567327	95377
chr22	36918777	37118777	harbor1	chr22	36944337	36945446	DNA/TcMar-Tigger	13257	-	554	36944891	26114
chr22	36918777	37118777	harbor1	chr22	36946110	36947138	DNA/TcMar-Tigger	13257	-	514	36946624	27847
chr22	36918777	37118777	harbor1	chr22	36947746	36947889	DNA/TcMar-Tigger	13257	-	72	36947818	29041
chr22	36918807	37118807	harbor1	chr22	36944337	36945446	DNA/TcMar-Tigger	13257	-	554	36944891	26084
chr22	36918807	37118807	harbor1	chr22	36946110	36947138	DNA/TcMar-Tigger	13257	-	514	36946624	27817
chr22	36918807	37118807	harbor1	chr22	36947746	36947889	DNA/TcMar-Tigger	13257	-	72	36947818	29011
chr22	24062659	24262659	harbor1	chr22	24111106	24111280	DNA/TcMar-Tigger	1695	-	87	24111193	48534
chr22	24062659	24262659	harbor1	chr22	24111614	24111805	DNA/TcMar-Tigger	1695	-	96	24111710	49051
chr22	24062659	24262659	harbor1	chr22	24122283	24122425	DNA/TcMar-Tigger	1191	-	71	24122354	59695
chr22	24062659	24262659	harbor1	chr22	24122735	24122824	DNA/TcMar-Tigger	1191	-	44	24122779	60120
chr22	42784441	42984441	harbor1	chr22	42822575	42822803	DNA/TcMar-Tigger	1172	-	114	42822689	38248
chr22	42784441	42984441	harbor1	chr22	42823110	42823194	DNA/TcMar-Tigger	1172	-	42	42823152	38711
chr22	36186432	36386432	harbor1	chr22	36196332	36196641	DNA/TcMar-Tigger	614	-	154	36196486	10054
chr22	32529769	32729769	harbor1	chr22	32586191	32586800	DNA/TcMar-Tigger	3348	-	304	32586495	56726
chr22	24017128	24217128	harbor1	chr22	24027963	24028182	DNA/TcMar-Tigger	1479	-	110	24028073	10945
chr22	24017128	24217128	harbor1	chr22	24028172	24028327	DNA/TcMar-Tigger	741	-	78	24028250	11122
chr22	24017128	24217128	harbor1	chr22	24111106	24111280	DNA/TcMar-Tigger	1695	-	87	24111193	94065
chr22	24017128	24217128	harbor1	chr22	24111614	24111805	DNA/TcMar-Tigger	1695	-	96	24111710	94582
chr22	36186441	36386441	harbor1	chr22	36196332	36196641	DNA/TcMar-Tigger	614	-	154	36196486	10045
chr22	36186368	36386368	harbor1	chr22	36196332	36196641	DNA/TcMar-Tigger	614	-	154	36196486	10118
chr22	36186428	36386428	harbor1	chr22	36196332	36196641	DNA/TcMar-Tigger	614	-	154	36196486	10058
chrX	18253915	18453915	harbor1	chrX	18271715	18271856	DNA/TcMar-Tigger	901	-	70	18271785	17870
chrX	18253915	18453915	harbor1	chrX	18312267	18312613	DNA/TcMar-Tigger	1286	-	173	18312440	58525
chrX	130071758	130271758	harbor1	chrX	130092852	130093030	DNA/TcMar-Tigger	1053	-	89	130092941	21183
chrX	130071758	130271758	harbor1	chrX	130093323	130093378	DNA/TcMar-Tigger	1053	-	28	130093351	21593
chrX	130071758	130271758	harbor1	chrX	130158978	130159274	DNA/TcMar-Tigger	679	-	148	130159126	87368
chrX	72043976	72243976	harbor1	chrX	72100159	72100466	DNA/TcMar-Tigger	1856	-	154	72100313	56337
chrX	129832695	130032695	harbor1	chrX	129901690	129901824	DNA/TcMar-Tigger	1187	-	67	129901757	69062
chrX	129832695	130032695	harbor1	chrX	129902211	129902296	DNA/TcMar-Tigger	1187	-	42	129902253	69558
chrX	18253792	18453792	harbor1	chrX	18271715	18271856	DNA/TcMar-Tigger	901	-	70	18271785	17993
chrX	18253792	18453792	harbor1	chrX	18312267	18312613	DNA/TcMar-Tigger	1286	-	173	18312440	58648
chrX	109902871	110102871	harbor1	chrX	109908886	109909144	DNA/TcMar-Tigger	689	-	129	109909015	6144
chrX	109902871	110102871	harbor1	chrX	109914222	109914525	DNA/TcMar-Tigger	1282	-	152	109914374	11503
chrX	109902871	110102871	harbor1	chrX	109979677	109980218	DNA/TcMar-Tigger	1737	-	270	109979947	77076
chrX	37578419	37778419	harbor1	chrX	37579312	37579406	DNA/TcMar-Tigger	589	-	47	37579359	940
chrX	37578419	37778419	harbor1	chrX	37579409	37579671	DNA/TcMar-Tigger	1323	-	131	37579540	1121
chrX	37578419	37778419	harbor1	chrX	37662107	37662380	DNA/TcMar-Tigger	896	-	136	37662243	83824
chrX	72029896	72229896	harbor1	chrX	72100159	72100466	DNA/TcMar-Tigger	1856	-	154	72100313	70417
chrX	49064231	49264231	harbor1	chrX	49118312	49118456	DNA/TcMar-Tigger	708	-	72	49118384	54153
chrX	49064231	49264231	harbor1	chrX	49118767	49118866	DNA/TcMar-Tigger	708	-	50	49118817	54586
chrX	19445154	19645154	harbor1	chrX	19454757	19454976	DNA/TcMar-Tigger	1365	-	110	19454867	9713
chrX	48792105	48992105	harbor1	chrX	48809331	48809522	DNA/TcMar-Tigger	1531	-	96	48809427	17322
chrX	48792105	48992105	harbor1	chrX	48809816	48809873	DNA/TcMar-Tigger	1531	-	28	48809844	17739
