H_chr	H_start	H_end	Harbor	TE_chr	TE_start	TE_end	TE	score	TE_strand	TE_half	TE_middle_pos	TE_dis
chr1	6394942	6594942	harbor1	chr1	6452550	6452712	DNA/hAT-Charlie	639	-	81	6452631	57689
chr1	6394942	6594942	harbor1	chr1	6457680	6457889	DNA/hAT-Charlie	1213	-	104	6457784	62842
chr1	6394942	6594942	harbor1	chr1	6459420	6459541	DNA/hAT-Charlie	1213	-	60	6459480	64538
chr1	6394942	6594942	harbor1	chr1	6468702	6468890	DNA/hAT-Charlie	473	-	94	6468796	73854
chr1	26400749	26600749	harbor1	chr1	26414678	26414888	DNA/hAT-Charlie	1110	-	105	26414783	14034
chr1	16423038	16623038	harbor1	chr1	16445281	16445501	DNA/hAT-Charlie	1097	-	110	16445391	22353
chr1	16423038	16623038	harbor1	chr1	16456713	16456728	DNA/hAT-Charlie	927	-	8	16456721	33683
chr1	16423038	16623038	harbor1	chr1	16457002	16457166	DNA/hAT-Charlie	927	-	82	16457084	34046
chr1	16423038	16623038	harbor1	chr1	16516738	16517077	DNA/hAT-Charlie	1936	-	170	16516908	93870
chr1	6046640	6246640	harbor1	chr1	6061494	6061676	DNA/hAT-Charlie	761	-	91	6061585	14945
chr1	6046640	6246640	harbor1	chr1	6114388	6114659	DNA/hAT-Charlie	1226	-	136	6114524	67884
chr1	16507813	16707813	harbor1	chr1	16516738	16517077	DNA/hAT-Charlie	1936	-	170	16516908	9095
chr1	227441506	227641506	harbor1	chr1	227513867	227514232	DNA/hAT-Charlie	2696	-	182	227514049	72543
chr1	108941871	109141871	harbor1	chr1	108952954	108953113	DNA/hAT-Charlie	990	-	80	108953034	11163
chr1	108941871	109141871	harbor1	chr1	108961271	108961392	DNA/hAT-Charlie	483	-	60	108961331	19460
chr1	108941871	109141871	harbor1	chr1	108963593	108963725	DNA/hAT-Charlie	445	-	66	108963659	21788
chr1	178438257	178638257	harbor1	chr1	178440376	178440535	DNA/hAT-Charlie	696	-	80	178440456	2199
chr1	178438257	178638257	harbor1	chr1	178446400	178446640	DNA/hAT-Charlie	887	-	120	178446520	8263
chr1	16544872	16744872	harbor1	chr1	16643865	16644061	DNA/hAT-Charlie	1037	-	98	16643963	99091
chr1	211033794	211233794	harbor1	chr1	211046909	211047228	DNA/hAT-Charlie	1243	-	160	211047069	13275
chr1	211033794	211233794	harbor1	chr1	211094077	211094404	DNA/hAT-Charlie	2338	-	164	211094241	60447
chr1	6294371	6494371	harbor1	chr1	6317155	6317441	DNA/hAT-Charlie	589	-	143	6317298	22927
chr1	33156095	33356095	harbor1	chr1	33169669	33169856	DNA/hAT-Charlie	921	-	94	33169763	13668
chr1	109183430	109383430	harbor1	chr1	109190912	109191072	DNA/hAT-Charlie	826	-	80	109190992	7562
chr1	109183430	109383430	harbor1	chr1	109218389	109218560	DNA/hAT-Charlie	474	-	86	109218475	35045
chr1	15661997	15861997	harbor1	chr1	15690399	15690572	DNA/hAT-Charlie	761	-	86	15690485	28488
chr1	15661997	15861997	harbor1	chr1	15707430	15707537	DNA/hAT-Charlie	503	-	54	15707484	45487
chr1	717645	917645	harbor1	chr1	729816	730235	DNA/hAT-Charlie	2306	-	210	730026	12381
chr1	717645	917645	harbor1	chr1	733225	733644	DNA/hAT-Charlie	2375	-	210	733435	15790
chr1	717645	917645	harbor1	chr1	736631	737050	DNA/hAT-Charlie	2322	-	210	736841	19196
chr1	717645	917645	harbor1	chr1	740047	740466	DNA/hAT-Charlie	2330	-	210	740257	22612
chr1	717645	917645	harbor1	chr1	743783	744214	DNA/hAT-Charlie	2775	-	216	743999	26354
chr1	717645	917645	harbor1	chr1	782312	782501	DNA/hAT-Charlie	870	-	94	782406	64761
chr1	717645	917645	harbor1	chr1	782641	782795	DNA/hAT-Charlie	620	-	77	782718	65073
chr1	16544914	16744914	harbor1	chr1	16643865	16644061	DNA/hAT-Charlie	1037	-	98	16643963	99049
chr1	47316941	47516941	harbor1	chr1	47345273	47345492	DNA/hAT-Charlie	1295	-	110	47345383	28442
chr1	47316941	47516941	harbor1	chr1	47346360	47346468	DNA/hAT-Charlie	1295	-	54	47346414	29473
chr1	47316941	47516941	harbor1	chr1	47347223	47347238	DNA/hAT-Charlie	667	-	8	47347231	30290
chr1	47316941	47516941	harbor1	chr1	47347509	47347622	DNA/hAT-Charlie	667	-	56	47347565	30624
chr1	47316941	47516941	harbor1	chr1	47347931	47348039	DNA/hAT-Charlie	667	-	54	47347985	31044
chr1	47316941	47516941	harbor1	chr1	47408955	47409181	DNA/hAT-Charlie	768	-	113	47409068	92127
chr1	16544773	16744773	harbor1	chr1	16643865	16644061	DNA/hAT-Charlie	1037	-	98	16643963	99190
chr1	16504018	16704018	harbor1	chr1	16516738	16517077	DNA/hAT-Charlie	1936	-	170	16516908	12890
chr1	226479130	226679130	harbor1	chr1	226555827	226556093	DNA/hAT-Charlie	1253	-	133	226555960	76830
chr1	226479130	226679130	harbor1	chr1	226570766	226570948	DNA/hAT-Charlie	1581	-	91	226570857	91727
chr1	226479130	226679130	harbor1	chr1	226571277	226571584	DNA/hAT-Charlie	1581	-	154	226571431	92301
chr1	211033705	211233705	harbor1	chr1	211046909	211047228	DNA/hAT-Charlie	1243	-	160	211047069	13364
chr1	211033705	211233705	harbor1	chr1	211094077	211094404	DNA/hAT-Charlie	2338	-	164	211094241	60536
chr1	16513040	16713040	harbor1	chr1	16516738	16517077	DNA/hAT-Charlie	1936	-	170	16516908	3868
chr1	47316928	47516928	harbor1	chr1	47345273	47345492	DNA/hAT-Charlie	1295	-	110	47345383	28455
chr1	47316928	47516928	harbor1	chr1	47346360	47346468	DNA/hAT-Charlie	1295	-	54	47346414	29486
chr1	47316928	47516928	harbor1	chr1	47347223	47347238	DNA/hAT-Charlie	667	-	8	47347231	30303
chr1	47316928	47516928	harbor1	chr1	47347509	47347622	DNA/hAT-Charlie	667	-	56	47347565	30637
chr1	47316928	47516928	harbor1	chr1	47347931	47348039	DNA/hAT-Charlie	667	-	54	47347985	31057
chr1	47316928	47516928	harbor1	chr1	47408955	47409181	DNA/hAT-Charlie	768	-	113	47409068	92140
chr1	3431314	3631314	harbor1	chr1	3439060	3439577	DNA/hAT-Charlie	3364	-	258	3439318	8004
chr1	13662912	13862912	harbor1	chr1	13671457	13671813	DNA/hAT-Charlie	1000	-	178	13671635	8723
chr1	13662912	13862912	harbor1	chr1	13690803	13690953	DNA/hAT-Charlie	682	-	75	13690878	27966
chr1	13662912	13862912	harbor1	chr1	13691253	13691291	DNA/hAT-Charlie	682	-	19	13691272	28360
chr1	13662912	13862912	harbor1	chr1	13692795	13693416	DNA/hAT-Charlie	3567	-	310	13693105	30193
chr1	13662912	13862912	harbor1	chr1	13703195	13703376	DNA/hAT-Charlie	940	-	90	13703285	40373
chr1	13662912	13862912	harbor1	chr1	13725633	13725834	DNA/hAT-Charlie	872	-	100	13725733	62821
chr1	13662912	13862912	harbor1	chr1	13664175	13664404	DNA/hAT-Charlie	1109	-	114	13664289	1377
chr1	16544793	16744793	harbor1	chr1	16643865	16644061	DNA/hAT-Charlie	1037	-	98	16643963	99170
chr1	211033814	211233814	harbor1	chr1	211046909	211047228	DNA/hAT-Charlie	1243	-	160	211047069	13255
chr1	211033814	211233814	harbor1	chr1	211094077	211094404	DNA/hAT-Charlie	2338	-	164	211094241	60427
chr1	16544707	16744707	harbor1	chr1	16643865	16644061	DNA/hAT-Charlie	1037	-	98	16643963	99256
chr1	6684326	6884326	harbor1	chr1	6697325	6697691	DNA/hAT-Charlie	1838	-	183	6697508	13182
chr1	6684326	6884326	harbor1	chr1	6718433	6718644	DNA/hAT-Charlie	1094	-	106	6718539	34213
chr1	6684326	6884326	harbor1	chr1	6762110	6762179	DNA/hAT-Charlie	460	-	34	6762144	77818
chr1	6684326	6884326	harbor1	chr1	6768105	6768271	DNA/hAT-Charlie	458	-	83	6768188	83862
chr1	6684326	6884326	harbor1	chr1	6781775	6782040	DNA/hAT-Charlie	1099	-	132	6781907	97581
chr1	6684326	6884326	harbor1	chr1	6782325	6782408	DNA/hAT-Charlie	1099	-	42	6782367	98041
chr1	16625283	16825283	harbor1	chr1	16643865	16644061	DNA/hAT-Charlie	1037	-	98	16643963	18680
chr1	16625283	16825283	harbor1	chr1	16650295	16650563	DNA/hAT-Charlie	1054	-	134	16650429	25146
chr1	16625283	16825283	harbor1	chr1	16653377	16653554	DNA/hAT-Charlie	954	-	88	16653465	28182
chr1	16625283	16825283	harbor1	chr1	16669402	16669589	DNA/hAT-Charlie	835	-	94	16669496	44213
chr1	16625283	16825283	harbor1	chr1	16687134	16687256	DNA/hAT-Charlie	554	-	61	16687195	61912
chr1	16625207	16825207	harbor1	chr1	16643865	16644061	DNA/hAT-Charlie	1037	-	98	16643963	18756
chr1	16625207	16825207	harbor1	chr1	16650295	16650563	DNA/hAT-Charlie	1054	-	134	16650429	25222
chr1	16625207	16825207	harbor1	chr1	16653377	16653554	DNA/hAT-Charlie	954	-	88	16653465	28258
chr1	16625207	16825207	harbor1	chr1	16669402	16669589	DNA/hAT-Charlie	835	-	94	16669496	44289
chr1	16625207	16825207	harbor1	chr1	16687134	16687256	DNA/hAT-Charlie	554	-	61	16687195	61988
chr1	17288486	17488486	harbor1	chr1	17317675	17317739	DNA/hAT-Charlie	1128	-	32	17317707	29221
chr1	17288486	17488486	harbor1	chr1	17318034	17318167	DNA/hAT-Charlie	1128	-	66	17318100	29614
chr1	17288486	17488486	harbor1	chr1	17350258	17350540	DNA/hAT-Charlie	784	-	141	17350399	61913
chr1	3246650	3446650	harbor1	chr1	3328243	3328365	DNA/hAT-Charlie	497	-	61	3328304	81654
chr1	16508264	16708264	harbor1	chr1	16516738	16517077	DNA/hAT-Charlie	1936	-	170	16516908	8644
chr1	16493369	16693369	harbor1	chr1	16516738	16517077	DNA/hAT-Charlie	1936	-	170	16516908	23539
chr1	21742070	21942070	harbor1	chr1	21794540	21794764	DNA/hAT-Charlie	969	-	112	21794652	52582
chr1	2420324	2620324	harbor1	chr1	2421645	2421691	DNA/hAT-Charlie	1985	-	23	2421668	1344
chr1	2420324	2620324	harbor1	chr1	2422293	2422675	DNA/hAT-Charlie	1985	-	191	2422484	2160
chr1	2420324	2620324	harbor1	chr1	2422842	2423137	DNA/hAT-Charlie	1985	-	148	2422990	2666
chr1	16545030	16745030	harbor1	chr1	16643865	16644061	DNA/hAT-Charlie	1037	-	98	16643963	98933
chr1	205330408	205530408	harbor1	chr1	205365761	205365884	DNA/hAT-Charlie	624	-	62	205365823	35415
chr1	205330408	205530408	harbor1	chr1	205378396	205378491	DNA/hAT-Charlie	534	-	48	205378444	48036
chr1	2375351	2575351	harbor1	chr1	2421645	2421691	DNA/hAT-Charlie	1985	-	23	2421668	46317
chr1	2375351	2575351	harbor1	chr1	2422293	2422675	DNA/hAT-Charlie	1985	-	191	2422484	47133
chr1	2375351	2575351	harbor1	chr1	2422842	2423137	DNA/hAT-Charlie	1985	-	148	2422990	47639
chr1	16544735	16744735	harbor1	chr1	16643865	16644061	DNA/hAT-Charlie	1037	-	98	16643963	99228
chr1	2375340	2575340	harbor1	chr1	2421645	2421691	DNA/hAT-Charlie	1985	-	23	2421668	46328
chr1	2375340	2575340	harbor1	chr1	2422293	2422675	DNA/hAT-Charlie	1985	-	191	2422484	47144
chr1	2375340	2575340	harbor1	chr1	2422842	2423137	DNA/hAT-Charlie	1985	-	148	2422990	47650
chr1	1	128757	harbor1	chr1	46893	47092	DNA/hAT-Charlie	875	-	100	46993	46992
chr1	39855348	40055348	harbor1	chr1	39856950	39857114	DNA/hAT-Charlie	886	-	82	39857032	1684
chr1	39855348	40055348	harbor1	chr1	39874209	39874416	DNA/hAT-Charlie	1089	-	104	39874313	18965
chr1	2138120	2338120	harbor1	chr1	2165539	2165716	DNA/hAT-Charlie	635	-	88	2165627	27507
chr1	2138120	2338120	harbor1	chr1	2168119	2168297	DNA/hAT-Charlie	732	-	89	2168208	30088
chr1	15323291	15523291	harbor1	chr1	15340732	15340902	DNA/hAT-Charlie	976	-	85	15340817	17526
chr1	15323291	15523291	harbor1	chr1	15341206	15341274	DNA/hAT-Charlie	976	-	34	15341240	17949
chr1	15323291	15523291	harbor1	chr1	15342339	15342482	DNA/hAT-Charlie	627	-	72	15342411	19120
chr1	15323291	15523291	harbor1	chr1	15344432	15344618	DNA/hAT-Charlie	777	-	93	15344525	21234
chr1	15323291	15523291	harbor1	chr1	15358364	15358553	DNA/hAT-Charlie	971	-	94	15358458	35167
chr1	15323291	15523291	harbor1	chr1	15361239	15361450	DNA/hAT-Charlie	954	-	106	15361345	38054
chr1	15323291	15523291	harbor1	chr1	15374708	15374848	DNA/hAT-Charlie	630	-	70	15374778	51487
chr1	15323291	15523291	harbor1	chr1	15375156	15375237	DNA/hAT-Charlie	630	-	40	15375196	51905
chr1	15323291	15523291	harbor1	chr1	15380220	15380434	DNA/hAT-Charlie	803	-	107	15380327	57036
chr1	15323291	15523291	harbor1	chr1	15402844	15403028	DNA/hAT-Charlie	678	-	92	15402936	79645
chr1	15323291	15523291	harbor1	chr1	15408864	15409025	DNA/hAT-Charlie	483	-	80	15408944	85653
chr1	15323291	15523291	harbor1	chr1	15422037	15422085	DNA/hAT-Charlie	767	-	24	15422061	98770
chr1	15323291	15523291	harbor1	chr1	15422390	15422566	DNA/hAT-Charlie	767	-	88	15422478	99187
chr1	755937	955937	harbor1	chr1	782312	782501	DNA/hAT-Charlie	870	-	94	782406	26469
chr1	755937	955937	harbor1	chr1	782641	782795	DNA/hAT-Charlie	620	-	77	782718	26781
chr1	755937	955937	harbor1	chr1	837340	837504	DNA/hAT-Charlie	756	-	82	837422	81485
chr1	755937	955937	harbor1	chr1	853264	853435	DNA/hAT-Charlie	487	-	86	853350	97413
chr1	29137918	29337918	harbor1	chr1	29192901	29192946	DNA/hAT-Charlie	948	-	22	29192923	55005
chr1	29137918	29337918	harbor1	chr1	29193245	29193424	DNA/hAT-Charlie	948	-	90	29193335	55417
chr1	29137918	29337918	harbor1	chr1	29197948	29198284	DNA/hAT-Charlie	2344	-	168	29198116	60198
chr1	29137918	29337918	harbor1	chr1	29209110	29209339	DNA/hAT-Charlie	621	-	114	29209224	71306
chr1	29137918	29337918	harbor1	chr1	29218311	29218571	DNA/hAT-Charlie	543	-	130	29218441	80523
chr1	29137918	29337918	harbor1	chr1	29222407	29222550	DNA/hAT-Charlie	522	-	72	29222479	84561
chr1	2138503	2338503	harbor1	chr1	2165539	2165716	DNA/hAT-Charlie	635	-	88	2165627	27124
chr1	2138503	2338503	harbor1	chr1	2168119	2168297	DNA/hAT-Charlie	732	-	89	2168208	29705
chr1	16544757	16744757	harbor1	chr1	16643865	16644061	DNA/hAT-Charlie	1037	-	98	16643963	99206
chr1	28799072	28999072	harbor1	chr1	28836860	28837361	DNA/hAT-Charlie	3323	-	250	28837110	38038
chr1	87225746	87425746	harbor1	chr1	87289137	87289332	DNA/hAT-Charlie	949	-	98	87289235	63489
chr1	87225746	87425746	harbor1	chr1	87308501	87308666	DNA/hAT-Charlie	454	-	82	87308583	82837
chr1	87225746	87425746	harbor1	chr1	87317129	87317164	DNA/hAT-Charlie	1226	-	18	87317147	91401
chr1	87225746	87425746	harbor1	chr1	87317462	87317649	DNA/hAT-Charlie	1226	-	94	87317556	91810
chr1	211033766	211233766	harbor1	chr1	211046909	211047228	DNA/hAT-Charlie	1243	-	160	211047069	13303
chr1	211033766	211233766	harbor1	chr1	211094077	211094404	DNA/hAT-Charlie	2338	-	164	211094241	60475
chr1	16544790	16744790	harbor1	chr1	16643865	16644061	DNA/hAT-Charlie	1037	-	98	16643963	99173
chr1	11498163	11698163	harbor1	chr1	11514114	11514280	DNA/hAT-Charlie	808	-	83	11514197	16034
chr1	154985127	155185127	harbor1	chr1	154990761	154990827	DNA/hAT-Charlie	496	-	33	154990794	5667
chr1	154985127	155185127	harbor1	chr1	154990904	154990929	DNA/hAT-Charlie	496	-	12	154990916	5789
chr1	154985127	155185127	harbor1	chr1	154991257	154991272	DNA/hAT-Charlie	496	-	8	154991265	6138
chr1	154985127	155185127	harbor1	chr1	154991572	154991662	DNA/hAT-Charlie	496	-	45	154991617	6490
chr1	2420521	2620521	harbor1	chr1	2421645	2421691	DNA/hAT-Charlie	1985	-	23	2421668	1147
chr1	2420521	2620521	harbor1	chr1	2422293	2422675	DNA/hAT-Charlie	1985	-	191	2422484	1963
chr1	2420521	2620521	harbor1	chr1	2422842	2423137	DNA/hAT-Charlie	1985	-	148	2422990	2469
chr1	26400777	26600777	harbor1	chr1	26414678	26414888	DNA/hAT-Charlie	1110	-	105	26414783	14006
chr1	51230780	51430780	harbor1	chr1	51281765	51281886	DNA/hAT-Charlie	526	-	60	51281825	51045
chr1	51230780	51430780	harbor1	chr1	51286855	51287094	DNA/hAT-Charlie	669	-	120	51286975	56195
chr1	51230780	51430780	harbor1	chr1	51301128	51301339	DNA/hAT-Charlie	986	-	106	51301234	70454
chr1	51230780	51430780	harbor1	chr1	51306349	51306571	DNA/hAT-Charlie	1186	-	111	51306460	75680
chr1	16544788	16744788	harbor1	chr1	16643865	16644061	DNA/hAT-Charlie	1037	-	98	16643963	99175
chr1	2420836	2620836	harbor1	chr1	2421645	2421691	DNA/hAT-Charlie	1985	-	23	2421668	832
chr1	2420836	2620836	harbor1	chr1	2422293	2422675	DNA/hAT-Charlie	1985	-	191	2422484	1648
chr1	2420836	2620836	harbor1	chr1	2422842	2423137	DNA/hAT-Charlie	1985	-	148	2422990	2154
chr1	244605801	244805801	harbor1	chr1	244611879	244612050	DNA/hAT-Charlie	817	-	86	244611965	6164
chr1	244605801	244805801	harbor1	chr1	244681425	244681600	DNA/hAT-Charlie	1151	-	88	244681513	75712
chr1	244605801	244805801	harbor1	chr1	244682602	244682799	DNA/hAT-Charlie	926	-	98	244682700	76899
chr1	244605801	244805801	harbor1	chr1	244702549	244702719	DNA/hAT-Charlie	677	-	85	244702634	96833
chr1	6685401	6885401	harbor1	chr1	6697325	6697691	DNA/hAT-Charlie	1838	-	183	6697508	12107
chr1	6685401	6885401	harbor1	chr1	6718433	6718644	DNA/hAT-Charlie	1094	-	106	6718539	33138
chr1	6685401	6885401	harbor1	chr1	6762110	6762179	DNA/hAT-Charlie	460	-	34	6762144	76743
chr1	6685401	6885401	harbor1	chr1	6768105	6768271	DNA/hAT-Charlie	458	-	83	6768188	82787
chr1	6685401	6885401	harbor1	chr1	6781775	6782040	DNA/hAT-Charlie	1099	-	132	6781907	96506
chr1	6685401	6885401	harbor1	chr1	6782325	6782408	DNA/hAT-Charlie	1099	-	42	6782367	96966
chr1	16544777	16744777	harbor1	chr1	16643865	16644061	DNA/hAT-Charlie	1037	-	98	16643963	99186
chr1	3431205	3631205	harbor1	chr1	3439060	3439577	DNA/hAT-Charlie	3364	-	258	3439318	8113
chr1	39855400	40055400	harbor1	chr1	39856950	39857114	DNA/hAT-Charlie	886	-	82	39857032	1632
chr1	39855400	40055400	harbor1	chr1	39874209	39874416	DNA/hAT-Charlie	1089	-	104	39874313	18913
chr1	2420325	2620325	harbor1	chr1	2421645	2421691	DNA/hAT-Charlie	1985	-	23	2421668	1343
chr1	2420325	2620325	harbor1	chr1	2422293	2422675	DNA/hAT-Charlie	1985	-	191	2422484	2159
chr1	2420325	2620325	harbor1	chr1	2422842	2423137	DNA/hAT-Charlie	1985	-	148	2422990	2665
chr1	226638244	226838244	harbor1	chr1	226682097	226682276	DNA/hAT-Charlie	611	-	90	226682187	43943
chr1	226638244	226838244	harbor1	chr1	226693488	226693712	DNA/hAT-Charlie	604	-	112	226693600	55356
chr1	226638244	226838244	harbor1	chr1	226694628	226694834	DNA/hAT-Charlie	1135	-	103	226694731	56487
chr1	16624842	16824842	harbor1	chr1	16643865	16644061	DNA/hAT-Charlie	1037	-	98	16643963	19121
chr1	16624842	16824842	harbor1	chr1	16650295	16650563	DNA/hAT-Charlie	1054	-	134	16650429	25587
chr1	16624842	16824842	harbor1	chr1	16653377	16653554	DNA/hAT-Charlie	954	-	88	16653465	28623
chr1	16624842	16824842	harbor1	chr1	16669402	16669589	DNA/hAT-Charlie	835	-	94	16669496	44654
chr1	16624842	16824842	harbor1	chr1	16687134	16687256	DNA/hAT-Charlie	554	-	61	16687195	62353
chr1	16625292	16825292	harbor1	chr1	16643865	16644061	DNA/hAT-Charlie	1037	-	98	16643963	18671
chr1	16625292	16825292	harbor1	chr1	16650295	16650563	DNA/hAT-Charlie	1054	-	134	16650429	25137
chr1	16625292	16825292	harbor1	chr1	16653377	16653554	DNA/hAT-Charlie	954	-	88	16653465	28173
chr1	16625292	16825292	harbor1	chr1	16669402	16669589	DNA/hAT-Charlie	835	-	94	16669496	44204
chr1	16625292	16825292	harbor1	chr1	16687134	16687256	DNA/hAT-Charlie	554	-	61	16687195	61903
chr1	54939721	55139721	harbor1	chr1	54967952	54968146	DNA/hAT-Charlie	1300	-	97	54968049	28328
chr1	54939721	55139721	harbor1	chr1	54968442	54968567	DNA/hAT-Charlie	1300	-	62	54968504	28783
chr1	54939721	55139721	harbor1	chr1	54976363	54976562	DNA/hAT-Charlie	1153	-	100	54976463	36742
chr1	54939721	55139721	harbor1	chr1	54976866	54976983	DNA/hAT-Charlie	1153	-	58	54976924	37203
chr1	54939721	55139721	harbor1	chr1	54987359	54987531	DNA/hAT-Charlie	548	-	86	54987445	47724
chr1	15213281	15413281	harbor1	chr1	15229966	15230199	DNA/hAT-Charlie	868	-	116	15230082	16801
chr1	15213281	15413281	harbor1	chr1	15294332	15294403	DNA/hAT-Charlie	1046	-	36	15294368	81087
chr1	15213281	15413281	harbor1	chr1	15294693	15294842	DNA/hAT-Charlie	1046	-	74	15294767	81486
chr1	15213281	15413281	harbor1	chr1	15295766	15295951	DNA/hAT-Charlie	770	-	92	15295858	82577
chr1	15213189	15413189	harbor1	chr1	15229966	15230199	DNA/hAT-Charlie	868	-	116	15230082	16893
chr1	15213189	15413189	harbor1	chr1	15294332	15294403	DNA/hAT-Charlie	1046	-	36	15294368	81179
chr1	15213189	15413189	harbor1	chr1	15294693	15294842	DNA/hAT-Charlie	1046	-	74	15294767	81578
chr1	15213189	15413189	harbor1	chr1	15295766	15295951	DNA/hAT-Charlie	770	-	92	15295858	82669
chr1	10110200	10310200	harbor1	chr1	10128470	10128623	DNA/hAT-Charlie	652	-	76	10128546	18346
chr1	15643080	15843080	harbor1	chr1	15690399	15690572	DNA/hAT-Charlie	761	-	86	15690485	47405
chr1	15643080	15843080	harbor1	chr1	15707430	15707537	DNA/hAT-Charlie	503	-	54	15707484	64404
chr1	205329486	205529486	harbor1	chr1	205365761	205365884	DNA/hAT-Charlie	624	-	62	205365823	36337
chr1	205329486	205529486	harbor1	chr1	205378396	205378491	DNA/hAT-Charlie	534	-	48	205378444	48958
chr1	16625346	16825346	harbor1	chr1	16643865	16644061	DNA/hAT-Charlie	1037	-	98	16643963	18617
chr1	16625346	16825346	harbor1	chr1	16650295	16650563	DNA/hAT-Charlie	1054	-	134	16650429	25083
chr1	16625346	16825346	harbor1	chr1	16653377	16653554	DNA/hAT-Charlie	954	-	88	16653465	28119
chr1	16625346	16825346	harbor1	chr1	16669402	16669589	DNA/hAT-Charlie	835	-	94	16669496	44150
chr1	16625346	16825346	harbor1	chr1	16687134	16687256	DNA/hAT-Charlie	554	-	61	16687195	61849
chr1	51230829	51430829	harbor1	chr1	51281765	51281886	DNA/hAT-Charlie	526	-	60	51281825	50996
chr1	51230829	51430829	harbor1	chr1	51286855	51287094	DNA/hAT-Charlie	669	-	120	51286975	56146
chr1	51230829	51430829	harbor1	chr1	51301128	51301339	DNA/hAT-Charlie	986	-	106	51301234	70405
chr1	51230829	51430829	harbor1	chr1	51306349	51306571	DNA/hAT-Charlie	1186	-	111	51306460	75631
chr1	11740558	11940558	harbor1	chr1	11781476	11781628	DNA/hAT-Charlie	447	-	76	11781552	40994
chr1	11740558	11940558	harbor1	chr1	11781932	11782034	DNA/hAT-Charlie	447	-	51	11781983	41425
chr1	11740558	11940558	harbor1	chr1	11798612	11798728	DNA/hAT-Charlie	527	-	58	11798670	58112
chr1	11740558	11940558	harbor1	chr1	11799042	11799183	DNA/hAT-Charlie	527	-	70	11799112	58554
chr1	11740558	11940558	harbor1	chr1	11824080	11824283	DNA/hAT-Charlie	492	-	102	11824182	83624
chr1	11740558	11940558	harbor1	chr1	11835075	11835188	DNA/hAT-Charlie	557	-	56	11835131	94573
chr1	4224540	4424540	harbor1	chr1	4266046	4266261	DNA/hAT-Charlie	755	-	108	4266154	41614
chr1	154870697	155070697	harbor1	chr1	154954303	154954440	DNA/hAT-Charlie	523	-	68	154954371	83674
chr1	2420670	2620670	harbor1	chr1	2421645	2421691	DNA/hAT-Charlie	1985	-	23	2421668	998
chr1	2420670	2620670	harbor1	chr1	2422293	2422675	DNA/hAT-Charlie	1985	-	191	2422484	1814
chr1	2420670	2620670	harbor1	chr1	2422842	2423137	DNA/hAT-Charlie	1985	-	148	2422990	2320
chr1	2375276	2575276	harbor1	chr1	2421645	2421691	DNA/hAT-Charlie	1985	-	23	2421668	46392
chr1	2375276	2575276	harbor1	chr1	2422293	2422675	DNA/hAT-Charlie	1985	-	191	2422484	47208
chr1	2375276	2575276	harbor1	chr1	2422842	2423137	DNA/hAT-Charlie	1985	-	148	2422990	47714
chr1	16544791	16744791	harbor1	chr1	16643865	16644061	DNA/hAT-Charlie	1037	-	98	16643963	99172
chr1	43447541	43647541	harbor1	chr1	43471470	43471623	DNA/hAT-Charlie	564	-	76	43471546	24005
chr1	43447541	43647541	harbor1	chr1	43471696	43471874	DNA/hAT-Charlie	1203	-	89	43471785	24244
chr1	43447541	43647541	harbor1	chr1	43503586	43503845	DNA/hAT-Charlie	943	-	130	43503716	56175
chr1	43447541	43647541	harbor1	chr1	43540060	43540277	DNA/hAT-Charlie	1177	-	108	43540168	92627
chr1	43447541	43647541	harbor1	chr1	43541504	43541705	DNA/hAT-Charlie	962	-	100	43541604	94063
chr1	726325	926325	harbor1	chr1	729816	730235	DNA/hAT-Charlie	2306	-	210	730026	3701
chr1	726325	926325	harbor1	chr1	733225	733644	DNA/hAT-Charlie	2375	-	210	733435	7110
chr1	726325	926325	harbor1	chr1	736631	737050	DNA/hAT-Charlie	2322	-	210	736841	10516
chr1	726325	926325	harbor1	chr1	740047	740466	DNA/hAT-Charlie	2330	-	210	740257	13932
chr1	726325	926325	harbor1	chr1	743783	744214	DNA/hAT-Charlie	2775	-	216	743999	17674
chr1	726325	926325	harbor1	chr1	782312	782501	DNA/hAT-Charlie	870	-	94	782406	56081
chr1	726325	926325	harbor1	chr1	782641	782795	DNA/hAT-Charlie	620	-	77	782718	56393
chr1	226637969	226837969	harbor1	chr1	226682097	226682276	DNA/hAT-Charlie	611	-	90	226682187	44218
chr1	226637969	226837969	harbor1	chr1	226693488	226693712	DNA/hAT-Charlie	604	-	112	226693600	55631
chr1	226637969	226837969	harbor1	chr1	226694628	226694834	DNA/hAT-Charlie	1135	-	103	226694731	56762
chr1	2375349	2575349	harbor1	chr1	2421645	2421691	DNA/hAT-Charlie	1985	-	23	2421668	46319
chr1	2375349	2575349	harbor1	chr1	2422293	2422675	DNA/hAT-Charlie	1985	-	191	2422484	47135
chr1	2375349	2575349	harbor1	chr1	2422842	2423137	DNA/hAT-Charlie	1985	-	148	2422990	47641
chr1	25518162	25718162	harbor1	chr1	25536656	25536872	DNA/hAT-Charlie	765	-	108	25536764	18602
chr1	25518162	25718162	harbor1	chr1	25593515	25593703	DNA/hAT-Charlie	675	-	94	25593609	75447
chr1	25518162	25718162	harbor1	chr1	25594099	25594218	DNA/hAT-Charlie	675	-	60	25594159	75997
chr1	25518162	25718162	harbor1	chr1	25610967	25611182	DNA/hAT-Charlie	1227	-	108	25611075	92913
chr1	53370479	53570479	harbor1	chr1	53394718	53395008	DNA/hAT-Charlie	1034	-	145	53394863	24384
chr1	53370479	53570479	harbor1	chr1	53451920	53452231	DNA/hAT-Charlie	1164	-	156	53452076	81597
chr1	2375585	2575585	harbor1	chr1	2421645	2421691	DNA/hAT-Charlie	1985	-	23	2421668	46083
chr1	2375585	2575585	harbor1	chr1	2422293	2422675	DNA/hAT-Charlie	1985	-	191	2422484	46899
chr1	2375585	2575585	harbor1	chr1	2422842	2423137	DNA/hAT-Charlie	1985	-	148	2422990	47405
chr1	16625216	16825216	harbor1	chr1	16643865	16644061	DNA/hAT-Charlie	1037	-	98	16643963	18747
chr1	16625216	16825216	harbor1	chr1	16650295	16650563	DNA/hAT-Charlie	1054	-	134	16650429	25213
chr1	16625216	16825216	harbor1	chr1	16653377	16653554	DNA/hAT-Charlie	954	-	88	16653465	28249
chr1	16625216	16825216	harbor1	chr1	16669402	16669589	DNA/hAT-Charlie	835	-	94	16669496	44280
chr1	16625216	16825216	harbor1	chr1	16687134	16687256	DNA/hAT-Charlie	554	-	61	16687195	61979
chr1	16625249	16825249	harbor1	chr1	16643865	16644061	DNA/hAT-Charlie	1037	-	98	16643963	18714
chr1	16625249	16825249	harbor1	chr1	16650295	16650563	DNA/hAT-Charlie	1054	-	134	16650429	25180
chr1	16625249	16825249	harbor1	chr1	16653377	16653554	DNA/hAT-Charlie	954	-	88	16653465	28216
chr1	16625249	16825249	harbor1	chr1	16669402	16669589	DNA/hAT-Charlie	835	-	94	16669496	44247
chr1	16625249	16825249	harbor1	chr1	16687134	16687256	DNA/hAT-Charlie	554	-	61	16687195	61946
chr1	16544924	16744924	harbor1	chr1	16643865	16644061	DNA/hAT-Charlie	1037	-	98	16643963	99039
chr1	244589301	244789301	harbor1	chr1	244611879	244612050	DNA/hAT-Charlie	817	-	86	244611965	22664
chr1	244589301	244789301	harbor1	chr1	244681425	244681600	DNA/hAT-Charlie	1151	-	88	244681513	92212
chr1	244589301	244789301	harbor1	chr1	244682602	244682799	DNA/hAT-Charlie	926	-	98	244682700	93399
chr1	2420759	2620759	harbor1	chr1	2421645	2421691	DNA/hAT-Charlie	1985	-	23	2421668	909
chr1	2420759	2620759	harbor1	chr1	2422293	2422675	DNA/hAT-Charlie	1985	-	191	2422484	1725
chr1	2420759	2620759	harbor1	chr1	2422842	2423137	DNA/hAT-Charlie	1985	-	148	2422990	2231
chr1	16596778	16796778	harbor1	chr1	16643865	16644061	DNA/hAT-Charlie	1037	-	98	16643963	47185
chr1	16596778	16796778	harbor1	chr1	16650295	16650563	DNA/hAT-Charlie	1054	-	134	16650429	53651
chr1	16596778	16796778	harbor1	chr1	16653377	16653554	DNA/hAT-Charlie	954	-	88	16653465	56687
chr1	16596778	16796778	harbor1	chr1	16669402	16669589	DNA/hAT-Charlie	835	-	94	16669496	72718
chr1	16596778	16796778	harbor1	chr1	16687134	16687256	DNA/hAT-Charlie	554	-	61	16687195	90417
chr1	16544873	16744873	harbor1	chr1	16643865	16644061	DNA/hAT-Charlie	1037	-	98	16643963	99090
chr1	16619578	16819578	harbor1	chr1	16643865	16644061	DNA/hAT-Charlie	1037	-	98	16643963	24385
chr1	16619578	16819578	harbor1	chr1	16650295	16650563	DNA/hAT-Charlie	1054	-	134	16650429	30851
chr1	16619578	16819578	harbor1	chr1	16653377	16653554	DNA/hAT-Charlie	954	-	88	16653465	33887
chr1	16619578	16819578	harbor1	chr1	16669402	16669589	DNA/hAT-Charlie	835	-	94	16669496	49918
chr1	16619578	16819578	harbor1	chr1	16687134	16687256	DNA/hAT-Charlie	554	-	61	16687195	67617
chr1	227440888	227640888	harbor1	chr1	227513867	227514232	DNA/hAT-Charlie	2696	-	182	227514049	73161
chr1	16545039	16745039	harbor1	chr1	16643865	16644061	DNA/hAT-Charlie	1037	-	98	16643963	98924
chr1	3679154	3879154	harbor1	chr1	3704165	3704426	DNA/hAT-Charlie	545	-	130	3704295	25141
chr1	2136117	2336117	harbor1	chr1	2165539	2165716	DNA/hAT-Charlie	635	-	88	2165627	29510
chr1	2136117	2336117	harbor1	chr1	2168119	2168297	DNA/hAT-Charlie	732	-	89	2168208	32091
chr1	226638245	226838245	harbor1	chr1	226682097	226682276	DNA/hAT-Charlie	611	-	90	226682187	43942
chr1	226638245	226838245	harbor1	chr1	226693488	226693712	DNA/hAT-Charlie	604	-	112	226693600	55355
chr1	226638245	226838245	harbor1	chr1	226694628	226694834	DNA/hAT-Charlie	1135	-	103	226694731	56486
chr1	154985666	155185666	harbor1	chr1	154990761	154990827	DNA/hAT-Charlie	496	-	33	154990794	5128
chr1	154985666	155185666	harbor1	chr1	154990904	154990929	DNA/hAT-Charlie	496	-	12	154990916	5250
chr1	154985666	155185666	harbor1	chr1	154991257	154991272	DNA/hAT-Charlie	496	-	8	154991265	5599
chr1	154985666	155185666	harbor1	chr1	154991572	154991662	DNA/hAT-Charlie	496	-	45	154991617	5951
chr1	53846279	54046279	harbor1	chr1	53905523	53905695	DNA/hAT-Charlie	656	-	86	53905609	59330
chr1	53846279	54046279	harbor1	chr1	53908343	53908481	DNA/hAT-Charlie	679	-	69	53908412	62133
chr1	53846279	54046279	harbor1	chr1	53912771	53912959	DNA/hAT-Charlie	1106	-	94	53912865	66586
chr1	53846338	54046338	harbor1	chr1	53905523	53905695	DNA/hAT-Charlie	656	-	86	53905609	59271
chr1	53846338	54046338	harbor1	chr1	53908343	53908481	DNA/hAT-Charlie	679	-	69	53908412	62074
chr1	53846338	54046338	harbor1	chr1	53912771	53912959	DNA/hAT-Charlie	1106	-	94	53912865	66527
chr1	2138467	2338467	harbor1	chr1	2165539	2165716	DNA/hAT-Charlie	635	-	88	2165627	27160
chr1	2138467	2338467	harbor1	chr1	2168119	2168297	DNA/hAT-Charlie	732	-	89	2168208	29741
chr1	154400577	154600577	harbor1	chr1	154408808	154408868	DNA/hAT-Charlie	1037	-	30	154408838	8261
chr1	154400577	154600577	harbor1	chr1	154409142	154409294	DNA/hAT-Charlie	1037	-	76	154409218	8641
chr1	154400577	154600577	harbor1	chr1	154444132	154444208	DNA/hAT-Charlie	650	-	38	154444170	43593
chr1	154400577	154600577	harbor1	chr1	154444506	154444608	DNA/hAT-Charlie	650	-	51	154444557	43980
chr1	154400577	154600577	harbor1	chr1	154492211	154492356	DNA/hAT-Charlie	538	-	72	154492283	91706
chr1	2420774	2620774	harbor1	chr1	2421645	2421691	DNA/hAT-Charlie	1985	-	23	2421668	894
chr1	2420774	2620774	harbor1	chr1	2422293	2422675	DNA/hAT-Charlie	1985	-	191	2422484	1710
chr1	2420774	2620774	harbor1	chr1	2422842	2423137	DNA/hAT-Charlie	1985	-	148	2422990	2216
chr1	204585380	204785380	harbor1	chr1	204608364	204608537	DNA/hAT-Charlie	913	-	86	204608450	23070
chr1	204585380	204785380	harbor1	chr1	204637332	204637490	DNA/hAT-Charlie	532	-	79	204637411	52031
chr1	1676051	1876051	harbor1	chr1	1733898	1734067	DNA/hAT-Charlie	494	-	84	1733982	57931
chr1	16544932	16744932	harbor1	chr1	16643865	16644061	DNA/hAT-Charlie	1037	-	98	16643963	99031
chr1	16625276	16825276	harbor1	chr1	16643865	16644061	DNA/hAT-Charlie	1037	-	98	16643963	18687
chr1	16625276	16825276	harbor1	chr1	16650295	16650563	DNA/hAT-Charlie	1054	-	134	16650429	25153
chr1	16625276	16825276	harbor1	chr1	16653377	16653554	DNA/hAT-Charlie	954	-	88	16653465	28189
chr1	16625276	16825276	harbor1	chr1	16669402	16669589	DNA/hAT-Charlie	835	-	94	16669496	44220
chr1	16625276	16825276	harbor1	chr1	16687134	16687256	DNA/hAT-Charlie	554	-	61	16687195	61919
chr1	211033792	211233792	harbor1	chr1	211046909	211047228	DNA/hAT-Charlie	1243	-	160	211047069	13277
chr1	211033792	211233792	harbor1	chr1	211094077	211094404	DNA/hAT-Charlie	2338	-	164	211094241	60449
chr1	59714670	59914670	harbor1	chr1	59751514	59752236	DNA/hAT-Charlie	1308	-	361	59751875	37205
chr1	59714670	59914670	harbor1	chr1	59773370	59773589	DNA/hAT-Charlie	1026	-	110	59773480	58810
chr1	59714670	59914670	harbor1	chr1	59775083	59775233	DNA/hAT-Charlie	665	-	75	59775158	60488
chr1	244735088	244935088	harbor1	chr1	244761677	244761814	DNA/hAT-Charlie	763	-	68	244761745	26657
chr1	244735088	244935088	harbor1	chr1	244769692	244769982	DNA/hAT-Charlie	1083	-	145	244769837	34749
chr1	244735088	244935088	harbor1	chr1	244788306	244788458	DNA/hAT-Charlie	761	-	76	244788382	53294
chr1	244735088	244935088	harbor1	chr1	244795769	244795853	DNA/hAT-Charlie	880	-	42	244795811	60723
chr1	244735088	244935088	harbor1	chr1	244796156	244796240	DNA/hAT-Charlie	880	-	42	244796198	61110
chr1	244735088	244935088	harbor1	chr1	244825186	244825565	DNA/hAT-Charlie	1520	-	190	244825376	90288
chr1	244735088	244935088	harbor1	chr1	244825575	244825686	DNA/hAT-Charlie	527	-	56	244825631	90543
chr1	9254542	9454542	harbor1	chr1	9327699	9327907	DNA/hAT-Charlie	1060	-	104	9327803	73261
chr1	9254542	9454542	harbor1	chr1	9328779	9328999	DNA/hAT-Charlie	636	-	110	9328889	74347
chr1	9254542	9454542	harbor1	chr1	9344188	9344361	DNA/hAT-Charlie	740	-	86	9344274	89732
chr1	2420768	2620768	harbor1	chr1	2421645	2421691	DNA/hAT-Charlie	1985	-	23	2421668	900
chr1	2420768	2620768	harbor1	chr1	2422293	2422675	DNA/hAT-Charlie	1985	-	191	2422484	1716
chr1	2420768	2620768	harbor1	chr1	2422842	2423137	DNA/hAT-Charlie	1985	-	148	2422990	2222
chr1	16544427	16744427	harbor1	chr1	16643865	16644061	DNA/hAT-Charlie	1037	-	98	16643963	99536
chr1	25516681	25716681	harbor1	chr1	25536656	25536872	DNA/hAT-Charlie	765	-	108	25536764	20083
chr1	25516681	25716681	harbor1	chr1	25593515	25593703	DNA/hAT-Charlie	675	-	94	25593609	76928
chr1	25516681	25716681	harbor1	chr1	25594099	25594218	DNA/hAT-Charlie	675	-	60	25594159	77478
chr1	25516681	25716681	harbor1	chr1	25610967	25611182	DNA/hAT-Charlie	1227	-	108	25611075	94394
chr1	116272513	116472513	harbor1	chr1	116326934	116327242	DNA/hAT-Charlie	977	-	154	116327088	54575
chr1	116272513	116472513	harbor1	chr1	116328137	116328272	DNA/hAT-Charlie	579	-	68	116328205	55692
chr1	116272513	116472513	harbor1	chr1	116343293	116343540	DNA/hAT-Charlie	914	-	124	116343417	70904
chr1	244605835	244805835	harbor1	chr1	244611879	244612050	DNA/hAT-Charlie	817	-	86	244611965	6130
chr1	244605835	244805835	harbor1	chr1	244681425	244681600	DNA/hAT-Charlie	1151	-	88	244681513	75678
chr1	244605835	244805835	harbor1	chr1	244682602	244682799	DNA/hAT-Charlie	926	-	98	244682700	76865
chr1	244605835	244805835	harbor1	chr1	244702549	244702719	DNA/hAT-Charlie	677	-	85	244702634	96799
chr1	16545027	16745027	harbor1	chr1	16643865	16644061	DNA/hAT-Charlie	1037	-	98	16643963	98936
chr1	2138442	2338442	harbor1	chr1	2165539	2165716	DNA/hAT-Charlie	635	-	88	2165627	27185
chr1	2138442	2338442	harbor1	chr1	2168119	2168297	DNA/hAT-Charlie	732	-	89	2168208	29766
chr1	244605400	244805400	harbor1	chr1	244611879	244612050	DNA/hAT-Charlie	817	-	86	244611965	6565
chr1	244605400	244805400	harbor1	chr1	244681425	244681600	DNA/hAT-Charlie	1151	-	88	244681513	76113
chr1	244605400	244805400	harbor1	chr1	244682602	244682799	DNA/hAT-Charlie	926	-	98	244682700	77300
chr1	244605400	244805400	harbor1	chr1	244702549	244702719	DNA/hAT-Charlie	677	-	85	244702634	97234
chr1	6397828	6597828	harbor1	chr1	6452550	6452712	DNA/hAT-Charlie	639	-	81	6452631	54803
chr1	6397828	6597828	harbor1	chr1	6457680	6457889	DNA/hAT-Charlie	1213	-	104	6457784	59956
chr1	6397828	6597828	harbor1	chr1	6459420	6459541	DNA/hAT-Charlie	1213	-	60	6459480	61652
chr1	6397828	6597828	harbor1	chr1	6468702	6468890	DNA/hAT-Charlie	473	-	94	6468796	70968
chr1	17019452	17219452	harbor1	chr1	17096861	17097051	DNA/hAT-Charlie	1146	-	95	17096956	77504
chr1	17019452	17219452	harbor1	chr1	17111606	17111789	DNA/hAT-Charlie	930	-	92	17111698	92246
chr1	16625337	16825337	harbor1	chr1	16643865	16644061	DNA/hAT-Charlie	1037	-	98	16643963	18626
chr1	16625337	16825337	harbor1	chr1	16650295	16650563	DNA/hAT-Charlie	1054	-	134	16650429	25092
chr1	16625337	16825337	harbor1	chr1	16653377	16653554	DNA/hAT-Charlie	954	-	88	16653465	28128
chr1	16625337	16825337	harbor1	chr1	16669402	16669589	DNA/hAT-Charlie	835	-	94	16669496	44159
chr1	16625337	16825337	harbor1	chr1	16687134	16687256	DNA/hAT-Charlie	554	-	61	16687195	61858
chr1	16625340	16825340	harbor1	chr1	16643865	16644061	DNA/hAT-Charlie	1037	-	98	16643963	18623
chr1	16625340	16825340	harbor1	chr1	16650295	16650563	DNA/hAT-Charlie	1054	-	134	16650429	25089
chr1	16625340	16825340	harbor1	chr1	16653377	16653554	DNA/hAT-Charlie	954	-	88	16653465	28125
chr1	16625340	16825340	harbor1	chr1	16669402	16669589	DNA/hAT-Charlie	835	-	94	16669496	44156
chr1	16625340	16825340	harbor1	chr1	16687134	16687256	DNA/hAT-Charlie	554	-	61	16687195	61855
chr1	16544809	16744809	harbor1	chr1	16643865	16644061	DNA/hAT-Charlie	1037	-	98	16643963	99154
chr1	2419947	2619947	harbor1	chr1	2421645	2421691	DNA/hAT-Charlie	1985	-	23	2421668	1721
chr1	2419947	2619947	harbor1	chr1	2422293	2422675	DNA/hAT-Charlie	1985	-	191	2422484	2537
chr1	2419947	2619947	harbor1	chr1	2422842	2423137	DNA/hAT-Charlie	1985	-	148	2422990	3043
chr1	2138106	2338106	harbor1	chr1	2165539	2165716	DNA/hAT-Charlie	635	-	88	2165627	27521
chr1	2138106	2338106	harbor1	chr1	2168119	2168297	DNA/hAT-Charlie	732	-	89	2168208	30102
chr1	51419171	51619171	harbor1	chr1	51432471	51432714	DNA/hAT-Charlie	946	-	122	51432593	13422
chr1	51419171	51619171	harbor1	chr1	51452814	51452989	DNA/hAT-Charlie	855	-	88	51452902	33731
chr1	16544989	16744989	harbor1	chr1	16643865	16644061	DNA/hAT-Charlie	1037	-	98	16643963	98974
chr1	16544731	16744731	harbor1	chr1	16643865	16644061	DNA/hAT-Charlie	1037	-	98	16643963	99232
chr1	28814567	29014567	harbor1	chr1	28836860	28837361	DNA/hAT-Charlie	3323	-	250	28837110	22543
chr1	2138449	2338449	harbor1	chr1	2165539	2165716	DNA/hAT-Charlie	635	-	88	2165627	27178
chr1	2138449	2338449	harbor1	chr1	2168119	2168297	DNA/hAT-Charlie	732	-	89	2168208	29759
chr1	110112132	110312132	harbor1	chr1	110196560	110197029	DNA/hAT-Charlie	1443	-	234	110196794	84662
chr1	2420749	2620749	harbor1	chr1	2421645	2421691	DNA/hAT-Charlie	1985	-	23	2421668	919
chr1	2420749	2620749	harbor1	chr1	2422293	2422675	DNA/hAT-Charlie	1985	-	191	2422484	1735
chr1	2420749	2620749	harbor1	chr1	2422842	2423137	DNA/hAT-Charlie	1985	-	148	2422990	2241
chr1	16544918	16744918	harbor1	chr1	16643865	16644061	DNA/hAT-Charlie	1037	-	98	16643963	99045
chr1	179714840	179914840	harbor1	chr1	179749913	179750081	DNA/hAT-Charlie	674	-	84	179749997	35157
chr1	179714840	179914840	harbor1	chr1	179759093	179759291	DNA/hAT-Charlie	1021	-	99	179759192	44352
chr1	179714840	179914840	harbor1	chr1	179811444	179811584	DNA/hAT-Charlie	700	-	70	179811514	96674
chr1	179714840	179914840	harbor1	chr1	179765245	179765394	DNA/hAT-Charlie	682	-	74	179765319	50479
chr1	23269371	23469371	harbor1	chr1	23269658	23269801	DNA/hAT-Charlie	1280	-	72	23269730	359
chr1	23269371	23469371	harbor1	chr1	23346491	23346667	DNA/hAT-Charlie	758	-	88	23346579	77208
chr1	23269371	23469371	harbor1	chr1	23347559	23347835	DNA/hAT-Charlie	1147	-	138	23347697	78326
chr1	23269371	23469371	harbor1	chr1	23364792	23364974	DNA/hAT-Charlie	546	-	91	23364883	95512
chr1	23269371	23469371	harbor1	chr1	23365936	23366000	DNA/hAT-Charlie	546	-	32	23365968	96597
chr1	31080007	31280007	harbor1	chr1	31110449	31110590	DNA/hAT-Charlie	626	-	70	31110519	30512
chr1	726411	926411	harbor1	chr1	729816	730235	DNA/hAT-Charlie	2306	-	210	730026	3615
chr1	726411	926411	harbor1	chr1	733225	733644	DNA/hAT-Charlie	2375	-	210	733435	7024
chr1	726411	926411	harbor1	chr1	736631	737050	DNA/hAT-Charlie	2322	-	210	736841	10430
chr1	726411	926411	harbor1	chr1	740047	740466	DNA/hAT-Charlie	2330	-	210	740257	13846
chr1	726411	926411	harbor1	chr1	743783	744214	DNA/hAT-Charlie	2775	-	216	743999	17588
chr1	726411	926411	harbor1	chr1	782312	782501	DNA/hAT-Charlie	870	-	94	782406	55995
chr1	726411	926411	harbor1	chr1	782641	782795	DNA/hAT-Charlie	620	-	77	782718	56307
chr1	2138451	2338451	harbor1	chr1	2165539	2165716	DNA/hAT-Charlie	635	-	88	2165627	27176
chr1	2138451	2338451	harbor1	chr1	2168119	2168297	DNA/hAT-Charlie	732	-	89	2168208	29757
chr1	7671217	7871217	harbor1	chr1	7698180	7698402	DNA/hAT-Charlie	1554	-	111	7698291	27074
chr1	7671217	7871217	harbor1	chr1	7740190	7740405	DNA/hAT-Charlie	836	-	108	7740298	69081
chr1	7671217	7871217	harbor1	chr1	7757192	7757408	DNA/hAT-Charlie	1120	-	108	7757300	86083
chr1	24895887	25095887	harbor1	chr1	24953423	24953644	DNA/hAT-Charlie	849	-	110	24953533	57646
chr1	32106047	32306047	harbor1	chr1	32119585	32119743	DNA/hAT-Charlie	435	-	79	32119664	13617
chr1	32106047	32306047	harbor1	chr1	32120036	32120134	DNA/hAT-Charlie	435	-	49	32120085	14038
chr1	32106047	32306047	harbor1	chr1	32123261	32123457	DNA/hAT-Charlie	756	-	98	32123359	17312
chr1	32106047	32306047	harbor1	chr1	32125147	32125362	DNA/hAT-Charlie	826	-	108	32125255	19208
chr1	32106047	32306047	harbor1	chr1	32125368	32125721	DNA/hAT-Charlie	1226	-	176	32125544	19497
chr1	51229911	51429911	harbor1	chr1	51281765	51281886	DNA/hAT-Charlie	526	-	60	51281825	51914
chr1	51229911	51429911	harbor1	chr1	51286855	51287094	DNA/hAT-Charlie	669	-	120	51286975	57064
chr1	51229911	51429911	harbor1	chr1	51301128	51301339	DNA/hAT-Charlie	986	-	106	51301234	71323
chr1	51229911	51429911	harbor1	chr1	51306349	51306571	DNA/hAT-Charlie	1186	-	111	51306460	76549
chr1	244605782	244805782	harbor1	chr1	244611879	244612050	DNA/hAT-Charlie	817	-	86	244611965	6183
chr1	244605782	244805782	harbor1	chr1	244681425	244681600	DNA/hAT-Charlie	1151	-	88	244681513	75731
chr1	244605782	244805782	harbor1	chr1	244682602	244682799	DNA/hAT-Charlie	926	-	98	244682700	76918
chr1	244605782	244805782	harbor1	chr1	244702549	244702719	DNA/hAT-Charlie	677	-	85	244702634	96852
chr1	20048547	20248547	harbor1	chr1	20075660	20075859	DNA/hAT-Charlie	448	-	100	20075760	27213
chr1	20048547	20248547	harbor1	chr1	20147931	20148092	DNA/hAT-Charlie	614	-	80	20148011	99464
chr1	16544880	16744880	harbor1	chr1	16643865	16644061	DNA/hAT-Charlie	1037	-	98	16643963	99083
chr1	16544895	16744895	harbor1	chr1	16643865	16644061	DNA/hAT-Charlie	1037	-	98	16643963	99068
chr1	16625259	16825259	harbor1	chr1	16643865	16644061	DNA/hAT-Charlie	1037	-	98	16643963	18704
chr1	16625259	16825259	harbor1	chr1	16650295	16650563	DNA/hAT-Charlie	1054	-	134	16650429	25170
chr1	16625259	16825259	harbor1	chr1	16653377	16653554	DNA/hAT-Charlie	954	-	88	16653465	28206
chr1	16625259	16825259	harbor1	chr1	16669402	16669589	DNA/hAT-Charlie	835	-	94	16669496	44237
chr1	16625259	16825259	harbor1	chr1	16687134	16687256	DNA/hAT-Charlie	554	-	61	16687195	61936
chr1	16625336	16825336	harbor1	chr1	16643865	16644061	DNA/hAT-Charlie	1037	-	98	16643963	18627
chr1	16625336	16825336	harbor1	chr1	16650295	16650563	DNA/hAT-Charlie	1054	-	134	16650429	25093
chr1	16625336	16825336	harbor1	chr1	16653377	16653554	DNA/hAT-Charlie	954	-	88	16653465	28129
chr1	16625336	16825336	harbor1	chr1	16669402	16669589	DNA/hAT-Charlie	835	-	94	16669496	44160
chr1	16625336	16825336	harbor1	chr1	16687134	16687256	DNA/hAT-Charlie	554	-	61	16687195	61859
chr1	3431277	3631277	harbor1	chr1	3439060	3439577	DNA/hAT-Charlie	3364	-	258	3439318	8041
chr1	2420675	2620675	harbor1	chr1	2421645	2421691	DNA/hAT-Charlie	1985	-	23	2421668	993
chr1	2420675	2620675	harbor1	chr1	2422293	2422675	DNA/hAT-Charlie	1985	-	191	2422484	1809
chr1	2420675	2620675	harbor1	chr1	2422842	2423137	DNA/hAT-Charlie	1985	-	148	2422990	2315
chr1	3845228	4045228	harbor1	chr1	3847033	3847333	DNA/hAT-Charlie	770	-	150	3847183	1955
chr1	2138561	2338561	harbor1	chr1	2165539	2165716	DNA/hAT-Charlie	635	-	88	2165627	27066
chr1	2138561	2338561	harbor1	chr1	2168119	2168297	DNA/hAT-Charlie	732	-	89	2168208	29647
chr1	16544752	16744752	harbor1	chr1	16643865	16644061	DNA/hAT-Charlie	1037	-	98	16643963	99211
chr1	227983972	228183972	harbor1	chr1	228034594	228034862	DNA/hAT-Charlie	810	-	134	228034728	50756
chr1	227983972	228183972	harbor1	chr1	228057762	228057822	DNA/hAT-Charlie	897	-	30	228057792	73820
chr1	227983972	228183972	harbor1	chr1	228058101	228058323	DNA/hAT-Charlie	897	-	111	228058212	74240
chr1	227983972	228183972	harbor1	chr1	228078614	228078782	DNA/hAT-Charlie	455	-	84	228078698	94726
chr1	2420704	2620704	harbor1	chr1	2421645	2421691	DNA/hAT-Charlie	1985	-	23	2421668	964
chr1	2420704	2620704	harbor1	chr1	2422293	2422675	DNA/hAT-Charlie	1985	-	191	2422484	1780
chr1	2420704	2620704	harbor1	chr1	2422842	2423137	DNA/hAT-Charlie	1985	-	148	2422990	2286
chr1	194372730	194572730	harbor1	chr1	194382567	194383064	DNA/hAT-Charlie	822	-	248	194382815	10085
chr1	194372730	194572730	harbor1	chr1	194383065	194384418	DNA/hAT-Charlie	4044	-	676	194383741	11011
chr1	230025255	230225255	harbor1	chr1	230074061	230074098	DNA/hAT-Charlie	1077	-	18	230074079	48824
chr1	230025255	230225255	harbor1	chr1	230074378	230074575	DNA/hAT-Charlie	1077	-	98	230074476	49221
chr1	2420476	2620476	harbor1	chr1	2421645	2421691	DNA/hAT-Charlie	1985	-	23	2421668	1192
chr1	2420476	2620476	harbor1	chr1	2422293	2422675	DNA/hAT-Charlie	1985	-	191	2422484	2008
chr1	2420476	2620476	harbor1	chr1	2422842	2423137	DNA/hAT-Charlie	1985	-	148	2422990	2514
chr1	2420584	2620584	harbor1	chr1	2421645	2421691	DNA/hAT-Charlie	1985	-	23	2421668	1084
chr1	2420584	2620584	harbor1	chr1	2422293	2422675	DNA/hAT-Charlie	1985	-	191	2422484	1900
chr1	2420584	2620584	harbor1	chr1	2422842	2423137	DNA/hAT-Charlie	1985	-	148	2422990	2406
chr1	28814559	29014559	harbor1	chr1	28836860	28837361	DNA/hAT-Charlie	3323	-	250	28837110	22551
chr1	47316981	47516981	harbor1	chr1	47345273	47345492	DNA/hAT-Charlie	1295	-	110	47345383	28402
chr1	47316981	47516981	harbor1	chr1	47346360	47346468	DNA/hAT-Charlie	1295	-	54	47346414	29433
chr1	47316981	47516981	harbor1	chr1	47347223	47347238	DNA/hAT-Charlie	667	-	8	47347231	30250
chr1	47316981	47516981	harbor1	chr1	47347509	47347622	DNA/hAT-Charlie	667	-	56	47347565	30584
chr1	47316981	47516981	harbor1	chr1	47347931	47348039	DNA/hAT-Charlie	667	-	54	47347985	31004
chr1	47316981	47516981	harbor1	chr1	47408955	47409181	DNA/hAT-Charlie	768	-	113	47409068	92087
chr1	165531488	165731488	harbor1	chr1	165556485	165556691	DNA/hAT-Charlie	987	-	103	165556588	25100
chr1	165531488	165731488	harbor1	chr1	165563251	165563414	DNA/hAT-Charlie	937	-	82	165563333	31845
chr1	165531488	165731488	harbor1	chr1	165617577	165617669	DNA/hAT-Charlie	986	-	46	165617623	86135
chr1	165531488	165731488	harbor1	chr1	165618031	165618139	DNA/hAT-Charlie	986	-	54	165618085	86597
chr1	222687998	222887998	harbor1	chr1	222707785	222707994	DNA/hAT-Charlie	689	-	104	222707889	19891
chr1	222687998	222887998	harbor1	chr1	222717084	222717243	DNA/hAT-Charlie	607	-	80	222717164	29166
chr1	222687998	222887998	harbor1	chr1	222739414	222739591	DNA/hAT-Charlie	732	-	88	222739502	51504
chr1	222687998	222887998	harbor1	chr1	222768420	222768476	DNA/hAT-Charlie	750	-	28	222768448	80450
chr1	222687998	222887998	harbor1	chr1	222768539	222768731	DNA/hAT-Charlie	750	-	96	222768635	80637
chr1	222687998	222887998	harbor1	chr1	222769843	222770070	DNA/hAT-Charlie	645	-	114	222769957	81959
chr1	3055728	3255728	harbor1	chr1	3113577	3113765	DNA/hAT-Charlie	441	-	94	3113671	57943
chr1	16625314	16825314	harbor1	chr1	16643865	16644061	DNA/hAT-Charlie	1037	-	98	16643963	18649
chr1	16625314	16825314	harbor1	chr1	16650295	16650563	DNA/hAT-Charlie	1054	-	134	16650429	25115
chr1	16625314	16825314	harbor1	chr1	16653377	16653554	DNA/hAT-Charlie	954	-	88	16653465	28151
chr1	16625314	16825314	harbor1	chr1	16669402	16669589	DNA/hAT-Charlie	835	-	94	16669496	44182
chr1	16625314	16825314	harbor1	chr1	16687134	16687256	DNA/hAT-Charlie	554	-	61	16687195	61881
chr1	11740582	11940582	harbor1	chr1	11781476	11781628	DNA/hAT-Charlie	447	-	76	11781552	40970
chr1	11740582	11940582	harbor1	chr1	11781932	11782034	DNA/hAT-Charlie	447	-	51	11781983	41401
chr1	11740582	11940582	harbor1	chr1	11798612	11798728	DNA/hAT-Charlie	527	-	58	11798670	58088
chr1	11740582	11940582	harbor1	chr1	11799042	11799183	DNA/hAT-Charlie	527	-	70	11799112	58530
chr1	11740582	11940582	harbor1	chr1	11824080	11824283	DNA/hAT-Charlie	492	-	102	11824182	83600
chr1	11740582	11940582	harbor1	chr1	11835075	11835188	DNA/hAT-Charlie	557	-	56	11835131	94549
chr1	203028332	203228332	harbor1	chr1	203053206	203053251	DNA/hAT-Charlie	718	-	22	203053228	24896
chr1	203028332	203228332	harbor1	chr1	203053569	203053675	DNA/hAT-Charlie	718	-	53	203053622	25290
chr1	203028332	203228332	harbor1	chr1	203054729	203054877	DNA/hAT-Charlie	564	-	74	203054803	26471
chr1	203028332	203228332	harbor1	chr1	203111341	203111811	DNA/hAT-Charlie	1154	-	235	203111576	83244
chr1	203028332	203228332	harbor1	chr1	203112011	203112140	DNA/hAT-Charlie	1792	-	64	203112075	83743
chr1	203028332	203228332	harbor1	chr1	203112450	203113043	DNA/hAT-Charlie	1792	-	296	203112746	84414
chr1	15615212	15815212	harbor1	chr1	15636769	15636936	DNA/hAT-Charlie	647	-	84	15636853	21641
chr1	15615212	15815212	harbor1	chr1	15690399	15690572	DNA/hAT-Charlie	761	-	86	15690485	75273
chr1	15615212	15815212	harbor1	chr1	15707430	15707537	DNA/hAT-Charlie	503	-	54	15707484	92272
chr1	207819139	208019139	harbor1	chr1	207849983	207850219	DNA/hAT-Charlie	1058	-	118	207850101	30962
chr1	207819139	208019139	harbor1	chr1	207851714	207851876	DNA/hAT-Charlie	697	-	81	207851795	32656
chr1	207819139	208019139	harbor1	chr1	207853690	207853958	DNA/hAT-Charlie	693	-	134	207853824	34685
chr1	207819139	208019139	harbor1	chr1	207864880	207865097	DNA/hAT-Charlie	1029	-	108	207864988	45849
chr1	207819139	208019139	harbor1	chr1	207869709	207869863	DNA/hAT-Charlie	517	-	77	207869786	50647
chr1	207819139	208019139	harbor1	chr1	207880692	207880950	DNA/hAT-Charlie	1039	-	129	207880821	61682
chr1	207819139	208019139	harbor1	chr1	207880952	207881140	DNA/hAT-Charlie	766	-	94	207881046	61907
chr1	2375370	2575370	harbor1	chr1	2421645	2421691	DNA/hAT-Charlie	1985	-	23	2421668	46298
chr1	2375370	2575370	harbor1	chr1	2422293	2422675	DNA/hAT-Charlie	1985	-	191	2422484	47114
chr1	2375370	2575370	harbor1	chr1	2422842	2423137	DNA/hAT-Charlie	1985	-	148	2422990	47620
chr1	89721428	89921428	harbor1	chr1	89811835	89811960	DNA/hAT-Charlie	479	-	62	89811897	90469
chr1	9589512	9789512	harbor1	chr1	9596341	9596533	DNA/hAT-Charlie	872	-	96	9596437	6925
chr1	9589512	9789512	harbor1	chr1	9612098	9612279	DNA/hAT-Charlie	746	-	90	9612188	22676
chr1	9589512	9789512	harbor1	chr1	9641933	9642119	DNA/hAT-Charlie	535	-	93	9642026	52514
chr1	9589512	9789512	harbor1	chr1	9642413	9642435	DNA/hAT-Charlie	535	-	11	9642424	52912
chr1	9589512	9789512	harbor1	chr1	9642735	9642805	DNA/hAT-Charlie	535	-	35	9642770	53258
chr1	9589512	9789512	harbor1	chr1	9672138	9672323	DNA/hAT-Charlie	642	-	92	9672230	82718
chr1	204879064	205079064	harbor1	chr1	204886492	204886645	DNA/hAT-Charlie	613	-	76	204886568	7504
chr1	3672871	3872871	harbor1	chr1	3704165	3704426	DNA/hAT-Charlie	545	-	130	3704295	31424
chr1	16625248	16825248	harbor1	chr1	16643865	16644061	DNA/hAT-Charlie	1037	-	98	16643963	18715
chr1	16625248	16825248	harbor1	chr1	16650295	16650563	DNA/hAT-Charlie	1054	-	134	16650429	25181
chr1	16625248	16825248	harbor1	chr1	16653377	16653554	DNA/hAT-Charlie	954	-	88	16653465	28217
chr1	16625248	16825248	harbor1	chr1	16669402	16669589	DNA/hAT-Charlie	835	-	94	16669496	44248
chr1	16625248	16825248	harbor1	chr1	16687134	16687256	DNA/hAT-Charlie	554	-	61	16687195	61947
chr1	6525772	6725772	harbor1	chr1	6573534	6573640	DNA/hAT-Charlie	2632	-	53	6573587	47815
chr1	6525772	6725772	harbor1	chr1	6573963	6574290	DNA/hAT-Charlie	2632	-	164	6574127	48355
chr1	6525772	6725772	harbor1	chr1	6584220	6584382	DNA/hAT-Charlie	584	-	81	6584301	58529
chr1	23877841	24077841	harbor1	chr1	23897314	23897481	DNA/hAT-Charlie	646	-	84	23897398	19557
chr1	23877841	24077841	harbor1	chr1	23897760	23897907	DNA/hAT-Charlie	646	-	74	23897834	19993
chr1	23877841	24077841	harbor1	chr1	23906916	23907112	DNA/hAT-Charlie	938	-	98	23907014	29173
chr1	23877841	24077841	harbor1	chr1	23907439	23907480	DNA/hAT-Charlie	938	-	20	23907459	29618
chr1	23877841	24077841	harbor1	chr1	23907792	23907978	DNA/hAT-Charlie	938	-	93	23907885	30044
chr1	23877841	24077841	harbor1	chr1	23916659	23916795	DNA/hAT-Charlie	753	-	68	23916727	38886
chr1	2420671	2620671	harbor1	chr1	2421645	2421691	DNA/hAT-Charlie	1985	-	23	2421668	997
chr1	2420671	2620671	harbor1	chr1	2422293	2422675	DNA/hAT-Charlie	1985	-	191	2422484	1813
chr1	2420671	2620671	harbor1	chr1	2422842	2423137	DNA/hAT-Charlie	1985	-	148	2422990	2319
chr1	2375291	2575291	harbor1	chr1	2421645	2421691	DNA/hAT-Charlie	1985	-	23	2421668	46377
chr1	2375291	2575291	harbor1	chr1	2422293	2422675	DNA/hAT-Charlie	1985	-	191	2422484	47193
chr1	2375291	2575291	harbor1	chr1	2422842	2423137	DNA/hAT-Charlie	1985	-	148	2422990	47699
chr1	53846292	54046292	harbor1	chr1	53905523	53905695	DNA/hAT-Charlie	656	-	86	53905609	59317
chr1	53846292	54046292	harbor1	chr1	53908343	53908481	DNA/hAT-Charlie	679	-	69	53908412	62120
chr1	53846292	54046292	harbor1	chr1	53912771	53912959	DNA/hAT-Charlie	1106	-	94	53912865	66573
chr1	3055710	3255710	harbor1	chr1	3113577	3113765	DNA/hAT-Charlie	441	-	94	3113671	57961
chr1	207924797	208124797	harbor1	chr1	207933011	207933204	DNA/hAT-Charlie	901	-	96	207933107	8310
chr1	207924797	208124797	harbor1	chr1	207943355	207943447	DNA/hAT-Charlie	3873	-	46	207943401	18604
chr1	207924797	208124797	harbor1	chr1	207946334	207946518	DNA/hAT-Charlie	10526	-	92	207946426	21629
chr1	207924797	208124797	harbor1	chr1	207958261	207958399	DNA/hAT-Charlie	675	-	69	207958330	33533
chr1	207924797	208124797	harbor1	chr1	207983866	207984031	DNA/hAT-Charlie	756	-	82	207983948	59151
chr1	207924797	208124797	harbor1	chr1	207984837	207986106	DNA/hAT-Charlie	6027	-	634	207985471	60674
chr1	207924797	208124797	harbor1	chr1	208001537	208001709	DNA/hAT-Charlie	673	-	86	208001623	76826
chr1	207924797	208124797	harbor1	chr1	207943785	207946045	DNA/hAT-Charlie	10526	-	1130	207944915	20118
chr1	7604696	7804696	harbor1	chr1	7653022	7653185	DNA/hAT-Charlie	720	-	82	7653104	48408
chr1	7604696	7804696	harbor1	chr1	7653921	7654032	DNA/hAT-Charlie	463	-	56	7653977	49281
chr1	7604696	7804696	harbor1	chr1	7698180	7698402	DNA/hAT-Charlie	1554	-	111	7698291	93595
chr1	53370409	53570409	harbor1	chr1	53394718	53395008	DNA/hAT-Charlie	1034	-	145	53394863	24454
chr1	53370409	53570409	harbor1	chr1	53451920	53452231	DNA/hAT-Charlie	1164	-	156	53452076	81667
chr1	43447553	43647553	harbor1	chr1	43471470	43471623	DNA/hAT-Charlie	564	-	76	43471546	23993
chr1	43447553	43647553	harbor1	chr1	43471696	43471874	DNA/hAT-Charlie	1203	-	89	43471785	24232
chr1	43447553	43647553	harbor1	chr1	43503586	43503845	DNA/hAT-Charlie	943	-	130	43503716	56163
chr1	43447553	43647553	harbor1	chr1	43540060	43540277	DNA/hAT-Charlie	1177	-	108	43540168	92615
chr1	43447553	43647553	harbor1	chr1	43541504	43541705	DNA/hAT-Charlie	962	-	100	43541604	94051
chr1	2138430	2338430	harbor1	chr1	2165539	2165716	DNA/hAT-Charlie	635	-	88	2165627	27197
chr1	2138430	2338430	harbor1	chr1	2168119	2168297	DNA/hAT-Charlie	732	-	89	2168208	29778
chr1	53846310	54046310	harbor1	chr1	53905523	53905695	DNA/hAT-Charlie	656	-	86	53905609	59299
chr1	53846310	54046310	harbor1	chr1	53908343	53908481	DNA/hAT-Charlie	679	-	69	53908412	62102
chr1	53846310	54046310	harbor1	chr1	53912771	53912959	DNA/hAT-Charlie	1106	-	94	53912865	66555
chr1	6160375	6360375	harbor1	chr1	6200200	6200331	DNA/hAT-Charlie	590	-	66	6200266	39891
chr1	25773550	25973550	harbor1	chr1	25777623	25777778	DNA/hAT-Charlie	431	-	78	25777701	4151
chr1	25773550	25973550	harbor1	chr1	25787833	25787926	DNA/hAT-Charlie	892	-	46	25787879	14329
chr1	25773550	25973550	harbor1	chr1	25788207	25788282	DNA/hAT-Charlie	892	-	38	25788245	14695
chr1	25773550	25973550	harbor1	chr1	25868324	25868426	DNA/hAT-Charlie	538	-	51	25868375	94825
chr1	25773550	25973550	harbor1	chr1	25868731	25868819	DNA/hAT-Charlie	538	-	44	25868775	95225
chr1	16544750	16744750	harbor1	chr1	16643865	16644061	DNA/hAT-Charlie	1037	-	98	16643963	99213
chr1	2375268	2575268	harbor1	chr1	2421645	2421691	DNA/hAT-Charlie	1985	-	23	2421668	46400
chr1	2375268	2575268	harbor1	chr1	2422293	2422675	DNA/hAT-Charlie	1985	-	191	2422484	47216
chr1	2375268	2575268	harbor1	chr1	2422842	2423137	DNA/hAT-Charlie	1985	-	148	2422990	47722
chr1	245603515	245803515	harbor1	chr1	245610353	245610523	DNA/hAT-Charlie	870	-	85	245610438	6923
chr1	245603515	245803515	harbor1	chr1	245679073	245679292	DNA/hAT-Charlie	1135	-	110	245679183	75668
chr1	3683862	3883862	harbor1	chr1	3704165	3704426	DNA/hAT-Charlie	545	-	130	3704295	20433
chr1	26400758	26600758	harbor1	chr1	26414678	26414888	DNA/hAT-Charlie	1110	-	105	26414783	14025
chr1	13663032	13863032	harbor1	chr1	13671457	13671813	DNA/hAT-Charlie	1000	-	178	13671635	8603
chr1	13663032	13863032	harbor1	chr1	13690803	13690953	DNA/hAT-Charlie	682	-	75	13690878	27846
chr1	13663032	13863032	harbor1	chr1	13691253	13691291	DNA/hAT-Charlie	682	-	19	13691272	28240
chr1	13663032	13863032	harbor1	chr1	13692795	13693416	DNA/hAT-Charlie	3567	-	310	13693105	30073
chr1	13663032	13863032	harbor1	chr1	13703195	13703376	DNA/hAT-Charlie	940	-	90	13703285	40253
chr1	13663032	13863032	harbor1	chr1	13725633	13725834	DNA/hAT-Charlie	872	-	100	13725733	62701
chr1	13663032	13863032	harbor1	chr1	13664175	13664404	DNA/hAT-Charlie	1109	-	114	13664289	1257
chr1	40761841	40961841	harbor1	chr1	40799850	40799982	DNA/hAT-Charlie	473	-	66	40799916	38075
chr1	40761841	40961841	harbor1	chr1	40828310	40828485	DNA/hAT-Charlie	695	-	88	40828398	66557
chr1	230759103	230959103	harbor1	chr1	230823867	230824021	DNA/hAT-Charlie	476	-	77	230823944	64841
chr1	230759103	230959103	harbor1	chr1	230834342	230834560	DNA/hAT-Charlie	1118	-	109	230834451	75348
chr1	16625224	16825224	harbor1	chr1	16643865	16644061	DNA/hAT-Charlie	1037	-	98	16643963	18739
chr1	16625224	16825224	harbor1	chr1	16650295	16650563	DNA/hAT-Charlie	1054	-	134	16650429	25205
chr1	16625224	16825224	harbor1	chr1	16653377	16653554	DNA/hAT-Charlie	954	-	88	16653465	28241
chr1	16625224	16825224	harbor1	chr1	16669402	16669589	DNA/hAT-Charlie	835	-	94	16669496	44272
chr1	16625224	16825224	harbor1	chr1	16687134	16687256	DNA/hAT-Charlie	554	-	61	16687195	61971
chr1	24195409	24395409	harbor1	chr1	24218535	24218716	DNA/hAT-Charlie	796	-	90	24218625	23216
chr1	24195409	24395409	harbor1	chr1	24223905	24224028	DNA/hAT-Charlie	654	-	62	24223967	28558
chr1	24195409	24395409	harbor1	chr1	24234496	24234554	DNA/hAT-Charlie	502	-	29	24234525	39116
chr1	24195409	24395409	harbor1	chr1	24234866	24234966	DNA/hAT-Charlie	502	-	50	24234916	39507
chr1	24195409	24395409	harbor1	chr1	24235205	24235372	DNA/hAT-Charlie	1462	-	84	24235289	39880
chr1	24195409	24395409	harbor1	chr1	24235681	24235914	DNA/hAT-Charlie	1462	-	116	24235797	40388
chr1	24195409	24395409	harbor1	chr1	24252951	24253094	DNA/hAT-Charlie	437	-	72	24253023	57614
chr1	16544828	16744828	harbor1	chr1	16643865	16644061	DNA/hAT-Charlie	1037	-	98	16643963	99135
chr1	13662918	13862918	harbor1	chr1	13671457	13671813	DNA/hAT-Charlie	1000	-	178	13671635	8717
chr1	13662918	13862918	harbor1	chr1	13690803	13690953	DNA/hAT-Charlie	682	-	75	13690878	27960
chr1	13662918	13862918	harbor1	chr1	13691253	13691291	DNA/hAT-Charlie	682	-	19	13691272	28354
chr1	13662918	13862918	harbor1	chr1	13692795	13693416	DNA/hAT-Charlie	3567	-	310	13693105	30187
chr1	13662918	13862918	harbor1	chr1	13703195	13703376	DNA/hAT-Charlie	940	-	90	13703285	40367
chr1	13662918	13862918	harbor1	chr1	13725633	13725834	DNA/hAT-Charlie	872	-	100	13725733	62815
chr1	13662918	13862918	harbor1	chr1	13664175	13664404	DNA/hAT-Charlie	1109	-	114	13664289	1371
chr1	2137893	2337893	harbor1	chr1	2165539	2165716	DNA/hAT-Charlie	635	-	88	2165627	27734
chr1	2137893	2337893	harbor1	chr1	2168119	2168297	DNA/hAT-Charlie	732	-	89	2168208	30315
chr1	16544915	16744915	harbor1	chr1	16643865	16644061	DNA/hAT-Charlie	1037	-	98	16643963	99048
chr1	31972870	32172870	harbor1	chr1	32003777	32003927	DNA/hAT-Charlie	521	-	75	32003852	30982
chr1	16625200	16825200	harbor1	chr1	16643865	16644061	DNA/hAT-Charlie	1037	-	98	16643963	18763
chr1	16625200	16825200	harbor1	chr1	16650295	16650563	DNA/hAT-Charlie	1054	-	134	16650429	25229
chr1	16625200	16825200	harbor1	chr1	16653377	16653554	DNA/hAT-Charlie	954	-	88	16653465	28265
chr1	16625200	16825200	harbor1	chr1	16669402	16669589	DNA/hAT-Charlie	835	-	94	16669496	44296
chr1	16625200	16825200	harbor1	chr1	16687134	16687256	DNA/hAT-Charlie	554	-	61	16687195	61995
chr1	16544721	16744721	harbor1	chr1	16643865	16644061	DNA/hAT-Charlie	1037	-	98	16643963	99242
chr1	205329484	205529484	harbor1	chr1	205365761	205365884	DNA/hAT-Charlie	624	-	62	205365823	36339
chr1	205329484	205529484	harbor1	chr1	205378396	205378491	DNA/hAT-Charlie	534	-	48	205378444	48960
chr1	2375306	2575306	harbor1	chr1	2421645	2421691	DNA/hAT-Charlie	1985	-	23	2421668	46362
chr1	2375306	2575306	harbor1	chr1	2422293	2422675	DNA/hAT-Charlie	1985	-	191	2422484	47178
chr1	2375306	2575306	harbor1	chr1	2422842	2423137	DNA/hAT-Charlie	1985	-	148	2422990	47684
chr1	111713067	111913067	harbor1	chr1	111767611	111767773	DNA/hAT-Charlie	529	-	81	111767692	54625
chr1	111713067	111913067	harbor1	chr1	111797037	111797212	DNA/hAT-Charlie	896	-	88	111797125	84058
chr1	13672401	13872401	harbor1	chr1	13690803	13690953	DNA/hAT-Charlie	682	-	75	13690878	18477
chr1	13672401	13872401	harbor1	chr1	13691253	13691291	DNA/hAT-Charlie	682	-	19	13691272	18871
chr1	13672401	13872401	harbor1	chr1	13692795	13693416	DNA/hAT-Charlie	3567	-	310	13693105	20704
chr1	13672401	13872401	harbor1	chr1	13703195	13703376	DNA/hAT-Charlie	940	-	90	13703285	30884
chr1	13672401	13872401	harbor1	chr1	13725633	13725834	DNA/hAT-Charlie	872	-	100	13725733	53332
chr1	2138476	2338476	harbor1	chr1	2165539	2165716	DNA/hAT-Charlie	635	-	88	2165627	27151
chr1	2138476	2338476	harbor1	chr1	2168119	2168297	DNA/hAT-Charlie	732	-	89	2168208	29732
chr1	6685469	6885469	harbor1	chr1	6697325	6697691	DNA/hAT-Charlie	1838	-	183	6697508	12039
chr1	6685469	6885469	harbor1	chr1	6718433	6718644	DNA/hAT-Charlie	1094	-	106	6718539	33070
chr1	6685469	6885469	harbor1	chr1	6762110	6762179	DNA/hAT-Charlie	460	-	34	6762144	76675
chr1	6685469	6885469	harbor1	chr1	6768105	6768271	DNA/hAT-Charlie	458	-	83	6768188	82719
chr1	6685469	6885469	harbor1	chr1	6781775	6782040	DNA/hAT-Charlie	1099	-	132	6781907	96438
chr1	6685469	6885469	harbor1	chr1	6782325	6782408	DNA/hAT-Charlie	1099	-	42	6782367	96898
chr1	244605833	244805833	harbor1	chr1	244611879	244612050	DNA/hAT-Charlie	817	-	86	244611965	6132
chr1	244605833	244805833	harbor1	chr1	244681425	244681600	DNA/hAT-Charlie	1151	-	88	244681513	75680
chr1	244605833	244805833	harbor1	chr1	244682602	244682799	DNA/hAT-Charlie	926	-	98	244682700	76867
chr1	244605833	244805833	harbor1	chr1	244702549	244702719	DNA/hAT-Charlie	677	-	85	244702634	96801
chr1	40913010	41113010	harbor1	chr1	40931974	40932146	DNA/hAT-Charlie	540	-	86	40932060	19050
chr1	40913010	41113010	harbor1	chr1	40952215	40952400	DNA/hAT-Charlie	773	-	92	40952307	39297
chr1	40913010	41113010	harbor1	chr1	40994970	40995144	DNA/hAT-Charlie	955	-	87	40995057	82047
chr1	155154854	155354854	harbor1	chr1	155157906	155158067	DNA/hAT-Charlie	732	-	80	155157986	3132
chr1	155154854	155354854	harbor1	chr1	155158754	155158770	DNA/hAT-Charlie	732	-	8	155158762	3908
chr1	155154854	155354854	harbor1	chr1	155222383	155222552	DNA/hAT-Charlie	567	-	84	155222467	67613
chr1	13686837	13886837	harbor1	chr1	13690803	13690953	DNA/hAT-Charlie	682	-	75	13690878	4041
chr1	13686837	13886837	harbor1	chr1	13691253	13691291	DNA/hAT-Charlie	682	-	19	13691272	4435
chr1	13686837	13886837	harbor1	chr1	13692795	13693416	DNA/hAT-Charlie	3567	-	310	13693105	6268
chr1	13686837	13886837	harbor1	chr1	13703195	13703376	DNA/hAT-Charlie	940	-	90	13703285	16448
chr1	13686837	13886837	harbor1	chr1	13725633	13725834	DNA/hAT-Charlie	872	-	100	13725733	38896
chr1	234508642	234708642	harbor1	chr1	234546376	234546411	DNA/hAT-Charlie	834	-	18	234546394	37752
chr1	234508642	234708642	harbor1	chr1	234546699	234546891	DNA/hAT-Charlie	834	-	96	234546795	38153
chr1	234508642	234708642	harbor1	chr1	234547960	234548143	DNA/hAT-Charlie	900	-	92	234548052	39410
chr1	234508642	234708642	harbor1	chr1	234594998	234595362	DNA/hAT-Charlie	2114	-	182	234595180	86538
chr1	211033696	211233696	harbor1	chr1	211046909	211047228	DNA/hAT-Charlie	1243	-	160	211047069	13373
chr1	211033696	211233696	harbor1	chr1	211094077	211094404	DNA/hAT-Charlie	2338	-	164	211094241	60545
chr1	24895890	25095890	harbor1	chr1	24953423	24953644	DNA/hAT-Charlie	849	-	110	24953533	57643
chr1	16545016	16745016	harbor1	chr1	16643865	16644061	DNA/hAT-Charlie	1037	-	98	16643963	98947
chr1	16625343	16825343	harbor1	chr1	16643865	16644061	DNA/hAT-Charlie	1037	-	98	16643963	18620
chr1	16625343	16825343	harbor1	chr1	16650295	16650563	DNA/hAT-Charlie	1054	-	134	16650429	25086
chr1	16625343	16825343	harbor1	chr1	16653377	16653554	DNA/hAT-Charlie	954	-	88	16653465	28122
chr1	16625343	16825343	harbor1	chr1	16669402	16669589	DNA/hAT-Charlie	835	-	94	16669496	44153
chr1	16625343	16825343	harbor1	chr1	16687134	16687256	DNA/hAT-Charlie	554	-	61	16687195	61852
chr1	16512786	16712786	harbor1	chr1	16516738	16517077	DNA/hAT-Charlie	1936	-	170	16516908	4122
chr1	148910670	149110670	harbor1	chr1	148916084	148916388	DNA/hAT-Charlie	1408	-	152	148916236	5566
chr1	148910670	149110670	harbor1	chr1	148939371	148939481	DNA/hAT-Charlie	460	-	55	148939426	28756
chr1	148910670	149110670	harbor1	chr1	148940458	148940684	DNA/hAT-Charlie	465	-	113	148940571	29901
chr1	148910670	149110670	harbor1	chr1	148945159	148945354	DNA/hAT-Charlie	928	-	98	148945257	34587
chr1	148910670	149110670	harbor1	chr1	148970513	148970695	DNA/hAT-Charlie	602	-	91	148970604	59934
chr1	148910670	149110670	harbor1	chr1	148990899	148991107	DNA/hAT-Charlie	895	-	104	148991003	80333
chr1	148910670	149110670	harbor1	chr1	149009055	149009320	DNA/hAT-Charlie	556	-	132	149009187	98517
chr1	226307818	226507818	harbor1	chr1	226307717	226307920	DNA/hAT-Charlie	856	-	102	226307819	1
chr1	226307818	226507818	harbor1	chr1	226335228	226335282	DNA/hAT-Charlie	807	-	27	226335255	27437
chr1	226307818	226507818	harbor1	chr1	226335597	226335714	DNA/hAT-Charlie	807	-	58	226335655	27837
chr1	226307818	226507818	harbor1	chr1	226340056	226340127	DNA/hAT-Charlie	478	-	36	226340092	32274
chr1	226307818	226507818	harbor1	chr1	226343024	226343114	DNA/hAT-Charlie	478	-	45	226343069	35251
chr1	226307818	226507818	harbor1	chr1	226405784	226405833	DNA/hAT-Charlie	1302	-	24	226405808	97990
chr1	226307818	226507818	harbor1	chr1	226405965	226406349	DNA/hAT-Charlie	1302	-	192	226406157	98339
chr1	54786918	54986918	harbor1	chr1	54815208	54815390	DNA/hAT-Charlie	1025	-	91	54815299	28381
chr1	46503416	46703416	harbor1	chr1	46591703	46591958	DNA/hAT-Charlie	1416	-	128	46591831	88415
chr1	46503416	46703416	harbor1	chr1	46592262	46592469	DNA/hAT-Charlie	1416	-	104	46592366	88950
chr1	46503416	46703416	harbor1	chr1	46596121	46596451	DNA/hAT-Charlie	1453	-	165	46596286	92870
chr1	46503416	46703416	harbor1	chr1	46579537	46579718	DNA/hAT-Charlie	784	-	90	46579627	76211
chr1	2136208	2336208	harbor1	chr1	2165539	2165716	DNA/hAT-Charlie	635	-	88	2165627	29419
chr1	2136208	2336208	harbor1	chr1	2168119	2168297	DNA/hAT-Charlie	732	-	89	2168208	32000
chr1	25330942	25530942	harbor1	chr1	25350690	25350855	DNA/hAT-Charlie	753	-	82	25350772	19830
chr1	25330942	25530942	harbor1	chr1	25359415	25359633	DNA/hAT-Charlie	1533	-	109	25359524	28582
chr1	25330942	25530942	harbor1	chr1	25382794	25383214	DNA/hAT-Charlie	875	-	210	25383004	52062
chr1	25330942	25530942	harbor1	chr1	25383992	25384178	DNA/hAT-Charlie	795	-	93	25384085	53143
chr1	25330942	25530942	harbor1	chr1	25385974	25386129	DNA/hAT-Charlie	808	-	78	25386052	55110
chr1	25330942	25530942	harbor1	chr1	25386140	25386309	DNA/hAT-Charlie	933	-	84	25386224	55282
chr1	25330942	25530942	harbor1	chr1	25392956	25393126	DNA/hAT-Charlie	501	-	85	25393041	62099
chr1	25330942	25530942	harbor1	chr1	25415839	25416023	DNA/hAT-Charlie	1068	-	92	25415931	84989
chr1	25330942	25530942	harbor1	chr1	25422714	25423035	DNA/hAT-Charlie	2109	-	160	25422874	91932
chr2	196073592	196273592	harbor1	chr2	196134093	196134258	DNA/hAT-Charlie	840	-	82	196134175	60583
chr2	26950219	27150219	harbor1	chr2	26960073	26960192	DNA/hAT-Charlie	675	-	60	26960133	9914
chr2	26950219	27150219	harbor1	chr2	26965832	26966004	DNA/hAT-Charlie	539	-	86	26965918	15699
chr2	26950219	27150219	harbor1	chr2	26995056	26995206	DNA/hAT-Charlie	894	-	75	26995131	44912
chr2	26950219	27150219	harbor1	chr2	26997130	26997253	DNA/hAT-Charlie	1891	-	62	26997192	46973
chr2	26950219	27150219	harbor1	chr2	26997473	26997678	DNA/hAT-Charlie	1891	-	102	26997575	47356
chr2	26950219	27150219	harbor1	chr2	27020311	27020528	DNA/hAT-Charlie	542	-	108	27020419	70200
chr2	74415405	74615405	harbor1	chr2	74445213	74445406	DNA/hAT-Charlie	443	-	96	74445309	29904
chr2	152618051	152818051	harbor1	chr2	152646448	152646563	DNA/hAT-Charlie	503	-	58	152646506	28455
chr2	152618051	152818051	harbor1	chr2	152660890	152661040	DNA/hAT-Charlie	529	-	75	152660965	42914
chr2	152618051	152818051	harbor1	chr2	152666651	152666797	DNA/hAT-Charlie	529	-	73	152666724	48673
chr2	152618051	152818051	harbor1	chr2	152691394	152691607	DNA/hAT-Charlie	963	-	106	152691500	73449
chr2	152618051	152818051	harbor1	chr2	152666107	152666205	DNA/hAT-Charlie	487	-	49	152666156	48105
chr2	26950237	27150237	harbor1	chr2	26960073	26960192	DNA/hAT-Charlie	675	-	60	26960133	9896
chr2	26950237	27150237	harbor1	chr2	26965832	26966004	DNA/hAT-Charlie	539	-	86	26965918	15681
chr2	26950237	27150237	harbor1	chr2	26995056	26995206	DNA/hAT-Charlie	894	-	75	26995131	44894
chr2	26950237	27150237	harbor1	chr2	26997130	26997253	DNA/hAT-Charlie	1891	-	62	26997192	46955
chr2	26950237	27150237	harbor1	chr2	26997473	26997678	DNA/hAT-Charlie	1891	-	102	26997575	47338
chr2	26950237	27150237	harbor1	chr2	27020311	27020528	DNA/hAT-Charlie	542	-	108	27020419	70182
chr2	219058841	219258841	harbor1	chr2	219092311	219092685	DNA/hAT-Charlie	1685	-	187	219092498	33657
chr2	219058841	219258841	harbor1	chr2	219099199	219099416	DNA/hAT-Charlie	1059	-	108	219099307	40466
chr2	219058841	219258841	harbor1	chr2	219149745	219149962	DNA/hAT-Charlie	1244	-	108	219149853	91012
chr2	218221236	218421236	harbor1	chr2	218222900	218223076	DNA/hAT-Charlie	441	-	88	218222988	1752
chr2	218221236	218421236	harbor1	chr2	218290107	218290347	DNA/hAT-Charlie	687	-	120	218290227	68991
chr2	218221236	218421236	harbor1	chr2	218300444	218300531	DNA/hAT-Charlie	476	-	44	218300488	79252
chr2	218221236	218421236	harbor1	chr2	218300852	218301049	DNA/hAT-Charlie	470	-	98	218300950	79714
chr2	218221236	218421236	harbor1	chr2	218301142	218301265	DNA/hAT-Charlie	649	-	62	218301204	79968
chr2	218221236	218421236	harbor1	chr2	218307168	218307685	DNA/hAT-Charlie	3457	-	258	218307426	86190
chr2	218221236	218421236	harbor1	chr2	218319309	218319365	DNA/hAT-Charlie	1008	-	28	218319337	98101
chr2	218221236	218421236	harbor1	chr2	218319674	218319830	DNA/hAT-Charlie	1008	-	78	218319752	98516
chr2	219073554	219273554	harbor1	chr2	219092311	219092685	DNA/hAT-Charlie	1685	-	187	219092498	18944
chr2	219073554	219273554	harbor1	chr2	219099199	219099416	DNA/hAT-Charlie	1059	-	108	219099307	25753
chr2	219073554	219273554	harbor1	chr2	219149745	219149962	DNA/hAT-Charlie	1244	-	108	219149853	76299
chr2	219073554	219273554	harbor1	chr2	219162720	219162940	DNA/hAT-Charlie	1172	-	110	219162830	89276
chr2	219073554	219273554	harbor1	chr2	219170801	219171348	DNA/hAT-Charlie	1551	-	274	219171075	97521
chr2	219073013	219273013	harbor1	chr2	219092311	219092685	DNA/hAT-Charlie	1685	-	187	219092498	19485
chr2	219073013	219273013	harbor1	chr2	219099199	219099416	DNA/hAT-Charlie	1059	-	108	219099307	26294
chr2	219073013	219273013	harbor1	chr2	219149745	219149962	DNA/hAT-Charlie	1244	-	108	219149853	76840
chr2	219073013	219273013	harbor1	chr2	219162720	219162940	DNA/hAT-Charlie	1172	-	110	219162830	89817
chr2	219073013	219273013	harbor1	chr2	219170801	219171348	DNA/hAT-Charlie	1551	-	274	219171075	98062
chr2	152617998	152817998	harbor1	chr2	152646448	152646563	DNA/hAT-Charlie	503	-	58	152646506	28508
chr2	152617998	152817998	harbor1	chr2	152660890	152661040	DNA/hAT-Charlie	529	-	75	152660965	42967
chr2	152617998	152817998	harbor1	chr2	152666651	152666797	DNA/hAT-Charlie	529	-	73	152666724	48726
chr2	152617998	152817998	harbor1	chr2	152691394	152691607	DNA/hAT-Charlie	963	-	106	152691500	73502
chr2	152617998	152817998	harbor1	chr2	152666107	152666205	DNA/hAT-Charlie	487	-	49	152666156	48158
chr2	86976337	87176337	harbor1	chr2	86989844	86989901	DNA/hAT-Charlie	1025	-	28	86989872	13535
chr2	86976337	87176337	harbor1	chr2	86990052	86990365	DNA/hAT-Charlie	1025	-	156	86990208	13871
chr2	86976337	87176337	harbor1	chr2	87056392	87056732	DNA/hAT-Charlie	2117	-	170	87056562	80225
chr2	86976337	87176337	harbor1	chr2	87057442	87057549	DNA/hAT-Charlie	538	-	54	87057496	81159
chr2	53759964	53959964	harbor1	chr2	53767030	53767169	DNA/hAT-Charlie	457	-	70	53767100	7136
chr2	15464442	15664442	harbor1	chr2	15519746	15519819	DNA/hAT-Charlie	467	-	36	15519782	55340
chr2	15464442	15664442	harbor1	chr2	15520512	15520813	DNA/hAT-Charlie	1180	-	150	15520662	56220
chr2	15464442	15664442	harbor1	chr2	15546774	15546971	DNA/hAT-Charlie	571	-	98	15546872	82430
chr2	15464442	15664442	harbor1	chr2	15558072	15558329	DNA/hAT-Charlie	1448	-	128	15558200	93758
chr2	219073574	219273574	harbor1	chr2	219092311	219092685	DNA/hAT-Charlie	1685	-	187	219092498	18924
chr2	219073574	219273574	harbor1	chr2	219099199	219099416	DNA/hAT-Charlie	1059	-	108	219099307	25733
chr2	219073574	219273574	harbor1	chr2	219149745	219149962	DNA/hAT-Charlie	1244	-	108	219149853	76279
chr2	219073574	219273574	harbor1	chr2	219162720	219162940	DNA/hAT-Charlie	1172	-	110	219162830	89256
chr2	219073574	219273574	harbor1	chr2	219170801	219171348	DNA/hAT-Charlie	1551	-	274	219171075	97501
chr2	85228519	85428519	harbor1	chr2	85239583	85239663	DNA/hAT-Charlie	934	-	40	85239623	11104
chr2	85228519	85428519	harbor1	chr2	85239976	85240192	DNA/hAT-Charlie	934	-	108	85240084	11565
chr2	85228519	85428519	harbor1	chr2	85248293	85248435	DNA/hAT-Charlie	642	-	71	85248364	19845
chr2	85228519	85428519	harbor1	chr2	85288244	85288343	DNA/hAT-Charlie	460	-	50	85288294	59775
chr2	85228519	85428519	harbor1	chr2	85293914	85294026	DNA/hAT-Charlie	490	-	56	85293970	65451
chr2	85228519	85428519	harbor1	chr2	85294396	85294507	DNA/hAT-Charlie	628	-	56	85294452	65933
chr2	219070180	219270180	harbor1	chr2	219092311	219092685	DNA/hAT-Charlie	1685	-	187	219092498	22318
chr2	219070180	219270180	harbor1	chr2	219099199	219099416	DNA/hAT-Charlie	1059	-	108	219099307	29127
chr2	219070180	219270180	harbor1	chr2	219149745	219149962	DNA/hAT-Charlie	1244	-	108	219149853	79673
chr2	219070180	219270180	harbor1	chr2	219162720	219162940	DNA/hAT-Charlie	1172	-	110	219162830	92650
chr2	219458053	219658053	harbor1	chr2	219474769	219474792	DNA/hAT-Charlie	804	-	12	219474781	16728
chr2	219458053	219658053	harbor1	chr2	219475085	219475402	DNA/hAT-Charlie	804	-	158	219475243	17190
chr2	219458053	219658053	harbor1	chr2	219476042	219476182	DNA/hAT-Charlie	505	-	70	219476112	18059
chr2	219458053	219658053	harbor1	chr2	219520772	219521001	DNA/hAT-Charlie	530	-	114	219520886	62833
chr2	219068681	219268681	harbor1	chr2	219092311	219092685	DNA/hAT-Charlie	1685	-	187	219092498	23817
chr2	219068681	219268681	harbor1	chr2	219099199	219099416	DNA/hAT-Charlie	1059	-	108	219099307	30626
chr2	219068681	219268681	harbor1	chr2	219149745	219149962	DNA/hAT-Charlie	1244	-	108	219149853	81172
chr2	219068681	219268681	harbor1	chr2	219162720	219162940	DNA/hAT-Charlie	1172	-	110	219162830	94149
chr2	42033084	42233084	harbor1	chr2	42038916	42039014	DNA/hAT-Charlie	458	-	49	42038965	5881
chr2	42033084	42233084	harbor1	chr2	42039308	42039565	DNA/hAT-Charlie	458	-	128	42039436	6352
chr2	26950242	27150242	harbor1	chr2	26960073	26960192	DNA/hAT-Charlie	675	-	60	26960133	9891
chr2	26950242	27150242	harbor1	chr2	26965832	26966004	DNA/hAT-Charlie	539	-	86	26965918	15676
chr2	26950242	27150242	harbor1	chr2	26995056	26995206	DNA/hAT-Charlie	894	-	75	26995131	44889
chr2	26950242	27150242	harbor1	chr2	26997130	26997253	DNA/hAT-Charlie	1891	-	62	26997192	46950
chr2	26950242	27150242	harbor1	chr2	26997473	26997678	DNA/hAT-Charlie	1891	-	102	26997575	47333
chr2	26950242	27150242	harbor1	chr2	27020311	27020528	DNA/hAT-Charlie	542	-	108	27020419	70177
chr2	44988947	45188947	harbor1	chr2	45073936	45074306	DNA/hAT-Charlie	1709	-	185	45074121	85174
chr2	44988947	45188947	harbor1	chr2	45074304	45074417	DNA/hAT-Charlie	612	-	56	45074360	85413
chr2	84760927	84960927	harbor1	chr2	84806077	84806245	DNA/hAT-Charlie	563	-	84	84806161	45234
chr2	84760927	84960927	harbor1	chr2	84859669	84859854	DNA/hAT-Charlie	962	-	92	84859761	98834
chr2	219383264	219583264	harbor1	chr2	219393057	219393276	DNA/hAT-Charlie	1517	-	110	219393167	9903
chr2	219383264	219583264	harbor1	chr2	219399383	219399543	DNA/hAT-Charlie	458	-	80	219399463	16199
chr2	219383264	219583264	harbor1	chr2	219474769	219474792	DNA/hAT-Charlie	804	-	12	219474781	91517
chr2	219383264	219583264	harbor1	chr2	219475085	219475402	DNA/hAT-Charlie	804	-	158	219475243	91979
chr2	219383264	219583264	harbor1	chr2	219476042	219476182	DNA/hAT-Charlie	505	-	70	219476112	92848
chr2	113484040	113684040	harbor1	chr2	113524530	113524679	DNA/hAT-Charlie	749	-	74	113524604	40564
chr2	113484040	113684040	harbor1	chr2	113562237	113562397	DNA/hAT-Charlie	668	-	80	113562317	78277
chr2	113484040	113684040	harbor1	chr2	113576022	113576407	DNA/hAT-Charlie	1586	-	192	113576214	92174
chr2	85461791	85661791	harbor1	chr2	85471597	85471849	DNA/hAT-Charlie	614	-	126	85471723	9932
chr2	85461791	85661791	harbor1	chr2	85481055	85481238	DNA/hAT-Charlie	728	-	92	85481147	19356
chr2	85461791	85661791	harbor1	chr2	85522555	85522682	DNA/hAT-Charlie	3173	-	64	85522619	60828
chr2	85461791	85661791	harbor1	chr2	85522990	85523406	DNA/hAT-Charlie	3173	-	208	85523198	61407
chr2	85461791	85661791	harbor1	chr2	85559869	85560091	DNA/hAT-Charlie	1122	-	111	85559980	98189
chr2	31910614	32110614	harbor1	chr2	31947971	31948115	DNA/hAT-Charlie	601	-	72	31948043	37429
chr2	31910614	32110614	harbor1	chr2	32006440	32006657	DNA/hAT-Charlie	647	-	108	32006548	95934
chr2	207648472	207848472	harbor1	chr2	207737722	207737818	DNA/hAT-Charlie	562	-	48	207737770	89298
chr2	207648472	207848472	harbor1	chr2	207737859	207738012	DNA/hAT-Charlie	3605	-	76	207737935	89463
chr2	207648472	207848472	harbor1	chr2	207738079	207738208	DNA/hAT-Charlie	3605	-	64	207738143	89671
chr2	207648472	207848472	harbor1	chr2	207738521	207738711	DNA/hAT-Charlie	3605	-	95	207738616	90144
chr2	207648472	207848472	harbor1	chr2	207739020	207739230	DNA/hAT-Charlie	3605	-	105	207739125	90653
chr2	207648472	207848472	harbor1	chr2	207739530	207740094	DNA/hAT-Charlie	3605	-	282	207739812	91340
chr2	71780774	71980774	harbor1	chr2	71828945	71829172	DNA/hAT-Charlie	830	-	114	71829059	48285
chr2	71780774	71980774	harbor1	chr2	71864586	71864793	DNA/hAT-Charlie	1005	-	104	71864690	83916
chr2	53759991	53959991	harbor1	chr2	53767030	53767169	DNA/hAT-Charlie	457	-	70	53767100	7109
chr2	113484101	113684101	harbor1	chr2	113524530	113524679	DNA/hAT-Charlie	749	-	74	113524604	40503
chr2	113484101	113684101	harbor1	chr2	113562237	113562397	DNA/hAT-Charlie	668	-	80	113562317	78216
chr2	113484101	113684101	harbor1	chr2	113576022	113576407	DNA/hAT-Charlie	1586	-	192	113576214	92113
chr2	113484028	113684028	harbor1	chr2	113524530	113524679	DNA/hAT-Charlie	749	-	74	113524604	40576
chr2	113484028	113684028	harbor1	chr2	113562237	113562397	DNA/hAT-Charlie	668	-	80	113562317	78289
chr2	113484028	113684028	harbor1	chr2	113576022	113576407	DNA/hAT-Charlie	1586	-	192	113576214	92186
chr2	219335190	219535190	harbor1	chr2	219357551	219357684	DNA/hAT-Charlie	440	-	66	219357617	22427
chr2	219335190	219535190	harbor1	chr2	219357982	219358076	DNA/hAT-Charlie	440	-	47	219358029	22839
chr2	219335190	219535190	harbor1	chr2	219381606	219381754	DNA/hAT-Charlie	504	-	74	219381680	46490
chr2	219335190	219535190	harbor1	chr2	219393057	219393276	DNA/hAT-Charlie	1517	-	110	219393167	57977
chr2	219335190	219535190	harbor1	chr2	219399383	219399543	DNA/hAT-Charlie	458	-	80	219399463	64273
chr2	47682917	47882917	harbor1	chr2	47689043	47689240	DNA/hAT-Charlie	1512	-	98	47689141	6224
chr2	47682917	47882917	harbor1	chr2	47701061	47701084	DNA/hAT-Charlie	494	-	12	47701073	18156
chr2	47682917	47882917	harbor1	chr2	47701344	47701490	DNA/hAT-Charlie	494	-	73	47701417	18500
chr2	47682917	47882917	harbor1	chr2	47723531	47723590	DNA/hAT-Charlie	778	-	30	47723561	40644
chr2	47682917	47882917	harbor1	chr2	47723875	47724014	DNA/hAT-Charlie	778	-	70	47723945	41028
chr2	47682917	47882917	harbor1	chr2	47764803	47764977	DNA/hAT-Charlie	788	-	87	47764890	81973
chr2	113484029	113684029	harbor1	chr2	113524530	113524679	DNA/hAT-Charlie	749	-	74	113524604	40575
chr2	113484029	113684029	harbor1	chr2	113562237	113562397	DNA/hAT-Charlie	668	-	80	113562317	78288
chr2	113484029	113684029	harbor1	chr2	113576022	113576407	DNA/hAT-Charlie	1586	-	192	113576214	92185
chr2	70453429	70653429	harbor1	chr2	70462503	70462765	DNA/hAT-Charlie	544	-	131	70462634	9205
chr2	70453429	70653429	harbor1	chr2	70489931	70490098	DNA/hAT-Charlie	686	-	84	70490015	36586
chr2	70453429	70653429	harbor1	chr2	70500006	70500192	DNA/hAT-Charlie	535	-	93	70500099	46670
chr2	70453429	70653429	harbor1	chr2	70508639	70508767	DNA/hAT-Charlie	499	-	64	70508703	55274
chr2	70453429	70653429	harbor1	chr2	70530402	70530612	DNA/hAT-Charlie	1383	-	105	70530507	77078
chr2	70453429	70653429	harbor1	chr2	70531545	70531668	DNA/hAT-Charlie	463	-	62	70531607	78178
chr2	70453429	70653429	harbor1	chr2	70539292	70539455	DNA/hAT-Charlie	449	-	82	70539374	85945
chr2	70453429	70653429	harbor1	chr2	70539753	70539825	DNA/hAT-Charlie	449	-	36	70539789	86360
chr2	111955709	112155709	harbor1	chr2	111959796	111959906	DNA/hAT-Charlie	569	-	55	111959851	4142
chr2	111955709	112155709	harbor1	chr2	111959891	111960141	DNA/hAT-Charlie	942	-	125	111960016	4307
chr2	111955709	112155709	harbor1	chr2	111987668	111987813	DNA/hAT-Charlie	498	-	72	111987740	32031
chr2	111955709	112155709	harbor1	chr2	112027859	112028062	DNA/hAT-Charlie	1129	-	102	112027961	72252
chr2	219077883	219277883	harbor1	chr2	219092311	219092685	DNA/hAT-Charlie	1685	-	187	219092498	14615
chr2	219077883	219277883	harbor1	chr2	219099199	219099416	DNA/hAT-Charlie	1059	-	108	219099307	21424
chr2	219077883	219277883	harbor1	chr2	219149745	219149962	DNA/hAT-Charlie	1244	-	108	219149853	71970
chr2	219077883	219277883	harbor1	chr2	219162720	219162940	DNA/hAT-Charlie	1172	-	110	219162830	84947
chr2	219077883	219277883	harbor1	chr2	219170801	219171348	DNA/hAT-Charlie	1551	-	274	219171075	93192
chr2	207668782	207868782	harbor1	chr2	207737722	207737818	DNA/hAT-Charlie	562	-	48	207737770	68988
chr2	207668782	207868782	harbor1	chr2	207737859	207738012	DNA/hAT-Charlie	3605	-	76	207737935	69153
chr2	207668782	207868782	harbor1	chr2	207738079	207738208	DNA/hAT-Charlie	3605	-	64	207738143	69361
chr2	207668782	207868782	harbor1	chr2	207738521	207738711	DNA/hAT-Charlie	3605	-	95	207738616	69834
chr2	207668782	207868782	harbor1	chr2	207739020	207739230	DNA/hAT-Charlie	3605	-	105	207739125	70343
chr2	207668782	207868782	harbor1	chr2	207739530	207740094	DNA/hAT-Charlie	3605	-	282	207739812	71030
chr2	27018955	27218955	harbor1	chr2	27020311	27020528	DNA/hAT-Charlie	542	-	108	27020419	1464
chr2	26403762	26603762	harbor1	chr2	26404112	26404190	DNA/hAT-Charlie	1468	-	39	26404151	389
chr2	26403762	26603762	harbor1	chr2	26411208	26411516	DNA/hAT-Charlie	1400	-	154	26411362	7600
chr2	26403762	26603762	harbor1	chr2	26467850	26468129	DNA/hAT-Charlie	669	-	140	26467990	64228
chr2	113484023	113684023	harbor1	chr2	113524530	113524679	DNA/hAT-Charlie	749	-	74	113524604	40581
chr2	113484023	113684023	harbor1	chr2	113562237	113562397	DNA/hAT-Charlie	668	-	80	113562317	78294
chr2	113484023	113684023	harbor1	chr2	113576022	113576407	DNA/hAT-Charlie	1586	-	192	113576214	92191
chr2	86976362	87176362	harbor1	chr2	86989844	86989901	DNA/hAT-Charlie	1025	-	28	86989872	13510
chr2	86976362	87176362	harbor1	chr2	86990052	86990365	DNA/hAT-Charlie	1025	-	156	86990208	13846
chr2	86976362	87176362	harbor1	chr2	87056392	87056732	DNA/hAT-Charlie	2117	-	170	87056562	80200
chr2	86976362	87176362	harbor1	chr2	87057442	87057549	DNA/hAT-Charlie	538	-	54	87057496	81134
chr2	26403771	26603771	harbor1	chr2	26404112	26404190	DNA/hAT-Charlie	1468	-	39	26404151	380
chr2	26403771	26603771	harbor1	chr2	26411208	26411516	DNA/hAT-Charlie	1400	-	154	26411362	7591
chr2	26403771	26603771	harbor1	chr2	26467850	26468129	DNA/hAT-Charlie	669	-	140	26467990	64219
chr2	129830912	130030912	harbor1	chr2	129924052	129924208	DNA/hAT-Charlie	1368	-	78	129924130	93218
chr2	129830912	130030912	harbor1	chr2	129924511	129924536	DNA/hAT-Charlie	1368	-	12	129924523	93611
chr2	129830912	130030912	harbor1	chr2	129924834	129924849	DNA/hAT-Charlie	1368	-	8	129924842	93930
chr2	129830912	130030912	harbor1	chr2	129925148	129925403	DNA/hAT-Charlie	1368	-	128	129925276	94364
chr2	26950298	27150298	harbor1	chr2	26960073	26960192	DNA/hAT-Charlie	675	-	60	26960133	9835
chr2	26950298	27150298	harbor1	chr2	26965832	26966004	DNA/hAT-Charlie	539	-	86	26965918	15620
chr2	26950298	27150298	harbor1	chr2	26995056	26995206	DNA/hAT-Charlie	894	-	75	26995131	44833
chr2	26950298	27150298	harbor1	chr2	26997130	26997253	DNA/hAT-Charlie	1891	-	62	26997192	46894
chr2	26950298	27150298	harbor1	chr2	26997473	26997678	DNA/hAT-Charlie	1891	-	102	26997575	47277
chr2	26950298	27150298	harbor1	chr2	27020311	27020528	DNA/hAT-Charlie	542	-	108	27020419	70121
chr2	130256054	130456054	harbor1	chr2	130258188	130258399	DNA/hAT-Charlie	693	-	106	130258294	2240
chr2	9301841	9501841	harbor1	chr2	9307129	9307302	DNA/hAT-Charlie	620	-	86	9307215	5374
chr2	9301841	9501841	harbor1	chr2	9387250	9387463	DNA/hAT-Charlie	857	-	106	9387356	85515
chr2	60880293	61080293	harbor1	chr2	60898601	60898812	DNA/hAT-Charlie	1102	-	106	60898707	18414
chr2	60880293	61080293	harbor1	chr2	60899990	60900289	DNA/hAT-Charlie	725	-	150	60900140	19847
chr2	60880293	61080293	harbor1	chr2	60951244	60951766	DNA/hAT-Charlie	3394	-	261	60951505	71212
chr2	152618050	152818050	harbor1	chr2	152646448	152646563	DNA/hAT-Charlie	503	-	58	152646506	28456
chr2	152618050	152818050	harbor1	chr2	152660890	152661040	DNA/hAT-Charlie	529	-	75	152660965	42915
chr2	152618050	152818050	harbor1	chr2	152666651	152666797	DNA/hAT-Charlie	529	-	73	152666724	48674
chr2	152618050	152818050	harbor1	chr2	152691394	152691607	DNA/hAT-Charlie	963	-	106	152691500	73450
chr2	152618050	152818050	harbor1	chr2	152666107	152666205	DNA/hAT-Charlie	487	-	49	152666156	48106
chr2	9945874	10145874	harbor1	chr2	9963183	9963365	DNA/hAT-Charlie	996	-	91	9963274	17400
chr2	9945874	10145874	harbor1	chr2	9982552	9982719	DNA/hAT-Charlie	639	-	84	9982636	36762
chr2	9945874	10145874	harbor1	chr2	9992831	9993029	DNA/hAT-Charlie	674	-	99	9992930	47056
chr2	30046187	30246187	harbor1	chr2	30050043	30050187	DNA/hAT-Charlie	675	-	72	30050115	3928
chr2	72971135	73171135	harbor1	chr2	72986955	72987103	DNA/hAT-Charlie	1843	-	74	72987029	15894
chr2	72971135	73171135	harbor1	chr2	72987408	72987475	DNA/hAT-Charlie	1843	-	34	72987442	16307
chr2	72971135	73171135	harbor1	chr2	72987786	72988021	DNA/hAT-Charlie	1843	-	118	72987904	16769
chr2	152617972	152817972	harbor1	chr2	152646448	152646563	DNA/hAT-Charlie	503	-	58	152646506	28534
chr2	152617972	152817972	harbor1	chr2	152660890	152661040	DNA/hAT-Charlie	529	-	75	152660965	42993
chr2	152617972	152817972	harbor1	chr2	152666651	152666797	DNA/hAT-Charlie	529	-	73	152666724	48752
chr2	152617972	152817972	harbor1	chr2	152691394	152691607	DNA/hAT-Charlie	963	-	106	152691500	73528
chr2	152617972	152817972	harbor1	chr2	152666107	152666205	DNA/hAT-Charlie	487	-	49	152666156	48184
chr2	72046074	72246074	harbor1	chr2	72060328	72060454	DNA/hAT-Charlie	582	-	63	72060391	14317
chr2	72046074	72246074	harbor1	chr2	72094914	72095033	DNA/hAT-Charlie	895	-	60	72094974	48900
chr2	72046074	72246074	harbor1	chr2	72095079	72095151	DNA/hAT-Charlie	895	-	36	72095115	49041
chr2	72046074	72246074	harbor1	chr2	72105609	72105779	DNA/hAT-Charlie	969	-	85	72105694	59620
chr2	72046074	72246074	harbor1	chr2	72106672	72106859	DNA/hAT-Charlie	945	-	94	72106766	60692
chr2	72046074	72246074	harbor1	chr2	72128584	72128786	DNA/hAT-Charlie	440	-	101	72128685	82611
chr2	152250414	152450414	harbor1	chr2	152264096	152264349	DNA/hAT-Charlie	540	-	126	152264222	13808
chr2	152250414	152450414	harbor1	chr2	152285482	152285817	DNA/hAT-Charlie	515	-	168	152285650	35236
chr2	152250414	152450414	harbor1	chr2	152332180	152332399	DNA/hAT-Charlie	972	-	110	152332290	81876
chr2	152250414	152450414	harbor1	chr2	152343810	152343870	DNA/hAT-Charlie	1009	-	30	152343840	93426
chr2	152250414	152450414	harbor1	chr2	152344179	152344303	DNA/hAT-Charlie	1009	-	62	152344241	93827
chr2	74415635	74615635	harbor1	chr2	74445213	74445406	DNA/hAT-Charlie	443	-	96	74445309	29674
chr2	66333430	66533430	harbor1	chr2	66376856	66377261	DNA/hAT-Charlie	1317	-	202	66377058	43628
chr2	66333430	66533430	harbor1	chr2	66377568	66377967	DNA/hAT-Charlie	1317	-	200	66377768	44338
chr2	66333430	66533430	harbor1	chr2	66378038	66378558	DNA/hAT-Charlie	814	-	260	66378298	44868
chr2	59821692	60021692	harbor1	chr2	59841544	59841867	DNA/hAT-Charlie	1468	-	162	59841706	20014
chr2	59821692	60021692	harbor1	chr2	59843486	59843692	DNA/hAT-Charlie	890	-	103	59843589	21897
chr2	59821692	60021692	harbor1	chr2	59866292	59866491	DNA/hAT-Charlie	1213	-	100	59866392	44700
chr2	59821692	60021692	harbor1	chr2	59897780	59897996	DNA/hAT-Charlie	979	-	108	59897888	76196
chr2	74415479	74615479	harbor1	chr2	74445213	74445406	DNA/hAT-Charlie	443	-	96	74445309	29830
chr2	85502391	85702391	harbor1	chr2	85522555	85522682	DNA/hAT-Charlie	3173	-	64	85522619	20228
chr2	85502391	85702391	harbor1	chr2	85522990	85523406	DNA/hAT-Charlie	3173	-	208	85523198	20807
chr2	85502391	85702391	harbor1	chr2	85559869	85560091	DNA/hAT-Charlie	1122	-	111	85559980	57589
chr2	85502391	85702391	harbor1	chr2	85562780	85562895	DNA/hAT-Charlie	609	-	58	85562838	60447
chr2	85502391	85702391	harbor1	chr2	85566471	85566635	DNA/hAT-Charlie	1644	-	82	85566553	64162
chr2	85502391	85702391	harbor1	chr2	85566933	85567177	DNA/hAT-Charlie	1644	-	122	85567055	64664
chr2	85502391	85702391	harbor1	chr2	85571047	85571261	DNA/hAT-Charlie	1133	-	107	85571154	68763
chr2	241050336	241250336	harbor1	chr2	241092357	241092476	DNA/hAT-Charlie	511	-	60	241092417	42081
chr2	241050336	241250336	harbor1	chr2	241094654	241094762	DNA/hAT-Charlie	619	-	54	241094708	44372
chr2	241050336	241250336	harbor1	chr2	241100998	241101494	DNA/hAT-Charlie	3341	-	248	241101246	50910
chr2	241050336	241250336	harbor1	chr2	241109811	241109994	DNA/hAT-Charlie	925	-	92	241109903	59567
chr2	131392202	131592202	harbor1	chr2	131404649	131404820	DNA/hAT-Charlie	1073	-	86	131404735	12533
chr2	131392202	131592202	harbor1	chr2	131404873	131405046	DNA/hAT-Charlie	933	-	86	131404959	12757
chr2	131392202	131592202	harbor1	chr2	131412431	131412629	DNA/hAT-Charlie	482	-	99	131412530	20328
chr2	131392202	131592202	harbor1	chr2	131412901	131412942	DNA/hAT-Charlie	482	-	20	131412921	20719
chr2	113177630	113377630	harbor1	chr2	113228415	113228640	DNA/hAT-Charlie	1073	-	112	113228527	50897
chr2	113177630	113377630	harbor1	chr2	113250428	113250612	DNA/hAT-Charlie	906	-	92	113250520	72890
chr2	22969090	23169090	harbor1	chr2	22977436	22977593	DNA/hAT-Charlie	882	-	78	22977514	8424
chr2	22969090	23169090	harbor1	chr2	22977606	22977828	DNA/hAT-Charlie	528	-	111	22977717	8627
chr2	22969090	23169090	harbor1	chr2	22996330	22996502	DNA/hAT-Charlie	854	-	86	22996416	27326
chr2	22969090	23169090	harbor1	chr2	23049923	23050060	DNA/hAT-Charlie	915	-	68	23049991	80901
chr2	22969090	23169090	harbor1	chr2	23050199	23050364	DNA/hAT-Charlie	915	-	82	23050281	81191
chr2	219458132	219658132	harbor1	chr2	219474769	219474792	DNA/hAT-Charlie	804	-	12	219474781	16649
chr2	219458132	219658132	harbor1	chr2	219475085	219475402	DNA/hAT-Charlie	804	-	158	219475243	17111
chr2	219458132	219658132	harbor1	chr2	219476042	219476182	DNA/hAT-Charlie	505	-	70	219476112	17980
chr2	219458132	219658132	harbor1	chr2	219520772	219521001	DNA/hAT-Charlie	530	-	114	219520886	62754
chr2	21176381	21376381	harbor1	chr2	21248210	21248394	DNA/hAT-Charlie	889	-	92	21248302	71921
chr2	26403748	26603748	harbor1	chr2	26404112	26404190	DNA/hAT-Charlie	1468	-	39	26404151	403
chr2	26403748	26603748	harbor1	chr2	26411208	26411516	DNA/hAT-Charlie	1400	-	154	26411362	7614
chr2	26403748	26603748	harbor1	chr2	26467850	26468129	DNA/hAT-Charlie	669	-	140	26467990	64242
chr2	74415451	74615451	harbor1	chr2	74445213	74445406	DNA/hAT-Charlie	443	-	96	74445309	29858
chr2	151310331	151510331	harbor1	chr2	151359322	151359386	DNA/hAT-Charlie	774	-	32	151359354	49023
chr2	151310331	151510331	harbor1	chr2	151359688	151359777	DNA/hAT-Charlie	774	-	44	151359732	49401
chr2	151310331	151510331	harbor1	chr2	151383238	151383373	DNA/hAT-Charlie	479	-	68	151383306	72975
chr2	151310331	151510331	harbor1	chr2	151383578	151383659	DNA/hAT-Charlie	744	-	40	151383618	73287
chr2	151310331	151510331	harbor1	chr2	151383944	151384183	DNA/hAT-Charlie	744	-	120	151384064	73733
chr2	237589573	237789573	harbor1	chr2	237623022	237623386	DNA/hAT-Charlie	684	-	182	237623204	33631
chr2	237589573	237789573	harbor1	chr2	237637985	237638515	DNA/hAT-Charlie	4008	-	265	237638250	48677
chr2	237589573	237789573	harbor1	chr2	237639761	237639978	DNA/hAT-Charlie	1057	-	108	237639869	50296
chr2	237589573	237789573	harbor1	chr2	237651666	237651892	DNA/hAT-Charlie	906	-	113	237651779	62206
chr2	219077865	219277865	harbor1	chr2	219092311	219092685	DNA/hAT-Charlie	1685	-	187	219092498	14633
chr2	219077865	219277865	harbor1	chr2	219099199	219099416	DNA/hAT-Charlie	1059	-	108	219099307	21442
chr2	219077865	219277865	harbor1	chr2	219149745	219149962	DNA/hAT-Charlie	1244	-	108	219149853	71988
chr2	219077865	219277865	harbor1	chr2	219162720	219162940	DNA/hAT-Charlie	1172	-	110	219162830	84965
chr2	219077865	219277865	harbor1	chr2	219170801	219171348	DNA/hAT-Charlie	1551	-	274	219171075	93210
chr2	218773740	218973740	harbor1	chr2	218784899	218785416	DNA/hAT-Charlie	3836	-	258	218785157	11417
chr2	85502849	85702849	harbor1	chr2	85522555	85522682	DNA/hAT-Charlie	3173	-	64	85522619	19770
chr2	85502849	85702849	harbor1	chr2	85522990	85523406	DNA/hAT-Charlie	3173	-	208	85523198	20349
chr2	85502849	85702849	harbor1	chr2	85559869	85560091	DNA/hAT-Charlie	1122	-	111	85559980	57131
chr2	85502849	85702849	harbor1	chr2	85562780	85562895	DNA/hAT-Charlie	609	-	58	85562838	59989
chr2	85502849	85702849	harbor1	chr2	85566471	85566635	DNA/hAT-Charlie	1644	-	82	85566553	63704
chr2	85502849	85702849	harbor1	chr2	85566933	85567177	DNA/hAT-Charlie	1644	-	122	85567055	64206
chr2	85502849	85702849	harbor1	chr2	85571047	85571261	DNA/hAT-Charlie	1133	-	107	85571154	68305
chr2	56085032	56285032	harbor1	chr2	56120094	56120222	DNA/hAT-Charlie	449	-	64	56120158	35126
chr2	56085032	56285032	harbor1	chr2	56148246	56148466	DNA/hAT-Charlie	1198	-	110	56148356	63324
chr2	56085032	56285032	harbor1	chr2	56166301	56166377	DNA/hAT-Charlie	466	-	38	56166339	81307
chr2	56085032	56285032	harbor1	chr2	56171299	56171447	DNA/hAT-Charlie	767	-	74	56171373	86341
chr2	113481247	113681247	harbor1	chr2	113524530	113524679	DNA/hAT-Charlie	749	-	74	113524604	43357
chr2	113481247	113681247	harbor1	chr2	113562237	113562397	DNA/hAT-Charlie	668	-	80	113562317	81070
chr2	113481247	113681247	harbor1	chr2	113576022	113576407	DNA/hAT-Charlie	1586	-	192	113576214	94967
chr2	45443610	45643610	harbor1	chr2	45467061	45467202	DNA/hAT-Charlie	514	-	70	45467131	23521
chr2	45443610	45643610	harbor1	chr2	45497452	45497615	DNA/hAT-Charlie	814	-	82	45497534	53924
chr2	45443610	45643610	harbor1	chr2	45536907	45537124	DNA/hAT-Charlie	761	-	108	45537015	93405
chr2	219071902	219271902	harbor1	chr2	219092311	219092685	DNA/hAT-Charlie	1685	-	187	219092498	20596
chr2	219071902	219271902	harbor1	chr2	219099199	219099416	DNA/hAT-Charlie	1059	-	108	219099307	27405
chr2	219071902	219271902	harbor1	chr2	219149745	219149962	DNA/hAT-Charlie	1244	-	108	219149853	77951
chr2	219071902	219271902	harbor1	chr2	219162720	219162940	DNA/hAT-Charlie	1172	-	110	219162830	90928
chr2	219071902	219271902	harbor1	chr2	219170801	219171348	DNA/hAT-Charlie	1551	-	274	219171075	99173
chr2	200971419	201171419	harbor1	chr2	200971776	200971932	DNA/hAT-Charlie	550	-	78	200971854	435
chr2	200971419	201171419	harbor1	chr2	201040346	201040485	DNA/hAT-Charlie	657	-	70	201040416	68997
chr2	200971419	201171419	harbor1	chr2	201040785	201040932	DNA/hAT-Charlie	657	-	74	201040859	69440
chr2	200971419	201171419	harbor1	chr2	201056844	201057020	DNA/hAT-Charlie	815	-	88	201056932	85513
chr2	72971209	73171209	harbor1	chr2	72986955	72987103	DNA/hAT-Charlie	1843	-	74	72987029	15820
chr2	72971209	73171209	harbor1	chr2	72987408	72987475	DNA/hAT-Charlie	1843	-	34	72987442	16233
chr2	72971209	73171209	harbor1	chr2	72987786	72988021	DNA/hAT-Charlie	1843	-	118	72987904	16695
chr2	158791034	158991034	harbor1	chr2	158792905	158793106	DNA/hAT-Charlie	882	-	100	158793005	1971
chr2	158791034	158991034	harbor1	chr2	158844342	158844464	DNA/hAT-Charlie	533	-	61	158844403	53369
chr2	26950213	27150213	harbor1	chr2	26960073	26960192	DNA/hAT-Charlie	675	-	60	26960133	9920
chr2	26950213	27150213	harbor1	chr2	26965832	26966004	DNA/hAT-Charlie	539	-	86	26965918	15705
chr2	26950213	27150213	harbor1	chr2	26995056	26995206	DNA/hAT-Charlie	894	-	75	26995131	44918
chr2	26950213	27150213	harbor1	chr2	26997130	26997253	DNA/hAT-Charlie	1891	-	62	26997192	46979
chr2	26950213	27150213	harbor1	chr2	26997473	26997678	DNA/hAT-Charlie	1891	-	102	26997575	47362
chr2	26950213	27150213	harbor1	chr2	27020311	27020528	DNA/hAT-Charlie	542	-	108	27020419	70206
chr2	74415403	74615403	harbor1	chr2	74445213	74445406	DNA/hAT-Charlie	443	-	96	74445309	29906
chr2	42971427	43171427	harbor1	chr2	42997161	42997338	DNA/hAT-Charlie	1375	-	88	42997249	25822
chr2	42971427	43171427	harbor1	chr2	42997647	42997745	DNA/hAT-Charlie	1375	-	49	42997696	26269
chr2	42971427	43171427	harbor1	chr2	42998055	42998155	DNA/hAT-Charlie	1375	-	50	42998105	26678
chr2	42971427	43171427	harbor1	chr2	42998469	42998796	DNA/hAT-Charlie	1375	-	164	42998633	27206
chr2	42971427	43171427	harbor1	chr2	43045162	43045365	DNA/hAT-Charlie	484	-	102	43045264	73837
chr2	42971427	43171427	harbor1	chr2	43070520	43070718	DNA/hAT-Charlie	505	-	99	43070619	99192
chr2	74405689	74605689	harbor1	chr2	74445213	74445406	DNA/hAT-Charlie	443	-	96	74445309	39620
chr2	72043426	72243426	harbor1	chr2	72060328	72060454	DNA/hAT-Charlie	582	-	63	72060391	16965
chr2	72043426	72243426	harbor1	chr2	72094914	72095033	DNA/hAT-Charlie	895	-	60	72094974	51548
chr2	72043426	72243426	harbor1	chr2	72095079	72095151	DNA/hAT-Charlie	895	-	36	72095115	51689
chr2	72043426	72243426	harbor1	chr2	72105609	72105779	DNA/hAT-Charlie	969	-	85	72105694	62268
chr2	72043426	72243426	harbor1	chr2	72106672	72106859	DNA/hAT-Charlie	945	-	94	72106766	63340
chr2	72043426	72243426	harbor1	chr2	72128584	72128786	DNA/hAT-Charlie	440	-	101	72128685	85259
chr2	156336151	156536151	harbor1	chr2	156389937	156390036	DNA/hAT-Charlie	506	-	50	156389987	53836
chr2	156336151	156536151	harbor1	chr2	156394022	156394296	DNA/hAT-Charlie	1229	-	137	156394159	58008
chr2	156336151	156536151	harbor1	chr2	156396924	156397058	DNA/hAT-Charlie	585	-	67	156396991	60840
chr2	156336151	156536151	harbor1	chr2	156421020	156421167	DNA/hAT-Charlie	752	-	74	156421094	84943
chr2	156336151	156536151	harbor1	chr2	156434751	156434919	DNA/hAT-Charlie	789	-	84	156434835	98684
chr2	111023146	111223146	harbor1	chr2	111072610	111072801	DNA/hAT-Charlie	668	-	96	111072706	49560
chr2	111023146	111223146	harbor1	chr2	111098211	111098436	DNA/hAT-Charlie	1462	-	112	111098323	75177
chr2	66131385	66331385	harbor1	chr2	66174791	66174957	DNA/hAT-Charlie	663	-	83	66174874	43489
chr2	66131385	66331385	harbor1	chr2	66218694	66218846	DNA/hAT-Charlie	659	-	76	66218770	87385
chr2	108438378	108638378	harbor1	chr2	108492331	108492518	DNA/hAT-Charlie	494	-	94	108492425	54047
chr2	108438378	108638378	harbor1	chr2	108534908	108536013	DNA/hAT-Charlie	3361	-	552	108535460	97082
chr2	108438378	108638378	harbor1	chr2	108537033	108537292	DNA/hAT-Charlie	985	-	130	108537163	98785
chr2	113454958	113654958	harbor1	chr2	113524530	113524679	DNA/hAT-Charlie	749	-	74	113524604	69646
chr2	112640558	112840558	harbor1	chr2	112676316	112676456	DNA/hAT-Charlie	495	-	70	112676386	35828
chr2	112640558	112840558	harbor1	chr2	112685511	112685594	DNA/hAT-Charlie	1145	-	42	112685553	44995
chr2	112640558	112840558	harbor1	chr2	112685892	112685916	DNA/hAT-Charlie	1145	-	12	112685904	45346
chr2	112640558	112840558	harbor1	chr2	112686201	112686423	DNA/hAT-Charlie	1145	-	111	112686312	45754
chr2	112640558	112840558	harbor1	chr2	112705347	112705613	DNA/hAT-Charlie	574	-	133	112705480	64922
chr2	113484018	113684018	harbor1	chr2	113524530	113524679	DNA/hAT-Charlie	749	-	74	113524604	40586
chr2	113484018	113684018	harbor1	chr2	113562237	113562397	DNA/hAT-Charlie	668	-	80	113562317	78299
chr2	113484018	113684018	harbor1	chr2	113576022	113576407	DNA/hAT-Charlie	1586	-	192	113576214	92196
chr2	69729666	69929666	harbor1	chr2	69747487	69747646	DNA/hAT-Charlie	670	-	80	69747567	17901
chr2	69729666	69929666	harbor1	chr2	69754559	69754704	DNA/hAT-Charlie	860	-	72	69754631	24965
chr2	69729666	69929666	harbor1	chr2	69761040	69761544	DNA/hAT-Charlie	2215	-	252	69761292	31626
chr2	69729666	69929666	harbor1	chr2	69761542	69761639	DNA/hAT-Charlie	1926	-	48	69761590	31924
chr2	69729666	69929666	harbor1	chr2	69761793	69762204	DNA/hAT-Charlie	1926	-	206	69761999	32333
chr2	69729666	69929666	harbor1	chr2	69776644	69776863	DNA/hAT-Charlie	1659	-	110	69776754	47088
chr2	69729666	69929666	harbor1	chr2	69777868	69778181	DNA/hAT-Charlie	1423	-	156	69778024	48358
chr2	69729666	69929666	harbor1	chr2	69780094	69780190	DNA/hAT-Charlie	641	-	48	69780142	50476
chr2	69729666	69929666	harbor1	chr2	69780496	69780569	DNA/hAT-Charlie	641	-	36	69780532	50866
chr2	69729666	69929666	harbor1	chr2	69805734	69806162	DNA/hAT-Charlie	1913	-	214	69805948	76282
chr2	69729666	69929666	harbor1	chr2	69806172	69806336	DNA/hAT-Charlie	891	-	82	69806254	76588
chr2	219392988	219592988	harbor1	chr2	219393057	219393276	DNA/hAT-Charlie	1517	-	110	219393167	179
chr2	219392988	219592988	harbor1	chr2	219399383	219399543	DNA/hAT-Charlie	458	-	80	219399463	6475
chr2	219392988	219592988	harbor1	chr2	219474769	219474792	DNA/hAT-Charlie	804	-	12	219474781	81793
chr2	219392988	219592988	harbor1	chr2	219475085	219475402	DNA/hAT-Charlie	804	-	158	219475243	82255
chr2	219392988	219592988	harbor1	chr2	219476042	219476182	DNA/hAT-Charlie	505	-	70	219476112	83124
chr2	64294495	64494495	harbor1	chr2	64316761	64316959	DNA/hAT-Charlie	1056	-	99	64316860	22365
chr2	64294495	64494495	harbor1	chr2	64318700	64318859	DNA/hAT-Charlie	621	-	80	64318780	24285
chr2	64294495	64494495	harbor1	chr2	64335318	64335644	DNA/hAT-Charlie	1530	-	163	64335481	40986
chr2	64294495	64494495	harbor1	chr2	64336664	64336889	DNA/hAT-Charlie	850	-	112	64336776	42281
chr2	64294495	64494495	harbor1	chr2	64358186	64358355	DNA/hAT-Charlie	801	-	84	64358270	63775
chr2	85502856	85702856	harbor1	chr2	85522555	85522682	DNA/hAT-Charlie	3173	-	64	85522619	19763
chr2	85502856	85702856	harbor1	chr2	85522990	85523406	DNA/hAT-Charlie	3173	-	208	85523198	20342
chr2	85502856	85702856	harbor1	chr2	85559869	85560091	DNA/hAT-Charlie	1122	-	111	85559980	57124
chr2	85502856	85702856	harbor1	chr2	85562780	85562895	DNA/hAT-Charlie	609	-	58	85562838	59982
chr2	85502856	85702856	harbor1	chr2	85566471	85566635	DNA/hAT-Charlie	1644	-	82	85566553	63697
chr2	85502856	85702856	harbor1	chr2	85566933	85567177	DNA/hAT-Charlie	1644	-	122	85567055	64199
chr2	85502856	85702856	harbor1	chr2	85571047	85571261	DNA/hAT-Charlie	1133	-	107	85571154	68298
chr2	74415978	74615978	harbor1	chr2	74445213	74445406	DNA/hAT-Charlie	443	-	96	74445309	29331
chr2	2132316	2332316	harbor1	chr2	2148196	2148529	DNA/hAT-Charlie	1921	-	166	2148362	16046
chr2	2132316	2332316	harbor1	chr2	2208657	2208999	DNA/hAT-Charlie	759	-	171	2208828	76512
chr2	2132316	2332316	harbor1	chr2	2209026	2209144	DNA/hAT-Charlie	759	-	59	2209085	76769
chr2	2132316	2332316	harbor1	chr2	2211202	2211525	DNA/hAT-Charlie	1097	-	162	2211364	79048
chr2	2132316	2332316	harbor1	chr2	2211836	2211943	DNA/hAT-Charlie	1097	-	54	2211890	79574
chr2	219060085	219260085	harbor1	chr2	219092311	219092685	DNA/hAT-Charlie	1685	-	187	219092498	32413
chr2	219060085	219260085	harbor1	chr2	219099199	219099416	DNA/hAT-Charlie	1059	-	108	219099307	39222
chr2	219060085	219260085	harbor1	chr2	219149745	219149962	DNA/hAT-Charlie	1244	-	108	219149853	89768
chr2	43054951	43254951	harbor1	chr2	43070520	43070718	DNA/hAT-Charlie	505	-	99	43070619	15668
chr2	43054951	43254951	harbor1	chr2	43126015	43126233	DNA/hAT-Charlie	1255	-	109	43126124	71173
chr2	204956154	205156154	harbor1	chr2	205013475	205013619	DNA/hAT-Charlie	499	-	72	205013547	57393
chr2	95924862	96124862	harbor1	chr2	95984208	95984431	DNA/hAT-Charlie	469	-	112	95984320	59458
chr2	95924862	96124862	harbor1	chr2	96016772	96016799	DNA/hAT-Charlie	622	-	14	96016786	91924
chr2	95924862	96124862	harbor1	chr2	96017166	96017337	DNA/hAT-Charlie	622	-	86	96017252	92390
chr2	89546776	89746776	harbor1	chr2	89555316	89555516	DNA/hAT-Charlie	966	-	100	89555416	8640
chr2	89546776	89746776	harbor1	chr2	89606679	89606883	DNA/hAT-Charlie	780	-	102	89606781	60005
chr2	89546776	89746776	harbor1	chr2	89628382	89628599	DNA/hAT-Charlie	739	-	108	89628490	81714
chr2	74415961	74615961	harbor1	chr2	74445213	74445406	DNA/hAT-Charlie	443	-	96	74445309	29348
chr2	239594717	239794717	harbor1	chr2	239604382	239606456	DNA/hAT-Charlie	7300	-	1037	239605419	10702
chr2	239594717	239794717	harbor1	chr2	239626312	239626525	DNA/hAT-Charlie	897	-	106	239626418	31701
chr2	219060809	219260809	harbor1	chr2	219092311	219092685	DNA/hAT-Charlie	1685	-	187	219092498	31689
chr2	219060809	219260809	harbor1	chr2	219099199	219099416	DNA/hAT-Charlie	1059	-	108	219099307	38498
chr2	219060809	219260809	harbor1	chr2	219149745	219149962	DNA/hAT-Charlie	1244	-	108	219149853	89044
chr2	119120408	119320408	harbor1	chr2	119184412	119185166	DNA/hAT-Charlie	2047	-	377	119184789	64381
chr2	119120408	119320408	harbor1	chr2	119219532	119219658	DNA/hAT-Charlie	488	-	63	119219595	99187
chr2	60966422	61166422	harbor1	chr2	60980859	60980896	DNA/hAT-Charlie	1982	-	18	60980877	14455
chr2	60966422	61166422	harbor1	chr2	60981582	60981939	DNA/hAT-Charlie	1982	-	178	60981760	15338
chr2	60966422	61166422	harbor1	chr2	60981193	60981292	DNA/hAT-Charlie	1982	-	50	60981243	14821
chr2	74415475	74615475	harbor1	chr2	74445213	74445406	DNA/hAT-Charlie	443	-	96	74445309	29834
chr2	74415962	74615962	harbor1	chr2	74445213	74445406	DNA/hAT-Charlie	443	-	96	74445309	29347
chr2	232203322	232403322	harbor1	chr2	232206339	232206648	DNA/hAT-Charlie	1195	-	154	232206493	3171
chr2	232203322	232403322	harbor1	chr2	232214071	232214235	DNA/hAT-Charlie	452	-	82	232214153	10831
chr2	232203322	232403322	harbor1	chr2	232252447	232252618	DNA/hAT-Charlie	734	-	86	232252533	49211
chr2	232203322	232403322	harbor1	chr2	232252988	232253444	DNA/hAT-Charlie	1168	-	228	232253216	49894
chr2	232203322	232403322	harbor1	chr2	232263977	232264309	DNA/hAT-Charlie	2146	-	166	232264143	60821
chr2	232203322	232403322	harbor1	chr2	232268428	232268748	DNA/hAT-Charlie	1629	-	160	232268588	65266
chr2	232203322	232403322	harbor1	chr2	232274671	232274930	DNA/hAT-Charlie	765	-	130	232274801	71479
chr2	53759983	53959983	harbor1	chr2	53767030	53767169	DNA/hAT-Charlie	457	-	70	53767100	7117
chr2	43126586	43326586	harbor1	chr2	43186443	43186533	DNA/hAT-Charlie	445	-	45	43186488	59902
chr2	97589114	97789114	harbor1	chr2	97609742	97609822	DNA/hAT-Charlie	1125	-	40	97609782	20668
chr2	97589114	97789114	harbor1	chr2	97610132	97610361	DNA/hAT-Charlie	1125	-	114	97610246	21132
chr2	72971106	73171106	harbor1	chr2	72986955	72987103	DNA/hAT-Charlie	1843	-	74	72987029	15923
chr2	72971106	73171106	harbor1	chr2	72987408	72987475	DNA/hAT-Charlie	1843	-	34	72987442	16336
chr2	72971106	73171106	harbor1	chr2	72987786	72988021	DNA/hAT-Charlie	1843	-	118	72987904	16798
chr2	26957504	27157504	harbor1	chr2	26960073	26960192	DNA/hAT-Charlie	675	-	60	26960133	2629
chr2	26957504	27157504	harbor1	chr2	26965832	26966004	DNA/hAT-Charlie	539	-	86	26965918	8414
chr2	26957504	27157504	harbor1	chr2	26995056	26995206	DNA/hAT-Charlie	894	-	75	26995131	37627
chr2	26957504	27157504	harbor1	chr2	26997130	26997253	DNA/hAT-Charlie	1891	-	62	26997192	39688
chr2	26957504	27157504	harbor1	chr2	26997473	26997678	DNA/hAT-Charlie	1891	-	102	26997575	40071
chr2	26957504	27157504	harbor1	chr2	27020311	27020528	DNA/hAT-Charlie	542	-	108	27020419	62915
chr2	28770576	28970576	harbor1	chr2	28866331	28866669	DNA/hAT-Charlie	2128	-	169	28866500	95924
chr2	43055485	43255485	harbor1	chr2	43070520	43070718	DNA/hAT-Charlie	505	-	99	43070619	15134
chr2	43055485	43255485	harbor1	chr2	43126015	43126233	DNA/hAT-Charlie	1255	-	109	43126124	70639
chr2	219458026	219658026	harbor1	chr2	219474769	219474792	DNA/hAT-Charlie	804	-	12	219474781	16755
chr2	219458026	219658026	harbor1	chr2	219475085	219475402	DNA/hAT-Charlie	804	-	158	219475243	17217
chr2	219458026	219658026	harbor1	chr2	219476042	219476182	DNA/hAT-Charlie	505	-	70	219476112	18086
chr2	219458026	219658026	harbor1	chr2	219520772	219521001	DNA/hAT-Charlie	530	-	114	219520886	62860
chr2	43118487	43318487	harbor1	chr2	43126015	43126233	DNA/hAT-Charlie	1255	-	109	43126124	7637
chr2	43118487	43318487	harbor1	chr2	43186443	43186533	DNA/hAT-Charlie	445	-	45	43186488	68001
chr2	60966462	61166462	harbor1	chr2	60980859	60980896	DNA/hAT-Charlie	1982	-	18	60980877	14415
chr2	60966462	61166462	harbor1	chr2	60981582	60981939	DNA/hAT-Charlie	1982	-	178	60981760	15298
chr2	60966462	61166462	harbor1	chr2	60981193	60981292	DNA/hAT-Charlie	1982	-	50	60981243	14781
chr2	72856127	73056127	harbor1	chr2	72912916	72913154	DNA/hAT-Charlie	717	-	119	72913035	56908
chr2	236586213	236786213	harbor1	chr2	236611327	236611696	DNA/hAT-Charlie	861	-	184	236611511	25298
chr2	236586213	236786213	harbor1	chr2	236647673	236647875	DNA/hAT-Charlie	1078	-	101	236647774	61561
chr2	236586213	236786213	harbor1	chr2	236674146	236674467	DNA/hAT-Charlie	1905	-	160	236674306	88093
chr2	24693648	24893648	harbor1	chr2	24711421	24711678	DNA/hAT-Charlie	561	-	128	24711549	17901
chr2	24693648	24893648	harbor1	chr2	24736671	24736884	DNA/hAT-Charlie	1104	-	106	24736777	43129
chr2	24693648	24893648	harbor1	chr2	24738588	24738791	DNA/hAT-Charlie	609	-	102	24738690	45042
chr2	24693648	24893648	harbor1	chr2	24743129	24744717	DNA/hAT-Charlie	3943	-	794	24743923	50275
chr2	24693648	24893648	harbor1	chr2	24744921	24745112	DNA/hAT-Charlie	3943	-	96	24745017	51369
chr2	24693648	24893648	harbor1	chr2	24785896	24786005	DNA/hAT-Charlie	562	-	54	24785950	92302
chr2	217614103	217814103	harbor1	chr2	217619964	217620279	DNA/hAT-Charlie	856	-	158	217620122	6019
chr2	217614103	217814103	harbor1	chr2	217626388	217626625	DNA/hAT-Charlie	503	-	118	217626506	12403
chr2	217614103	217814103	harbor1	chr2	217643385	217643578	DNA/hAT-Charlie	718	-	96	217643481	29378
chr2	217614103	217814103	harbor1	chr2	217670554	217670756	DNA/hAT-Charlie	858	-	101	217670655	56552
chr2	160393135	160593135	harbor1	chr2	160457644	160457873	DNA/hAT-Charlie	519	-	114	160457758	64623
chr2	94934942	95134942	harbor1	chr2	95002341	95002642	DNA/hAT-Charlie	799	-	150	95002491	67549
chr2	94934942	95134942	harbor1	chr2	95015749	95015976	DNA/hAT-Charlie	502	-	114	95015863	80921
chr2	97564374	97764374	harbor1	chr2	97609742	97609822	DNA/hAT-Charlie	1125	-	40	97609782	45408
chr2	97564374	97764374	harbor1	chr2	97610132	97610361	DNA/hAT-Charlie	1125	-	114	97610246	45872
chr2	111955759	112155759	harbor1	chr2	111959796	111959906	DNA/hAT-Charlie	569	-	55	111959851	4092
chr2	111955759	112155759	harbor1	chr2	111959891	111960141	DNA/hAT-Charlie	942	-	125	111960016	4257
chr2	111955759	112155759	harbor1	chr2	111987668	111987813	DNA/hAT-Charlie	498	-	72	111987740	31981
chr2	111955759	112155759	harbor1	chr2	112027859	112028062	DNA/hAT-Charlie	1129	-	102	112027961	72202
chr2	112779792	112979792	harbor1	chr2	112840817	112840933	DNA/hAT-Charlie	500	-	58	112840875	61083
chr2	112779792	112979792	harbor1	chr2	112867818	112867970	DNA/hAT-Charlie	511	-	76	112867894	88102
chr2	26403834	26603834	harbor1	chr2	26404112	26404190	DNA/hAT-Charlie	1468	-	39	26404151	317
chr2	26403834	26603834	harbor1	chr2	26411208	26411516	DNA/hAT-Charlie	1400	-	154	26411362	7528
chr2	26403834	26603834	harbor1	chr2	26467850	26468129	DNA/hAT-Charlie	669	-	140	26467990	64156
chr2	219077829	219277829	harbor1	chr2	219092311	219092685	DNA/hAT-Charlie	1685	-	187	219092498	14669
chr2	219077829	219277829	harbor1	chr2	219099199	219099416	DNA/hAT-Charlie	1059	-	108	219099307	21478
chr2	219077829	219277829	harbor1	chr2	219149745	219149962	DNA/hAT-Charlie	1244	-	108	219149853	72024
chr2	219077829	219277829	harbor1	chr2	219162720	219162940	DNA/hAT-Charlie	1172	-	110	219162830	85001
chr2	219077829	219277829	harbor1	chr2	219170801	219171348	DNA/hAT-Charlie	1551	-	274	219171075	93246
chr2	26950239	27150239	harbor1	chr2	26960073	26960192	DNA/hAT-Charlie	675	-	60	26960133	9894
chr2	26950239	27150239	harbor1	chr2	26965832	26966004	DNA/hAT-Charlie	539	-	86	26965918	15679
chr2	26950239	27150239	harbor1	chr2	26995056	26995206	DNA/hAT-Charlie	894	-	75	26995131	44892
chr2	26950239	27150239	harbor1	chr2	26997130	26997253	DNA/hAT-Charlie	1891	-	62	26997192	46953
chr2	26950239	27150239	harbor1	chr2	26997473	26997678	DNA/hAT-Charlie	1891	-	102	26997575	47336
chr2	26950239	27150239	harbor1	chr2	27020311	27020528	DNA/hAT-Charlie	542	-	108	27020419	70180
chr2	217726903	217926903	harbor1	chr2	217734610	217734623	DNA/hAT-Charlie	1791	-	6	217734616	7713
chr2	217726903	217926903	harbor1	chr2	217734998	217735307	DNA/hAT-Charlie	1791	-	154	217735152	8249
chr2	217726903	217926903	harbor1	chr2	217751567	217751758	DNA/hAT-Charlie	545	-	96	217751663	24760
chr2	217726903	217926903	harbor1	chr2	217762127	217762461	DNA/hAT-Charlie	2298	-	167	217762294	35391
chr2	217726903	217926903	harbor1	chr2	217784672	217784872	DNA/hAT-Charlie	745	-	100	217784772	57869
chr2	217726903	217926903	harbor1	chr2	217796612	217796765	DNA/hAT-Charlie	547	-	76	217796688	69785
chr2	217726903	217926903	harbor1	chr2	217807087	217807394	DNA/hAT-Charlie	654	-	154	217807241	80338
chr2	217726903	217926903	harbor1	chr2	217814316	217814528	DNA/hAT-Charlie	971	-	106	217814422	87519
chr2	217726903	217926903	harbor1	chr2	217823167	217823342	DNA/hAT-Charlie	705	-	88	217823255	96352
chr2	217726903	217926903	harbor1	chr2	217824014	217824226	DNA/hAT-Charlie	858	-	106	217824120	97217
chr3	127489937	127689937	harbor1	chr3	127534897	127535192	DNA/hAT-Charlie	936	-	148	127535045	45108
chr3	127489937	127689937	harbor1	chr3	127556022	127556263	DNA/hAT-Charlie	800	-	120	127556142	66205
chr3	127489937	127689937	harbor1	chr3	127556582	127556712	DNA/hAT-Charlie	768	-	65	127556647	66710
chr3	127489937	127689937	harbor1	chr3	127562699	127562813	DNA/hAT-Charlie	544	-	57	127562756	72819
chr3	127489937	127689937	harbor1	chr3	127562819	127563029	DNA/hAT-Charlie	739	-	105	127562924	72987
chr3	127489937	127689937	harbor1	chr3	127549313	127549528	DNA/hAT-Charlie	812	-	108	127549421	59484
chr3	138334620	138534620	harbor1	chr3	138372017	138372218	DNA/hAT-Charlie	1001	-	100	138372117	37497
chr3	138334620	138534620	harbor1	chr3	138376542	138376714	DNA/hAT-Charlie	602	-	86	138376628	42008
chr3	138334620	138534620	harbor1	chr3	138411094	138411269	DNA/hAT-Charlie	658	-	88	138411182	76562
chr3	138334620	138534620	harbor1	chr3	138412408	138412562	DNA/hAT-Charlie	583	-	77	138412485	77865
chr3	49586786	49786786	harbor1	chr3	49623867	49623995	DNA/hAT-Charlie	565	-	64	49623931	37145
chr3	107991341	108191341	harbor1	chr3	107991855	107992015	DNA/hAT-Charlie	706	-	80	107991935	594
chr3	107991341	108191341	harbor1	chr3	108007310	108007351	DNA/hAT-Charlie	663	-	20	108007330	15989
chr3	107991341	108191341	harbor1	chr3	108007678	108007808	DNA/hAT-Charlie	663	-	65	108007743	16402
chr3	107991341	108191341	harbor1	chr3	108033460	108033658	DNA/hAT-Charlie	485	-	99	108033559	42218
chr3	107991341	108191341	harbor1	chr3	108033655	108033824	DNA/hAT-Charlie	482	-	84	108033739	42398
chr3	107991341	108191341	harbor1	chr3	108061139	108061306	DNA/hAT-Charlie	524	-	84	108061223	69882
chr3	107991308	108191308	harbor1	chr3	107991855	107992015	DNA/hAT-Charlie	706	-	80	107991935	627
chr3	107991308	108191308	harbor1	chr3	108007310	108007351	DNA/hAT-Charlie	663	-	20	108007330	16022
chr3	107991308	108191308	harbor1	chr3	108007678	108007808	DNA/hAT-Charlie	663	-	65	108007743	16435
chr3	107991308	108191308	harbor1	chr3	108033460	108033658	DNA/hAT-Charlie	485	-	99	108033559	42251
chr3	107991308	108191308	harbor1	chr3	108033655	108033824	DNA/hAT-Charlie	482	-	84	108033739	42431
chr3	107991308	108191308	harbor1	chr3	108061139	108061306	DNA/hAT-Charlie	524	-	84	108061223	69915
chr3	107991371	108191371	harbor1	chr3	107991855	107992015	DNA/hAT-Charlie	706	-	80	107991935	564
chr3	107991371	108191371	harbor1	chr3	108007310	108007351	DNA/hAT-Charlie	663	-	20	108007330	15959
chr3	107991371	108191371	harbor1	chr3	108007678	108007808	DNA/hAT-Charlie	663	-	65	108007743	16372
chr3	107991371	108191371	harbor1	chr3	108033460	108033658	DNA/hAT-Charlie	485	-	99	108033559	42188
chr3	107991371	108191371	harbor1	chr3	108033655	108033824	DNA/hAT-Charlie	482	-	84	108033739	42368
chr3	107991371	108191371	harbor1	chr3	108061139	108061306	DNA/hAT-Charlie	524	-	84	108061223	69852
chr3	107991316	108191316	harbor1	chr3	107991855	107992015	DNA/hAT-Charlie	706	-	80	107991935	619
chr3	107991316	108191316	harbor1	chr3	108007310	108007351	DNA/hAT-Charlie	663	-	20	108007330	16014
chr3	107991316	108191316	harbor1	chr3	108007678	108007808	DNA/hAT-Charlie	663	-	65	108007743	16427
chr3	107991316	108191316	harbor1	chr3	108033460	108033658	DNA/hAT-Charlie	485	-	99	108033559	42243
chr3	107991316	108191316	harbor1	chr3	108033655	108033824	DNA/hAT-Charlie	482	-	84	108033739	42423
chr3	107991316	108191316	harbor1	chr3	108061139	108061306	DNA/hAT-Charlie	524	-	84	108061223	69907
chr3	9817202	10017202	harbor1	chr3	9877703	9877860	DNA/hAT-Charlie	656	-	78	9877781	60579
chr3	9817202	10017202	harbor1	chr3	9883731	9883917	DNA/hAT-Charlie	823	-	93	9883824	66622
chr3	9817202	10017202	harbor1	chr3	9912433	9912700	DNA/hAT-Charlie	442	-	134	9912567	95365
chr3	107991276	108191276	harbor1	chr3	107991855	107992015	DNA/hAT-Charlie	706	-	80	107991935	659
chr3	107991276	108191276	harbor1	chr3	108007310	108007351	DNA/hAT-Charlie	663	-	20	108007330	16054
chr3	107991276	108191276	harbor1	chr3	108007678	108007808	DNA/hAT-Charlie	663	-	65	108007743	16467
chr3	107991276	108191276	harbor1	chr3	108033460	108033658	DNA/hAT-Charlie	485	-	99	108033559	42283
chr3	107991276	108191276	harbor1	chr3	108033655	108033824	DNA/hAT-Charlie	482	-	84	108033739	42463
chr3	107991276	108191276	harbor1	chr3	108061139	108061306	DNA/hAT-Charlie	524	-	84	108061223	69947
chr3	107991357	108191357	harbor1	chr3	107991855	107992015	DNA/hAT-Charlie	706	-	80	107991935	578
chr3	107991357	108191357	harbor1	chr3	108007310	108007351	DNA/hAT-Charlie	663	-	20	108007330	15973
chr3	107991357	108191357	harbor1	chr3	108007678	108007808	DNA/hAT-Charlie	663	-	65	108007743	16386
chr3	107991357	108191357	harbor1	chr3	108033460	108033658	DNA/hAT-Charlie	485	-	99	108033559	42202
chr3	107991357	108191357	harbor1	chr3	108033655	108033824	DNA/hAT-Charlie	482	-	84	108033739	42382
chr3	107991357	108191357	harbor1	chr3	108061139	108061306	DNA/hAT-Charlie	524	-	84	108061223	69866
chr3	107991312	108191312	harbor1	chr3	107991855	107992015	DNA/hAT-Charlie	706	-	80	107991935	623
chr3	107991312	108191312	harbor1	chr3	108007310	108007351	DNA/hAT-Charlie	663	-	20	108007330	16018
chr3	107991312	108191312	harbor1	chr3	108007678	108007808	DNA/hAT-Charlie	663	-	65	108007743	16431
chr3	107991312	108191312	harbor1	chr3	108033460	108033658	DNA/hAT-Charlie	485	-	99	108033559	42247
chr3	107991312	108191312	harbor1	chr3	108033655	108033824	DNA/hAT-Charlie	482	-	84	108033739	42427
chr3	107991312	108191312	harbor1	chr3	108061139	108061306	DNA/hAT-Charlie	524	-	84	108061223	69911
chr3	107991310	108191310	harbor1	chr3	107991855	107992015	DNA/hAT-Charlie	706	-	80	107991935	625
chr3	107991310	108191310	harbor1	chr3	108007310	108007351	DNA/hAT-Charlie	663	-	20	108007330	16020
chr3	107991310	108191310	harbor1	chr3	108007678	108007808	DNA/hAT-Charlie	663	-	65	108007743	16433
chr3	107991310	108191310	harbor1	chr3	108033460	108033658	DNA/hAT-Charlie	485	-	99	108033559	42249
chr3	107991310	108191310	harbor1	chr3	108033655	108033824	DNA/hAT-Charlie	482	-	84	108033739	42429
chr3	107991310	108191310	harbor1	chr3	108061139	108061306	DNA/hAT-Charlie	524	-	84	108061223	69913
chr3	107991337	108191337	harbor1	chr3	107991855	107992015	DNA/hAT-Charlie	706	-	80	107991935	598
chr3	107991337	108191337	harbor1	chr3	108007310	108007351	DNA/hAT-Charlie	663	-	20	108007330	15993
chr3	107991337	108191337	harbor1	chr3	108007678	108007808	DNA/hAT-Charlie	663	-	65	108007743	16406
chr3	107991337	108191337	harbor1	chr3	108033460	108033658	DNA/hAT-Charlie	485	-	99	108033559	42222
chr3	107991337	108191337	harbor1	chr3	108033655	108033824	DNA/hAT-Charlie	482	-	84	108033739	42402
chr3	107991337	108191337	harbor1	chr3	108061139	108061306	DNA/hAT-Charlie	524	-	84	108061223	69886
chr3	107991338	108191338	harbor1	chr3	107991855	107992015	DNA/hAT-Charlie	706	-	80	107991935	597
chr3	107991338	108191338	harbor1	chr3	108007310	108007351	DNA/hAT-Charlie	663	-	20	108007330	15992
chr3	107991338	108191338	harbor1	chr3	108007678	108007808	DNA/hAT-Charlie	663	-	65	108007743	16405
chr3	107991338	108191338	harbor1	chr3	108033460	108033658	DNA/hAT-Charlie	485	-	99	108033559	42221
chr3	107991338	108191338	harbor1	chr3	108033655	108033824	DNA/hAT-Charlie	482	-	84	108033739	42401
chr3	107991338	108191338	harbor1	chr3	108061139	108061306	DNA/hAT-Charlie	524	-	84	108061223	69885
chr3	107991370	108191370	harbor1	chr3	107991855	107992015	DNA/hAT-Charlie	706	-	80	107991935	565
chr3	107991370	108191370	harbor1	chr3	108007310	108007351	DNA/hAT-Charlie	663	-	20	108007330	15960
chr3	107991370	108191370	harbor1	chr3	108007678	108007808	DNA/hAT-Charlie	663	-	65	108007743	16373
chr3	107991370	108191370	harbor1	chr3	108033460	108033658	DNA/hAT-Charlie	485	-	99	108033559	42189
chr3	107991370	108191370	harbor1	chr3	108033655	108033824	DNA/hAT-Charlie	482	-	84	108033739	42369
chr3	107991370	108191370	harbor1	chr3	108061139	108061306	DNA/hAT-Charlie	524	-	84	108061223	69853
chr3	107991302	108191302	harbor1	chr3	107991855	107992015	DNA/hAT-Charlie	706	-	80	107991935	633
chr3	107991302	108191302	harbor1	chr3	108007310	108007351	DNA/hAT-Charlie	663	-	20	108007330	16028
chr3	107991302	108191302	harbor1	chr3	108007678	108007808	DNA/hAT-Charlie	663	-	65	108007743	16441
chr3	107991302	108191302	harbor1	chr3	108033460	108033658	DNA/hAT-Charlie	485	-	99	108033559	42257
chr3	107991302	108191302	harbor1	chr3	108033655	108033824	DNA/hAT-Charlie	482	-	84	108033739	42437
chr3	107991302	108191302	harbor1	chr3	108061139	108061306	DNA/hAT-Charlie	524	-	84	108061223	69921
chr3	156989205	157189205	harbor1	chr3	157009119	157009424	DNA/hAT-Charlie	1051	-	152	157009271	20066
chr3	156989205	157189205	harbor1	chr3	157017068	157017216	DNA/hAT-Charlie	853	-	74	157017142	27937
chr3	156989205	157189205	harbor1	chr3	157026995	157027118	DNA/hAT-Charlie	576	-	62	157027057	37852
chr3	156989205	157189205	harbor1	chr3	157027232	157027317	DNA/hAT-Charlie	494	-	42	157027274	38069
chr3	156989205	157189205	harbor1	chr3	157052697	157052844	DNA/hAT-Charlie	467	-	74	157052771	63566
chr3	156989205	157189205	harbor1	chr3	157053006	157053726	DNA/hAT-Charlie	1396	-	360	157053366	64161
chr3	156989205	157189205	harbor1	chr3	157074848	157074905	DNA/hAT-Charlie	502	-	28	157074876	85671
chr3	156989205	157189205	harbor1	chr3	157075349	157075563	DNA/hAT-Charlie	502	-	107	157075456	86251
chr3	107991361	108191361	harbor1	chr3	107991855	107992015	DNA/hAT-Charlie	706	-	80	107991935	574
chr3	107991361	108191361	harbor1	chr3	108007310	108007351	DNA/hAT-Charlie	663	-	20	108007330	15969
chr3	107991361	108191361	harbor1	chr3	108007678	108007808	DNA/hAT-Charlie	663	-	65	108007743	16382
chr3	107991361	108191361	harbor1	chr3	108033460	108033658	DNA/hAT-Charlie	485	-	99	108033559	42198
chr3	107991361	108191361	harbor1	chr3	108033655	108033824	DNA/hAT-Charlie	482	-	84	108033739	42378
chr3	107991361	108191361	harbor1	chr3	108061139	108061306	DNA/hAT-Charlie	524	-	84	108061223	69862
chr3	107991380	108191380	harbor1	chr3	107991855	107992015	DNA/hAT-Charlie	706	-	80	107991935	555
chr3	107991380	108191380	harbor1	chr3	108007310	108007351	DNA/hAT-Charlie	663	-	20	108007330	15950
chr3	107991380	108191380	harbor1	chr3	108007678	108007808	DNA/hAT-Charlie	663	-	65	108007743	16363
chr3	107991380	108191380	harbor1	chr3	108033460	108033658	DNA/hAT-Charlie	485	-	99	108033559	42179
chr3	107991380	108191380	harbor1	chr3	108033655	108033824	DNA/hAT-Charlie	482	-	84	108033739	42359
chr3	107991380	108191380	harbor1	chr3	108061139	108061306	DNA/hAT-Charlie	524	-	84	108061223	69843
chr3	46799563	46999563	harbor1	chr3	46824882	46825072	DNA/hAT-Charlie	592	-	95	46824977	25414
chr3	46799563	46999563	harbor1	chr3	46836403	46836618	DNA/hAT-Charlie	1400	-	108	46836511	36948
chr3	46799563	46999563	harbor1	chr3	46838561	46838870	DNA/hAT-Charlie	1290	-	154	46838715	39152
chr3	50288182	50488182	harbor1	chr3	50339812	50339965	DNA/hAT-Charlie	469	-	76	50339888	51706
chr3	52405285	52605285	harbor1	chr3	52462234	52462441	DNA/hAT-Charlie	1231	-	104	52462338	57053
chr3	52405285	52605285	harbor1	chr3	52465940	52466283	DNA/hAT-Charlie	582	-	172	52466112	60827
chr3	52405285	52605285	harbor1	chr3	52466582	52466870	DNA/hAT-Charlie	582	-	144	52466726	61441
chr3	107991451	108191451	harbor1	chr3	107991855	107992015	DNA/hAT-Charlie	706	-	80	107991935	484
chr3	107991451	108191451	harbor1	chr3	108007310	108007351	DNA/hAT-Charlie	663	-	20	108007330	15879
chr3	107991451	108191451	harbor1	chr3	108007678	108007808	DNA/hAT-Charlie	663	-	65	108007743	16292
chr3	107991451	108191451	harbor1	chr3	108033460	108033658	DNA/hAT-Charlie	485	-	99	108033559	42108
chr3	107991451	108191451	harbor1	chr3	108033655	108033824	DNA/hAT-Charlie	482	-	84	108033739	42288
chr3	107991451	108191451	harbor1	chr3	108061139	108061306	DNA/hAT-Charlie	524	-	84	108061223	69772
chr3	129021155	129221155	harbor1	chr3	129055272	129055465	DNA/hAT-Charlie	436	-	96	129055368	34213
chr3	129021155	129221155	harbor1	chr3	129060071	129060378	DNA/hAT-Charlie	743	-	154	129060225	39070
chr3	129021155	129221155	harbor1	chr3	129063332	129063537	DNA/hAT-Charlie	617	-	102	129063434	42279
chr3	129021155	129221155	harbor1	chr3	129063850	129063919	DNA/hAT-Charlie	617	-	34	129063884	42729
chr3	129021155	129221155	harbor1	chr3	129071683	129071766	DNA/hAT-Charlie	672	-	42	129071725	50570
chr3	129021155	129221155	harbor1	chr3	129072269	129072403	DNA/hAT-Charlie	762	-	67	129072336	51181
chr3	129021155	129221155	harbor1	chr3	129084531	129084681	DNA/hAT-Charlie	737	-	75	129084606	63451
chr3	107991298	108191298	harbor1	chr3	107991855	107992015	DNA/hAT-Charlie	706	-	80	107991935	637
chr3	107991298	108191298	harbor1	chr3	108007310	108007351	DNA/hAT-Charlie	663	-	20	108007330	16032
chr3	107991298	108191298	harbor1	chr3	108007678	108007808	DNA/hAT-Charlie	663	-	65	108007743	16445
chr3	107991298	108191298	harbor1	chr3	108033460	108033658	DNA/hAT-Charlie	485	-	99	108033559	42261
chr3	107991298	108191298	harbor1	chr3	108033655	108033824	DNA/hAT-Charlie	482	-	84	108033739	42441
chr3	107991298	108191298	harbor1	chr3	108061139	108061306	DNA/hAT-Charlie	524	-	84	108061223	69925
chr3	52222004	52422004	harbor1	chr3	52262466	52262644	DNA/hAT-Charlie	847	-	89	52262555	40551
chr3	147453950	147653950	harbor1	chr3	147464917	147465270	DNA/hAT-Charlie	1358	-	176	147465093	11143
chr3	147453950	147653950	harbor1	chr3	147465280	147465403	DNA/hAT-Charlie	539	-	62	147465342	11392
chr3	147453950	147653950	harbor1	chr3	147486438	147486565	DNA/hAT-Charlie	497	-	64	147486502	32552
chr3	147453950	147653950	harbor1	chr3	147511856	147511959	DNA/hAT-Charlie	616	-	52	147511908	57958
chr3	147453950	147653950	harbor1	chr3	147525748	147525966	DNA/hAT-Charlie	1452	-	109	147525857	71907
chr3	161005424	161205424	harbor1	chr3	161073070	161073365	DNA/hAT-Charlie	806	-	148	161073218	67794
chr3	107991375	108191375	harbor1	chr3	107991855	107992015	DNA/hAT-Charlie	706	-	80	107991935	560
chr3	107991375	108191375	harbor1	chr3	108007310	108007351	DNA/hAT-Charlie	663	-	20	108007330	15955
chr3	107991375	108191375	harbor1	chr3	108007678	108007808	DNA/hAT-Charlie	663	-	65	108007743	16368
chr3	107991375	108191375	harbor1	chr3	108033460	108033658	DNA/hAT-Charlie	485	-	99	108033559	42184
chr3	107991375	108191375	harbor1	chr3	108033655	108033824	DNA/hAT-Charlie	482	-	84	108033739	42364
chr3	107991375	108191375	harbor1	chr3	108061139	108061306	DNA/hAT-Charlie	524	-	84	108061223	69848
chr3	107991366	108191366	harbor1	chr3	107991855	107992015	DNA/hAT-Charlie	706	-	80	107991935	569
chr3	107991366	108191366	harbor1	chr3	108007310	108007351	DNA/hAT-Charlie	663	-	20	108007330	15964
chr3	107991366	108191366	harbor1	chr3	108007678	108007808	DNA/hAT-Charlie	663	-	65	108007743	16377
chr3	107991366	108191366	harbor1	chr3	108033460	108033658	DNA/hAT-Charlie	485	-	99	108033559	42193
chr3	107991366	108191366	harbor1	chr3	108033655	108033824	DNA/hAT-Charlie	482	-	84	108033739	42373
chr3	107991366	108191366	harbor1	chr3	108061139	108061306	DNA/hAT-Charlie	524	-	84	108061223	69857
chr3	107991309	108191309	harbor1	chr3	107991855	107992015	DNA/hAT-Charlie	706	-	80	107991935	626
chr3	107991309	108191309	harbor1	chr3	108007310	108007351	DNA/hAT-Charlie	663	-	20	108007330	16021
chr3	107991309	108191309	harbor1	chr3	108007678	108007808	DNA/hAT-Charlie	663	-	65	108007743	16434
chr3	107991309	108191309	harbor1	chr3	108033460	108033658	DNA/hAT-Charlie	485	-	99	108033559	42250
chr3	107991309	108191309	harbor1	chr3	108033655	108033824	DNA/hAT-Charlie	482	-	84	108033739	42430
chr3	107991309	108191309	harbor1	chr3	108061139	108061306	DNA/hAT-Charlie	524	-	84	108061223	69914
chr3	43899206	44099206	harbor1	chr3	43965777	43965945	DNA/hAT-Charlie	787	-	84	43965861	66655
chr3	107991277	108191277	harbor1	chr3	107991855	107992015	DNA/hAT-Charlie	706	-	80	107991935	658
chr3	107991277	108191277	harbor1	chr3	108007310	108007351	DNA/hAT-Charlie	663	-	20	108007330	16053
chr3	107991277	108191277	harbor1	chr3	108007678	108007808	DNA/hAT-Charlie	663	-	65	108007743	16466
chr3	107991277	108191277	harbor1	chr3	108033460	108033658	DNA/hAT-Charlie	485	-	99	108033559	42282
chr3	107991277	108191277	harbor1	chr3	108033655	108033824	DNA/hAT-Charlie	482	-	84	108033739	42462
chr3	107991277	108191277	harbor1	chr3	108061139	108061306	DNA/hAT-Charlie	524	-	84	108061223	69946
chr3	124721335	124921335	harbor1	chr3	124732402	124732527	DNA/hAT-Charlie	620	-	62	124732464	11129
chr3	124721335	124921335	harbor1	chr3	124732612	124732700	DNA/hAT-Charlie	543	-	44	124732656	11321
chr3	124721335	124921335	harbor1	chr3	124745866	124746050	DNA/hAT-Charlie	847	-	92	124745958	24623
chr3	124721335	124921335	harbor1	chr3	124806773	124807133	DNA/hAT-Charlie	1607	-	180	124806953	85618
chr3	124721335	124921335	harbor1	chr3	124807440	124807581	DNA/hAT-Charlie	1607	-	70	124807510	86175
chr3	125916736	126116736	harbor1	chr3	125934138	125934345	DNA/hAT-Charlie	884	-	104	125934242	17506
chr3	125916736	126116736	harbor1	chr3	125950937	125951084	DNA/hAT-Charlie	695	-	74	125951011	34275
chr3	125916736	126116736	harbor1	chr3	125962859	125963084	DNA/hAT-Charlie	1038	-	112	125962971	46235
chr3	125916736	126116736	harbor1	chr3	125988366	125988669	DNA/hAT-Charlie	1018	-	152	125988518	71782
chr3	125916736	126116736	harbor1	chr3	126006085	126006273	DNA/hAT-Charlie	655	-	94	126006179	89443
chr3	195981907	196181907	harbor1	chr3	195982660	195982821	DNA/hAT-Charlie	424	-	80	195982740	833
chr3	107991343	108191343	harbor1	chr3	107991855	107992015	DNA/hAT-Charlie	706	-	80	107991935	592
chr3	107991343	108191343	harbor1	chr3	108007310	108007351	DNA/hAT-Charlie	663	-	20	108007330	15987
chr3	107991343	108191343	harbor1	chr3	108007678	108007808	DNA/hAT-Charlie	663	-	65	108007743	16400
chr3	107991343	108191343	harbor1	chr3	108033460	108033658	DNA/hAT-Charlie	485	-	99	108033559	42216
chr3	107991343	108191343	harbor1	chr3	108033655	108033824	DNA/hAT-Charlie	482	-	84	108033739	42396
chr3	107991343	108191343	harbor1	chr3	108061139	108061306	DNA/hAT-Charlie	524	-	84	108061223	69880
chr3	17061072	17261072	harbor1	chr3	17126275	17126488	DNA/hAT-Charlie	1038	-	106	17126381	65309
chr3	107991355	108191355	harbor1	chr3	107991855	107992015	DNA/hAT-Charlie	706	-	80	107991935	580
chr3	107991355	108191355	harbor1	chr3	108007310	108007351	DNA/hAT-Charlie	663	-	20	108007330	15975
chr3	107991355	108191355	harbor1	chr3	108007678	108007808	DNA/hAT-Charlie	663	-	65	108007743	16388
chr3	107991355	108191355	harbor1	chr3	108033460	108033658	DNA/hAT-Charlie	485	-	99	108033559	42204
chr3	107991355	108191355	harbor1	chr3	108033655	108033824	DNA/hAT-Charlie	482	-	84	108033739	42384
chr3	107991355	108191355	harbor1	chr3	108061139	108061306	DNA/hAT-Charlie	524	-	84	108061223	69868
chr3	49542479	49742479	harbor1	chr3	49623867	49623995	DNA/hAT-Charlie	565	-	64	49623931	81452
chr3	43899195	44099195	harbor1	chr3	43965777	43965945	DNA/hAT-Charlie	787	-	84	43965861	66666
chr3	184085534	184285534	harbor1	chr3	184086094	184086253	DNA/hAT-Charlie	865	-	80	184086174	640
chr3	184085534	184285534	harbor1	chr3	184125409	184125553	DNA/hAT-Charlie	652	-	72	184125481	39947
chr3	184085534	184285534	harbor1	chr3	184157541	184157751	DNA/hAT-Charlie	550	-	105	184157646	72112
chr3	49410828	49610828	harbor1	chr3	49420817	49420931	DNA/hAT-Charlie	616	-	57	49420874	10046
chr3	49410828	49610828	harbor1	chr3	49421207	49421231	DNA/hAT-Charlie	616	-	12	49421219	10391
chr3	49410828	49610828	harbor1	chr3	49448221	49448393	DNA/hAT-Charlie	779	-	86	49448307	37479
chr3	49410828	49610828	harbor1	chr3	49448995	49449070	DNA/hAT-Charlie	779	-	38	49449033	38205
chr3	49410828	49610828	harbor1	chr3	49509617	49509729	DNA/hAT-Charlie	496	-	56	49509673	98845
chr3	49410828	49610828	harbor1	chr3	49510026	49510288	DNA/hAT-Charlie	511	-	131	49510157	99329
chr3	123349837	123549837	harbor1	chr3	123438148	123438320	DNA/hAT-Charlie	438	-	86	123438234	88397
chr3	195853169	196053169	harbor1	chr3	195889167	195889375	DNA/hAT-Charlie	478	-	104	195889271	36102
chr3	195853169	196053169	harbor1	chr3	195913603	195913743	DNA/hAT-Charlie	501	-	70	195913673	60504
chr3	49542474	49742474	harbor1	chr3	49623867	49623995	DNA/hAT-Charlie	565	-	64	49623931	81457
chr3	185838095	186038095	harbor1	chr3	185911957	185912081	DNA/hAT-Charlie	920	-	62	185912019	73924
chr3	185838095	186038095	harbor1	chr3	185912390	185912628	DNA/hAT-Charlie	920	-	119	185912509	74414
chr3	185838095	186038095	harbor1	chr3	185915024	185915139	DNA/hAT-Charlie	665	-	58	185915082	76987
chr3	142754359	142954359	harbor1	chr3	142793904	142794105	DNA/hAT-Charlie	689	-	100	142794004	39645
chr3	142754359	142954359	harbor1	chr3	142805395	142805762	DNA/hAT-Charlie	1695	-	184	142805579	51220
chr3	142754359	142954359	harbor1	chr3	142828318	142828459	DNA/hAT-Charlie	671	-	70	142828388	74029
chr3	196916565	197116565	harbor1	chr3	197004798	197004969	DNA/hAT-Charlie	592	-	86	197004884	88319
chr3	23710846	23910846	harbor1	chr3	23724586	23724687	DNA/hAT-Charlie	490	-	50	23724636	13790
chr3	23710846	23910846	harbor1	chr3	23724724	23724749	DNA/hAT-Charlie	490	-	12	23724736	13890
chr3	23710846	23910846	harbor1	chr3	23753686	23753803	DNA/hAT-Charlie	519	-	58	23753744	42898
chr3	23710846	23910846	harbor1	chr3	23767580	23767740	DNA/hAT-Charlie	674	-	80	23767660	56814
chr3	23710846	23910846	harbor1	chr3	23778202	23778376	DNA/hAT-Charlie	810	-	87	23778289	67443
chr3	23710846	23910846	harbor1	chr3	23779339	23779447	DNA/hAT-Charlie	514	-	54	23779393	68547
chr3	23710846	23910846	harbor1	chr3	23789090	23789224	DNA/hAT-Charlie	611	-	67	23789157	78311
chr3	107991335	108191335	harbor1	chr3	107991855	107992015	DNA/hAT-Charlie	706	-	80	107991935	600
chr3	107991335	108191335	harbor1	chr3	108007310	108007351	DNA/hAT-Charlie	663	-	20	108007330	15995
chr3	107991335	108191335	harbor1	chr3	108007678	108007808	DNA/hAT-Charlie	663	-	65	108007743	16408
chr3	107991335	108191335	harbor1	chr3	108033460	108033658	DNA/hAT-Charlie	485	-	99	108033559	42224
chr3	107991335	108191335	harbor1	chr3	108033655	108033824	DNA/hAT-Charlie	482	-	84	108033739	42404
chr3	107991335	108191335	harbor1	chr3	108061139	108061306	DNA/hAT-Charlie	524	-	84	108061223	69888
chr3	39004795	39204795	harbor1	chr3	39050643	39050906	DNA/hAT-Charlie	904	-	132	39050775	45980
chr3	39004795	39204795	harbor1	chr3	39054257	39054477	DNA/hAT-Charlie	1105	-	110	39054367	49572
chr3	39004795	39204795	harbor1	chr3	39073945	39074118	DNA/hAT-Charlie	815	-	86	39074031	69236
chr3	39004795	39204795	harbor1	chr3	39080063	39080262	DNA/hAT-Charlie	785	-	100	39080163	75368
chr3	127581151	127781151	harbor1	chr3	127678490	127678676	DNA/hAT-Charlie	803	-	93	127678583	97432
chr3	123544681	123744681	harbor1	chr3	123566084	123566251	DNA/hAT-Charlie	554	-	84	123566168	21487
chr3	123544681	123744681	harbor1	chr3	123570118	123570350	DNA/hAT-Charlie	873	-	116	123570234	25553
chr3	123544681	123744681	harbor1	chr3	123571943	123572097	DNA/hAT-Charlie	427	-	77	123572020	27339
chr3	123544681	123744681	harbor1	chr3	123575048	123575104	DNA/hAT-Charlie	798	-	28	123575076	30395
chr3	123544681	123744681	harbor1	chr3	123575417	123575540	DNA/hAT-Charlie	798	-	62	123575479	30798
chr3	123544681	123744681	harbor1	chr3	123586151	123586462	DNA/hAT-Charlie	1797	-	156	123586307	41626
chr3	123544681	123744681	harbor1	chr3	123589691	123590017	DNA/hAT-Charlie	2353	-	163	123589854	45173
chr3	123544681	123744681	harbor1	chr3	123599527	123599823	DNA/hAT-Charlie	789	-	148	123599675	54994
chr3	123544681	123744681	harbor1	chr3	123611526	123612044	DNA/hAT-Charlie	3714	-	259	123611785	67104
chr3	16431951	16631951	harbor1	chr3	16456579	16456699	DNA/hAT-Charlie	592	-	60	16456639	24688
chr3	16431951	16631951	harbor1	chr3	16456688	16456885	DNA/hAT-Charlie	802	-	98	16456786	24835
chr3	16431951	16631951	harbor1	chr3	16503382	16503530	DNA/hAT-Charlie	572	-	74	16503456	71505
chr3	16431951	16631951	harbor1	chr3	16504054	16504613	DNA/hAT-Charlie	2733	-	280	16504334	72383
chr3	50248580	50448580	harbor1	chr3	50339812	50339965	DNA/hAT-Charlie	469	-	76	50339888	91308
chr3	23710841	23910841	harbor1	chr3	23724586	23724687	DNA/hAT-Charlie	490	-	50	23724636	13795
chr3	23710841	23910841	harbor1	chr3	23724724	23724749	DNA/hAT-Charlie	490	-	12	23724736	13895
chr3	23710841	23910841	harbor1	chr3	23753686	23753803	DNA/hAT-Charlie	519	-	58	23753744	42903
chr3	23710841	23910841	harbor1	chr3	23767580	23767740	DNA/hAT-Charlie	674	-	80	23767660	56819
chr3	23710841	23910841	harbor1	chr3	23778202	23778376	DNA/hAT-Charlie	810	-	87	23778289	67448
chr3	23710841	23910841	harbor1	chr3	23779339	23779447	DNA/hAT-Charlie	514	-	54	23779393	68552
chr3	23710841	23910841	harbor1	chr3	23789090	23789224	DNA/hAT-Charlie	611	-	67	23789157	78316
chr3	128328692	128528692	harbor1	chr3	128346203	128346994	DNA/hAT-Charlie	3160	-	396	128346599	17907
chr3	128328692	128528692	harbor1	chr3	128371314	128371516	DNA/hAT-Charlie	792	-	101	128371415	42723
chr3	128328692	128528692	harbor1	chr3	128383764	128384037	DNA/hAT-Charlie	461	-	136	128383900	55208
chr3	123349752	123549752	harbor1	chr3	123438148	123438320	DNA/hAT-Charlie	438	-	86	123438234	88482
chr3	46771747	46971747	harbor1	chr3	46824882	46825072	DNA/hAT-Charlie	592	-	95	46824977	53230
chr3	46771747	46971747	harbor1	chr3	46836403	46836618	DNA/hAT-Charlie	1400	-	108	46836511	64764
chr3	46771747	46971747	harbor1	chr3	46838561	46838870	DNA/hAT-Charlie	1290	-	154	46838715	66968
chr3	138334619	138534619	harbor1	chr3	138372017	138372218	DNA/hAT-Charlie	1001	-	100	138372117	37498
chr3	138334619	138534619	harbor1	chr3	138376542	138376714	DNA/hAT-Charlie	602	-	86	138376628	42009
chr3	138334619	138534619	harbor1	chr3	138411094	138411269	DNA/hAT-Charlie	658	-	88	138411182	76563
chr3	138334619	138534619	harbor1	chr3	138412408	138412562	DNA/hAT-Charlie	583	-	77	138412485	77866
chr3	127490156	127690156	harbor1	chr3	127534897	127535192	DNA/hAT-Charlie	936	-	148	127535045	44889
chr3	127490156	127690156	harbor1	chr3	127556022	127556263	DNA/hAT-Charlie	800	-	120	127556142	65986
chr3	127490156	127690156	harbor1	chr3	127556582	127556712	DNA/hAT-Charlie	768	-	65	127556647	66491
chr3	127490156	127690156	harbor1	chr3	127562699	127562813	DNA/hAT-Charlie	544	-	57	127562756	72600
chr3	127490156	127690156	harbor1	chr3	127562819	127563029	DNA/hAT-Charlie	739	-	105	127562924	72768
chr3	127490156	127690156	harbor1	chr3	127549313	127549528	DNA/hAT-Charlie	812	-	108	127549421	59265
chr3	113647007	113847007	harbor1	chr3	113691925	113692187	DNA/hAT-Charlie	1504	-	131	113692056	45049
chr3	113647007	113847007	harbor1	chr3	113694595	113694762	DNA/hAT-Charlie	1012	-	84	113694679	47672
chr3	113647007	113847007	harbor1	chr3	113695062	113695131	DNA/hAT-Charlie	1012	-	34	113695096	48089
chr3	113647007	113847007	harbor1	chr3	113740151	113740363	DNA/hAT-Charlie	714	-	106	113740257	93250
chr3	113647007	113847007	harbor1	chr3	113737669	113737840	DNA/hAT-Charlie	779	-	86	113737755	90748
chr3	179842465	180042465	harbor1	chr3	179849182	179849403	DNA/hAT-Charlie	429	-	110	179849292	6827
chr3	179842465	180042465	harbor1	chr3	179865682	179865864	DNA/hAT-Charlie	856	-	91	179865773	23308
chr3	179842465	180042465	harbor1	chr3	179895060	179895370	DNA/hAT-Charlie	1291	-	155	179895215	52750
chr3	179842465	180042465	harbor1	chr3	179927895	179928030	DNA/hAT-Charlie	461	-	68	179927963	85498
chr3	190413906	190613906	harbor1	chr3	190480799	190481260	DNA/hAT-Charlie	1205	-	230	190481029	67123
chr3	127490312	127690312	harbor1	chr3	127534897	127535192	DNA/hAT-Charlie	936	-	148	127535045	44733
chr3	127490312	127690312	harbor1	chr3	127556022	127556263	DNA/hAT-Charlie	800	-	120	127556142	65830
chr3	127490312	127690312	harbor1	chr3	127556582	127556712	DNA/hAT-Charlie	768	-	65	127556647	66335
chr3	127490312	127690312	harbor1	chr3	127562699	127562813	DNA/hAT-Charlie	544	-	57	127562756	72444
chr3	127490312	127690312	harbor1	chr3	127562819	127563029	DNA/hAT-Charlie	739	-	105	127562924	72612
chr3	127490312	127690312	harbor1	chr3	127549313	127549528	DNA/hAT-Charlie	812	-	108	127549421	59109
chr3	128328699	128528699	harbor1	chr3	128346203	128346994	DNA/hAT-Charlie	3160	-	396	128346599	17900
chr3	128328699	128528699	harbor1	chr3	128371314	128371516	DNA/hAT-Charlie	792	-	101	128371415	42716
chr3	128328699	128528699	harbor1	chr3	128383764	128384037	DNA/hAT-Charlie	461	-	136	128383900	55201
chr3	49589472	49789472	harbor1	chr3	49623867	49623995	DNA/hAT-Charlie	565	-	64	49623931	34459
chr3	128328755	128528755	harbor1	chr3	128346203	128346994	DNA/hAT-Charlie	3160	-	396	128346599	17844
chr3	128328755	128528755	harbor1	chr3	128371314	128371516	DNA/hAT-Charlie	792	-	101	128371415	42660
chr3	128328755	128528755	harbor1	chr3	128383764	128384037	DNA/hAT-Charlie	461	-	136	128383900	55145
chr3	184199369	184399369	harbor1	chr3	184240371	184240488	DNA/hAT-Charlie	563	-	58	184240429	41060
chr3	184199369	184399369	harbor1	chr3	184252522	184252660	DNA/hAT-Charlie	810	-	69	184252591	53222
chr3	184199369	184399369	harbor1	chr3	184252972	184253038	DNA/hAT-Charlie	810	-	33	184253005	53636
chr3	123544677	123744677	harbor1	chr3	123566084	123566251	DNA/hAT-Charlie	554	-	84	123566168	21491
chr3	123544677	123744677	harbor1	chr3	123570118	123570350	DNA/hAT-Charlie	873	-	116	123570234	25557
chr3	123544677	123744677	harbor1	chr3	123571943	123572097	DNA/hAT-Charlie	427	-	77	123572020	27343
chr3	123544677	123744677	harbor1	chr3	123575048	123575104	DNA/hAT-Charlie	798	-	28	123575076	30399
chr3	123544677	123744677	harbor1	chr3	123575417	123575540	DNA/hAT-Charlie	798	-	62	123575479	30802
chr3	123544677	123744677	harbor1	chr3	123586151	123586462	DNA/hAT-Charlie	1797	-	156	123586307	41630
chr3	123544677	123744677	harbor1	chr3	123589691	123590017	DNA/hAT-Charlie	2353	-	163	123589854	45177
chr3	123544677	123744677	harbor1	chr3	123599527	123599823	DNA/hAT-Charlie	789	-	148	123599675	54998
chr3	123544677	123744677	harbor1	chr3	123611526	123612044	DNA/hAT-Charlie	3714	-	259	123611785	67108
chr3	54747497	54947497	harbor1	chr3	54814169	54814291	DNA/hAT-Charlie	440	-	61	54814230	66733
chr3	54747497	54947497	harbor1	chr3	54816295	54816474	DNA/hAT-Charlie	768	-	90	54816385	68888
chr3	54747497	54947497	harbor1	chr3	54835318	54835454	DNA/hAT-Charlie	452	-	68	54835386	87889
chr3	122414401	122614401	harbor1	chr3	122492398	122492678	DNA/hAT-Charlie	979	-	140	122492538	78137
chr3	138087580	138287580	harbor1	chr3	138119643	138119694	DNA/hAT-Charlie	1404	-	26	138119669	32089
chr3	138087580	138287580	harbor1	chr3	138120004	138120377	DNA/hAT-Charlie	1404	-	186	138120190	32610
chr3	50288152	50488152	harbor1	chr3	50339812	50339965	DNA/hAT-Charlie	469	-	76	50339888	51736
chr3	107991305	108191305	harbor1	chr3	107991855	107992015	DNA/hAT-Charlie	706	-	80	107991935	630
chr3	107991305	108191305	harbor1	chr3	108007310	108007351	DNA/hAT-Charlie	663	-	20	108007330	16025
chr3	107991305	108191305	harbor1	chr3	108007678	108007808	DNA/hAT-Charlie	663	-	65	108007743	16438
chr3	107991305	108191305	harbor1	chr3	108033460	108033658	DNA/hAT-Charlie	485	-	99	108033559	42254
chr3	107991305	108191305	harbor1	chr3	108033655	108033824	DNA/hAT-Charlie	482	-	84	108033739	42434
chr3	107991305	108191305	harbor1	chr3	108061139	108061306	DNA/hAT-Charlie	524	-	84	108061223	69918
chr3	50278721	50478721	harbor1	chr3	50339812	50339965	DNA/hAT-Charlie	469	-	76	50339888	61167
chr3	51571820	51771820	harbor1	chr3	51583070	51583416	DNA/hAT-Charlie	1631	-	173	51583243	11423
chr3	51571820	51771820	harbor1	chr3	51583727	51583851	DNA/hAT-Charlie	1631	-	62	51583789	11969
chr3	51571820	51771820	harbor1	chr3	51583923	51584001	DNA/hAT-Charlie	523	-	39	51583962	12142
chr3	51571820	51771820	harbor1	chr3	51642521	51642730	DNA/hAT-Charlie	1153	-	104	51642625	70805
chr3	113849062	114049062	harbor1	chr3	113898542	113898917	DNA/hAT-Charlie	542	-	188	113898730	49668
chr3	113849062	114049062	harbor1	chr3	113938510	113938700	DNA/hAT-Charlie	469	-	95	113938605	89543
chr3	21855680	22055680	harbor1	chr3	21860183	21860391	DNA/hAT-Charlie	607	-	104	21860287	4607
chr3	21855680	22055680	harbor1	chr3	21863879	21864028	DNA/hAT-Charlie	738	-	74	21863953	8273
chr3	21855680	22055680	harbor1	chr3	21866513	21866684	DNA/hAT-Charlie	774	-	86	21866599	10919
chr3	21855680	22055680	harbor1	chr3	21868129	21868341	DNA/hAT-Charlie	717	-	106	21868235	12555
chr3	21855680	22055680	harbor1	chr3	21899386	21899574	DNA/hAT-Charlie	876	-	94	21899480	43800
chr3	21855680	22055680	harbor1	chr3	21919529	21919764	DNA/hAT-Charlie	523	-	118	21919647	63967
chr3	21855680	22055680	harbor1	chr3	21954478	21955002	DNA/hAT-Charlie	1989	-	262	21954740	99060
chr3	19954840	20154840	harbor1	chr3	20025517	20025707	DNA/hAT-Charlie	695	-	95	20025612	70772
chr3	19954840	20154840	harbor1	chr3	20042047	20042196	DNA/hAT-Charlie	866	-	74	20042121	87281
chr3	47725179	47925179	harbor1	chr3	47786133	47786247	DNA/hAT-Charlie	609	-	57	47786190	61011
chr3	47725179	47925179	harbor1	chr3	47821917	47822142	DNA/hAT-Charlie	933	-	112	47822029	96850
chr3	197857923	198057923	harbor1	chr3	197861264	197861427	DNA/hAT-Charlie	744	-	82	197861346	3423
chr3	197857923	198057923	harbor1	chr3	197884040	197884145	DNA/hAT-Charlie	459	-	52	197884092	26169
chr3	197857923	198057923	harbor1	chr3	197916795	197917011	DNA/hAT-Charlie	1484	-	108	197916903	58980
chr3	197857923	198057923	harbor1	chr3	197926138	197926307	DNA/hAT-Charlie	545	-	84	197926222	68299
chr3	197857923	198057923	harbor1	chr3	197936958	197937163	DNA/hAT-Charlie	934	-	102	197937060	79137
chr3	58016450	58216450	harbor1	chr3	58027682	58028103	DNA/hAT-Charlie	1302	-	210	58027892	11442
chr3	58016450	58216450	harbor1	chr3	58048314	58048419	DNA/hAT-Charlie	454	-	52	58048366	31916
chr3	58016450	58216450	harbor1	chr3	58054256	58054398	DNA/hAT-Charlie	650	-	71	58054327	37877
chr3	58016450	58216450	harbor1	chr3	58055773	58056064	DNA/hAT-Charlie	939	-	146	58055919	39469
chr3	58016450	58216450	harbor1	chr3	58058929	58059171	DNA/hAT-Charlie	636	-	121	58059050	42600
chr3	58016450	58216450	harbor1	chr3	58105630	58105848	DNA/hAT-Charlie	1140	-	109	58105739	89289
chr3	58016450	58216450	harbor1	chr3	58108020	58108237	DNA/hAT-Charlie	1439	-	108	58108128	91678
chr3	50493434	50693434	harbor1	chr3	50589073	50589282	DNA/hAT-Charlie	609	-	104	50589177	95743
chr3	30507293	30707293	harbor1	chr3	30512767	30512952	DNA/hAT-Charlie	702	-	92	30512859	5566
chr3	30507293	30707293	harbor1	chr3	30553351	30553532	DNA/hAT-Charlie	942	-	90	30553441	46148
chr3	30507293	30707293	harbor1	chr3	30576577	30576785	DNA/hAT-Charlie	444	-	104	30576681	69388
chr3	23710887	23910887	harbor1	chr3	23724586	23724687	DNA/hAT-Charlie	490	-	50	23724636	13749
chr3	23710887	23910887	harbor1	chr3	23724724	23724749	DNA/hAT-Charlie	490	-	12	23724736	13849
chr3	23710887	23910887	harbor1	chr3	23753686	23753803	DNA/hAT-Charlie	519	-	58	23753744	42857
chr3	23710887	23910887	harbor1	chr3	23767580	23767740	DNA/hAT-Charlie	674	-	80	23767660	56773
chr3	23710887	23910887	harbor1	chr3	23778202	23778376	DNA/hAT-Charlie	810	-	87	23778289	67402
chr3	23710887	23910887	harbor1	chr3	23779339	23779447	DNA/hAT-Charlie	514	-	54	23779393	68506
chr3	23710887	23910887	harbor1	chr3	23789090	23789224	DNA/hAT-Charlie	611	-	67	23789157	78270
chr3	53395675	53595675	harbor1	chr3	53411438	53411619	DNA/hAT-Charlie	514	-	90	53411528	15853
chr3	53395675	53595675	harbor1	chr3	53436452	53437232	DNA/hAT-Charlie	2284	-	390	53436842	41167
chr3	53395675	53595675	harbor1	chr3	53437465	53437687	DNA/hAT-Charlie	1694	-	111	53437576	41901
chr3	53395675	53595675	harbor1	chr3	53484117	53484292	DNA/hAT-Charlie	981	-	88	53484205	88530
chr3	182580289	182780289	harbor1	chr3	182597719	182597883	DNA/hAT-Charlie	579	-	82	182597801	17512
chr3	182580289	182780289	harbor1	chr3	182599304	182599473	DNA/hAT-Charlie	708	-	84	182599388	19099
chr3	182580289	182780289	harbor1	chr3	182662461	182662644	DNA/hAT-Charlie	710	-	92	182662553	82264
chr3	107991294	108191294	harbor1	chr3	107991855	107992015	DNA/hAT-Charlie	706	-	80	107991935	641
chr3	107991294	108191294	harbor1	chr3	108007310	108007351	DNA/hAT-Charlie	663	-	20	108007330	16036
chr3	107991294	108191294	harbor1	chr3	108007678	108007808	DNA/hAT-Charlie	663	-	65	108007743	16449
chr3	107991294	108191294	harbor1	chr3	108033460	108033658	DNA/hAT-Charlie	485	-	99	108033559	42265
chr3	107991294	108191294	harbor1	chr3	108033655	108033824	DNA/hAT-Charlie	482	-	84	108033739	42445
chr3	107991294	108191294	harbor1	chr3	108061139	108061306	DNA/hAT-Charlie	524	-	84	108061223	69929
chr3	49573788	49773788	harbor1	chr3	49623867	49623995	DNA/hAT-Charlie	565	-	64	49623931	50143
chr3	159480531	159680531	harbor1	chr3	159535729	159535944	DNA/hAT-Charlie	674	-	108	159535837	55306
chr3	159480531	159680531	harbor1	chr3	159535956	159536165	DNA/hAT-Charlie	907	-	104	159536060	55529
chr3	156989217	157189217	harbor1	chr3	157009119	157009424	DNA/hAT-Charlie	1051	-	152	157009271	20054
chr3	156989217	157189217	harbor1	chr3	157017068	157017216	DNA/hAT-Charlie	853	-	74	157017142	27925
chr3	156989217	157189217	harbor1	chr3	157026995	157027118	DNA/hAT-Charlie	576	-	62	157027057	37840
chr3	156989217	157189217	harbor1	chr3	157027232	157027317	DNA/hAT-Charlie	494	-	42	157027274	38057
chr3	156989217	157189217	harbor1	chr3	157052697	157052844	DNA/hAT-Charlie	467	-	74	157052771	63554
chr3	156989217	157189217	harbor1	chr3	157053006	157053726	DNA/hAT-Charlie	1396	-	360	157053366	64149
chr3	156989217	157189217	harbor1	chr3	157074848	157074905	DNA/hAT-Charlie	502	-	28	157074876	85659
chr3	156989217	157189217	harbor1	chr3	157075349	157075563	DNA/hAT-Charlie	502	-	107	157075456	86239
chr3	123544615	123744615	harbor1	chr3	123566084	123566251	DNA/hAT-Charlie	554	-	84	123566168	21553
chr3	123544615	123744615	harbor1	chr3	123570118	123570350	DNA/hAT-Charlie	873	-	116	123570234	25619
chr3	123544615	123744615	harbor1	chr3	123571943	123572097	DNA/hAT-Charlie	427	-	77	123572020	27405
chr3	123544615	123744615	harbor1	chr3	123575048	123575104	DNA/hAT-Charlie	798	-	28	123575076	30461
chr3	123544615	123744615	harbor1	chr3	123575417	123575540	DNA/hAT-Charlie	798	-	62	123575479	30864
chr3	123544615	123744615	harbor1	chr3	123586151	123586462	DNA/hAT-Charlie	1797	-	156	123586307	41692
chr3	123544615	123744615	harbor1	chr3	123589691	123590017	DNA/hAT-Charlie	2353	-	163	123589854	45239
chr3	123544615	123744615	harbor1	chr3	123599527	123599823	DNA/hAT-Charlie	789	-	148	123599675	55060
chr3	123544615	123744615	harbor1	chr3	123611526	123612044	DNA/hAT-Charlie	3714	-	259	123611785	67170
chr3	49589405	49789405	harbor1	chr3	49623867	49623995	DNA/hAT-Charlie	565	-	64	49623931	34526
chr3	46799778	46999778	harbor1	chr3	46824882	46825072	DNA/hAT-Charlie	592	-	95	46824977	25199
chr3	46799778	46999778	harbor1	chr3	46836403	46836618	DNA/hAT-Charlie	1400	-	108	46836511	36733
chr3	46799778	46999778	harbor1	chr3	46838561	46838870	DNA/hAT-Charlie	1290	-	154	46838715	38937
chr3	48890290	49090290	harbor1	chr3	48962604	48962807	DNA/hAT-Charlie	986	-	102	48962706	72416
chr3	51281519	51481519	harbor1	chr3	51328020	51328184	DNA/hAT-Charlie	682	-	82	51328102	46583
chr3	107991304	108191304	harbor1	chr3	107991855	107992015	DNA/hAT-Charlie	706	-	80	107991935	631
chr3	107991304	108191304	harbor1	chr3	108007310	108007351	DNA/hAT-Charlie	663	-	20	108007330	16026
chr3	107991304	108191304	harbor1	chr3	108007678	108007808	DNA/hAT-Charlie	663	-	65	108007743	16439
chr3	107991304	108191304	harbor1	chr3	108033460	108033658	DNA/hAT-Charlie	485	-	99	108033559	42255
chr3	107991304	108191304	harbor1	chr3	108033655	108033824	DNA/hAT-Charlie	482	-	84	108033739	42435
chr3	107991304	108191304	harbor1	chr3	108061139	108061306	DNA/hAT-Charlie	524	-	84	108061223	69919
chr3	38066121	38266121	harbor1	chr3	38089200	38089355	DNA/hAT-Charlie	520	-	78	38089278	23157
chr3	38066121	38266121	harbor1	chr3	38093921	38094095	DNA/hAT-Charlie	665	-	87	38094008	27887
chr3	38066121	38266121	harbor1	chr3	38150243	38150612	DNA/hAT-Charlie	1397	-	184	38150427	84306
chr3	129021082	129221082	harbor1	chr3	129055272	129055465	DNA/hAT-Charlie	436	-	96	129055368	34286
chr3	129021082	129221082	harbor1	chr3	129060071	129060378	DNA/hAT-Charlie	743	-	154	129060225	39143
chr3	129021082	129221082	harbor1	chr3	129063332	129063537	DNA/hAT-Charlie	617	-	102	129063434	42352
chr3	129021082	129221082	harbor1	chr3	129063850	129063919	DNA/hAT-Charlie	617	-	34	129063884	42802
chr3	129021082	129221082	harbor1	chr3	129071683	129071766	DNA/hAT-Charlie	672	-	42	129071725	50643
chr3	129021082	129221082	harbor1	chr3	129072269	129072403	DNA/hAT-Charlie	762	-	67	129072336	51254
chr3	129021082	129221082	harbor1	chr3	129084531	129084681	DNA/hAT-Charlie	737	-	75	129084606	63524
chr3	47725235	47925235	harbor1	chr3	47786133	47786247	DNA/hAT-Charlie	609	-	57	47786190	60955
chr3	47725235	47925235	harbor1	chr3	47821917	47822142	DNA/hAT-Charlie	933	-	112	47822029	96794
chr3	49623710	49823710	harbor1	chr3	49623867	49623995	DNA/hAT-Charlie	565	-	64	49623931	221
chr3	195982427	196182427	harbor1	chr3	195982660	195982821	DNA/hAT-Charlie	424	-	80	195982740	313
chr3	107991392	108191392	harbor1	chr3	107991855	107992015	DNA/hAT-Charlie	706	-	80	107991935	543
chr3	107991392	108191392	harbor1	chr3	108007310	108007351	DNA/hAT-Charlie	663	-	20	108007330	15938
chr3	107991392	108191392	harbor1	chr3	108007678	108007808	DNA/hAT-Charlie	663	-	65	108007743	16351
chr3	107991392	108191392	harbor1	chr3	108033460	108033658	DNA/hAT-Charlie	485	-	99	108033559	42167
chr3	107991392	108191392	harbor1	chr3	108033655	108033824	DNA/hAT-Charlie	482	-	84	108033739	42347
chr3	107991392	108191392	harbor1	chr3	108061139	108061306	DNA/hAT-Charlie	524	-	84	108061223	69831
chr3	128328747	128528747	harbor1	chr3	128346203	128346994	DNA/hAT-Charlie	3160	-	396	128346599	17852
chr3	128328747	128528747	harbor1	chr3	128371314	128371516	DNA/hAT-Charlie	792	-	101	128371415	42668
chr3	128328747	128528747	harbor1	chr3	128383764	128384037	DNA/hAT-Charlie	461	-	136	128383900	55153
chr3	126256502	126456502	harbor1	chr3	126320071	126320351	DNA/hAT-Charlie	573	-	140	126320211	63709
chr3	128328796	128528796	harbor1	chr3	128346203	128346994	DNA/hAT-Charlie	3160	-	396	128346599	17803
chr3	128328796	128528796	harbor1	chr3	128371314	128371516	DNA/hAT-Charlie	792	-	101	128371415	42619
chr3	128328796	128528796	harbor1	chr3	128383764	128384037	DNA/hAT-Charlie	461	-	136	128383900	55104
chr3	51571305	51771305	harbor1	chr3	51583070	51583416	DNA/hAT-Charlie	1631	-	173	51583243	11938
chr3	51571305	51771305	harbor1	chr3	51583727	51583851	DNA/hAT-Charlie	1631	-	62	51583789	12484
chr3	51571305	51771305	harbor1	chr3	51583923	51584001	DNA/hAT-Charlie	523	-	39	51583962	12657
chr3	51571305	51771305	harbor1	chr3	51642521	51642730	DNA/hAT-Charlie	1153	-	104	51642625	71320
chr3	138334857	138534857	harbor1	chr3	138372017	138372218	DNA/hAT-Charlie	1001	-	100	138372117	37260
chr3	138334857	138534857	harbor1	chr3	138376542	138376714	DNA/hAT-Charlie	602	-	86	138376628	41771
chr3	138334857	138534857	harbor1	chr3	138411094	138411269	DNA/hAT-Charlie	658	-	88	138411182	76325
chr3	138334857	138534857	harbor1	chr3	138412408	138412562	DNA/hAT-Charlie	583	-	77	138412485	77628
chr3	42482018	42682018	harbor1	chr3	42518031	42518456	DNA/hAT-Charlie	2242	-	212	42518243	36225
chr3	42482018	42682018	harbor1	chr3	42518741	42519012	DNA/hAT-Charlie	2242	-	136	42518877	36859
chr3	42482018	42682018	harbor1	chr3	42563051	42563248	DNA/hAT-Charlie	868	-	98	42563149	81131
chr3	127581163	127781163	harbor1	chr3	127678490	127678676	DNA/hAT-Charlie	803	-	93	127678583	97420
chr4	145080529	145280529	harbor1	chr4	145084481	145084658	DNA/hAT-Charlie	1170	-	88	145084569	4040
chr4	145080529	145280529	harbor1	chr4	145086614	145086861	DNA/hAT-Charlie	861	-	124	145086738	6209
chr4	145080529	145280529	harbor1	chr4	145087553	145087684	DNA/hAT-Charlie	537	-	66	145087619	7090
chr4	145080529	145280529	harbor1	chr4	145114351	145114548	DNA/hAT-Charlie	531	-	98	145114449	33920
chr4	145080529	145280529	harbor1	chr4	145154646	145154839	DNA/hAT-Charlie	905	-	96	145154742	74213
chr4	25761117	25961117	harbor1	chr4	25777872	25778073	DNA/hAT-Charlie	945	-	100	25777972	16855
chr4	25761117	25961117	harbor1	chr4	25840713	25840905	DNA/hAT-Charlie	639	-	96	25840809	79692
chr4	150914523	151114523	harbor1	chr4	150936262	150936442	DNA/hAT-Charlie	526	-	90	150936352	21829
chr4	150914523	151114523	harbor1	chr4	150986171	150986283	DNA/hAT-Charlie	664	-	56	150986227	71704
chr4	145080526	145280526	harbor1	chr4	145084481	145084658	DNA/hAT-Charlie	1170	-	88	145084569	4043
chr4	145080526	145280526	harbor1	chr4	145086614	145086861	DNA/hAT-Charlie	861	-	124	145086738	6212
chr4	145080526	145280526	harbor1	chr4	145087553	145087684	DNA/hAT-Charlie	537	-	66	145087619	7093
chr4	145080526	145280526	harbor1	chr4	145114351	145114548	DNA/hAT-Charlie	531	-	98	145114449	33923
chr4	145080526	145280526	harbor1	chr4	145154646	145154839	DNA/hAT-Charlie	905	-	96	145154742	74216
chr4	70739795	70939795	harbor1	chr4	70762338	70762458	DNA/hAT-Charlie	568	-	60	70762398	22603
chr4	159002387	159202387	harbor1	chr4	159014718	159014936	DNA/hAT-Charlie	1559	-	109	159014827	12440
chr4	159002387	159202387	harbor1	chr4	159066784	159066961	DNA/hAT-Charlie	740	-	88	159066872	64485
chr4	159002718	159202718	harbor1	chr4	159014718	159014936	DNA/hAT-Charlie	1559	-	109	159014827	12109
chr4	159002718	159202718	harbor1	chr4	159066784	159066961	DNA/hAT-Charlie	740	-	88	159066872	64154
chr4	139456023	139656023	harbor1	chr4	139544432	139544655	DNA/hAT-Charlie	632	-	112	139544544	88521
chr4	1661985	1861985	harbor1	chr4	1700187	1700564	DNA/hAT-Charlie	968	-	188	1700375	38390
chr4	1661985	1861985	harbor1	chr4	1700864	1700923	DNA/hAT-Charlie	968	-	30	1700894	38909
chr4	1661985	1861985	harbor1	chr4	1703347	1703517	DNA/hAT-Charlie	717	-	85	1703432	41447
chr4	39598067	39798067	harbor1	chr4	39656910	39657172	DNA/hAT-Charlie	1779	-	131	39657041	58974
chr4	39598067	39798067	harbor1	chr4	39680320	39680442	DNA/hAT-Charlie	1653	-	61	39680381	82314
chr4	39598067	39798067	harbor1	chr4	39680750	39680861	DNA/hAT-Charlie	1653	-	56	39680806	82739
chr4	39598067	39798067	harbor1	chr4	39688009	39688154	DNA/hAT-Charlie	629	-	72	39688081	90014
chr4	2826505	3026505	harbor1	chr4	2861616	2861783	DNA/hAT-Charlie	576	-	84	2861700	35195
chr4	6922283	7122283	harbor1	chr4	6927610	6927817	DNA/hAT-Charlie	859	-	104	6927714	5431
chr4	6922283	7122283	harbor1	chr4	6940105	6940299	DNA/hAT-Charlie	957	-	97	6940202	17919
chr4	6922283	7122283	harbor1	chr4	6945847	6946017	DNA/hAT-Charlie	585	-	85	6945932	23649
chr4	6922283	7122283	harbor1	chr4	6952175	6952354	DNA/hAT-Charlie	767	-	90	6952265	29982
chr4	6922283	7122283	harbor1	chr4	6972576	6972762	DNA/hAT-Charlie	1404	-	93	6972669	50386
chr4	6922283	7122283	harbor1	chr4	7013149	7013354	DNA/hAT-Charlie	543	-	102	7013251	90968
chr4	6922283	7122283	harbor1	chr4	7016564	7016825	DNA/hAT-Charlie	550	-	130	7016694	94411
chr4	145080585	145280585	harbor1	chr4	145084481	145084658	DNA/hAT-Charlie	1170	-	88	145084569	3984
chr4	145080585	145280585	harbor1	chr4	145086614	145086861	DNA/hAT-Charlie	861	-	124	145086738	6153
chr4	145080585	145280585	harbor1	chr4	145087553	145087684	DNA/hAT-Charlie	537	-	66	145087619	7034
chr4	145080585	145280585	harbor1	chr4	145114351	145114548	DNA/hAT-Charlie	531	-	98	145114449	33864
chr4	145080585	145280585	harbor1	chr4	145154646	145154839	DNA/hAT-Charlie	905	-	96	145154742	74157
chr4	158917337	159117337	harbor1	chr4	158925447	158925780	DNA/hAT-Charlie	2055	-	166	158925613	8276
chr4	158917337	159117337	harbor1	chr4	158997984	158998298	DNA/hAT-Charlie	1248	-	157	158998141	80804
chr4	158917337	159117337	harbor1	chr4	159014718	159014936	DNA/hAT-Charlie	1559	-	109	159014827	97490
chr4	9441130	9641130	harbor1	chr4	9535956	9536186	DNA/hAT-Charlie	701	-	115	9536071	94941
chr4	1107423	1307423	harbor1	chr4	1173867	1173918	DNA/hAT-Charlie	1404	-	26	1173893	66470
chr4	1107423	1307423	harbor1	chr4	1174533	1174870	DNA/hAT-Charlie	1404	-	168	1174701	67278
chr4	150608140	150808140	harbor1	chr4	150652510	150652808	DNA/hAT-Charlie	1125	-	149	150652659	44519
chr4	52497288	52697288	harbor1	chr4	52497219	52497974	DNA/hAT-Charlie	4592	-	378	52497597	309
chr4	52497288	52697288	harbor1	chr4	52498346	52498729	DNA/hAT-Charlie	4592	-	192	52498538	1250
chr4	52497288	52697288	harbor1	chr4	52520887	52521017	DNA/hAT-Charlie	538	-	65	52520952	23664
chr4	52497288	52697288	harbor1	chr4	52546067	52546332	DNA/hAT-Charlie	1124	-	132	52546199	48911
chr4	52497288	52697288	harbor1	chr4	52555655	52555714	DNA/hAT-Charlie	739	-	30	52555685	58397
chr4	52497288	52697288	harbor1	chr4	52556208	52556343	DNA/hAT-Charlie	739	-	68	52556276	58988
chr4	128711743	128911743	harbor1	chr4	128773992	128774112	DNA/hAT-Charlie	1040	-	60	128774052	62309
chr4	128711743	128911743	harbor1	chr4	128774415	128774479	DNA/hAT-Charlie	1040	-	32	128774447	62704
chr4	128711743	128911743	harbor1	chr4	128780391	128780544	DNA/hAT-Charlie	541	-	76	128780467	68724
chr4	128711743	128911743	harbor1	chr4	128803957	128804103	DNA/hAT-Charlie	760	-	73	128804030	92287
chr4	76113424	76313424	harbor1	chr4	76116697	76116839	DNA/hAT-Charlie	634	-	71	76116768	3344
chr4	76113424	76313424	harbor1	chr4	76128151	76128328	DNA/hAT-Charlie	842	-	88	76128239	14815
chr4	76113424	76313424	harbor1	chr4	76205723	76205956	DNA/hAT-Charlie	679	-	116	76205839	92415
chr4	76113424	76313424	harbor1	chr4	76206308	76206468	DNA/hAT-Charlie	679	-	80	76206388	92964
chr4	2826521	3026521	harbor1	chr4	2861616	2861783	DNA/hAT-Charlie	576	-	84	2861700	35179
chr4	120822653	121022653	harbor1	chr4	120826861	120827342	DNA/hAT-Charlie	955	-	240	120827101	4448
chr4	120822653	121022653	harbor1	chr4	120827323	120827648	DNA/hAT-Charlie	925	-	162	120827485	4832
chr4	120822653	121022653	harbor1	chr4	120838512	120838706	DNA/hAT-Charlie	1288	-	97	120838609	15956
chr4	120822653	121022653	harbor1	chr4	120840876	120841000	DNA/hAT-Charlie	641	-	62	120840938	18285
chr4	120822653	121022653	harbor1	chr4	120882448	120883070	DNA/hAT-Charlie	7086	-	311	120882759	60106
chr4	120822653	121022653	harbor1	chr4	120910779	120911034	DNA/hAT-Charlie	801	-	128	120910907	88254
chr4	120822653	121022653	harbor1	chr4	120880382	120882215	DNA/hAT-Charlie	7086	-	916	120881298	58645
chr4	2363119	2563119	harbor1	chr4	2380006	2380537	DNA/hAT-Charlie	993	-	266	2380272	17153
chr4	2832662	3032662	harbor1	chr4	2861616	2861783	DNA/hAT-Charlie	576	-	84	2861700	29038
chr4	8767896	8967896	harbor1	chr4	8793456	8793740	DNA/hAT-Charlie	776	-	142	8793598	25702
chr4	8767896	8967896	harbor1	chr4	8797244	8797425	DNA/hAT-Charlie	866	-	90	8797334	29438
chr4	143414065	143614065	harbor1	chr4	143440634	143440925	DNA/hAT-Charlie	669	-	146	143440780	26715
chr4	143414065	143614065	harbor1	chr4	143471398	143471734	DNA/hAT-Charlie	679	-	168	143471566	57501
chr4	120822725	121022725	harbor1	chr4	120826861	120827342	DNA/hAT-Charlie	955	-	240	120827101	4376
chr4	120822725	121022725	harbor1	chr4	120827323	120827648	DNA/hAT-Charlie	925	-	162	120827485	4760
chr4	120822725	121022725	harbor1	chr4	120838512	120838706	DNA/hAT-Charlie	1288	-	97	120838609	15884
chr4	120822725	121022725	harbor1	chr4	120840876	120841000	DNA/hAT-Charlie	641	-	62	120840938	18213
chr4	120822725	121022725	harbor1	chr4	120882448	120883070	DNA/hAT-Charlie	7086	-	311	120882759	60034
chr4	120822725	121022725	harbor1	chr4	120910779	120911034	DNA/hAT-Charlie	801	-	128	120910907	88182
chr4	120822725	121022725	harbor1	chr4	120880382	120882215	DNA/hAT-Charlie	7086	-	916	120881298	58573
chr4	148339554	148539554	harbor1	chr4	148365441	148365898	DNA/hAT-Charlie	1629	-	228	148365669	26115
chr4	148339554	148539554	harbor1	chr4	148393484	148393715	DNA/hAT-Charlie	587	-	116	148393600	54046
chr4	148339554	148539554	harbor1	chr4	148431858	148432495	DNA/hAT-Charlie	2078	-	318	148432176	92622
chr4	148339554	148539554	harbor1	chr4	148438136	148438345	DNA/hAT-Charlie	1293	-	104	148438240	98686
chr4	55295888	55495888	harbor1	chr4	55367955	55368088	DNA/hAT-Charlie	636	-	66	55368021	72133
chr4	25762833	25962833	harbor1	chr4	25777872	25778073	DNA/hAT-Charlie	945	-	100	25777972	15139
chr4	25762833	25962833	harbor1	chr4	25840713	25840905	DNA/hAT-Charlie	639	-	96	25840809	77976
chr4	70739714	70939714	harbor1	chr4	70762338	70762458	DNA/hAT-Charlie	568	-	60	70762398	22684
chr4	153364398	153564398	harbor1	chr4	153396107	153396309	DNA/hAT-Charlie	801	-	101	153396208	31810
chr4	15581883	15781883	harbor1	chr4	15587031	15587371	DNA/hAT-Charlie	2099	-	170	15587201	5318
chr4	15581883	15781883	harbor1	chr4	15633935	15634143	DNA/hAT-Charlie	956	-	104	15634039	52156
chr4	15581883	15781883	harbor1	chr4	15646047	15646350	DNA/hAT-Charlie	1361	-	152	15646199	64316
chr4	139076181	139276181	harbor1	chr4	139078759	139078940	DNA/hAT-Charlie	1164	-	90	139078849	2668
chr4	139076181	139276181	harbor1	chr4	139079230	139079517	DNA/hAT-Charlie	1164	-	144	139079374	3193
chr4	120822783	121022783	harbor1	chr4	120826861	120827342	DNA/hAT-Charlie	955	-	240	120827101	4318
chr4	120822783	121022783	harbor1	chr4	120827323	120827648	DNA/hAT-Charlie	925	-	162	120827485	4702
chr4	120822783	121022783	harbor1	chr4	120838512	120838706	DNA/hAT-Charlie	1288	-	97	120838609	15826
chr4	120822783	121022783	harbor1	chr4	120840876	120841000	DNA/hAT-Charlie	641	-	62	120840938	18155
chr4	120822783	121022783	harbor1	chr4	120882448	120883070	DNA/hAT-Charlie	7086	-	311	120882759	59976
chr4	120822783	121022783	harbor1	chr4	120910779	120911034	DNA/hAT-Charlie	801	-	128	120910907	88124
chr4	120822783	121022783	harbor1	chr4	120880382	120882215	DNA/hAT-Charlie	7086	-	916	120881298	58515
chr4	55295797	55495797	harbor1	chr4	55367955	55368088	DNA/hAT-Charlie	636	-	66	55368021	72224
chr5	73351493	73551493	harbor1	chr5	73366527	73366862	DNA/hAT-Charlie	2157	-	168	73366695	15202
chr5	73351493	73551493	harbor1	chr5	73372908	73373048	DNA/hAT-Charlie	559	-	70	73372978	21485
chr5	9549845	9749845	harbor1	chr5	9559208	9559379	DNA/hAT-Charlie	849	-	86	9559294	9449
chr5	9549845	9749845	harbor1	chr5	9559388	9559574	DNA/hAT-Charlie	807	-	93	9559481	9636
chr5	9549845	9749845	harbor1	chr5	9609403	9609554	DNA/hAT-Charlie	532	-	76	9609479	59634
chr5	9549845	9749845	harbor1	chr5	9630948	9631123	DNA/hAT-Charlie	634	-	88	9631036	81191
chr5	10661237	10861237	harbor1	chr5	10705036	10705212	DNA/hAT-Charlie	428	-	88	10705124	43887
chr5	9114326	9314326	harbor1	chr5	9128801	9129010	DNA/hAT-Charlie	1078	-	104	9128905	14579
chr5	9114326	9314326	harbor1	chr5	9161347	9161648	DNA/hAT-Charlie	738	-	150	9161497	47171
chr5	9114326	9314326	harbor1	chr5	9182395	9182598	DNA/hAT-Charlie	534	-	102	9182497	68171
chr5	10341920	10541920	harbor1	chr5	10362406	10362849	DNA/hAT-Charlie	738	-	222	10362628	20708
chr5	10341920	10541920	harbor1	chr5	10372641	10372903	DNA/hAT-Charlie	775	-	131	10372772	30852
chr5	10341920	10541920	harbor1	chr5	10413895	10414099	DNA/hAT-Charlie	899	-	102	10413997	72077
chr5	10150551	10350551	harbor1	chr5	10155446	10155548	DNA/hAT-Charlie	442	-	51	10155497	4946
chr5	10150551	10350551	harbor1	chr5	10158553	10158825	DNA/hAT-Charlie	453	-	136	10158689	8138
chr5	10150551	10350551	harbor1	chr5	10158854	10159096	DNA/hAT-Charlie	442	-	121	10158975	8424
chr5	150532654	150732654	harbor1	chr5	150591546	150591864	DNA/hAT-Charlie	1244	-	159	150591705	59051
chr5	150532654	150732654	harbor1	chr5	150607706	150608039	DNA/hAT-Charlie	1508	-	166	150607872	75218
chr5	150532654	150732654	harbor1	chr5	150608678	150608845	DNA/hAT-Charlie	746	-	84	150608762	76108
chr5	37007782	37207782	harbor1	chr5	37008937	37009143	DNA/hAT-Charlie	852	-	103	37009040	1258
chr5	37007782	37207782	harbor1	chr5	37035491	37035701	DNA/hAT-Charlie	639	-	105	37035596	27814
chr5	37007782	37207782	harbor1	chr5	37043768	37043987	DNA/hAT-Charlie	1136	-	110	37043878	36096
chr5	37007782	37207782	harbor1	chr5	37045725	37045963	DNA/hAT-Charlie	789	-	119	37045844	38062
chr5	37007782	37207782	harbor1	chr5	37106584	37106823	DNA/hAT-Charlie	977	-	120	37106704	98922
chr5	37007782	37207782	harbor1	chr5	37076936	37077090	DNA/hAT-Charlie	643	-	77	37077013	69231
chr5	6633235	6833235	harbor1	chr5	6641951	6642465	DNA/hAT-Charlie	2373	-	257	6642208	8973
chr5	6633235	6833235	harbor1	chr5	6642478	6643297	DNA/hAT-Charlie	5122	-	410	6642888	9653
chr5	6633235	6833235	harbor1	chr5	6643590	6643970	DNA/hAT-Charlie	5122	-	190	6643780	10545
chr5	6633235	6833235	harbor1	chr5	6682783	6683008	DNA/hAT-Charlie	593	-	112	6682895	49660
chr5	6633235	6833235	harbor1	chr5	6709310	6709487	DNA/hAT-Charlie	427	-	88	6709398	76163
chr5	10102676	10302676	harbor1	chr5	10141244	10141370	DNA/hAT-Charlie	433	-	63	10141307	38631
chr5	10102676	10302676	harbor1	chr5	10141884	10141896	DNA/hAT-Charlie	603	-	6	10141890	39214
chr5	10102676	10302676	harbor1	chr5	10143522	10143682	DNA/hAT-Charlie	603	-	80	10143602	40926
chr5	10102676	10302676	harbor1	chr5	10155446	10155548	DNA/hAT-Charlie	442	-	51	10155497	52821
chr5	10102676	10302676	harbor1	chr5	10158553	10158825	DNA/hAT-Charlie	453	-	136	10158689	56013
chr5	10102676	10302676	harbor1	chr5	10158854	10159096	DNA/hAT-Charlie	442	-	121	10158975	56299
chr5	10296849	10496849	harbor1	chr5	10362406	10362849	DNA/hAT-Charlie	738	-	222	10362628	65779
chr5	10296849	10496849	harbor1	chr5	10372641	10372903	DNA/hAT-Charlie	775	-	131	10372772	75923
chr5	10661256	10861256	harbor1	chr5	10705036	10705212	DNA/hAT-Charlie	428	-	88	10705124	43868
chr5	139560781	139760781	harbor1	chr5	139566701	139566901	DNA/hAT-Charlie	582	-	100	139566801	6020
chr5	139560781	139760781	harbor1	chr5	139573402	139573687	DNA/hAT-Charlie	952	-	142	139573544	12763
chr5	139560781	139760781	harbor1	chr5	139573999	139574077	DNA/hAT-Charlie	952	-	39	139574038	13257
chr5	139560781	139760781	harbor1	chr5	139592395	139592563	DNA/hAT-Charlie	644	-	84	139592479	31698
chr5	139560781	139760781	harbor1	chr5	139639582	139639730	DNA/hAT-Charlie	592	-	74	139639656	78875
chr5	40697590	40897590	harbor1	chr5	40717478	40717685	DNA/hAT-Charlie	940	-	104	40717582	19992
chr5	40697590	40897590	harbor1	chr5	40733303	40733458	DNA/hAT-Charlie	795	-	78	40733381	35791
chr5	40697590	40897590	harbor1	chr5	40756521	40756732	DNA/hAT-Charlie	808	-	106	40756627	59037
chr5	141778257	141978257	harbor1	chr5	141781161	141781337	DNA/hAT-Charlie	900	-	88	141781249	2992
chr5	141778257	141978257	harbor1	chr5	141801191	141801348	DNA/hAT-Charlie	811	-	78	141801269	23012
chr5	141778257	141978257	harbor1	chr5	141812337	141812553	DNA/hAT-Charlie	1375	-	108	141812445	34188
chr5	139559543	139759543	harbor1	chr5	139566701	139566901	DNA/hAT-Charlie	582	-	100	139566801	7258
chr5	139559543	139759543	harbor1	chr5	139573402	139573687	DNA/hAT-Charlie	952	-	142	139573544	14001
chr5	139559543	139759543	harbor1	chr5	139573999	139574077	DNA/hAT-Charlie	952	-	39	139574038	14495
chr5	139559543	139759543	harbor1	chr5	139592395	139592563	DNA/hAT-Charlie	644	-	84	139592479	32936
chr5	139559543	139759543	harbor1	chr5	139639582	139639730	DNA/hAT-Charlie	592	-	74	139639656	80113
chr5	10661135	10861135	harbor1	chr5	10705036	10705212	DNA/hAT-Charlie	428	-	88	10705124	43989
chr5	10184404	10384404	harbor1	chr5	10257816	10257950	DNA/hAT-Charlie	620	-	67	10257883	73479
chr5	135008188	135208188	harbor1	chr5	135104594	135104883	DNA/hAT-Charlie	915	-	144	135104738	96550
chr5	169913062	170113062	harbor1	chr5	169921462	169921656	DNA/hAT-Charlie	501	-	97	169921559	8497
chr5	169913062	170113062	harbor1	chr5	169927322	169927465	DNA/hAT-Charlie	599	-	72	169927394	14332
chr5	169913062	170113062	harbor1	chr5	169933276	169933424	DNA/hAT-Charlie	461	-	74	169933350	20288
chr5	169913062	170113062	harbor1	chr5	169940369	169940877	DNA/hAT-Charlie	3771	-	254	169940623	27561
chr5	169913062	170113062	harbor1	chr5	169963794	169963974	DNA/hAT-Charlie	733	-	90	169963884	50822
chr5	169913062	170113062	harbor1	chr5	169965206	169965366	DNA/hAT-Charlie	756	-	80	169965286	52224
chr5	169913062	170113062	harbor1	chr5	169969659	169969703	DNA/hAT-Charlie	586	-	22	169969681	56619
chr5	169913062	170113062	harbor1	chr5	169969791	169970001	DNA/hAT-Charlie	586	-	105	169969896	56834
chr5	169913062	170113062	harbor1	chr5	169971952	169972080	DNA/hAT-Charlie	652	-	64	169972016	58954
chr5	169913062	170113062	harbor1	chr5	169972328	169972536	DNA/hAT-Charlie	915	-	104	169972432	59370
chr5	169913062	170113062	harbor1	chr5	170007802	170007969	DNA/hAT-Charlie	911	-	84	170007886	94824
chr5	169913062	170113062	harbor1	chr5	170010166	170010274	DNA/hAT-Charlie	655	-	54	170010220	97158
chr5	169913062	170113062	harbor1	chr5	170010272	170010683	DNA/hAT-Charlie	696	-	206	170010478	97416
chr5	109788598	109988598	harbor1	chr5	109831464	109831805	DNA/hAT-Charlie	1609	-	170	109831634	43036
chr5	109788598	109988598	harbor1	chr5	109831833	109832156	DNA/hAT-Charlie	1609	-	162	109831995	43397
chr5	109788598	109988598	harbor1	chr5	109833715	109833939	DNA/hAT-Charlie	927	-	112	109833827	45229
chr5	132128916	132328916	harbor1	chr5	132176428	132176497	DNA/hAT-Charlie	431	-	34	132176462	47546
chr5	132128916	132328916	harbor1	chr5	132176839	132176875	DNA/hAT-Charlie	431	-	18	132176857	47941
chr5	73351452	73551452	harbor1	chr5	73366527	73366862	DNA/hAT-Charlie	2157	-	168	73366695	15243
chr5	73351452	73551452	harbor1	chr5	73372908	73373048	DNA/hAT-Charlie	559	-	70	73372978	21526
chr5	37740423	37940423	harbor1	chr5	37741413	37741746	DNA/hAT-Charlie	2299	-	166	37741579	1156
chr5	37740423	37940423	harbor1	chr5	37816499	37816666	DNA/hAT-Charlie	461	-	84	37816583	76160
chr5	37740423	37940423	harbor1	chr5	37818094	37818205	DNA/hAT-Charlie	915	-	56	37818150	77727
chr5	37740423	37940423	harbor1	chr5	37818574	37818668	DNA/hAT-Charlie	915	-	47	37818621	78198
chr5	9749157	9949157	harbor1	chr5	9786523	9786690	DNA/hAT-Charlie	493	-	84	9786607	37450
chr5	9749157	9949157	harbor1	chr5	9823253	9823414	DNA/hAT-Charlie	569	-	80	9823333	74176
chr5	9749157	9949157	harbor1	chr5	9836361	9836579	DNA/hAT-Charlie	1172	-	109	9836470	87313
chr5	10341913	10541913	harbor1	chr5	10362406	10362849	DNA/hAT-Charlie	738	-	222	10362628	20715
chr5	10341913	10541913	harbor1	chr5	10372641	10372903	DNA/hAT-Charlie	775	-	131	10372772	30859
chr5	10341913	10541913	harbor1	chr5	10413895	10414099	DNA/hAT-Charlie	899	-	102	10413997	72084
chr5	73350932	73550932	harbor1	chr5	73366527	73366862	DNA/hAT-Charlie	2157	-	168	73366695	15763
chr5	73350932	73550932	harbor1	chr5	73372908	73373048	DNA/hAT-Charlie	559	-	70	73372978	22046
chr5	9879703	10079703	harbor1	chr5	9880484	9880688	DNA/hAT-Charlie	934	-	102	9880586	883
chr5	9879703	10079703	harbor1	chr5	9912554	9912757	DNA/hAT-Charlie	672	-	102	9912656	32953
chr5	9879703	10079703	harbor1	chr5	9949206	9949564	DNA/hAT-Charlie	2366	-	179	9949385	69682
chr5	9879703	10079703	harbor1	chr5	9966552	9966729	DNA/hAT-Charlie	782	-	88	9966640	86937
chr5	10661236	10861236	harbor1	chr5	10705036	10705212	DNA/hAT-Charlie	428	-	88	10705124	43888
chr5	176525237	176725237	harbor1	chr5	176600501	176600631	DNA/hAT-Charlie	816	-	65	176600566	75329
chr5	176525237	176725237	harbor1	chr5	176600947	176601143	DNA/hAT-Charlie	816	-	98	176601045	75808
chr5	176525237	176725237	harbor1	chr5	176603808	176604012	DNA/hAT-Charlie	467	-	102	176603910	78673
chr5	79136023	79336023	harbor1	chr5	79203030	79203186	DNA/hAT-Charlie	565	-	78	79203108	67085
chr5	135374498	135574498	harbor1	chr5	135401479	135402371	DNA/hAT-Charlie	4509	-	446	135401925	27427
chr5	135374498	135574498	harbor1	chr5	135402818	135403053	DNA/hAT-Charlie	2334	-	118	135402936	28438
chr5	135374498	135574498	harbor1	chr5	135403079	135403324	DNA/hAT-Charlie	2334	-	122	135403201	28703
chr5	135374498	135574498	harbor1	chr5	135432989	135433093	DNA/hAT-Charlie	482	-	52	135433041	58543
chr5	135008281	135208281	harbor1	chr5	135104594	135104883	DNA/hAT-Charlie	915	-	144	135104738	96457
chr5	135830655	136030655	harbor1	chr5	135860259	135860565	DNA/hAT-Charlie	841	-	153	135860412	29757
chr5	135830655	136030655	harbor1	chr5	135865771	135866039	DNA/hAT-Charlie	467	-	134	135865905	35250
chr5	135830655	136030655	harbor1	chr5	135883910	135884093	DNA/hAT-Charlie	526	-	92	135884002	53347
chr5	135830655	136030655	harbor1	chr5	135887063	135887416	DNA/hAT-Charlie	1208	-	176	135887239	56584
chr5	135830655	136030655	harbor1	chr5	135898250	135898558	DNA/hAT-Charlie	724	-	154	135898404	67749
chr5	10341778	10541778	harbor1	chr5	10362406	10362849	DNA/hAT-Charlie	738	-	222	10362628	20850
chr5	10341778	10541778	harbor1	chr5	10372641	10372903	DNA/hAT-Charlie	775	-	131	10372772	30994
chr5	10341778	10541778	harbor1	chr5	10413895	10414099	DNA/hAT-Charlie	899	-	102	10413997	72219
chr5	177199777	177399777	harbor1	chr5	177273213	177273408	DNA/hAT-Charlie	1300	-	98	177273311	73534
chr5	177199777	177399777	harbor1	chr5	177283470	177283649	DNA/hAT-Charlie	691	-	90	177283560	83783
chr5	71628508	71828508	harbor1	chr5	71664165	71664237	DNA/hAT-Charlie	456	-	36	71664201	35693
chr5	71628508	71828508	harbor1	chr5	71668811	71668867	DNA/hAT-Charlie	457	-	28	71668839	40331
chr5	71628508	71828508	harbor1	chr5	71669170	71669276	DNA/hAT-Charlie	457	-	53	71669223	40715
chr5	52700042	52900042	harbor1	chr5	52767147	52767326	DNA/hAT-Charlie	2078	-	90	52767237	67195
chr5	52700042	52900042	harbor1	chr5	52767696	52768605	DNA/hAT-Charlie	2078	-	454	52768150	68108
chr5	52700042	52900042	harbor1	chr5	52785362	52785680	DNA/hAT-Charlie	2159	-	159	52785521	85479
chr5	73350824	73550824	harbor1	chr5	73366527	73366862	DNA/hAT-Charlie	2157	-	168	73366695	15871
chr5	73350824	73550824	harbor1	chr5	73372908	73373048	DNA/hAT-Charlie	559	-	70	73372978	22154
chr5	372623	572623	harbor1	chr5	408004	408198	DNA/hAT-Charlie	683	-	97	408101	35478
chr5	372623	572623	harbor1	chr5	428538	429067	DNA/hAT-Charlie	3274	-	264	428802	56179
chr5	10661301	10861301	harbor1	chr5	10705036	10705212	DNA/hAT-Charlie	428	-	88	10705124	43823
chr5	175976844	176176844	harbor1	chr5	175988656	175988908	DNA/hAT-Charlie	432	-	126	175988782	11938
chr5	73336206	73536206	harbor1	chr5	73366527	73366862	DNA/hAT-Charlie	2157	-	168	73366695	30489
chr5	73336206	73536206	harbor1	chr5	73372908	73373048	DNA/hAT-Charlie	559	-	70	73372978	36772
chr5	9111212	9311212	harbor1	chr5	9128801	9129010	DNA/hAT-Charlie	1078	-	104	9128905	17693
chr5	9111212	9311212	harbor1	chr5	9161347	9161648	DNA/hAT-Charlie	738	-	150	9161497	50285
chr5	9111212	9311212	harbor1	chr5	9182395	9182598	DNA/hAT-Charlie	534	-	102	9182497	71285
chr5	79136006	79336006	harbor1	chr5	79203030	79203186	DNA/hAT-Charlie	565	-	78	79203108	67102
chr5	73177858	73377858	harbor1	chr5	73188037	73188139	DNA/hAT-Charlie	1519	-	51	73188088	10230
chr5	73177858	73377858	harbor1	chr5	73188177	73188279	DNA/hAT-Charlie	1519	-	51	73188228	10370
chr5	73177858	73377858	harbor1	chr5	73225556	73225664	DNA/hAT-Charlie	582	-	54	73225610	47752
chr5	73177858	73377858	harbor1	chr5	73227310	73227409	DNA/hAT-Charlie	806	-	50	73227360	49502
chr5	73177858	73377858	harbor1	chr5	73227806	73227924	DNA/hAT-Charlie	806	-	59	73227865	50007
chr5	73177858	73377858	harbor1	chr5	73274139	73274414	DNA/hAT-Charlie	567	-	138	73274277	96419
chr5	73177858	73377858	harbor1	chr5	73274411	73274638	DNA/hAT-Charlie	559	-	114	73274525	96667
chr5	181061441	181261441	harbor1	chr5	181105452	181105775	DNA/hAT-Charlie	915	-	162	181105614	44173
chr5	181061441	181261441	harbor1	chr5	181111795	181111898	DNA/hAT-Charlie	506	-	52	181111847	50406
chr5	141125589	141325589	harbor1	chr5	141217327	141217553	DNA/hAT-Charlie	457	-	113	141217440	91851
chr5	421781	621781	harbor1	chr5	428538	429067	DNA/hAT-Charlie	3274	-	264	428802	7021
chr5	10341929	10541929	harbor1	chr5	10362406	10362849	DNA/hAT-Charlie	738	-	222	10362628	20699
chr5	10341929	10541929	harbor1	chr5	10372641	10372903	DNA/hAT-Charlie	775	-	131	10372772	30843
chr5	10341929	10541929	harbor1	chr5	10413895	10414099	DNA/hAT-Charlie	899	-	102	10413997	72068
chr5	10660380	10860380	harbor1	chr5	10705036	10705212	DNA/hAT-Charlie	428	-	88	10705124	44744
chr5	139797116	139997116	harbor1	chr5	139844298	139844495	DNA/hAT-Charlie	821	-	98	139844396	47280
chr5	73351484	73551484	harbor1	chr5	73366527	73366862	DNA/hAT-Charlie	2157	-	168	73366695	15211
chr5	73351484	73551484	harbor1	chr5	73372908	73373048	DNA/hAT-Charlie	559	-	70	73372978	21494
chr5	9114356	9314356	harbor1	chr5	9128801	9129010	DNA/hAT-Charlie	1078	-	104	9128905	14549
chr5	9114356	9314356	harbor1	chr5	9161347	9161648	DNA/hAT-Charlie	738	-	150	9161497	47141
chr5	9114356	9314356	harbor1	chr5	9182395	9182598	DNA/hAT-Charlie	534	-	102	9182497	68141
chr5	9114296	9314296	harbor1	chr5	9128801	9129010	DNA/hAT-Charlie	1078	-	104	9128905	14609
chr5	9114296	9314296	harbor1	chr5	9161347	9161648	DNA/hAT-Charlie	738	-	150	9161497	47201
chr5	9114296	9314296	harbor1	chr5	9182395	9182598	DNA/hAT-Charlie	534	-	102	9182497	68201
chr5	132103968	132303968	harbor1	chr5	132104445	132104681	DNA/hAT-Charlie	1448	-	118	132104563	595
chr5	132103968	132303968	harbor1	chr5	132176428	132176497	DNA/hAT-Charlie	431	-	34	132176462	72494
chr5	132103968	132303968	harbor1	chr5	132176839	132176875	DNA/hAT-Charlie	431	-	18	132176857	72889
chr5	150964914	151164914	harbor1	chr5	151010738	151010904	DNA/hAT-Charlie	761	-	83	151010821	45907
chr5	150964914	151164914	harbor1	chr5	151015424	151015551	DNA/hAT-Charlie	1030	-	64	151015488	50574
chr5	150964914	151164914	harbor1	chr5	151015809	151015977	DNA/hAT-Charlie	1030	-	84	151015893	50979
chr5	135980228	136180228	harbor1	chr5	136015803	136015985	DNA/hAT-Charlie	937	-	91	136015894	35666
chr5	135980228	136180228	harbor1	chr5	136074858	136075008	DNA/hAT-Charlie	556	-	75	136074933	94705
chr5	135980228	136180228	harbor1	chr5	136075167	136075283	DNA/hAT-Charlie	595	-	58	136075225	94997
chr5	135980228	136180228	harbor1	chr5	136078284	136078506	DNA/hAT-Charlie	1571	-	111	136078395	98167
chr5	73351560	73551560	harbor1	chr5	73366527	73366862	DNA/hAT-Charlie	2157	-	168	73366695	15135
chr5	73351560	73551560	harbor1	chr5	73372908	73373048	DNA/hAT-Charlie	559	-	70	73372978	21418
chr5	10661235	10861235	harbor1	chr5	10705036	10705212	DNA/hAT-Charlie	428	-	88	10705124	43889
chr5	9114331	9314331	harbor1	chr5	9128801	9129010	DNA/hAT-Charlie	1078	-	104	9128905	14574
chr5	9114331	9314331	harbor1	chr5	9161347	9161648	DNA/hAT-Charlie	738	-	150	9161497	47166
chr5	9114331	9314331	harbor1	chr5	9182395	9182598	DNA/hAT-Charlie	534	-	102	9182497	68166
chr5	52699384	52899384	harbor1	chr5	52767147	52767326	DNA/hAT-Charlie	2078	-	90	52767237	67853
chr5	52699384	52899384	harbor1	chr5	52767696	52768605	DNA/hAT-Charlie	2078	-	454	52768150	68766
chr5	52699384	52899384	harbor1	chr5	52785362	52785680	DNA/hAT-Charlie	2159	-	159	52785521	86137
chr5	9114252	9314252	harbor1	chr5	9128801	9129010	DNA/hAT-Charlie	1078	-	104	9128905	14653
chr5	9114252	9314252	harbor1	chr5	9161347	9161648	DNA/hAT-Charlie	738	-	150	9161497	47245
chr5	9114252	9314252	harbor1	chr5	9182395	9182598	DNA/hAT-Charlie	534	-	102	9182497	68245
chr5	9114320	9314320	harbor1	chr5	9128801	9129010	DNA/hAT-Charlie	1078	-	104	9128905	14585
chr5	9114320	9314320	harbor1	chr5	9161347	9161648	DNA/hAT-Charlie	738	-	150	9161497	47177
chr5	9114320	9314320	harbor1	chr5	9182395	9182598	DNA/hAT-Charlie	534	-	102	9182497	68177
chr5	171287664	171487664	harbor1	chr5	171306315	171306499	DNA/hAT-Charlie	1049	-	92	171306407	18743
chr5	93472721	93672721	harbor1	chr5	93542348	93542552	DNA/hAT-Charlie	1014	-	102	93542450	69729
chr5	73351469	73551469	harbor1	chr5	73366527	73366862	DNA/hAT-Charlie	2157	-	168	73366695	15226
chr5	73351469	73551469	harbor1	chr5	73372908	73373048	DNA/hAT-Charlie	559	-	70	73372978	21509
chr5	7622638	7822638	harbor1	chr5	7661502	7661998	DNA/hAT-Charlie	1046	-	248	7661750	39112
chr5	7622638	7822638	harbor1	chr5	7670590	7670916	DNA/hAT-Charlie	2158	-	163	7670753	48115
chr5	9057233	9257233	harbor1	chr5	9128801	9129010	DNA/hAT-Charlie	1078	-	104	9128905	71672
chr5	9114329	9314329	harbor1	chr5	9128801	9129010	DNA/hAT-Charlie	1078	-	104	9128905	14576
chr5	9114329	9314329	harbor1	chr5	9161347	9161648	DNA/hAT-Charlie	738	-	150	9161497	47168
chr5	9114329	9314329	harbor1	chr5	9182395	9182598	DNA/hAT-Charlie	534	-	102	9182497	68168
chr5	10311688	10511688	harbor1	chr5	10362406	10362849	DNA/hAT-Charlie	738	-	222	10362628	50940
chr5	10311688	10511688	harbor1	chr5	10372641	10372903	DNA/hAT-Charlie	775	-	131	10372772	61084
chr5	74950541	75150541	harbor1	chr5	74959686	74959875	DNA/hAT-Charlie	436	-	94	74959780	9239
chr5	74950541	75150541	harbor1	chr5	74973686	74973716	DNA/hAT-Charlie	508	-	15	74973701	23160
chr5	74950541	75150541	harbor1	chr5	74994979	74995139	DNA/hAT-Charlie	783	-	80	74995059	44518
chr5	74950541	75150541	harbor1	chr5	75007501	75007641	DNA/hAT-Charlie	604	-	70	75007571	57030
chr5	74950541	75150541	harbor1	chr5	75013247	75013413	DNA/hAT-Charlie	898	-	83	75013330	62789
chr5	74950541	75150541	harbor1	chr5	75031373	75031571	DNA/hAT-Charlie	1169	-	99	75031472	80931
chr5	74950541	75150541	harbor1	chr5	74973116	74973240	DNA/hAT-Charlie	508	-	62	74973178	22637
chr5	143206591	143406591	harbor1	chr5	143271474	143271692	DNA/hAT-Charlie	1103	-	109	143271583	64992
chr5	73114177	73314177	harbor1	chr5	73156932	73157113	DNA/hAT-Charlie	976	-	90	73157022	42845
chr5	73114177	73314177	harbor1	chr5	73188037	73188139	DNA/hAT-Charlie	1519	-	51	73188088	73911
chr5	73114177	73314177	harbor1	chr5	73188177	73188279	DNA/hAT-Charlie	1519	-	51	73188228	74051
chr5	171288209	171488209	harbor1	chr5	171306315	171306499	DNA/hAT-Charlie	1049	-	92	171306407	18198
chr5	181061409	181261409	harbor1	chr5	181105452	181105775	DNA/hAT-Charlie	915	-	162	181105614	44205
chr5	181061409	181261409	harbor1	chr5	181111795	181111898	DNA/hAT-Charlie	506	-	52	181111847	50438
chr5	10661175	10861175	harbor1	chr5	10705036	10705212	DNA/hAT-Charlie	428	-	88	10705124	43949
chr5	93221055	93421055	harbor1	chr5	93290843	93291243	DNA/hAT-Charlie	1325	-	200	93291043	69988
chr5	52700079	52900079	harbor1	chr5	52767147	52767326	DNA/hAT-Charlie	2078	-	90	52767237	67158
chr5	52700079	52900079	harbor1	chr5	52767696	52768605	DNA/hAT-Charlie	2078	-	454	52768150	68071
chr5	52700079	52900079	harbor1	chr5	52785362	52785680	DNA/hAT-Charlie	2159	-	159	52785521	85442
chr5	4842506	5042506	harbor1	chr5	4844650	4846615	DNA/hAT-Charlie	1497	-	982	4845632	3126
chr5	4842506	5042506	harbor1	chr5	4853496	4853825	DNA/hAT-Charlie	1749	-	164	4853660	11154
chr5	4842506	5042506	harbor1	chr5	4928113	4928320	DNA/hAT-Charlie	1147	-	104	4928217	85711
chr5	4842506	5042506	harbor1	chr5	4915056	4915239	DNA/hAT-Charlie	426	-	92	4915148	72642
chr5	150964913	151164913	harbor1	chr5	151010738	151010904	DNA/hAT-Charlie	761	-	83	151010821	45908
chr5	150964913	151164913	harbor1	chr5	151015424	151015551	DNA/hAT-Charlie	1030	-	64	151015488	50575
chr5	150964913	151164913	harbor1	chr5	151015809	151015977	DNA/hAT-Charlie	1030	-	84	151015893	50980
chr5	52699708	52899708	harbor1	chr5	52767147	52767326	DNA/hAT-Charlie	2078	-	90	52767237	67529
chr5	52699708	52899708	harbor1	chr5	52767696	52768605	DNA/hAT-Charlie	2078	-	454	52768150	68442
chr5	52699708	52899708	harbor1	chr5	52785362	52785680	DNA/hAT-Charlie	2159	-	159	52785521	85813
chr5	10660536	10860536	harbor1	chr5	10705036	10705212	DNA/hAT-Charlie	428	-	88	10705124	44588
chr5	10024023	10224023	harbor1	chr5	10077710	10077863	DNA/hAT-Charlie	670	-	76	10077786	53763
chr5	10024023	10224023	harbor1	chr5	10092547	10092765	DNA/hAT-Charlie	815	-	109	10092656	68633
chr5	170538258	170738258	harbor1	chr5	170549611	170549818	DNA/hAT-Charlie	671	-	104	170549715	11457
chr5	170538258	170738258	harbor1	chr5	170571855	170572222	DNA/hAT-Charlie	879	-	184	170572039	33781
chr5	170538258	170738258	harbor1	chr5	170614432	170614569	DNA/hAT-Charlie	413	-	68	170614500	76242
chr5	170538258	170738258	harbor1	chr5	170617649	170617772	DNA/hAT-Charlie	456	-	62	170617711	79453
chr5	170538258	170738258	harbor1	chr5	170634280	170634488	DNA/hAT-Charlie	577	-	104	170634384	96126
chr5	170538258	170738258	harbor1	chr5	170622861	170623208	DNA/hAT-Charlie	2091	-	174	170623035	84777
chr5	64935093	65135093	harbor1	chr5	64951878	64951997	DNA/hAT-Charlie	549	-	60	64951938	16845
chr5	64935093	65135093	harbor1	chr5	64952332	64952408	DNA/hAT-Charlie	549	-	38	64952370	17277
chr5	64935093	65135093	harbor1	chr5	64982751	64982788	DNA/hAT-Charlie	460	-	18	64982769	47676
chr5	64935093	65135093	harbor1	chr5	64983130	64983495	DNA/hAT-Charlie	1137	-	182	64983312	48219
chr5	132103911	132303911	harbor1	chr5	132104445	132104681	DNA/hAT-Charlie	1448	-	118	132104563	652
chr5	132103911	132303911	harbor1	chr5	132176428	132176497	DNA/hAT-Charlie	431	-	34	132176462	72551
chr5	132103911	132303911	harbor1	chr5	132176839	132176875	DNA/hAT-Charlie	431	-	18	132176857	72946
chr5	79136012	79336012	harbor1	chr5	79203030	79203186	DNA/hAT-Charlie	565	-	78	79203108	67096
chr5	73350822	73550822	harbor1	chr5	73366527	73366862	DNA/hAT-Charlie	2157	-	168	73366695	15873
chr5	73350822	73550822	harbor1	chr5	73372908	73373048	DNA/hAT-Charlie	559	-	70	73372978	22156
chr5	10661147	10861147	harbor1	chr5	10705036	10705212	DNA/hAT-Charlie	428	-	88	10705124	43977
chr5	135919218	136119218	harbor1	chr5	135939878	135940169	DNA/hAT-Charlie	1111	-	146	135940024	20806
chr5	135919218	136119218	harbor1	chr5	136015803	136015985	DNA/hAT-Charlie	937	-	91	136015894	96676
chr5	6533033	6733033	harbor1	chr5	6541419	6541582	DNA/hAT-Charlie	892	-	82	6541501	8468
chr5	6533033	6733033	harbor1	chr5	6573237	6573382	DNA/hAT-Charlie	681	-	72	6573309	40276
chr5	126677744	126877744	harbor1	chr5	126689973	126690030	DNA/hAT-Charlie	1451	-	28	126690001	12257
chr5	126677744	126877744	harbor1	chr5	126690321	126690401	DNA/hAT-Charlie	1451	-	40	126690361	12617
chr5	126677744	126877744	harbor1	chr5	126691022	126691345	DNA/hAT-Charlie	1451	-	162	126691184	13440
chr5	126677744	126877744	harbor1	chr5	126696252	126696365	DNA/hAT-Charlie	628	-	56	126696308	18564
chr5	126677744	126877744	harbor1	chr5	126696525	126696674	DNA/hAT-Charlie	1068	-	74	126696599	18855
chr5	126677744	126877744	harbor1	chr5	126696984	126697394	DNA/hAT-Charlie	1068	-	205	126697189	19445
chr5	126677744	126877744	harbor1	chr5	126698095	126698172	DNA/hAT-Charlie	1068	-	38	126698133	20389
chr5	126677744	126877744	harbor1	chr5	126698199	126698442	DNA/hAT-Charlie	593	-	122	126698321	20577
chr5	10341894	10541894	harbor1	chr5	10362406	10362849	DNA/hAT-Charlie	738	-	222	10362628	20734
chr5	10341894	10541894	harbor1	chr5	10372641	10372903	DNA/hAT-Charlie	775	-	131	10372772	30878
chr5	10341894	10541894	harbor1	chr5	10413895	10414099	DNA/hAT-Charlie	899	-	102	10413997	72103
chr5	10231669	10431669	harbor1	chr5	10257816	10257950	DNA/hAT-Charlie	620	-	67	10257883	26214
chr5	93490732	93690732	harbor1	chr5	93542348	93542552	DNA/hAT-Charlie	1014	-	102	93542450	51718
chr5	10150998	10350998	harbor1	chr5	10155446	10155548	DNA/hAT-Charlie	442	-	51	10155497	4499
chr5	10150998	10350998	harbor1	chr5	10158553	10158825	DNA/hAT-Charlie	453	-	136	10158689	7691
chr5	10150998	10350998	harbor1	chr5	10158854	10159096	DNA/hAT-Charlie	442	-	121	10158975	7977
chr5	71628507	71828507	harbor1	chr5	71664165	71664237	DNA/hAT-Charlie	456	-	36	71664201	35694
chr5	71628507	71828507	harbor1	chr5	71668811	71668867	DNA/hAT-Charlie	457	-	28	71668839	40332
chr5	71628507	71828507	harbor1	chr5	71669170	71669276	DNA/hAT-Charlie	457	-	53	71669223	40716
chr5	177199421	177399421	harbor1	chr5	177273213	177273408	DNA/hAT-Charlie	1300	-	98	177273311	73890
chr5	177199421	177399421	harbor1	chr5	177283470	177283649	DNA/hAT-Charlie	691	-	90	177283560	84139
chr5	179703607	179903607	harbor1	chr5	179743840	179744187	DNA/hAT-Charlie	942	-	174	179744014	40407
chr5	179703607	179903607	harbor1	chr5	179744486	179744522	DNA/hAT-Charlie	942	-	18	179744504	40897
chr5	179703607	179903607	harbor1	chr5	179744880	179744902	DNA/hAT-Charlie	1488	-	11	179744891	41284
chr5	179703607	179903607	harbor1	chr5	179745205	179745433	DNA/hAT-Charlie	1488	-	114	179745319	41712
chr5	179703607	179903607	harbor1	chr5	179746354	179746378	DNA/hAT-Charlie	1488	-	12	179746366	42759
chr5	179703607	179903607	harbor1	chr5	179746673	179746943	DNA/hAT-Charlie	1488	-	135	179746808	43201
chr5	179703607	179903607	harbor1	chr5	179754644	179754828	DNA/hAT-Charlie	1025	-	92	179754736	51129
chr5	78709775	78909775	harbor1	chr5	78750715	78750856	DNA/hAT-Charlie	419	-	70	78750785	41010
chr5	78709775	78909775	harbor1	chr5	78751177	78751222	DNA/hAT-Charlie	419	-	22	78751199	41424
chr5	78709775	78909775	harbor1	chr5	78791928	78792099	DNA/hAT-Charlie	1490	-	86	78792014	82239
chr5	78709775	78909775	harbor1	chr5	78792396	78792459	DNA/hAT-Charlie	1490	-	32	78792428	82653
chr5	139559517	139759517	harbor1	chr5	139566701	139566901	DNA/hAT-Charlie	582	-	100	139566801	7284
chr5	139559517	139759517	harbor1	chr5	139573402	139573687	DNA/hAT-Charlie	952	-	142	139573544	14027
chr5	139559517	139759517	harbor1	chr5	139573999	139574077	DNA/hAT-Charlie	952	-	39	139574038	14521
chr5	139559517	139759517	harbor1	chr5	139592395	139592563	DNA/hAT-Charlie	644	-	84	139592479	32962
chr5	139559517	139759517	harbor1	chr5	139639582	139639730	DNA/hAT-Charlie	592	-	74	139639656	80139
chr5	78410099	78610099	harbor1	chr5	78501108	78501395	DNA/hAT-Charlie	653	-	144	78501252	91153
chr5	10661144	10861144	harbor1	chr5	10705036	10705212	DNA/hAT-Charlie	428	-	88	10705124	43980
chr5	10661231	10861231	harbor1	chr5	10705036	10705212	DNA/hAT-Charlie	428	-	88	10705124	43893
chr5	10339015	10539015	harbor1	chr5	10362406	10362849	DNA/hAT-Charlie	738	-	222	10362628	23613
chr5	10339015	10539015	harbor1	chr5	10372641	10372903	DNA/hAT-Charlie	775	-	131	10372772	33757
chr5	10339015	10539015	harbor1	chr5	10413895	10414099	DNA/hAT-Charlie	899	-	102	10413997	74982
chr5	137653913	137853913	harbor1	chr5	137670442	137670660	DNA/hAT-Charlie	793	-	109	137670551	16638
chr5	137653913	137853913	harbor1	chr5	137692665	137692813	DNA/hAT-Charlie	836	-	74	137692739	38826
chr5	137653913	137853913	harbor1	chr5	137692856	137693031	DNA/hAT-Charlie	865	-	88	137692944	39031
chr5	137653913	137853913	harbor1	chr5	137740621	137740964	DNA/hAT-Charlie	2249	-	172	137740793	86880
chr5	78410150	78610150	harbor1	chr5	78501108	78501395	DNA/hAT-Charlie	653	-	144	78501252	91102
chr6	139275451	139475451	harbor1	chr6	139293970	139294403	DNA/hAT-Charlie	788	-	216	139294186	18735
chr6	139275552	139475552	harbor1	chr6	139293970	139294403	DNA/hAT-Charlie	788	-	216	139294186	18634
chr6	31640512	31840512	harbor1	chr6	31714665	31715068	DNA/hAT-Charlie	1560	-	202	31714867	74355
chr6	37070857	37270857	harbor1	chr6	37145651	37145814	DNA/hAT-Charlie	525	-	82	37145733	74876
chr6	37070857	37270857	harbor1	chr6	37155466	37155642	DNA/hAT-Charlie	931	-	88	37155554	84697
chr6	139268099	139468099	harbor1	chr6	139273133	139273343	DNA/hAT-Charlie	836	-	105	139273238	5139
chr6	139268099	139468099	harbor1	chr6	139293970	139294403	DNA/hAT-Charlie	788	-	216	139294186	26087
chr6	127167311	127367311	harbor1	chr6	127249733	127250059	DNA/hAT-Charlie	636	-	163	127249896	82585
chr6	127167311	127367311	harbor1	chr6	127263172	127263648	DNA/hAT-Charlie	1644	-	238	127263410	96099
chr6	89719728	89919728	harbor1	chr6	89817794	89817987	DNA/hAT-Charlie	708	-	96	89817890	98162
chr6	37002869	37202869	harbor1	chr6	37016129	37016280	DNA/hAT-Charlie	657	-	76	37016205	13336
chr6	37002869	37202869	harbor1	chr6	37052099	37052266	DNA/hAT-Charlie	788	-	84	37052183	49314
chr6	37070851	37270851	harbor1	chr6	37145651	37145814	DNA/hAT-Charlie	525	-	82	37145733	74882
chr6	37070851	37270851	harbor1	chr6	37155466	37155642	DNA/hAT-Charlie	931	-	88	37155554	84703
chr6	166512562	166712562	harbor1	chr6	166512987	166513200	DNA/hAT-Charlie	1364	-	106	166513093	531
chr6	166512562	166712562	harbor1	chr6	166561717	166561770	DNA/hAT-Charlie	465	-	26	166561743	49181
chr6	166512562	166712562	harbor1	chr6	166580375	166580584	DNA/hAT-Charlie	1280	-	104	166580479	67917
chr6	37070872	37270872	harbor1	chr6	37145651	37145814	DNA/hAT-Charlie	525	-	82	37145733	74861
chr6	37070872	37270872	harbor1	chr6	37155466	37155642	DNA/hAT-Charlie	931	-	88	37155554	84682
chr6	139275170	139475170	harbor1	chr6	139293970	139294403	DNA/hAT-Charlie	788	-	216	139294186	19016
chr6	124862435	125062435	harbor1	chr6	124911644	124911963	DNA/hAT-Charlie	2049	-	160	124911804	49369
chr6	124862435	125062435	harbor1	chr6	124946936	124947098	DNA/hAT-Charlie	638	-	81	124947017	84582
chr6	11481954	11681954	harbor1	chr6	11489478	11489608	DNA/hAT-Charlie	657	-	65	11489543	7589
chr6	11481954	11681954	harbor1	chr6	11497320	11497536	DNA/hAT-Charlie	925	-	108	11497428	15474
chr6	11481954	11681954	harbor1	chr6	11559004	11559181	DNA/hAT-Charlie	1092	-	88	11559092	77138
chr6	11481954	11681954	harbor1	chr6	11559485	11559593	DNA/hAT-Charlie	1092	-	54	11559539	77585
chr6	11481954	11681954	harbor1	chr6	11569460	11569665	DNA/hAT-Charlie	755	-	102	11569562	87608
chr6	11481954	11681954	harbor1	chr6	11570842	11571038	DNA/hAT-Charlie	796	-	98	11570940	88986
chr6	37070827	37270827	harbor1	chr6	37145651	37145814	DNA/hAT-Charlie	525	-	82	37145733	74906
chr6	37070827	37270827	harbor1	chr6	37155466	37155642	DNA/hAT-Charlie	931	-	88	37155554	84727
chr6	7626957	7826957	harbor1	chr6	7669759	7669975	DNA/hAT-Charlie	970	-	108	7669867	42910
chr6	7626957	7826957	harbor1	chr6	7710063	7710347	DNA/hAT-Charlie	627	-	142	7710205	83248
chr6	105894234	106094234	harbor1	chr6	105898318	105898508	DNA/hAT-Charlie	1079	-	95	105898413	4179
chr6	105894234	106094234	harbor1	chr6	105904620	105904676	DNA/hAT-Charlie	540	-	28	105904648	10414
chr6	105894234	106094234	harbor1	chr6	105905246	105905407	DNA/hAT-Charlie	540	-	80	105905326	11092
chr6	105894234	106094234	harbor1	chr6	105909486	105909695	DNA/hAT-Charlie	911	-	104	105909590	15356
chr6	36992832	37192832	harbor1	chr6	37016129	37016280	DNA/hAT-Charlie	657	-	76	37016205	23373
chr6	36992832	37192832	harbor1	chr6	37052099	37052266	DNA/hAT-Charlie	788	-	84	37052183	59351
chr6	107387585	107587585	harbor1	chr6	107408549	107408776	DNA/hAT-Charlie	525	-	114	107408663	21078
chr6	107387585	107587585	harbor1	chr6	107457447	107457647	DNA/hAT-Charlie	1094	-	100	107457547	69962
chr6	107387585	107587585	harbor1	chr6	107462054	107462264	DNA/hAT-Charlie	1050	-	105	107462159	74574
chr6	138673799	138873799	harbor1	chr6	138677745	138677927	DNA/hAT-Charlie	929	-	91	138677836	4037
chr6	138673799	138873799	harbor1	chr6	138750306	138750814	DNA/hAT-Charlie	1374	-	254	138750560	76761
chr6	138673799	138873799	harbor1	chr6	138751092	138751300	DNA/hAT-Charlie	777	-	104	138751196	77397
chr6	138673799	138873799	harbor1	chr6	138754596	138754768	DNA/hAT-Charlie	490	-	86	138754682	80883
chr6	138673799	138873799	harbor1	chr6	138769576	138769922	DNA/hAT-Charlie	2113	-	173	138769749	95950
chr6	35352746	35552746	harbor1	chr6	35356557	35356774	DNA/hAT-Charlie	1209	-	108	35356665	3919
chr6	31630414	31830414	harbor1	chr6	31714665	31715068	DNA/hAT-Charlie	1560	-	202	31714867	84453
chr6	45541025	45741025	harbor1	chr6	45542960	45543210	DNA/hAT-Charlie	742	-	125	45543085	2060
chr6	45541025	45741025	harbor1	chr6	45552178	45552389	DNA/hAT-Charlie	1202	-	106	45552284	11259
chr6	45541025	45741025	harbor1	chr6	45584670	45585064	DNA/hAT-Charlie	1313	-	197	45584867	43842
chr6	45541025	45741025	harbor1	chr6	45588927	45589238	DNA/hAT-Charlie	1583	-	156	45589083	48058
chr6	45541025	45741025	harbor1	chr6	45614069	45614133	DNA/hAT-Charlie	1265	-	32	45614101	73076
chr6	45541025	45741025	harbor1	chr6	45614436	45614691	DNA/hAT-Charlie	1265	-	128	45614564	73539
chr6	99421500	99621500	harbor1	chr6	99467888	99468297	DNA/hAT-Charlie	644	-	204	99468092	46592
chr6	99421500	99621500	harbor1	chr6	99512226	99512369	DNA/hAT-Charlie	462	-	72	99512298	90798
chr6	41820289	42020289	harbor1	chr6	41866640	41866886	DNA/hAT-Charlie	1177	-	123	41866763	46474
chr6	107722375	107922375	harbor1	chr6	107750714	107750869	DNA/hAT-Charlie	847	-	78	107750792	28417
chr6	107722375	107922375	harbor1	chr6	107770138	107770410	DNA/hAT-Charlie	850	-	136	107770274	47899
chr6	31630308	31830308	harbor1	chr6	31714665	31715068	DNA/hAT-Charlie	1560	-	202	31714867	84559
chr6	139274146	139474146	harbor1	chr6	139293970	139294403	DNA/hAT-Charlie	788	-	216	139294186	20040
chr6	36493941	36693941	harbor1	chr6	36550805	36550964	DNA/hAT-Charlie	795	-	80	36550885	56944
chr6	36493941	36693941	harbor1	chr6	36570193	36570372	DNA/hAT-Charlie	1133	-	90	36570283	76342
chr6	36493941	36693941	harbor1	chr6	36586073	36586092	DNA/hAT-Charlie	739	-	10	36586083	92142
chr6	36493941	36693941	harbor1	chr6	36586411	36586604	DNA/hAT-Charlie	739	-	96	36586507	92566
chr6	36493941	36693941	harbor1	chr6	36585460	36585510	DNA/hAT-Charlie	739	-	25	36585485	91544
chr6	77363005	77563005	harbor1	chr6	77367345	77367542	DNA/hAT-Charlie	900	-	98	77367443	4438
chr6	37002597	37202597	harbor1	chr6	37016129	37016280	DNA/hAT-Charlie	657	-	76	37016205	13608
chr6	37002597	37202597	harbor1	chr6	37052099	37052266	DNA/hAT-Charlie	788	-	84	37052183	49586
chr6	139274683	139474683	harbor1	chr6	139293970	139294403	DNA/hAT-Charlie	788	-	216	139294186	19503
chr6	169864005	170064005	harbor1	chr6	169932002	169932162	DNA/hAT-Charlie	484	-	80	169932082	68077
chr6	30784323	30984323	harbor1	chr6	30875930	30876322	DNA/hAT-Charlie	978	-	196	30876126	91803
chr6	37070831	37270831	harbor1	chr6	37145651	37145814	DNA/hAT-Charlie	525	-	82	37145733	74902
chr6	37070831	37270831	harbor1	chr6	37155466	37155642	DNA/hAT-Charlie	931	-	88	37155554	84723
chr6	100355730	100555730	harbor1	chr6	100432228	100432409	DNA/hAT-Charlie	804	-	90	100432318	76588
chr6	100355730	100555730	harbor1	chr6	100441629	100441878	DNA/hAT-Charlie	686	-	124	100441753	86023
chr6	37070836	37270836	harbor1	chr6	37145651	37145814	DNA/hAT-Charlie	525	-	82	37145733	74897
chr6	37070836	37270836	harbor1	chr6	37155466	37155642	DNA/hAT-Charlie	931	-	88	37155554	84718
chr6	167862748	168062748	harbor1	chr6	167866378	167866898	DNA/hAT-Charlie	1036	-	260	167866638	3890
chr6	167862748	168062748	harbor1	chr6	167952524	167952716	DNA/hAT-Charlie	885	-	96	167952620	89872
chr6	167862748	168062748	harbor1	chr6	167935944	167936232	DNA/hAT-Charlie	977	-	144	167936088	73340
chr6	10421300	10621300	harbor1	chr6	10511184	10511513	DNA/hAT-Charlie	1570	-	164	10511348	90048
chr6	139275445	139475445	harbor1	chr6	139293970	139294403	DNA/hAT-Charlie	788	-	216	139294186	18741
chr6	7626988	7826988	harbor1	chr6	7669759	7669975	DNA/hAT-Charlie	970	-	108	7669867	42879
chr6	7626988	7826988	harbor1	chr6	7710063	7710347	DNA/hAT-Charlie	627	-	142	7710205	83217
chr6	27415355	27615355	harbor1	chr6	27463956	27464169	DNA/hAT-Charlie	886	-	106	27464062	48707
chr6	37070816	37270816	harbor1	chr6	37145651	37145814	DNA/hAT-Charlie	525	-	82	37145733	74917
chr6	37070816	37270816	harbor1	chr6	37155466	37155642	DNA/hAT-Charlie	931	-	88	37155554	84738
chr6	167862786	168062786	harbor1	chr6	167866378	167866898	DNA/hAT-Charlie	1036	-	260	167866638	3852
chr6	167862786	168062786	harbor1	chr6	167952524	167952716	DNA/hAT-Charlie	885	-	96	167952620	89834
chr6	167862786	168062786	harbor1	chr6	167935944	167936232	DNA/hAT-Charlie	977	-	144	167936088	73302
chr6	139274657	139474657	harbor1	chr6	139293970	139294403	DNA/hAT-Charlie	788	-	216	139294186	19529
chr6	37070849	37270849	harbor1	chr6	37145651	37145814	DNA/hAT-Charlie	525	-	82	37145733	74884
chr6	37070849	37270849	harbor1	chr6	37155466	37155642	DNA/hAT-Charlie	931	-	88	37155554	84705
chr6	147104160	147304160	harbor1	chr6	147152094	147152274	DNA/hAT-Charlie	548	-	90	147152184	48024
chr6	37070846	37270846	harbor1	chr6	37145651	37145814	DNA/hAT-Charlie	525	-	82	37145733	74887
chr6	37070846	37270846	harbor1	chr6	37155466	37155642	DNA/hAT-Charlie	931	-	88	37155554	84708
chr6	37070848	37270848	harbor1	chr6	37145651	37145814	DNA/hAT-Charlie	525	-	82	37145733	74885
chr6	37070848	37270848	harbor1	chr6	37155466	37155642	DNA/hAT-Charlie	931	-	88	37155554	84706
chr6	36343280	36543280	harbor1	chr6	36343443	36343744	DNA/hAT-Charlie	1614	-	150	36343593	313
chr6	36343280	36543280	harbor1	chr6	36378660	36378872	DNA/hAT-Charlie	1059	-	106	36378766	35486
chr6	36343280	36543280	harbor1	chr6	36400099	36400270	DNA/hAT-Charlie	626	-	86	36400185	56905
chr6	36343280	36543280	harbor1	chr6	36401043	36401351	DNA/hAT-Charlie	1587	-	154	36401197	57917
chr6	36343280	36543280	harbor1	chr6	36401634	36401699	DNA/hAT-Charlie	1587	-	32	36401666	58386
chr6	36343280	36543280	harbor1	chr6	36401697	36401821	DNA/hAT-Charlie	828	-	62	36401759	58479
chr6	36343280	36543280	harbor1	chr6	36427499	36427825	DNA/hAT-Charlie	1755	-	163	36427662	84382
chr6	101699773	101899773	harbor1	chr6	101730895	101731052	DNA/hAT-Charlie	564	-	78	101730973	31200
chr6	101699773	101899773	harbor1	chr6	101738656	101738831	DNA/hAT-Charlie	722	-	88	101738744	38971
chr6	37070843	37270843	harbor1	chr6	37145651	37145814	DNA/hAT-Charlie	525	-	82	37145733	74890
chr6	37070843	37270843	harbor1	chr6	37155466	37155642	DNA/hAT-Charlie	931	-	88	37155554	84711
chr6	34135066	34335066	harbor1	chr6	34225436	34225666	DNA/hAT-Charlie	981	-	115	34225551	90485
chr6	169864011	170064011	harbor1	chr6	169932002	169932162	DNA/hAT-Charlie	484	-	80	169932082	68071
chr6	149351029	149551029	harbor1	chr6	149394843	149395038	DNA/hAT-Charlie	1096	-	98	149394941	43912
chr6	10422562	10622562	harbor1	chr6	10511184	10511513	DNA/hAT-Charlie	1570	-	164	10511348	88786
chr6	147104106	147304106	harbor1	chr6	147152094	147152274	DNA/hAT-Charlie	548	-	90	147152184	48078
chr6	110248805	110448805	harbor1	chr6	110257346	110257541	DNA/hAT-Charlie	844	-	98	110257444	8639
chr6	110248805	110448805	harbor1	chr6	110257567	110257700	DNA/hAT-Charlie	486	-	66	110257633	8828
chr6	110248805	110448805	harbor1	chr6	110325259	110325480	DNA/hAT-Charlie	1212	-	110	110325369	76564
chr6	110248805	110448805	harbor1	chr6	110344403	110344606	DNA/hAT-Charlie	820	-	102	110344505	95700
chr6	110248805	110448805	harbor1	chr6	110345957	110346039	DNA/hAT-Charlie	496	-	41	110345998	97193
chr6	7626967	7826967	harbor1	chr6	7669759	7669975	DNA/hAT-Charlie	970	-	108	7669867	42900
chr6	7626967	7826967	harbor1	chr6	7710063	7710347	DNA/hAT-Charlie	627	-	142	7710205	83238
chr6	31996362	32196362	harbor1	chr6	32092111	32092298	DNA/hAT-Charlie	1083	-	94	32092205	95843
chr6	104840667	105040667	harbor1	chr6	104889835	104890038	DNA/hAT-Charlie	752	-	102	104889937	49270
chr6	52476539	52676539	harbor1	chr6	52484220	52484719	DNA/hAT-Charlie	2079	-	250	52484470	7931
chr6	52476539	52676539	harbor1	chr6	52486999	52487228	DNA/hAT-Charlie	1135	-	114	52487113	10574
chr6	52476539	52676539	harbor1	chr6	52513945	52514108	DNA/hAT-Charlie	729	-	82	52514027	37488
chr6	52476539	52676539	harbor1	chr6	52522001	52522533	DNA/hAT-Charlie	818	-	266	52522267	45728
chr6	52476539	52676539	harbor1	chr6	52529435	52529593	DNA/hAT-Charlie	737	-	79	52529514	52975
chr6	139274673	139474673	harbor1	chr6	139293970	139294403	DNA/hAT-Charlie	788	-	216	139294186	19513
chr6	127167329	127367329	harbor1	chr6	127249733	127250059	DNA/hAT-Charlie	636	-	163	127249896	82567
chr6	127167329	127367329	harbor1	chr6	127263172	127263648	DNA/hAT-Charlie	1644	-	238	127263410	96081
chr6	139274467	139474467	harbor1	chr6	139293970	139294403	DNA/hAT-Charlie	788	-	216	139294186	19719
chr6	127167314	127367314	harbor1	chr6	127249733	127250059	DNA/hAT-Charlie	636	-	163	127249896	82582
chr6	127167314	127367314	harbor1	chr6	127263172	127263648	DNA/hAT-Charlie	1644	-	238	127263410	96096
chr6	139274604	139474604	harbor1	chr6	139293970	139294403	DNA/hAT-Charlie	788	-	216	139294186	19582
chr6	147104102	147304102	harbor1	chr6	147152094	147152274	DNA/hAT-Charlie	548	-	90	147152184	48082
chr6	139275131	139475131	harbor1	chr6	139293970	139294403	DNA/hAT-Charlie	788	-	216	139294186	19055
chr6	149351091	149551091	harbor1	chr6	149394843	149395038	DNA/hAT-Charlie	1096	-	98	149394941	43850
chr6	165559697	165759697	harbor1	chr6	165634030	165634169	DNA/hAT-Charlie	479	-	70	165634100	74403
chr6	165559697	165759697	harbor1	chr6	165642927	165643098	DNA/hAT-Charlie	565	-	86	165643013	83316
chr6	165559697	165759697	harbor1	chr6	165643440	165643569	DNA/hAT-Charlie	518	-	64	165643504	83807
chr6	150799534	150999534	harbor1	chr6	150815880	150816326	DNA/hAT-Charlie	3180	-	223	150816103	16569
chr6	150799534	150999534	harbor1	chr6	150816624	150816646	DNA/hAT-Charlie	3180	-	11	150816635	17101
chr6	150799534	150999534	harbor1	chr6	150816641	150817129	DNA/hAT-Charlie	3744	-	244	150816885	17351
chr6	150799534	150999534	harbor1	chr6	150868659	150868779	DNA/hAT-Charlie	564	-	60	150868719	69185
chr6	41091863	41291863	harbor1	chr6	41113725	41114028	DNA/hAT-Charlie	1095	-	152	41113877	22014
chr6	139275443	139475443	harbor1	chr6	139293970	139294403	DNA/hAT-Charlie	788	-	216	139294186	18743
chr6	45540941	45740941	harbor1	chr6	45542960	45543210	DNA/hAT-Charlie	742	-	125	45543085	2144
chr6	45540941	45740941	harbor1	chr6	45552178	45552389	DNA/hAT-Charlie	1202	-	106	45552284	11343
chr6	45540941	45740941	harbor1	chr6	45584670	45585064	DNA/hAT-Charlie	1313	-	197	45584867	43926
chr6	45540941	45740941	harbor1	chr6	45588927	45589238	DNA/hAT-Charlie	1583	-	156	45589083	48142
chr6	45540941	45740941	harbor1	chr6	45614069	45614133	DNA/hAT-Charlie	1265	-	32	45614101	73160
chr6	45540941	45740941	harbor1	chr6	45614436	45614691	DNA/hAT-Charlie	1265	-	128	45614564	73623
chr6	139275520	139475520	harbor1	chr6	139293970	139294403	DNA/hAT-Charlie	788	-	216	139294186	18666
chr6	45540990	45740990	harbor1	chr6	45542960	45543210	DNA/hAT-Charlie	742	-	125	45543085	2095
chr6	45540990	45740990	harbor1	chr6	45552178	45552389	DNA/hAT-Charlie	1202	-	106	45552284	11294
chr6	45540990	45740990	harbor1	chr6	45584670	45585064	DNA/hAT-Charlie	1313	-	197	45584867	43877
chr6	45540990	45740990	harbor1	chr6	45588927	45589238	DNA/hAT-Charlie	1583	-	156	45589083	48093
chr6	45540990	45740990	harbor1	chr6	45614069	45614133	DNA/hAT-Charlie	1265	-	32	45614101	73111
chr6	45540990	45740990	harbor1	chr6	45614436	45614691	DNA/hAT-Charlie	1265	-	128	45614564	73574
chr6	37070864	37270864	harbor1	chr6	37145651	37145814	DNA/hAT-Charlie	525	-	82	37145733	74869
chr6	37070864	37270864	harbor1	chr6	37155466	37155642	DNA/hAT-Charlie	931	-	88	37155554	84690
chr6	43355517	43555517	harbor1	chr6	43395099	43395351	DNA/hAT-Charlie	740	-	126	43395225	39708
chr6	146813054	147013054	harbor1	chr6	146856148	146856334	DNA/hAT-Charlie	508	-	93	146856241	43187
chr6	146813054	147013054	harbor1	chr6	146890705	146890865	DNA/hAT-Charlie	732	-	80	146890785	77731
chr6	34138380	34338380	harbor1	chr6	34225436	34225666	DNA/hAT-Charlie	981	-	115	34225551	87171
chr6	45540939	45740939	harbor1	chr6	45542960	45543210	DNA/hAT-Charlie	742	-	125	45543085	2146
chr6	45540939	45740939	harbor1	chr6	45552178	45552389	DNA/hAT-Charlie	1202	-	106	45552284	11345
chr6	45540939	45740939	harbor1	chr6	45584670	45585064	DNA/hAT-Charlie	1313	-	197	45584867	43928
chr6	45540939	45740939	harbor1	chr6	45588927	45589238	DNA/hAT-Charlie	1583	-	156	45589083	48144
chr6	45540939	45740939	harbor1	chr6	45614069	45614133	DNA/hAT-Charlie	1265	-	32	45614101	73162
chr6	45540939	45740939	harbor1	chr6	45614436	45614691	DNA/hAT-Charlie	1265	-	128	45614564	73625
chr6	166512135	166712135	harbor1	chr6	166512987	166513200	DNA/hAT-Charlie	1364	-	106	166513093	958
chr6	166512135	166712135	harbor1	chr6	166561717	166561770	DNA/hAT-Charlie	465	-	26	166561743	49608
chr6	166512135	166712135	harbor1	chr6	166580375	166580584	DNA/hAT-Charlie	1280	-	104	166580479	68344
chr6	43815149	44015149	harbor1	chr6	43823714	43823954	DNA/hAT-Charlie	535	-	120	43823834	8685
chr6	43815149	44015149	harbor1	chr6	43828524	43828805	DNA/hAT-Charlie	595	-	140	43828664	13515
chr6	43815149	44015149	harbor1	chr6	43837198	43837324	DNA/hAT-Charlie	728	-	63	43837261	22112
chr6	43815149	44015149	harbor1	chr6	43837612	43837676	DNA/hAT-Charlie	728	-	32	43837644	22495
chr6	43815149	44015149	harbor1	chr6	43845362	43845513	DNA/hAT-Charlie	587	-	76	43845438	30289
chr6	43815149	44015149	harbor1	chr6	43893493	43893769	DNA/hAT-Charlie	582	-	138	43893631	78482
chr6	139274545	139474545	harbor1	chr6	139293970	139294403	DNA/hAT-Charlie	788	-	216	139294186	19641
chr6	21629834	21829834	harbor1	chr6	21632412	21632686	DNA/hAT-Charlie	847	-	137	21632549	2715
chr6	21629834	21829834	harbor1	chr6	21690394	21690684	DNA/hAT-Charlie	1024	-	145	21690539	60705
chr6	7626958	7826958	harbor1	chr6	7669759	7669975	DNA/hAT-Charlie	970	-	108	7669867	42909
chr6	7626958	7826958	harbor1	chr6	7710063	7710347	DNA/hAT-Charlie	627	-	142	7710205	83247
chr6	144187246	144387246	harbor1	chr6	144202315	144202465	DNA/hAT-Charlie	675	-	75	144202390	15144
chr6	144187246	144387246	harbor1	chr6	144247454	144247653	DNA/hAT-Charlie	712	-	100	144247554	60308
chr6	144187246	144387246	harbor1	chr6	144247957	144248159	DNA/hAT-Charlie	712	-	101	144248058	60812
chr6	144187246	144387246	harbor1	chr6	144249466	144249588	DNA/hAT-Charlie	514	-	61	144249527	62281
chr6	144187246	144387246	harbor1	chr6	144276664	144276783	DNA/hAT-Charlie	1061	-	60	144276724	89478
chr6	144187246	144387246	harbor1	chr6	144277094	144277476	DNA/hAT-Charlie	1061	-	191	144277285	90039
chr6	127167324	127367324	harbor1	chr6	127249733	127250059	DNA/hAT-Charlie	636	-	163	127249896	82572
chr6	127167324	127367324	harbor1	chr6	127263172	127263648	DNA/hAT-Charlie	1644	-	238	127263410	96086
chr6	169863372	170063372	harbor1	chr6	169932002	169932162	DNA/hAT-Charlie	484	-	80	169932082	68710
chr6	127167395	127367395	harbor1	chr6	127249733	127250059	DNA/hAT-Charlie	636	-	163	127249896	82501
chr6	127167395	127367395	harbor1	chr6	127263172	127263648	DNA/hAT-Charlie	1644	-	238	127263410	96015
chr6	324347	524347	harbor1	chr6	335506	335820	DNA/hAT-Charlie	1253	-	157	335663	11316
chr6	56854700	57054700	harbor1	chr6	56909608	56909788	DNA/hAT-Charlie	925	-	90	56909698	54998
chr6	56854700	57054700	harbor1	chr6	56911232	56911396	DNA/hAT-Charlie	1123	-	82	56911314	56614
chr6	56854700	57054700	harbor1	chr6	56912288	56912487	DNA/hAT-Charlie	907	-	100	56912388	57688
chr6	24811164	25011164	harbor1	chr6	24849583	24849749	DNA/hAT-Charlie	647	-	83	24849666	38502
chr6	24811164	25011164	harbor1	chr6	24878593	24878736	DNA/hAT-Charlie	548	-	72	24878665	67501
chr6	24811164	25011164	harbor1	chr6	24895004	24895046	DNA/hAT-Charlie	480	-	21	24895025	83861
chr6	24811164	25011164	harbor1	chr6	24895348	24895443	DNA/hAT-Charlie	480	-	48	24895396	84232
chr6	139275141	139475141	harbor1	chr6	139293970	139294403	DNA/hAT-Charlie	788	-	216	139294186	19045
chr6	151197903	151397903	harbor1	chr6	151291161	151291254	DNA/hAT-Charlie	476	-	46	151291207	93304
chr6	149351013	149551013	harbor1	chr6	149394843	149395038	DNA/hAT-Charlie	1096	-	98	149394941	43928
chr6	105894232	106094232	harbor1	chr6	105898318	105898508	DNA/hAT-Charlie	1079	-	95	105898413	4181
chr6	105894232	106094232	harbor1	chr6	105904620	105904676	DNA/hAT-Charlie	540	-	28	105904648	10416
chr6	105894232	106094232	harbor1	chr6	105905246	105905407	DNA/hAT-Charlie	540	-	80	105905326	11094
chr6	105894232	106094232	harbor1	chr6	105909486	105909695	DNA/hAT-Charlie	911	-	104	105909590	15358
chr6	127167313	127367313	harbor1	chr6	127249733	127250059	DNA/hAT-Charlie	636	-	163	127249896	82583
chr6	127167313	127367313	harbor1	chr6	127263172	127263648	DNA/hAT-Charlie	1644	-	238	127263410	96097
chr6	45540950	45740950	harbor1	chr6	45542960	45543210	DNA/hAT-Charlie	742	-	125	45543085	2135
chr6	45540950	45740950	harbor1	chr6	45552178	45552389	DNA/hAT-Charlie	1202	-	106	45552284	11334
chr6	45540950	45740950	harbor1	chr6	45584670	45585064	DNA/hAT-Charlie	1313	-	197	45584867	43917
chr6	45540950	45740950	harbor1	chr6	45588927	45589238	DNA/hAT-Charlie	1583	-	156	45589083	48133
chr6	45540950	45740950	harbor1	chr6	45614069	45614133	DNA/hAT-Charlie	1265	-	32	45614101	73151
chr6	45540950	45740950	harbor1	chr6	45614436	45614691	DNA/hAT-Charlie	1265	-	128	45614564	73614
chr6	2665182	2865182	harbor1	chr6	2692903	2693111	DNA/hAT-Charlie	894	-	104	2693007	27825
chr6	2665182	2865182	harbor1	chr6	2734818	2734945	DNA/hAT-Charlie	549	-	64	2734882	69700
chr6	27415346	27615346	harbor1	chr6	27463956	27464169	DNA/hAT-Charlie	886	-	106	27464062	48716
chr6	43521769	43721769	harbor1	chr6	43537447	43537621	DNA/hAT-Charlie	621	-	87	43537534	15765
chr6	43521769	43721769	harbor1	chr6	43545905	43546068	DNA/hAT-Charlie	851	-	82	43545987	24218
chr6	43521769	43721769	harbor1	chr6	43591674	43591841	DNA/hAT-Charlie	468	-	84	43591758	69989
chr6	27415357	27615357	harbor1	chr6	27463956	27464169	DNA/hAT-Charlie	886	-	106	27464062	48705
chr6	34138364	34338364	harbor1	chr6	34225436	34225666	DNA/hAT-Charlie	981	-	115	34225551	87187
chr6	107857147	108057147	harbor1	chr6	107867706	107867935	DNA/hAT-Charlie	789	-	114	107867820	10673
chr6	107857147	108057147	harbor1	chr6	107878048	107878197	DNA/hAT-Charlie	469	-	74	107878122	20975
chr6	107857147	108057147	harbor1	chr6	107938070	107938188	DNA/hAT-Charlie	469	-	59	107938129	80982
chr6	107857147	108057147	harbor1	chr6	107939369	107939472	DNA/hAT-Charlie	507	-	52	107939421	82274
chr6	107857147	108057147	harbor1	chr6	107940410	107940606	DNA/hAT-Charlie	795	-	98	107940508	83361
chr6	35352842	35552842	harbor1	chr6	35356557	35356774	DNA/hAT-Charlie	1209	-	108	35356665	3823
chr6	13611912	13811912	harbor1	chr6	13654598	13654801	DNA/hAT-Charlie	677	-	102	13654700	42788
chr6	70156169	70356169	harbor1	chr6	70185233	70185444	DNA/hAT-Charlie	1074	-	106	70185339	29170
chr6	70156169	70356169	harbor1	chr6	70219638	70219854	DNA/hAT-Charlie	818	-	108	70219746	63577
chr6	70156169	70356169	harbor1	chr6	70231043	70231200	DNA/hAT-Charlie	660	-	78	70231121	74952
chr6	167860893	168060893	harbor1	chr6	167866378	167866898	DNA/hAT-Charlie	1036	-	260	167866638	5745
chr6	167860893	168060893	harbor1	chr6	167952524	167952716	DNA/hAT-Charlie	885	-	96	167952620	91727
chr6	167860893	168060893	harbor1	chr6	167935944	167936232	DNA/hAT-Charlie	977	-	144	167936088	75195
chr6	124862446	125062446	harbor1	chr6	124911644	124911963	DNA/hAT-Charlie	2049	-	160	124911804	49358
chr6	124862446	125062446	harbor1	chr6	124946936	124947098	DNA/hAT-Charlie	638	-	81	124947017	84571
chr6	139275129	139475129	harbor1	chr6	139293970	139294403	DNA/hAT-Charlie	788	-	216	139294186	19057
chr6	111111942	111311942	harbor1	chr6	111119270	111119568	DNA/hAT-Charlie	948	-	149	111119419	7477
chr6	111111942	111311942	harbor1	chr6	111158332	111158638	DNA/hAT-Charlie	1986	-	153	111158485	46543
chr6	139275116	139475116	harbor1	chr6	139293970	139294403	DNA/hAT-Charlie	788	-	216	139294186	19070
chr6	31901468	32101468	harbor1	chr6	31911531	31911628	DNA/hAT-Charlie	523	-	48	31911579	10111
chr6	31901468	32101468	harbor1	chr6	31912072	31912143	DNA/hAT-Charlie	523	-	36	31912108	10640
chr6	41091918	41291918	harbor1	chr6	41113725	41114028	DNA/hAT-Charlie	1095	-	152	41113877	21959
chr6	31996234	32196234	harbor1	chr6	32092111	32092298	DNA/hAT-Charlie	1083	-	94	32092205	95971
chr6	169623052	169823052	harbor1	chr6	169714306	169714468	DNA/hAT-Charlie	816	-	81	169714387	91335
chr6	159069545	159269545	harbor1	chr6	159073956	159074130	DNA/hAT-Charlie	621	-	87	159074043	4498
chr6	159069545	159269545	harbor1	chr6	159140229	159140402	DNA/hAT-Charlie	1234	-	86	159140315	70770
chr6	34138141	34338141	harbor1	chr6	34225436	34225666	DNA/hAT-Charlie	981	-	115	34225551	87410
chr6	73362002	73562002	harbor1	chr6	73378885	73379040	DNA/hAT-Charlie	1291	-	78	73378963	16961
chr6	73362002	73562002	harbor1	chr6	73379324	73379362	DNA/hAT-Charlie	1291	-	19	73379343	17341
chr6	73362002	73562002	harbor1	chr6	73379662	73380243	DNA/hAT-Charlie	1291	-	290	73379952	17950
chr6	73362002	73562002	harbor1	chr6	73438874	73439212	DNA/hAT-Charlie	748	-	169	73439043	77041
chr6	73362002	73562002	harbor1	chr6	73456218	73456479	DNA/hAT-Charlie	546	-	130	73456348	94346
chr6	208571	408571	harbor1	chr6	232175	232708	DNA/hAT-Charlie	4031	-	266	232441	23870
chr6	208571	408571	harbor1	chr6	294421	294766	DNA/hAT-Charlie	1233	-	172	294593	86022
chr6	208571	408571	harbor1	chr6	297484	297683	DNA/hAT-Charlie	874	-	100	297584	89013
chr6	63473420	63673420	harbor1	chr6	63538695	63538874	DNA/hAT-Charlie	824	-	90	63538785	65365
chr6	63473420	63673420	harbor1	chr6	63560378	63560402	DNA/hAT-Charlie	811	-	12	63560390	86970
chr6	63473420	63673420	harbor1	chr6	63560704	63560869	DNA/hAT-Charlie	811	-	82	63560786	87366
chr6	167863263	168063263	harbor1	chr6	167866378	167866898	DNA/hAT-Charlie	1036	-	260	167866638	3375
chr6	167863263	168063263	harbor1	chr6	167952524	167952716	DNA/hAT-Charlie	885	-	96	167952620	89357
chr6	167863263	168063263	harbor1	chr6	167935944	167936232	DNA/hAT-Charlie	977	-	144	167936088	72825
chr6	146812183	147012183	harbor1	chr6	146856148	146856334	DNA/hAT-Charlie	508	-	93	146856241	44058
chr6	146812183	147012183	harbor1	chr6	146890705	146890865	DNA/hAT-Charlie	732	-	80	146890785	78602
chr6	145635082	145835082	harbor1	chr6	145643893	145644055	DNA/hAT-Charlie	556	-	81	145643974	8892
chr6	27415340	27615340	harbor1	chr6	27463956	27464169	DNA/hAT-Charlie	886	-	106	27464062	48722
chr6	32752654	32952654	harbor1	chr6	32809138	32810403	DNA/hAT-Charlie	5522	-	632	32809770	57116
chr6	87813618	88013618	harbor1	chr6	87865173	87865386	DNA/hAT-Charlie	604	-	106	87865279	51661
chr6	87813618	88013618	harbor1	chr6	87895786	87896128	DNA/hAT-Charlie	1258	-	171	87895957	82339
chr6	63535819	63735819	harbor1	chr6	63538695	63538874	DNA/hAT-Charlie	824	-	90	63538785	2966
chr6	63535819	63735819	harbor1	chr6	63560378	63560402	DNA/hAT-Charlie	811	-	12	63560390	24571
chr6	63535819	63735819	harbor1	chr6	63560704	63560869	DNA/hAT-Charlie	811	-	82	63560786	24967
chr6	63535819	63735819	harbor1	chr6	63635043	63635270	DNA/hAT-Charlie	874	-	114	63635157	99338
chr6	158719384	158919384	harbor1	chr6	158753754	158753911	DNA/hAT-Charlie	582	-	78	158753832	34448
chr6	158719384	158919384	harbor1	chr6	158809750	158809942	DNA/hAT-Charlie	624	-	96	158809846	90462
chr6	32050380	32250380	harbor1	chr6	32092111	32092298	DNA/hAT-Charlie	1083	-	94	32092205	41825
chr6	32050380	32250380	harbor1	chr6	32131900	32132049	DNA/hAT-Charlie	715	-	74	32131974	81594
chr6	32050380	32250380	harbor1	chr6	32139587	32139755	DNA/hAT-Charlie	614	-	84	32139671	89291
chr6	32050380	32250380	harbor1	chr6	32145758	32145860	DNA/hAT-Charlie	512	-	51	32145809	95429
chr6	169863974	170063974	harbor1	chr6	169932002	169932162	DNA/hAT-Charlie	484	-	80	169932082	68108
chr7	28080201	28280201	harbor1	chr7	28115156	28115475	DNA/hAT-Charlie	1505	-	160	28115316	35115
chr7	28080201	28280201	harbor1	chr7	28140641	28140862	DNA/hAT-Charlie	614	-	110	28140751	60550
chr7	28080201	28280201	harbor1	chr7	28140860	28141053	DNA/hAT-Charlie	609	-	96	28140956	60755
chr7	28080201	28280201	harbor1	chr7	28156584	28156775	DNA/hAT-Charlie	728	-	96	28156680	76479
chr7	28080201	28280201	harbor1	chr7	28157297	28157605	DNA/hAT-Charlie	1580	-	154	28157451	77250
chr7	50203946	50403946	harbor1	chr7	50242710	50243369	DNA/hAT-Charlie	2537	-	330	50243040	39094
chr7	50203946	50403946	harbor1	chr7	50243370	50244786	DNA/hAT-Charlie	5483	-	708	50244078	40132
chr7	50203946	50403946	harbor1	chr7	50260583	50260901	DNA/hAT-Charlie	1231	-	159	50260742	56796
chr7	50203946	50403946	harbor1	chr7	50298530	50298972	DNA/hAT-Charlie	3084	-	221	50298751	94805
chr7	130391130	130591130	harbor1	chr7	130474642	130474796	DNA/hAT-Charlie	728	-	77	130474719	83589
chr7	151420770	151620770	harbor1	chr7	151445442	151445603	DNA/hAT-Charlie	487	-	80	151445522	24752
chr7	151420770	151620770	harbor1	chr7	151489561	151489893	DNA/hAT-Charlie	1334	-	166	151489727	68957
chr7	28080214	28280214	harbor1	chr7	28115156	28115475	DNA/hAT-Charlie	1505	-	160	28115316	35102
chr7	28080214	28280214	harbor1	chr7	28140641	28140862	DNA/hAT-Charlie	614	-	110	28140751	60537
chr7	28080214	28280214	harbor1	chr7	28140860	28141053	DNA/hAT-Charlie	609	-	96	28140956	60742
chr7	28080214	28280214	harbor1	chr7	28156584	28156775	DNA/hAT-Charlie	728	-	96	28156680	76466
chr7	28080214	28280214	harbor1	chr7	28157297	28157605	DNA/hAT-Charlie	1580	-	154	28157451	77237
chr7	39729557	39929557	harbor1	chr7	39745570	39745732	DNA/hAT-Charlie	645	-	81	39745651	16094
chr7	39729557	39929557	harbor1	chr7	39747392	39747518	DNA/hAT-Charlie	425	-	63	39747455	17898
chr7	39729557	39929557	harbor1	chr7	39804213	39804377	DNA/hAT-Charlie	857	-	82	39804295	74738
chr7	39729557	39929557	harbor1	chr7	39819562	39819775	DNA/hAT-Charlie	997	-	106	39819668	90111
chr7	130568057	130768057	harbor1	chr7	130621397	130621528	DNA/hAT-Charlie	673	-	66	130621463	53406
chr7	130568057	130768057	harbor1	chr7	130663620	130663725	DNA/hAT-Charlie	545	-	52	130663672	95615
chr7	130568057	130768057	harbor1	chr7	130664039	130664101	DNA/hAT-Charlie	545	-	31	130664070	96013
chr7	130568057	130768057	harbor1	chr7	130613061	130613396	DNA/hAT-Charlie	2198	-	168	130613229	45172
chr7	50203894	50403894	harbor1	chr7	50242710	50243369	DNA/hAT-Charlie	2537	-	330	50243040	39146
chr7	50203894	50403894	harbor1	chr7	50243370	50244786	DNA/hAT-Charlie	5483	-	708	50244078	40184
chr7	50203894	50403894	harbor1	chr7	50260583	50260901	DNA/hAT-Charlie	1231	-	159	50260742	56848
chr7	50203894	50403894	harbor1	chr7	50298530	50298972	DNA/hAT-Charlie	3084	-	221	50298751	94857
chr7	155708589	155908589	harbor1	chr7	155742353	155742577	DNA/hAT-Charlie	757	-	112	155742465	33876
chr7	155708589	155908589	harbor1	chr7	155758301	155758626	DNA/hAT-Charlie	1968	-	162	155758463	49874
chr7	155708589	155908589	harbor1	chr7	155799159	155799480	DNA/hAT-Charlie	1260	-	160	155799319	90730
chr7	28080184	28280184	harbor1	chr7	28115156	28115475	DNA/hAT-Charlie	1505	-	160	28115316	35132
chr7	28080184	28280184	harbor1	chr7	28140641	28140862	DNA/hAT-Charlie	614	-	110	28140751	60567
chr7	28080184	28280184	harbor1	chr7	28140860	28141053	DNA/hAT-Charlie	609	-	96	28140956	60772
chr7	28080184	28280184	harbor1	chr7	28156584	28156775	DNA/hAT-Charlie	728	-	96	28156680	76496
chr7	28080184	28280184	harbor1	chr7	28157297	28157605	DNA/hAT-Charlie	1580	-	154	28157451	77267
chr7	50283638	50483638	harbor1	chr7	50341619	50341931	DNA/hAT-Charlie	1106	-	156	50341775	58137
chr7	50283638	50483638	harbor1	chr7	50374930	50375106	DNA/hAT-Charlie	732	-	88	50375018	91380
chr7	50283638	50483638	harbor1	chr7	50379042	50379155	DNA/hAT-Charlie	478	-	56	50379098	95460
chr7	50283638	50483638	harbor1	chr7	50298530	50298972	DNA/hAT-Charlie	3084	-	221	50298751	15113
chr7	149613875	149813875	harbor1	chr7	149699566	149699803	DNA/hAT-Charlie	2435	-	118	149699684	85809
chr7	149613875	149813875	harbor1	chr7	149702291	149702671	DNA/hAT-Charlie	958	-	190	149702481	88606
chr7	149613875	149813875	harbor1	chr7	149700108	149700683	DNA/hAT-Charlie	2435	-	288	149700396	86521
chr7	123649229	123849229	harbor1	chr7	123703865	123703977	DNA/hAT-Charlie	438	-	56	123703921	54692
chr7	123649229	123849229	harbor1	chr7	123706032	123706249	DNA/hAT-Charlie	564	-	108	123706140	56911
chr7	123649229	123849229	harbor1	chr7	123709897	123710021	DNA/hAT-Charlie	697	-	62	123709959	60730
chr7	123649229	123849229	harbor1	chr7	123717788	123717966	DNA/hAT-Charlie	572	-	89	123717877	68648
chr7	123649229	123849229	harbor1	chr7	123722074	123722226	DNA/hAT-Charlie	466	-	76	123722150	72921
chr7	123649229	123849229	harbor1	chr7	123729105	123729394	DNA/hAT-Charlie	1120	-	144	123729249	80020
chr7	123649229	123849229	harbor1	chr7	123737052	123737269	DNA/hAT-Charlie	1344	-	108	123737160	87931
chr7	123649229	123849229	harbor1	chr7	123738775	123738996	DNA/hAT-Charlie	1312	-	110	123738885	89656
chr7	50204667	50404667	harbor1	chr7	50242710	50243369	DNA/hAT-Charlie	2537	-	330	50243040	38373
chr7	50204667	50404667	harbor1	chr7	50243370	50244786	DNA/hAT-Charlie	5483	-	708	50244078	39411
chr7	50204667	50404667	harbor1	chr7	50260583	50260901	DNA/hAT-Charlie	1231	-	159	50260742	56075
chr7	50204667	50404667	harbor1	chr7	50298530	50298972	DNA/hAT-Charlie	3084	-	221	50298751	94084
chr7	44506818	44706818	harbor1	chr7	44559103	44559264	DNA/hAT-Charlie	619	-	80	44559183	52365
chr7	44506818	44706818	harbor1	chr7	44559563	44559615	DNA/hAT-Charlie	619	-	26	44559589	52771
chr7	28080180	28280180	harbor1	chr7	28115156	28115475	DNA/hAT-Charlie	1505	-	160	28115316	35136
chr7	28080180	28280180	harbor1	chr7	28140641	28140862	DNA/hAT-Charlie	614	-	110	28140751	60571
chr7	28080180	28280180	harbor1	chr7	28140860	28141053	DNA/hAT-Charlie	609	-	96	28140956	60776
chr7	28080180	28280180	harbor1	chr7	28156584	28156775	DNA/hAT-Charlie	728	-	96	28156680	76500
chr7	28080180	28280180	harbor1	chr7	28157297	28157605	DNA/hAT-Charlie	1580	-	154	28157451	77271
chr7	583630	783630	harbor1	chr7	648170	648329	DNA/hAT-Charlie	593	-	80	648250	64620
chr7	583630	783630	harbor1	chr7	649196	649526	DNA/hAT-Charlie	480	-	165	649361	65731
chr7	47567087	47767087	harbor1	chr7	47646221	47646282	DNA/hAT-Charlie	582	-	30	47646251	79164
chr7	47567087	47767087	harbor1	chr7	47646591	47646688	DNA/hAT-Charlie	582	-	48	47646639	79552
chr7	155708566	155908566	harbor1	chr7	155742353	155742577	DNA/hAT-Charlie	757	-	112	155742465	33899
chr7	155708566	155908566	harbor1	chr7	155758301	155758626	DNA/hAT-Charlie	1968	-	162	155758463	49897
chr7	155708566	155908566	harbor1	chr7	155799159	155799480	DNA/hAT-Charlie	1260	-	160	155799319	90753
chr7	123649386	123849386	harbor1	chr7	123703865	123703977	DNA/hAT-Charlie	438	-	56	123703921	54535
chr7	123649386	123849386	harbor1	chr7	123706032	123706249	DNA/hAT-Charlie	564	-	108	123706140	56754
chr7	123649386	123849386	harbor1	chr7	123709897	123710021	DNA/hAT-Charlie	697	-	62	123709959	60573
chr7	123649386	123849386	harbor1	chr7	123717788	123717966	DNA/hAT-Charlie	572	-	89	123717877	68491
chr7	123649386	123849386	harbor1	chr7	123722074	123722226	DNA/hAT-Charlie	466	-	76	123722150	72764
chr7	123649386	123849386	harbor1	chr7	123729105	123729394	DNA/hAT-Charlie	1120	-	144	123729249	79863
chr7	123649386	123849386	harbor1	chr7	123737052	123737269	DNA/hAT-Charlie	1344	-	108	123737160	87774
chr7	123649386	123849386	harbor1	chr7	123738775	123738996	DNA/hAT-Charlie	1312	-	110	123738885	89499
chr7	41324284	41524284	harbor1	chr7	41334504	41334701	DNA/hAT-Charlie	759	-	98	41334602	10318
chr7	47246884	47446884	harbor1	chr7	47300857	47301127	DNA/hAT-Charlie	524	-	135	47300992	54108
chr7	50203975	50403975	harbor1	chr7	50242710	50243369	DNA/hAT-Charlie	2537	-	330	50243040	39065
chr7	50203975	50403975	harbor1	chr7	50243370	50244786	DNA/hAT-Charlie	5483	-	708	50244078	40103
chr7	50203975	50403975	harbor1	chr7	50260583	50260901	DNA/hAT-Charlie	1231	-	159	50260742	56767
chr7	50203975	50403975	harbor1	chr7	50298530	50298972	DNA/hAT-Charlie	3084	-	221	50298751	94776
chr7	6404408	6604408	harbor1	chr7	6425076	6425179	DNA/hAT-Charlie	448	-	52	6425128	20720
chr7	6404408	6604408	harbor1	chr7	6466479	6467001	DNA/hAT-Charlie	3677	-	261	6466740	62332
chr7	28080194	28280194	harbor1	chr7	28115156	28115475	DNA/hAT-Charlie	1505	-	160	28115316	35122
chr7	28080194	28280194	harbor1	chr7	28140641	28140862	DNA/hAT-Charlie	614	-	110	28140751	60557
chr7	28080194	28280194	harbor1	chr7	28140860	28141053	DNA/hAT-Charlie	609	-	96	28140956	60762
chr7	28080194	28280194	harbor1	chr7	28156584	28156775	DNA/hAT-Charlie	728	-	96	28156680	76486
chr7	28080194	28280194	harbor1	chr7	28157297	28157605	DNA/hAT-Charlie	1580	-	154	28157451	77257
chr7	47228348	47428348	harbor1	chr7	47233611	47233790	DNA/hAT-Charlie	832	-	90	47233701	5353
chr7	47228348	47428348	harbor1	chr7	47300857	47301127	DNA/hAT-Charlie	524	-	135	47300992	72644
chr7	123649293	123849293	harbor1	chr7	123703865	123703977	DNA/hAT-Charlie	438	-	56	123703921	54628
chr7	123649293	123849293	harbor1	chr7	123706032	123706249	DNA/hAT-Charlie	564	-	108	123706140	56847
chr7	123649293	123849293	harbor1	chr7	123709897	123710021	DNA/hAT-Charlie	697	-	62	123709959	60666
chr7	123649293	123849293	harbor1	chr7	123717788	123717966	DNA/hAT-Charlie	572	-	89	123717877	68584
chr7	123649293	123849293	harbor1	chr7	123722074	123722226	DNA/hAT-Charlie	466	-	76	123722150	72857
chr7	123649293	123849293	harbor1	chr7	123729105	123729394	DNA/hAT-Charlie	1120	-	144	123729249	79956
chr7	123649293	123849293	harbor1	chr7	123737052	123737269	DNA/hAT-Charlie	1344	-	108	123737160	87867
chr7	123649293	123849293	harbor1	chr7	123738775	123738996	DNA/hAT-Charlie	1312	-	110	123738885	89592
chr7	155249500	155449500	harbor1	chr7	155255877	155256133	DNA/hAT-Charlie	644	-	128	155256005	6505
chr7	140597158	140797158	harbor1	chr7	140603715	140603895	DNA/hAT-Charlie	836	-	90	140603805	6647
chr7	28080212	28280212	harbor1	chr7	28115156	28115475	DNA/hAT-Charlie	1505	-	160	28115316	35104
chr7	28080212	28280212	harbor1	chr7	28140641	28140862	DNA/hAT-Charlie	614	-	110	28140751	60539
chr7	28080212	28280212	harbor1	chr7	28140860	28141053	DNA/hAT-Charlie	609	-	96	28140956	60744
chr7	28080212	28280212	harbor1	chr7	28156584	28156775	DNA/hAT-Charlie	728	-	96	28156680	76468
chr7	28080212	28280212	harbor1	chr7	28157297	28157605	DNA/hAT-Charlie	1580	-	154	28157451	77239
chr7	77912395	78112395	harbor1	chr7	77929710	77929947	DNA/hAT-Charlie	1081	-	118	77929828	17433
chr7	77912395	78112395	harbor1	chr7	77930254	77930316	DNA/hAT-Charlie	1081	-	31	77930285	17890
chr7	77912395	78112395	harbor1	chr7	77946609	77946801	DNA/hAT-Charlie	558	-	96	77946705	34310
chr7	77912395	78112395	harbor1	chr7	78003049	78003073	DNA/hAT-Charlie	766	-	12	78003061	90666
chr7	77912395	78112395	harbor1	chr7	78003746	78003890	DNA/hAT-Charlie	766	-	72	78003818	91423
chr7	28080187	28280187	harbor1	chr7	28115156	28115475	DNA/hAT-Charlie	1505	-	160	28115316	35129
chr7	28080187	28280187	harbor1	chr7	28140641	28140862	DNA/hAT-Charlie	614	-	110	28140751	60564
chr7	28080187	28280187	harbor1	chr7	28140860	28141053	DNA/hAT-Charlie	609	-	96	28140956	60769
chr7	28080187	28280187	harbor1	chr7	28156584	28156775	DNA/hAT-Charlie	728	-	96	28156680	76493
chr7	28080187	28280187	harbor1	chr7	28157297	28157605	DNA/hAT-Charlie	1580	-	154	28157451	77264
chr7	65982514	66182514	harbor1	chr7	66049855	66050379	DNA/hAT-Charlie	3666	-	262	66050117	67603
chr7	157884935	158084935	harbor1	chr7	157900176	157900374	DNA/hAT-Charlie	857	-	99	157900275	15340
chr7	155708581	155908581	harbor1	chr7	155742353	155742577	DNA/hAT-Charlie	757	-	112	155742465	33884
chr7	155708581	155908581	harbor1	chr7	155758301	155758626	DNA/hAT-Charlie	1968	-	162	155758463	49882
chr7	155708581	155908581	harbor1	chr7	155799159	155799480	DNA/hAT-Charlie	1260	-	160	155799319	90738
chr7	123610933	123810933	harbor1	chr7	123703865	123703977	DNA/hAT-Charlie	438	-	56	123703921	92988
chr7	123610933	123810933	harbor1	chr7	123706032	123706249	DNA/hAT-Charlie	564	-	108	123706140	95207
chr7	123610933	123810933	harbor1	chr7	123709897	123710021	DNA/hAT-Charlie	697	-	62	123709959	99026
chr7	123649263	123849263	harbor1	chr7	123703865	123703977	DNA/hAT-Charlie	438	-	56	123703921	54658
chr7	123649263	123849263	harbor1	chr7	123706032	123706249	DNA/hAT-Charlie	564	-	108	123706140	56877
chr7	123649263	123849263	harbor1	chr7	123709897	123710021	DNA/hAT-Charlie	697	-	62	123709959	60696
chr7	123649263	123849263	harbor1	chr7	123717788	123717966	DNA/hAT-Charlie	572	-	89	123717877	68614
chr7	123649263	123849263	harbor1	chr7	123722074	123722226	DNA/hAT-Charlie	466	-	76	123722150	72887
chr7	123649263	123849263	harbor1	chr7	123729105	123729394	DNA/hAT-Charlie	1120	-	144	123729249	79986
chr7	123649263	123849263	harbor1	chr7	123737052	123737269	DNA/hAT-Charlie	1344	-	108	123737160	87897
chr7	123649263	123849263	harbor1	chr7	123738775	123738996	DNA/hAT-Charlie	1312	-	110	123738885	89622
chr7	155231815	155431815	harbor1	chr7	155255877	155256133	DNA/hAT-Charlie	644	-	128	155256005	24190
chr7	50203887	50403887	harbor1	chr7	50242710	50243369	DNA/hAT-Charlie	2537	-	330	50243040	39153
chr7	50203887	50403887	harbor1	chr7	50243370	50244786	DNA/hAT-Charlie	5483	-	708	50244078	40191
chr7	50203887	50403887	harbor1	chr7	50260583	50260901	DNA/hAT-Charlie	1231	-	159	50260742	56855
chr7	50203887	50403887	harbor1	chr7	50298530	50298972	DNA/hAT-Charlie	3084	-	221	50298751	94864
chr7	101437983	101637983	harbor1	chr7	101493502	101493640	DNA/hAT-Charlie	1080	-	69	101493571	55588
chr7	101437983	101637983	harbor1	chr7	101493949	101494128	DNA/hAT-Charlie	1080	-	90	101494039	56056
chr7	101437983	101637983	harbor1	chr7	101494426	101494573	DNA/hAT-Charlie	1080	-	74	101494500	56517
chr7	47228344	47428344	harbor1	chr7	47233611	47233790	DNA/hAT-Charlie	832	-	90	47233701	5357
chr7	47228344	47428344	harbor1	chr7	47300857	47301127	DNA/hAT-Charlie	524	-	135	47300992	72648
chr7	47228340	47428340	harbor1	chr7	47233611	47233790	DNA/hAT-Charlie	832	-	90	47233701	5361
chr7	47228340	47428340	harbor1	chr7	47300857	47301127	DNA/hAT-Charlie	524	-	135	47300992	72652
chr7	90221478	90421478	harbor1	chr7	90241205	90241374	DNA/hAT-Charlie	514	-	84	90241289	19811
chr7	90221478	90421478	harbor1	chr7	90249693	90249863	DNA/hAT-Charlie	805	-	85	90249778	28300
chr7	90221478	90421478	harbor1	chr7	90259845	90259968	DNA/hAT-Charlie	499	-	62	90259907	38429
chr7	47228502	47428502	harbor1	chr7	47233611	47233790	DNA/hAT-Charlie	832	-	90	47233701	5199
chr7	47228502	47428502	harbor1	chr7	47300857	47301127	DNA/hAT-Charlie	524	-	135	47300992	72490
chr7	123649244	123849244	harbor1	chr7	123703865	123703977	DNA/hAT-Charlie	438	-	56	123703921	54677
chr7	123649244	123849244	harbor1	chr7	123706032	123706249	DNA/hAT-Charlie	564	-	108	123706140	56896
chr7	123649244	123849244	harbor1	chr7	123709897	123710021	DNA/hAT-Charlie	697	-	62	123709959	60715
chr7	123649244	123849244	harbor1	chr7	123717788	123717966	DNA/hAT-Charlie	572	-	89	123717877	68633
chr7	123649244	123849244	harbor1	chr7	123722074	123722226	DNA/hAT-Charlie	466	-	76	123722150	72906
chr7	123649244	123849244	harbor1	chr7	123729105	123729394	DNA/hAT-Charlie	1120	-	144	123729249	80005
chr7	123649244	123849244	harbor1	chr7	123737052	123737269	DNA/hAT-Charlie	1344	-	108	123737160	87916
chr7	123649244	123849244	harbor1	chr7	123738775	123738996	DNA/hAT-Charlie	1312	-	110	123738885	89641
chr7	127292503	127492503	harbor1	chr7	127338222	127338410	DNA/hAT-Charlie	680	-	94	127338316	45813
chr7	127292503	127492503	harbor1	chr7	127350179	127351139	DNA/hAT-Charlie	1402	-	480	127350659	58156
chr7	128101419	128301419	harbor1	chr7	128102313	128102465	DNA/hAT-Charlie	776	-	76	128102389	970
chr7	128101419	128301419	harbor1	chr7	128157357	128157553	DNA/hAT-Charlie	891	-	98	128157455	56036
chr7	128101419	128301419	harbor1	chr7	128175070	128175229	DNA/hAT-Charlie	568	-	80	128175150	73731
chr7	128101419	128301419	harbor1	chr7	128175253	128175366	DNA/hAT-Charlie	471	-	56	128175309	73890
chr7	128101419	128301419	harbor1	chr7	128175966	128176028	DNA/hAT-Charlie	471	-	31	128175997	74578
chr7	128101419	128301419	harbor1	chr7	128155533	128155771	DNA/hAT-Charlie	488	-	119	128155652	54233
chr7	47174241	47374241	harbor1	chr7	47233611	47233790	DNA/hAT-Charlie	832	-	90	47233701	59460
chr7	123649264	123849264	harbor1	chr7	123703865	123703977	DNA/hAT-Charlie	438	-	56	123703921	54657
chr7	123649264	123849264	harbor1	chr7	123706032	123706249	DNA/hAT-Charlie	564	-	108	123706140	56876
chr7	123649264	123849264	harbor1	chr7	123709897	123710021	DNA/hAT-Charlie	697	-	62	123709959	60695
chr7	123649264	123849264	harbor1	chr7	123717788	123717966	DNA/hAT-Charlie	572	-	89	123717877	68613
chr7	123649264	123849264	harbor1	chr7	123722074	123722226	DNA/hAT-Charlie	466	-	76	123722150	72886
chr7	123649264	123849264	harbor1	chr7	123729105	123729394	DNA/hAT-Charlie	1120	-	144	123729249	79985
chr7	123649264	123849264	harbor1	chr7	123737052	123737269	DNA/hAT-Charlie	1344	-	108	123737160	87896
chr7	123649264	123849264	harbor1	chr7	123738775	123738996	DNA/hAT-Charlie	1312	-	110	123738885	89621
chr7	47228327	47428327	harbor1	chr7	47233611	47233790	DNA/hAT-Charlie	832	-	90	47233701	5374
chr7	47228327	47428327	harbor1	chr7	47300857	47301127	DNA/hAT-Charlie	524	-	135	47300992	72665
chr7	151420775	151620775	harbor1	chr7	151445442	151445603	DNA/hAT-Charlie	487	-	80	151445522	24747
chr7	151420775	151620775	harbor1	chr7	151489561	151489893	DNA/hAT-Charlie	1334	-	166	151489727	68952
chr7	102325596	102525596	harbor1	chr7	102326342	102326685	DNA/hAT-Charlie	1013	-	172	102326514	918
chr7	102325596	102525596	harbor1	chr7	102413051	102413279	DNA/hAT-Charlie	444	-	114	102413165	87569
chr7	141411856	141611856	harbor1	chr7	141422936	141423032	DNA/hAT-Charlie	1257	-	48	141422984	11128
chr7	141411856	141611856	harbor1	chr7	141423329	141423540	DNA/hAT-Charlie	1257	-	106	141423435	11579
chr7	141411856	141611856	harbor1	chr7	141453777	141453850	DNA/hAT-Charlie	442	-	36	141453813	41957
chr7	141411856	141611856	harbor1	chr7	141478489	141478813	DNA/hAT-Charlie	1425	-	162	141478651	66795
chr7	28080189	28280189	harbor1	chr7	28115156	28115475	DNA/hAT-Charlie	1505	-	160	28115316	35127
chr7	28080189	28280189	harbor1	chr7	28140641	28140862	DNA/hAT-Charlie	614	-	110	28140751	60562
chr7	28080189	28280189	harbor1	chr7	28140860	28141053	DNA/hAT-Charlie	609	-	96	28140956	60767
chr7	28080189	28280189	harbor1	chr7	28156584	28156775	DNA/hAT-Charlie	728	-	96	28156680	76491
chr7	28080189	28280189	harbor1	chr7	28157297	28157605	DNA/hAT-Charlie	1580	-	154	28157451	77262
chr7	26995642	27195642	harbor1	chr7	27065558	27065652	DNA/hAT-Charlie	432	-	47	27065605	69963
chr7	26995642	27195642	harbor1	chr7	27083091	27083315	DNA/hAT-Charlie	1621	-	112	27083203	87561
chr7	26995642	27195642	harbor1	chr7	27066188	27066500	DNA/hAT-Charlie	820	-	156	27066344	70702
chr7	102378973	102578973	harbor1	chr7	102413051	102413279	DNA/hAT-Charlie	444	-	114	102413165	34192
chr7	102378973	102578973	harbor1	chr7	102477474	102477672	DNA/hAT-Charlie	755	-	99	102477573	98600
chr7	66456842	66656842	harbor1	chr7	66476949	66477122	DNA/hAT-Charlie	952	-	86	66477035	20193
chr7	105288909	105488909	harbor1	chr7	105344105	105344297	DNA/hAT-Charlie	698	-	96	105344201	55292
chr7	105288909	105488909	harbor1	chr7	105344529	105344676	DNA/hAT-Charlie	492	-	74	105344603	55694
chr7	105288909	105488909	harbor1	chr7	105345772	105345965	DNA/hAT-Charlie	853	-	96	105345868	56959
chr7	25270046	25470046	harbor1	chr7	25276782	25276865	DNA/hAT-Charlie	514	-	42	25276824	6778
chr7	25270046	25470046	harbor1	chr7	25285667	25285810	DNA/hAT-Charlie	581	-	72	25285739	15693
chr7	25270046	25470046	harbor1	chr7	25355828	25356289	DNA/hAT-Charlie	1516	-	230	25356058	86012
chr7	25270046	25470046	harbor1	chr7	25356381	25357771	DNA/hAT-Charlie	5443	-	695	25357076	87030
chr7	6060488	6260488	harbor1	chr7	6134535	6134659	DNA/hAT-Charlie	523	-	62	6134597	74109
chr7	25697532	25897532	harbor1	chr7	25723421	25723626	DNA/hAT-Charlie	869	-	102	25723523	25991
chr7	25697532	25897532	harbor1	chr7	25774594	25774798	DNA/hAT-Charlie	518	-	102	25774696	77164
chr7	25697532	25897532	harbor1	chr7	25789146	25789321	DNA/hAT-Charlie	822	-	88	25789234	91702
chr7	24657406	24857406	harbor1	chr7	24678825	24679037	DNA/hAT-Charlie	877	-	106	24678931	21525
chr7	47227890	47427890	harbor1	chr7	47233611	47233790	DNA/hAT-Charlie	832	-	90	47233701	5811
chr7	47227890	47427890	harbor1	chr7	47300857	47301127	DNA/hAT-Charlie	524	-	135	47300992	73102
chr7	504701	704701	harbor1	chr7	574302	574447	DNA/hAT-Charlie	713	-	72	574374	69673
chr7	504701	704701	harbor1	chr7	574744	574874	DNA/hAT-Charlie	713	-	65	574809	70108
chr7	16531	216531	harbor1	chr7	52133	52338	DNA/hAT-Charlie	586	-	102	52235	35704
chr7	108470160	108670160	harbor1	chr7	108499519	108499728	DNA/hAT-Charlie	1029	-	104	108499623	29463
chr7	100766226	100966226	harbor1	chr7	100820583	100820871	DNA/hAT-Charlie	717	-	144	100820727	54501
chr7	100766226	100966226	harbor1	chr7	100821768	100821879	DNA/hAT-Charlie	717	-	56	100821824	55598
chr7	47228426	47428426	harbor1	chr7	47233611	47233790	DNA/hAT-Charlie	832	-	90	47233701	5275
chr7	47228426	47428426	harbor1	chr7	47300857	47301127	DNA/hAT-Charlie	524	-	135	47300992	72566
chr7	123649335	123849335	harbor1	chr7	123703865	123703977	DNA/hAT-Charlie	438	-	56	123703921	54586
chr7	123649335	123849335	harbor1	chr7	123706032	123706249	DNA/hAT-Charlie	564	-	108	123706140	56805
chr7	123649335	123849335	harbor1	chr7	123709897	123710021	DNA/hAT-Charlie	697	-	62	123709959	60624
chr7	123649335	123849335	harbor1	chr7	123717788	123717966	DNA/hAT-Charlie	572	-	89	123717877	68542
chr7	123649335	123849335	harbor1	chr7	123722074	123722226	DNA/hAT-Charlie	466	-	76	123722150	72815
chr7	123649335	123849335	harbor1	chr7	123729105	123729394	DNA/hAT-Charlie	1120	-	144	123729249	79914
chr7	123649335	123849335	harbor1	chr7	123737052	123737269	DNA/hAT-Charlie	1344	-	108	123737160	87825
chr7	123649335	123849335	harbor1	chr7	123738775	123738996	DNA/hAT-Charlie	1312	-	110	123738885	89550
chr7	123649230	123849230	harbor1	chr7	123703865	123703977	DNA/hAT-Charlie	438	-	56	123703921	54691
chr7	123649230	123849230	harbor1	chr7	123706032	123706249	DNA/hAT-Charlie	564	-	108	123706140	56910
chr7	123649230	123849230	harbor1	chr7	123709897	123710021	DNA/hAT-Charlie	697	-	62	123709959	60729
chr7	123649230	123849230	harbor1	chr7	123717788	123717966	DNA/hAT-Charlie	572	-	89	123717877	68647
chr7	123649230	123849230	harbor1	chr7	123722074	123722226	DNA/hAT-Charlie	466	-	76	123722150	72920
chr7	123649230	123849230	harbor1	chr7	123729105	123729394	DNA/hAT-Charlie	1120	-	144	123729249	80019
chr7	123649230	123849230	harbor1	chr7	123737052	123737269	DNA/hAT-Charlie	1344	-	108	123737160	87930
chr7	123649230	123849230	harbor1	chr7	123738775	123738996	DNA/hAT-Charlie	1312	-	110	123738885	89655
chr7	73478344	73678344	harbor1	chr7	73551140	73551291	DNA/hAT-Charlie	744	-	76	73551216	72872
chr7	73478344	73678344	harbor1	chr7	73551604	73551673	DNA/hAT-Charlie	744	-	34	73551638	73294
chr7	47568386	47768386	harbor1	chr7	47646221	47646282	DNA/hAT-Charlie	582	-	30	47646251	77865
chr7	47568386	47768386	harbor1	chr7	47646591	47646688	DNA/hAT-Charlie	582	-	48	47646639	78253
chr7	47227923	47427923	harbor1	chr7	47233611	47233790	DNA/hAT-Charlie	832	-	90	47233701	5778
chr7	47227923	47427923	harbor1	chr7	47300857	47301127	DNA/hAT-Charlie	524	-	135	47300992	73069
chr7	123481083	123681083	harbor1	chr7	123574329	123574539	DNA/hAT-Charlie	838	-	105	123574434	93351
chr7	155196997	155396997	harbor1	chr7	155255877	155256133	DNA/hAT-Charlie	644	-	128	155256005	59008
chr7	32628791	32828791	harbor1	chr7	32672992	32673062	DNA/hAT-Charlie	486	-	35	32673027	44236
chr7	32628791	32828791	harbor1	chr7	32673088	32673266	DNA/hAT-Charlie	486	-	89	32673177	44386
chr7	6059184	6259184	harbor1	chr7	6134535	6134659	DNA/hAT-Charlie	523	-	62	6134597	75413
chr7	141411783	141611783	harbor1	chr7	141422936	141423032	DNA/hAT-Charlie	1257	-	48	141422984	11201
chr7	141411783	141611783	harbor1	chr7	141423329	141423540	DNA/hAT-Charlie	1257	-	106	141423435	11652
chr7	141411783	141611783	harbor1	chr7	141453777	141453850	DNA/hAT-Charlie	442	-	36	141453813	42030
chr7	141411783	141611783	harbor1	chr7	141478489	141478813	DNA/hAT-Charlie	1425	-	162	141478651	66868
chr7	30975839	31175839	harbor1	chr7	31018077	31018415	DNA/hAT-Charlie	492	-	169	31018246	42407
chr7	30975839	31175839	harbor1	chr7	31055386	31055705	DNA/hAT-Charlie	1478	-	160	31055546	79707
chr7	30975839	31175839	harbor1	chr7	31065475	31065615	DNA/hAT-Charlie	494	-	70	31065545	89706
chr7	30975839	31175839	harbor1	chr7	31070763	31070898	DNA/hAT-Charlie	777	-	68	31070831	94992
chr7	30579971	30779971	harbor1	chr7	30643842	30643977	DNA/hAT-Charlie	524	-	68	30643910	63939
chr7	30579971	30779971	harbor1	chr7	30670063	30670280	DNA/hAT-Charlie	530	-	108	30670171	90200
chr7	189947	389947	harbor1	chr7	209329	209530	DNA/hAT-Charlie	464	-	100	209429	19482
chr7	189947	389947	harbor1	chr7	242646	242813	DNA/hAT-Charlie	519	-	84	242730	52783
chr7	127133798	127333798	harbor1	chr7	127140167	127140390	DNA/hAT-Charlie	1107	-	112	127140279	6481
chr7	127133798	127333798	harbor1	chr7	127157351	127157614	DNA/hAT-Charlie	1005	-	132	127157483	23685
chr7	43919232	44119232	harbor1	chr7	43925417	43925488	DNA/hAT-Charlie	532	-	36	43925453	6221
chr7	43919232	44119232	harbor1	chr7	43925799	43925892	DNA/hAT-Charlie	532	-	46	43925845	6613
chr7	43919232	44119232	harbor1	chr7	43940864	43941028	DNA/hAT-Charlie	483	-	82	43940946	21714
chr7	43919232	44119232	harbor1	chr7	44017727	44017926	DNA/hAT-Charlie	808	-	100	44017827	98595
chr7	627133	827133	harbor1	chr7	648170	648329	DNA/hAT-Charlie	593	-	80	648250	21117
chr7	627133	827133	harbor1	chr7	649196	649526	DNA/hAT-Charlie	480	-	165	649361	22228
chr7	140378858	140578858	harbor1	chr7	140382084	140382291	DNA/hAT-Charlie	998	-	104	140382188	3330
chr7	140378858	140578858	harbor1	chr7	140401874	140401925	DNA/hAT-Charlie	520	-	26	140401900	23042
chr7	140378858	140578858	harbor1	chr7	140402217	140402412	DNA/hAT-Charlie	520	-	98	140402315	23457
chr7	140378858	140578858	harbor1	chr7	140411444	140411661	DNA/hAT-Charlie	1434	-	108	140411552	32694
chr7	140378858	140578858	harbor1	chr7	140446466	140446785	DNA/hAT-Charlie	1669	-	160	140446626	67768
chr7	140378858	140578858	harbor1	chr7	140460763	140460962	DNA/hAT-Charlie	682	-	100	140460863	82005
chr7	140378858	140578858	harbor1	chr7	140463364	140463555	DNA/hAT-Charlie	512	-	96	140463460	84602
chr7	44436448	44636448	harbor1	chr7	44491664	44491965	DNA/hAT-Charlie	4029	-	150	44491814	55366
chr7	44436448	44636448	harbor1	chr7	44492252	44492434	DNA/hAT-Charlie	4029	-	91	44492343	55895
chr7	44436448	44636448	harbor1	chr7	44492742	44493495	DNA/hAT-Charlie	4029	-	376	44493118	56670
chr7	44436448	44636448	harbor1	chr7	44493890	44494049	DNA/hAT-Charlie	785	-	80	44493970	57522
chr7	122786849	122986849	harbor1	chr7	122823477	122823637	DNA/hAT-Charlie	534	-	80	122823557	36708
chr7	122786849	122986849	harbor1	chr7	122863034	122863535	DNA/hAT-Charlie	1392	-	250	122863284	76435
chr7	122786849	122986849	harbor1	chr7	122880581	122880739	DNA/hAT-Charlie	686	-	79	122880660	93811
chr7	90112306	90312306	harbor1	chr7	90205286	90205538	DNA/hAT-Charlie	686	-	126	90205412	93106
chr7	123648388	123848388	harbor1	chr7	123703865	123703977	DNA/hAT-Charlie	438	-	56	123703921	55533
chr7	123648388	123848388	harbor1	chr7	123706032	123706249	DNA/hAT-Charlie	564	-	108	123706140	57752
chr7	123648388	123848388	harbor1	chr7	123709897	123710021	DNA/hAT-Charlie	697	-	62	123709959	61571
chr7	123648388	123848388	harbor1	chr7	123717788	123717966	DNA/hAT-Charlie	572	-	89	123717877	69489
chr7	123648388	123848388	harbor1	chr7	123722074	123722226	DNA/hAT-Charlie	466	-	76	123722150	73762
chr7	123648388	123848388	harbor1	chr7	123729105	123729394	DNA/hAT-Charlie	1120	-	144	123729249	80861
chr7	123648388	123848388	harbor1	chr7	123737052	123737269	DNA/hAT-Charlie	1344	-	108	123737160	88772
chr7	123648388	123848388	harbor1	chr7	123738775	123738996	DNA/hAT-Charlie	1312	-	110	123738885	90497
chr7	100752657	100952657	harbor1	chr7	100820583	100820871	DNA/hAT-Charlie	717	-	144	100820727	68070
chr7	100752657	100952657	harbor1	chr7	100821768	100821879	DNA/hAT-Charlie	717	-	56	100821824	69167
chr7	123649270	123849270	harbor1	chr7	123703865	123703977	DNA/hAT-Charlie	438	-	56	123703921	54651
chr7	123649270	123849270	harbor1	chr7	123706032	123706249	DNA/hAT-Charlie	564	-	108	123706140	56870
chr7	123649270	123849270	harbor1	chr7	123709897	123710021	DNA/hAT-Charlie	697	-	62	123709959	60689
chr7	123649270	123849270	harbor1	chr7	123717788	123717966	DNA/hAT-Charlie	572	-	89	123717877	68607
chr7	123649270	123849270	harbor1	chr7	123722074	123722226	DNA/hAT-Charlie	466	-	76	123722150	72880
chr7	123649270	123849270	harbor1	chr7	123729105	123729394	DNA/hAT-Charlie	1120	-	144	123729249	79979
chr7	123649270	123849270	harbor1	chr7	123737052	123737269	DNA/hAT-Charlie	1344	-	108	123737160	87890
chr7	123649270	123849270	harbor1	chr7	123738775	123738996	DNA/hAT-Charlie	1312	-	110	123738885	89615
chr7	47228349	47428349	harbor1	chr7	47233611	47233790	DNA/hAT-Charlie	832	-	90	47233701	5352
chr7	47228349	47428349	harbor1	chr7	47300857	47301127	DNA/hAT-Charlie	524	-	135	47300992	72643
chr7	123649311	123849311	harbor1	chr7	123703865	123703977	DNA/hAT-Charlie	438	-	56	123703921	54610
chr7	123649311	123849311	harbor1	chr7	123706032	123706249	DNA/hAT-Charlie	564	-	108	123706140	56829
chr7	123649311	123849311	harbor1	chr7	123709897	123710021	DNA/hAT-Charlie	697	-	62	123709959	60648
chr7	123649311	123849311	harbor1	chr7	123717788	123717966	DNA/hAT-Charlie	572	-	89	123717877	68566
chr7	123649311	123849311	harbor1	chr7	123722074	123722226	DNA/hAT-Charlie	466	-	76	123722150	72839
chr7	123649311	123849311	harbor1	chr7	123729105	123729394	DNA/hAT-Charlie	1120	-	144	123729249	79938
chr7	123649311	123849311	harbor1	chr7	123737052	123737269	DNA/hAT-Charlie	1344	-	108	123737160	87849
chr7	123649311	123849311	harbor1	chr7	123738775	123738996	DNA/hAT-Charlie	1312	-	110	123738885	89574
chr8	23428482	23628482	harbor1	chr8	23430496	23430632	DNA/hAT-Charlie	530	-	68	23430564	2082
chr8	23428482	23628482	harbor1	chr8	23452452	23452644	DNA/hAT-Charlie	954	-	96	23452548	24066
chr8	18018925	18218925	harbor1	chr8	18019323	18019836	DNA/hAT-Charlie	3079	-	256	18019579	654
chr8	18018925	18218925	harbor1	chr8	18052656	18052920	DNA/hAT-Charlie	1506	-	132	18052788	33863
chr8	18018925	18218925	harbor1	chr8	18053238	18053551	DNA/hAT-Charlie	1506	-	156	18053394	34469
chr8	18018925	18218925	harbor1	chr8	18076736	18077920	DNA/hAT-Charlie	5464	-	592	18077328	58403
chr8	23381169	23581169	harbor1	chr8	23385691	23385999	DNA/hAT-Charlie	1394	-	154	23385845	4676
chr8	23381169	23581169	harbor1	chr8	23422702	23422858	DNA/hAT-Charlie	630	-	78	23422780	41611
chr8	23381169	23581169	harbor1	chr8	23422868	23423121	DNA/hAT-Charlie	941	-	126	23422994	41825
chr8	23381169	23581169	harbor1	chr8	23423408	23423499	DNA/hAT-Charlie	941	-	46	23423454	42285
chr8	23381169	23581169	harbor1	chr8	23430496	23430632	DNA/hAT-Charlie	530	-	68	23430564	49395
chr8	23381169	23581169	harbor1	chr8	23452452	23452644	DNA/hAT-Charlie	954	-	96	23452548	71379
chr8	23381133	23581133	harbor1	chr8	23385691	23385999	DNA/hAT-Charlie	1394	-	154	23385845	4712
chr8	23381133	23581133	harbor1	chr8	23422702	23422858	DNA/hAT-Charlie	630	-	78	23422780	41647
chr8	23381133	23581133	harbor1	chr8	23422868	23423121	DNA/hAT-Charlie	941	-	126	23422994	41861
chr8	23381133	23581133	harbor1	chr8	23423408	23423499	DNA/hAT-Charlie	941	-	46	23423454	42321
chr8	23381133	23581133	harbor1	chr8	23430496	23430632	DNA/hAT-Charlie	530	-	68	23430564	49431
chr8	23381133	23581133	harbor1	chr8	23452452	23452644	DNA/hAT-Charlie	954	-	96	23452548	71415
chr8	23379942	23579942	harbor1	chr8	23385691	23385999	DNA/hAT-Charlie	1394	-	154	23385845	5903
chr8	23379942	23579942	harbor1	chr8	23422702	23422858	DNA/hAT-Charlie	630	-	78	23422780	42838
chr8	23379942	23579942	harbor1	chr8	23422868	23423121	DNA/hAT-Charlie	941	-	126	23422994	43052
chr8	23379942	23579942	harbor1	chr8	23423408	23423499	DNA/hAT-Charlie	941	-	46	23423454	43512
chr8	23379942	23579942	harbor1	chr8	23430496	23430632	DNA/hAT-Charlie	530	-	68	23430564	50622
chr8	23379942	23579942	harbor1	chr8	23452452	23452644	DNA/hAT-Charlie	954	-	96	23452548	72606
chr8	23382754	23582754	harbor1	chr8	23385691	23385999	DNA/hAT-Charlie	1394	-	154	23385845	3091
chr8	23382754	23582754	harbor1	chr8	23422702	23422858	DNA/hAT-Charlie	630	-	78	23422780	40026
chr8	23382754	23582754	harbor1	chr8	23422868	23423121	DNA/hAT-Charlie	941	-	126	23422994	40240
chr8	23382754	23582754	harbor1	chr8	23423408	23423499	DNA/hAT-Charlie	941	-	46	23423454	40700
chr8	23382754	23582754	harbor1	chr8	23430496	23430632	DNA/hAT-Charlie	530	-	68	23430564	47810
chr8	23382754	23582754	harbor1	chr8	23452452	23452644	DNA/hAT-Charlie	954	-	96	23452548	69794
chr8	1646122	1846122	harbor1	chr8	1742908	1743239	DNA/hAT-Charlie	1002	-	166	1743074	96952
chr8	23428976	23628976	harbor1	chr8	23430496	23430632	DNA/hAT-Charlie	530	-	68	23430564	1588
chr8	23428976	23628976	harbor1	chr8	23452452	23452644	DNA/hAT-Charlie	954	-	96	23452548	23572
chr8	85145898	85345898	harbor1	chr8	85164138	85164471	DNA/hAT-Charlie	1746	-	166	85164304	18406
chr8	23428919	23628919	harbor1	chr8	23430496	23430632	DNA/hAT-Charlie	530	-	68	23430564	1645
chr8	23428919	23628919	harbor1	chr8	23452452	23452644	DNA/hAT-Charlie	954	-	96	23452548	23629
chr8	599970	799970	harbor1	chr8	657010	657139	DNA/hAT-Charlie	600	-	64	657074	57104
chr8	100620899	100820899	harbor1	chr8	100638261	100638470	DNA/hAT-Charlie	803	-	104	100638365	17466
chr8	100620899	100820899	harbor1	chr8	100658018	100658155	DNA/hAT-Charlie	659	-	68	100658086	37187
chr8	100620899	100820899	harbor1	chr8	100667499	100667815	DNA/hAT-Charlie	648	-	158	100667657	46758
chr8	100620899	100820899	harbor1	chr8	100674839	100675049	DNA/hAT-Charlie	1038	-	105	100674944	54045
chr8	100620899	100820899	harbor1	chr8	100684578	100684659	DNA/hAT-Charlie	453	-	40	100684618	63719
chr8	100620899	100820899	harbor1	chr8	100711305	100711386	DNA/hAT-Charlie	529	-	40	100711345	90446
chr8	23428922	23628922	harbor1	chr8	23430496	23430632	DNA/hAT-Charlie	530	-	68	23430564	1642
chr8	23428922	23628922	harbor1	chr8	23452452	23452644	DNA/hAT-Charlie	954	-	96	23452548	23626
chr8	23374002	23574002	harbor1	chr8	23385691	23385999	DNA/hAT-Charlie	1394	-	154	23385845	11843
chr8	23374002	23574002	harbor1	chr8	23422702	23422858	DNA/hAT-Charlie	630	-	78	23422780	48778
chr8	23374002	23574002	harbor1	chr8	23422868	23423121	DNA/hAT-Charlie	941	-	126	23422994	48992
chr8	23374002	23574002	harbor1	chr8	23423408	23423499	DNA/hAT-Charlie	941	-	46	23423454	49452
chr8	23374002	23574002	harbor1	chr8	23430496	23430632	DNA/hAT-Charlie	530	-	68	23430564	56562
chr8	23374002	23574002	harbor1	chr8	23452452	23452644	DNA/hAT-Charlie	954	-	96	23452548	78546
chr8	23379952	23579952	harbor1	chr8	23385691	23385999	DNA/hAT-Charlie	1394	-	154	23385845	5893
chr8	23379952	23579952	harbor1	chr8	23422702	23422858	DNA/hAT-Charlie	630	-	78	23422780	42828
chr8	23379952	23579952	harbor1	chr8	23422868	23423121	DNA/hAT-Charlie	941	-	126	23422994	43042
chr8	23379952	23579952	harbor1	chr8	23423408	23423499	DNA/hAT-Charlie	941	-	46	23423454	43502
chr8	23379952	23579952	harbor1	chr8	23430496	23430632	DNA/hAT-Charlie	530	-	68	23430564	50612
chr8	23379952	23579952	harbor1	chr8	23452452	23452644	DNA/hAT-Charlie	954	-	96	23452548	72596
chr8	90545266	90745266	harbor1	chr8	90553771	90553856	DNA/hAT-Charlie	492	-	42	90553813	8547
chr8	90545266	90745266	harbor1	chr8	90553868	90554020	DNA/hAT-Charlie	600	-	76	90553944	8678
chr8	90545266	90745266	harbor1	chr8	90598237	90598437	DNA/hAT-Charlie	660	-	100	90598337	53071
chr8	90545266	90745266	harbor1	chr8	90641147	90641450	DNA/hAT-Charlie	1140	-	152	90641299	96033
chr8	23428500	23628500	harbor1	chr8	23430496	23430632	DNA/hAT-Charlie	530	-	68	23430564	2064
chr8	23428500	23628500	harbor1	chr8	23452452	23452644	DNA/hAT-Charlie	954	-	96	23452548	24048
chr8	23409692	23609692	harbor1	chr8	23422702	23422858	DNA/hAT-Charlie	630	-	78	23422780	13088
chr8	23409692	23609692	harbor1	chr8	23422868	23423121	DNA/hAT-Charlie	941	-	126	23422994	13302
chr8	23409692	23609692	harbor1	chr8	23423408	23423499	DNA/hAT-Charlie	941	-	46	23423454	13762
chr8	23409692	23609692	harbor1	chr8	23430496	23430632	DNA/hAT-Charlie	530	-	68	23430564	20872
chr8	23409692	23609692	harbor1	chr8	23452452	23452644	DNA/hAT-Charlie	954	-	96	23452548	42856
chr8	42040638	42240638	harbor1	chr8	42102253	42102387	DNA/hAT-Charlie	913	-	67	42102320	61682
chr8	42040638	42240638	harbor1	chr8	42102688	42102749	DNA/hAT-Charlie	913	-	30	42102718	62080
chr8	42040638	42240638	harbor1	chr8	42115172	42115383	DNA/hAT-Charlie	1422	-	106	42115278	74640
chr8	42040638	42240638	harbor1	chr8	42137893	42138049	DNA/hAT-Charlie	686	-	78	42137971	97333
chr8	23428873	23628873	harbor1	chr8	23430496	23430632	DNA/hAT-Charlie	530	-	68	23430564	1691
chr8	23428873	23628873	harbor1	chr8	23452452	23452644	DNA/hAT-Charlie	954	-	96	23452548	23675
chr8	141207362	141407362	harbor1	chr8	141251626	141251858	DNA/hAT-Charlie	578	-	116	141251742	44380
chr8	141207362	141407362	harbor1	chr8	141257967	141258188	DNA/hAT-Charlie	598	-	110	141258077	50715
chr8	23407606	23607606	harbor1	chr8	23422702	23422858	DNA/hAT-Charlie	630	-	78	23422780	15174
chr8	23407606	23607606	harbor1	chr8	23422868	23423121	DNA/hAT-Charlie	941	-	126	23422994	15388
chr8	23407606	23607606	harbor1	chr8	23423408	23423499	DNA/hAT-Charlie	941	-	46	23423454	15848
chr8	23407606	23607606	harbor1	chr8	23430496	23430632	DNA/hAT-Charlie	530	-	68	23430564	22958
chr8	23407606	23607606	harbor1	chr8	23452452	23452644	DNA/hAT-Charlie	954	-	96	23452548	44942
chr8	23428431	23628431	harbor1	chr8	23430496	23430632	DNA/hAT-Charlie	530	-	68	23430564	2133
chr8	23428431	23628431	harbor1	chr8	23452452	23452644	DNA/hAT-Charlie	954	-	96	23452548	24117
chr8	129907115	130107115	harbor1	chr8	129935290	129935602	DNA/hAT-Charlie	1827	-	156	129935446	28331
chr8	129907115	130107115	harbor1	chr8	129956307	129956484	DNA/hAT-Charlie	642	-	88	129956395	49280
chr8	23398445	23598445	harbor1	chr8	23422702	23422858	DNA/hAT-Charlie	630	-	78	23422780	24335
chr8	23398445	23598445	harbor1	chr8	23422868	23423121	DNA/hAT-Charlie	941	-	126	23422994	24549
chr8	23398445	23598445	harbor1	chr8	23423408	23423499	DNA/hAT-Charlie	941	-	46	23423454	25009
chr8	23398445	23598445	harbor1	chr8	23430496	23430632	DNA/hAT-Charlie	530	-	68	23430564	32119
chr8	23398445	23598445	harbor1	chr8	23452452	23452644	DNA/hAT-Charlie	954	-	96	23452548	54103
chr8	23428857	23628857	harbor1	chr8	23430496	23430632	DNA/hAT-Charlie	530	-	68	23430564	1707
chr8	23428857	23628857	harbor1	chr8	23452452	23452644	DNA/hAT-Charlie	954	-	96	23452548	23691
chr8	8665132	8865132	harbor1	chr8	8704688	8704842	DNA/hAT-Charlie	733	-	77	8704765	39633
chr8	8665132	8865132	harbor1	chr8	8725071	8725494	DNA/hAT-Charlie	1727	-	212	8725283	60151
chr8	8665132	8865132	harbor1	chr8	8729082	8729228	DNA/hAT-Charlie	648	-	73	8729155	64023
chr8	23412840	23612840	harbor1	chr8	23422702	23422858	DNA/hAT-Charlie	630	-	78	23422780	9940
chr8	23412840	23612840	harbor1	chr8	23422868	23423121	DNA/hAT-Charlie	941	-	126	23422994	10154
chr8	23412840	23612840	harbor1	chr8	23423408	23423499	DNA/hAT-Charlie	941	-	46	23423454	10614
chr8	23412840	23612840	harbor1	chr8	23430496	23430632	DNA/hAT-Charlie	530	-	68	23430564	17724
chr8	23412840	23612840	harbor1	chr8	23452452	23452644	DNA/hAT-Charlie	954	-	96	23452548	39708
chr8	23428958	23628958	harbor1	chr8	23430496	23430632	DNA/hAT-Charlie	530	-	68	23430564	1606
chr8	23428958	23628958	harbor1	chr8	23452452	23452644	DNA/hAT-Charlie	954	-	96	23452548	23590
chr8	23409094	23609094	harbor1	chr8	23422702	23422858	DNA/hAT-Charlie	630	-	78	23422780	13686
chr8	23409094	23609094	harbor1	chr8	23422868	23423121	DNA/hAT-Charlie	941	-	126	23422994	13900
chr8	23409094	23609094	harbor1	chr8	23423408	23423499	DNA/hAT-Charlie	941	-	46	23423454	14360
chr8	23409094	23609094	harbor1	chr8	23430496	23430632	DNA/hAT-Charlie	530	-	68	23430564	21470
chr8	23409094	23609094	harbor1	chr8	23452452	23452644	DNA/hAT-Charlie	954	-	96	23452548	43454
chr8	96274034	96474034	harbor1	chr8	96285644	96285804	DNA/hAT-Charlie	455	-	80	96285724	11690
chr8	96274034	96474034	harbor1	chr8	96347618	96347722	DNA/hAT-Charlie	506	-	52	96347670	73636
chr8	96274034	96474034	harbor1	chr8	96357754	96357830	DNA/hAT-Charlie	1393	-	38	96357792	83758
chr8	96274034	96474034	harbor1	chr8	96358203	96358430	DNA/hAT-Charlie	1393	-	114	96358317	84283
chr8	23380409	23580409	harbor1	chr8	23385691	23385999	DNA/hAT-Charlie	1394	-	154	23385845	5436
chr8	23380409	23580409	harbor1	chr8	23422702	23422858	DNA/hAT-Charlie	630	-	78	23422780	42371
chr8	23380409	23580409	harbor1	chr8	23422868	23423121	DNA/hAT-Charlie	941	-	126	23422994	42585
chr8	23380409	23580409	harbor1	chr8	23423408	23423499	DNA/hAT-Charlie	941	-	46	23423454	43045
chr8	23380409	23580409	harbor1	chr8	23430496	23430632	DNA/hAT-Charlie	530	-	68	23430564	50155
chr8	23380409	23580409	harbor1	chr8	23452452	23452644	DNA/hAT-Charlie	954	-	96	23452548	72139
chr8	23428835	23628835	harbor1	chr8	23430496	23430632	DNA/hAT-Charlie	530	-	68	23430564	1729
chr8	23428835	23628835	harbor1	chr8	23452452	23452644	DNA/hAT-Charlie	954	-	96	23452548	23713
chr8	23428925	23628925	harbor1	chr8	23430496	23430632	DNA/hAT-Charlie	530	-	68	23430564	1639
chr8	23428925	23628925	harbor1	chr8	23452452	23452644	DNA/hAT-Charlie	954	-	96	23452548	23623
chr8	23372590	23572590	harbor1	chr8	23385691	23385999	DNA/hAT-Charlie	1394	-	154	23385845	13255
chr8	23372590	23572590	harbor1	chr8	23422702	23422858	DNA/hAT-Charlie	630	-	78	23422780	50190
chr8	23372590	23572590	harbor1	chr8	23422868	23423121	DNA/hAT-Charlie	941	-	126	23422994	50404
chr8	23372590	23572590	harbor1	chr8	23423408	23423499	DNA/hAT-Charlie	941	-	46	23423454	50864
chr8	23372590	23572590	harbor1	chr8	23430496	23430632	DNA/hAT-Charlie	530	-	68	23430564	57974
chr8	23372590	23572590	harbor1	chr8	23452452	23452644	DNA/hAT-Charlie	954	-	96	23452548	79958
chr8	23428499	23628499	harbor1	chr8	23430496	23430632	DNA/hAT-Charlie	530	-	68	23430564	2065
chr8	23428499	23628499	harbor1	chr8	23452452	23452644	DNA/hAT-Charlie	954	-	96	23452548	24049
chr8	38076189	38276189	harbor1	chr8	38100584	38100759	DNA/hAT-Charlie	569	-	88	38100672	24483
chr8	38076189	38276189	harbor1	chr8	38101074	38101087	DNA/hAT-Charlie	569	-	6	38101080	24891
chr8	23428888	23628888	harbor1	chr8	23430496	23430632	DNA/hAT-Charlie	530	-	68	23430564	1676
chr8	23428888	23628888	harbor1	chr8	23452452	23452644	DNA/hAT-Charlie	954	-	96	23452548	23660
chr8	22757824	22957824	harbor1	chr8	22758319	22758502	DNA/hAT-Charlie	892	-	92	22758411	587
chr8	22757824	22957824	harbor1	chr8	22804667	22804757	DNA/hAT-Charlie	431	-	45	22804712	46888
chr8	22757824	22957824	harbor1	chr8	22824434	22824947	DNA/hAT-Charlie	3536	-	256	22824690	66866
chr8	23380336	23580336	harbor1	chr8	23385691	23385999	DNA/hAT-Charlie	1394	-	154	23385845	5509
chr8	23380336	23580336	harbor1	chr8	23422702	23422858	DNA/hAT-Charlie	630	-	78	23422780	42444
chr8	23380336	23580336	harbor1	chr8	23422868	23423121	DNA/hAT-Charlie	941	-	126	23422994	42658
chr8	23380336	23580336	harbor1	chr8	23423408	23423499	DNA/hAT-Charlie	941	-	46	23423454	43118
chr8	23380336	23580336	harbor1	chr8	23430496	23430632	DNA/hAT-Charlie	530	-	68	23430564	50228
chr8	23380336	23580336	harbor1	chr8	23452452	23452644	DNA/hAT-Charlie	954	-	96	23452548	72212
chr8	40746828	40946828	harbor1	chr8	40755270	40755462	DNA/hAT-Charlie	1453	-	96	40755366	8538
chr8	40746828	40946828	harbor1	chr8	40755753	40755903	DNA/hAT-Charlie	1453	-	75	40755828	9000
chr8	142240188	142440188	harbor1	chr8	142335733	142335934	DNA/hAT-Charlie	722	-	100	142335833	95645
chr8	39955067	40155067	harbor1	chr8	39961931	39962091	DNA/hAT-Charlie	724	-	80	39962011	6944
chr8	39955067	40155067	harbor1	chr8	40038435	40038597	DNA/hAT-Charlie	715	-	81	40038516	83449
chr8	66077981	66277981	harbor1	chr8	66119780	66119969	DNA/hAT-Charlie	761	-	94	66119874	41893
chr8	66077981	66277981	harbor1	chr8	66133977	66134144	DNA/hAT-Charlie	571	-	84	66134061	56080
chr8	23423555	23623555	harbor1	chr8	23430496	23430632	DNA/hAT-Charlie	530	-	68	23430564	7009
chr8	23423555	23623555	harbor1	chr8	23452452	23452644	DNA/hAT-Charlie	954	-	96	23452548	28993
chr8	23428893	23628893	harbor1	chr8	23430496	23430632	DNA/hAT-Charlie	530	-	68	23430564	1671
chr8	23428893	23628893	harbor1	chr8	23452452	23452644	DNA/hAT-Charlie	954	-	96	23452548	23655
chr8	141166248	141366248	harbor1	chr8	141251626	141251858	DNA/hAT-Charlie	578	-	116	141251742	85494
chr8	141166248	141366248	harbor1	chr8	141257967	141258188	DNA/hAT-Charlie	598	-	110	141258077	91829
chr8	23419596	23619596	harbor1	chr8	23422702	23422858	DNA/hAT-Charlie	630	-	78	23422780	3184
chr8	23419596	23619596	harbor1	chr8	23422868	23423121	DNA/hAT-Charlie	941	-	126	23422994	3398
chr8	23419596	23619596	harbor1	chr8	23423408	23423499	DNA/hAT-Charlie	941	-	46	23423454	3858
chr8	23419596	23619596	harbor1	chr8	23430496	23430632	DNA/hAT-Charlie	530	-	68	23430564	10968
chr8	23419596	23619596	harbor1	chr8	23452452	23452644	DNA/hAT-Charlie	954	-	96	23452548	32952
chr8	599963	799963	harbor1	chr8	657010	657139	DNA/hAT-Charlie	600	-	64	657074	57111
chr8	60552749	60752749	harbor1	chr8	60572585	60572714	DNA/hAT-Charlie	619	-	64	60572649	19900
chr8	60552749	60752749	harbor1	chr8	60572715	60573099	DNA/hAT-Charlie	1362	-	192	60572907	20158
chr8	60552749	60752749	harbor1	chr8	60607601	60607748	DNA/hAT-Charlie	695	-	74	60607675	54926
chr8	38019471	38219471	harbor1	chr8	38024321	38024509	DNA/hAT-Charlie	1116	-	94	38024415	4944
chr8	38019471	38219471	harbor1	chr8	38028997	38029240	DNA/hAT-Charlie	988	-	122	38029119	9648
chr8	38019471	38219471	harbor1	chr8	38073236	38073419	DNA/hAT-Charlie	980	-	92	38073328	53857
chr8	38019471	38219471	harbor1	chr8	38100584	38100759	DNA/hAT-Charlie	569	-	88	38100672	81201
chr8	38019471	38219471	harbor1	chr8	38101074	38101087	DNA/hAT-Charlie	569	-	6	38101080	81609
chr8	23392919	23592919	harbor1	chr8	23422702	23422858	DNA/hAT-Charlie	630	-	78	23422780	29861
chr8	23392919	23592919	harbor1	chr8	23422868	23423121	DNA/hAT-Charlie	941	-	126	23422994	30075
chr8	23392919	23592919	harbor1	chr8	23423408	23423499	DNA/hAT-Charlie	941	-	46	23423454	30535
chr8	23392919	23592919	harbor1	chr8	23430496	23430632	DNA/hAT-Charlie	530	-	68	23430564	37645
chr8	23392919	23592919	harbor1	chr8	23452452	23452644	DNA/hAT-Charlie	954	-	96	23452548	59629
chr8	23398382	23598382	harbor1	chr8	23422702	23422858	DNA/hAT-Charlie	630	-	78	23422780	24398
chr8	23398382	23598382	harbor1	chr8	23422868	23423121	DNA/hAT-Charlie	941	-	126	23422994	24612
chr8	23398382	23598382	harbor1	chr8	23423408	23423499	DNA/hAT-Charlie	941	-	46	23423454	25072
chr8	23398382	23598382	harbor1	chr8	23430496	23430632	DNA/hAT-Charlie	530	-	68	23430564	32182
chr8	23398382	23598382	harbor1	chr8	23452452	23452644	DNA/hAT-Charlie	954	-	96	23452548	54166
chr8	23428533	23628533	harbor1	chr8	23430496	23430632	DNA/hAT-Charlie	530	-	68	23430564	2031
chr8	23428533	23628533	harbor1	chr8	23452452	23452644	DNA/hAT-Charlie	954	-	96	23452548	24015
chr8	23393307	23593307	harbor1	chr8	23422702	23422858	DNA/hAT-Charlie	630	-	78	23422780	29473
chr8	23393307	23593307	harbor1	chr8	23422868	23423121	DNA/hAT-Charlie	941	-	126	23422994	29687
chr8	23393307	23593307	harbor1	chr8	23423408	23423499	DNA/hAT-Charlie	941	-	46	23423454	30147
chr8	23393307	23593307	harbor1	chr8	23430496	23430632	DNA/hAT-Charlie	530	-	68	23430564	37257
chr8	23393307	23593307	harbor1	chr8	23452452	23452644	DNA/hAT-Charlie	954	-	96	23452548	59241
chr8	66405191	66605191	harbor1	chr8	66420340	66420514	DNA/hAT-Charlie	557	-	87	66420427	15236
chr8	66405191	66605191	harbor1	chr8	66427436	66427602	DNA/hAT-Charlie	773	-	83	66427519	22328
chr8	66405191	66605191	harbor1	chr8	66433710	66433965	DNA/hAT-Charlie	593	-	128	66433838	28647
chr8	66405191	66605191	harbor1	chr8	66443579	66443903	DNA/hAT-Charlie	499	-	162	66443741	38550
chr8	66405191	66605191	harbor1	chr8	66461539	66461786	DNA/hAT-Charlie	729	-	124	66461663	56472
chr8	66405191	66605191	harbor1	chr8	66486394	66486545	DNA/hAT-Charlie	634	-	76	66486470	81279
chr8	23428940	23628940	harbor1	chr8	23430496	23430632	DNA/hAT-Charlie	530	-	68	23430564	1624
chr8	23428940	23628940	harbor1	chr8	23452452	23452644	DNA/hAT-Charlie	954	-	96	23452548	23608
chr8	23428850	23628850	harbor1	chr8	23430496	23430632	DNA/hAT-Charlie	530	-	68	23430564	1714
chr8	23428850	23628850	harbor1	chr8	23452452	23452644	DNA/hAT-Charlie	954	-	96	23452548	23698
chr8	42040276	42240276	harbor1	chr8	42102253	42102387	DNA/hAT-Charlie	913	-	67	42102320	62044
chr8	42040276	42240276	harbor1	chr8	42102688	42102749	DNA/hAT-Charlie	913	-	30	42102718	62442
chr8	42040276	42240276	harbor1	chr8	42115172	42115383	DNA/hAT-Charlie	1422	-	106	42115278	75002
chr8	42040276	42240276	harbor1	chr8	42137893	42138049	DNA/hAT-Charlie	686	-	78	42137971	97695
chr8	23428530	23628530	harbor1	chr8	23430496	23430632	DNA/hAT-Charlie	530	-	68	23430564	2034
chr8	23428530	23628530	harbor1	chr8	23452452	23452644	DNA/hAT-Charlie	954	-	96	23452548	24018
chr8	23429026	23629026	harbor1	chr8	23430496	23430632	DNA/hAT-Charlie	530	-	68	23430564	1538
chr8	23429026	23629026	harbor1	chr8	23452452	23452644	DNA/hAT-Charlie	954	-	96	23452548	23522
chr8	98847692	99047692	harbor1	chr8	98875216	98875521	DNA/hAT-Charlie	719	-	152	98875368	27676
chr8	98847692	99047692	harbor1	chr8	98879389	98879894	DNA/hAT-Charlie	795	-	252	98879641	31949
chr8	98847692	99047692	harbor1	chr8	98880428	98880596	DNA/hAT-Charlie	520	-	84	98880512	32820
chr8	98847692	99047692	harbor1	chr8	98882022	98882239	DNA/hAT-Charlie	650	-	108	98882130	34438
chr8	98847692	99047692	harbor1	chr8	98889698	98889870	DNA/hAT-Charlie	730	-	86	98889784	42092
chr8	98847692	99047692	harbor1	chr8	98895188	98895342	DNA/hAT-Charlie	626	-	77	98895265	47573
chr8	98847692	99047692	harbor1	chr8	98932620	98932767	DNA/hAT-Charlie	483	-	74	98932694	85002
chr8	98847692	99047692	harbor1	chr8	98939302	98939472	DNA/hAT-Charlie	1101	-	85	98939387	91695
chr8	23428510	23628510	harbor1	chr8	23430496	23430632	DNA/hAT-Charlie	530	-	68	23430564	2054
chr8	23428510	23628510	harbor1	chr8	23452452	23452644	DNA/hAT-Charlie	954	-	96	23452548	24038
chr8	129839917	130039917	harbor1	chr8	129883165	129883378	DNA/hAT-Charlie	921	-	106	129883271	43354
chr8	129839917	130039917	harbor1	chr8	129885497	129885714	DNA/hAT-Charlie	1034	-	108	129885605	45688
chr8	129839917	130039917	harbor1	chr8	129935290	129935602	DNA/hAT-Charlie	1827	-	156	129935446	95529
chr8	141231066	141431066	harbor1	chr8	141251626	141251858	DNA/hAT-Charlie	578	-	116	141251742	20676
chr8	141231066	141431066	harbor1	chr8	141257967	141258188	DNA/hAT-Charlie	598	-	110	141258077	27011
chr8	141231066	141431066	harbor1	chr8	141327510	141327721	DNA/hAT-Charlie	1094	-	106	141327616	96550
chr8	141231066	141431066	harbor1	chr8	141328029	141328127	DNA/hAT-Charlie	1094	-	49	141328078	97012
chr8	141231066	141431066	harbor1	chr8	141328906	141329181	DNA/hAT-Charlie	931	-	138	141329044	97978
chr8	142674146	142874146	harbor1	chr8	142677341	142677458	DNA/hAT-Charlie	459	-	58	142677399	3253
chr8	142674146	142874146	harbor1	chr8	142716166	142716477	DNA/hAT-Charlie	2003	-	156	142716322	42176
chr8	81559422	81759422	harbor1	chr8	81648495	81648633	DNA/hAT-Charlie	492	-	69	81648564	89142
chr8	23380964	23580964	harbor1	chr8	23385691	23385999	DNA/hAT-Charlie	1394	-	154	23385845	4881
chr8	23380964	23580964	harbor1	chr8	23422702	23422858	DNA/hAT-Charlie	630	-	78	23422780	41816
chr8	23380964	23580964	harbor1	chr8	23422868	23423121	DNA/hAT-Charlie	941	-	126	23422994	42030
chr8	23380964	23580964	harbor1	chr8	23423408	23423499	DNA/hAT-Charlie	941	-	46	23423454	42490
chr8	23380964	23580964	harbor1	chr8	23430496	23430632	DNA/hAT-Charlie	530	-	68	23430564	49600
chr8	23380964	23580964	harbor1	chr8	23452452	23452644	DNA/hAT-Charlie	954	-	96	23452548	71584
chr8	57161177	57361177	harbor1	chr8	57169848	57169979	DNA/hAT-Charlie	502	-	66	57169914	8737
chr8	57161177	57361177	harbor1	chr8	57182255	57182465	DNA/hAT-Charlie	881	-	105	57182360	21183
chr8	57161177	57361177	harbor1	chr8	57183523	57183596	DNA/hAT-Charlie	996	-	36	57183559	22382
chr8	57161177	57361177	harbor1	chr8	57183844	57183968	DNA/hAT-Charlie	996	-	62	57183906	22729
chr8	57161177	57361177	harbor1	chr8	57185668	57185856	DNA/hAT-Charlie	774	-	94	57185762	24585
chr8	57161177	57361177	harbor1	chr8	57208963	57209131	DNA/hAT-Charlie	454	-	84	57209047	47870
chr8	57161177	57361177	harbor1	chr8	57213342	57213510	DNA/hAT-Charlie	446	-	84	57213426	52249
chr8	57161177	57361177	harbor1	chr8	57251079	57251281	DNA/hAT-Charlie	891	-	101	57251180	90003
chr8	53743525	53943525	harbor1	chr8	53762045	53762214	DNA/hAT-Charlie	482	-	84	53762129	18604
chr8	53743525	53943525	harbor1	chr8	53777611	53777825	DNA/hAT-Charlie	882	-	107	53777718	34193
chr8	53743525	53943525	harbor1	chr8	53786886	53787159	DNA/hAT-Charlie	1023	-	136	53787022	43497
chr8	53743525	53943525	harbor1	chr8	53807829	53807977	DNA/hAT-Charlie	668	-	74	53807903	64378
chr8	27322694	27522694	harbor1	chr8	27341641	27341672	DNA/hAT-Charlie	550	-	16	27341657	18963
chr8	27322694	27522694	harbor1	chr8	27341977	27342113	DNA/hAT-Charlie	550	-	68	27342045	19351
chr8	90970523	91170523	harbor1	chr8	90987680	90988044	DNA/hAT-Charlie	1705	-	182	90987862	17339
chr8	90970523	91170523	harbor1	chr8	91061872	91062320	DNA/hAT-Charlie	754	-	224	91062096	91573
chr8	85145876	85345876	harbor1	chr8	85164138	85164471	DNA/hAT-Charlie	1746	-	166	85164304	18428
chr8	85144970	85344970	harbor1	chr8	85164138	85164471	DNA/hAT-Charlie	1746	-	166	85164304	19334
chr8	599952	799952	harbor1	chr8	657010	657139	DNA/hAT-Charlie	600	-	64	657074	57122
chr8	42040690	42240690	harbor1	chr8	42102253	42102387	DNA/hAT-Charlie	913	-	67	42102320	61630
chr8	42040690	42240690	harbor1	chr8	42102688	42102749	DNA/hAT-Charlie	913	-	30	42102718	62028
chr8	42040690	42240690	harbor1	chr8	42115172	42115383	DNA/hAT-Charlie	1422	-	106	42115278	74588
chr8	42040690	42240690	harbor1	chr8	42137893	42138049	DNA/hAT-Charlie	686	-	78	42137971	97281
chr8	141296156	141496156	harbor1	chr8	141327510	141327721	DNA/hAT-Charlie	1094	-	106	141327616	31460
chr8	141296156	141496156	harbor1	chr8	141328029	141328127	DNA/hAT-Charlie	1094	-	49	141328078	31922
chr8	141296156	141496156	harbor1	chr8	141328906	141329181	DNA/hAT-Charlie	931	-	138	141329044	32888
chr8	141296156	141496156	harbor1	chr8	141356620	141356776	DNA/hAT-Charlie	421	-	78	141356698	60542
chr8	23428435	23628435	harbor1	chr8	23430496	23430632	DNA/hAT-Charlie	530	-	68	23430564	2129
chr8	23428435	23628435	harbor1	chr8	23452452	23452644	DNA/hAT-Charlie	954	-	96	23452548	24113
chr8	78034557	78234557	harbor1	chr8	78064126	78064372	DNA/hAT-Charlie	1614	-	123	78064249	29692
chr8	78034557	78234557	harbor1	chr8	78107964	78108248	DNA/hAT-Charlie	1146	-	142	78108106	73549
chr8	78034557	78234557	harbor1	chr8	78108300	78108584	DNA/hAT-Charlie	948	-	142	78108442	73885
chr8	78034557	78234557	harbor1	chr8	78053094	78053525	DNA/hAT-Charlie	754	-	216	78053310	18753
chr8	23429035	23629035	harbor1	chr8	23430496	23430632	DNA/hAT-Charlie	530	-	68	23430564	1529
chr8	23429035	23629035	harbor1	chr8	23452452	23452644	DNA/hAT-Charlie	954	-	96	23452548	23513
chr8	23388472	23588472	harbor1	chr8	23422702	23422858	DNA/hAT-Charlie	630	-	78	23422780	34308
chr8	23388472	23588472	harbor1	chr8	23422868	23423121	DNA/hAT-Charlie	941	-	126	23422994	34522
chr8	23388472	23588472	harbor1	chr8	23423408	23423499	DNA/hAT-Charlie	941	-	46	23423454	34982
chr8	23388472	23588472	harbor1	chr8	23430496	23430632	DNA/hAT-Charlie	530	-	68	23430564	42092
chr8	23388472	23588472	harbor1	chr8	23452452	23452644	DNA/hAT-Charlie	954	-	96	23452548	64076
chr8	17984183	18184183	harbor1	chr8	18019323	18019836	DNA/hAT-Charlie	3079	-	256	18019579	35396
chr8	17984183	18184183	harbor1	chr8	18052656	18052920	DNA/hAT-Charlie	1506	-	132	18052788	68605
chr8	17984183	18184183	harbor1	chr8	18053238	18053551	DNA/hAT-Charlie	1506	-	156	18053394	69211
chr8	17984183	18184183	harbor1	chr8	18076736	18077920	DNA/hAT-Charlie	5464	-	592	18077328	93145
chr8	129839623	130039623	harbor1	chr8	129839457	129839773	DNA/hAT-Charlie	1450	-	158	129839615	8
chr8	129839623	130039623	harbor1	chr8	129883165	129883378	DNA/hAT-Charlie	921	-	106	129883271	43648
chr8	129839623	130039623	harbor1	chr8	129885497	129885714	DNA/hAT-Charlie	1034	-	108	129885605	45982
chr8	129839623	130039623	harbor1	chr8	129935290	129935602	DNA/hAT-Charlie	1827	-	156	129935446	95823
chr8	100618244	100818244	harbor1	chr8	100638261	100638470	DNA/hAT-Charlie	803	-	104	100638365	20121
chr8	100618244	100818244	harbor1	chr8	100658018	100658155	DNA/hAT-Charlie	659	-	68	100658086	39842
chr8	100618244	100818244	harbor1	chr8	100667499	100667815	DNA/hAT-Charlie	648	-	158	100667657	49413
chr8	100618244	100818244	harbor1	chr8	100674839	100675049	DNA/hAT-Charlie	1038	-	105	100674944	56700
chr8	100618244	100818244	harbor1	chr8	100684578	100684659	DNA/hAT-Charlie	453	-	40	100684618	66374
chr8	100618244	100818244	harbor1	chr8	100711305	100711386	DNA/hAT-Charlie	529	-	40	100711345	93101
chr8	54002046	54202046	harbor1	chr8	54005230	54005395	DNA/hAT-Charlie	692	-	82	54005312	3266
chr8	54002046	54202046	harbor1	chr8	54007147	54007347	DNA/hAT-Charlie	1177	-	100	54007247	5201
chr8	54002046	54202046	harbor1	chr8	54007481	54007725	DNA/hAT-Charlie	1177	-	122	54007603	5557
chr8	54002046	54202046	harbor1	chr8	54064740	54064960	DNA/hAT-Charlie	1309	-	110	54064850	62804
chr8	54002046	54202046	harbor1	chr8	54083507	54083762	DNA/hAT-Charlie	1147	-	128	54083635	81589
chr8	29891739	30091739	harbor1	chr8	29945698	29945932	DNA/hAT-Charlie	864	-	117	29945815	54076
chr8	29891739	30091739	harbor1	chr8	29961007	29961147	DNA/hAT-Charlie	443	-	70	29961077	69338
chr8	23393297	23593297	harbor1	chr8	23422702	23422858	DNA/hAT-Charlie	630	-	78	23422780	29483
chr8	23393297	23593297	harbor1	chr8	23422868	23423121	DNA/hAT-Charlie	941	-	126	23422994	29697
chr8	23393297	23593297	harbor1	chr8	23423408	23423499	DNA/hAT-Charlie	941	-	46	23423454	30157
chr8	23393297	23593297	harbor1	chr8	23430496	23430632	DNA/hAT-Charlie	530	-	68	23430564	37267
chr8	23393297	23593297	harbor1	chr8	23452452	23452644	DNA/hAT-Charlie	954	-	96	23452548	59251
chr8	17057584	17257584	harbor1	chr8	17064694	17064916	DNA/hAT-Charlie	1040	-	111	17064805	7221
chr8	17057584	17257584	harbor1	chr8	17076709	17076864	DNA/hAT-Charlie	687	-	78	17076787	19203
chr8	17057584	17257584	harbor1	chr8	17094256	17094588	DNA/hAT-Charlie	1405	-	166	17094422	36838
chr8	17057584	17257584	harbor1	chr8	17094585	17094873	DNA/hAT-Charlie	1694	-	144	17094729	37145
chr8	23382752	23582752	harbor1	chr8	23385691	23385999	DNA/hAT-Charlie	1394	-	154	23385845	3093
chr8	23382752	23582752	harbor1	chr8	23422702	23422858	DNA/hAT-Charlie	630	-	78	23422780	40028
chr8	23382752	23582752	harbor1	chr8	23422868	23423121	DNA/hAT-Charlie	941	-	126	23422994	40242
chr8	23382752	23582752	harbor1	chr8	23423408	23423499	DNA/hAT-Charlie	941	-	46	23423454	40702
chr8	23382752	23582752	harbor1	chr8	23430496	23430632	DNA/hAT-Charlie	530	-	68	23430564	47812
chr8	23382752	23582752	harbor1	chr8	23452452	23452644	DNA/hAT-Charlie	954	-	96	23452548	69796
chr8	23398575	23598575	harbor1	chr8	23422702	23422858	DNA/hAT-Charlie	630	-	78	23422780	24205
chr8	23398575	23598575	harbor1	chr8	23422868	23423121	DNA/hAT-Charlie	941	-	126	23422994	24419
chr8	23398575	23598575	harbor1	chr8	23423408	23423499	DNA/hAT-Charlie	941	-	46	23423454	24879
chr8	23398575	23598575	harbor1	chr8	23430496	23430632	DNA/hAT-Charlie	530	-	68	23430564	31989
chr8	23398575	23598575	harbor1	chr8	23452452	23452644	DNA/hAT-Charlie	954	-	96	23452548	53973
chr8	23382836	23582836	harbor1	chr8	23385691	23385999	DNA/hAT-Charlie	1394	-	154	23385845	3009
chr8	23382836	23582836	harbor1	chr8	23422702	23422858	DNA/hAT-Charlie	630	-	78	23422780	39944
chr8	23382836	23582836	harbor1	chr8	23422868	23423121	DNA/hAT-Charlie	941	-	126	23422994	40158
chr8	23382836	23582836	harbor1	chr8	23423408	23423499	DNA/hAT-Charlie	941	-	46	23423454	40618
chr8	23382836	23582836	harbor1	chr8	23430496	23430632	DNA/hAT-Charlie	530	-	68	23430564	47728
chr8	23382836	23582836	harbor1	chr8	23452452	23452644	DNA/hAT-Charlie	954	-	96	23452548	69712
chr8	35278099	35478099	harbor1	chr8	35283422	35283479	DNA/hAT-Charlie	615	-	28	35283450	5351
chr8	35278099	35478099	harbor1	chr8	35283815	35283932	DNA/hAT-Charlie	615	-	58	35283873	5774
chr8	35278099	35478099	harbor1	chr8	35302923	35303311	DNA/hAT-Charlie	1437	-	194	35303117	25018
chr8	35278099	35478099	harbor1	chr8	35307020	35307238	DNA/hAT-Charlie	1519	-	109	35307129	29030
chr8	35278099	35478099	harbor1	chr8	35342966	35343152	DNA/hAT-Charlie	888	-	93	35343059	64960
chr8	35278099	35478099	harbor1	chr8	35348801	35350138	DNA/hAT-Charlie	4520	-	668	35349469	71370
chr8	35278099	35478099	harbor1	chr8	35362736	35362931	DNA/hAT-Charlie	551	-	98	35362834	84735
chr8	23146666	23346666	harbor1	chr8	23148727	23148908	DNA/hAT-Charlie	549	-	90	23148817	2151
chr8	23146666	23346666	harbor1	chr8	23202931	23203219	DNA/hAT-Charlie	1133	-	144	23203075	56409
chr8	8665131	8865131	harbor1	chr8	8704688	8704842	DNA/hAT-Charlie	733	-	77	8704765	39634
chr8	8665131	8865131	harbor1	chr8	8725071	8725494	DNA/hAT-Charlie	1727	-	212	8725283	60152
chr8	8665131	8865131	harbor1	chr8	8729082	8729228	DNA/hAT-Charlie	648	-	73	8729155	64024
chr8	102556522	102756522	harbor1	chr8	102562678	102562805	DNA/hAT-Charlie	596	-	64	102562742	6220
chr8	102556522	102756522	harbor1	chr8	102615069	102615393	DNA/hAT-Charlie	1934	-	162	102615231	58709
chr8	102556522	102756522	harbor1	chr8	102616930	102617114	DNA/hAT-Charlie	970	-	92	102617022	60500
chr8	21682210	21882210	harbor1	chr8	21743735	21743819	DNA/hAT-Charlie	454	-	42	21743777	61567
chr8	42040636	42240636	harbor1	chr8	42102253	42102387	DNA/hAT-Charlie	913	-	67	42102320	61684
chr8	42040636	42240636	harbor1	chr8	42102688	42102749	DNA/hAT-Charlie	913	-	30	42102718	62082
chr8	42040636	42240636	harbor1	chr8	42115172	42115383	DNA/hAT-Charlie	1422	-	106	42115278	74642
chr8	42040636	42240636	harbor1	chr8	42137893	42138049	DNA/hAT-Charlie	686	-	78	42137971	97335
chr8	96960816	97160816	harbor1	chr8	96966510	96966698	DNA/hAT-Charlie	989	-	94	96966604	5788
chr8	96960816	97160816	harbor1	chr8	97038672	97038830	DNA/hAT-Charlie	699	-	79	97038751	77935
chr8	96960816	97160816	harbor1	chr8	97051175	97051634	DNA/hAT-Charlie	2202	-	230	97051405	90589
chr8	23428962	23628962	harbor1	chr8	23430496	23430632	DNA/hAT-Charlie	530	-	68	23430564	1602
chr8	23428962	23628962	harbor1	chr8	23452452	23452644	DNA/hAT-Charlie	954	-	96	23452548	23586
chr8	41443390	41643390	harbor1	chr8	41466404	41466570	DNA/hAT-Charlie	481	-	83	41466487	23097
chr8	41443390	41643390	harbor1	chr8	41467345	41467470	DNA/hAT-Charlie	494	-	62	41467407	24017
chr8	41443390	41643390	harbor1	chr8	41467770	41467810	DNA/hAT-Charlie	494	-	20	41467790	24400
chr8	41443390	41643390	harbor1	chr8	41528306	41528474	DNA/hAT-Charlie	515	-	84	41528390	85000
chr8	41443390	41643390	harbor1	chr8	41531580	41531735	DNA/hAT-Charlie	620	-	78	41531658	88268
chr8	3258304	3458304	harbor1	chr8	3346981	3347191	DNA/hAT-Charlie	1290	-	105	3347086	88782
chr8	100621232	100821232	harbor1	chr8	100638261	100638470	DNA/hAT-Charlie	803	-	104	100638365	17133
chr8	100621232	100821232	harbor1	chr8	100658018	100658155	DNA/hAT-Charlie	659	-	68	100658086	36854
chr8	100621232	100821232	harbor1	chr8	100667499	100667815	DNA/hAT-Charlie	648	-	158	100667657	46425
chr8	100621232	100821232	harbor1	chr8	100674839	100675049	DNA/hAT-Charlie	1038	-	105	100674944	53712
chr8	100621232	100821232	harbor1	chr8	100684578	100684659	DNA/hAT-Charlie	453	-	40	100684618	63386
chr8	100621232	100821232	harbor1	chr8	100711305	100711386	DNA/hAT-Charlie	529	-	40	100711345	90113
chr8	32680112	32880112	harbor1	chr8	32739224	32739352	DNA/hAT-Charlie	506	-	64	32739288	59176
chr8	32680112	32880112	harbor1	chr8	32743826	32744012	DNA/hAT-Charlie	927	-	93	32743919	63807
chr8	32680112	32880112	harbor1	chr8	32773906	32774405	DNA/hAT-Charlie	1373	-	250	32774156	94044
chr8	23428892	23628892	harbor1	chr8	23430496	23430632	DNA/hAT-Charlie	530	-	68	23430564	1672
chr8	23428892	23628892	harbor1	chr8	23452452	23452644	DNA/hAT-Charlie	954	-	96	23452548	23656
chr8	66405141	66605141	harbor1	chr8	66420340	66420514	DNA/hAT-Charlie	557	-	87	66420427	15286
chr8	66405141	66605141	harbor1	chr8	66427436	66427602	DNA/hAT-Charlie	773	-	83	66427519	22378
chr8	66405141	66605141	harbor1	chr8	66433710	66433965	DNA/hAT-Charlie	593	-	128	66433838	28697
chr8	66405141	66605141	harbor1	chr8	66443579	66443903	DNA/hAT-Charlie	499	-	162	66443741	38600
chr8	66405141	66605141	harbor1	chr8	66461539	66461786	DNA/hAT-Charlie	729	-	124	66461663	56522
chr8	66405141	66605141	harbor1	chr8	66486394	66486545	DNA/hAT-Charlie	634	-	76	66486470	81329
chr8	23384163	23584163	harbor1	chr8	23385691	23385999	DNA/hAT-Charlie	1394	-	154	23385845	1682
chr8	23384163	23584163	harbor1	chr8	23422702	23422858	DNA/hAT-Charlie	630	-	78	23422780	38617
chr8	23384163	23584163	harbor1	chr8	23422868	23423121	DNA/hAT-Charlie	941	-	126	23422994	38831
chr8	23384163	23584163	harbor1	chr8	23423408	23423499	DNA/hAT-Charlie	941	-	46	23423454	39291
chr8	23384163	23584163	harbor1	chr8	23430496	23430632	DNA/hAT-Charlie	530	-	68	23430564	46401
chr8	23384163	23584163	harbor1	chr8	23452452	23452644	DNA/hAT-Charlie	954	-	96	23452548	68385
chr9	4663254	4863254	harbor1	chr9	4672038	4672085	DNA/hAT-Charlie	629	-	24	4672062	8808
chr9	4663254	4863254	harbor1	chr9	4672390	4672533	DNA/hAT-Charlie	629	-	72	4672462	9208
chr9	4883814	5083814	harbor1	chr9	4925049	4925218	DNA/hAT-Charlie	715	-	84	4925133	41319
chr9	4883814	5083814	harbor1	chr9	4927857	4928102	DNA/hAT-Charlie	1204	-	122	4927979	44165
chr9	4883814	5083814	harbor1	chr9	4930956	4931012	DNA/hAT-Charlie	618	-	28	4930984	47170
chr9	4883814	5083814	harbor1	chr9	4931315	4931411	DNA/hAT-Charlie	618	-	48	4931363	47549
chr9	4883814	5083814	harbor1	chr9	4954142	4954453	DNA/hAT-Charlie	1321	-	156	4954298	70484
chr9	4883814	5083814	harbor1	chr9	4955805	4956092	DNA/hAT-Charlie	1056	-	144	4955949	72135
chr9	4883814	5083814	harbor1	chr9	4965239	4965403	DNA/hAT-Charlie	635	-	82	4965321	81507
chr9	4883814	5083814	harbor1	chr9	4968067	4968223	DNA/hAT-Charlie	832	-	78	4968145	84331
chr9	4883814	5083814	harbor1	chr9	4977317	4977504	DNA/hAT-Charlie	1153	-	94	4977411	93597
chr9	4663492	4863492	harbor1	chr9	4672038	4672085	DNA/hAT-Charlie	629	-	24	4672062	8570
chr9	4663492	4863492	harbor1	chr9	4672390	4672533	DNA/hAT-Charlie	629	-	72	4672462	8970
chr9	1955525	2155525	harbor1	chr9	1968013	1968130	DNA/hAT-Charlie	555	-	58	1968071	12546
chr9	1955525	2155525	harbor1	chr9	1992810	1993160	DNA/hAT-Charlie	2235	-	175	1992985	37460
chr9	1955525	2155525	harbor1	chr9	2009338	2009486	DNA/hAT-Charlie	1180	-	74	2009412	53887
chr9	1955525	2155525	harbor1	chr9	2009801	2010006	DNA/hAT-Charlie	1180	-	102	2009903	54378
chr9	1955525	2155525	harbor1	chr9	2010315	2010692	DNA/hAT-Charlie	1180	-	188	2010503	54978
chr9	1955525	2155525	harbor1	chr9	2048005	2048213	DNA/hAT-Charlie	946	-	104	2048109	92584
chr9	4766620	4966620	harbor1	chr9	4819157	4819322	DNA/hAT-Charlie	978	-	82	4819239	52619
chr9	4663979	4863979	harbor1	chr9	4672038	4672085	DNA/hAT-Charlie	629	-	24	4672062	8083
chr9	4663979	4863979	harbor1	chr9	4672390	4672533	DNA/hAT-Charlie	629	-	72	4672462	8483
chr9	4779222	4979222	harbor1	chr9	4819157	4819322	DNA/hAT-Charlie	978	-	82	4819239	40017
chr9	132805611	133005611	harbor1	chr9	132824476	132824695	DNA/hAT-Charlie	1052	-	110	132824586	18975
chr9	132805611	133005611	harbor1	chr9	132857165	132857349	DNA/hAT-Charlie	897	-	92	132857257	51646
chr9	132805611	133005611	harbor1	chr9	132901307	132901485	DNA/hAT-Charlie	855	-	89	132901396	95785
chr9	100252658	100452658	harbor1	chr9	100285916	100286034	DNA/hAT-Charlie	587	-	59	100285975	33317
chr9	100252658	100452658	harbor1	chr9	100334552	100334657	DNA/hAT-Charlie	2532	-	52	100334604	81946
chr9	100252658	100452658	harbor1	chr9	100334965	100335207	DNA/hAT-Charlie	2532	-	121	100335086	82428
chr9	100252658	100452658	harbor1	chr9	100335499	100335733	DNA/hAT-Charlie	2532	-	117	100335616	82958
chr9	4879874	5079874	harbor1	chr9	4925049	4925218	DNA/hAT-Charlie	715	-	84	4925133	45259
chr9	4879874	5079874	harbor1	chr9	4927857	4928102	DNA/hAT-Charlie	1204	-	122	4927979	48105
chr9	4879874	5079874	harbor1	chr9	4930956	4931012	DNA/hAT-Charlie	618	-	28	4930984	51110
chr9	4879874	5079874	harbor1	chr9	4931315	4931411	DNA/hAT-Charlie	618	-	48	4931363	51489
chr9	4879874	5079874	harbor1	chr9	4954142	4954453	DNA/hAT-Charlie	1321	-	156	4954298	74424
chr9	4879874	5079874	harbor1	chr9	4955805	4956092	DNA/hAT-Charlie	1056	-	144	4955949	76075
chr9	4879874	5079874	harbor1	chr9	4965239	4965403	DNA/hAT-Charlie	635	-	82	4965321	85447
chr9	4879874	5079874	harbor1	chr9	4968067	4968223	DNA/hAT-Charlie	832	-	78	4968145	88271
chr9	4879874	5079874	harbor1	chr9	4977317	4977504	DNA/hAT-Charlie	1153	-	94	4977411	97537
chr9	4883151	5083151	harbor1	chr9	4925049	4925218	DNA/hAT-Charlie	715	-	84	4925133	41982
chr9	4883151	5083151	harbor1	chr9	4927857	4928102	DNA/hAT-Charlie	1204	-	122	4927979	44828
chr9	4883151	5083151	harbor1	chr9	4930956	4931012	DNA/hAT-Charlie	618	-	28	4930984	47833
chr9	4883151	5083151	harbor1	chr9	4931315	4931411	DNA/hAT-Charlie	618	-	48	4931363	48212
chr9	4883151	5083151	harbor1	chr9	4954142	4954453	DNA/hAT-Charlie	1321	-	156	4954298	71147
chr9	4883151	5083151	harbor1	chr9	4955805	4956092	DNA/hAT-Charlie	1056	-	144	4955949	72798
chr9	4883151	5083151	harbor1	chr9	4965239	4965403	DNA/hAT-Charlie	635	-	82	4965321	82170
chr9	4883151	5083151	harbor1	chr9	4968067	4968223	DNA/hAT-Charlie	832	-	78	4968145	84994
chr9	4883151	5083151	harbor1	chr9	4977317	4977504	DNA/hAT-Charlie	1153	-	94	4977411	94260
chr9	4669979	4869979	harbor1	chr9	4672038	4672085	DNA/hAT-Charlie	629	-	24	4672062	2083
chr9	4669979	4869979	harbor1	chr9	4672390	4672533	DNA/hAT-Charlie	629	-	72	4672462	2483
chr9	130220946	130420946	harbor1	chr9	130223373	130223845	DNA/hAT-Charlie	1674	-	236	130223609	2663
chr9	130220946	130420946	harbor1	chr9	130224798	130224909	DNA/hAT-Charlie	569	-	56	130224854	3908
chr9	130220946	130420946	harbor1	chr9	130225194	130225466	DNA/hAT-Charlie	569	-	136	130225330	4384
chr9	130220946	130420946	harbor1	chr9	130237939	130238129	DNA/hAT-Charlie	723	-	95	130238034	17088
chr9	4884822	5084822	harbor1	chr9	4925049	4925218	DNA/hAT-Charlie	715	-	84	4925133	40311
chr9	4884822	5084822	harbor1	chr9	4927857	4928102	DNA/hAT-Charlie	1204	-	122	4927979	43157
chr9	4884822	5084822	harbor1	chr9	4930956	4931012	DNA/hAT-Charlie	618	-	28	4930984	46162
chr9	4884822	5084822	harbor1	chr9	4931315	4931411	DNA/hAT-Charlie	618	-	48	4931363	46541
chr9	4884822	5084822	harbor1	chr9	4954142	4954453	DNA/hAT-Charlie	1321	-	156	4954298	69476
chr9	4884822	5084822	harbor1	chr9	4955805	4956092	DNA/hAT-Charlie	1056	-	144	4955949	71127
chr9	4884822	5084822	harbor1	chr9	4965239	4965403	DNA/hAT-Charlie	635	-	82	4965321	80499
chr9	4884822	5084822	harbor1	chr9	4968067	4968223	DNA/hAT-Charlie	832	-	78	4968145	83323
chr9	4884822	5084822	harbor1	chr9	4977317	4977504	DNA/hAT-Charlie	1153	-	94	4977411	92589
chr9	132382125	132582125	harbor1	chr9	132392848	132393102	DNA/hAT-Charlie	983	-	127	132392975	10850
chr9	132382125	132582125	harbor1	chr9	132464469	132464752	DNA/hAT-Charlie	1192	-	142	132464611	82486
chr9	68605581	68805581	harbor1	chr9	68628654	68628781	DNA/hAT-Charlie	489	-	64	68628718	23137
chr9	68605581	68805581	harbor1	chr9	68633723	68633772	DNA/hAT-Charlie	689	-	24	68633747	28166
chr9	68605581	68805581	harbor1	chr9	68634036	68634228	DNA/hAT-Charlie	689	-	96	68634132	28551
chr9	68605581	68805581	harbor1	chr9	68648743	68648935	DNA/hAT-Charlie	1184	-	96	68648839	43258
chr9	68605581	68805581	harbor1	chr9	68674972	68675194	DNA/hAT-Charlie	561	-	111	68675083	69502
chr9	68605581	68805581	harbor1	chr9	68685446	68685594	DNA/hAT-Charlie	953	-	74	68685520	79939
chr9	68605581	68805581	harbor1	chr9	68692579	68692768	DNA/hAT-Charlie	796	-	94	68692673	87092
chr9	4669278	4869278	harbor1	chr9	4672038	4672085	DNA/hAT-Charlie	629	-	24	4672062	2784
chr9	4669278	4869278	harbor1	chr9	4672390	4672533	DNA/hAT-Charlie	629	-	72	4672462	3184
chr9	4755861	4955861	harbor1	chr9	4819157	4819322	DNA/hAT-Charlie	978	-	82	4819239	63378
chr9	4884838	5084838	harbor1	chr9	4925049	4925218	DNA/hAT-Charlie	715	-	84	4925133	40295
chr9	4884838	5084838	harbor1	chr9	4927857	4928102	DNA/hAT-Charlie	1204	-	122	4927979	43141
chr9	4884838	5084838	harbor1	chr9	4930956	4931012	DNA/hAT-Charlie	618	-	28	4930984	46146
chr9	4884838	5084838	harbor1	chr9	4931315	4931411	DNA/hAT-Charlie	618	-	48	4931363	46525
chr9	4884838	5084838	harbor1	chr9	4954142	4954453	DNA/hAT-Charlie	1321	-	156	4954298	69460
chr9	4884838	5084838	harbor1	chr9	4955805	4956092	DNA/hAT-Charlie	1056	-	144	4955949	71111
chr9	4884838	5084838	harbor1	chr9	4965239	4965403	DNA/hAT-Charlie	635	-	82	4965321	80483
chr9	4884838	5084838	harbor1	chr9	4968067	4968223	DNA/hAT-Charlie	832	-	78	4968145	83307
chr9	4884838	5084838	harbor1	chr9	4977317	4977504	DNA/hAT-Charlie	1153	-	94	4977411	92573
chr9	19130921	19330921	harbor1	chr9	19218878	19219048	DNA/hAT-Charlie	719	-	85	19218963	88042
chr9	4567404	4767404	harbor1	chr9	4644907	4645159	DNA/hAT-Charlie	1000	-	126	4645033	77629
chr9	4747782	4947782	harbor1	chr9	4819157	4819322	DNA/hAT-Charlie	978	-	82	4819239	71457
chr9	4884786	5084786	harbor1	chr9	4925049	4925218	DNA/hAT-Charlie	715	-	84	4925133	40347
chr9	4884786	5084786	harbor1	chr9	4927857	4928102	DNA/hAT-Charlie	1204	-	122	4927979	43193
chr9	4884786	5084786	harbor1	chr9	4930956	4931012	DNA/hAT-Charlie	618	-	28	4930984	46198
chr9	4884786	5084786	harbor1	chr9	4931315	4931411	DNA/hAT-Charlie	618	-	48	4931363	46577
chr9	4884786	5084786	harbor1	chr9	4954142	4954453	DNA/hAT-Charlie	1321	-	156	4954298	69512
chr9	4884786	5084786	harbor1	chr9	4955805	4956092	DNA/hAT-Charlie	1056	-	144	4955949	71163
chr9	4884786	5084786	harbor1	chr9	4965239	4965403	DNA/hAT-Charlie	635	-	82	4965321	80535
chr9	4884786	5084786	harbor1	chr9	4968067	4968223	DNA/hAT-Charlie	832	-	78	4968145	83359
chr9	4884786	5084786	harbor1	chr9	4977317	4977504	DNA/hAT-Charlie	1153	-	94	4977411	92625
chr9	4884812	5084812	harbor1	chr9	4925049	4925218	DNA/hAT-Charlie	715	-	84	4925133	40321
chr9	4884812	5084812	harbor1	chr9	4927857	4928102	DNA/hAT-Charlie	1204	-	122	4927979	43167
chr9	4884812	5084812	harbor1	chr9	4930956	4931012	DNA/hAT-Charlie	618	-	28	4930984	46172
chr9	4884812	5084812	harbor1	chr9	4931315	4931411	DNA/hAT-Charlie	618	-	48	4931363	46551
chr9	4884812	5084812	harbor1	chr9	4954142	4954453	DNA/hAT-Charlie	1321	-	156	4954298	69486
chr9	4884812	5084812	harbor1	chr9	4955805	4956092	DNA/hAT-Charlie	1056	-	144	4955949	71137
chr9	4884812	5084812	harbor1	chr9	4965239	4965403	DNA/hAT-Charlie	635	-	82	4965321	80509
chr9	4884812	5084812	harbor1	chr9	4968067	4968223	DNA/hAT-Charlie	832	-	78	4968145	83333
chr9	4884812	5084812	harbor1	chr9	4977317	4977504	DNA/hAT-Charlie	1153	-	94	4977411	92599
chr9	4884794	5084794	harbor1	chr9	4925049	4925218	DNA/hAT-Charlie	715	-	84	4925133	40339
chr9	4884794	5084794	harbor1	chr9	4927857	4928102	DNA/hAT-Charlie	1204	-	122	4927979	43185
chr9	4884794	5084794	harbor1	chr9	4930956	4931012	DNA/hAT-Charlie	618	-	28	4930984	46190
chr9	4884794	5084794	harbor1	chr9	4931315	4931411	DNA/hAT-Charlie	618	-	48	4931363	46569
chr9	4884794	5084794	harbor1	chr9	4954142	4954453	DNA/hAT-Charlie	1321	-	156	4954298	69504
chr9	4884794	5084794	harbor1	chr9	4955805	4956092	DNA/hAT-Charlie	1056	-	144	4955949	71155
chr9	4884794	5084794	harbor1	chr9	4965239	4965403	DNA/hAT-Charlie	635	-	82	4965321	80527
chr9	4884794	5084794	harbor1	chr9	4968067	4968223	DNA/hAT-Charlie	832	-	78	4968145	83351
chr9	4884794	5084794	harbor1	chr9	4977317	4977504	DNA/hAT-Charlie	1153	-	94	4977411	92617
chr9	68603685	68803685	harbor1	chr9	68628654	68628781	DNA/hAT-Charlie	489	-	64	68628718	25033
chr9	68603685	68803685	harbor1	chr9	68633723	68633772	DNA/hAT-Charlie	689	-	24	68633747	30062
chr9	68603685	68803685	harbor1	chr9	68634036	68634228	DNA/hAT-Charlie	689	-	96	68634132	30447
chr9	68603685	68803685	harbor1	chr9	68648743	68648935	DNA/hAT-Charlie	1184	-	96	68648839	45154
chr9	68603685	68803685	harbor1	chr9	68674972	68675194	DNA/hAT-Charlie	561	-	111	68675083	71398
chr9	68603685	68803685	harbor1	chr9	68685446	68685594	DNA/hAT-Charlie	953	-	74	68685520	81835
chr9	68603685	68803685	harbor1	chr9	68692579	68692768	DNA/hAT-Charlie	796	-	94	68692673	88988
chr9	4663011	4863011	harbor1	chr9	4672038	4672085	DNA/hAT-Charlie	629	-	24	4672062	9051
chr9	4663011	4863011	harbor1	chr9	4672390	4672533	DNA/hAT-Charlie	629	-	72	4672462	9451
chr9	95414535	95614535	harbor1	chr9	95417594	95417929	DNA/hAT-Charlie	1341	-	168	95417762	3227
chr9	95414535	95614535	harbor1	chr9	95435677	95435833	DNA/hAT-Charlie	601	-	78	95435755	21220
chr9	95414535	95614535	harbor1	chr9	95437625	95437841	DNA/hAT-Charlie	1105	-	108	95437733	23198
chr9	95414535	95614535	harbor1	chr9	95442577	95442748	DNA/hAT-Charlie	541	-	86	95442663	28128
chr9	95414535	95614535	harbor1	chr9	95447865	95448055	DNA/hAT-Charlie	632	-	95	95447960	33425
chr9	35657186	35857186	harbor1	chr9	35692408	35692805	DNA/hAT-Charlie	1441	-	198	35692606	35420
chr9	35657186	35857186	harbor1	chr9	35693927	35694020	DNA/hAT-Charlie	2793	-	46	35693973	36787
chr9	35657186	35857186	harbor1	chr9	35694325	35694485	DNA/hAT-Charlie	2793	-	80	35694405	37219
chr9	35657186	35857186	harbor1	chr9	35694809	35695277	DNA/hAT-Charlie	2793	-	234	35695043	37857
chr9	35657186	35857186	harbor1	chr9	35695759	35695865	DNA/hAT-Charlie	589	-	53	35695812	38626
chr9	35657186	35857186	harbor1	chr9	35755463	35755813	DNA/hAT-Charlie	2312	-	175	35755638	98452
chr9	4883407	5083407	harbor1	chr9	4925049	4925218	DNA/hAT-Charlie	715	-	84	4925133	41726
chr9	4883407	5083407	harbor1	chr9	4927857	4928102	DNA/hAT-Charlie	1204	-	122	4927979	44572
chr9	4883407	5083407	harbor1	chr9	4930956	4931012	DNA/hAT-Charlie	618	-	28	4930984	47577
chr9	4883407	5083407	harbor1	chr9	4931315	4931411	DNA/hAT-Charlie	618	-	48	4931363	47956
chr9	4883407	5083407	harbor1	chr9	4954142	4954453	DNA/hAT-Charlie	1321	-	156	4954298	70891
chr9	4883407	5083407	harbor1	chr9	4955805	4956092	DNA/hAT-Charlie	1056	-	144	4955949	72542
chr9	4883407	5083407	harbor1	chr9	4965239	4965403	DNA/hAT-Charlie	635	-	82	4965321	81914
chr9	4883407	5083407	harbor1	chr9	4968067	4968223	DNA/hAT-Charlie	832	-	78	4968145	84738
chr9	4883407	5083407	harbor1	chr9	4977317	4977504	DNA/hAT-Charlie	1153	-	94	4977411	94004
chr9	4766714	4966714	harbor1	chr9	4819157	4819322	DNA/hAT-Charlie	978	-	82	4819239	52525
chr9	4883310	5083310	harbor1	chr9	4925049	4925218	DNA/hAT-Charlie	715	-	84	4925133	41823
chr9	4883310	5083310	harbor1	chr9	4927857	4928102	DNA/hAT-Charlie	1204	-	122	4927979	44669
chr9	4883310	5083310	harbor1	chr9	4930956	4931012	DNA/hAT-Charlie	618	-	28	4930984	47674
chr9	4883310	5083310	harbor1	chr9	4931315	4931411	DNA/hAT-Charlie	618	-	48	4931363	48053
chr9	4883310	5083310	harbor1	chr9	4954142	4954453	DNA/hAT-Charlie	1321	-	156	4954298	70988
chr9	4883310	5083310	harbor1	chr9	4955805	4956092	DNA/hAT-Charlie	1056	-	144	4955949	72639
chr9	4883310	5083310	harbor1	chr9	4965239	4965403	DNA/hAT-Charlie	635	-	82	4965321	82011
chr9	4883310	5083310	harbor1	chr9	4968067	4968223	DNA/hAT-Charlie	832	-	78	4968145	84835
chr9	4883310	5083310	harbor1	chr9	4977317	4977504	DNA/hAT-Charlie	1153	-	94	4977411	94101
chr9	4883306	5083306	harbor1	chr9	4925049	4925218	DNA/hAT-Charlie	715	-	84	4925133	41827
chr9	4883306	5083306	harbor1	chr9	4927857	4928102	DNA/hAT-Charlie	1204	-	122	4927979	44673
chr9	4883306	5083306	harbor1	chr9	4930956	4931012	DNA/hAT-Charlie	618	-	28	4930984	47678
chr9	4883306	5083306	harbor1	chr9	4931315	4931411	DNA/hAT-Charlie	618	-	48	4931363	48057
chr9	4883306	5083306	harbor1	chr9	4954142	4954453	DNA/hAT-Charlie	1321	-	156	4954298	70992
chr9	4883306	5083306	harbor1	chr9	4955805	4956092	DNA/hAT-Charlie	1056	-	144	4955949	72643
chr9	4883306	5083306	harbor1	chr9	4965239	4965403	DNA/hAT-Charlie	635	-	82	4965321	82015
chr9	4883306	5083306	harbor1	chr9	4968067	4968223	DNA/hAT-Charlie	832	-	78	4968145	84839
chr9	4883306	5083306	harbor1	chr9	4977317	4977504	DNA/hAT-Charlie	1153	-	94	4977411	94105
chr9	111796999	111996999	harbor1	chr9	111895910	111896146	DNA/hAT-Charlie	611	-	118	111896028	99029
chr9	4663450	4863450	harbor1	chr9	4672038	4672085	DNA/hAT-Charlie	629	-	24	4672062	8612
chr9	4663450	4863450	harbor1	chr9	4672390	4672533	DNA/hAT-Charlie	629	-	72	4672462	9012
chr9	126299438	126499438	harbor1	chr9	126341614	126341850	DNA/hAT-Charlie	1028	-	118	126341732	42294
chr9	126299438	126499438	harbor1	chr9	126360300	126360486	DNA/hAT-Charlie	596	-	93	126360393	60955
chr9	3230875	3430875	harbor1	chr9	3234184	3234356	DNA/hAT-Charlie	778	-	86	3234270	3395
chr9	3230875	3430875	harbor1	chr9	3234667	3234761	DNA/hAT-Charlie	778	-	47	3234714	3839
chr9	3230875	3430875	harbor1	chr9	3256432	3256601	DNA/hAT-Charlie	827	-	84	3256516	25641
chr9	3230875	3430875	harbor1	chr9	3275898	3276586	DNA/hAT-Charlie	1776	-	344	3276242	45367
chr9	4739858	4939858	harbor1	chr9	4819157	4819322	DNA/hAT-Charlie	978	-	82	4819239	79381
chr9	4663900	4863900	harbor1	chr9	4672038	4672085	DNA/hAT-Charlie	629	-	24	4672062	8162
chr9	4663900	4863900	harbor1	chr9	4672390	4672533	DNA/hAT-Charlie	629	-	72	4672462	8562
chr9	83716782	83916782	harbor1	chr9	83724546	83724817	DNA/hAT-Charlie	1260	-	136	83724682	7900
chr9	83716782	83916782	harbor1	chr9	83767281	83767363	DNA/hAT-Charlie	603	-	41	83767322	50540
chr9	83716782	83916782	harbor1	chr9	83767663	83767701	DNA/hAT-Charlie	603	-	19	83767682	50900
chr9	83716782	83916782	harbor1	chr9	83767986	83768094	DNA/hAT-Charlie	603	-	54	83768040	51258
chr9	4884859	5084859	harbor1	chr9	4925049	4925218	DNA/hAT-Charlie	715	-	84	4925133	40274
chr9	4884859	5084859	harbor1	chr9	4927857	4928102	DNA/hAT-Charlie	1204	-	122	4927979	43120
chr9	4884859	5084859	harbor1	chr9	4930956	4931012	DNA/hAT-Charlie	618	-	28	4930984	46125
chr9	4884859	5084859	harbor1	chr9	4931315	4931411	DNA/hAT-Charlie	618	-	48	4931363	46504
chr9	4884859	5084859	harbor1	chr9	4954142	4954453	DNA/hAT-Charlie	1321	-	156	4954298	69439
chr9	4884859	5084859	harbor1	chr9	4955805	4956092	DNA/hAT-Charlie	1056	-	144	4955949	71090
chr9	4884859	5084859	harbor1	chr9	4965239	4965403	DNA/hAT-Charlie	635	-	82	4965321	80462
chr9	4884859	5084859	harbor1	chr9	4968067	4968223	DNA/hAT-Charlie	832	-	78	4968145	83286
chr9	4884859	5084859	harbor1	chr9	4977317	4977504	DNA/hAT-Charlie	1153	-	94	4977411	92552
chr9	4663906	4863906	harbor1	chr9	4672038	4672085	DNA/hAT-Charlie	629	-	24	4672062	8156
chr9	4663906	4863906	harbor1	chr9	4672390	4672533	DNA/hAT-Charlie	629	-	72	4672462	8556
chr9	4879900	5079900	harbor1	chr9	4925049	4925218	DNA/hAT-Charlie	715	-	84	4925133	45233
chr9	4879900	5079900	harbor1	chr9	4927857	4928102	DNA/hAT-Charlie	1204	-	122	4927979	48079
chr9	4879900	5079900	harbor1	chr9	4930956	4931012	DNA/hAT-Charlie	618	-	28	4930984	51084
chr9	4879900	5079900	harbor1	chr9	4931315	4931411	DNA/hAT-Charlie	618	-	48	4931363	51463
chr9	4879900	5079900	harbor1	chr9	4954142	4954453	DNA/hAT-Charlie	1321	-	156	4954298	74398
chr9	4879900	5079900	harbor1	chr9	4955805	4956092	DNA/hAT-Charlie	1056	-	144	4955949	76049
chr9	4879900	5079900	harbor1	chr9	4965239	4965403	DNA/hAT-Charlie	635	-	82	4965321	85421
chr9	4879900	5079900	harbor1	chr9	4968067	4968223	DNA/hAT-Charlie	832	-	78	4968145	88245
chr9	4879900	5079900	harbor1	chr9	4977317	4977504	DNA/hAT-Charlie	1153	-	94	4977411	97511
chr9	4877201	5077201	harbor1	chr9	4925049	4925218	DNA/hAT-Charlie	715	-	84	4925133	47932
chr9	4877201	5077201	harbor1	chr9	4927857	4928102	DNA/hAT-Charlie	1204	-	122	4927979	50778
chr9	4877201	5077201	harbor1	chr9	4930956	4931012	DNA/hAT-Charlie	618	-	28	4930984	53783
chr9	4877201	5077201	harbor1	chr9	4931315	4931411	DNA/hAT-Charlie	618	-	48	4931363	54162
chr9	4877201	5077201	harbor1	chr9	4954142	4954453	DNA/hAT-Charlie	1321	-	156	4954298	77097
chr9	4877201	5077201	harbor1	chr9	4955805	4956092	DNA/hAT-Charlie	1056	-	144	4955949	78748
chr9	4877201	5077201	harbor1	chr9	4965239	4965403	DNA/hAT-Charlie	635	-	82	4965321	88120
chr9	4877201	5077201	harbor1	chr9	4968067	4968223	DNA/hAT-Charlie	832	-	78	4968145	90944
chr9	1	114163	harbor1	chr9	67132	67336	DNA/hAT-Charlie	1103	-	102	67234	67233
chr9	1	114163	harbor1	chr9	77696	77888	DNA/hAT-Charlie	595	-	96	77792	77791
chr9	1	114163	harbor1	chr9	91100	91377	DNA/hAT-Charlie	596	-	138	91238	91237
chr9	1	114163	harbor1	chr9	91696	91837	DNA/hAT-Charlie	617	-	70	91766	91765
chr9	1	114163	harbor1	chr9	92192	92371	DNA/hAT-Charlie	852	-	90	92282	92281
chr9	1	114163	harbor1	chr9	98943	99103	DNA/hAT-Charlie	1009	-	80	99023	99022
chr9	1	114163	harbor1	chr9	99374	99454	DNA/hAT-Charlie	1009	-	40	99414	99413
chr9	4663278	4863278	harbor1	chr9	4672038	4672085	DNA/hAT-Charlie	629	-	24	4672062	8784
chr9	4663278	4863278	harbor1	chr9	4672390	4672533	DNA/hAT-Charlie	629	-	72	4672462	9184
chr9	113066019	113266019	harbor1	chr9	113120554	113120670	DNA/hAT-Charlie	519	-	58	113120612	54593
chr9	113066019	113266019	harbor1	chr9	113120967	113121033	DNA/hAT-Charlie	519	-	33	113121000	54981
chr9	35598598	35798598	harbor1	chr9	35603505	35603961	DNA/hAT-Charlie	791	-	228	35603733	5135
chr9	35598598	35798598	harbor1	chr9	35636079	35636290	DNA/hAT-Charlie	1060	-	106	35636185	37587
chr9	35598598	35798598	harbor1	chr9	35654667	35654792	DNA/hAT-Charlie	1690	-	62	35654729	56131
chr9	35598598	35798598	harbor1	chr9	35655104	35655361	DNA/hAT-Charlie	1690	-	128	35655232	56634
chr9	35598598	35798598	harbor1	chr9	35692408	35692805	DNA/hAT-Charlie	1441	-	198	35692606	94008
chr9	35598598	35798598	harbor1	chr9	35693927	35694020	DNA/hAT-Charlie	2793	-	46	35693973	95375
chr9	35598598	35798598	harbor1	chr9	35694325	35694485	DNA/hAT-Charlie	2793	-	80	35694405	95807
chr9	35598598	35798598	harbor1	chr9	35694809	35695277	DNA/hAT-Charlie	2793	-	234	35695043	96445
chr9	35598598	35798598	harbor1	chr9	35695759	35695865	DNA/hAT-Charlie	589	-	53	35695812	97214
chr9	4755859	4955859	harbor1	chr9	4819157	4819322	DNA/hAT-Charlie	978	-	82	4819239	63380
chr9	1915302	2115302	harbor1	chr9	1968013	1968130	DNA/hAT-Charlie	555	-	58	1968071	52769
chr9	1915302	2115302	harbor1	chr9	1992810	1993160	DNA/hAT-Charlie	2235	-	175	1992985	77683
chr9	1915302	2115302	harbor1	chr9	2009338	2009486	DNA/hAT-Charlie	1180	-	74	2009412	94110
chr9	1915302	2115302	harbor1	chr9	2009801	2010006	DNA/hAT-Charlie	1180	-	102	2009903	94601
chr9	1915302	2115302	harbor1	chr9	2010315	2010692	DNA/hAT-Charlie	1180	-	188	2010503	95201
chr9	137214690	137414690	harbor1	chr9	137258772	137258921	DNA/hAT-Charlie	541	-	74	137258846	44156
chr9	137214690	137414690	harbor1	chr9	137259209	137259325	DNA/hAT-Charlie	541	-	58	137259267	44577
chr9	4663875	4863875	harbor1	chr9	4672038	4672085	DNA/hAT-Charlie	629	-	24	4672062	8187
chr9	4663875	4863875	harbor1	chr9	4672390	4672533	DNA/hAT-Charlie	629	-	72	4672462	8587
chr9	1987488	2187488	harbor1	chr9	1992810	1993160	DNA/hAT-Charlie	2235	-	175	1992985	5497
chr9	1987488	2187488	harbor1	chr9	2009338	2009486	DNA/hAT-Charlie	1180	-	74	2009412	21924
chr9	1987488	2187488	harbor1	chr9	2009801	2010006	DNA/hAT-Charlie	1180	-	102	2009903	22415
chr9	1987488	2187488	harbor1	chr9	2010315	2010692	DNA/hAT-Charlie	1180	-	188	2010503	23015
chr9	1987488	2187488	harbor1	chr9	2048005	2048213	DNA/hAT-Charlie	946	-	104	2048109	60621
chr9	1987488	2187488	harbor1	chr9	2079422	2079653	DNA/hAT-Charlie	1026	-	116	2079538	92050
chr9	134036206	134236206	harbor1	chr9	134071153	134071488	DNA/hAT-Charlie	2229	-	168	134071321	35115
chr9	4669568	4869568	harbor1	chr9	4672038	4672085	DNA/hAT-Charlie	629	-	24	4672062	2494
chr9	4669568	4869568	harbor1	chr9	4672390	4672533	DNA/hAT-Charlie	629	-	72	4672462	2894
chr9	4884854	5084854	harbor1	chr9	4925049	4925218	DNA/hAT-Charlie	715	-	84	4925133	40279
chr9	4884854	5084854	harbor1	chr9	4927857	4928102	DNA/hAT-Charlie	1204	-	122	4927979	43125
chr9	4884854	5084854	harbor1	chr9	4930956	4931012	DNA/hAT-Charlie	618	-	28	4930984	46130
chr9	4884854	5084854	harbor1	chr9	4931315	4931411	DNA/hAT-Charlie	618	-	48	4931363	46509
chr9	4884854	5084854	harbor1	chr9	4954142	4954453	DNA/hAT-Charlie	1321	-	156	4954298	69444
chr9	4884854	5084854	harbor1	chr9	4955805	4956092	DNA/hAT-Charlie	1056	-	144	4955949	71095
chr9	4884854	5084854	harbor1	chr9	4965239	4965403	DNA/hAT-Charlie	635	-	82	4965321	80467
chr9	4884854	5084854	harbor1	chr9	4968067	4968223	DNA/hAT-Charlie	832	-	78	4968145	83291
chr9	4884854	5084854	harbor1	chr9	4977317	4977504	DNA/hAT-Charlie	1153	-	94	4977411	92557
chr9	123332197	123532197	harbor1	chr9	123414452	123414742	DNA/hAT-Charlie	577	-	145	123414597	82400
chr9	4884933	5084933	harbor1	chr9	4925049	4925218	DNA/hAT-Charlie	715	-	84	4925133	40200
chr9	4884933	5084933	harbor1	chr9	4927857	4928102	DNA/hAT-Charlie	1204	-	122	4927979	43046
chr9	4884933	5084933	harbor1	chr9	4930956	4931012	DNA/hAT-Charlie	618	-	28	4930984	46051
chr9	4884933	5084933	harbor1	chr9	4931315	4931411	DNA/hAT-Charlie	618	-	48	4931363	46430
chr9	4884933	5084933	harbor1	chr9	4954142	4954453	DNA/hAT-Charlie	1321	-	156	4954298	69365
chr9	4884933	5084933	harbor1	chr9	4955805	4956092	DNA/hAT-Charlie	1056	-	144	4955949	71016
chr9	4884933	5084933	harbor1	chr9	4965239	4965403	DNA/hAT-Charlie	635	-	82	4965321	80388
chr9	4884933	5084933	harbor1	chr9	4968067	4968223	DNA/hAT-Charlie	832	-	78	4968145	83212
chr9	4884933	5084933	harbor1	chr9	4977317	4977504	DNA/hAT-Charlie	1153	-	94	4977411	92478
chr9	21875478	22075478	harbor1	chr9	21957243	21957421	DNA/hAT-Charlie	827	-	89	21957332	81854
chr9	4885046	5085046	harbor1	chr9	4925049	4925218	DNA/hAT-Charlie	715	-	84	4925133	40087
chr9	4885046	5085046	harbor1	chr9	4927857	4928102	DNA/hAT-Charlie	1204	-	122	4927979	42933
chr9	4885046	5085046	harbor1	chr9	4930956	4931012	DNA/hAT-Charlie	618	-	28	4930984	45938
chr9	4885046	5085046	harbor1	chr9	4931315	4931411	DNA/hAT-Charlie	618	-	48	4931363	46317
chr9	4885046	5085046	harbor1	chr9	4954142	4954453	DNA/hAT-Charlie	1321	-	156	4954298	69252
chr9	4885046	5085046	harbor1	chr9	4955805	4956092	DNA/hAT-Charlie	1056	-	144	4955949	70903
chr9	4885046	5085046	harbor1	chr9	4965239	4965403	DNA/hAT-Charlie	635	-	82	4965321	80275
chr9	4885046	5085046	harbor1	chr9	4968067	4968223	DNA/hAT-Charlie	832	-	78	4968145	83099
chr9	4885046	5085046	harbor1	chr9	4977317	4977504	DNA/hAT-Charlie	1153	-	94	4977411	92365
chr9	134035557	134235557	harbor1	chr9	134071153	134071488	DNA/hAT-Charlie	2229	-	168	134071321	35764
chr9	137214689	137414689	harbor1	chr9	137258772	137258921	DNA/hAT-Charlie	541	-	74	137258846	44157
chr9	137214689	137414689	harbor1	chr9	137259209	137259325	DNA/hAT-Charlie	541	-	58	137259267	44578
chr9	4747506	4947506	harbor1	chr9	4819157	4819322	DNA/hAT-Charlie	978	-	82	4819239	71733
chr9	137213986	137413986	harbor1	chr9	137258772	137258921	DNA/hAT-Charlie	541	-	74	137258846	44860
chr9	137213986	137413986	harbor1	chr9	137259209	137259325	DNA/hAT-Charlie	541	-	58	137259267	45281
chr9	35656433	35856433	harbor1	chr9	35692408	35692805	DNA/hAT-Charlie	1441	-	198	35692606	36173
chr9	35656433	35856433	harbor1	chr9	35693927	35694020	DNA/hAT-Charlie	2793	-	46	35693973	37540
chr9	35656433	35856433	harbor1	chr9	35694325	35694485	DNA/hAT-Charlie	2793	-	80	35694405	37972
chr9	35656433	35856433	harbor1	chr9	35694809	35695277	DNA/hAT-Charlie	2793	-	234	35695043	38610
chr9	35656433	35856433	harbor1	chr9	35695759	35695865	DNA/hAT-Charlie	589	-	53	35695812	39379
chr9	35656433	35856433	harbor1	chr9	35755463	35755813	DNA/hAT-Charlie	2312	-	175	35755638	99205
chr9	4884905	5084905	harbor1	chr9	4925049	4925218	DNA/hAT-Charlie	715	-	84	4925133	40228
chr9	4884905	5084905	harbor1	chr9	4927857	4928102	DNA/hAT-Charlie	1204	-	122	4927979	43074
chr9	4884905	5084905	harbor1	chr9	4930956	4931012	DNA/hAT-Charlie	618	-	28	4930984	46079
chr9	4884905	5084905	harbor1	chr9	4931315	4931411	DNA/hAT-Charlie	618	-	48	4931363	46458
chr9	4884905	5084905	harbor1	chr9	4954142	4954453	DNA/hAT-Charlie	1321	-	156	4954298	69393
chr9	4884905	5084905	harbor1	chr9	4955805	4956092	DNA/hAT-Charlie	1056	-	144	4955949	71044
chr9	4884905	5084905	harbor1	chr9	4965239	4965403	DNA/hAT-Charlie	635	-	82	4965321	80416
chr9	4884905	5084905	harbor1	chr9	4968067	4968223	DNA/hAT-Charlie	832	-	78	4968145	83240
chr9	4884905	5084905	harbor1	chr9	4977317	4977504	DNA/hAT-Charlie	1153	-	94	4977411	92506
chr9	35580921	35780921	harbor1	chr9	35603505	35603961	DNA/hAT-Charlie	791	-	228	35603733	22812
chr9	35580921	35780921	harbor1	chr9	35636079	35636290	DNA/hAT-Charlie	1060	-	106	35636185	55264
chr9	35580921	35780921	harbor1	chr9	35654667	35654792	DNA/hAT-Charlie	1690	-	62	35654729	73808
chr9	35580921	35780921	harbor1	chr9	35655104	35655361	DNA/hAT-Charlie	1690	-	128	35655232	74311
chr9	1955526	2155526	harbor1	chr9	1968013	1968130	DNA/hAT-Charlie	555	-	58	1968071	12545
chr9	1955526	2155526	harbor1	chr9	1992810	1993160	DNA/hAT-Charlie	2235	-	175	1992985	37459
chr9	1955526	2155526	harbor1	chr9	2009338	2009486	DNA/hAT-Charlie	1180	-	74	2009412	53886
chr9	1955526	2155526	harbor1	chr9	2009801	2010006	DNA/hAT-Charlie	1180	-	102	2009903	54377
chr9	1955526	2155526	harbor1	chr9	2010315	2010692	DNA/hAT-Charlie	1180	-	188	2010503	54977
chr9	1955526	2155526	harbor1	chr9	2048005	2048213	DNA/hAT-Charlie	946	-	104	2048109	92583
chr9	89260220	89460220	harbor1	chr9	89266165	89266306	DNA/hAT-Charlie	736	-	70	89266235	6015
chr9	89260220	89460220	harbor1	chr9	89290217	89290358	DNA/hAT-Charlie	642	-	70	89290287	30067
chr9	89260220	89460220	harbor1	chr9	89291072	89291360	DNA/hAT-Charlie	577	-	144	89291216	30996
chr9	89260220	89460220	harbor1	chr9	89353097	89353263	DNA/hAT-Charlie	672	-	83	89353180	92960
chr9	4884994	5084994	harbor1	chr9	4925049	4925218	DNA/hAT-Charlie	715	-	84	4925133	40139
chr9	4884994	5084994	harbor1	chr9	4927857	4928102	DNA/hAT-Charlie	1204	-	122	4927979	42985
chr9	4884994	5084994	harbor1	chr9	4930956	4931012	DNA/hAT-Charlie	618	-	28	4930984	45990
chr9	4884994	5084994	harbor1	chr9	4931315	4931411	DNA/hAT-Charlie	618	-	48	4931363	46369
chr9	4884994	5084994	harbor1	chr9	4954142	4954453	DNA/hAT-Charlie	1321	-	156	4954298	69304
chr9	4884994	5084994	harbor1	chr9	4955805	4956092	DNA/hAT-Charlie	1056	-	144	4955949	70955
chr9	4884994	5084994	harbor1	chr9	4965239	4965403	DNA/hAT-Charlie	635	-	82	4965321	80327
chr9	4884994	5084994	harbor1	chr9	4968067	4968223	DNA/hAT-Charlie	832	-	78	4968145	83151
chr9	4884994	5084994	harbor1	chr9	4977317	4977504	DNA/hAT-Charlie	1153	-	94	4977411	92417
chr9	137214628	137414628	harbor1	chr9	137258772	137258921	DNA/hAT-Charlie	541	-	74	137258846	44218
chr9	137214628	137414628	harbor1	chr9	137259209	137259325	DNA/hAT-Charlie	541	-	58	137259267	44639
chr9	134035364	134235364	harbor1	chr9	134071153	134071488	DNA/hAT-Charlie	2229	-	168	134071321	35957
chr9	134577518	134777518	harbor1	chr9	134652794	134652969	DNA/hAT-Charlie	617	-	88	134652882	75364
chr9	4669265	4869265	harbor1	chr9	4672038	4672085	DNA/hAT-Charlie	629	-	24	4672062	2797
chr9	4669265	4869265	harbor1	chr9	4672390	4672533	DNA/hAT-Charlie	629	-	72	4672462	3197
chr9	97885114	98085114	harbor1	chr9	97897341	97897539	DNA/hAT-Charlie	846	-	99	97897440	12326
chr9	97885114	98085114	harbor1	chr9	97915301	97915494	DNA/hAT-Charlie	891	-	96	97915397	30283
chr9	133586298	133786298	harbor1	chr9	133604660	133604805	DNA/hAT-Charlie	503	-	72	133604732	18434
chr9	4748106	4948106	harbor1	chr9	4819157	4819322	DNA/hAT-Charlie	978	-	82	4819239	71133
chr9	83553396	83753396	harbor1	chr9	83571892	83572077	DNA/hAT-Charlie	1151	-	92	83571984	18588
chr9	83553396	83753396	harbor1	chr9	83631626	83631775	DNA/hAT-Charlie	779	-	74	83631700	78304
chr9	83553396	83753396	harbor1	chr9	83632459	83632683	DNA/hAT-Charlie	1361	-	112	83632571	79175
chr9	133605246	133805246	harbor1	chr9	133687582	133687738	DNA/hAT-Charlie	511	-	78	133687660	82414
chr9	4884926	5084926	harbor1	chr9	4925049	4925218	DNA/hAT-Charlie	715	-	84	4925133	40207
chr9	4884926	5084926	harbor1	chr9	4927857	4928102	DNA/hAT-Charlie	1204	-	122	4927979	43053
chr9	4884926	5084926	harbor1	chr9	4930956	4931012	DNA/hAT-Charlie	618	-	28	4930984	46058
chr9	4884926	5084926	harbor1	chr9	4931315	4931411	DNA/hAT-Charlie	618	-	48	4931363	46437
chr9	4884926	5084926	harbor1	chr9	4954142	4954453	DNA/hAT-Charlie	1321	-	156	4954298	69372
chr9	4884926	5084926	harbor1	chr9	4955805	4956092	DNA/hAT-Charlie	1056	-	144	4955949	71023
chr9	4884926	5084926	harbor1	chr9	4965239	4965403	DNA/hAT-Charlie	635	-	82	4965321	80395
chr9	4884926	5084926	harbor1	chr9	4968067	4968223	DNA/hAT-Charlie	832	-	78	4968145	83219
chr9	4884926	5084926	harbor1	chr9	4977317	4977504	DNA/hAT-Charlie	1153	-	94	4977411	92485
chr9	4663127	4863127	harbor1	chr9	4672038	4672085	DNA/hAT-Charlie	629	-	24	4672062	8935
chr9	4663127	4863127	harbor1	chr9	4672390	4672533	DNA/hAT-Charlie	629	-	72	4672462	9335
chr9	137734976	137934976	harbor1	chr9	137741377	137741551	DNA/hAT-Charlie	567	-	87	137741464	6488
chr9	137734976	137934976	harbor1	chr9	137763989	137764098	DNA/hAT-Charlie	533	-	54	137764043	29067
chr9	133904999	134104999	harbor1	chr9	133983857	133983971	DNA/hAT-Charlie	524	-	57	133983914	78915
chr9	133904999	134104999	harbor1	chr9	133984274	133984339	DNA/hAT-Charlie	524	-	32	133984306	79307
chr9	133904999	134104999	harbor1	chr9	133984622	133984703	DNA/hAT-Charlie	524	-	40	133984662	79663
chr9	133904999	134104999	harbor1	chr9	134000584	134000902	DNA/hAT-Charlie	1267	-	159	134000743	95744
chr9	94048912	94248912	harbor1	chr9	94064496	94064653	DNA/hAT-Charlie	651	-	78	94064574	15662
chr9	94048912	94248912	harbor1	chr9	94066012	94066213	DNA/hAT-Charlie	522	-	100	94066112	17200
chr9	94048912	94248912	harbor1	chr9	94126018	94126214	DNA/hAT-Charlie	949	-	98	94126116	77204
chr9	68605563	68805563	harbor1	chr9	68628654	68628781	DNA/hAT-Charlie	489	-	64	68628718	23155
chr9	68605563	68805563	harbor1	chr9	68633723	68633772	DNA/hAT-Charlie	689	-	24	68633747	28184
chr9	68605563	68805563	harbor1	chr9	68634036	68634228	DNA/hAT-Charlie	689	-	96	68634132	28569
chr9	68605563	68805563	harbor1	chr9	68648743	68648935	DNA/hAT-Charlie	1184	-	96	68648839	43276
chr9	68605563	68805563	harbor1	chr9	68674972	68675194	DNA/hAT-Charlie	561	-	111	68675083	69520
chr9	68605563	68805563	harbor1	chr9	68685446	68685594	DNA/hAT-Charlie	953	-	74	68685520	79957
chr9	68605563	68805563	harbor1	chr9	68692579	68692768	DNA/hAT-Charlie	796	-	94	68692673	87110
chr9	137214596	137414596	harbor1	chr9	137258772	137258921	DNA/hAT-Charlie	541	-	74	137258846	44250
chr9	137214596	137414596	harbor1	chr9	137259209	137259325	DNA/hAT-Charlie	541	-	58	137259267	44671
chr9	137214600	137414600	harbor1	chr9	137258772	137258921	DNA/hAT-Charlie	541	-	74	137258846	44246
chr9	137214600	137414600	harbor1	chr9	137259209	137259325	DNA/hAT-Charlie	541	-	58	137259267	44667
chr9	4884847	5084847	harbor1	chr9	4925049	4925218	DNA/hAT-Charlie	715	-	84	4925133	40286
chr9	4884847	5084847	harbor1	chr9	4927857	4928102	DNA/hAT-Charlie	1204	-	122	4927979	43132
chr9	4884847	5084847	harbor1	chr9	4930956	4931012	DNA/hAT-Charlie	618	-	28	4930984	46137
chr9	4884847	5084847	harbor1	chr9	4931315	4931411	DNA/hAT-Charlie	618	-	48	4931363	46516
chr9	4884847	5084847	harbor1	chr9	4954142	4954453	DNA/hAT-Charlie	1321	-	156	4954298	69451
chr9	4884847	5084847	harbor1	chr9	4955805	4956092	DNA/hAT-Charlie	1056	-	144	4955949	71102
chr9	4884847	5084847	harbor1	chr9	4965239	4965403	DNA/hAT-Charlie	635	-	82	4965321	80474
chr9	4884847	5084847	harbor1	chr9	4968067	4968223	DNA/hAT-Charlie	832	-	78	4968145	83298
chr9	4884847	5084847	harbor1	chr9	4977317	4977504	DNA/hAT-Charlie	1153	-	94	4977411	92564
chr9	112387221	112587221	harbor1	chr9	112401475	112401628	DNA/hAT-Charlie	815	-	76	112401551	14330
chr9	112387221	112587221	harbor1	chr9	112455911	112456065	DNA/hAT-Charlie	707	-	77	112455988	68767
chr9	4883816	5083816	harbor1	chr9	4925049	4925218	DNA/hAT-Charlie	715	-	84	4925133	41317
chr9	4883816	5083816	harbor1	chr9	4927857	4928102	DNA/hAT-Charlie	1204	-	122	4927979	44163
chr9	4883816	5083816	harbor1	chr9	4930956	4931012	DNA/hAT-Charlie	618	-	28	4930984	47168
chr9	4883816	5083816	harbor1	chr9	4931315	4931411	DNA/hAT-Charlie	618	-	48	4931363	47547
chr9	4883816	5083816	harbor1	chr9	4954142	4954453	DNA/hAT-Charlie	1321	-	156	4954298	70482
chr9	4883816	5083816	harbor1	chr9	4955805	4956092	DNA/hAT-Charlie	1056	-	144	4955949	72133
chr9	4883816	5083816	harbor1	chr9	4965239	4965403	DNA/hAT-Charlie	635	-	82	4965321	81505
chr9	4883816	5083816	harbor1	chr9	4968067	4968223	DNA/hAT-Charlie	832	-	78	4968145	84329
chr9	4883816	5083816	harbor1	chr9	4977317	4977504	DNA/hAT-Charlie	1153	-	94	4977411	93595
chr9	4663649	4863649	harbor1	chr9	4672038	4672085	DNA/hAT-Charlie	629	-	24	4672062	8413
chr9	4663649	4863649	harbor1	chr9	4672390	4672533	DNA/hAT-Charlie	629	-	72	4672462	8813
chr9	35691958	35891958	harbor1	chr9	35692408	35692805	DNA/hAT-Charlie	1441	-	198	35692606	648
chr9	35691958	35891958	harbor1	chr9	35693927	35694020	DNA/hAT-Charlie	2793	-	46	35693973	2015
chr9	35691958	35891958	harbor1	chr9	35694325	35694485	DNA/hAT-Charlie	2793	-	80	35694405	2447
chr9	35691958	35891958	harbor1	chr9	35694809	35695277	DNA/hAT-Charlie	2793	-	234	35695043	3085
chr9	35691958	35891958	harbor1	chr9	35695759	35695865	DNA/hAT-Charlie	589	-	53	35695812	3854
chr9	35691958	35891958	harbor1	chr9	35755463	35755813	DNA/hAT-Charlie	2312	-	175	35755638	63680
chr9	35691958	35891958	harbor1	chr9	35760300	35760471	DNA/hAT-Charlie	813	-	86	35760386	68428
chr9	35691958	35891958	harbor1	chr9	35784910	35785295	DNA/hAT-Charlie	1339	-	192	35785102	93144
chr9	4663080	4863080	harbor1	chr9	4672038	4672085	DNA/hAT-Charlie	629	-	24	4672062	8982
chr9	4663080	4863080	harbor1	chr9	4672390	4672533	DNA/hAT-Charlie	629	-	72	4672462	9382
chr9	125322076	125522076	harbor1	chr9	125333829	125334042	DNA/hAT-Charlie	1144	-	106	125333935	11859
chr9	125322076	125522076	harbor1	chr9	125356286	125356481	DNA/hAT-Charlie	1078	-	98	125356384	34308
chr9	4884823	5084823	harbor1	chr9	4925049	4925218	DNA/hAT-Charlie	715	-	84	4925133	40310
chr9	4884823	5084823	harbor1	chr9	4927857	4928102	DNA/hAT-Charlie	1204	-	122	4927979	43156
chr9	4884823	5084823	harbor1	chr9	4930956	4931012	DNA/hAT-Charlie	618	-	28	4930984	46161
chr9	4884823	5084823	harbor1	chr9	4931315	4931411	DNA/hAT-Charlie	618	-	48	4931363	46540
chr9	4884823	5084823	harbor1	chr9	4954142	4954453	DNA/hAT-Charlie	1321	-	156	4954298	69475
chr9	4884823	5084823	harbor1	chr9	4955805	4956092	DNA/hAT-Charlie	1056	-	144	4955949	71126
chr9	4884823	5084823	harbor1	chr9	4965239	4965403	DNA/hAT-Charlie	635	-	82	4965321	80498
chr9	4884823	5084823	harbor1	chr9	4968067	4968223	DNA/hAT-Charlie	832	-	78	4968145	83322
chr9	4884823	5084823	harbor1	chr9	4977317	4977504	DNA/hAT-Charlie	1153	-	94	4977411	92588
chr9	126245605	126445605	harbor1	chr9	126249988	126250128	DNA/hAT-Charlie	612	-	70	126250058	4453
chr9	126245605	126445605	harbor1	chr9	126267302	126267491	DNA/hAT-Charlie	655	-	94	126267396	21791
chr9	126245605	126445605	harbor1	chr9	126341614	126341850	DNA/hAT-Charlie	1028	-	118	126341732	96127
chr9	68605579	68805579	harbor1	chr9	68628654	68628781	DNA/hAT-Charlie	489	-	64	68628718	23139
chr9	68605579	68805579	harbor1	chr9	68633723	68633772	DNA/hAT-Charlie	689	-	24	68633747	28168
chr9	68605579	68805579	harbor1	chr9	68634036	68634228	DNA/hAT-Charlie	689	-	96	68634132	28553
chr9	68605579	68805579	harbor1	chr9	68648743	68648935	DNA/hAT-Charlie	1184	-	96	68648839	43260
chr9	68605579	68805579	harbor1	chr9	68674972	68675194	DNA/hAT-Charlie	561	-	111	68675083	69504
chr9	68605579	68805579	harbor1	chr9	68685446	68685594	DNA/hAT-Charlie	953	-	74	68685520	79941
chr9	68605579	68805579	harbor1	chr9	68692579	68692768	DNA/hAT-Charlie	796	-	94	68692673	87094
chr9	6658046	6858046	harbor1	chr9	6747232	6747265	DNA/hAT-Charlie	565	-	16	6747248	89202
chr9	6658046	6858046	harbor1	chr9	6747563	6747725	DNA/hAT-Charlie	565	-	81	6747644	89598
chr9	89262840	89462840	harbor1	chr9	89266165	89266306	DNA/hAT-Charlie	736	-	70	89266235	3395
chr9	89262840	89462840	harbor1	chr9	89290217	89290358	DNA/hAT-Charlie	642	-	70	89290287	27447
chr9	89262840	89462840	harbor1	chr9	89291072	89291360	DNA/hAT-Charlie	577	-	144	89291216	28376
chr9	89262840	89462840	harbor1	chr9	89353097	89353263	DNA/hAT-Charlie	672	-	83	89353180	90340
chr9	4883473	5083473	harbor1	chr9	4925049	4925218	DNA/hAT-Charlie	715	-	84	4925133	41660
chr9	4883473	5083473	harbor1	chr9	4927857	4928102	DNA/hAT-Charlie	1204	-	122	4927979	44506
chr9	4883473	5083473	harbor1	chr9	4930956	4931012	DNA/hAT-Charlie	618	-	28	4930984	47511
chr9	4883473	5083473	harbor1	chr9	4931315	4931411	DNA/hAT-Charlie	618	-	48	4931363	47890
chr9	4883473	5083473	harbor1	chr9	4954142	4954453	DNA/hAT-Charlie	1321	-	156	4954298	70825
chr9	4883473	5083473	harbor1	chr9	4955805	4956092	DNA/hAT-Charlie	1056	-	144	4955949	72476
chr9	4883473	5083473	harbor1	chr9	4965239	4965403	DNA/hAT-Charlie	635	-	82	4965321	81848
chr9	4883473	5083473	harbor1	chr9	4968067	4968223	DNA/hAT-Charlie	832	-	78	4968145	84672
chr9	4883473	5083473	harbor1	chr9	4977317	4977504	DNA/hAT-Charlie	1153	-	94	4977411	93938
chr9	35656293	35856293	harbor1	chr9	35692408	35692805	DNA/hAT-Charlie	1441	-	198	35692606	36313
chr9	35656293	35856293	harbor1	chr9	35693927	35694020	DNA/hAT-Charlie	2793	-	46	35693973	37680
chr9	35656293	35856293	harbor1	chr9	35694325	35694485	DNA/hAT-Charlie	2793	-	80	35694405	38112
chr9	35656293	35856293	harbor1	chr9	35694809	35695277	DNA/hAT-Charlie	2793	-	234	35695043	38750
chr9	35656293	35856293	harbor1	chr9	35695759	35695865	DNA/hAT-Charlie	589	-	53	35695812	39519
chr9	35656293	35856293	harbor1	chr9	35755463	35755813	DNA/hAT-Charlie	2312	-	175	35755638	99345
chr9	4669986	4869986	harbor1	chr9	4672038	4672085	DNA/hAT-Charlie	629	-	24	4672062	2076
chr9	4669986	4869986	harbor1	chr9	4672390	4672533	DNA/hAT-Charlie	629	-	72	4672462	2476
chr9	4884959	5084959	harbor1	chr9	4925049	4925218	DNA/hAT-Charlie	715	-	84	4925133	40174
chr9	4884959	5084959	harbor1	chr9	4927857	4928102	DNA/hAT-Charlie	1204	-	122	4927979	43020
chr9	4884959	5084959	harbor1	chr9	4930956	4931012	DNA/hAT-Charlie	618	-	28	4930984	46025
chr9	4884959	5084959	harbor1	chr9	4931315	4931411	DNA/hAT-Charlie	618	-	48	4931363	46404
chr9	4884959	5084959	harbor1	chr9	4954142	4954453	DNA/hAT-Charlie	1321	-	156	4954298	69339
chr9	4884959	5084959	harbor1	chr9	4955805	4956092	DNA/hAT-Charlie	1056	-	144	4955949	70990
chr9	4884959	5084959	harbor1	chr9	4965239	4965403	DNA/hAT-Charlie	635	-	82	4965321	80362
chr9	4884959	5084959	harbor1	chr9	4968067	4968223	DNA/hAT-Charlie	832	-	78	4968145	83186
chr9	4884959	5084959	harbor1	chr9	4977317	4977504	DNA/hAT-Charlie	1153	-	94	4977411	92452
chr9	3426384	3626384	harbor1	chr9	3433791	3433990	DNA/hAT-Charlie	1107	-	100	3433891	7507
chr9	3426384	3626384	harbor1	chr9	3433999	3434156	DNA/hAT-Charlie	562	-	78	3434077	7693
chr9	3426384	3626384	harbor1	chr9	3473973	3474108	DNA/hAT-Charlie	771	-	68	3474041	47657
chr9	3426384	3626384	harbor1	chr9	3494286	3494365	DNA/hAT-Charlie	1120	-	40	3494326	67942
chr9	3426384	3626384	harbor1	chr9	3494576	3494868	DNA/hAT-Charlie	1120	-	146	3494722	68338
chr9	4884897	5084897	harbor1	chr9	4925049	4925218	DNA/hAT-Charlie	715	-	84	4925133	40236
chr9	4884897	5084897	harbor1	chr9	4927857	4928102	DNA/hAT-Charlie	1204	-	122	4927979	43082
chr9	4884897	5084897	harbor1	chr9	4930956	4931012	DNA/hAT-Charlie	618	-	28	4930984	46087
chr9	4884897	5084897	harbor1	chr9	4931315	4931411	DNA/hAT-Charlie	618	-	48	4931363	46466
chr9	4884897	5084897	harbor1	chr9	4954142	4954453	DNA/hAT-Charlie	1321	-	156	4954298	69401
chr9	4884897	5084897	harbor1	chr9	4955805	4956092	DNA/hAT-Charlie	1056	-	144	4955949	71052
chr9	4884897	5084897	harbor1	chr9	4965239	4965403	DNA/hAT-Charlie	635	-	82	4965321	80424
chr9	4884897	5084897	harbor1	chr9	4968067	4968223	DNA/hAT-Charlie	832	-	78	4968145	83248
chr9	4884897	5084897	harbor1	chr9	4977317	4977504	DNA/hAT-Charlie	1153	-	94	4977411	92514
chr9	4884936	5084936	harbor1	chr9	4925049	4925218	DNA/hAT-Charlie	715	-	84	4925133	40197
chr9	4884936	5084936	harbor1	chr9	4927857	4928102	DNA/hAT-Charlie	1204	-	122	4927979	43043
chr9	4884936	5084936	harbor1	chr9	4930956	4931012	DNA/hAT-Charlie	618	-	28	4930984	46048
chr9	4884936	5084936	harbor1	chr9	4931315	4931411	DNA/hAT-Charlie	618	-	48	4931363	46427
chr9	4884936	5084936	harbor1	chr9	4954142	4954453	DNA/hAT-Charlie	1321	-	156	4954298	69362
chr9	4884936	5084936	harbor1	chr9	4955805	4956092	DNA/hAT-Charlie	1056	-	144	4955949	71013
chr9	4884936	5084936	harbor1	chr9	4965239	4965403	DNA/hAT-Charlie	635	-	82	4965321	80385
chr9	4884936	5084936	harbor1	chr9	4968067	4968223	DNA/hAT-Charlie	832	-	78	4968145	83209
chr9	4884936	5084936	harbor1	chr9	4977317	4977504	DNA/hAT-Charlie	1153	-	94	4977411	92475
chr9	134036095	134236095	harbor1	chr9	134071153	134071488	DNA/hAT-Charlie	2229	-	168	134071321	35226
chr9	4722331	4922331	harbor1	chr9	4819157	4819322	DNA/hAT-Charlie	978	-	82	4819239	96908
chr9	4883068	5083068	harbor1	chr9	4925049	4925218	DNA/hAT-Charlie	715	-	84	4925133	42065
chr9	4883068	5083068	harbor1	chr9	4927857	4928102	DNA/hAT-Charlie	1204	-	122	4927979	44911
chr9	4883068	5083068	harbor1	chr9	4930956	4931012	DNA/hAT-Charlie	618	-	28	4930984	47916
chr9	4883068	5083068	harbor1	chr9	4931315	4931411	DNA/hAT-Charlie	618	-	48	4931363	48295
chr9	4883068	5083068	harbor1	chr9	4954142	4954453	DNA/hAT-Charlie	1321	-	156	4954298	71230
chr9	4883068	5083068	harbor1	chr9	4955805	4956092	DNA/hAT-Charlie	1056	-	144	4955949	72881
chr9	4883068	5083068	harbor1	chr9	4965239	4965403	DNA/hAT-Charlie	635	-	82	4965321	82253
chr9	4883068	5083068	harbor1	chr9	4968067	4968223	DNA/hAT-Charlie	832	-	78	4968145	85077
chr9	4883068	5083068	harbor1	chr9	4977317	4977504	DNA/hAT-Charlie	1153	-	94	4977411	94343
chr9	4884790	5084790	harbor1	chr9	4925049	4925218	DNA/hAT-Charlie	715	-	84	4925133	40343
chr9	4884790	5084790	harbor1	chr9	4927857	4928102	DNA/hAT-Charlie	1204	-	122	4927979	43189
chr9	4884790	5084790	harbor1	chr9	4930956	4931012	DNA/hAT-Charlie	618	-	28	4930984	46194
chr9	4884790	5084790	harbor1	chr9	4931315	4931411	DNA/hAT-Charlie	618	-	48	4931363	46573
chr9	4884790	5084790	harbor1	chr9	4954142	4954453	DNA/hAT-Charlie	1321	-	156	4954298	69508
chr9	4884790	5084790	harbor1	chr9	4955805	4956092	DNA/hAT-Charlie	1056	-	144	4955949	71159
chr9	4884790	5084790	harbor1	chr9	4965239	4965403	DNA/hAT-Charlie	635	-	82	4965321	80531
chr9	4884790	5084790	harbor1	chr9	4968067	4968223	DNA/hAT-Charlie	832	-	78	4968145	83355
chr9	4884790	5084790	harbor1	chr9	4977317	4977504	DNA/hAT-Charlie	1153	-	94	4977411	92621
chr9	137214599	137414599	harbor1	chr9	137258772	137258921	DNA/hAT-Charlie	541	-	74	137258846	44247
chr9	137214599	137414599	harbor1	chr9	137259209	137259325	DNA/hAT-Charlie	541	-	58	137259267	44668
chr9	136402517	136602517	harbor1	chr9	136435713	136435964	DNA/hAT-Charlie	673	-	126	136435839	33322
chr9	127963374	128163374	harbor1	chr9	127965234	127965363	DNA/hAT-Charlie	529	-	64	127965298	1924
chr9	127963374	128163374	harbor1	chr9	128060963	128061194	DNA/hAT-Charlie	903	-	116	128061079	97705
chr9	4663076	4863076	harbor1	chr9	4672038	4672085	DNA/hAT-Charlie	629	-	24	4672062	8986
chr9	4663076	4863076	harbor1	chr9	4672390	4672533	DNA/hAT-Charlie	629	-	72	4672462	9386
chr9	97533584	97733584	harbor1	chr9	97561368	97561536	DNA/hAT-Charlie	1001	-	84	97561452	27868
chr9	97533584	97733584	harbor1	chr9	97565241	97565387	DNA/hAT-Charlie	506	-	73	97565314	31730
chr9	97533584	97733584	harbor1	chr9	97590828	97590968	DNA/hAT-Charlie	628	-	70	97590898	57314
chr9	97533584	97733584	harbor1	chr9	97601589	97601728	DNA/hAT-Charlie	749	-	70	97601659	68075
chr9	97533584	97733584	harbor1	chr9	97601962	97601990	DNA/hAT-Charlie	749	-	14	97601976	68392
chr9	97533584	97733584	harbor1	chr9	97603637	97603711	DNA/hAT-Charlie	1828	-	37	97603674	70090
chr9	97533584	97733584	harbor1	chr9	97603991	97604416	DNA/hAT-Charlie	1828	-	212	97604203	70619
chr9	97533584	97733584	harbor1	chr9	97618551	97618743	DNA/hAT-Charlie	587	-	96	97618647	85063
chr9	35692023	35892023	harbor1	chr9	35692408	35692805	DNA/hAT-Charlie	1441	-	198	35692606	583
chr9	35692023	35892023	harbor1	chr9	35693927	35694020	DNA/hAT-Charlie	2793	-	46	35693973	1950
chr9	35692023	35892023	harbor1	chr9	35694325	35694485	DNA/hAT-Charlie	2793	-	80	35694405	2382
chr9	35692023	35892023	harbor1	chr9	35694809	35695277	DNA/hAT-Charlie	2793	-	234	35695043	3020
chr9	35692023	35892023	harbor1	chr9	35695759	35695865	DNA/hAT-Charlie	589	-	53	35695812	3789
chr9	35692023	35892023	harbor1	chr9	35755463	35755813	DNA/hAT-Charlie	2312	-	175	35755638	63615
chr9	35692023	35892023	harbor1	chr9	35760300	35760471	DNA/hAT-Charlie	813	-	86	35760386	68363
chr9	35692023	35892023	harbor1	chr9	35784910	35785295	DNA/hAT-Charlie	1339	-	192	35785102	93079
chr9	4663656	4863656	harbor1	chr9	4672038	4672085	DNA/hAT-Charlie	629	-	24	4672062	8406
chr9	4663656	4863656	harbor1	chr9	4672390	4672533	DNA/hAT-Charlie	629	-	72	4672462	8806
chr9	19130894	19330894	harbor1	chr9	19218878	19219048	DNA/hAT-Charlie	719	-	85	19218963	88069
chr9	137214587	137414587	harbor1	chr9	137258772	137258921	DNA/hAT-Charlie	541	-	74	137258846	44259
chr9	137214587	137414587	harbor1	chr9	137259209	137259325	DNA/hAT-Charlie	541	-	58	137259267	44680
chr9	418608	618608	harbor1	chr9	455153	455212	DNA/hAT-Charlie	800	-	30	455183	36575
chr9	418608	618608	harbor1	chr9	455529	455633	DNA/hAT-Charlie	800	-	52	455581	36973
chr9	418608	618608	harbor1	chr9	466155	466231	DNA/hAT-Charlie	1329	-	38	466193	47585
chr9	418608	618608	harbor1	chr9	466524	466767	DNA/hAT-Charlie	1329	-	122	466646	48038
chr9	114075621	114275621	harbor1	chr9	114117940	114118095	DNA/hAT-Charlie	664	-	78	114118018	42397
chr9	35692027	35892027	harbor1	chr9	35692408	35692805	DNA/hAT-Charlie	1441	-	198	35692606	579
chr9	35692027	35892027	harbor1	chr9	35693927	35694020	DNA/hAT-Charlie	2793	-	46	35693973	1946
chr9	35692027	35892027	harbor1	chr9	35694325	35694485	DNA/hAT-Charlie	2793	-	80	35694405	2378
chr9	35692027	35892027	harbor1	chr9	35694809	35695277	DNA/hAT-Charlie	2793	-	234	35695043	3016
chr9	35692027	35892027	harbor1	chr9	35695759	35695865	DNA/hAT-Charlie	589	-	53	35695812	3785
chr9	35692027	35892027	harbor1	chr9	35755463	35755813	DNA/hAT-Charlie	2312	-	175	35755638	63611
chr9	35692027	35892027	harbor1	chr9	35760300	35760471	DNA/hAT-Charlie	813	-	86	35760386	68359
chr9	35692027	35892027	harbor1	chr9	35784910	35785295	DNA/hAT-Charlie	1339	-	192	35785102	93075
chr9	35654956	35854956	harbor1	chr9	35655104	35655361	DNA/hAT-Charlie	1690	-	128	35655232	276
chr9	35654956	35854956	harbor1	chr9	35692408	35692805	DNA/hAT-Charlie	1441	-	198	35692606	37650
chr9	35654956	35854956	harbor1	chr9	35693927	35694020	DNA/hAT-Charlie	2793	-	46	35693973	39017
chr9	35654956	35854956	harbor1	chr9	35694325	35694485	DNA/hAT-Charlie	2793	-	80	35694405	39449
chr9	35654956	35854956	harbor1	chr9	35694809	35695277	DNA/hAT-Charlie	2793	-	234	35695043	40087
chr9	35654956	35854956	harbor1	chr9	35695759	35695865	DNA/hAT-Charlie	589	-	53	35695812	40856
chr9	4830107	5030107	harbor1	chr9	4925049	4925218	DNA/hAT-Charlie	715	-	84	4925133	95026
chr9	4830107	5030107	harbor1	chr9	4927857	4928102	DNA/hAT-Charlie	1204	-	122	4927979	97872
chr9	79473211	79673211	harbor1	chr9	79492479	79492792	DNA/hAT-Charlie	1675	-	156	79492635	19424
chr9	79473211	79673211	harbor1	chr9	79527969	79528130	DNA/hAT-Charlie	682	-	80	79528049	54838
chr9	79473211	79673211	harbor1	chr9	79536861	79537022	DNA/hAT-Charlie	892	-	80	79536941	63730
chr9	79473211	79673211	harbor1	chr9	79543914	79544092	DNA/hAT-Charlie	930	-	89	79544003	70792
chr9	137214594	137414594	harbor1	chr9	137258772	137258921	DNA/hAT-Charlie	541	-	74	137258846	44252
chr9	137214594	137414594	harbor1	chr9	137259209	137259325	DNA/hAT-Charlie	541	-	58	137259267	44673
chr9	4669933	4869933	harbor1	chr9	4672038	4672085	DNA/hAT-Charlie	629	-	24	4672062	2129
chr9	4669933	4869933	harbor1	chr9	4672390	4672533	DNA/hAT-Charlie	629	-	72	4672462	2529
chr9	137214592	137414592	harbor1	chr9	137258772	137258921	DNA/hAT-Charlie	541	-	74	137258846	44254
chr9	137214592	137414592	harbor1	chr9	137259209	137259325	DNA/hAT-Charlie	541	-	58	137259267	44675
chr9	124761747	124961747	harbor1	chr9	124762155	124763500	DNA/hAT-Charlie	6333	-	672	124762827	1080
chr9	124761747	124961747	harbor1	chr9	124775331	124775455	DNA/hAT-Charlie	678	-	62	124775393	13646
chr9	124761747	124961747	harbor1	chr9	124791335	124791454	DNA/hAT-Charlie	1118	-	60	124791395	29648
chr9	124761747	124961747	harbor1	chr9	124791768	124791959	DNA/hAT-Charlie	1118	-	96	124791864	30117
chr9	4751750	4951750	harbor1	chr9	4819157	4819322	DNA/hAT-Charlie	978	-	82	4819239	67489
chr9	137179535	137379535	harbor1	chr9	137202744	137202785	DNA/hAT-Charlie	525	-	20	137202764	23229
chr9	137179535	137379535	harbor1	chr9	137203087	137203108	DNA/hAT-Charlie	525	-	10	137203097	23562
chr9	137179535	137379535	harbor1	chr9	137203300	137203344	DNA/hAT-Charlie	525	-	22	137203322	23787
chr9	137179535	137379535	harbor1	chr9	137203654	137203730	DNA/hAT-Charlie	525	-	38	137203692	24157
chr9	137179535	137379535	harbor1	chr9	137258772	137258921	DNA/hAT-Charlie	541	-	74	137258846	79311
chr9	137179535	137379535	harbor1	chr9	137259209	137259325	DNA/hAT-Charlie	541	-	58	137259267	79732
chr9	137214601	137414601	harbor1	chr9	137258772	137258921	DNA/hAT-Charlie	541	-	74	137258846	44245
chr9	137214601	137414601	harbor1	chr9	137259209	137259325	DNA/hAT-Charlie	541	-	58	137259267	44666
chr9	126427098	126627098	harbor1	chr9	126495399	126495840	DNA/hAT-Charlie	586	-	220	126495619	68521
chr9	76918823	77118823	harbor1	chr9	76926364	76926699	DNA/hAT-Charlie	1212	-	168	76926532	7709
chr9	4663097	4863097	harbor1	chr9	4672038	4672085	DNA/hAT-Charlie	629	-	24	4672062	8965
chr9	4663097	4863097	harbor1	chr9	4672390	4672533	DNA/hAT-Charlie	629	-	72	4672462	9365
chr9	68605569	68805569	harbor1	chr9	68628654	68628781	DNA/hAT-Charlie	489	-	64	68628718	23149
chr9	68605569	68805569	harbor1	chr9	68633723	68633772	DNA/hAT-Charlie	689	-	24	68633747	28178
chr9	68605569	68805569	harbor1	chr9	68634036	68634228	DNA/hAT-Charlie	689	-	96	68634132	28563
chr9	68605569	68805569	harbor1	chr9	68648743	68648935	DNA/hAT-Charlie	1184	-	96	68648839	43270
chr9	68605569	68805569	harbor1	chr9	68674972	68675194	DNA/hAT-Charlie	561	-	111	68675083	69514
chr9	68605569	68805569	harbor1	chr9	68685446	68685594	DNA/hAT-Charlie	953	-	74	68685520	79951
chr9	68605569	68805569	harbor1	chr9	68692579	68692768	DNA/hAT-Charlie	796	-	94	68692673	87104
chr9	97885166	98085166	harbor1	chr9	97897341	97897539	DNA/hAT-Charlie	846	-	99	97897440	12274
chr9	97885166	98085166	harbor1	chr9	97915301	97915494	DNA/hAT-Charlie	891	-	96	97915397	30231
chr9	111561650	111761650	harbor1	chr9	111571805	111571876	DNA/hAT-Charlie	512	-	36	111571841	10191
chr9	111561650	111761650	harbor1	chr9	111578198	111578742	DNA/hAT-Charlie	3313	-	272	111578470	16820
chr9	4668976	4868976	harbor1	chr9	4672038	4672085	DNA/hAT-Charlie	629	-	24	4672062	3086
chr9	4668976	4868976	harbor1	chr9	4672390	4672533	DNA/hAT-Charlie	629	-	72	4672462	3486
chr9	4885042	5085042	harbor1	chr9	4925049	4925218	DNA/hAT-Charlie	715	-	84	4925133	40091
chr9	4885042	5085042	harbor1	chr9	4927857	4928102	DNA/hAT-Charlie	1204	-	122	4927979	42937
chr9	4885042	5085042	harbor1	chr9	4930956	4931012	DNA/hAT-Charlie	618	-	28	4930984	45942
chr9	4885042	5085042	harbor1	chr9	4931315	4931411	DNA/hAT-Charlie	618	-	48	4931363	46321
chr9	4885042	5085042	harbor1	chr9	4954142	4954453	DNA/hAT-Charlie	1321	-	156	4954298	69256
chr9	4885042	5085042	harbor1	chr9	4955805	4956092	DNA/hAT-Charlie	1056	-	144	4955949	70907
chr9	4885042	5085042	harbor1	chr9	4965239	4965403	DNA/hAT-Charlie	635	-	82	4965321	80279
chr9	4885042	5085042	harbor1	chr9	4968067	4968223	DNA/hAT-Charlie	832	-	78	4968145	83103
chr9	4885042	5085042	harbor1	chr9	4977317	4977504	DNA/hAT-Charlie	1153	-	94	4977411	92369
chr9	4883803	5083803	harbor1	chr9	4925049	4925218	DNA/hAT-Charlie	715	-	84	4925133	41330
chr9	4883803	5083803	harbor1	chr9	4927857	4928102	DNA/hAT-Charlie	1204	-	122	4927979	44176
chr9	4883803	5083803	harbor1	chr9	4930956	4931012	DNA/hAT-Charlie	618	-	28	4930984	47181
chr9	4883803	5083803	harbor1	chr9	4931315	4931411	DNA/hAT-Charlie	618	-	48	4931363	47560
chr9	4883803	5083803	harbor1	chr9	4954142	4954453	DNA/hAT-Charlie	1321	-	156	4954298	70495
chr9	4883803	5083803	harbor1	chr9	4955805	4956092	DNA/hAT-Charlie	1056	-	144	4955949	72146
chr9	4883803	5083803	harbor1	chr9	4965239	4965403	DNA/hAT-Charlie	635	-	82	4965321	81518
chr9	4883803	5083803	harbor1	chr9	4968067	4968223	DNA/hAT-Charlie	832	-	78	4968145	84342
chr9	4883803	5083803	harbor1	chr9	4977317	4977504	DNA/hAT-Charlie	1153	-	94	4977411	93608
chr9	4662994	4862994	harbor1	chr9	4672038	4672085	DNA/hAT-Charlie	629	-	24	4672062	9068
chr9	4662994	4862994	harbor1	chr9	4672390	4672533	DNA/hAT-Charlie	629	-	72	4672462	9468
chr9	104717537	104917537	harbor1	chr9	104815738	104815843	DNA/hAT-Charlie	527	-	52	104815790	98253
chr9	111383307	111583307	harbor1	chr9	111412385	111412682	DNA/hAT-Charlie	1305	-	148	111412533	29226
chr9	111383307	111583307	harbor1	chr9	111428241	111429206	DNA/hAT-Charlie	3284	-	482	111428723	45416
chr9	111383307	111583307	harbor1	chr9	111429210	111429486	DNA/hAT-Charlie	877	-	138	111429348	46041
chr9	111383307	111583307	harbor1	chr9	111394679	111394879	DNA/hAT-Charlie	813	-	100	111394779	11472
chr9	112387266	112587266	harbor1	chr9	112401475	112401628	DNA/hAT-Charlie	815	-	76	112401551	14285
chr9	112387266	112587266	harbor1	chr9	112455911	112456065	DNA/hAT-Charlie	707	-	77	112455988	68722
chr9	2521362	2721362	harbor1	chr9	2547751	2547981	DNA/hAT-Charlie	946	-	115	2547866	26504
chr9	2521362	2721362	harbor1	chr9	2566549	2566761	DNA/hAT-Charlie	1110	-	106	2566655	45293
chr9	2521362	2721362	harbor1	chr9	2614209	2614362	DNA/hAT-Charlie	533	-	76	2614285	92923
chr9	2521362	2721362	harbor1	chr9	2615866	2616085	DNA/hAT-Charlie	852	-	110	2615976	94614
chr9	4884820	5084820	harbor1	chr9	4925049	4925218	DNA/hAT-Charlie	715	-	84	4925133	40313
chr9	4884820	5084820	harbor1	chr9	4927857	4928102	DNA/hAT-Charlie	1204	-	122	4927979	43159
chr9	4884820	5084820	harbor1	chr9	4930956	4931012	DNA/hAT-Charlie	618	-	28	4930984	46164
chr9	4884820	5084820	harbor1	chr9	4931315	4931411	DNA/hAT-Charlie	618	-	48	4931363	46543
chr9	4884820	5084820	harbor1	chr9	4954142	4954453	DNA/hAT-Charlie	1321	-	156	4954298	69478
chr9	4884820	5084820	harbor1	chr9	4955805	4956092	DNA/hAT-Charlie	1056	-	144	4955949	71129
chr9	4884820	5084820	harbor1	chr9	4965239	4965403	DNA/hAT-Charlie	635	-	82	4965321	80501
chr9	4884820	5084820	harbor1	chr9	4968067	4968223	DNA/hAT-Charlie	832	-	78	4968145	83325
chr9	4884820	5084820	harbor1	chr9	4977317	4977504	DNA/hAT-Charlie	1153	-	94	4977411	92591
chr9	112387344	112587344	harbor1	chr9	112401475	112401628	DNA/hAT-Charlie	815	-	76	112401551	14207
chr9	112387344	112587344	harbor1	chr9	112455911	112456065	DNA/hAT-Charlie	707	-	77	112455988	68644
chr9	4658000	4858000	harbor1	chr9	4672038	4672085	DNA/hAT-Charlie	629	-	24	4672062	14062
chr9	4658000	4858000	harbor1	chr9	4672390	4672533	DNA/hAT-Charlie	629	-	72	4672462	14462
chr9	6658192	6858192	harbor1	chr9	6747232	6747265	DNA/hAT-Charlie	565	-	16	6747248	89056
chr9	6658192	6858192	harbor1	chr9	6747563	6747725	DNA/hAT-Charlie	565	-	81	6747644	89452
chr9	4883030	5083030	harbor1	chr9	4925049	4925218	DNA/hAT-Charlie	715	-	84	4925133	42103
chr9	4883030	5083030	harbor1	chr9	4927857	4928102	DNA/hAT-Charlie	1204	-	122	4927979	44949
chr9	4883030	5083030	harbor1	chr9	4930956	4931012	DNA/hAT-Charlie	618	-	28	4930984	47954
chr9	4883030	5083030	harbor1	chr9	4931315	4931411	DNA/hAT-Charlie	618	-	48	4931363	48333
chr9	4883030	5083030	harbor1	chr9	4954142	4954453	DNA/hAT-Charlie	1321	-	156	4954298	71268
chr9	4883030	5083030	harbor1	chr9	4955805	4956092	DNA/hAT-Charlie	1056	-	144	4955949	72919
chr9	4883030	5083030	harbor1	chr9	4965239	4965403	DNA/hAT-Charlie	635	-	82	4965321	82291
chr9	4883030	5083030	harbor1	chr9	4968067	4968223	DNA/hAT-Charlie	832	-	78	4968145	85115
chr9	4883030	5083030	harbor1	chr9	4977317	4977504	DNA/hAT-Charlie	1153	-	94	4977411	94381
chr9	1	129273	harbor1	chr9	67132	67336	DNA/hAT-Charlie	1103	-	102	67234	67233
chr9	1	129273	harbor1	chr9	77696	77888	DNA/hAT-Charlie	595	-	96	77792	77791
chr9	1	129273	harbor1	chr9	91100	91377	DNA/hAT-Charlie	596	-	138	91238	91237
chr9	1	129273	harbor1	chr9	91696	91837	DNA/hAT-Charlie	617	-	70	91766	91765
chr9	1	129273	harbor1	chr9	92192	92371	DNA/hAT-Charlie	852	-	90	92282	92281
chr9	1	129273	harbor1	chr9	98943	99103	DNA/hAT-Charlie	1009	-	80	99023	99022
chr9	1	129273	harbor1	chr9	99374	99454	DNA/hAT-Charlie	1009	-	40	99414	99413
chr9	4663850	4863850	harbor1	chr9	4672038	4672085	DNA/hAT-Charlie	629	-	24	4672062	8212
chr9	4663850	4863850	harbor1	chr9	4672390	4672533	DNA/hAT-Charlie	629	-	72	4672462	8612
chr9	4669263	4869263	harbor1	chr9	4672038	4672085	DNA/hAT-Charlie	629	-	24	4672062	2799
chr9	4669263	4869263	harbor1	chr9	4672390	4672533	DNA/hAT-Charlie	629	-	72	4672462	3199
chr9	4597199	4797199	harbor1	chr9	4644907	4645159	DNA/hAT-Charlie	1000	-	126	4645033	47834
chr9	4597199	4797199	harbor1	chr9	4672038	4672085	DNA/hAT-Charlie	629	-	24	4672062	74863
chr9	4597199	4797199	harbor1	chr9	4672390	4672533	DNA/hAT-Charlie	629	-	72	4672462	75263
chr9	133968504	134168504	harbor1	chr9	133983857	133983971	DNA/hAT-Charlie	524	-	57	133983914	15410
chr9	133968504	134168504	harbor1	chr9	133984274	133984339	DNA/hAT-Charlie	524	-	32	133984306	15802
chr9	133968504	134168504	harbor1	chr9	133984622	133984703	DNA/hAT-Charlie	524	-	40	133984662	16158
chr9	133968504	134168504	harbor1	chr9	134000584	134000902	DNA/hAT-Charlie	1267	-	159	134000743	32239
chr9	35654325	35854325	harbor1	chr9	35654667	35654792	DNA/hAT-Charlie	1690	-	62	35654729	404
chr9	35654325	35854325	harbor1	chr9	35655104	35655361	DNA/hAT-Charlie	1690	-	128	35655232	907
chr9	35654325	35854325	harbor1	chr9	35692408	35692805	DNA/hAT-Charlie	1441	-	198	35692606	38281
chr9	35654325	35854325	harbor1	chr9	35693927	35694020	DNA/hAT-Charlie	2793	-	46	35693973	39648
chr9	35654325	35854325	harbor1	chr9	35694325	35694485	DNA/hAT-Charlie	2793	-	80	35694405	40080
chr9	35654325	35854325	harbor1	chr9	35694809	35695277	DNA/hAT-Charlie	2793	-	234	35695043	40718
chr9	35654325	35854325	harbor1	chr9	35695759	35695865	DNA/hAT-Charlie	589	-	53	35695812	41487
chr9	127963377	128163377	harbor1	chr9	127965234	127965363	DNA/hAT-Charlie	529	-	64	127965298	1921
chr9	127963377	128163377	harbor1	chr9	128060963	128061194	DNA/hAT-Charlie	903	-	116	128061079	97702
chr9	113807755	114007755	harbor1	chr9	113811686	113811902	DNA/hAT-Charlie	544	-	108	113811794	4039
chr9	113807755	114007755	harbor1	chr9	113812077	113812380	DNA/hAT-Charlie	1333	-	152	113812229	4474
chr9	113807755	114007755	harbor1	chr9	113839552	113840045	DNA/hAT-Charlie	2464	-	246	113839798	32043
chr9	113807755	114007755	harbor1	chr9	113855057	113855584	DNA/hAT-Charlie	2043	-	264	113855321	47566
chr9	113807755	114007755	harbor1	chr9	113855751	113855909	DNA/hAT-Charlie	517	-	79	113855830	48075
chr9	113807755	114007755	harbor1	chr9	113881332	113881657	DNA/hAT-Charlie	1444	-	162	113881494	73739
chr9	113807755	114007755	harbor1	chr9	113884516	113884700	DNA/hAT-Charlie	613	-	92	113884608	76853
chr9	4777664	4977664	harbor1	chr9	4819157	4819322	DNA/hAT-Charlie	978	-	82	4819239	41575
chr9	97885101	98085101	harbor1	chr9	97897341	97897539	DNA/hAT-Charlie	846	-	99	97897440	12339
chr9	97885101	98085101	harbor1	chr9	97915301	97915494	DNA/hAT-Charlie	891	-	96	97915397	30296
chr9	133934915	134134915	harbor1	chr9	133983857	133983971	DNA/hAT-Charlie	524	-	57	133983914	48999
chr9	133934915	134134915	harbor1	chr9	133984274	133984339	DNA/hAT-Charlie	524	-	32	133984306	49391
chr9	133934915	134134915	harbor1	chr9	133984622	133984703	DNA/hAT-Charlie	524	-	40	133984662	49747
chr9	133934915	134134915	harbor1	chr9	134000584	134000902	DNA/hAT-Charlie	1267	-	159	134000743	65828
chr9	83717816	83917816	harbor1	chr9	83724546	83724817	DNA/hAT-Charlie	1260	-	136	83724682	6866
chr9	83717816	83917816	harbor1	chr9	83767281	83767363	DNA/hAT-Charlie	603	-	41	83767322	49506
chr9	83717816	83917816	harbor1	chr9	83767663	83767701	DNA/hAT-Charlie	603	-	19	83767682	49866
chr9	83717816	83917816	harbor1	chr9	83767986	83768094	DNA/hAT-Charlie	603	-	54	83768040	50224
chr9	4884858	5084858	harbor1	chr9	4925049	4925218	DNA/hAT-Charlie	715	-	84	4925133	40275
chr9	4884858	5084858	harbor1	chr9	4927857	4928102	DNA/hAT-Charlie	1204	-	122	4927979	43121
chr9	4884858	5084858	harbor1	chr9	4930956	4931012	DNA/hAT-Charlie	618	-	28	4930984	46126
chr9	4884858	5084858	harbor1	chr9	4931315	4931411	DNA/hAT-Charlie	618	-	48	4931363	46505
chr9	4884858	5084858	harbor1	chr9	4954142	4954453	DNA/hAT-Charlie	1321	-	156	4954298	69440
chr9	4884858	5084858	harbor1	chr9	4955805	4956092	DNA/hAT-Charlie	1056	-	144	4955949	71091
chr9	4884858	5084858	harbor1	chr9	4965239	4965403	DNA/hAT-Charlie	635	-	82	4965321	80463
chr9	4884858	5084858	harbor1	chr9	4968067	4968223	DNA/hAT-Charlie	832	-	78	4968145	83287
chr9	4884858	5084858	harbor1	chr9	4977317	4977504	DNA/hAT-Charlie	1153	-	94	4977411	92553
chr10	70441215	70641215	harbor1	chr10	70491316	70491484	DNA/hAT-Charlie	436	-	84	70491400	50185
chr10	70441215	70641215	harbor1	chr10	70504125	70504244	DNA/hAT-Charlie	4931	-	60	70504185	62970
chr10	70441215	70641215	harbor1	chr10	70504543	70505313	DNA/hAT-Charlie	4931	-	385	70504928	63713
chr10	70441215	70641215	harbor1	chr10	70505656	70505738	DNA/hAT-Charlie	4931	-	41	70505697	64482
chr10	70441215	70641215	harbor1	chr10	70506033	70506458	DNA/hAT-Charlie	4931	-	212	70506245	65030
chr10	70441215	70641215	harbor1	chr10	70516089	70516131	DNA/hAT-Charlie	950	-	21	70516110	74895
chr10	70441215	70641215	harbor1	chr10	70516420	70516547	DNA/hAT-Charlie	950	-	64	70516484	75269
chr10	70441215	70641215	harbor1	chr10	70516856	70516989	DNA/hAT-Charlie	950	-	66	70516922	75707
chr10	70441215	70641215	harbor1	chr10	70521831	70522072	DNA/hAT-Charlie	461	-	120	70521951	80736
chr10	102140008	102340008	harbor1	chr10	102168432	102168614	DNA/hAT-Charlie	1035	-	91	102168523	28515
chr10	102140008	102340008	harbor1	chr10	102237634	102237911	DNA/hAT-Charlie	612	-	138	102237772	97764
chr10	131310777	131510777	harbor1	chr10	131372392	131372601	DNA/hAT-Charlie	540	-	104	131372496	61719
chr10	131310777	131510777	harbor1	chr10	131373737	131373899	DNA/hAT-Charlie	441	-	81	131373818	63041
chr10	78865729	79065729	harbor1	chr10	78891780	78891956	DNA/hAT-Charlie	970	-	88	78891868	26139
chr10	78865729	79065729	harbor1	chr10	78912981	78913155	DNA/hAT-Charlie	609	-	87	78913068	47339
chr10	78865729	79065729	harbor1	chr10	78924518	78924727	DNA/hAT-Charlie	1296	-	104	78924622	58893
chr10	97399009	97599009	harbor1	chr10	97464487	97464639	DNA/hAT-Charlie	695	-	76	97464563	65554
chr10	97399009	97599009	harbor1	chr10	97478663	97478821	DNA/hAT-Charlie	732	-	79	97478742	79733
chr10	560140	760140	harbor1	chr10	581873	582212	DNA/hAT-Charlie	1404	-	170	582043	21903
chr10	97398813	97598813	harbor1	chr10	97464487	97464639	DNA/hAT-Charlie	695	-	76	97464563	65750
chr10	97398813	97598813	harbor1	chr10	97478663	97478821	DNA/hAT-Charlie	732	-	79	97478742	79929
chr10	49511878	49711878	harbor1	chr10	49525255	49525445	DNA/hAT-Charlie	975	-	95	49525350	13472
chr10	49511878	49711878	harbor1	chr10	49580978	49581161	DNA/hAT-Charlie	733	-	92	49581070	69192
chr10	49511878	49711878	harbor1	chr10	49595989	49596188	DNA/hAT-Charlie	476	-	100	49596089	84211
chr10	102141807	102341807	harbor1	chr10	102168432	102168614	DNA/hAT-Charlie	1035	-	91	102168523	26716
chr10	102141807	102341807	harbor1	chr10	102237634	102237911	DNA/hAT-Charlie	612	-	138	102237772	95965
chr10	14778677	14978677	harbor1	chr10	14835773	14836099	DNA/hAT-Charlie	729	-	163	14835936	57259
chr10	14778677	14978677	harbor1	chr10	14854789	14854924	DNA/hAT-Charlie	752	-	68	14854857	76180
chr10	14778677	14978677	harbor1	chr10	14875493	14875724	DNA/hAT-Charlie	1351	-	116	14875609	96932
chr10	14778677	14978677	harbor1	chr10	14875982	14876226	DNA/hAT-Charlie	1351	-	122	14876104	97427
chr10	14778677	14978677	harbor1	chr10	14811091	14811272	DNA/hAT-Charlie	578	-	90	14811181	32504
chr10	7566933	7766933	harbor1	chr10	7612251	7612450	DNA/hAT-Charlie	939	-	100	7612351	45418
chr10	7566933	7766933	harbor1	chr10	7631124	7631293	DNA/hAT-Charlie	543	-	84	7631208	64275
chr10	37911041	38111041	harbor1	chr10	37950141	37950449	DNA/hAT-Charlie	1208	-	154	37950295	39254
chr10	37911041	38111041	harbor1	chr10	37971353	37971537	DNA/hAT-Charlie	640	-	92	37971445	60404
chr10	37911041	38111041	harbor1	chr10	37991519	37991717	DNA/hAT-Charlie	1518	-	99	37991618	80577
chr10	69458832	69658832	harbor1	chr10	69477500	69477675	DNA/hAT-Charlie	562	-	88	69477588	18756
chr10	69458832	69658832	harbor1	chr10	69478597	69479051	DNA/hAT-Charlie	1844	-	227	69478824	19992
chr10	69458832	69658832	harbor1	chr10	69505094	69505576	DNA/hAT-Charlie	1594	-	241	69505335	46503
chr10	69458832	69658832	harbor1	chr10	69527196	69527313	DNA/hAT-Charlie	1253	-	58	69527254	68422
chr10	69458832	69658832	harbor1	chr10	69527609	69527697	DNA/hAT-Charlie	1253	-	44	69527653	68821
chr10	13709746	13909746	harbor1	chr10	13726513	13726636	DNA/hAT-Charlie	644	-	62	13726575	16829
chr10	13709746	13909746	harbor1	chr10	13727202	13727274	DNA/hAT-Charlie	644	-	36	13727238	17492
chr10	13709746	13909746	harbor1	chr10	13763385	13763536	DNA/hAT-Charlie	797	-	76	13763461	53715
chr10	133103372	133303372	harbor1	chr10	133170517	133170950	DNA/hAT-Charlie	1313	-	216	133170733	67361
chr10	92188891	92388891	harbor1	chr10	92267181	92267356	DNA/hAT-Charlie	722	-	88	92267269	78378
chr10	92188891	92388891	harbor1	chr10	92275148	92275321	DNA/hAT-Charlie	994	-	86	92275234	86343
chr10	92188891	92388891	harbor1	chr10	92281539	92282014	DNA/hAT-Charlie	1746	-	238	92281777	92886
chr10	100897233	101097233	harbor1	chr10	100960898	100960998	DNA/hAT-Charlie	706	-	50	100960948	63715
chr10	100897233	101097233	harbor1	chr10	100961309	100961386	DNA/hAT-Charlie	706	-	38	100961347	64114
chr10	100897233	101097233	harbor1	chr10	100975200	100975348	DNA/hAT-Charlie	790	-	74	100975274	78041
chr10	100897233	101097233	harbor1	chr10	100925156	100925467	DNA/hAT-Charlie	666	-	156	100925312	28079
chr10	100086018	100286018	harbor1	chr10	100162571	100162883	DNA/hAT-Charlie	1043	-	156	100162727	76709
chr10	100086018	100286018	harbor1	chr10	100173326	100173530	DNA/hAT-Charlie	580	-	102	100173428	87410
chr10	97398947	97598947	harbor1	chr10	97464487	97464639	DNA/hAT-Charlie	695	-	76	97464563	65616
chr10	97398947	97598947	harbor1	chr10	97478663	97478821	DNA/hAT-Charlie	732	-	79	97478742	79795
chr10	14778710	14978710	harbor1	chr10	14835773	14836099	DNA/hAT-Charlie	729	-	163	14835936	57226
chr10	14778710	14978710	harbor1	chr10	14854789	14854924	DNA/hAT-Charlie	752	-	68	14854857	76147
chr10	14778710	14978710	harbor1	chr10	14875493	14875724	DNA/hAT-Charlie	1351	-	116	14875609	96899
chr10	14778710	14978710	harbor1	chr10	14875982	14876226	DNA/hAT-Charlie	1351	-	122	14876104	97394
chr10	14778710	14978710	harbor1	chr10	14811091	14811272	DNA/hAT-Charlie	578	-	90	14811181	32471
chr10	113669309	113869309	harbor1	chr10	113696779	113696925	DNA/hAT-Charlie	734	-	73	113696852	27543
chr10	113669309	113869309	harbor1	chr10	113699437	113700611	DNA/hAT-Charlie	1728	-	587	113700024	30715
chr10	113669309	113869309	harbor1	chr10	113704281	113704644	DNA/hAT-Charlie	960	-	182	113704463	35154
chr10	75111057	75311057	harbor1	chr10	75131860	75132034	DNA/hAT-Charlie	518	-	87	75131947	20890
chr10	75111057	75311057	harbor1	chr10	75145614	75145801	DNA/hAT-Charlie	771	-	94	75145708	34651
chr10	75111057	75311057	harbor1	chr10	75168236	75168394	DNA/hAT-Charlie	789	-	79	75168315	57258
chr10	75111057	75311057	harbor1	chr10	75188145	75188259	DNA/hAT-Charlie	441	-	57	75188202	77145
chr10	14673058	14873058	harbor1	chr10	14726760	14727285	DNA/hAT-Charlie	3953	-	262	14727022	53964
chr10	14673058	14873058	harbor1	chr10	14729595	14729653	DNA/hAT-Charlie	573	-	29	14729624	56566
chr10	14673058	14873058	harbor1	chr10	14730209	14730337	DNA/hAT-Charlie	573	-	64	14730273	57215
chr10	14778691	14978691	harbor1	chr10	14835773	14836099	DNA/hAT-Charlie	729	-	163	14835936	57245
chr10	14778691	14978691	harbor1	chr10	14854789	14854924	DNA/hAT-Charlie	752	-	68	14854857	76166
chr10	14778691	14978691	harbor1	chr10	14875493	14875724	DNA/hAT-Charlie	1351	-	116	14875609	96918
chr10	14778691	14978691	harbor1	chr10	14875982	14876226	DNA/hAT-Charlie	1351	-	122	14876104	97413
chr10	14778691	14978691	harbor1	chr10	14811091	14811272	DNA/hAT-Charlie	578	-	90	14811181	32490
chr10	102140695	102340695	harbor1	chr10	102168432	102168614	DNA/hAT-Charlie	1035	-	91	102168523	27828
chr10	102140695	102340695	harbor1	chr10	102237634	102237911	DNA/hAT-Charlie	612	-	138	102237772	97077
chr10	102141695	102341695	harbor1	chr10	102168432	102168614	DNA/hAT-Charlie	1035	-	91	102168523	26828
chr10	102141695	102341695	harbor1	chr10	102237634	102237911	DNA/hAT-Charlie	612	-	138	102237772	96077
chr10	100611262	100811262	harbor1	chr10	100667151	100667374	DNA/hAT-Charlie	1031	-	112	100667263	56001
chr10	6020235	6220235	harbor1	chr10	6080516	6080802	DNA/hAT-Charlie	1267	-	143	6080659	60424
chr10	102141682	102341682	harbor1	chr10	102168432	102168614	DNA/hAT-Charlie	1035	-	91	102168523	26841
chr10	102141682	102341682	harbor1	chr10	102237634	102237911	DNA/hAT-Charlie	612	-	138	102237772	96090
chr10	3072743	3272743	harbor1	chr10	3164433	3164467	DNA/hAT-Charlie	1068	-	17	3164450	91707
chr10	3072743	3272743	harbor1	chr10	3164593	3165056	DNA/hAT-Charlie	1068	-	232	3164825	92082
chr10	79214909	79414909	harbor1	chr10	79245748	79245951	DNA/hAT-Charlie	769	-	102	79245850	30941
chr10	79214909	79414909	harbor1	chr10	79249569	79249743	DNA/hAT-Charlie	834	-	87	79249656	34747
chr10	79214909	79414909	harbor1	chr10	79258032	79258099	DNA/hAT-Charlie	463	-	34	79258066	43157
chr10	79214909	79414909	harbor1	chr10	79258415	79258554	DNA/hAT-Charlie	463	-	70	79258485	43576
chr10	62704867	62904867	harbor1	chr10	62720766	62720956	DNA/hAT-Charlie	667	-	95	62720861	15994
chr10	62704867	62904867	harbor1	chr10	62737459	62737548	DNA/hAT-Charlie	849	-	44	62737503	32636
chr10	62704867	62904867	harbor1	chr10	62737582	62737664	DNA/hAT-Charlie	849	-	41	62737623	32756
chr10	62704867	62904867	harbor1	chr10	62742029	62742408	DNA/hAT-Charlie	1520	-	190	62742219	37352
chr10	78346452	78546452	harbor1	chr10	78361254	78361436	DNA/hAT-Charlie	772	-	91	78361345	14893
chr10	78346452	78546452	harbor1	chr10	78377846	78378107	DNA/hAT-Charlie	671	-	130	78377976	31524
chr10	78346452	78546452	harbor1	chr10	78383444	78383638	DNA/hAT-Charlie	1003	-	97	78383541	37089
chr10	78346452	78546452	harbor1	chr10	78430387	78430754	DNA/hAT-Charlie	1150	-	184	78430571	84119
chr10	78346452	78546452	harbor1	chr10	78440701	78440897	DNA/hAT-Charlie	764	-	98	78440799	94347
chr10	78346452	78546452	harbor1	chr10	78441183	78441431	DNA/hAT-Charlie	1377	-	124	78441307	94855
chr10	78346452	78546452	harbor1	chr10	78441737	78441859	DNA/hAT-Charlie	1377	-	61	78441798	95346
chr10	2967276	3167276	harbor1	chr10	2976095	2976198	DNA/hAT-Charlie	1012	-	52	2976147	8871
chr10	2967276	3167276	harbor1	chr10	2976529	2976729	DNA/hAT-Charlie	1012	-	100	2976629	9353
chr10	96887352	97087352	harbor1	chr10	96897150	96897386	DNA/hAT-Charlie	467	-	118	96897268	9916
chr10	14778054	14978054	harbor1	chr10	14835773	14836099	DNA/hAT-Charlie	729	-	163	14835936	57882
chr10	14778054	14978054	harbor1	chr10	14854789	14854924	DNA/hAT-Charlie	752	-	68	14854857	76803
chr10	14778054	14978054	harbor1	chr10	14875493	14875724	DNA/hAT-Charlie	1351	-	116	14875609	97555
chr10	14778054	14978054	harbor1	chr10	14875982	14876226	DNA/hAT-Charlie	1351	-	122	14876104	98050
chr10	14778054	14978054	harbor1	chr10	14811091	14811272	DNA/hAT-Charlie	578	-	90	14811181	33127
chr10	131255629	131455629	harbor1	chr10	131257604	131257812	DNA/hAT-Charlie	728	-	104	131257708	2079
chr10	43100314	43300314	harbor1	chr10	43156569	43156911	DNA/hAT-Charlie	2069	-	171	43156740	56426
chr10	43100314	43300314	harbor1	chr10	43162700	43162879	DNA/hAT-Charlie	632	-	90	43162790	62476
chr10	43100314	43300314	harbor1	chr10	43175097	43175312	DNA/hAT-Charlie	1002	-	108	43175205	74891
chr10	43100314	43300314	harbor1	chr10	43193718	43193848	DNA/hAT-Charlie	515	-	65	43193783	93469
chr10	100897105	101097105	harbor1	chr10	100960898	100960998	DNA/hAT-Charlie	706	-	50	100960948	63843
chr10	100897105	101097105	harbor1	chr10	100961309	100961386	DNA/hAT-Charlie	706	-	38	100961347	64242
chr10	100897105	101097105	harbor1	chr10	100975200	100975348	DNA/hAT-Charlie	790	-	74	100975274	78169
chr10	100897105	101097105	harbor1	chr10	100925156	100925467	DNA/hAT-Charlie	666	-	156	100925312	28207
chr10	48299633	48499633	harbor1	chr10	48302514	48302688	DNA/hAT-Charlie	802	-	87	48302601	2968
chr10	48299633	48499633	harbor1	chr10	48335422	48335784	DNA/hAT-Charlie	1438	-	181	48335603	35970
chr10	48299633	48499633	harbor1	chr10	48335781	48336022	DNA/hAT-Charlie	1048	-	120	48335901	36268
chr10	48299633	48499633	harbor1	chr10	48336447	48336670	DNA/hAT-Charlie	634	-	112	48336559	36926
chr10	48299633	48499633	harbor1	chr10	48354491	48354663	DNA/hAT-Charlie	951	-	86	48354577	54944
chr10	96974852	97174852	harbor1	chr10	97028925	97029080	DNA/hAT-Charlie	481	-	78	97029003	54151
chr10	96974852	97174852	harbor1	chr10	97045876	97046048	DNA/hAT-Charlie	929	-	86	97045962	71110
chr10	14778029	14978029	harbor1	chr10	14835773	14836099	DNA/hAT-Charlie	729	-	163	14835936	57907
chr10	14778029	14978029	harbor1	chr10	14854789	14854924	DNA/hAT-Charlie	752	-	68	14854857	76828
chr10	14778029	14978029	harbor1	chr10	14875493	14875724	DNA/hAT-Charlie	1351	-	116	14875609	97580
chr10	14778029	14978029	harbor1	chr10	14875982	14876226	DNA/hAT-Charlie	1351	-	122	14876104	98075
chr10	14778029	14978029	harbor1	chr10	14811091	14811272	DNA/hAT-Charlie	578	-	90	14811181	33152
chr10	68131746	68331746	harbor1	chr10	68136944	68138094	DNA/hAT-Charlie	5300	-	575	68137519	5773
chr10	68131746	68331746	harbor1	chr10	68138402	68138625	DNA/hAT-Charlie	5300	-	112	68138514	6768
chr10	68131746	68331746	harbor1	chr10	68206130	68206239	DNA/hAT-Charlie	478	-	54	68206184	74438
chr10	68131746	68331746	harbor1	chr10	68212997	68213204	DNA/hAT-Charlie	1210	-	104	68213101	81355
chr10	97398990	97598990	harbor1	chr10	97464487	97464639	DNA/hAT-Charlie	695	-	76	97464563	65573
chr10	97398990	97598990	harbor1	chr10	97478663	97478821	DNA/hAT-Charlie	732	-	79	97478742	79752
chr10	97398875	97598875	harbor1	chr10	97464487	97464639	DNA/hAT-Charlie	695	-	76	97464563	65688
chr10	97398875	97598875	harbor1	chr10	97478663	97478821	DNA/hAT-Charlie	732	-	79	97478742	79867
chr10	22337593	22537593	harbor1	chr10	22388108	22388326	DNA/hAT-Charlie	1079	-	109	22388217	50624
chr10	72254310	72454310	harbor1	chr10	72288744	72288771	DNA/hAT-Charlie	1343	-	14	72288758	34448
chr10	72254310	72454310	harbor1	chr10	72289071	72289176	DNA/hAT-Charlie	1343	-	52	72289123	34813
chr10	72254310	72454310	harbor1	chr10	72289492	72289621	DNA/hAT-Charlie	1343	-	64	72289556	35246
chr10	72254310	72454310	harbor1	chr10	72289962	72290096	DNA/hAT-Charlie	1343	-	67	72290029	35719
chr10	72254310	72454310	harbor1	chr10	72290436	72290459	DNA/hAT-Charlie	480	-	12	72290448	36138
chr10	72254310	72454310	harbor1	chr10	72290750	72290842	DNA/hAT-Charlie	480	-	46	72290796	36486
chr10	133130641	133330641	harbor1	chr10	133170517	133170950	DNA/hAT-Charlie	1313	-	216	133170733	40092
chr10	95979828	96179828	harbor1	chr10	95997350	95997394	DNA/hAT-Charlie	768	-	22	95997372	17544
chr10	95979828	96179828	harbor1	chr10	95997688	95997824	DNA/hAT-Charlie	768	-	68	95997756	17928
chr10	95979828	96179828	harbor1	chr10	96015039	96015074	DNA/hAT-Charlie	526	-	18	96015057	35229
chr10	95979828	96179828	harbor1	chr10	96015377	96015604	DNA/hAT-Charlie	526	-	114	96015491	35663
chr10	95979828	96179828	harbor1	chr10	96023746	96023927	DNA/hAT-Charlie	790	-	90	96023836	44008
chr10	95979828	96179828	harbor1	chr10	96034318	96034500	DNA/hAT-Charlie	1047	-	91	96034409	54581
chr10	46006427	46206427	harbor1	chr10	46037196	46037306	DNA/hAT-Charlie	482	-	55	46037251	30824
chr10	43474486	43674486	harbor1	chr10	43485664	43485800	DNA/hAT-Charlie	576	-	68	43485732	11246
chr10	43474486	43674486	harbor1	chr10	43491783	43491907	DNA/hAT-Charlie	629	-	62	43491845	17359
chr10	43474486	43674486	harbor1	chr10	43492167	43492431	DNA/hAT-Charlie	1348	-	132	43492299	17813
chr10	43474486	43674486	harbor1	chr10	43492718	43492730	DNA/hAT-Charlie	1348	-	6	43492724	18238
chr10	43474486	43674486	harbor1	chr10	43493769	43493874	DNA/hAT-Charlie	481	-	52	43493821	19335
chr10	43474486	43674486	harbor1	chr10	43494070	43494428	DNA/hAT-Charlie	1330	-	179	43494249	19763
chr10	43474486	43674486	harbor1	chr10	43548166	43548361	DNA/hAT-Charlie	942	-	98	43548264	73778
chr10	101032219	101232219	harbor1	chr10	101101466	101101557	DNA/hAT-Charlie	560	-	46	101101512	69293
chr10	131310773	131510773	harbor1	chr10	131372392	131372601	DNA/hAT-Charlie	540	-	104	131372496	61723
chr10	131310773	131510773	harbor1	chr10	131373737	131373899	DNA/hAT-Charlie	441	-	81	131373818	63045
chr10	86532110	86732110	harbor1	chr10	86545315	86545534	DNA/hAT-Charlie	755	-	110	86545425	13315
chr10	86532110	86732110	harbor1	chr10	86550772	86550865	DNA/hAT-Charlie	578	-	46	86550818	18708
chr10	46184879	46384879	harbor1	chr10	46205630	46205848	DNA/hAT-Charlie	969	-	109	46205739	20860
chr10	46184879	46384879	harbor1	chr10	46207243	46207366	DNA/hAT-Charlie	1450	-	62	46207305	22426
chr10	46184879	46384879	harbor1	chr10	46207654	46208105	DNA/hAT-Charlie	2534	-	226	46207880	23001
chr10	46184879	46384879	harbor1	chr10	46212194	46212352	DNA/hAT-Charlie	522	-	79	46212273	27394
chr10	47239932	47439932	harbor1	chr10	47288509	47288820	DNA/hAT-Charlie	708	-	156	47288665	48733
chr10	47239932	47439932	harbor1	chr10	47299028	47299482	DNA/hAT-Charlie	1853	-	227	47299255	59323
chr10	47239932	47439932	harbor1	chr10	47323068	47323265	DNA/hAT-Charlie	628	-	98	47323166	83234
chr10	4842408	5042408	harbor1	chr10	4853151	4853421	DNA/hAT-Charlie	880	-	135	4853286	10878
chr10	4842408	5042408	harbor1	chr10	4860514	4861238	DNA/hAT-Charlie	1356	-	362	4860876	18468
chr10	4842408	5042408	harbor1	chr10	4904030	4904201	DNA/hAT-Charlie	576	-	86	4904116	61708
chr10	4842408	5042408	harbor1	chr10	4917803	4918144	DNA/hAT-Charlie	1176	-	170	4917973	75565
chr10	47239964	47439964	harbor1	chr10	47288509	47288820	DNA/hAT-Charlie	708	-	156	47288665	48701
chr10	47239964	47439964	harbor1	chr10	47299028	47299482	DNA/hAT-Charlie	1853	-	227	47299255	59291
chr10	47239964	47439964	harbor1	chr10	47323068	47323265	DNA/hAT-Charlie	628	-	98	47323166	83202
chr10	75111030	75311030	harbor1	chr10	75131860	75132034	DNA/hAT-Charlie	518	-	87	75131947	20917
chr10	75111030	75311030	harbor1	chr10	75145614	75145801	DNA/hAT-Charlie	771	-	94	75145708	34678
chr10	75111030	75311030	harbor1	chr10	75168236	75168394	DNA/hAT-Charlie	789	-	79	75168315	57285
chr10	75111030	75311030	harbor1	chr10	75188145	75188259	DNA/hAT-Charlie	441	-	57	75188202	77172
chr10	131309416	131509416	harbor1	chr10	131372392	131372601	DNA/hAT-Charlie	540	-	104	131372496	63080
chr10	131309416	131509416	harbor1	chr10	131373737	131373899	DNA/hAT-Charlie	441	-	81	131373818	64402
chr10	78865014	79065014	harbor1	chr10	78891780	78891956	DNA/hAT-Charlie	970	-	88	78891868	26854
chr10	78865014	79065014	harbor1	chr10	78912981	78913155	DNA/hAT-Charlie	609	-	87	78913068	48054
chr10	78865014	79065014	harbor1	chr10	78924518	78924727	DNA/hAT-Charlie	1296	-	104	78924622	59608
chr10	14778674	14978674	harbor1	chr10	14835773	14836099	DNA/hAT-Charlie	729	-	163	14835936	57262
chr10	14778674	14978674	harbor1	chr10	14854789	14854924	DNA/hAT-Charlie	752	-	68	14854857	76183
chr10	14778674	14978674	harbor1	chr10	14875493	14875724	DNA/hAT-Charlie	1351	-	116	14875609	96935
chr10	14778674	14978674	harbor1	chr10	14875982	14876226	DNA/hAT-Charlie	1351	-	122	14876104	97430
chr10	14778674	14978674	harbor1	chr10	14811091	14811272	DNA/hAT-Charlie	578	-	90	14811181	32507
chr10	77303746	77503746	harbor1	chr10	77304951	77305102	DNA/hAT-Charlie	500	-	76	77305027	1281
chr10	77303746	77503746	harbor1	chr10	77314840	77314923	DNA/hAT-Charlie	561	-	42	77314882	11136
chr10	77303746	77503746	harbor1	chr10	77314968	77315102	DNA/hAT-Charlie	561	-	67	77315035	11289
chr10	77303746	77503746	harbor1	chr10	77316461	77316609	DNA/hAT-Charlie	490	-	74	77316535	12789
chr10	77303746	77503746	harbor1	chr10	77334723	77335019	DNA/hAT-Charlie	1052	-	148	77334871	31125
chr10	77303746	77503746	harbor1	chr10	77335430	77335610	DNA/hAT-Charlie	575	-	90	77335520	31774
chr10	77303746	77503746	harbor1	chr10	77383569	77383715	DNA/hAT-Charlie	560	-	73	77383642	79896
chr10	77303746	77503746	harbor1	chr10	77383857	77383900	DNA/hAT-Charlie	560	-	22	77383879	80133
chr10	77303746	77503746	harbor1	chr10	77394814	77395064	DNA/hAT-Charlie	1279	-	125	77394939	91193
chr10	77303746	77503746	harbor1	chr10	77395377	77395452	DNA/hAT-Charlie	1279	-	38	77395415	91669
chr10	75111036	75311036	harbor1	chr10	75131860	75132034	DNA/hAT-Charlie	518	-	87	75131947	20911
chr10	75111036	75311036	harbor1	chr10	75145614	75145801	DNA/hAT-Charlie	771	-	94	75145708	34672
chr10	75111036	75311036	harbor1	chr10	75168236	75168394	DNA/hAT-Charlie	789	-	79	75168315	57279
chr10	75111036	75311036	harbor1	chr10	75188145	75188259	DNA/hAT-Charlie	441	-	57	75188202	77166
chr10	62704945	62904945	harbor1	chr10	62720766	62720956	DNA/hAT-Charlie	667	-	95	62720861	15916
chr10	62704945	62904945	harbor1	chr10	62737459	62737548	DNA/hAT-Charlie	849	-	44	62737503	32558
chr10	62704945	62904945	harbor1	chr10	62737582	62737664	DNA/hAT-Charlie	849	-	41	62737623	32678
chr10	62704945	62904945	harbor1	chr10	62742029	62742408	DNA/hAT-Charlie	1520	-	190	62742219	37274
chr10	97672149	97872149	harbor1	chr10	97765937	97766077	DNA/hAT-Charlie	512	-	70	97766007	93858
chr10	14778680	14978680	harbor1	chr10	14835773	14836099	DNA/hAT-Charlie	729	-	163	14835936	57256
chr10	14778680	14978680	harbor1	chr10	14854789	14854924	DNA/hAT-Charlie	752	-	68	14854857	76177
chr10	14778680	14978680	harbor1	chr10	14875493	14875724	DNA/hAT-Charlie	1351	-	116	14875609	96929
chr10	14778680	14978680	harbor1	chr10	14875982	14876226	DNA/hAT-Charlie	1351	-	122	14876104	97424
chr10	14778680	14978680	harbor1	chr10	14811091	14811272	DNA/hAT-Charlie	578	-	90	14811181	32501
chr10	128885275	129085275	harbor1	chr10	128894532	128894664	DNA/hAT-Charlie	569	-	66	128894598	9323
chr10	128885275	129085275	harbor1	chr10	128934915	128935476	DNA/hAT-Charlie	1399	-	280	128935195	49920
chr10	128885275	129085275	harbor1	chr10	128936574	128936879	DNA/hAT-Charlie	461	-	152	128936726	51451
chr10	35265	235265	harbor1	chr10	109487	109673	DNA/hAT-Charlie	667	-	93	109580	74315
chr10	102141613	102341613	harbor1	chr10	102168432	102168614	DNA/hAT-Charlie	1035	-	91	102168523	26910
chr10	102141613	102341613	harbor1	chr10	102237634	102237911	DNA/hAT-Charlie	612	-	138	102237772	96159
chr10	79279347	79479347	harbor1	chr10	79322133	79322379	DNA/hAT-Charlie	502	-	123	79322256	42909
chr10	110707741	110907741	harbor1	chr10	110725186	110725347	DNA/hAT-Charlie	518	-	80	110725266	17525
chr10	110707741	110907741	harbor1	chr10	110763826	110764023	DNA/hAT-Charlie	938	-	98	110763924	56183
chr10	110707741	110907741	harbor1	chr10	110793315	110793452	DNA/hAT-Charlie	487	-	68	110793383	85642
chr10	110707741	110907741	harbor1	chr10	110803416	110803578	DNA/hAT-Charlie	723	-	81	110803497	95756
chr10	43005593	43205593	harbor1	chr10	43009342	43009663	DNA/hAT-Charlie	2016	-	160	43009502	3909
chr10	43005593	43205593	harbor1	chr10	43070044	43070160	DNA/hAT-Charlie	544	-	58	43070102	64509
chr10	89202972	89402972	harbor1	chr10	89295450	89295622	DNA/hAT-Charlie	745	-	86	89295536	92564
chr10	46006339	46206339	harbor1	chr10	46037196	46037306	DNA/hAT-Charlie	482	-	55	46037251	30912
chr10	47239866	47439866	harbor1	chr10	47288509	47288820	DNA/hAT-Charlie	708	-	156	47288665	48799
chr10	47239866	47439866	harbor1	chr10	47299028	47299482	DNA/hAT-Charlie	1853	-	227	47299255	59389
chr10	47239866	47439866	harbor1	chr10	47323068	47323265	DNA/hAT-Charlie	628	-	98	47323166	83300
chr10	62704875	62904875	harbor1	chr10	62720766	62720956	DNA/hAT-Charlie	667	-	95	62720861	15986
chr10	62704875	62904875	harbor1	chr10	62737459	62737548	DNA/hAT-Charlie	849	-	44	62737503	32628
chr10	62704875	62904875	harbor1	chr10	62737582	62737664	DNA/hAT-Charlie	849	-	41	62737623	32748
chr10	62704875	62904875	harbor1	chr10	62742029	62742408	DNA/hAT-Charlie	1520	-	190	62742219	37344
chr10	47239913	47439913	harbor1	chr10	47288509	47288820	DNA/hAT-Charlie	708	-	156	47288665	48752
chr10	47239913	47439913	harbor1	chr10	47299028	47299482	DNA/hAT-Charlie	1853	-	227	47299255	59342
chr10	47239913	47439913	harbor1	chr10	47323068	47323265	DNA/hAT-Charlie	628	-	98	47323166	83253
chr10	69472286	69672286	harbor1	chr10	69477500	69477675	DNA/hAT-Charlie	562	-	88	69477588	5302
chr10	69472286	69672286	harbor1	chr10	69478597	69479051	DNA/hAT-Charlie	1844	-	227	69478824	6538
chr10	69472286	69672286	harbor1	chr10	69505094	69505576	DNA/hAT-Charlie	1594	-	241	69505335	33049
chr10	69472286	69672286	harbor1	chr10	69527196	69527313	DNA/hAT-Charlie	1253	-	58	69527254	54968
chr10	69472286	69672286	harbor1	chr10	69527609	69527697	DNA/hAT-Charlie	1253	-	44	69527653	55367
chr11	112678749	112878749	harbor1	chr11	112740659	112741006	DNA/hAT-Charlie	1673	-	174	112740833	62084
chr11	112678749	112878749	harbor1	chr11	112741318	112741628	DNA/hAT-Charlie	1673	-	155	112741473	62724
chr11	112678749	112878749	harbor1	chr11	112741633	112742212	DNA/hAT-Charlie	1059	-	290	112741923	63174
chr11	112678749	112878749	harbor1	chr11	112742991	112743293	DNA/hAT-Charlie	759	-	151	112743142	64393
chr11	112678749	112878749	harbor1	chr11	112760057	112760225	DNA/hAT-Charlie	762	-	84	112760141	81392
chr11	5127157	5327157	harbor1	chr11	5136341	5136518	DNA/hAT-Charlie	814	-	88	5136429	9272
chr11	5127156	5327156	harbor1	chr11	5136341	5136518	DNA/hAT-Charlie	814	-	88	5136429	9273
chr11	5129450	5329450	harbor1	chr11	5136341	5136518	DNA/hAT-Charlie	814	-	88	5136429	6979
chr11	5127277	5327277	harbor1	chr11	5136341	5136518	DNA/hAT-Charlie	814	-	88	5136429	9152
chr11	5127135	5327135	harbor1	chr11	5136341	5136518	DNA/hAT-Charlie	814	-	88	5136429	9294
chr11	5127181	5327181	harbor1	chr11	5136341	5136518	DNA/hAT-Charlie	814	-	88	5136429	9248
chr11	5127341	5327341	harbor1	chr11	5136341	5136518	DNA/hAT-Charlie	814	-	88	5136429	9088
chr11	5127230	5327230	harbor1	chr11	5136341	5136518	DNA/hAT-Charlie	814	-	88	5136429	9199
chr11	68642659	68842659	harbor1	chr11	68660952	68661152	DNA/hAT-Charlie	857	-	100	68661052	18393
chr11	68642659	68842659	harbor1	chr11	68740102	68740278	DNA/hAT-Charlie	800	-	88	68740190	97531
chr11	64537901	64737901	harbor1	chr11	64546086	64546250	DNA/hAT-Charlie	942	-	82	64546168	8267
chr11	5134663	5334663	harbor1	chr11	5136341	5136518	DNA/hAT-Charlie	814	-	88	5136429	1766
chr11	72121656	72321656	harbor1	chr11	72147566	72147615	DNA/hAT-Charlie	403	-	24	72147590	25934
chr11	72121656	72321656	harbor1	chr11	72147618	72147704	DNA/hAT-Charlie	531	-	43	72147661	26005
chr11	72121656	72321656	harbor1	chr11	72219307	72219822	DNA/hAT-Charlie	1774	-	258	72219565	97909
chr11	64242408	64442408	harbor1	chr11	64277779	64278005	DNA/hAT-Charlie	639	-	113	64277892	35484
chr11	102246099	102446099	harbor1	chr11	102320561	102321072	DNA/hAT-Charlie	1347	-	256	102320817	74718
chr11	2054543	2254543	harbor1	chr11	2111330	2111482	DNA/hAT-Charlie	440	-	76	2111406	56863
chr11	2054543	2254543	harbor1	chr11	2111965	2112363	DNA/hAT-Charlie	884	-	199	2112164	57621
chr11	2054543	2254543	harbor1	chr11	2113288	2113323	DNA/hAT-Charlie	901	-	18	2113306	58763
chr11	2054543	2254543	harbor1	chr11	2113595	2113908	DNA/hAT-Charlie	901	-	156	2113751	59208
chr11	2054543	2254543	harbor1	chr11	2113942	2114133	DNA/hAT-Charlie	773	-	96	2114038	59495
chr11	5126804	5326804	harbor1	chr11	5136341	5136518	DNA/hAT-Charlie	814	-	88	5136429	9625
chr11	5127222	5327222	harbor1	chr11	5136341	5136518	DNA/hAT-Charlie	814	-	88	5136429	9207
chr11	5127226	5327226	harbor1	chr11	5136341	5136518	DNA/hAT-Charlie	814	-	88	5136429	9203
chr11	57399763	57599763	harbor1	chr11	57422126	57422540	DNA/hAT-Charlie	1203	-	207	57422333	22570
chr11	57399763	57599763	harbor1	chr11	57427663	57428017	DNA/hAT-Charlie	696	-	177	57427840	28077
chr11	89682097	89882097	harbor1	chr11	89706281	89706686	DNA/hAT-Charlie	1490	-	202	89706483	24386
chr11	89682097	89882097	harbor1	chr11	89727861	89728141	DNA/hAT-Charlie	1791	-	140	89728001	45904
chr11	119387210	119587210	harbor1	chr11	119407087	119407429	DNA/hAT-Charlie	2154	-	171	119407258	20048
chr11	119387210	119587210	harbor1	chr11	119475650	119475840	DNA/hAT-Charlie	851	-	95	119475745	88535
chr11	5127150	5327150	harbor1	chr11	5136341	5136518	DNA/hAT-Charlie	814	-	88	5136429	9279
chr11	5127250	5327250	harbor1	chr11	5136341	5136518	DNA/hAT-Charlie	814	-	88	5136429	9179
chr11	2054521	2254521	harbor1	chr11	2111330	2111482	DNA/hAT-Charlie	440	-	76	2111406	56885
chr11	2054521	2254521	harbor1	chr11	2111965	2112363	DNA/hAT-Charlie	884	-	199	2112164	57643
chr11	2054521	2254521	harbor1	chr11	2113288	2113323	DNA/hAT-Charlie	901	-	18	2113306	58785
chr11	2054521	2254521	harbor1	chr11	2113595	2113908	DNA/hAT-Charlie	901	-	156	2113751	59230
chr11	2054521	2254521	harbor1	chr11	2113942	2114133	DNA/hAT-Charlie	773	-	96	2114038	59517
chr11	5126803	5326803	harbor1	chr11	5136341	5136518	DNA/hAT-Charlie	814	-	88	5136429	9626
chr11	5134612	5334612	harbor1	chr11	5136341	5136518	DNA/hAT-Charlie	814	-	88	5136429	1817
chr11	5134133	5334133	harbor1	chr11	5136341	5136518	DNA/hAT-Charlie	814	-	88	5136429	2296
chr11	113773314	113973314	harbor1	chr11	113799765	113799881	DNA/hAT-Charlie	486	-	58	113799823	26509
chr11	113773314	113973314	harbor1	chr11	113801753	113801926	DNA/hAT-Charlie	672	-	86	113801839	28525
chr11	113773314	113973314	harbor1	chr11	113801983	113802145	DNA/hAT-Charlie	517	-	81	113802064	28750
chr11	113773314	113973314	harbor1	chr11	113871393	113871604	DNA/hAT-Charlie	814	-	106	113871499	98185
chr11	46034956	46234956	harbor1	chr11	46054467	46054582	DNA/hAT-Charlie	429	-	58	46054525	19569
chr11	46034956	46234956	harbor1	chr11	46057308	46057467	DNA/hAT-Charlie	703	-	80	46057388	22432
chr11	46034956	46234956	harbor1	chr11	46063362	46063575	DNA/hAT-Charlie	834	-	106	46063468	28512
chr11	46034956	46234956	harbor1	chr11	46090496	46090712	DNA/hAT-Charlie	1167	-	108	46090604	55648
chr11	46034956	46234956	harbor1	chr11	46123843	46124187	DNA/hAT-Charlie	1409	-	172	46124015	89059
chr11	46034956	46234956	harbor1	chr11	46127204	46127367	DNA/hAT-Charlie	963	-	82	46127286	92330
chr11	46034956	46234956	harbor1	chr11	46130440	46130550	DNA/hAT-Charlie	445	-	55	46130495	95539
chr11	119643315	119843315	harbor1	chr11	119688418	119688605	DNA/hAT-Charlie	702	-	94	119688512	45197
chr11	5125277	5325277	harbor1	chr11	5136341	5136518	DNA/hAT-Charlie	814	-	88	5136429	11152
chr11	108021540	108221540	harbor1	chr11	108067394	108067586	DNA/hAT-Charlie	562	-	96	108067490	45950
chr11	5125978	5325978	harbor1	chr11	5136341	5136518	DNA/hAT-Charlie	814	-	88	5136429	10451
chr11	57399760	57599760	harbor1	chr11	57422126	57422540	DNA/hAT-Charlie	1203	-	207	57422333	22573
chr11	57399760	57599760	harbor1	chr11	57427663	57428017	DNA/hAT-Charlie	696	-	177	57427840	28080
chr11	5127141	5327141	harbor1	chr11	5136341	5136518	DNA/hAT-Charlie	814	-	88	5136429	9288
chr11	5127172	5327172	harbor1	chr11	5136341	5136518	DNA/hAT-Charlie	814	-	88	5136429	9257
chr11	5134086	5334086	harbor1	chr11	5136341	5136518	DNA/hAT-Charlie	814	-	88	5136429	2343
chr11	5127261	5327261	harbor1	chr11	5136341	5136518	DNA/hAT-Charlie	814	-	88	5136429	9168
chr11	5134533	5334533	harbor1	chr11	5136341	5136518	DNA/hAT-Charlie	814	-	88	5136429	1896
chr11	5126745	5326745	harbor1	chr11	5136341	5136518	DNA/hAT-Charlie	814	-	88	5136429	9684
chr11	46185687	46385687	harbor1	chr11	46247510	46247717	DNA/hAT-Charlie	930	-	104	46247614	61927
chr11	5134641	5334641	harbor1	chr11	5136341	5136518	DNA/hAT-Charlie	814	-	88	5136429	1788
chr11	57399762	57599762	harbor1	chr11	57422126	57422540	DNA/hAT-Charlie	1203	-	207	57422333	22571
chr11	57399762	57599762	harbor1	chr11	57427663	57428017	DNA/hAT-Charlie	696	-	177	57427840	28078
chr11	108004348	108204348	harbor1	chr11	108067394	108067586	DNA/hAT-Charlie	562	-	96	108067490	63142
chr11	2759442	2959442	harbor1	chr11	2787506	2787859	DNA/hAT-Charlie	1354	-	176	2787682	28240
chr11	5127278	5327278	harbor1	chr11	5136341	5136518	DNA/hAT-Charlie	814	-	88	5136429	9151
chr11	65968777	66168777	harbor1	chr11	65969144	65969324	DNA/hAT-Charlie	569	-	90	65969234	457
chr11	65968777	66168777	harbor1	chr11	66032969	66033175	DNA/hAT-Charlie	994	-	103	66033072	64295
chr11	80398104	80598104	harbor1	chr11	80446964	80447172	DNA/hAT-Charlie	577	-	104	80447068	48964
chr11	5134115	5334115	harbor1	chr11	5136341	5136518	DNA/hAT-Charlie	814	-	88	5136429	2314
chr11	5134546	5334546	harbor1	chr11	5136341	5136518	DNA/hAT-Charlie	814	-	88	5136429	1883
chr11	5124980	5324980	harbor1	chr11	5136341	5136518	DNA/hAT-Charlie	814	-	88	5136429	11449
chr11	5127317	5327317	harbor1	chr11	5136341	5136518	DNA/hAT-Charlie	814	-	88	5136429	9112
chr11	5127257	5327257	harbor1	chr11	5136341	5136518	DNA/hAT-Charlie	814	-	88	5136429	9172
chr11	86559546	86759546	harbor1	chr11	86626618	86626805	DNA/hAT-Charlie	908	-	94	86626712	67166
chr11	86559546	86759546	harbor1	chr11	86642773	86643056	DNA/hAT-Charlie	885	-	142	86642915	83369
chr11	5100509	5300509	harbor1	chr11	5136341	5136518	DNA/hAT-Charlie	814	-	88	5136429	35920
chr11	5127273	5327273	harbor1	chr11	5136341	5136518	DNA/hAT-Charlie	814	-	88	5136429	9156
chr11	91718101	91918101	harbor1	chr11	91718611	91718801	DNA/hAT-Charlie	832	-	95	91718706	605
chr11	91718101	91918101	harbor1	chr11	91741020	91741158	DNA/hAT-Charlie	430	-	69	91741089	22988
chr11	91718101	91918101	harbor1	chr11	91779861	91780317	DNA/hAT-Charlie	2617	-	228	91780089	61988
chr11	91718101	91918101	harbor1	chr11	91811596	91811879	DNA/hAT-Charlie	1111	-	142	91811738	93637
chr11	91718101	91918101	harbor1	chr11	91812455	91812649	DNA/hAT-Charlie	408	-	97	91812552	94451
chr11	4695187	4895187	harbor1	chr11	4766526	4766678	DNA/hAT-Charlie	537	-	76	4766602	71415
chr11	5134560	5334560	harbor1	chr11	5136341	5136518	DNA/hAT-Charlie	814	-	88	5136429	1869
chr11	108021573	108221573	harbor1	chr11	108067394	108067586	DNA/hAT-Charlie	562	-	96	108067490	45917
chr11	76580974	76780974	harbor1	chr11	76649880	76650144	DNA/hAT-Charlie	863	-	132	76650012	69038
chr11	76580974	76780974	harbor1	chr11	76675310	76675490	DNA/hAT-Charlie	837	-	90	76675400	94426
chr11	5127126	5327126	harbor1	chr11	5136341	5136518	DNA/hAT-Charlie	814	-	88	5136429	9303
chr11	65758060	65958060	harbor1	chr11	65823507	65823692	DNA/hAT-Charlie	558	-	92	65823599	65539
chr11	5125006	5325006	harbor1	chr11	5136341	5136518	DNA/hAT-Charlie	814	-	88	5136429	11423
chr11	5134608	5334608	harbor1	chr11	5136341	5136518	DNA/hAT-Charlie	814	-	88	5136429	1821
chr11	70391186	70591186	harbor1	chr11	70426013	70426125	DNA/hAT-Charlie	707	-	56	70426069	34883
chr11	70391186	70591186	harbor1	chr11	70427025	70427067	DNA/hAT-Charlie	707	-	21	70427046	35860
chr11	70391186	70591186	harbor1	chr11	70427368	70427574	DNA/hAT-Charlie	707	-	103	70427471	36285
chr11	70391186	70591186	harbor1	chr11	70427648	70428152	DNA/hAT-Charlie	1464	-	252	70427900	36714
chr11	70391186	70591186	harbor1	chr11	70460550	70460648	DNA/hAT-Charlie	654	-	49	70460599	69413
chr11	70391186	70591186	harbor1	chr11	70460681	70460770	DNA/hAT-Charlie	654	-	44	70460725	69539
chr11	5126778	5326778	harbor1	chr11	5136341	5136518	DNA/hAT-Charlie	814	-	88	5136429	9651
chr11	5134653	5334653	harbor1	chr11	5136341	5136518	DNA/hAT-Charlie	814	-	88	5136429	1776
chr11	5134111	5334111	harbor1	chr11	5136341	5136518	DNA/hAT-Charlie	814	-	88	5136429	2318
chr11	2054541	2254541	harbor1	chr11	2111330	2111482	DNA/hAT-Charlie	440	-	76	2111406	56865
chr11	2054541	2254541	harbor1	chr11	2111965	2112363	DNA/hAT-Charlie	884	-	199	2112164	57623
chr11	2054541	2254541	harbor1	chr11	2113288	2113323	DNA/hAT-Charlie	901	-	18	2113306	58765
chr11	2054541	2254541	harbor1	chr11	2113595	2113908	DNA/hAT-Charlie	901	-	156	2113751	59210
chr11	2054541	2254541	harbor1	chr11	2113942	2114133	DNA/hAT-Charlie	773	-	96	2114038	59497
chr11	57374327	57574327	harbor1	chr11	57378021	57378170	DNA/hAT-Charlie	933	-	74	57378095	3768
chr11	57374327	57574327	harbor1	chr11	57382295	57382512	DNA/hAT-Charlie	976	-	108	57382403	8076
chr11	57374327	57574327	harbor1	chr11	57398506	57398710	DNA/hAT-Charlie	981	-	102	57398608	24281
chr11	57374327	57574327	harbor1	chr11	57422126	57422540	DNA/hAT-Charlie	1203	-	207	57422333	48006
chr11	57374327	57574327	harbor1	chr11	57427663	57428017	DNA/hAT-Charlie	696	-	177	57427840	53513
chr11	5127183	5327183	harbor1	chr11	5136341	5136518	DNA/hAT-Charlie	814	-	88	5136429	9246
chr11	5127132	5327132	harbor1	chr11	5136341	5136518	DNA/hAT-Charlie	814	-	88	5136429	9297
chr11	70336771	70536771	harbor1	chr11	70337686	70337781	DNA/hAT-Charlie	455	-	48	70337734	963
chr11	70336771	70536771	harbor1	chr11	70337858	70337959	DNA/hAT-Charlie	401	-	50	70337908	1137
chr11	70336771	70536771	harbor1	chr11	70352314	70352465	DNA/hAT-Charlie	440	-	76	70352390	15619
chr11	70336771	70536771	harbor1	chr11	70426013	70426125	DNA/hAT-Charlie	707	-	56	70426069	89298
chr11	70336771	70536771	harbor1	chr11	70427025	70427067	DNA/hAT-Charlie	707	-	21	70427046	90275
chr11	70336771	70536771	harbor1	chr11	70427368	70427574	DNA/hAT-Charlie	707	-	103	70427471	90700
chr11	70336771	70536771	harbor1	chr11	70427648	70428152	DNA/hAT-Charlie	1464	-	252	70427900	91129
chr11	10401686	10601686	harbor1	chr11	10406396	10406738	DNA/hAT-Charlie	2033	-	171	10406567	4881
chr11	10401686	10601686	harbor1	chr11	10406859	10407188	DNA/hAT-Charlie	2033	-	164	10407023	5337
chr11	10401686	10601686	harbor1	chr11	10407714	10407911	DNA/hAT-Charlie	494	-	98	10407812	6126
chr11	10401686	10601686	harbor1	chr11	10408381	10408638	DNA/hAT-Charlie	1340	-	128	10408509	6823
chr11	10401686	10601686	harbor1	chr11	10413252	10413611	DNA/hAT-Charlie	1932	-	180	10413432	11746
chr11	10401686	10601686	harbor1	chr11	10417417	10417920	DNA/hAT-Charlie	13674	-	252	10417669	15983
chr11	10401686	10601686	harbor1	chr11	10418203	10420201	DNA/hAT-Charlie	13674	-	999	10419202	17516
chr11	10401686	10601686	harbor1	chr11	10447726	10448083	DNA/hAT-Charlie	613	-	178	10447904	46218
chr11	5126760	5326760	harbor1	chr11	5136341	5136518	DNA/hAT-Charlie	814	-	88	5136429	9669
chr11	34816228	35016228	harbor1	chr11	34850468	34850769	DNA/hAT-Charlie	722	-	150	34850618	34390
chr11	5127108	5327108	harbor1	chr11	5136341	5136518	DNA/hAT-Charlie	814	-	88	5136429	9321
chr11	2052793	2252793	harbor1	chr11	2111330	2111482	DNA/hAT-Charlie	440	-	76	2111406	58613
chr11	2052793	2252793	harbor1	chr11	2111965	2112363	DNA/hAT-Charlie	884	-	199	2112164	59371
chr11	2052793	2252793	harbor1	chr11	2113288	2113323	DNA/hAT-Charlie	901	-	18	2113306	60513
chr11	2052793	2252793	harbor1	chr11	2113595	2113908	DNA/hAT-Charlie	901	-	156	2113751	60958
chr11	2052793	2252793	harbor1	chr11	2113942	2114133	DNA/hAT-Charlie	773	-	96	2114038	61245
chr11	5127203	5327203	harbor1	chr11	5136341	5136518	DNA/hAT-Charlie	814	-	88	5136429	9226
chr11	5127281	5327281	harbor1	chr11	5136341	5136518	DNA/hAT-Charlie	814	-	88	5136429	9148
chr11	5134553	5334553	harbor1	chr11	5136341	5136518	DNA/hAT-Charlie	814	-	88	5136429	1876
chr11	86572150	86772150	harbor1	chr11	86626618	86626805	DNA/hAT-Charlie	908	-	94	86626712	54562
chr11	86572150	86772150	harbor1	chr11	86642773	86643056	DNA/hAT-Charlie	885	-	142	86642915	70765
chr11	5134570	5334570	harbor1	chr11	5136341	5136518	DNA/hAT-Charlie	814	-	88	5136429	1859
chr11	123313642	123513642	harbor1	chr11	123327028	123327068	DNA/hAT-Charlie	1079	-	20	123327048	13406
chr11	123313642	123513642	harbor1	chr11	123327370	123327757	DNA/hAT-Charlie	1079	-	194	123327564	13922
chr11	123313642	123513642	harbor1	chr11	123328072	123328211	DNA/hAT-Charlie	596	-	70	123328142	14500
chr11	123313642	123513642	harbor1	chr11	123328222	123328439	DNA/hAT-Charlie	703	-	108	123328330	14688
chr11	123313642	123513642	harbor1	chr11	123333564	123333758	DNA/hAT-Charlie	921	-	97	123333661	20019
chr11	123313642	123513642	harbor1	chr11	123354795	123355094	DNA/hAT-Charlie	827	-	150	123354945	41303
chr11	123313642	123513642	harbor1	chr11	123384787	123384993	DNA/hAT-Charlie	918	-	103	123384890	71248
chr11	76580440	76780440	harbor1	chr11	76649880	76650144	DNA/hAT-Charlie	863	-	132	76650012	69572
chr11	76580440	76780440	harbor1	chr11	76675310	76675490	DNA/hAT-Charlie	837	-	90	76675400	94960
chr11	5126802	5326802	harbor1	chr11	5136341	5136518	DNA/hAT-Charlie	814	-	88	5136429	9627
chr11	106768224	106968224	harbor1	chr11	106825353	106825501	DNA/hAT-Charlie	1010	-	74	106825427	57203
chr11	106768224	106968224	harbor1	chr11	106825662	106825879	DNA/hAT-Charlie	1458	-	108	106825770	57546
chr11	106768224	106968224	harbor1	chr11	106842756	106842888	DNA/hAT-Charlie	428	-	66	106842822	74598
chr11	133733693	133933693	harbor1	chr11	133776261	133776456	DNA/hAT-Charlie	875	-	98	133776359	42666
chr11	5125241	5325241	harbor1	chr11	5136341	5136518	DNA/hAT-Charlie	814	-	88	5136429	11188
chr11	5134190	5334190	harbor1	chr11	5136341	5136518	DNA/hAT-Charlie	814	-	88	5136429	2239
chr11	5125737	5325737	harbor1	chr11	5136341	5136518	DNA/hAT-Charlie	814	-	88	5136429	10692
chr11	5127241	5327241	harbor1	chr11	5136341	5136518	DNA/hAT-Charlie	814	-	88	5136429	9188
chr11	5126766	5326766	harbor1	chr11	5136341	5136518	DNA/hAT-Charlie	814	-	88	5136429	9663
chr11	5134609	5334609	harbor1	chr11	5136341	5136518	DNA/hAT-Charlie	814	-	88	5136429	1820
chr11	5134091	5334091	harbor1	chr11	5136341	5136518	DNA/hAT-Charlie	814	-	88	5136429	2338
chr11	5127300	5327300	harbor1	chr11	5136341	5136518	DNA/hAT-Charlie	814	-	88	5136429	9129
chr11	5127229	5327229	harbor1	chr11	5136341	5136518	DNA/hAT-Charlie	814	-	88	5136429	9200
chr11	107465643	107665643	harbor1	chr11	107529418	107529509	DNA/hAT-Charlie	881	-	46	107529464	63821
chr11	107465643	107665643	harbor1	chr11	107529802	107530123	DNA/hAT-Charlie	881	-	160	107529962	64319
chr11	107465643	107665643	harbor1	chr11	107531700	107531904	DNA/hAT-Charlie	1008	-	102	107531802	66159
chr11	107465643	107665643	harbor1	chr11	107532544	107532708	DNA/hAT-Charlie	502	-	82	107532626	66983
chr11	107465643	107665643	harbor1	chr11	107557968	107558144	DNA/hAT-Charlie	418	-	88	107558056	92413
chr11	108021539	108221539	harbor1	chr11	108067394	108067586	DNA/hAT-Charlie	562	-	96	108067490	45951
chr11	5126785	5326785	harbor1	chr11	5136341	5136518	DNA/hAT-Charlie	814	-	88	5136429	9644
chr11	64538073	64738073	harbor1	chr11	64546086	64546250	DNA/hAT-Charlie	942	-	82	64546168	8095
chr11	5127144	5327144	harbor1	chr11	5136341	5136518	DNA/hAT-Charlie	814	-	88	5136429	9285
chr11	5127200	5327200	harbor1	chr11	5136341	5136518	DNA/hAT-Charlie	814	-	88	5136429	9229
chr11	117886632	118086632	harbor1	chr11	117953642	117953815	DNA/hAT-Charlie	463	-	86	117953728	67096
chr11	5103484	5303484	harbor1	chr11	5136341	5136518	DNA/hAT-Charlie	814	-	88	5136429	32945
chr11	69539230	69739230	harbor1	chr11	69612675	69612867	DNA/hAT-Charlie	828	-	96	69612771	73541
chr11	69539230	69739230	harbor1	chr11	69613461	69613771	DNA/hAT-Charlie	828	-	155	69613616	74386
chr11	5127304	5327304	harbor1	chr11	5136341	5136518	DNA/hAT-Charlie	814	-	88	5136429	9125
chr11	57394202	57594202	harbor1	chr11	57398506	57398710	DNA/hAT-Charlie	981	-	102	57398608	4406
chr11	57394202	57594202	harbor1	chr11	57422126	57422540	DNA/hAT-Charlie	1203	-	207	57422333	28131
chr11	57394202	57594202	harbor1	chr11	57427663	57428017	DNA/hAT-Charlie	696	-	177	57427840	33638
chr11	6201318	6401318	harbor1	chr11	6232867	6233052	DNA/hAT-Charlie	519	-	92	6232959	31641
chr11	70734522	70934522	harbor1	chr11	70761619	70761779	DNA/hAT-Charlie	565	-	80	70761699	27177
chr11	46138065	46338065	harbor1	chr11	46145380	46145590	DNA/hAT-Charlie	405	-	105	46145485	7420
chr11	46138065	46338065	harbor1	chr11	46181530	46181692	DNA/hAT-Charlie	542	-	81	46181611	43546
chr11	57246770	57446770	harbor1	chr11	57270138	57270337	DNA/hAT-Charlie	878	-	100	57270238	23468
chr11	57246770	57446770	harbor1	chr11	57327040	57327304	DNA/hAT-Charlie	598	-	132	57327172	80402
chr11	57383305	57583305	harbor1	chr11	57398506	57398710	DNA/hAT-Charlie	981	-	102	57398608	15303
chr11	57383305	57583305	harbor1	chr11	57422126	57422540	DNA/hAT-Charlie	1203	-	207	57422333	39028
chr11	57383305	57583305	harbor1	chr11	57427663	57428017	DNA/hAT-Charlie	696	-	177	57427840	44535
chr11	12139700	12339700	harbor1	chr11	12171774	12172072	DNA/hAT-Charlie	1272	-	149	12171923	32223
chr11	12139700	12339700	harbor1	chr11	12173885	12174161	DNA/hAT-Charlie	1399	-	138	12174023	34323
chr11	12139700	12339700	harbor1	chr11	12181258	12181593	DNA/hAT-Charlie	442	-	168	12181426	41726
chr11	12139700	12339700	harbor1	chr11	12210795	12210999	DNA/hAT-Charlie	879	-	102	12210897	71197
chr11	12139700	12339700	harbor1	chr11	12215433	12215606	DNA/hAT-Charlie	923	-	86	12215519	75819
chr11	12139700	12339700	harbor1	chr11	12227696	12227833	DNA/hAT-Charlie	728	-	68	12227764	88064
chr11	107914515	108114515	harbor1	chr11	107933959	107934145	DNA/hAT-Charlie	637	-	93	107934052	19537
chr11	107914515	108114515	harbor1	chr11	107934454	107934492	DNA/hAT-Charlie	637	-	19	107934473	19958
chr11	68332127	68532127	harbor1	chr11	68386808	68386964	DNA/hAT-Charlie	522	-	78	68386886	54759
chr11	64537994	64737994	harbor1	chr11	64546086	64546250	DNA/hAT-Charlie	942	-	82	64546168	8174
chr11	76580499	76780499	harbor1	chr11	76649880	76650144	DNA/hAT-Charlie	863	-	132	76650012	69513
chr11	76580499	76780499	harbor1	chr11	76675310	76675490	DNA/hAT-Charlie	837	-	90	76675400	94901
chr11	76580347	76780347	harbor1	chr11	76649880	76650144	DNA/hAT-Charlie	863	-	132	76650012	69665
chr11	76580347	76780347	harbor1	chr11	76675310	76675490	DNA/hAT-Charlie	837	-	90	76675400	95053
chr11	34936228	35136228	harbor1	chr11	34953514	34953678	DNA/hAT-Charlie	491	-	82	34953596	17368
chr11	34936228	35136228	harbor1	chr11	34953956	34954312	DNA/hAT-Charlie	904	-	178	34954134	17906
chr11	34936228	35136228	harbor1	chr11	34977567	34977756	DNA/hAT-Charlie	423	-	94	34977661	41433
chr11	34936228	35136228	harbor1	chr11	35034845	35035005	DNA/hAT-Charlie	725	-	80	35034925	98697
chr11	5127117	5327117	harbor1	chr11	5136341	5136518	DNA/hAT-Charlie	814	-	88	5136429	9312
chr11	76580972	76780972	harbor1	chr11	76649880	76650144	DNA/hAT-Charlie	863	-	132	76650012	69040
chr11	76580972	76780972	harbor1	chr11	76675310	76675490	DNA/hAT-Charlie	837	-	90	76675400	94428
chr11	5134657	5334657	harbor1	chr11	5136341	5136518	DNA/hAT-Charlie	814	-	88	5136429	1772
chr11	6201420	6401420	harbor1	chr11	6232867	6233052	DNA/hAT-Charlie	519	-	92	6232959	31539
chr11	108021633	108221633	harbor1	chr11	108067394	108067586	DNA/hAT-Charlie	562	-	96	108067490	45857
chr11	119643264	119843264	harbor1	chr11	119688418	119688605	DNA/hAT-Charlie	702	-	94	119688512	45248
chr11	5127276	5327276	harbor1	chr11	5136341	5136518	DNA/hAT-Charlie	814	-	88	5136429	9153
chr11	19099393	19299393	harbor1	chr11	19122204	19122684	DNA/hAT-Charlie	1027	-	240	19122444	23051
chr11	19099393	19299393	harbor1	chr11	19143759	19144145	DNA/hAT-Charlie	454	-	193	19143952	44559
chr11	19099393	19299393	harbor1	chr11	19192170	19192254	DNA/hAT-Charlie	563	-	42	19192212	92819
chr11	19099393	19299393	harbor1	chr11	19192897	19193028	DNA/hAT-Charlie	685	-	66	19192963	93570
chr11	5134554	5334554	harbor1	chr11	5136341	5136518	DNA/hAT-Charlie	814	-	88	5136429	1875
chr11	6201346	6401346	harbor1	chr11	6232867	6233052	DNA/hAT-Charlie	519	-	92	6232959	31613
chr11	5134601	5334601	harbor1	chr11	5136341	5136518	DNA/hAT-Charlie	814	-	88	5136429	1828
chr11	5036924	5236924	harbor1	chr11	5136341	5136518	DNA/hAT-Charlie	814	-	88	5136429	99505
chr11	70734529	70934529	harbor1	chr11	70761619	70761779	DNA/hAT-Charlie	565	-	80	70761699	27170
chr11	67369231	67569231	harbor1	chr11	67461579	67461852	DNA/hAT-Charlie	729	-	136	67461715	92484
chr11	5127104	5327104	harbor1	chr11	5136341	5136518	DNA/hAT-Charlie	814	-	88	5136429	9325
chr11	66158708	66358708	harbor1	chr11	66178529	66178960	DNA/hAT-Charlie	1463	-	216	66178745	20037
chr11	5127078	5327078	harbor1	chr11	5136341	5136518	DNA/hAT-Charlie	814	-	88	5136429	9351
chr11	70734576	70934576	harbor1	chr11	70761619	70761779	DNA/hAT-Charlie	565	-	80	70761699	27123
chr11	22725288	22925288	harbor1	chr11	22732939	22733098	DNA/hAT-Charlie	632	-	80	22733019	7731
chr11	22725288	22925288	harbor1	chr11	22776230	22776403	DNA/hAT-Charlie	665	-	86	22776316	51028
chr11	22725288	22925288	harbor1	chr11	22788347	22788557	DNA/hAT-Charlie	770	-	105	22788452	63164
chr11	5132790	5332790	harbor1	chr11	5136341	5136518	DNA/hAT-Charlie	814	-	88	5136429	3639
chr11	75668477	75868477	harbor1	chr11	75736805	75737104	DNA/hAT-Charlie	1086	-	150	75736955	68478
chr11	5134186	5334186	harbor1	chr11	5136341	5136518	DNA/hAT-Charlie	814	-	88	5136429	2243
chr11	73042808	73242808	harbor1	chr11	73050046	73050256	DNA/hAT-Charlie	1027	-	105	73050151	7343
chr11	73042808	73242808	harbor1	chr11	73121748	73121933	DNA/hAT-Charlie	818	-	92	73121840	79032
chr11	5126808	5326808	harbor1	chr11	5136341	5136518	DNA/hAT-Charlie	814	-	88	5136429	9621
chr11	119007536	119207536	harbor1	chr11	119010843	119011146	DNA/hAT-Charlie	1752	-	152	119010995	3459
chr11	119007536	119207536	harbor1	chr11	119045899	119045970	DNA/hAT-Charlie	694	-	36	119045935	38399
chr11	119007536	119207536	harbor1	chr11	119046266	119046370	DNA/hAT-Charlie	694	-	52	119046318	38782
chr11	119007536	119207536	harbor1	chr11	119054724	119054933	DNA/hAT-Charlie	1227	-	104	119054828	47292
chr11	69539219	69739219	harbor1	chr11	69612675	69612867	DNA/hAT-Charlie	828	-	96	69612771	73552
chr11	69539219	69739219	harbor1	chr11	69613461	69613771	DNA/hAT-Charlie	828	-	155	69613616	74397
chr11	76581035	76781035	harbor1	chr11	76649880	76650144	DNA/hAT-Charlie	863	-	132	76650012	68977
chr11	76581035	76781035	harbor1	chr11	76675310	76675490	DNA/hAT-Charlie	837	-	90	76675400	94365
chr11	32073529	32273529	harbor1	chr11	32090125	32090297	DNA/hAT-Charlie	736	-	86	32090211	16682
chr11	32073529	32273529	harbor1	chr11	32096028	32096255	DNA/hAT-Charlie	607	-	114	32096142	22613
chr11	32073529	32273529	harbor1	chr11	32140970	32141190	DNA/hAT-Charlie	1430	-	110	32141080	67551
chr11	32073529	32273529	harbor1	chr11	32153833	32154000	DNA/hAT-Charlie	750	-	84	32153917	80388
chr11	32073529	32273529	harbor1	chr11	32169300	32169565	DNA/hAT-Charlie	991	-	132	32169432	95903
chr11	5127131	5327131	harbor1	chr11	5136341	5136518	DNA/hAT-Charlie	814	-	88	5136429	9298
chr11	65513352	65713352	harbor1	chr11	65594395	65594584	DNA/hAT-Charlie	516	-	94	65594489	81137
chr11	69539220	69739220	harbor1	chr11	69612675	69612867	DNA/hAT-Charlie	828	-	96	69612771	73551
chr11	69539220	69739220	harbor1	chr11	69613461	69613771	DNA/hAT-Charlie	828	-	155	69613616	74396
chr11	5125969	5325969	harbor1	chr11	5136341	5136518	DNA/hAT-Charlie	814	-	88	5136429	10460
chr11	68332185	68532185	harbor1	chr11	68386808	68386964	DNA/hAT-Charlie	522	-	78	68386886	54701
chr11	72610267	72810267	harbor1	chr11	72614489	72614675	DNA/hAT-Charlie	1094	-	93	72614582	4315
chr11	72610267	72810267	harbor1	chr11	72691787	72692071	DNA/hAT-Charlie	1708	-	142	72691929	81662
chr11	72610267	72810267	harbor1	chr11	72696093	72696399	DNA/hAT-Charlie	1816	-	153	72696246	85979
chr11	72610267	72810267	harbor1	chr11	72705473	72705625	DNA/hAT-Charlie	569	-	76	72705549	95282
chr11	1448331	1648331	harbor1	chr11	1463462	1463588	DNA/hAT-Charlie	470	-	63	1463525	15194
chr11	1448331	1648331	harbor1	chr11	1522651	1522868	DNA/hAT-Charlie	481	-	108	1522759	74428
chr11	2062911	2262911	harbor1	chr11	2111330	2111482	DNA/hAT-Charlie	440	-	76	2111406	48495
chr11	2062911	2262911	harbor1	chr11	2111965	2112363	DNA/hAT-Charlie	884	-	199	2112164	49253
chr11	2062911	2262911	harbor1	chr11	2113288	2113323	DNA/hAT-Charlie	901	-	18	2113306	50395
chr11	2062911	2262911	harbor1	chr11	2113595	2113908	DNA/hAT-Charlie	901	-	156	2113751	50840
chr11	2062911	2262911	harbor1	chr11	2113942	2114133	DNA/hAT-Charlie	773	-	96	2114038	51127
chr11	3125267	3325267	harbor1	chr11	3208142	3208588	DNA/hAT-Charlie	525	-	223	3208365	83098
chr11	47075637	47275637	harbor1	chr11	47094200	47094270	DNA/hAT-Charlie	929	-	35	47094235	18598
chr11	47075637	47275637	harbor1	chr11	47094656	47094801	DNA/hAT-Charlie	929	-	72	47094728	19091
chr11	47075637	47275637	harbor1	chr11	47123181	47123439	DNA/hAT-Charlie	567	-	129	47123310	47673
chr11	47075637	47275637	harbor1	chr11	47144785	47144960	DNA/hAT-Charlie	1067	-	88	47144873	69236
chr11	47075637	47275637	harbor1	chr11	47167643	47167836	DNA/hAT-Charlie	891	-	96	47167739	92102
chr11	5126984	5326984	harbor1	chr11	5136341	5136518	DNA/hAT-Charlie	814	-	88	5136429	9445
chr11	69498462	69698462	harbor1	chr11	69504344	69504543	DNA/hAT-Charlie	509	-	100	69504444	5982
chr11	5127187	5327187	harbor1	chr11	5136341	5136518	DNA/hAT-Charlie	814	-	88	5136429	9242
chr11	65969885	66169885	harbor1	chr11	66032969	66033175	DNA/hAT-Charlie	994	-	103	66033072	63187
chr11	69575154	69775154	harbor1	chr11	69612675	69612867	DNA/hAT-Charlie	828	-	96	69612771	37617
chr11	69575154	69775154	harbor1	chr11	69613461	69613771	DNA/hAT-Charlie	828	-	155	69613616	38462
chr11	69575154	69775154	harbor1	chr11	69654587	69654716	DNA/hAT-Charlie	448	-	64	69654651	79497
chr11	69575154	69775154	harbor1	chr11	69658853	69659051	DNA/hAT-Charlie	865	-	99	69658952	83798
chr11	33157309	33357309	harbor1	chr11	33206385	33206967	DNA/hAT-Charlie	2081	-	291	33206676	49367
chr11	77964208	78164208	harbor1	chr11	78013813	78013999	DNA/hAT-Charlie	780	-	93	78013906	49698
chr11	77964208	78164208	harbor1	chr11	78015933	78016079	DNA/hAT-Charlie	813	-	73	78016006	51798
chr11	77964208	78164208	harbor1	chr11	78052765	78052892	DNA/hAT-Charlie	475	-	64	78052829	88621
chr11	64537959	64737959	harbor1	chr11	64546086	64546250	DNA/hAT-Charlie	942	-	82	64546168	8209
chr11	5132879	5332879	harbor1	chr11	5136341	5136518	DNA/hAT-Charlie	814	-	88	5136429	3550
chr11	1289639	1489639	harbor1	chr11	1301048	1301393	DNA/hAT-Charlie	651	-	172	1301220	11581
chr11	1289639	1489639	harbor1	chr11	1301430	1301636	DNA/hAT-Charlie	404	-	103	1301533	11894
chr11	6201311	6401311	harbor1	chr11	6232867	6233052	DNA/hAT-Charlie	519	-	92	6232959	31648
chr11	113773432	113973432	harbor1	chr11	113799765	113799881	DNA/hAT-Charlie	486	-	58	113799823	26391
chr11	113773432	113973432	harbor1	chr11	113801753	113801926	DNA/hAT-Charlie	672	-	86	113801839	28407
chr11	113773432	113973432	harbor1	chr11	113801983	113802145	DNA/hAT-Charlie	517	-	81	113802064	28632
chr11	113773432	113973432	harbor1	chr11	113871393	113871604	DNA/hAT-Charlie	814	-	106	113871499	98067
chr11	68880548	69080548	harbor1	chr11	68911077	68911257	DNA/hAT-Charlie	601	-	90	68911167	30619
chr11	5126814	5326814	harbor1	chr11	5136341	5136518	DNA/hAT-Charlie	814	-	88	5136429	9615
chr11	2705362	2905362	harbor1	chr11	2787506	2787859	DNA/hAT-Charlie	1354	-	176	2787682	82320
chr11	5132579	5332579	harbor1	chr11	5136341	5136518	DNA/hAT-Charlie	814	-	88	5136429	3850
chr11	9360652	9560652	harbor1	chr11	9420812	9420948	DNA/hAT-Charlie	541	-	68	9420880	60228
chr11	9360652	9560652	harbor1	chr11	9421261	9421365	DNA/hAT-Charlie	509	-	52	9421313	60661
chr11	9360652	9560652	harbor1	chr11	9421640	9421662	DNA/hAT-Charlie	556	-	11	9421651	60999
chr11	9360652	9560652	harbor1	chr11	9421957	9421997	DNA/hAT-Charlie	556	-	20	9421977	61325
chr11	9360652	9560652	harbor1	chr11	9422243	9422258	DNA/hAT-Charlie	556	-	8	9422251	61599
chr11	9360652	9560652	harbor1	chr11	9422298	9422513	DNA/hAT-Charlie	556	-	108	9422406	61754
chr11	9360652	9560652	harbor1	chr11	9429927	9430213	DNA/hAT-Charlie	1550	-	143	9430070	69418
chr11	3984543	4184543	harbor1	chr11	3998901	3999063	DNA/hAT-Charlie	1023	-	81	3998982	14439
chr11	3984543	4184543	harbor1	chr11	3999336	3999384	DNA/hAT-Charlie	1023	-	24	3999360	14817
chr11	3984543	4184543	harbor1	chr11	4048228	4048443	DNA/hAT-Charlie	839	-	108	4048336	63793
chr11	3984543	4184543	harbor1	chr11	4048474	4048668	DNA/hAT-Charlie	627	-	97	4048571	64028
chr11	3984543	4184543	harbor1	chr11	4078535	4078569	DNA/hAT-Charlie	780	-	17	4078552	94009
chr11	3984543	4184543	harbor1	chr11	4078870	4079010	DNA/hAT-Charlie	780	-	70	4078940	94397
chr11	3984543	4184543	harbor1	chr11	4079595	4079668	DNA/hAT-Charlie	780	-	36	4079631	95088
chr11	5127120	5327120	harbor1	chr11	5136341	5136518	DNA/hAT-Charlie	814	-	88	5136429	9309
chr11	76580334	76780334	harbor1	chr11	76649880	76650144	DNA/hAT-Charlie	863	-	132	76650012	69678
chr11	76580334	76780334	harbor1	chr11	76675310	76675490	DNA/hAT-Charlie	837	-	90	76675400	95066
chr11	64538041	64738041	harbor1	chr11	64546086	64546250	DNA/hAT-Charlie	942	-	82	64546168	8127
chr11	69539244	69739244	harbor1	chr11	69612675	69612867	DNA/hAT-Charlie	828	-	96	69612771	73527
chr11	69539244	69739244	harbor1	chr11	69613461	69613771	DNA/hAT-Charlie	828	-	155	69613616	74372
chr11	64218129	64418129	harbor1	chr11	64277779	64278005	DNA/hAT-Charlie	639	-	113	64277892	59763
chr11	68332140	68532140	harbor1	chr11	68386808	68386964	DNA/hAT-Charlie	522	-	78	68386886	54746
chr11	3116372	3316372	harbor1	chr11	3208142	3208588	DNA/hAT-Charlie	525	-	223	3208365	91993
chr11	7933373	8133373	harbor1	chr11	7954686	7954844	DNA/hAT-Charlie	912	-	79	7954765	21392
chr11	7933373	8133373	harbor1	chr11	7990302	7990445	DNA/hAT-Charlie	738	-	72	7990374	57001
chr11	7933373	8133373	harbor1	chr11	7995575	7995734	DNA/hAT-Charlie	670	-	80	7995655	62282
chr11	7933373	8133373	harbor1	chr11	8017788	8018103	DNA/hAT-Charlie	717	-	158	8017946	84573
chr11	122556267	122756267	harbor1	chr11	122561018	122561082	DNA/hAT-Charlie	621	-	32	122561050	4783
chr11	122556267	122756267	harbor1	chr11	122561369	122561460	DNA/hAT-Charlie	621	-	46	122561415	5148
chr11	122556267	122756267	harbor1	chr11	122599993	122600148	DNA/hAT-Charlie	591	-	78	122600071	43804
chr11	76580627	76780627	harbor1	chr11	76649880	76650144	DNA/hAT-Charlie	863	-	132	76650012	69385
chr11	76580627	76780627	harbor1	chr11	76675310	76675490	DNA/hAT-Charlie	837	-	90	76675400	94773
chr11	5127220	5327220	harbor1	chr11	5136341	5136518	DNA/hAT-Charlie	814	-	88	5136429	9209
chr11	5127275	5327275	harbor1	chr11	5136341	5136518	DNA/hAT-Charlie	814	-	88	5136429	9154
chr11	76575076	76775076	harbor1	chr11	76577988	76578136	DNA/hAT-Charlie	694	-	74	76578062	2986
chr11	76575076	76775076	harbor1	chr11	76649880	76650144	DNA/hAT-Charlie	863	-	132	76650012	74936
chr11	7520537	7720537	harbor1	chr11	7557769	7557877	DNA/hAT-Charlie	438	-	54	7557823	37286
chr11	7520537	7720537	harbor1	chr11	7561904	7562244	DNA/hAT-Charlie	2210	-	170	7562074	41537
chr11	7520537	7720537	harbor1	chr11	7600728	7600970	DNA/hAT-Charlie	737	-	121	7600849	80312
chr11	32939956	33139956	harbor1	chr11	32958913	32959040	DNA/hAT-Charlie	686	-	64	32958977	19021
chr11	32939956	33139956	harbor1	chr11	32960898	32961440	DNA/hAT-Charlie	1136	-	271	32961169	21213
chr11	32939956	33139956	harbor1	chr11	32962653	32963142	DNA/hAT-Charlie	2232	-	244	32962897	22941
chr11	32939956	33139956	harbor1	chr11	32964278	32964537	DNA/hAT-Charlie	846	-	130	32964408	24452
chr11	32939956	33139956	harbor1	chr11	33019169	33019352	DNA/hAT-Charlie	940	-	92	33019261	79305
chr11	5127188	5327188	harbor1	chr11	5136341	5136518	DNA/hAT-Charlie	814	-	88	5136429	9241
chr11	76580968	76780968	harbor1	chr11	76649880	76650144	DNA/hAT-Charlie	863	-	132	76650012	69044
chr11	76580968	76780968	harbor1	chr11	76675310	76675490	DNA/hAT-Charlie	837	-	90	76675400	94432
chr11	9413280	9613280	harbor1	chr11	9420812	9420948	DNA/hAT-Charlie	541	-	68	9420880	7600
chr11	9413280	9613280	harbor1	chr11	9421261	9421365	DNA/hAT-Charlie	509	-	52	9421313	8033
chr11	9413280	9613280	harbor1	chr11	9421640	9421662	DNA/hAT-Charlie	556	-	11	9421651	8371
chr11	9413280	9613280	harbor1	chr11	9421957	9421997	DNA/hAT-Charlie	556	-	20	9421977	8697
chr11	9413280	9613280	harbor1	chr11	9422243	9422258	DNA/hAT-Charlie	556	-	8	9422251	8971
chr11	9413280	9613280	harbor1	chr11	9422298	9422513	DNA/hAT-Charlie	556	-	108	9422406	9126
chr11	9413280	9613280	harbor1	chr11	9429927	9430213	DNA/hAT-Charlie	1550	-	143	9430070	16790
chr11	9413280	9613280	harbor1	chr11	9506480	9506618	DNA/hAT-Charlie	506	-	69	9506549	93269
chr11	64752705	64952705	harbor1	chr11	64814707	64814903	DNA/hAT-Charlie	928	-	98	64814805	62100
chr11	64752705	64952705	harbor1	chr11	64816318	64816343	DNA/hAT-Charlie	794	-	12	64816330	63625
chr11	64752705	64952705	harbor1	chr11	64816660	64816750	DNA/hAT-Charlie	794	-	45	64816705	64000
chr11	64752705	64952705	harbor1	chr11	64817361	64817501	DNA/hAT-Charlie	794	-	70	64817431	64726
chr11	16505283	16705283	harbor1	chr11	16596719	16596877	DNA/hAT-Charlie	603	-	79	16596798	91515
chr11	5127127	5327127	harbor1	chr11	5136341	5136518	DNA/hAT-Charlie	814	-	88	5136429	9302
chr11	3160998	3360998	harbor1	chr11	3208142	3208588	DNA/hAT-Charlie	525	-	223	3208365	47367
chr11	3160998	3360998	harbor1	chr11	3249064	3249395	DNA/hAT-Charlie	2156	-	166	3249230	88232
chr11	2054535	2254535	harbor1	chr11	2111330	2111482	DNA/hAT-Charlie	440	-	76	2111406	56871
chr11	2054535	2254535	harbor1	chr11	2111965	2112363	DNA/hAT-Charlie	884	-	199	2112164	57629
chr11	2054535	2254535	harbor1	chr11	2113288	2113323	DNA/hAT-Charlie	901	-	18	2113306	58771
chr11	2054535	2254535	harbor1	chr11	2113595	2113908	DNA/hAT-Charlie	901	-	156	2113751	59216
chr11	2054535	2254535	harbor1	chr11	2113942	2114133	DNA/hAT-Charlie	773	-	96	2114038	59503
chr11	65286790	65486790	harbor1	chr11	65373450	65373592	DNA/hAT-Charlie	718	-	71	65373521	86731
chr11	65286790	65486790	harbor1	chr11	65373888	65373942	DNA/hAT-Charlie	718	-	27	65373915	87125
chr11	64537966	64737966	harbor1	chr11	64546086	64546250	DNA/hAT-Charlie	942	-	82	64546168	8202
chr11	66158664	66358664	harbor1	chr11	66178529	66178960	DNA/hAT-Charlie	1463	-	216	66178745	20081
chr11	67172339	67372339	harbor1	chr11	67220510	67220665	DNA/hAT-Charlie	687	-	78	67220588	48249
chr11	67172339	67372339	harbor1	chr11	67220666	67220913	DNA/hAT-Charlie	1129	-	124	67220790	48451
chr11	67172339	67372339	harbor1	chr11	67244588	67244703	DNA/hAT-Charlie	625	-	58	67244646	72307
chr11	67172339	67372339	harbor1	chr11	67245003	67245094	DNA/hAT-Charlie	625	-	46	67245049	72710
chr11	67172318	67372318	harbor1	chr11	67220510	67220665	DNA/hAT-Charlie	687	-	78	67220588	48270
chr11	67172318	67372318	harbor1	chr11	67220666	67220913	DNA/hAT-Charlie	1129	-	124	67220790	48472
chr11	67172318	67372318	harbor1	chr11	67244588	67244703	DNA/hAT-Charlie	625	-	58	67244646	72328
chr11	67172318	67372318	harbor1	chr11	67245003	67245094	DNA/hAT-Charlie	625	-	46	67245049	72731
chr11	64348428	64548428	harbor1	chr11	64355830	64355938	DNA/hAT-Charlie	496	-	54	64355884	7456
chr11	64348428	64548428	harbor1	chr11	64428419	64428586	DNA/hAT-Charlie	1160	-	84	64428503	80075
chr11	64348428	64548428	harbor1	chr11	64435133	64435275	DNA/hAT-Charlie	547	-	71	64435204	86776
chr11	64348428	64548428	harbor1	chr11	64435304	64435511	DNA/hAT-Charlie	963	-	104	64435408	86980
chr11	64348428	64548428	harbor1	chr11	64447976	64448124	DNA/hAT-Charlie	736	-	74	64448050	99622
chr11	1472008	1672008	harbor1	chr11	1522651	1522868	DNA/hAT-Charlie	481	-	108	1522759	50751
chr11	69112726	69312726	harbor1	chr11	69125064	69125290	DNA/hAT-Charlie	862	-	113	69125177	12451
chr11	69112726	69312726	harbor1	chr11	69136987	69137201	DNA/hAT-Charlie	1132	-	107	69137094	24368
chr11	69539269	69739269	harbor1	chr11	69612675	69612867	DNA/hAT-Charlie	828	-	96	69612771	73502
chr11	69539269	69739269	harbor1	chr11	69613461	69613771	DNA/hAT-Charlie	828	-	155	69613616	74347
chr11	47452991	47652991	harbor1	chr11	47494781	47494917	DNA/hAT-Charlie	653	-	68	47494849	41858
chr11	47452991	47652991	harbor1	chr11	47495050	47495099	DNA/hAT-Charlie	653	-	24	47495074	42083
chr11	47452991	47652991	harbor1	chr11	47506033	47506144	DNA/hAT-Charlie	1181	-	56	47506089	53098
chr11	47452991	47652991	harbor1	chr11	47506448	47506544	DNA/hAT-Charlie	1181	-	48	47506496	53505
chr11	5127170	5327170	harbor1	chr11	5136341	5136518	DNA/hAT-Charlie	814	-	88	5136429	9259
chr11	5127159	5327159	harbor1	chr11	5136341	5136518	DNA/hAT-Charlie	814	-	88	5136429	9270
chr11	46818647	47018647	harbor1	chr11	46884222	46884302	DNA/hAT-Charlie	451	-	40	46884262	65615
chr11	46818647	47018647	harbor1	chr11	46885297	46885369	DNA/hAT-Charlie	554	-	36	46885333	66686
chr11	9513814	9713814	harbor1	chr11	9594091	9594631	DNA/hAT-Charlie	3479	-	270	9594361	80547
chr11	19613809	19813809	harbor1	chr11	19663888	19664079	DNA/hAT-Charlie	503	-	96	19663984	50175
chr11	19613809	19813809	harbor1	chr11	19671636	19671844	DNA/hAT-Charlie	1134	-	104	19671740	57931
chr11	19613809	19813809	harbor1	chr11	19691011	19691165	DNA/hAT-Charlie	729	-	77	19691088	77279
chr11	19613809	19813809	harbor1	chr11	19691182	19691481	DNA/hAT-Charlie	1446	-	150	19691332	77523
chr11	19613809	19813809	harbor1	chr11	19703796	19703934	DNA/hAT-Charlie	454	-	69	19703865	90056
chr11	19613809	19813809	harbor1	chr11	19710473	19710639	DNA/hAT-Charlie	895	-	83	19710556	96747
chr11	5125968	5325968	harbor1	chr11	5136341	5136518	DNA/hAT-Charlie	814	-	88	5136429	10461
chr11	5127290	5327290	harbor1	chr11	5136341	5136518	DNA/hAT-Charlie	814	-	88	5136429	9139
chr11	1289622	1489622	harbor1	chr11	1301048	1301393	DNA/hAT-Charlie	651	-	172	1301220	11598
chr11	1289622	1489622	harbor1	chr11	1301430	1301636	DNA/hAT-Charlie	404	-	103	1301533	11911
chr11	5126787	5326787	harbor1	chr11	5136341	5136518	DNA/hAT-Charlie	814	-	88	5136429	9642
chr11	64538002	64738002	harbor1	chr11	64546086	64546250	DNA/hAT-Charlie	942	-	82	64546168	8166
chr11	67368631	67568631	harbor1	chr11	67461579	67461852	DNA/hAT-Charlie	729	-	136	67461715	93084
chr11	5134597	5334597	harbor1	chr11	5136341	5136518	DNA/hAT-Charlie	814	-	88	5136429	1832
chr11	86572183	86772183	harbor1	chr11	86626618	86626805	DNA/hAT-Charlie	908	-	94	86626712	54529
chr11	86572183	86772183	harbor1	chr11	86642773	86643056	DNA/hAT-Charlie	885	-	142	86642915	70732
chr11	47085613	47285613	harbor1	chr11	47094200	47094270	DNA/hAT-Charlie	929	-	35	47094235	8622
chr11	47085613	47285613	harbor1	chr11	47094656	47094801	DNA/hAT-Charlie	929	-	72	47094728	9115
chr11	47085613	47285613	harbor1	chr11	47123181	47123439	DNA/hAT-Charlie	567	-	129	47123310	37697
chr11	47085613	47285613	harbor1	chr11	47144785	47144960	DNA/hAT-Charlie	1067	-	88	47144873	59260
chr11	47085613	47285613	harbor1	chr11	47167643	47167836	DNA/hAT-Charlie	891	-	96	47167739	82126
chr12	55898013	56098013	harbor1	chr12	55905999	55906617	DNA/hAT-Charlie	2914	-	309	55906308	8295
chr12	123133097	123333097	harbor1	chr12	123172146	123172328	DNA/hAT-Charlie	1322	-	91	123172237	39140
chr12	123133097	123333097	harbor1	chr12	123172633	123172773	DNA/hAT-Charlie	1322	-	70	123172703	39606
chr12	2940625	3140625	harbor1	chr12	2969887	2969944	DNA/hAT-Charlie	956	-	28	2969915	29290
chr12	2940625	3140625	harbor1	chr12	2970078	2970294	DNA/hAT-Charlie	956	-	108	2970186	29561
chr12	12257335	12457335	harbor1	chr12	12290696	12290869	DNA/hAT-Charlie	1014	-	86	12290782	33447
chr12	12257335	12457335	harbor1	chr12	12306803	12307004	DNA/hAT-Charlie	904	-	100	12306903	49568
chr12	12257335	12457335	harbor1	chr12	12317809	12317961	DNA/hAT-Charlie	621	-	76	12317885	60550
chr12	12257335	12457335	harbor1	chr12	12347015	12347515	DNA/hAT-Charlie	3402	-	250	12347265	89930
chr12	12257335	12457335	harbor1	chr12	12348931	12349207	DNA/hAT-Charlie	1066	-	138	12349069	91734
chr12	68421784	68621784	harbor1	chr12	68448767	68448966	DNA/hAT-Charlie	1529	-	100	68448867	27083
chr12	68421784	68621784	harbor1	chr12	68460362	68460579	DNA/hAT-Charlie	1118	-	108	68460470	38686
chr12	130738919	130938919	harbor1	chr12	130746432	130746732	DNA/hAT-Charlie	1669	-	150	130746582	7663
chr12	130738919	130938919	harbor1	chr12	130769671	130770102	DNA/hAT-Charlie	729	-	216	130769887	30968
chr12	130738919	130938919	harbor1	chr12	130823778	130824083	DNA/hAT-Charlie	724	-	152	130823930	85011
chr12	130738919	130938919	harbor1	chr12	130837940	130838107	DNA/hAT-Charlie	880	-	84	130838024	99105
chr12	130061504	130261504	harbor1	chr12	130123669	130123890	DNA/hAT-Charlie	1545	-	110	130123779	62275
chr12	130061504	130261504	harbor1	chr12	130143906	130143990	DNA/hAT-Charlie	641	-	42	130143948	82444
chr12	130061504	130261504	harbor1	chr12	130144303	130144391	DNA/hAT-Charlie	641	-	44	130144347	82843
chr12	130061504	130261504	harbor1	chr12	130146608	130146809	DNA/hAT-Charlie	878	-	100	130146708	85204
chr12	69779300	69979300	harbor1	chr12	69792931	69793256	DNA/hAT-Charlie	1051	-	162	69793093	13793
chr12	69779300	69979300	harbor1	chr12	69814467	69814654	DNA/hAT-Charlie	1038	-	94	69814561	35261
chr12	69779300	69979300	harbor1	chr12	69873144	69873365	DNA/hAT-Charlie	1386	-	110	69873254	93954
chr12	89254167	89454167	harbor1	chr12	89255998	89256206	DNA/hAT-Charlie	1164	-	104	89256102	1935
chr12	89254167	89454167	harbor1	chr12	89262167	89262382	DNA/hAT-Charlie	759	-	108	89262275	8108
chr12	89254167	89454167	harbor1	chr12	89268538	89268751	DNA/hAT-Charlie	961	-	106	89268644	14477
chr12	89254167	89454167	harbor1	chr12	89278164	89278620	DNA/hAT-Charlie	884	-	228	89278392	24225
chr12	53851036	54051036	harbor1	chr12	53852595	53852774	DNA/hAT-Charlie	729	-	90	53852685	1649
chr12	1496692	1696692	harbor1	chr12	1496831	1497155	DNA/hAT-Charlie	922	-	162	1496993	301
chr12	1496692	1696692	harbor1	chr12	1509270	1509451	DNA/hAT-Charlie	748	-	90	1509360	12668
chr12	1496692	1696692	harbor1	chr12	1538986	1539171	DNA/hAT-Charlie	1004	-	92	1539078	42386
chr12	47713189	47913189	harbor1	chr12	47717286	47717464	DNA/hAT-Charlie	896	-	89	47717375	4186
chr12	47713189	47913189	harbor1	chr12	47721098	47721405	DNA/hAT-Charlie	1055	-	154	47721252	8063
chr12	47713189	47913189	harbor1	chr12	47769884	47770041	DNA/hAT-Charlie	789	-	78	47769962	56773
chr12	47713189	47913189	harbor1	chr12	47778688	47778995	DNA/hAT-Charlie	716	-	154	47778842	65653
chr12	10623688	10823688	harbor1	chr12	10629159	10629355	DNA/hAT-Charlie	877	-	98	10629257	5569
chr12	121711754	121911754	harbor1	chr12	121740861	121741177	DNA/hAT-Charlie	1350	-	158	121741019	29265
chr12	121711754	121911754	harbor1	chr12	121745006	121745156	DNA/hAT-Charlie	658	-	75	121745081	33327
chr12	121711754	121911754	harbor1	chr12	121777626	121777833	DNA/hAT-Charlie	883	-	104	121777730	65976
chr12	6248395	6448395	harbor1	chr12	6255358	6255544	DNA/hAT-Charlie	815	-	93	6255451	7056
chr12	96299297	96499297	harbor1	chr12	96315119	96315415	DNA/hAT-Charlie	592	-	148	96315267	15970
chr12	96299297	96499297	harbor1	chr12	96326573	96326759	DNA/hAT-Charlie	1016	-	93	96326666	27369
chr12	96299297	96499297	harbor1	chr12	96353354	96353713	DNA/hAT-Charlie	1031	-	180	96353534	54237
chr12	122759135	122959135	harbor1	chr12	122779422	122779580	DNA/hAT-Charlie	868	-	79	122779501	20366
chr12	122759135	122959135	harbor1	chr12	122839609	122839926	DNA/hAT-Charlie	1427	-	158	122839767	80632
chr12	64467190	64667190	harbor1	chr12	64470169	64470540	DNA/hAT-Charlie	1148	-	186	64470355	3165
chr12	64467190	64667190	harbor1	chr12	64472668	64472901	DNA/hAT-Charlie	1255	-	116	64472784	5594
chr13	94612331	94812331	harbor1	chr13	94618549	94618731	DNA/hAT-Charlie	731	-	91	94618640	6309
chr13	94612331	94812331	harbor1	chr13	94687751	94687971	DNA/hAT-Charlie	838	-	110	94687861	75530
chr13	36893557	37093557	harbor1	chr13	36895345	36895563	DNA/hAT-Charlie	928	-	109	36895454	1897
chr13	100574884	100774884	harbor1	chr13	100590925	100591027	DNA/hAT-Charlie	506	-	51	100590976	16092
chr13	100574884	100774884	harbor1	chr13	100599921	100600230	DNA/hAT-Charlie	1268	-	154	100600075	25191
chr13	100574884	100774884	harbor1	chr13	100601292	100601484	DNA/hAT-Charlie	661	-	96	100601388	26504
chr13	100574884	100774884	harbor1	chr13	100639986	100640128	DNA/hAT-Charlie	529	-	71	100640057	65173
chr13	100574884	100774884	harbor1	chr13	100645787	100646021	DNA/hAT-Charlie	763	-	117	100645904	71020
chr13	100574884	100774884	harbor1	chr13	100646633	100647042	DNA/hAT-Charlie	774	-	204	100646837	71953
chr13	44477883	44677883	harbor1	chr13	44502426	44502615	DNA/hAT-Charlie	721	-	94	44502520	24637
chr13	20315145	20515145	harbor1	chr13	20372461	20372623	DNA/hAT-Charlie	618	-	81	20372542	57397
chr13	27728634	27928634	harbor1	chr13	27743097	27743206	DNA/hAT-Charlie	640	-	54	27743151	14517
chr13	27728634	27928634	harbor1	chr13	27798346	27798550	DNA/hAT-Charlie	1078	-	102	27798448	69814
chr13	27728634	27928634	harbor1	chr13	27813471	27813580	DNA/hAT-Charlie	525	-	54	27813525	84891
chr13	20314698	20514698	harbor1	chr13	20372461	20372623	DNA/hAT-Charlie	618	-	81	20372542	57844
chr13	20315192	20515192	harbor1	chr13	20372461	20372623	DNA/hAT-Charlie	618	-	81	20372542	57350
chr13	48133654	48333654	harbor1	chr13	48156217	48156438	DNA/hAT-Charlie	598	-	110	48156327	22673
chr13	48133654	48333654	harbor1	chr13	48179595	48180340	DNA/hAT-Charlie	1272	-	372	48179967	46313
chr13	48133654	48333654	harbor1	chr13	48211856	48212110	DNA/hAT-Charlie	979	-	127	48211983	78329
chr13	100574881	100774881	harbor1	chr13	100590925	100591027	DNA/hAT-Charlie	506	-	51	100590976	16095
chr13	100574881	100774881	harbor1	chr13	100599921	100600230	DNA/hAT-Charlie	1268	-	154	100600075	25194
chr13	100574881	100774881	harbor1	chr13	100601292	100601484	DNA/hAT-Charlie	661	-	96	100601388	26507
chr13	100574881	100774881	harbor1	chr13	100639986	100640128	DNA/hAT-Charlie	529	-	71	100640057	65176
chr13	100574881	100774881	harbor1	chr13	100645787	100646021	DNA/hAT-Charlie	763	-	117	100645904	71023
chr13	100574881	100774881	harbor1	chr13	100646633	100647042	DNA/hAT-Charlie	774	-	204	100646837	71956
chr13	100574914	100774914	harbor1	chr13	100590925	100591027	DNA/hAT-Charlie	506	-	51	100590976	16062
chr13	100574914	100774914	harbor1	chr13	100599921	100600230	DNA/hAT-Charlie	1268	-	154	100600075	25161
chr13	100574914	100774914	harbor1	chr13	100601292	100601484	DNA/hAT-Charlie	661	-	96	100601388	26474
chr13	100574914	100774914	harbor1	chr13	100639986	100640128	DNA/hAT-Charlie	529	-	71	100640057	65143
chr13	100574914	100774914	harbor1	chr13	100645787	100646021	DNA/hAT-Charlie	763	-	117	100645904	70990
chr13	100574914	100774914	harbor1	chr13	100646633	100647042	DNA/hAT-Charlie	774	-	204	100646837	71923
chr13	20315123	20515123	harbor1	chr13	20372461	20372623	DNA/hAT-Charlie	618	-	81	20372542	57419
chr13	94612324	94812324	harbor1	chr13	94618549	94618731	DNA/hAT-Charlie	731	-	91	94618640	6316
chr13	94612324	94812324	harbor1	chr13	94687751	94687971	DNA/hAT-Charlie	838	-	110	94687861	75537
chr13	98425553	98625553	harbor1	chr13	98447507	98447666	DNA/hAT-Charlie	662	-	80	98447587	22034
chr13	98425553	98625553	harbor1	chr13	98462977	98463073	DNA/hAT-Charlie	423	-	48	98463025	37472
chr13	98425553	98625553	harbor1	chr13	98486513	98486715	DNA/hAT-Charlie	604	-	101	98486614	61061
chr13	98425553	98625553	harbor1	chr13	98522988	98523158	DNA/hAT-Charlie	647	-	85	98523073	97520
chr13	51810106	52010106	harbor1	chr13	51894682	51895207	DNA/hAT-Charlie	4016	-	262	51894944	84838
chr13	51810106	52010106	harbor1	chr13	51904904	51905113	DNA/hAT-Charlie	877	-	104	51905008	94902
chr13	27707987	27907987	harbor1	chr13	27724200	27724374	DNA/hAT-Charlie	614	-	87	27724287	16300
chr13	27707987	27907987	harbor1	chr13	27743097	27743206	DNA/hAT-Charlie	640	-	54	27743151	35164
chr13	27707987	27907987	harbor1	chr13	27798346	27798550	DNA/hAT-Charlie	1078	-	102	27798448	90461
chr13	28720365	28920365	harbor1	chr13	28747072	28747225	DNA/hAT-Charlie	575	-	76	28747148	26783
chr13	99473104	99673104	harbor1	chr13	99514671	99514843	DNA/hAT-Charlie	712	-	86	99514757	41653
chr13	19461422	19661422	harbor1	chr13	19466154	19466336	DNA/hAT-Charlie	605	-	91	19466245	4823
chr13	21574752	21774752	harbor1	chr13	21599771	21600141	DNA/hAT-Charlie	947	-	185	21599956	25204
chr13	21574752	21774752	harbor1	chr13	21608334	21608648	DNA/hAT-Charlie	608	-	157	21608491	33739
chr13	21574752	21774752	harbor1	chr13	21611871	21612113	DNA/hAT-Charlie	874	-	121	21611992	37240
chr13	21574752	21774752	harbor1	chr13	21612343	21612717	DNA/hAT-Charlie	1081	-	187	21612530	37778
chr13	21574752	21774752	harbor1	chr13	21613021	21613224	DNA/hAT-Charlie	1081	-	102	21613123	38371
chr13	21574752	21774752	harbor1	chr13	21617897	21618053	DNA/hAT-Charlie	565	-	78	21617975	43223
chr13	21574752	21774752	harbor1	chr13	21618651	21618860	DNA/hAT-Charlie	1091	-	104	21618755	44003
chr13	20315141	20515141	harbor1	chr13	20372461	20372623	DNA/hAT-Charlie	618	-	81	20372542	57401
chr13	20315163	20515163	harbor1	chr13	20372461	20372623	DNA/hAT-Charlie	618	-	81	20372542	57379
chr13	100574912	100774912	harbor1	chr13	100590925	100591027	DNA/hAT-Charlie	506	-	51	100590976	16064
chr13	100574912	100774912	harbor1	chr13	100599921	100600230	DNA/hAT-Charlie	1268	-	154	100600075	25163
chr13	100574912	100774912	harbor1	chr13	100601292	100601484	DNA/hAT-Charlie	661	-	96	100601388	26476
chr13	100574912	100774912	harbor1	chr13	100639986	100640128	DNA/hAT-Charlie	529	-	71	100640057	65145
chr13	100574912	100774912	harbor1	chr13	100645787	100646021	DNA/hAT-Charlie	763	-	117	100645904	70992
chr13	100574912	100774912	harbor1	chr13	100646633	100647042	DNA/hAT-Charlie	774	-	204	100646837	71925
chr13	72959194	73159194	harbor1	chr13	73005730	73005912	DNA/hAT-Charlie	543	-	91	73005821	46627
chr13	72959194	73159194	harbor1	chr13	73010170	73010318	DNA/hAT-Charlie	437	-	74	73010244	51050
chr13	72959194	73159194	harbor1	chr13	73016685	73016706	DNA/hAT-Charlie	488	-	10	73016695	57501
chr13	72959194	73159194	harbor1	chr13	73017009	73017144	DNA/hAT-Charlie	488	-	68	73017077	57883
chr13	72959194	73159194	harbor1	chr13	73035760	73035927	DNA/hAT-Charlie	435	-	84	73035844	76650
chr13	112670833	112870833	harbor1	chr13	112728018	112728188	DNA/hAT-Charlie	614	-	85	112728103	57270
chr13	112670833	112870833	harbor1	chr13	112735466	112735837	DNA/hAT-Charlie	567	-	186	112735652	64819
chr13	112670833	112870833	harbor1	chr13	112755070	112755259	DNA/hAT-Charlie	595	-	94	112755164	84331
chr13	112670833	112870833	harbor1	chr13	112766210	112766400	DNA/hAT-Charlie	1428	-	95	112766305	95472
chr13	19984869	20184869	harbor1	chr13	20022825	20023219	DNA/hAT-Charlie	1060	-	197	20023022	38153
chr13	19984869	20184869	harbor1	chr13	20073235	20073335	DNA/hAT-Charlie	485	-	50	20073285	88416
chr13	19984869	20184869	harbor1	chr13	20084351	20084540	DNA/hAT-Charlie	641	-	94	20084445	99576
chr13	75438285	75638285	harbor1	chr13	75457300	75457506	DNA/hAT-Charlie	830	-	103	75457403	19118
chr13	75438285	75638285	harbor1	chr13	75470151	75470323	DNA/hAT-Charlie	756	-	86	75470237	31952
chr13	20315167	20515167	harbor1	chr13	20372461	20372623	DNA/hAT-Charlie	618	-	81	20372542	57375
chr14	102975689	103175689	harbor1	chr14	102991902	102992102	DNA/hAT-Charlie	927	-	100	102992002	16313
chr14	102975689	103175689	harbor1	chr14	103017945	103018277	DNA/hAT-Charlie	1992	-	166	103018111	42422
chr14	102975689	103175689	harbor1	chr14	103061519	103061729	DNA/hAT-Charlie	1108	-	105	103061624	85935
chr14	99103274	99303274	harbor1	chr14	99141851	99141897	DNA/hAT-Charlie	451	-	23	99141874	38600
chr14	99103274	99303274	harbor1	chr14	99142474	99142557	DNA/hAT-Charlie	451	-	42	99142516	39242
chr14	99103274	99303274	harbor1	chr14	99142844	99142986	DNA/hAT-Charlie	451	-	71	99142915	39641
chr14	99103274	99303274	harbor1	chr14	99155144	99155602	DNA/hAT-Charlie	890	-	229	99155373	52099
chr14	99103274	99303274	harbor1	chr14	99168934	99169103	DNA/hAT-Charlie	724	-	84	99169018	65744
chr14	99103274	99303274	harbor1	chr14	99176627	99176851	DNA/hAT-Charlie	1013	-	112	99176739	73465
chr14	105492607	105692607	harbor1	chr14	105505552	105505987	DNA/hAT-Charlie	1575	-	218	105505770	13163
chr14	105492607	105692607	harbor1	chr14	105506574	105506704	DNA/hAT-Charlie	1575	-	65	105506639	14032
chr14	99486023	99686023	harbor1	chr14	99487292	99487507	DNA/hAT-Charlie	1277	-	108	99487400	1377
chr14	24016236	24216236	harbor1	chr14	24050069	24050193	DNA/hAT-Charlie	523	-	62	24050131	33895
chr14	24016236	24216236	harbor1	chr14	24065999	24066273	DNA/hAT-Charlie	608	-	137	24066136	49900
chr14	24016236	24216236	harbor1	chr14	24083677	24083889	DNA/hAT-Charlie	503	-	106	24083783	67547
chr14	24016236	24216236	harbor1	chr14	24105938	24106097	DNA/hAT-Charlie	847	-	80	24106018	89782
chr14	24016236	24216236	harbor1	chr14	24035191	24035386	DNA/hAT-Charlie	611	-	98	24035289	19053
chr14	88724597	88924597	harbor1	chr14	88727068	88727392	DNA/hAT-Charlie	1580	-	162	88727230	2633
chr14	88724597	88924597	harbor1	chr14	88735131	88735302	DNA/hAT-Charlie	766	-	86	88735217	10620
chr14	88724597	88924597	harbor1	chr14	88768847	88768978	DNA/hAT-Charlie	774	-	66	88768913	44316
chr14	88724597	88924597	harbor1	chr14	88773774	88773836	DNA/hAT-Charlie	632	-	31	88773805	49208
chr14	88724597	88924597	harbor1	chr14	88774147	88774286	DNA/hAT-Charlie	632	-	70	88774217	49620
chr14	103423043	103623043	harbor1	chr14	103458063	103458175	DNA/hAT-Charlie	1247	-	56	103458119	35076
chr14	103423043	103623043	harbor1	chr14	103458479	103458593	DNA/hAT-Charlie	1247	-	57	103458536	35493
chr14	66383081	66583081	harbor1	chr14	66429090	66429317	DNA/hAT-Charlie	465	-	114	66429204	46123
chr14	66383081	66583081	harbor1	chr14	66462147	66462428	DNA/hAT-Charlie	654	-	140	66462287	79206
chr14	66383081	66583081	harbor1	chr14	66481205	66482138	DNA/hAT-Charlie	3328	-	466	66481671	98590
chr14	66383081	66583081	harbor1	chr14	66482144	66482470	DNA/hAT-Charlie	869	-	163	66482307	99226
chr14	99583656	99783656	harbor1	chr14	99610923	99611057	DNA/hAT-Charlie	577	-	67	99610990	27334
chr14	99583656	99783656	harbor1	chr14	99677947	99678300	DNA/hAT-Charlie	2113	-	176	99678123	94467
chr14	99583656	99783656	harbor1	chr14	99680305	99680463	DNA/hAT-Charlie	530	-	79	99680384	96728
chr14	99583656	99783656	harbor1	chr14	99680480	99680646	DNA/hAT-Charlie	1377	-	83	99680563	96907
chr14	99583656	99783656	harbor1	chr14	99680958	99681097	DNA/hAT-Charlie	1377	-	70	99681028	97372
chr14	100183362	100383362	harbor1	chr14	100199646	100199792	DNA/hAT-Charlie	607	-	73	100199719	16357
chr14	75327984	75527984	harbor1	chr14	75397824	75397960	DNA/hAT-Charlie	586	-	68	75397892	69908
chr14	75327984	75527984	harbor1	chr14	75424224	75424359	DNA/hAT-Charlie	694	-	68	75424292	96308
chr14	75327984	75527984	harbor1	chr14	75424761	75424833	DNA/hAT-Charlie	694	-	36	75424797	96813
chr14	100185484	100385484	harbor1	chr14	100199646	100199792	DNA/hAT-Charlie	607	-	73	100199719	14235
chr14	23961782	24161782	harbor1	chr14	23967962	23968087	DNA/hAT-Charlie	525	-	62	23968024	6242
chr14	23961782	24161782	harbor1	chr14	23968118	23968170	DNA/hAT-Charlie	525	-	26	23968144	6362
chr14	23961782	24161782	harbor1	chr14	23987558	23987833	DNA/hAT-Charlie	714	-	138	23987696	25914
chr14	23961782	24161782	harbor1	chr14	24005088	24005213	DNA/hAT-Charlie	529	-	62	24005150	43368
chr14	23961782	24161782	harbor1	chr14	24005244	24005296	DNA/hAT-Charlie	529	-	26	24005270	43488
chr14	23961782	24161782	harbor1	chr14	24050069	24050193	DNA/hAT-Charlie	523	-	62	24050131	88349
chr14	23961782	24161782	harbor1	chr14	24035191	24035386	DNA/hAT-Charlie	611	-	98	24035289	73507
chr14	63247906	63447906	harbor1	chr14	63249734	63249872	DNA/hAT-Charlie	451	-	69	63249803	1897
chr14	63247906	63447906	harbor1	chr14	63271456	63271582	DNA/hAT-Charlie	965	-	63	63271519	23613
chr14	63247906	63447906	harbor1	chr14	63271885	63271957	DNA/hAT-Charlie	965	-	36	63271921	24015
chr14	63247906	63447906	harbor1	chr14	63276119	63276314	DNA/hAT-Charlie	810	-	98	63276217	28311
chr14	63247906	63447906	harbor1	chr14	63325877	63326098	DNA/hAT-Charlie	908	-	110	63325987	78081
chr14	63247906	63447906	harbor1	chr14	63326346	63326404	DNA/hAT-Charlie	908	-	29	63326375	78469
chr14	63247906	63447906	harbor1	chr14	63326685	63326783	DNA/hAT-Charlie	908	-	49	63326734	78828
chr14	90282762	90482762	harbor1	chr14	90311678	90311834	DNA/hAT-Charlie	1077	-	78	90311756	28994
chr14	90282762	90482762	harbor1	chr14	90335081	90335226	DNA/hAT-Charlie	521	-	72	90335153	52391
chr14	90282762	90482762	harbor1	chr14	90354919	90355274	DNA/hAT-Charlie	1966	-	178	90355097	72335
chr14	90283216	90483216	harbor1	chr14	90311678	90311834	DNA/hAT-Charlie	1077	-	78	90311756	28540
chr14	90283216	90483216	harbor1	chr14	90335081	90335226	DNA/hAT-Charlie	521	-	72	90335153	51937
chr14	90283216	90483216	harbor1	chr14	90354919	90355274	DNA/hAT-Charlie	1966	-	178	90355097	71881
chr14	57989413	58189413	harbor1	chr14	58008633	58008815	DNA/hAT-Charlie	926	-	91	58008724	19311
chr14	57989413	58189413	harbor1	chr14	58013156	58013489	DNA/hAT-Charlie	1465	-	166	58013322	23909
chr14	57989413	58189413	harbor1	chr14	58032396	58032504	DNA/hAT-Charlie	549	-	54	58032450	43037
chr14	57989413	58189413	harbor1	chr14	58038611	58038906	DNA/hAT-Charlie	1312	-	148	58038759	49346
chr14	57989413	58189413	harbor1	chr14	58046751	58046964	DNA/hAT-Charlie	629	-	106	58046857	57444
chr14	57989413	58189413	harbor1	chr14	58078610	58078830	DNA/hAT-Charlie	1146	-	110	58078720	89307
chr14	67488947	67688947	harbor1	chr14	67558770	67558943	DNA/hAT-Charlie	996	-	86	67558856	69909
chr14	54388477	54588477	harbor1	chr14	54445675	54445811	DNA/hAT-Charlie	559	-	68	54445743	57266
chr14	73659272	73859272	harbor1	chr14	73663052	73663202	DNA/hAT-Charlie	490	-	75	73663127	3855
chr14	73659272	73859272	harbor1	chr14	73663506	73663623	DNA/hAT-Charlie	490	-	58	73663564	4292
chr14	73659272	73859272	harbor1	chr14	73698954	73699127	DNA/hAT-Charlie	1032	-	86	73699040	39768
chr14	73659272	73859272	harbor1	chr14	73711943	73712116	DNA/hAT-Charlie	564	-	86	73712029	52757
chr14	73659272	73859272	harbor1	chr14	73730160	73730306	DNA/hAT-Charlie	727	-	73	73730233	70961
chr14	75328384	75528384	harbor1	chr14	75397824	75397960	DNA/hAT-Charlie	586	-	68	75397892	69508
chr14	75328384	75528384	harbor1	chr14	75424224	75424359	DNA/hAT-Charlie	694	-	68	75424292	95908
chr14	75328384	75528384	harbor1	chr14	75424761	75424833	DNA/hAT-Charlie	694	-	36	75424797	96413
chr14	51349924	51549924	harbor1	chr14	51367881	51368050	DNA/hAT-Charlie	631	-	84	51367965	18041
chr14	51349924	51549924	harbor1	chr14	51368052	51368339	DNA/hAT-Charlie	1351	-	144	51368196	18272
chr14	51349924	51549924	harbor1	chr14	51440908	51441100	DNA/hAT-Charlie	503	-	96	51441004	91080
chr14	104195767	104395767	harbor1	chr14	104262254	104262371	DNA/hAT-Charlie	525	-	58	104262312	66545
chr14	65117756	65317756	harbor1	chr14	65130412	65130502	DNA/hAT-Charlie	1361	-	45	65130457	12701
chr14	65117756	65317756	harbor1	chr14	65131198	65131414	DNA/hAT-Charlie	1361	-	108	65131306	13550
chr14	65117756	65317756	harbor1	chr14	65165941	65166125	DNA/hAT-Charlie	517	-	92	65166033	48277
chr14	65117756	65317756	harbor1	chr14	65209384	65209507	DNA/hAT-Charlie	454	-	62	65209446	91690
chr14	103423133	103623133	harbor1	chr14	103458063	103458175	DNA/hAT-Charlie	1247	-	56	103458119	34986
chr14	103423133	103623133	harbor1	chr14	103458479	103458593	DNA/hAT-Charlie	1247	-	57	103458536	35403
chr14	93015942	93215942	harbor1	chr14	93071425	93072011	DNA/hAT-Charlie	2590	-	293	93071718	55776
chr14	93015942	93215942	harbor1	chr14	93072331	93072609	DNA/hAT-Charlie	2590	-	139	93072470	56528
chr14	93015942	93215942	harbor1	chr14	93072878	93072979	DNA/hAT-Charlie	2590	-	50	93072928	56986
chr14	90283244	90483244	harbor1	chr14	90311678	90311834	DNA/hAT-Charlie	1077	-	78	90311756	28512
chr14	90283244	90483244	harbor1	chr14	90335081	90335226	DNA/hAT-Charlie	521	-	72	90335153	51909
chr14	90283244	90483244	harbor1	chr14	90354919	90355274	DNA/hAT-Charlie	1966	-	178	90355097	71853
chr14	23419129	23619129	harbor1	chr14	23480878	23481053	DNA/hAT-Charlie	495	-	88	23480966	61837
chr14	23477321	23677321	harbor1	chr14	23480878	23481053	DNA/hAT-Charlie	495	-	88	23480966	3645
chr14	104833585	105033585	harbor1	chr14	104870086	104870374	DNA/hAT-Charlie	826	-	144	104870230	36645
chr14	71625517	71825517	harbor1	chr14	71643350	71643813	DNA/hAT-Charlie	4769	-	232	71643582	18065
chr14	71625517	71825517	harbor1	chr14	71644106	71644221	DNA/hAT-Charlie	4769	-	58	71644164	18647
chr14	71625517	71825517	harbor1	chr14	71644537	71644907	DNA/hAT-Charlie	4769	-	185	71644722	19205
chr14	71625517	71825517	harbor1	chr14	71645413	71645882	DNA/hAT-Charlie	4769	-	234	71645647	20130
chr14	71625517	71825517	harbor1	chr14	71663059	71663474	DNA/hAT-Charlie	1266	-	208	71663267	37750
chr14	71625517	71825517	harbor1	chr14	71663479	71663603	DNA/hAT-Charlie	525	-	62	71663541	38024
chr14	75328363	75528363	harbor1	chr14	75397824	75397960	DNA/hAT-Charlie	586	-	68	75397892	69529
chr14	75328363	75528363	harbor1	chr14	75424224	75424359	DNA/hAT-Charlie	694	-	68	75424292	95929
chr14	75328363	75528363	harbor1	chr14	75424761	75424833	DNA/hAT-Charlie	694	-	36	75424797	96434
chr14	105255513	105455513	harbor1	chr14	105340391	105340668	DNA/hAT-Charlie	1498	-	138	105340529	85016
chr14	75328401	75528401	harbor1	chr14	75397824	75397960	DNA/hAT-Charlie	586	-	68	75397892	69491
chr14	75328401	75528401	harbor1	chr14	75424224	75424359	DNA/hAT-Charlie	694	-	68	75424292	95891
chr14	75328401	75528401	harbor1	chr14	75424761	75424833	DNA/hAT-Charlie	694	-	36	75424797	96396
chr14	49792466	49992466	harbor1	chr14	49844135	49844462	DNA/hAT-Charlie	2242	-	164	49844299	51833
chr14	90282174	90482174	harbor1	chr14	90311678	90311834	DNA/hAT-Charlie	1077	-	78	90311756	29582
chr14	90282174	90482174	harbor1	chr14	90335081	90335226	DNA/hAT-Charlie	521	-	72	90335153	52979
chr14	90282174	90482174	harbor1	chr14	90354919	90355274	DNA/hAT-Charlie	1966	-	178	90355097	72923
chr14	73660276	73860276	harbor1	chr14	73663052	73663202	DNA/hAT-Charlie	490	-	75	73663127	2851
chr14	73660276	73860276	harbor1	chr14	73663506	73663623	DNA/hAT-Charlie	490	-	58	73663564	3288
chr14	73660276	73860276	harbor1	chr14	73698954	73699127	DNA/hAT-Charlie	1032	-	86	73699040	38764
chr14	73660276	73860276	harbor1	chr14	73711943	73712116	DNA/hAT-Charlie	564	-	86	73712029	51753
chr14	73660276	73860276	harbor1	chr14	73730160	73730306	DNA/hAT-Charlie	727	-	73	73730233	69957
chr14	24047678	24247678	harbor1	chr14	24050069	24050193	DNA/hAT-Charlie	523	-	62	24050131	2453
chr14	24047678	24247678	harbor1	chr14	24065999	24066273	DNA/hAT-Charlie	608	-	137	24066136	18458
chr14	24047678	24247678	harbor1	chr14	24083677	24083889	DNA/hAT-Charlie	503	-	106	24083783	36105
chr14	24047678	24247678	harbor1	chr14	24105938	24106097	DNA/hAT-Charlie	847	-	80	24106018	58340
chr14	100185630	100385630	harbor1	chr14	100199646	100199792	DNA/hAT-Charlie	607	-	73	100199719	14089
chr14	100118258	100318258	harbor1	chr14	100199646	100199792	DNA/hAT-Charlie	607	-	73	100199719	81461
chr14	73640450	73840450	harbor1	chr14	73663052	73663202	DNA/hAT-Charlie	490	-	75	73663127	22677
chr14	73640450	73840450	harbor1	chr14	73663506	73663623	DNA/hAT-Charlie	490	-	58	73663564	23114
chr14	73640450	73840450	harbor1	chr14	73698954	73699127	DNA/hAT-Charlie	1032	-	86	73699040	58590
chr14	73640450	73840450	harbor1	chr14	73711943	73712116	DNA/hAT-Charlie	564	-	86	73712029	71579
chr14	73640450	73840450	harbor1	chr14	73730160	73730306	DNA/hAT-Charlie	727	-	73	73730233	89783
chr14	103419639	103619639	harbor1	chr14	103419315	103419729	DNA/hAT-Charlie	2060	-	207	103419522	117
chr14	103419639	103619639	harbor1	chr14	103458063	103458175	DNA/hAT-Charlie	1247	-	56	103458119	38480
chr14	103419639	103619639	harbor1	chr14	103458479	103458593	DNA/hAT-Charlie	1247	-	57	103458536	38897
chr14	67482246	67682246	harbor1	chr14	67558770	67558943	DNA/hAT-Charlie	996	-	86	67558856	76610
chr14	72958440	73158440	harbor1	chr14	73017248	73017465	DNA/hAT-Charlie	854	-	108	73017356	58916
chr14	104457988	104657988	harbor1	chr14	104501317	104501439	DNA/hAT-Charlie	1144	-	61	104501378	43390
chr14	104457988	104657988	harbor1	chr14	104501802	104501907	DNA/hAT-Charlie	1144	-	52	104501854	43866
chr14	75328399	75528399	harbor1	chr14	75397824	75397960	DNA/hAT-Charlie	586	-	68	75397892	69493
chr14	75328399	75528399	harbor1	chr14	75424224	75424359	DNA/hAT-Charlie	694	-	68	75424292	95893
chr14	75328399	75528399	harbor1	chr14	75424761	75424833	DNA/hAT-Charlie	694	-	36	75424797	96398
chr14	88724593	88924593	harbor1	chr14	88727068	88727392	DNA/hAT-Charlie	1580	-	162	88727230	2637
chr14	88724593	88924593	harbor1	chr14	88735131	88735302	DNA/hAT-Charlie	766	-	86	88735217	10624
chr14	88724593	88924593	harbor1	chr14	88768847	88768978	DNA/hAT-Charlie	774	-	66	88768913	44320
chr14	88724593	88924593	harbor1	chr14	88773774	88773836	DNA/hAT-Charlie	632	-	31	88773805	49212
chr14	88724593	88924593	harbor1	chr14	88774147	88774286	DNA/hAT-Charlie	632	-	70	88774217	49624
chr14	73545047	73745047	harbor1	chr14	73626166	73626388	DNA/hAT-Charlie	1480	-	111	73626277	81230
chr14	24047662	24247662	harbor1	chr14	24050069	24050193	DNA/hAT-Charlie	523	-	62	24050131	2469
chr14	24047662	24247662	harbor1	chr14	24065999	24066273	DNA/hAT-Charlie	608	-	137	24066136	18474
chr14	24047662	24247662	harbor1	chr14	24083677	24083889	DNA/hAT-Charlie	503	-	106	24083783	36121
chr14	24047662	24247662	harbor1	chr14	24105938	24106097	DNA/hAT-Charlie	847	-	80	24106018	58356
chr14	67108235	67308235	harbor1	chr14	67127509	67127637	DNA/hAT-Charlie	513	-	64	67127573	19338
chr14	94469585	94669585	harbor1	chr14	94531922	94532736	DNA/hAT-Charlie	1319	-	407	94532329	62744
chr14	94469585	94669585	harbor1	chr14	94534088	94534472	DNA/hAT-Charlie	1084	-	192	94534280	64695
chr14	94469585	94669585	harbor1	chr14	94539814	94540002	DNA/hAT-Charlie	856	-	94	94539908	70323
chr14	100182074	100382074	harbor1	chr14	100199646	100199792	DNA/hAT-Charlie	607	-	73	100199719	17645
chr14	21337357	21537357	harbor1	chr14	21414549	21414677	DNA/hAT-Charlie	521	-	64	21414613	77256
chr14	24047772	24247772	harbor1	chr14	24050069	24050193	DNA/hAT-Charlie	523	-	62	24050131	2359
chr14	24047772	24247772	harbor1	chr14	24065999	24066273	DNA/hAT-Charlie	608	-	137	24066136	18364
chr14	24047772	24247772	harbor1	chr14	24083677	24083889	DNA/hAT-Charlie	503	-	106	24083783	36011
chr14	24047772	24247772	harbor1	chr14	24105938	24106097	DNA/hAT-Charlie	847	-	80	24106018	58246
chr14	100146444	100346444	harbor1	chr14	100199646	100199792	DNA/hAT-Charlie	607	-	73	100199719	53275
chr14	90283172	90483172	harbor1	chr14	90311678	90311834	DNA/hAT-Charlie	1077	-	78	90311756	28584
chr14	90283172	90483172	harbor1	chr14	90335081	90335226	DNA/hAT-Charlie	521	-	72	90335153	51981
chr14	90283172	90483172	harbor1	chr14	90354919	90355274	DNA/hAT-Charlie	1966	-	178	90355097	71925
chr14	55014896	55214896	harbor1	chr14	55033334	55033802	DNA/hAT-Charlie	1370	-	234	55033568	18672
chr14	55014896	55214896	harbor1	chr14	55080629	55080870	DNA/hAT-Charlie	470	-	120	55080749	65853
chr14	100185510	100385510	harbor1	chr14	100199646	100199792	DNA/hAT-Charlie	607	-	73	100199719	14209
chr14	75328390	75528390	harbor1	chr14	75397824	75397960	DNA/hAT-Charlie	586	-	68	75397892	69502
chr14	75328390	75528390	harbor1	chr14	75424224	75424359	DNA/hAT-Charlie	694	-	68	75424292	95902
chr14	75328390	75528390	harbor1	chr14	75424761	75424833	DNA/hAT-Charlie	694	-	36	75424797	96407
chr14	23251947	23451947	harbor1	chr14	23315339	23315661	DNA/hAT-Charlie	1497	-	161	23315500	63553
chr14	73999218	74199218	harbor1	chr14	74012554	74012914	DNA/hAT-Charlie	1190	-	180	74012734	13516
chr14	73999218	74199218	harbor1	chr14	74013038	74013215	DNA/hAT-Charlie	978	-	88	74013126	13908
chr14	71816792	72016792	harbor1	chr14	71852154	71852318	DNA/hAT-Charlie	973	-	82	71852236	35444
chr14	100581636	100781636	harbor1	chr14	100663498	100663776	DNA/hAT-Charlie	876	-	139	100663637	82001
chr14	20369071	20569071	harbor1	chr14	20394244	20394445	DNA/hAT-Charlie	779	-	100	20394344	25273
chr14	20369071	20569071	harbor1	chr14	20397530	20397752	DNA/hAT-Charlie	473	-	111	20397641	28570
chr14	20369071	20569071	harbor1	chr14	20398393	20398713	DNA/hAT-Charlie	473	-	160	20398553	29482
chr14	20369071	20569071	harbor1	chr14	20415079	20415446	DNA/hAT-Charlie	2016	-	184	20415263	46192
chr14	20369071	20569071	harbor1	chr14	20415748	20415971	DNA/hAT-Charlie	2016	-	112	20415860	46789
chr14	20369071	20569071	harbor1	chr14	20417536	20417688	DNA/hAT-Charlie	451	-	76	20417612	48541
chr14	20369071	20569071	harbor1	chr14	20430849	20431031	DNA/hAT-Charlie	537	-	91	20430940	61869
chr14	20369071	20569071	harbor1	chr14	20398053	20398097	DNA/hAT-Charlie	473	-	22	20398075	29004
chr14	75328424	75528424	harbor1	chr14	75397824	75397960	DNA/hAT-Charlie	586	-	68	75397892	69468
chr14	75328424	75528424	harbor1	chr14	75424224	75424359	DNA/hAT-Charlie	694	-	68	75424292	95868
chr14	75328424	75528424	harbor1	chr14	75424761	75424833	DNA/hAT-Charlie	694	-	36	75424797	96373
chr14	23252088	23452088	harbor1	chr14	23315339	23315661	DNA/hAT-Charlie	1497	-	161	23315500	63412
chr14	21337368	21537368	harbor1	chr14	21414549	21414677	DNA/hAT-Charlie	521	-	64	21414613	77245
chr14	50142883	50342883	harbor1	chr14	50174980	50175120	DNA/hAT-Charlie	526	-	70	50175050	32167
chr14	50142883	50342883	harbor1	chr14	50191639	50191878	DNA/hAT-Charlie	535	-	120	50191759	48876
chr14	20357270	20557270	harbor1	chr14	20365577	20365827	DNA/hAT-Charlie	1065	-	125	20365702	8432
chr14	20357270	20557270	harbor1	chr14	20394244	20394445	DNA/hAT-Charlie	779	-	100	20394344	37074
chr14	20357270	20557270	harbor1	chr14	20397530	20397752	DNA/hAT-Charlie	473	-	111	20397641	40371
chr14	20357270	20557270	harbor1	chr14	20398393	20398713	DNA/hAT-Charlie	473	-	160	20398553	41283
chr14	20357270	20557270	harbor1	chr14	20415079	20415446	DNA/hAT-Charlie	2016	-	184	20415263	57993
chr14	20357270	20557270	harbor1	chr14	20415748	20415971	DNA/hAT-Charlie	2016	-	112	20415860	58590
chr14	20357270	20557270	harbor1	chr14	20417536	20417688	DNA/hAT-Charlie	451	-	76	20417612	60342
chr14	20357270	20557270	harbor1	chr14	20430849	20431031	DNA/hAT-Charlie	537	-	91	20430940	73670
chr14	20357270	20557270	harbor1	chr14	20398053	20398097	DNA/hAT-Charlie	473	-	22	20398075	40805
chr14	104877001	105077001	harbor1	chr14	104959914	104960105	DNA/hAT-Charlie	578	-	96	104960010	83009
chr14	99416276	99616276	harbor1	chr14	99455730	99455872	DNA/hAT-Charlie	565	-	71	99455801	39525
chr14	99416276	99616276	harbor1	chr14	99487292	99487507	DNA/hAT-Charlie	1277	-	108	99487400	71124
chr14	95435221	95635221	harbor1	chr14	95456394	95456599	DNA/hAT-Charlie	608	-	102	95456496	21275
chr14	95435221	95635221	harbor1	chr14	95459046	95459290	DNA/hAT-Charlie	804	-	122	95459168	23947
chr14	95435221	95635221	harbor1	chr14	95478662	95478851	DNA/hAT-Charlie	692	-	94	95478756	43535
chr14	95435221	95635221	harbor1	chr14	95484892	95485061	DNA/hAT-Charlie	790	-	84	95484976	49755
chr14	95435221	95635221	harbor1	chr14	95497616	95497828	DNA/hAT-Charlie	1162	-	106	95497722	62501
chr14	100012246	100212246	harbor1	chr14	100021580	100021762	DNA/hAT-Charlie	1054	-	91	100021671	9425
chr14	100012246	100212246	harbor1	chr14	100041984	100042268	DNA/hAT-Charlie	1074	-	142	100042126	29880
chr14	100012246	100212246	harbor1	chr14	100080129	100080323	DNA/hAT-Charlie	1342	-	97	100080226	67980
chr14	54692460	54892460	harbor1	chr14	54710966	54711078	DNA/hAT-Charlie	465	-	56	54711022	18562
chr14	54692460	54892460	harbor1	chr14	54725938	54726083	DNA/hAT-Charlie	765	-	72	54726010	33550
chr14	54692460	54892460	harbor1	chr14	54726644	54726823	DNA/hAT-Charlie	494	-	90	54726734	34274
chr14	54692460	54892460	harbor1	chr14	54748426	54748591	DNA/hAT-Charlie	630	-	82	54748508	56048
chr14	67500383	67700383	harbor1	chr14	67558770	67558943	DNA/hAT-Charlie	996	-	86	67558856	58473
chr14	81336737	81536737	harbor1	chr14	81351918	81352119	DNA/hAT-Charlie	552	-	100	81352018	15281
chr14	81336737	81536737	harbor1	chr14	81352214	81352463	DNA/hAT-Charlie	1028	-	124	81352338	15601
chr14	81336737	81536737	harbor1	chr14	81392699	81393057	DNA/hAT-Charlie	761	-	179	81392878	56141
chr14	81336737	81536737	harbor1	chr14	81397258	81397551	DNA/hAT-Charlie	1215	-	146	81397404	60667
chr14	105287660	105487660	harbor1	chr14	105340391	105340668	DNA/hAT-Charlie	1498	-	138	105340529	52869
chr14	55029359	55229359	harbor1	chr14	55033334	55033802	DNA/hAT-Charlie	1370	-	234	55033568	4209
chr14	55029359	55229359	harbor1	chr14	55080629	55080870	DNA/hAT-Charlie	470	-	120	55080749	51390
chr14	104785132	104985132	harbor1	chr14	104870086	104870374	DNA/hAT-Charlie	826	-	144	104870230	85098
chr14	103445438	103645438	harbor1	chr14	103458063	103458175	DNA/hAT-Charlie	1247	-	56	103458119	12681
chr14	103445438	103645438	harbor1	chr14	103458479	103458593	DNA/hAT-Charlie	1247	-	57	103458536	13098
chr14	91224876	91424876	harbor1	chr14	91239035	91239212	DNA/hAT-Charlie	877	-	88	91239123	14247
chr14	91224876	91424876	harbor1	chr14	91244152	91244212	DNA/hAT-Charlie	737	-	30	91244182	19306
chr14	91224876	91424876	harbor1	chr14	91244258	91244415	DNA/hAT-Charlie	737	-	78	91244336	19460
chr14	91224876	91424876	harbor1	chr14	91305313	91305487	DNA/hAT-Charlie	464	-	87	91305400	80524
chr14	91224876	91424876	harbor1	chr14	91306580	91306765	DNA/hAT-Charlie	768	-	92	91306672	81796
chr14	91224876	91424876	harbor1	chr14	91315281	91315477	DNA/hAT-Charlie	750	-	98	91315379	90503
chr14	69474346	69674346	harbor1	chr14	69490175	69490525	DNA/hAT-Charlie	1817	-	175	69490350	16004
chr14	69474346	69674346	harbor1	chr14	69562830	69562959	DNA/hAT-Charlie	471	-	64	69562894	88548
chr14	69474346	69674346	harbor1	chr14	69563018	69563041	DNA/hAT-Charlie	471	-	12	69563030	88684
chr14	69474346	69674346	harbor1	chr14	69563348	69563418	DNA/hAT-Charlie	471	-	35	69563383	89037
chr14	69474346	69674346	harbor1	chr14	69563676	69563806	DNA/hAT-Charlie	539	-	65	69563741	89395
chr15	31114834	31314834	harbor1	chr15	31145821	31146037	DNA/hAT-Charlie	1110	-	108	31145929	31095
chr15	89279015	89479015	harbor1	chr15	89308167	89308368	DNA/hAT-Charlie	1156	-	100	89308267	29252
chr15	89279015	89479015	harbor1	chr15	89310129	89310336	DNA/hAT-Charlie	1007	-	104	89310233	31218
chr15	50319048	50519048	harbor1	chr15	50333084	50333183	DNA/hAT-Charlie	484	-	50	50333134	14086
chr15	50319048	50519048	harbor1	chr15	50333514	50333555	DNA/hAT-Charlie	484	-	20	50333534	14486
chr15	50319048	50519048	harbor1	chr15	50358469	50358732	DNA/hAT-Charlie	1083	-	132	50358601	39553
chr15	50319048	50519048	harbor1	chr15	50363279	50363389	DNA/hAT-Charlie	606	-	55	50363334	44286
chr15	50319048	50519048	harbor1	chr15	50363685	50363799	DNA/hAT-Charlie	606	-	57	50363742	44694
chr15	50319048	50519048	harbor1	chr15	50392235	50392377	DNA/hAT-Charlie	816	-	71	50392306	73258
chr15	32313757	32513757	harbor1	chr15	32409128	32409201	DNA/hAT-Charlie	449	-	36	32409164	95407
chr15	67421763	67621763	harbor1	chr15	67460127	67460261	DNA/hAT-Charlie	672	-	67	67460194	38431
chr15	67421763	67621763	harbor1	chr15	67486647	67486957	DNA/hAT-Charlie	1236	-	155	67486802	65039
chr15	67421763	67621763	harbor1	chr15	67488594	67488959	DNA/hAT-Charlie	2286	-	182	67488776	67013
chr15	67421763	67621763	harbor1	chr15	67500238	67500538	DNA/hAT-Charlie	676	-	150	67500388	78625
chr15	35446216	35646216	harbor1	chr15	35524050	35524340	DNA/hAT-Charlie	1031	-	145	35524195	77979
chr15	35446299	35646299	harbor1	chr15	35524050	35524340	DNA/hAT-Charlie	1031	-	145	35524195	77896
chr15	75330451	75530451	harbor1	chr15	75331733	75331940	DNA/hAT-Charlie	933	-	104	75331837	1386
chr15	75330451	75530451	harbor1	chr15	75376334	75376483	DNA/hAT-Charlie	628	-	74	75376408	45957
chr15	75330451	75530451	harbor1	chr15	75424025	75424151	DNA/hAT-Charlie	753	-	63	75424088	93637
chr15	75330451	75530451	harbor1	chr15	75424455	75424469	DNA/hAT-Charlie	753	-	7	75424462	94011
chr15	75330451	75530451	harbor1	chr15	75424773	75424892	DNA/hAT-Charlie	753	-	60	75424833	94382
chr15	75330451	75530451	harbor1	chr15	75429518	75429648	DNA/hAT-Charlie	476	-	65	75429583	99132
chr15	74496627	74696627	harbor1	chr15	74496667	74496741	DNA/hAT-Charlie	1181	-	37	74496704	77
chr15	74496627	74696627	harbor1	chr15	74517458	74517681	DNA/hAT-Charlie	1062	-	112	74517570	20943
chr15	74496627	74696627	harbor1	chr15	74575822	74575898	DNA/hAT-Charlie	1058	-	38	74575860	79233
chr15	74496627	74696627	harbor1	chr15	74576193	74576332	DNA/hAT-Charlie	1058	-	70	74576263	79636
chr15	67421715	67621715	harbor1	chr15	67460127	67460261	DNA/hAT-Charlie	672	-	67	67460194	38479
chr15	67421715	67621715	harbor1	chr15	67486647	67486957	DNA/hAT-Charlie	1236	-	155	67486802	65087
chr15	67421715	67621715	harbor1	chr15	67488594	67488959	DNA/hAT-Charlie	2286	-	182	67488776	67061
chr15	67421715	67621715	harbor1	chr15	67500238	67500538	DNA/hAT-Charlie	676	-	150	67500388	78673
chr15	67421806	67621806	harbor1	chr15	67460127	67460261	DNA/hAT-Charlie	672	-	67	67460194	38388
chr15	67421806	67621806	harbor1	chr15	67486647	67486957	DNA/hAT-Charlie	1236	-	155	67486802	64996
chr15	67421806	67621806	harbor1	chr15	67488594	67488959	DNA/hAT-Charlie	2286	-	182	67488776	66970
chr15	67421806	67621806	harbor1	chr15	67500238	67500538	DNA/hAT-Charlie	676	-	150	67500388	78582
chr15	35446212	35646212	harbor1	chr15	35524050	35524340	DNA/hAT-Charlie	1031	-	145	35524195	77983
chr15	67421703	67621703	harbor1	chr15	67460127	67460261	DNA/hAT-Charlie	672	-	67	67460194	38491
chr15	67421703	67621703	harbor1	chr15	67486647	67486957	DNA/hAT-Charlie	1236	-	155	67486802	65099
chr15	67421703	67621703	harbor1	chr15	67488594	67488959	DNA/hAT-Charlie	2286	-	182	67488776	67073
chr15	67421703	67621703	harbor1	chr15	67500238	67500538	DNA/hAT-Charlie	676	-	150	67500388	78685
chr15	35446272	35646272	harbor1	chr15	35524050	35524340	DNA/hAT-Charlie	1031	-	145	35524195	77923
chr15	35446324	35646324	harbor1	chr15	35524050	35524340	DNA/hAT-Charlie	1031	-	145	35524195	77871
chr15	101861586	102061586	harbor1	chr15	101953535	101953921	DNA/hAT-Charlie	1566	-	193	101953728	92142
chr15	74510960	74710960	harbor1	chr15	74517458	74517681	DNA/hAT-Charlie	1062	-	112	74517570	6610
chr15	74510960	74710960	harbor1	chr15	74575822	74575898	DNA/hAT-Charlie	1058	-	38	74575860	64900
chr15	74510960	74710960	harbor1	chr15	74576193	74576332	DNA/hAT-Charlie	1058	-	70	74576263	65303
chr15	35446318	35646318	harbor1	chr15	35524050	35524340	DNA/hAT-Charlie	1031	-	145	35524195	77877
chr15	101858909	102058909	harbor1	chr15	101953535	101953921	DNA/hAT-Charlie	1566	-	193	101953728	94819
chr15	35446271	35646271	harbor1	chr15	35524050	35524340	DNA/hAT-Charlie	1031	-	145	35524195	77924
chr15	35446266	35646266	harbor1	chr15	35524050	35524340	DNA/hAT-Charlie	1031	-	145	35524195	77929
chr15	35446252	35646252	harbor1	chr15	35524050	35524340	DNA/hAT-Charlie	1031	-	145	35524195	77943
chr15	67421691	67621691	harbor1	chr15	67460127	67460261	DNA/hAT-Charlie	672	-	67	67460194	38503
chr15	67421691	67621691	harbor1	chr15	67486647	67486957	DNA/hAT-Charlie	1236	-	155	67486802	65111
chr15	67421691	67621691	harbor1	chr15	67488594	67488959	DNA/hAT-Charlie	2286	-	182	67488776	67085
chr15	67421691	67621691	harbor1	chr15	67500238	67500538	DNA/hAT-Charlie	676	-	150	67500388	78697
chr15	35446296	35646296	harbor1	chr15	35524050	35524340	DNA/hAT-Charlie	1031	-	145	35524195	77899
chr15	75576188	75776188	harbor1	chr15	75629097	75629349	DNA/hAT-Charlie	691	-	126	75629223	53035
chr15	75576188	75776188	harbor1	chr15	75671152	75671295	DNA/hAT-Charlie	741	-	72	75671224	95036
chr15	79796978	79996978	harbor1	chr15	79850378	79850591	DNA/hAT-Charlie	1003	-	106	79850484	53506
chr15	75247615	75447615	harbor1	chr15	75257123	75257277	DNA/hAT-Charlie	850	-	77	75257200	9585
chr15	75247615	75447615	harbor1	chr15	75281400	75281554	DNA/hAT-Charlie	819	-	77	75281477	33862
chr15	75247615	75447615	harbor1	chr15	75331733	75331940	DNA/hAT-Charlie	933	-	104	75331837	84222
chr15	35446210	35646210	harbor1	chr15	35524050	35524340	DNA/hAT-Charlie	1031	-	145	35524195	77985
chr15	45087531	45287531	harbor1	chr15	45096417	45096838	DNA/hAT-Charlie	1057	-	210	45096627	9096
chr15	45087531	45287531	harbor1	chr15	45105185	45105361	DNA/hAT-Charlie	874	-	88	45105273	17742
chr15	45087531	45287531	harbor1	chr15	45176700	45176814	DNA/hAT-Charlie	451	-	57	45176757	89226
chr15	45087531	45287531	harbor1	chr15	45182603	45182770	DNA/hAT-Charlie	478	-	84	45182687	95156
chr15	35446293	35646293	harbor1	chr15	35524050	35524340	DNA/hAT-Charlie	1031	-	145	35524195	77902
chr15	69999125	70199125	harbor1	chr15	70017831	70017990	DNA/hAT-Charlie	791	-	80	70017911	18786
chr15	69999125	70199125	harbor1	chr15	70046522	70046651	DNA/hAT-Charlie	486	-	64	70046586	47461
chr15	69999125	70199125	harbor1	chr15	70077968	70078093	DNA/hAT-Charlie	572	-	62	70078030	78905
chr15	69999125	70199125	harbor1	chr15	70084955	70085149	DNA/hAT-Charlie	1036	-	97	70085052	85927
chr15	67421799	67621799	harbor1	chr15	67460127	67460261	DNA/hAT-Charlie	672	-	67	67460194	38395
chr15	67421799	67621799	harbor1	chr15	67486647	67486957	DNA/hAT-Charlie	1236	-	155	67486802	65003
chr15	67421799	67621799	harbor1	chr15	67488594	67488959	DNA/hAT-Charlie	2286	-	182	67488776	66977
chr15	67421799	67621799	harbor1	chr15	67500238	67500538	DNA/hAT-Charlie	676	-	150	67500388	78589
chr15	67421689	67621689	harbor1	chr15	67460127	67460261	DNA/hAT-Charlie	672	-	67	67460194	38505
chr15	67421689	67621689	harbor1	chr15	67486647	67486957	DNA/hAT-Charlie	1236	-	155	67486802	65113
chr15	67421689	67621689	harbor1	chr15	67488594	67488959	DNA/hAT-Charlie	2286	-	182	67488776	67087
chr15	67421689	67621689	harbor1	chr15	67500238	67500538	DNA/hAT-Charlie	676	-	150	67500388	78699
chr15	72131568	72331568	harbor1	chr15	72153351	72153546	DNA/hAT-Charlie	786	-	98	72153449	21881
chr15	99950832	100150832	harbor1	chr15	100019607	100019779	DNA/hAT-Charlie	487	-	86	100019693	68861
chr15	99950832	100150832	harbor1	chr15	100044760	100044807	DNA/hAT-Charlie	495	-	24	100044784	93952
chr15	99950832	100150832	harbor1	chr15	100045107	100045390	DNA/hAT-Charlie	495	-	142	100045249	94417
chr15	31768267	31968267	harbor1	chr15	31790200	31790362	DNA/hAT-Charlie	725	-	81	31790281	22014
chr15	35446228	35646228	harbor1	chr15	35524050	35524340	DNA/hAT-Charlie	1031	-	145	35524195	77967
chr15	35446303	35646303	harbor1	chr15	35524050	35524340	DNA/hAT-Charlie	1031	-	145	35524195	77892
chr15	45029667	45229667	harbor1	chr15	45068512	45068720	DNA/hAT-Charlie	1260	-	104	45068616	38949
chr15	45029667	45229667	harbor1	chr15	45096417	45096838	DNA/hAT-Charlie	1057	-	210	45096627	66960
chr15	45029667	45229667	harbor1	chr15	45105185	45105361	DNA/hAT-Charlie	874	-	88	45105273	75606
chr15	35446298	35646298	harbor1	chr15	35524050	35524340	DNA/hAT-Charlie	1031	-	145	35524195	77897
chr15	69999141	70199141	harbor1	chr15	70017831	70017990	DNA/hAT-Charlie	791	-	80	70017911	18770
chr15	69999141	70199141	harbor1	chr15	70046522	70046651	DNA/hAT-Charlie	486	-	64	70046586	47445
chr15	69999141	70199141	harbor1	chr15	70077968	70078093	DNA/hAT-Charlie	572	-	62	70078030	78889
chr15	69999141	70199141	harbor1	chr15	70084955	70085149	DNA/hAT-Charlie	1036	-	97	70085052	85911
chr15	35446321	35646321	harbor1	chr15	35524050	35524340	DNA/hAT-Charlie	1031	-	145	35524195	77874
chr15	98547489	98747489	harbor1	chr15	98596163	98596301	DNA/hAT-Charlie	418	-	69	98596232	48743
chr15	35446273	35646273	harbor1	chr15	35524050	35524340	DNA/hAT-Charlie	1031	-	145	35524195	77922
chr15	67421848	67621848	harbor1	chr15	67460127	67460261	DNA/hAT-Charlie	672	-	67	67460194	38346
chr15	67421848	67621848	harbor1	chr15	67486647	67486957	DNA/hAT-Charlie	1236	-	155	67486802	64954
chr15	67421848	67621848	harbor1	chr15	67488594	67488959	DNA/hAT-Charlie	2286	-	182	67488776	66928
chr15	67421848	67621848	harbor1	chr15	67500238	67500538	DNA/hAT-Charlie	676	-	150	67500388	78540
chr15	63405315	63605315	harbor1	chr15	63433586	63433944	DNA/hAT-Charlie	1723	-	179	63433765	28450
chr15	63405315	63605315	harbor1	chr15	63434225	63434250	DNA/hAT-Charlie	1723	-	12	63434237	28922
chr15	63405315	63605315	harbor1	chr15	63444837	63445012	DNA/hAT-Charlie	632	-	88	63444925	39610
chr15	63405315	63605315	harbor1	chr15	63447687	63447839	DNA/hAT-Charlie	822	-	76	63447763	42448
chr15	63405315	63605315	harbor1	chr15	63473802	63473983	DNA/hAT-Charlie	777	-	90	63473892	68577
chr15	63405315	63605315	harbor1	chr15	63482707	63483097	DNA/hAT-Charlie	1701	-	195	63482902	77587
chr15	63405315	63605315	harbor1	chr15	63483098	63483174	DNA/hAT-Charlie	751	-	38	63483136	77821
chr15	63405315	63605315	harbor1	chr15	63483477	63483565	DNA/hAT-Charlie	751	-	44	63483521	78206
chr15	45302919	45502919	harbor1	chr15	45335853	45336065	DNA/hAT-Charlie	442	-	106	45335959	33040
chr15	45302919	45502919	harbor1	chr15	45353611	45354002	DNA/hAT-Charlie	2125	-	196	45353807	50888
chr15	45302919	45502919	harbor1	chr15	45354295	45354397	DNA/hAT-Charlie	2125	-	51	45354346	51427
chr15	45302919	45502919	harbor1	chr15	45354899	45355351	DNA/hAT-Charlie	1982	-	226	45355125	52206
chr15	45302919	45502919	harbor1	chr15	45355355	45356366	DNA/hAT-Charlie	4113	-	506	45355861	52942
chr15	45302919	45502919	harbor1	chr15	45389770	45389848	DNA/hAT-Charlie	607	-	39	45389809	86890
chr15	45302919	45502919	harbor1	chr15	45390152	45390224	DNA/hAT-Charlie	607	-	36	45390188	87269
chr15	45302919	45502919	harbor1	chr15	45350892	45351059	DNA/hAT-Charlie	516	-	84	45350976	48057
chr15	35446294	35646294	harbor1	chr15	35524050	35524340	DNA/hAT-Charlie	1031	-	145	35524195	77901
chr15	98321796	98521796	harbor1	chr15	98352376	98352455	DNA/hAT-Charlie	559	-	40	98352416	30620
chr15	98321796	98521796	harbor1	chr15	98352817	98352941	DNA/hAT-Charlie	559	-	62	98352879	31083
chr15	98321796	98521796	harbor1	chr15	98374773	98375170	DNA/hAT-Charlie	1792	-	198	98374971	53175
chr15	98321796	98521796	harbor1	chr15	98385898	98386064	DNA/hAT-Charlie	766	-	83	98385981	64185
chr15	69713052	69913052	harbor1	chr15	69738328	69738448	DNA/hAT-Charlie	574	-	60	69738388	25336
chr15	69713052	69913052	harbor1	chr15	69758383	69758567	DNA/hAT-Charlie	969	-	92	69758475	45423
chr15	69713052	69913052	harbor1	chr15	69805693	69805806	DNA/hAT-Charlie	483	-	56	69805749	92697
chr15	35446205	35646205	harbor1	chr15	35524050	35524340	DNA/hAT-Charlie	1031	-	145	35524195	77990
chr15	67421758	67621758	harbor1	chr15	67460127	67460261	DNA/hAT-Charlie	672	-	67	67460194	38436
chr15	67421758	67621758	harbor1	chr15	67486647	67486957	DNA/hAT-Charlie	1236	-	155	67486802	65044
chr15	67421758	67621758	harbor1	chr15	67488594	67488959	DNA/hAT-Charlie	2286	-	182	67488776	67018
chr15	67421758	67621758	harbor1	chr15	67500238	67500538	DNA/hAT-Charlie	676	-	150	67500388	78630
chr15	35446313	35646313	harbor1	chr15	35524050	35524340	DNA/hAT-Charlie	1031	-	145	35524195	77882
chr15	88185139	88385139	harbor1	chr15	88185088	88185462	DNA/hAT-Charlie	842	-	187	88185275	136
chr15	88185139	88385139	harbor1	chr15	88208439	88208605	DNA/hAT-Charlie	952	-	83	88208522	23383
chr15	88185139	88385139	harbor1	chr15	88208746	88208888	DNA/hAT-Charlie	616	-	71	88208817	23678
chr15	88185139	88385139	harbor1	chr15	88276301	88276458	DNA/hAT-Charlie	920	-	78	88276379	91240
chr15	88185139	88385139	harbor1	chr15	88276468	88276647	DNA/hAT-Charlie	772	-	90	88276558	91419
chr15	88185139	88385139	harbor1	chr15	88278588	88278813	DNA/hAT-Charlie	1075	-	112	88278700	93561
chr15	41794702	41994702	harbor1	chr15	41811374	41811560	DNA/hAT-Charlie	923	-	93	41811467	16765
chr15	96225435	96425435	harbor1	chr15	96264240	96264432	DNA/hAT-Charlie	639	-	96	96264336	38901
chr15	96225435	96425435	harbor1	chr15	96264456	96264646	DNA/hAT-Charlie	917	-	95	96264551	39116
chr15	96225435	96425435	harbor1	chr15	96279127	96279240	DNA/hAT-Charlie	420	-	56	96279183	53748
chr15	20916532	21116532	harbor1	chr15	20964406	20964632	DNA/hAT-Charlie	1085	-	113	20964519	47987
chr15	31770669	31970669	harbor1	chr15	31790200	31790362	DNA/hAT-Charlie	725	-	81	31790281	19612
chr15	35446401	35646401	harbor1	chr15	35524050	35524340	DNA/hAT-Charlie	1031	-	145	35524195	77794
chr15	74496573	74696573	harbor1	chr15	74496667	74496741	DNA/hAT-Charlie	1181	-	37	74496704	131
chr15	74496573	74696573	harbor1	chr15	74517458	74517681	DNA/hAT-Charlie	1062	-	112	74517570	20997
chr15	74496573	74696573	harbor1	chr15	74575822	74575898	DNA/hAT-Charlie	1058	-	38	74575860	79287
chr15	74496573	74696573	harbor1	chr15	74576193	74576332	DNA/hAT-Charlie	1058	-	70	74576263	79690
chr15	35446238	35646238	harbor1	chr15	35524050	35524340	DNA/hAT-Charlie	1031	-	145	35524195	77957
chr15	67421764	67621764	harbor1	chr15	67460127	67460261	DNA/hAT-Charlie	672	-	67	67460194	38430
chr15	67421764	67621764	harbor1	chr15	67486647	67486957	DNA/hAT-Charlie	1236	-	155	67486802	65038
chr15	67421764	67621764	harbor1	chr15	67488594	67488959	DNA/hAT-Charlie	2286	-	182	67488776	67012
chr15	67421764	67621764	harbor1	chr15	67500238	67500538	DNA/hAT-Charlie	676	-	150	67500388	78624
chr15	35446427	35646427	harbor1	chr15	35524050	35524340	DNA/hAT-Charlie	1031	-	145	35524195	77768
chr15	22459893	22659893	harbor1	chr15	22477502	22477547	DNA/hAT-Charlie	1012	-	22	22477524	17631
chr15	22459893	22659893	harbor1	chr15	22477866	22478172	DNA/hAT-Charlie	1012	-	153	22478019	18126
chr15	22459893	22659893	harbor1	chr15	22502772	22502964	DNA/hAT-Charlie	805	-	96	22502868	42975
chr15	22459893	22659893	harbor1	chr15	22503269	22503324	DNA/hAT-Charlie	805	-	28	22503297	43404
chr15	22459893	22659893	harbor1	chr15	22520425	22520683	DNA/hAT-Charlie	965	-	129	22520554	60661
chr15	101859054	102059054	harbor1	chr15	101953535	101953921	DNA/hAT-Charlie	1566	-	193	101953728	94674
chr15	74944603	75144603	harbor1	chr15	75034986	75035155	DNA/hAT-Charlie	742	-	84	75035070	90467
chr15	74944603	75144603	harbor1	chr15	75041987	75042148	DNA/hAT-Charlie	485	-	80	75042067	97464
chr15	74947211	75147211	harbor1	chr15	75034986	75035155	DNA/hAT-Charlie	742	-	84	75035070	87859
chr15	74947211	75147211	harbor1	chr15	75041987	75042148	DNA/hAT-Charlie	485	-	80	75042067	94856
chr15	35446269	35646269	harbor1	chr15	35524050	35524340	DNA/hAT-Charlie	1031	-	145	35524195	77926
chr15	35445428	35645428	harbor1	chr15	35524050	35524340	DNA/hAT-Charlie	1031	-	145	35524195	78767
chr15	20765866	20965866	harbor1	chr15	20837521	20838031	DNA/hAT-Charlie	3281	-	255	20837776	71910
chr15	75354646	75554646	harbor1	chr15	75376334	75376483	DNA/hAT-Charlie	628	-	74	75376408	21762
chr15	75354646	75554646	harbor1	chr15	75424025	75424151	DNA/hAT-Charlie	753	-	63	75424088	69442
chr15	75354646	75554646	harbor1	chr15	75424455	75424469	DNA/hAT-Charlie	753	-	7	75424462	69816
chr15	75354646	75554646	harbor1	chr15	75424773	75424892	DNA/hAT-Charlie	753	-	60	75424833	70187
chr15	75354646	75554646	harbor1	chr15	75429518	75429648	DNA/hAT-Charlie	476	-	65	75429583	74937
chr15	52686084	52886084	harbor1	chr15	52759461	52759610	DNA/hAT-Charlie	631	-	74	52759535	73451
chr15	52686084	52886084	harbor1	chr15	52759898	52760015	DNA/hAT-Charlie	631	-	58	52759956	73872
chr15	52686084	52886084	harbor1	chr15	52770191	52770363	DNA/hAT-Charlie	728	-	86	52770277	84193
chr15	52686084	52886084	harbor1	chr15	52770373	52770522	DNA/hAT-Charlie	709	-	74	52770447	84363
chr15	52686084	52886084	harbor1	chr15	52772940	52773063	DNA/hAT-Charlie	431	-	62	52773002	86918
chr15	52686084	52886084	harbor1	chr15	52776881	52777044	DNA/hAT-Charlie	865	-	82	52776963	90879
chr15	101854375	102054375	harbor1	chr15	101953535	101953921	DNA/hAT-Charlie	1566	-	193	101953728	99353
chr15	67421788	67621788	harbor1	chr15	67460127	67460261	DNA/hAT-Charlie	672	-	67	67460194	38406
chr15	67421788	67621788	harbor1	chr15	67486647	67486957	DNA/hAT-Charlie	1236	-	155	67486802	65014
chr15	67421788	67621788	harbor1	chr15	67488594	67488959	DNA/hAT-Charlie	2286	-	182	67488776	66988
chr15	67421788	67621788	harbor1	chr15	67500238	67500538	DNA/hAT-Charlie	676	-	150	67500388	78600
chr15	101861607	102061607	harbor1	chr15	101953535	101953921	DNA/hAT-Charlie	1566	-	193	101953728	92121
chr15	57606922	57806922	harbor1	chr15	57644001	57644160	DNA/hAT-Charlie	584	-	80	57644081	37159
chr15	27433813	27633813	harbor1	chr15	27435294	27435495	DNA/hAT-Charlie	536	-	100	27435394	1581
chr15	35446215	35646215	harbor1	chr15	35524050	35524340	DNA/hAT-Charlie	1031	-	145	35524195	77980
chr15	31049451	31249451	harbor1	chr15	31059759	31059871	DNA/hAT-Charlie	434	-	56	31059815	10364
chr15	31049451	31249451	harbor1	chr15	31112735	31112941	DNA/hAT-Charlie	854	-	103	31112838	63387
chr15	31049451	31249451	harbor1	chr15	31145821	31146037	DNA/hAT-Charlie	1110	-	108	31145929	96478
chr15	66727112	66927112	harbor1	chr15	66758956	66759133	DNA/hAT-Charlie	851	-	88	66759044	31932
chr15	35446283	35646283	harbor1	chr15	35524050	35524340	DNA/hAT-Charlie	1031	-	145	35524195	77912
chr16	66189905	66389905	harbor1	chr16	66204035	66204249	DNA/hAT-Charlie	1420	-	107	66204142	14237
chr16	66189905	66389905	harbor1	chr16	66209085	66209260	DNA/hAT-Charlie	620	-	88	66209173	19268
chr16	73380	273380	harbor1	chr16	110914	111119	DNA/hAT-Charlie	877	-	102	111016	37636
chr16	73380	273380	harbor1	chr16	111404	111437	DNA/hAT-Charlie	877	-	16	111420	38040
chr16	73380	273380	harbor1	chr16	111753	112093	DNA/hAT-Charlie	1007	-	170	111923	38543
chr16	2062817	2262817	harbor1	chr16	2156210	2156402	DNA/hAT-Charlie	736	-	96	2156306	93489
chr16	79309359	79509359	harbor1	chr16	79326572	79326795	DNA/hAT-Charlie	1148	-	112	79326684	17325
chr16	79309359	79509359	harbor1	chr16	79340684	79340829	DNA/hAT-Charlie	737	-	72	79340756	31397
chr16	79309359	79509359	harbor1	chr16	79352700	79352894	DNA/hAT-Charlie	721	-	97	79352797	43438
chr16	79309359	79509359	harbor1	chr16	79386085	79386608	DNA/hAT-Charlie	3611	-	262	79386347	76988
chr16	79309359	79509359	harbor1	chr16	79394663	79394843	DNA/hAT-Charlie	722	-	90	79394753	85394
chr16	79309359	79509359	harbor1	chr16	79396678	79396852	DNA/hAT-Charlie	671	-	87	79396765	87406
chr16	67063106	67263106	harbor1	chr16	67119378	67119520	DNA/hAT-Charlie	1258	-	71	67119449	56343
chr16	67063106	67263106	harbor1	chr16	67119828	67119899	DNA/hAT-Charlie	1258	-	36	67119864	56758
chr16	864044	1064044	harbor1	chr16	935472	935655	DNA/hAT-Charlie	1168	-	92	935564	71520
chr16	1863921	2063921	harbor1	chr16	1892884	1893006	DNA/hAT-Charlie	565	-	61	1892945	29024
chr16	87390013	87590013	harbor1	chr16	87465634	87465759	DNA/hAT-Charlie	561	-	62	87465696	75683
chr16	87390013	87590013	harbor1	chr16	87466451	87466607	DNA/hAT-Charlie	629	-	78	87466529	76516
chr16	87390013	87590013	harbor1	chr16	87466642	87466830	DNA/hAT-Charlie	565	-	94	87466736	76723
chr16	88644690	88844690	harbor1	chr16	88671322	88671831	DNA/hAT-Charlie	1175	-	254	88671576	26886
chr16	870964	1070964	harbor1	chr16	935472	935655	DNA/hAT-Charlie	1168	-	92	935564	64600
chr16	46873236	47073236	harbor1	chr16	46949856	46950063	DNA/hAT-Charlie	1105	-	104	46949960	76724
chr16	46873236	47073236	harbor1	chr16	46966356	46966559	DNA/hAT-Charlie	974	-	102	46966458	93222
chr16	4312160	4512160	harbor1	chr16	4335732	4336007	DNA/hAT-Charlie	586	-	138	4335870	23710
chr16	4312160	4512160	harbor1	chr16	4410725	4410940	DNA/hAT-Charlie	1065	-	108	4410833	98673
chr16	1892189	2092189	harbor1	chr16	1892884	1893006	DNA/hAT-Charlie	565	-	61	1892945	756
chr16	1892191	2092191	harbor1	chr16	1892884	1893006	DNA/hAT-Charlie	565	-	61	1892945	754
chr16	2340233	2540233	harbor1	chr16	2349602	2349787	DNA/hAT-Charlie	693	-	92	2349694	9461
chr16	2823031	3023031	harbor1	chr16	2828244	2828567	DNA/hAT-Charlie	909	-	162	2828406	5375
chr16	2823031	3023031	harbor1	chr16	2910884	2911083	DNA/hAT-Charlie	855	-	100	2910984	87953
chr16	2062311	2262311	harbor1	chr16	2156210	2156402	DNA/hAT-Charlie	736	-	96	2156306	93995
chr16	870901	1070901	harbor1	chr16	935472	935655	DNA/hAT-Charlie	1168	-	92	935564	64663
chr16	31026123	31226123	harbor1	chr16	31110853	31111050	DNA/hAT-Charlie	1008	-	98	31110951	84828
chr16	1889985	2089985	harbor1	chr16	1892884	1893006	DNA/hAT-Charlie	565	-	61	1892945	2960
chr16	30887234	31087234	harbor1	chr16	30951487	30951582	DNA/hAT-Charlie	892	-	48	30951535	64301
chr16	30887234	31087234	harbor1	chr16	30951724	30951976	DNA/hAT-Charlie	892	-	126	30951850	64616
chr16	67009887	67209887	harbor1	chr16	67039722	67039870	DNA/hAT-Charlie	696	-	74	67039796	29909
chr16	56526501	56726501	harbor1	chr16	56571708	56572005	DNA/hAT-Charlie	1347	-	148	56571856	45355
chr16	56526501	56726501	harbor1	chr16	56580361	56580581	DNA/hAT-Charlie	1222	-	110	56580471	53970
chr16	56526501	56726501	harbor1	chr16	56582152	56582347	DNA/hAT-Charlie	672	-	98	56582250	55749
chr16	67084475	67284475	harbor1	chr16	67119378	67119520	DNA/hAT-Charlie	1258	-	71	67119449	34974
chr16	67084475	67284475	harbor1	chr16	67119828	67119899	DNA/hAT-Charlie	1258	-	36	67119864	35389
chr16	2204139	2404139	harbor1	chr16	2266703	2266979	DNA/hAT-Charlie	949	-	138	2266841	62702
chr16	46871997	47071997	harbor1	chr16	46949856	46950063	DNA/hAT-Charlie	1105	-	104	46949960	77963
chr16	46871997	47071997	harbor1	chr16	46966356	46966559	DNA/hAT-Charlie	974	-	102	46966458	94461
chr16	27963715	28163715	harbor1	chr16	28034672	28034894	DNA/hAT-Charlie	1033	-	111	28034783	71068
chr16	27963715	28163715	harbor1	chr16	28057463	28057660	DNA/hAT-Charlie	612	-	98	28057561	93846
chr16	67009935	67209935	harbor1	chr16	67039722	67039870	DNA/hAT-Charlie	696	-	74	67039796	29861
chr16	47360972	47560972	harbor1	chr16	47408800	47408938	DNA/hAT-Charlie	663	-	69	47408869	47897
chr16	47360972	47560972	harbor1	chr16	47408932	47409124	DNA/hAT-Charlie	569	-	96	47409028	48056
chr16	47360972	47560972	harbor1	chr16	47435746	47436224	DNA/hAT-Charlie	2075	-	239	47435985	75013
chr16	47360972	47560972	harbor1	chr16	47436296	47437092	DNA/hAT-Charlie	2075	-	398	47436694	75722
chr16	47360972	47560972	harbor1	chr16	47443946	47445509	DNA/hAT-Charlie	3494	-	782	47444728	83756
chr16	88756404	88956404	harbor1	chr16	88844804	88845065	DNA/hAT-Charlie	813	-	130	88844934	88530
chr16	88756404	88956404	harbor1	chr16	88845372	88845422	DNA/hAT-Charlie	813	-	25	88845397	88993
chr16	66743175	66943175	harbor1	chr16	66765287	66765449	DNA/hAT-Charlie	905	-	81	66765368	22193
chr16	66743175	66943175	harbor1	chr16	66765758	66765798	DNA/hAT-Charlie	905	-	20	66765778	22603
chr16	66743175	66943175	harbor1	chr16	66825079	66825168	DNA/hAT-Charlie	825	-	44	66825123	81948
chr16	66743175	66943175	harbor1	chr16	66825464	66825658	DNA/hAT-Charlie	825	-	97	66825561	82386
chr16	67352779	67552779	harbor1	chr16	67383398	67383576	DNA/hAT-Charlie	955	-	89	67383487	30708
chr16	1892466	2092466	harbor1	chr16	1892884	1893006	DNA/hAT-Charlie	565	-	61	1892945	479
chr16	66864287	67064287	harbor1	chr16	66865179	66865275	DNA/hAT-Charlie	1091	-	48	66865227	940
chr16	66864287	67064287	harbor1	chr16	66865583	66865876	DNA/hAT-Charlie	1091	-	146	66865729	1442
chr16	66864287	67064287	harbor1	chr16	66866204	66866350	DNA/hAT-Charlie	1091	-	73	66866277	1990
chr16	57566222	57766222	harbor1	chr16	57665204	57665452	DNA/hAT-Charlie	644	-	124	57665328	99106
chr16	70034	270034	harbor1	chr16	110914	111119	DNA/hAT-Charlie	877	-	102	111016	40982
chr16	70034	270034	harbor1	chr16	111404	111437	DNA/hAT-Charlie	877	-	16	111420	41386
chr16	70034	270034	harbor1	chr16	111753	112093	DNA/hAT-Charlie	1007	-	170	111923	41889
chr16	57884565	58084565	harbor1	chr16	57900586	57900927	DNA/hAT-Charlie	823	-	170	57900756	16191
chr16	57884565	58084565	harbor1	chr16	57937784	57937951	DNA/hAT-Charlie	741	-	84	57937868	53303
chr16	57884565	58084565	harbor1	chr16	57937966	57938125	DNA/hAT-Charlie	568	-	80	57938046	53481
chr16	57884565	58084565	harbor1	chr16	57954259	57954530	DNA/hAT-Charlie	607	-	136	57954395	69830
chr16	870936	1070936	harbor1	chr16	935472	935655	DNA/hAT-Charlie	1168	-	92	935564	64628
chr16	2865141	3065141	harbor1	chr16	2910884	2911083	DNA/hAT-Charlie	855	-	100	2910984	45843
chr16	427634	627634	harbor1	chr16	461034	461360	DNA/hAT-Charlie	1625	-	163	461197	33563
chr16	67574619	67774619	harbor1	chr16	67609577	67609621	DNA/hAT-Charlie	992	-	22	67609599	34980
chr16	67574619	67774619	harbor1	chr16	67609926	67610100	DNA/hAT-Charlie	992	-	87	67610013	35394
chr16	167411	367411	harbor1	chr16	245577	245768	DNA/hAT-Charlie	1107	-	96	245673	78262
chr16	78302994	78502994	harbor1	chr16	78322703	78322991	DNA/hAT-Charlie	1127	-	144	78322847	19853
chr16	78302994	78502994	harbor1	chr16	78336526	78336770	DNA/hAT-Charlie	569	-	122	78336648	33654
chr16	78302994	78502994	harbor1	chr16	78376591	78376785	DNA/hAT-Charlie	888	-	97	78376688	73694
chr16	78302994	78502994	harbor1	chr16	78394606	78394820	DNA/hAT-Charlie	925	-	107	78394713	91719
chr16	47360990	47560990	harbor1	chr16	47408800	47408938	DNA/hAT-Charlie	663	-	69	47408869	47879
chr16	47360990	47560990	harbor1	chr16	47408932	47409124	DNA/hAT-Charlie	569	-	96	47409028	48038
chr16	47360990	47560990	harbor1	chr16	47435746	47436224	DNA/hAT-Charlie	2075	-	239	47435985	74995
chr16	47360990	47560990	harbor1	chr16	47436296	47437092	DNA/hAT-Charlie	2075	-	398	47436694	75704
chr16	47360990	47560990	harbor1	chr16	47443946	47445509	DNA/hAT-Charlie	3494	-	782	47444728	83738
chr16	47361018	47561018	harbor1	chr16	47408800	47408938	DNA/hAT-Charlie	663	-	69	47408869	47851
chr16	47361018	47561018	harbor1	chr16	47408932	47409124	DNA/hAT-Charlie	569	-	96	47409028	48010
chr16	47361018	47561018	harbor1	chr16	47435746	47436224	DNA/hAT-Charlie	2075	-	239	47435985	74967
chr16	47361018	47561018	harbor1	chr16	47436296	47437092	DNA/hAT-Charlie	2075	-	398	47436694	75676
chr16	47361018	47561018	harbor1	chr16	47443946	47445509	DNA/hAT-Charlie	3494	-	782	47444728	83710
chr16	2167697	2367697	harbor1	chr16	2266703	2266979	DNA/hAT-Charlie	949	-	138	2266841	99144
chr16	92247	292247	harbor1	chr16	110914	111119	DNA/hAT-Charlie	877	-	102	111016	18769
chr16	92247	292247	harbor1	chr16	111404	111437	DNA/hAT-Charlie	877	-	16	111420	19173
chr16	92247	292247	harbor1	chr16	111753	112093	DNA/hAT-Charlie	1007	-	170	111923	19676
chr16	456401	656401	harbor1	chr16	461034	461360	DNA/hAT-Charlie	1625	-	163	461197	4796
chr16	73620	273620	harbor1	chr16	110914	111119	DNA/hAT-Charlie	877	-	102	111016	37396
chr16	73620	273620	harbor1	chr16	111404	111437	DNA/hAT-Charlie	877	-	16	111420	37800
chr16	73620	273620	harbor1	chr16	111753	112093	DNA/hAT-Charlie	1007	-	170	111923	38303
chr16	456325	656325	harbor1	chr16	461034	461360	DNA/hAT-Charlie	1625	-	163	461197	4872
chr16	47360574	47560574	harbor1	chr16	47408800	47408938	DNA/hAT-Charlie	663	-	69	47408869	48295
chr16	47360574	47560574	harbor1	chr16	47408932	47409124	DNA/hAT-Charlie	569	-	96	47409028	48454
chr16	47360574	47560574	harbor1	chr16	47435746	47436224	DNA/hAT-Charlie	2075	-	239	47435985	75411
chr16	47360574	47560574	harbor1	chr16	47436296	47437092	DNA/hAT-Charlie	2075	-	398	47436694	76120
chr16	47360574	47560574	harbor1	chr16	47443946	47445509	DNA/hAT-Charlie	3494	-	782	47444728	84154
chr16	2836839	3036839	harbor1	chr16	2910884	2911083	DNA/hAT-Charlie	855	-	100	2910984	74145
chr16	73663	273663	harbor1	chr16	110914	111119	DNA/hAT-Charlie	877	-	102	111016	37353
chr16	73663	273663	harbor1	chr16	111404	111437	DNA/hAT-Charlie	877	-	16	111420	37757
chr16	73663	273663	harbor1	chr16	111753	112093	DNA/hAT-Charlie	1007	-	170	111923	38260
chr16	30013459	30213459	harbor1	chr16	30041986	30042179	DNA/hAT-Charlie	565	-	96	30042082	28623
chr16	30013459	30213459	harbor1	chr16	30044611	30044798	DNA/hAT-Charlie	938	-	94	30044705	31246
chr16	30013459	30213459	harbor1	chr16	30045123	30045226	DNA/hAT-Charlie	938	-	52	30045175	31716
chr16	56535629	56735629	harbor1	chr16	56571708	56572005	DNA/hAT-Charlie	1347	-	148	56571856	36227
chr16	56535629	56735629	harbor1	chr16	56580361	56580581	DNA/hAT-Charlie	1222	-	110	56580471	44842
chr16	56535629	56735629	harbor1	chr16	56582152	56582347	DNA/hAT-Charlie	672	-	98	56582250	46621
chr16	73590	273590	harbor1	chr16	110914	111119	DNA/hAT-Charlie	877	-	102	111016	37426
chr16	73590	273590	harbor1	chr16	111404	111437	DNA/hAT-Charlie	877	-	16	111420	37830
chr16	73590	273590	harbor1	chr16	111753	112093	DNA/hAT-Charlie	1007	-	170	111923	38333
chr16	47149798	47349798	harbor1	chr16	47199606	47200130	DNA/hAT-Charlie	3647	-	262	47199868	50070
chr16	47149798	47349798	harbor1	chr16	47203289	47203813	DNA/hAT-Charlie	3907	-	262	47203551	53753
chr16	47149798	47349798	harbor1	chr16	47205181	47205389	DNA/hAT-Charlie	1181	-	104	47205285	55487
chr16	31032745	31232745	harbor1	chr16	31110853	31111050	DNA/hAT-Charlie	1008	-	98	31110951	78206
chr16	67009915	67209915	harbor1	chr16	67039722	67039870	DNA/hAT-Charlie	696	-	74	67039796	29881
chr16	30534673	30734673	harbor1	chr16	30608047	30608226	DNA/hAT-Charlie	905	-	90	30608137	73464
chr16	79500579	79700579	harbor1	chr16	79526163	79526516	DNA/hAT-Charlie	1734	-	176	79526339	25760
chr16	79500579	79700579	harbor1	chr16	79531326	79531848	DNA/hAT-Charlie	3370	-	261	79531587	31008
chr16	79500579	79700579	harbor1	chr16	79569150	79569365	DNA/hAT-Charlie	963	-	108	79569258	68679
chr16	79500579	79700579	harbor1	chr16	79569646	79569817	DNA/hAT-Charlie	689	-	86	79569732	69153
chr16	79500579	79700579	harbor1	chr16	79544201	79544399	DNA/hAT-Charlie	1007	-	99	79544300	43721
chr16	31042643	31242643	harbor1	chr16	31110853	31111050	DNA/hAT-Charlie	1008	-	98	31110951	68308
chr16	4718894	4918894	harbor1	chr16	4758570	4758734	DNA/hAT-Charlie	581	-	82	4758652	39758
chr16	4718894	4918894	harbor1	chr16	4790192	4790373	DNA/hAT-Charlie	861	-	90	4790282	71388
chr16	165471	365471	harbor1	chr16	245577	245768	DNA/hAT-Charlie	1107	-	96	245673	80202
chr16	167367	367367	harbor1	chr16	245577	245768	DNA/hAT-Charlie	1107	-	96	245673	78306
chr16	2184827	2384827	harbor1	chr16	2266703	2266979	DNA/hAT-Charlie	949	-	138	2266841	82014
chr16	870548	1070548	harbor1	chr16	935472	935655	DNA/hAT-Charlie	1168	-	92	935564	65016
chr16	71269697	71469697	harbor1	chr16	71296922	71297129	DNA/hAT-Charlie	912	-	104	71297026	27329
chr16	71269697	71469697	harbor1	chr16	71346808	71347077	DNA/hAT-Charlie	1474	-	134	71346942	77245
chr16	71269697	71469697	harbor1	chr16	71347119	71347153	DNA/hAT-Charlie	1474	-	17	71347136	77439
chr16	71269697	71469697	harbor1	chr16	71365532	71365708	DNA/hAT-Charlie	586	-	88	71365620	95923
chr16	870915	1070915	harbor1	chr16	935472	935655	DNA/hAT-Charlie	1168	-	92	935564	64649
chr16	2136853	2336853	harbor1	chr16	2156210	2156402	DNA/hAT-Charlie	736	-	96	2156306	19453
chr16	57884912	58084912	harbor1	chr16	57900586	57900927	DNA/hAT-Charlie	823	-	170	57900756	15844
chr16	57884912	58084912	harbor1	chr16	57937784	57937951	DNA/hAT-Charlie	741	-	84	57937868	52956
chr16	57884912	58084912	harbor1	chr16	57937966	57938125	DNA/hAT-Charlie	568	-	80	57938046	53134
chr16	57884912	58084912	harbor1	chr16	57954259	57954530	DNA/hAT-Charlie	607	-	136	57954395	69483
chr16	1872249	2072249	harbor1	chr16	1892884	1893006	DNA/hAT-Charlie	565	-	61	1892945	20696
chr16	73025	273025	harbor1	chr16	110914	111119	DNA/hAT-Charlie	877	-	102	111016	37991
chr16	73025	273025	harbor1	chr16	111404	111437	DNA/hAT-Charlie	877	-	16	111420	38395
chr16	73025	273025	harbor1	chr16	111753	112093	DNA/hAT-Charlie	1007	-	170	111923	38898
chr16	18689988	18889988	harbor1	chr16	18704866	18705156	DNA/hAT-Charlie	1151	-	145	18705011	15023
chr16	18689988	18889988	harbor1	chr16	18745125	18745287	DNA/hAT-Charlie	817	-	81	18745206	55218
chr16	73598	273598	harbor1	chr16	110914	111119	DNA/hAT-Charlie	877	-	102	111016	37418
chr16	73598	273598	harbor1	chr16	111404	111437	DNA/hAT-Charlie	877	-	16	111420	37822
chr16	73598	273598	harbor1	chr16	111753	112093	DNA/hAT-Charlie	1007	-	170	111923	38325
chr16	4312159	4512159	harbor1	chr16	4335732	4336007	DNA/hAT-Charlie	586	-	138	4335870	23711
chr16	4312159	4512159	harbor1	chr16	4410725	4410940	DNA/hAT-Charlie	1065	-	108	4410833	98674
chr16	1578327	1778327	harbor1	chr16	1601919	1602085	DNA/hAT-Charlie	586	-	83	1602002	23675
chr16	427636	627636	harbor1	chr16	461034	461360	DNA/hAT-Charlie	1625	-	163	461197	33561
chr16	30599212	30799212	harbor1	chr16	30608047	30608226	DNA/hAT-Charlie	905	-	90	30608137	8925
chr16	30599212	30799212	harbor1	chr16	30640280	30640589	DNA/hAT-Charlie	724	-	154	30640434	41222
chr16	28018013	28218013	harbor1	chr16	28034672	28034894	DNA/hAT-Charlie	1033	-	111	28034783	16770
chr16	28018013	28218013	harbor1	chr16	28057463	28057660	DNA/hAT-Charlie	612	-	98	28057561	39548
chr16	28018013	28218013	harbor1	chr16	28071651	28072547	DNA/hAT-Charlie	2682	-	448	28072099	54086
chr16	88587269	88787269	harbor1	chr16	88671322	88671831	DNA/hAT-Charlie	1175	-	254	88671576	84307
chr16	897114	1097114	harbor1	chr16	935472	935655	DNA/hAT-Charlie	1168	-	92	935564	38450
chr16	29349577	29549577	harbor1	chr16	29350027	29350236	DNA/hAT-Charlie	758	-	104	29350131	554
chr16	29349577	29549577	harbor1	chr16	29372430	29372564	DNA/hAT-Charlie	705	-	67	29372497	22920
chr16	29349577	29549577	harbor1	chr16	29394315	29394429	DNA/hAT-Charlie	1179	-	57	29394372	44795
chr16	29349577	29549577	harbor1	chr16	29395046	29395147	DNA/hAT-Charlie	1179	-	50	29395096	45519
chr16	870430	1070430	harbor1	chr16	935472	935655	DNA/hAT-Charlie	1168	-	92	935564	65134
chr16	57884931	58084931	harbor1	chr16	57900586	57900927	DNA/hAT-Charlie	823	-	170	57900756	15825
chr16	57884931	58084931	harbor1	chr16	57937784	57937951	DNA/hAT-Charlie	741	-	84	57937868	52937
chr16	57884931	58084931	harbor1	chr16	57937966	57938125	DNA/hAT-Charlie	568	-	80	57938046	53115
chr16	57884931	58084931	harbor1	chr16	57954259	57954530	DNA/hAT-Charlie	607	-	136	57954395	69464
chr16	75364612	75564612	harbor1	chr16	75371100	75371288	DNA/hAT-Charlie	829	-	94	75371194	6582
chr16	75364612	75564612	harbor1	chr16	75374668	75374952	DNA/hAT-Charlie	973	-	142	75374810	10198
chr16	75364612	75564612	harbor1	chr16	75388458	75388656	DNA/hAT-Charlie	598	-	99	75388557	23945
chr16	75364612	75564612	harbor1	chr16	75454095	75454296	DNA/hAT-Charlie	868	-	100	75454195	89583
chr16	85541766	85741766	harbor1	chr16	85571279	85571494	DNA/hAT-Charlie	829	-	108	85571387	29621
chr16	85541766	85741766	harbor1	chr16	85596573	85596753	DNA/hAT-Charlie	620	-	90	85596663	54897
chr16	427637	627637	harbor1	chr16	461034	461360	DNA/hAT-Charlie	1625	-	163	461197	33560
chr16	57884956	58084956	harbor1	chr16	57900586	57900927	DNA/hAT-Charlie	823	-	170	57900756	15800
chr16	57884956	58084956	harbor1	chr16	57937784	57937951	DNA/hAT-Charlie	741	-	84	57937868	52912
chr16	57884956	58084956	harbor1	chr16	57937966	57938125	DNA/hAT-Charlie	568	-	80	57938046	53090
chr16	57884956	58084956	harbor1	chr16	57954259	57954530	DNA/hAT-Charlie	607	-	136	57954395	69439
chr16	875427	1075427	harbor1	chr16	935472	935655	DNA/hAT-Charlie	1168	-	92	935564	60137
chr16	2865156	3065156	harbor1	chr16	2910884	2911083	DNA/hAT-Charlie	855	-	100	2910984	45828
chr16	67063131	67263131	harbor1	chr16	67119378	67119520	DNA/hAT-Charlie	1258	-	71	67119449	56318
chr16	67063131	67263131	harbor1	chr16	67119828	67119899	DNA/hAT-Charlie	1258	-	36	67119864	56733
chr16	57884909	58084909	harbor1	chr16	57900586	57900927	DNA/hAT-Charlie	823	-	170	57900756	15847
chr16	57884909	58084909	harbor1	chr16	57937784	57937951	DNA/hAT-Charlie	741	-	84	57937868	52959
chr16	57884909	58084909	harbor1	chr16	57937966	57938125	DNA/hAT-Charlie	568	-	80	57938046	53137
chr16	57884909	58084909	harbor1	chr16	57954259	57954530	DNA/hAT-Charlie	607	-	136	57954395	69486
chr16	87748370	87948370	harbor1	chr16	87758587	87758755	DNA/hAT-Charlie	1038	-	84	87758671	10301
chr16	87748370	87948370	harbor1	chr16	87796877	87797318	DNA/hAT-Charlie	1000	-	220	87797097	48727
chr16	87748370	87948370	harbor1	chr16	87797626	87797713	DNA/hAT-Charlie	1000	-	44	87797670	49300
chr16	87748370	87948370	harbor1	chr16	87807584	87807731	DNA/hAT-Charlie	1184	-	74	87807658	59288
chr16	87748370	87948370	harbor1	chr16	87808028	87808089	DNA/hAT-Charlie	1184	-	30	87808058	59688
chr16	2865150	3065150	harbor1	chr16	2910884	2911083	DNA/hAT-Charlie	855	-	100	2910984	45834
chr17	79709440	79909440	harbor1	chr17	79775701	79775849	DNA/hAT-Charlie	686	-	74	79775775	66335
chr17	79702953	79902953	harbor1	chr17	79775701	79775849	DNA/hAT-Charlie	686	-	74	79775775	72822
chr17	55165220	55365220	harbor1	chr17	55214842	55215187	DNA/hAT-Charlie	2451	-	172	55215014	49794
chr17	55165220	55365220	harbor1	chr17	55229744	55229963	DNA/hAT-Charlie	1004	-	110	55229854	64634
chr17	55165220	55365220	harbor1	chr17	55264555	55264696	DNA/hAT-Charlie	773	-	70	55264625	99405
chr17	1527914	1727914	harbor1	chr17	1607679	1607721	DNA/hAT-Charlie	893	-	21	1607700	79786
chr17	1527914	1727914	harbor1	chr17	1608015	1608203	DNA/hAT-Charlie	893	-	94	1608109	80195
chr17	63676342	63876342	harbor1	chr17	63705200	63705388	DNA/hAT-Charlie	718	-	94	63705294	28952
chr17	63676342	63876342	harbor1	chr17	63716607	63716833	DNA/hAT-Charlie	757	-	113	63716720	40378
chr17	63676342	63876342	harbor1	chr17	63769668	63769878	DNA/hAT-Charlie	1481	-	105	63769773	93431
chr17	2838072	3038072	harbor1	chr17	2916246	2916441	DNA/hAT-Charlie	879	-	98	2916344	78272
chr17	987890	1187890	harbor1	chr17	999756	999902	DNA/hAT-Charlie	722	-	73	999829	11939
chr17	987890	1187890	harbor1	chr17	1013947	1014159	DNA/hAT-Charlie	848	-	106	1014053	26163
chr17	987890	1187890	harbor1	chr17	1014545	1014556	DNA/hAT-Charlie	974	-	6	1014551	26661
chr17	987890	1187890	harbor1	chr17	1014870	1015135	DNA/hAT-Charlie	974	-	132	1015002	27112
chr17	987890	1187890	harbor1	chr17	1015436	1015457	DNA/hAT-Charlie	974	-	10	1015446	27556
chr17	987890	1187890	harbor1	chr17	1016038	1016299	DNA/hAT-Charlie	892	-	130	1016168	28278
chr17	987890	1187890	harbor1	chr17	1015758	1015949	DNA/hAT-Charlie	974	-	96	1015854	27964
chr17	58388439	58588439	harbor1	chr17	58425823	58425968	DNA/hAT-Charlie	702	-	72	58425895	37456
chr17	58388439	58588439	harbor1	chr17	58427858	58428187	DNA/hAT-Charlie	1622	-	164	58428022	39583
chr17	2838075	3038075	harbor1	chr17	2916246	2916441	DNA/hAT-Charlie	879	-	98	2916344	78269
chr17	48623726	48823726	harbor1	chr17	48676338	48676891	DNA/hAT-Charlie	2787	-	276	48676614	52888
chr17	76768659	76968659	harbor1	chr17	76812294	76812527	DNA/hAT-Charlie	675	-	116	76812410	43751
chr17	80785283	80985283	harbor1	chr17	80807790	80807961	DNA/hAT-Charlie	652	-	86	80807876	22593
chr17	79702897	79902897	harbor1	chr17	79775701	79775849	DNA/hAT-Charlie	686	-	74	79775775	72878
chr17	64956159	65156159	harbor1	chr17	64959481	64959719	DNA/hAT-Charlie	1239	-	119	64959600	3441
chr17	64956159	65156159	harbor1	chr17	64959747	64959770	DNA/hAT-Charlie	1239	-	12	64959759	3600
chr17	18132683	18332683	harbor1	chr17	18169652	18169816	DNA/hAT-Charlie	630	-	82	18169734	37051
chr17	18132683	18332683	harbor1	chr17	18170035	18170225	DNA/hAT-Charlie	811	-	95	18170130	37447
chr17	18132683	18332683	harbor1	chr17	18187398	18187602	DNA/hAT-Charlie	785	-	102	18187500	54817
chr17	79702898	79902898	harbor1	chr17	79775701	79775849	DNA/hAT-Charlie	686	-	74	79775775	72877
chr17	48339875	48539875	harbor1	chr17	48405164	48405374	DNA/hAT-Charlie	1145	-	105	48405269	65394
chr17	48339875	48539875	harbor1	chr17	48405798	48405909	DNA/hAT-Charlie	1145	-	56	48405854	65979
chr17	48339875	48539875	harbor1	chr17	48420762	48420973	DNA/hAT-Charlie	1317	-	106	48420868	80993
chr17	76768658	76968658	harbor1	chr17	76812294	76812527	DNA/hAT-Charlie	675	-	116	76812410	43752
chr17	7813042	8013042	harbor1	chr17	7819650	7819811	DNA/hAT-Charlie	601	-	80	7819730	6688
chr17	81088157	81288157	harbor1	chr17	81102407	81102604	DNA/hAT-Charlie	661	-	98	81102505	14348
chr17	56020599	56220599	harbor1	chr17	56021042	56021258	DNA/hAT-Charlie	1014	-	108	56021150	551
chr17	56020599	56220599	harbor1	chr17	56109333	56109543	DNA/hAT-Charlie	1255	-	105	56109438	88839
chr17	78924128	79124128	harbor1	chr17	78931022	78931205	DNA/hAT-Charlie	855	-	92	78931114	6986
chr17	7142998	7342998	harbor1	chr17	7166907	7167069	DNA/hAT-Charlie	832	-	81	7166988	23990
chr17	8056331	8256331	harbor1	chr17	8119377	8119654	DNA/hAT-Charlie	701	-	138	8119515	63184
chr17	79702899	79902899	harbor1	chr17	79775701	79775849	DNA/hAT-Charlie	686	-	74	79775775	72876
chr17	67266541	67466541	harbor1	chr17	67350866	67351055	DNA/hAT-Charlie	672	-	94	67350960	84419
chr17	79689709	79889709	harbor1	chr17	79775701	79775849	DNA/hAT-Charlie	686	-	74	79775775	86066
chr17	2838074	3038074	harbor1	chr17	2916246	2916441	DNA/hAT-Charlie	879	-	98	2916344	78270
chr17	1528042	1728042	harbor1	chr17	1607679	1607721	DNA/hAT-Charlie	893	-	21	1607700	79658
chr17	1528042	1728042	harbor1	chr17	1608015	1608203	DNA/hAT-Charlie	893	-	94	1608109	80067
chr17	79743478	79943478	harbor1	chr17	79775701	79775849	DNA/hAT-Charlie	686	-	74	79775775	32297
chr17	64956153	65156153	harbor1	chr17	64959481	64959719	DNA/hAT-Charlie	1239	-	119	64959600	3447
chr17	64956153	65156153	harbor1	chr17	64959747	64959770	DNA/hAT-Charlie	1239	-	12	64959759	3606
chr17	76283247	76483247	harbor1	chr17	76314057	76314201	DNA/hAT-Charlie	920	-	72	76314129	30882
chr17	76283247	76483247	harbor1	chr17	76314517	76314546	DNA/hAT-Charlie	920	-	14	76314531	31284
chr17	76283247	76483247	harbor1	chr17	76314670	76314769	DNA/hAT-Charlie	920	-	50	76314720	31473
chr17	76283247	76483247	harbor1	chr17	76317954	76318144	DNA/hAT-Charlie	805	-	95	76318049	34802
chr17	50408598	50608598	harbor1	chr17	50482891	50483015	DNA/hAT-Charlie	662	-	62	50482953	74355
chr17	58416995	58616995	harbor1	chr17	58425823	58425968	DNA/hAT-Charlie	702	-	72	58425895	8900
chr17	58416995	58616995	harbor1	chr17	58427858	58428187	DNA/hAT-Charlie	1622	-	164	58428022	11027
chr17	58416995	58616995	harbor1	chr17	58507681	58507883	DNA/hAT-Charlie	714	-	101	58507782	90787
chr17	39087193	39287193	harbor1	chr17	39140186	39140300	DNA/hAT-Charlie	637	-	57	39140243	53050
chr17	39087193	39287193	harbor1	chr17	39140605	39140682	DNA/hAT-Charlie	637	-	38	39140643	53450
chr17	39087193	39287193	harbor1	chr17	39142011	39142194	DNA/hAT-Charlie	916	-	92	39142103	54910
chr17	39087193	39287193	harbor1	chr17	39153486	39153612	DNA/hAT-Charlie	619	-	63	39153549	66356
chr17	39087193	39287193	harbor1	chr17	39163252	39163339	DNA/hAT-Charlie	709	-	44	39163296	76103
chr17	39087193	39287193	harbor1	chr17	39163692	39163702	DNA/hAT-Charlie	709	-	5	39163697	76504
chr17	39087193	39287193	harbor1	chr17	39164229	39164303	DNA/hAT-Charlie	709	-	37	39164266	77073
chr17	17393446	17593446	harbor1	chr17	17458464	17458510	DNA/hAT-Charlie	776	-	23	17458487	65041
chr17	17393446	17593446	harbor1	chr17	17458805	17458936	DNA/hAT-Charlie	776	-	66	17458871	65425
chr17	17393446	17593446	harbor1	chr17	17478211	17478577	DNA/hAT-Charlie	841	-	183	17478394	84948
chr17	17393446	17593446	harbor1	chr17	17478873	17479110	DNA/hAT-Charlie	841	-	118	17478991	85545
chr17	30610000	30810000	harbor1	chr17	30612089	30612576	DNA/hAT-Charlie	3277	-	244	30612333	2333
chr17	30610000	30810000	harbor1	chr17	30672383	30672595	DNA/hAT-Charlie	1126	-	106	30672489	62489
chr17	1548006	1748006	harbor1	chr17	1607679	1607721	DNA/hAT-Charlie	893	-	21	1607700	59694
chr17	1548006	1748006	harbor1	chr17	1608015	1608203	DNA/hAT-Charlie	893	-	94	1608109	60103
chr17	63600181	63800181	harbor1	chr17	63659458	63659525	DNA/hAT-Charlie	954	-	34	63659492	59311
chr17	63600181	63800181	harbor1	chr17	63659828	63660074	DNA/hAT-Charlie	954	-	123	63659951	59770
chr17	79696398	79896398	harbor1	chr17	79775701	79775849	DNA/hAT-Charlie	686	-	74	79775775	79377
chr17	76768628	76968628	harbor1	chr17	76812294	76812527	DNA/hAT-Charlie	675	-	116	76812410	43782
chr17	76768654	76968654	harbor1	chr17	76812294	76812527	DNA/hAT-Charlie	675	-	116	76812410	43756
chr17	15555287	15755287	harbor1	chr17	15584981	15585261	DNA/hAT-Charlie	995	-	140	15585121	29834
chr17	76283501	76483501	harbor1	chr17	76314057	76314201	DNA/hAT-Charlie	920	-	72	76314129	30628
chr17	76283501	76483501	harbor1	chr17	76314517	76314546	DNA/hAT-Charlie	920	-	14	76314531	31030
chr17	76283501	76483501	harbor1	chr17	76314670	76314769	DNA/hAT-Charlie	920	-	50	76314720	31219
chr17	76283501	76483501	harbor1	chr17	76317954	76318144	DNA/hAT-Charlie	805	-	95	76318049	34548
chr17	33191683	33391683	harbor1	chr17	33209418	33209630	DNA/hAT-Charlie	1237	-	106	33209524	17841
chr17	33191683	33391683	harbor1	chr17	33214581	33214723	DNA/hAT-Charlie	801	-	71	33214652	22969
chr17	33191683	33391683	harbor1	chr17	33226796	33227135	DNA/hAT-Charlie	1103	-	170	33226966	35283
chr17	33191683	33391683	harbor1	chr17	33232563	33232775	DNA/hAT-Charlie	793	-	106	33232669	40986
chr17	33191683	33391683	harbor1	chr17	33259763	33259934	DNA/hAT-Charlie	715	-	86	33259849	68166
chr17	33191705	33391705	harbor1	chr17	33209418	33209630	DNA/hAT-Charlie	1237	-	106	33209524	17819
chr17	33191705	33391705	harbor1	chr17	33214581	33214723	DNA/hAT-Charlie	801	-	71	33214652	22947
chr17	33191705	33391705	harbor1	chr17	33226796	33227135	DNA/hAT-Charlie	1103	-	170	33226966	35261
chr17	33191705	33391705	harbor1	chr17	33232563	33232775	DNA/hAT-Charlie	793	-	106	33232669	40964
chr17	33191705	33391705	harbor1	chr17	33259763	33259934	DNA/hAT-Charlie	715	-	86	33259849	68144
chr17	43590747	43790747	harbor1	chr17	43593772	43593923	DNA/hAT-Charlie	834	-	76	43593848	3101
chr17	43590747	43790747	harbor1	chr17	43620381	43620695	DNA/hAT-Charlie	924	-	157	43620538	29791
chr17	80841308	81041308	harbor1	chr17	80899628	80899854	DNA/hAT-Charlie	686	-	113	80899741	58433
chr17	8023310	8223310	harbor1	chr17	8119377	8119654	DNA/hAT-Charlie	701	-	138	8119515	96205
chr17	286286	486286	harbor1	chr17	329500	329980	DNA/hAT-Charlie	1712	-	240	329740	43454
chr17	286286	486286	harbor1	chr17	351649	351813	DNA/hAT-Charlie	695	-	82	351731	65445
chr17	57767550	57967550	harbor1	chr17	57859405	57859568	DNA/hAT-Charlie	912	-	82	57859487	91937
chr17	57767550	57967550	harbor1	chr17	57859580	57859742	DNA/hAT-Charlie	814	-	81	57859661	92111
chr17	57767550	57967550	harbor1	chr17	57860601	57860723	DNA/hAT-Charlie	612	-	61	57860662	93112
chr17	987847	1187847	harbor1	chr17	999756	999902	DNA/hAT-Charlie	722	-	73	999829	11982
chr17	987847	1187847	harbor1	chr17	1013947	1014159	DNA/hAT-Charlie	848	-	106	1014053	26206
chr17	987847	1187847	harbor1	chr17	1014545	1014556	DNA/hAT-Charlie	974	-	6	1014551	26704
chr17	987847	1187847	harbor1	chr17	1014870	1015135	DNA/hAT-Charlie	974	-	132	1015002	27155
chr17	987847	1187847	harbor1	chr17	1015436	1015457	DNA/hAT-Charlie	974	-	10	1015446	27599
chr17	987847	1187847	harbor1	chr17	1016038	1016299	DNA/hAT-Charlie	892	-	130	1016168	28321
chr17	987847	1187847	harbor1	chr17	1015758	1015949	DNA/hAT-Charlie	974	-	96	1015854	28007
chr17	36836264	37036264	harbor1	chr17	36849157	36849194	DNA/hAT-Charlie	1449	-	18	36849175	12911
chr17	36836264	37036264	harbor1	chr17	36849498	36849805	DNA/hAT-Charlie	1449	-	154	36849652	13388
chr17	36836264	37036264	harbor1	chr17	36876135	36876217	DNA/hAT-Charlie	656	-	41	36876176	39912
chr17	36836264	37036264	harbor1	chr17	36876809	36876872	DNA/hAT-Charlie	656	-	32	36876841	40577
chr17	36836264	37036264	harbor1	chr17	36924530	36924705	DNA/hAT-Charlie	826	-	88	36924618	88354
chr17	38631460	38831460	harbor1	chr17	38653817	38654030	DNA/hAT-Charlie	1196	-	106	38653923	22463
chr17	38631460	38831460	harbor1	chr17	38708549	38708614	DNA/hAT-Charlie	1010	-	32	38708581	77121
chr17	38631460	38831460	harbor1	chr17	38708925	38709069	DNA/hAT-Charlie	1010	-	72	38708997	77537
chr17	41516785	41716785	harbor1	chr17	41592544	41592905	DNA/hAT-Charlie	2021	-	180	41592724	75939
chr17	57827332	58027332	harbor1	chr17	57859405	57859568	DNA/hAT-Charlie	912	-	82	57859487	32155
chr17	57827332	58027332	harbor1	chr17	57859580	57859742	DNA/hAT-Charlie	814	-	81	57859661	32329
chr17	57827332	58027332	harbor1	chr17	57860601	57860723	DNA/hAT-Charlie	612	-	61	57860662	33330
chr17	57827332	58027332	harbor1	chr17	57911082	57911255	DNA/hAT-Charlie	900	-	86	57911168	83836
chr17	987852	1187852	harbor1	chr17	999756	999902	DNA/hAT-Charlie	722	-	73	999829	11977
chr17	987852	1187852	harbor1	chr17	1013947	1014159	DNA/hAT-Charlie	848	-	106	1014053	26201
chr17	987852	1187852	harbor1	chr17	1014545	1014556	DNA/hAT-Charlie	974	-	6	1014551	26699
chr17	987852	1187852	harbor1	chr17	1014870	1015135	DNA/hAT-Charlie	974	-	132	1015002	27150
chr17	987852	1187852	harbor1	chr17	1015436	1015457	DNA/hAT-Charlie	974	-	10	1015446	27594
chr17	987852	1187852	harbor1	chr17	1016038	1016299	DNA/hAT-Charlie	892	-	130	1016168	28316
chr17	987852	1187852	harbor1	chr17	1015758	1015949	DNA/hAT-Charlie	974	-	96	1015854	28002
chr17	79702893	79902893	harbor1	chr17	79775701	79775849	DNA/hAT-Charlie	686	-	74	79775775	72882
chr17	79702970	79902970	harbor1	chr17	79775701	79775849	DNA/hAT-Charlie	686	-	74	79775775	72805
chr17	31921178	32121178	harbor1	chr17	31943244	31943653	DNA/hAT-Charlie	1561	-	204	31943448	22270
chr17	31921178	32121178	harbor1	chr17	32010178	32010386	DNA/hAT-Charlie	816	-	104	32010282	89104
chr17	78924157	79124157	harbor1	chr17	78931022	78931205	DNA/hAT-Charlie	855	-	92	78931114	6957
chr17	2829895	3029895	harbor1	chr17	2916246	2916441	DNA/hAT-Charlie	879	-	98	2916344	86449
chr17	78252870	78452870	harbor1	chr17	78319657	78319878	DNA/hAT-Charlie	1123	-	110	78319767	66897
chr17	78252870	78452870	harbor1	chr17	78320501	78320513	DNA/hAT-Charlie	1123	-	6	78320507	67637
chr17	78252870	78452870	harbor1	chr17	78320809	78320896	DNA/hAT-Charlie	1123	-	44	78320853	67983
chr17	76768627	76968627	harbor1	chr17	76812294	76812527	DNA/hAT-Charlie	675	-	116	76812410	43783
chr17	15134573	15334573	harbor1	chr17	15161131	15161622	DNA/hAT-Charlie	3412	-	246	15161377	26804
chr17	1548969	1748969	harbor1	chr17	1607679	1607721	DNA/hAT-Charlie	893	-	21	1607700	58731
chr17	1548969	1748969	harbor1	chr17	1608015	1608203	DNA/hAT-Charlie	893	-	94	1608109	59140
chr17	42914345	43114345	harbor1	chr17	42995104	42995261	DNA/hAT-Charlie	869	-	78	42995182	80837
chr17	76485502	76685502	harbor1	chr17	76500154	76500378	DNA/hAT-Charlie	1060	-	112	76500266	14764
chr17	76485502	76685502	harbor1	chr17	76560338	76560578	DNA/hAT-Charlie	1195	-	120	76560458	74956
chr17	2837929	3037929	harbor1	chr17	2916246	2916441	DNA/hAT-Charlie	879	-	98	2916344	78415
chr17	31921150	32121150	harbor1	chr17	31943244	31943653	DNA/hAT-Charlie	1561	-	204	31943448	22298
chr17	31921150	32121150	harbor1	chr17	32010178	32010386	DNA/hAT-Charlie	816	-	104	32010282	89132
chr17	32166126	32366126	harbor1	chr17	32177176	32177372	DNA/hAT-Charlie	892	-	98	32177274	11148
chr17	32166126	32366126	harbor1	chr17	32214172	32214478	DNA/hAT-Charlie	870	-	153	32214325	48199
chr17	32166126	32366126	harbor1	chr17	32230442	32230667	DNA/hAT-Charlie	1120	-	112	32230554	64428
chr17	32166126	32366126	harbor1	chr17	32230955	32231003	DNA/hAT-Charlie	1120	-	24	32230979	64853
chr17	32166126	32366126	harbor1	chr17	32194387	32194577	DNA/hAT-Charlie	904	-	95	32194482	28356
chr17	79689289	79889289	harbor1	chr17	79775701	79775849	DNA/hAT-Charlie	686	-	74	79775775	86486
chr17	6918778	7118778	harbor1	chr17	6986960	6987008	DNA/hAT-Charlie	623	-	24	6986984	68206
chr17	6918778	7118778	harbor1	chr17	6987315	6987434	DNA/hAT-Charlie	623	-	60	6987375	68597
chr17	6918778	7118778	harbor1	chr17	7000700	7000884	DNA/hAT-Charlie	979	-	92	7000792	82014
chr17	6918778	7118778	harbor1	chr17	7010573	7010872	DNA/hAT-Charlie	947	-	150	7010723	91945
chr17	40256634	40456634	harbor1	chr17	40263146	40263475	DNA/hAT-Charlie	2079	-	164	40263310	6676
chr17	40256634	40456634	harbor1	chr17	40353989	40354189	DNA/hAT-Charlie	1193	-	100	40354089	97455
chr17	79689683	79889683	harbor1	chr17	79775701	79775849	DNA/hAT-Charlie	686	-	74	79775775	86092
chr17	76283274	76483274	harbor1	chr17	76314057	76314201	DNA/hAT-Charlie	920	-	72	76314129	30855
chr17	76283274	76483274	harbor1	chr17	76314517	76314546	DNA/hAT-Charlie	920	-	14	76314531	31257
chr17	76283274	76483274	harbor1	chr17	76314670	76314769	DNA/hAT-Charlie	920	-	50	76314720	31446
chr17	76283274	76483274	harbor1	chr17	76317954	76318144	DNA/hAT-Charlie	805	-	95	76318049	34775
chr17	1548896	1748896	harbor1	chr17	1607679	1607721	DNA/hAT-Charlie	893	-	21	1607700	58804
chr17	1548896	1748896	harbor1	chr17	1608015	1608203	DNA/hAT-Charlie	893	-	94	1608109	59213
chr17	33191648	33391648	harbor1	chr17	33209418	33209630	DNA/hAT-Charlie	1237	-	106	33209524	17876
chr17	33191648	33391648	harbor1	chr17	33214581	33214723	DNA/hAT-Charlie	801	-	71	33214652	23004
chr17	33191648	33391648	harbor1	chr17	33226796	33227135	DNA/hAT-Charlie	1103	-	170	33226966	35318
chr17	33191648	33391648	harbor1	chr17	33232563	33232775	DNA/hAT-Charlie	793	-	106	33232669	41021
chr17	33191648	33391648	harbor1	chr17	33259763	33259934	DNA/hAT-Charlie	715	-	86	33259849	68201
chr17	77858865	78058865	harbor1	chr17	77955318	77955485	DNA/hAT-Charlie	824	-	84	77955402	96537
chr17	44256633	44456633	harbor1	chr17	44343089	44343299	DNA/hAT-Charlie	1060	-	105	44343194	86561
chr17	79689660	79889660	harbor1	chr17	79775701	79775849	DNA/hAT-Charlie	686	-	74	79775775	86115
chr17	40257301	40457301	harbor1	chr17	40263146	40263475	DNA/hAT-Charlie	2079	-	164	40263310	6009
chr17	40257301	40457301	harbor1	chr17	40353989	40354189	DNA/hAT-Charlie	1193	-	100	40354089	96788
chr17	45358313	45558313	harbor1	chr17	45383021	45383297	DNA/hAT-Charlie	629	-	138	45383159	24846
chr17	45358313	45558313	harbor1	chr17	45452745	45452935	DNA/hAT-Charlie	766	-	95	45452840	94527
chr17	38349446	38549446	harbor1	chr17	38382884	38383082	DNA/hAT-Charlie	909	-	99	38382983	33537
chr17	30610045	30810045	harbor1	chr17	30612089	30612576	DNA/hAT-Charlie	3277	-	244	30612333	2288
chr17	30610045	30810045	harbor1	chr17	30672383	30672595	DNA/hAT-Charlie	1126	-	106	30672489	62444
chr17	48808683	49008683	harbor1	chr17	48898214	48898436	DNA/hAT-Charlie	865	-	111	48898325	89642
chr17	48647673	48847673	harbor1	chr17	48676338	48676891	DNA/hAT-Charlie	2787	-	276	48676614	28941
chr17	30994986	31194986	harbor1	chr17	31015592	31015927	DNA/hAT-Charlie	2217	-	168	31015760	20774
chr17	30994986	31194986	harbor1	chr17	31025589	31026075	DNA/hAT-Charlie	3277	-	243	31025832	30846
chr17	30994986	31194986	harbor1	chr17	31038898	31039109	DNA/hAT-Charlie	1045	-	106	31039004	44018
chr17	30994986	31194986	harbor1	chr17	31041716	31041902	DNA/hAT-Charlie	796	-	93	31041809	46823
chr17	7079598	7279598	harbor1	chr17	7166907	7167069	DNA/hAT-Charlie	832	-	81	7166988	87390
chr17	987876	1187876	harbor1	chr17	999756	999902	DNA/hAT-Charlie	722	-	73	999829	11953
chr17	987876	1187876	harbor1	chr17	1013947	1014159	DNA/hAT-Charlie	848	-	106	1014053	26177
chr17	987876	1187876	harbor1	chr17	1014545	1014556	DNA/hAT-Charlie	974	-	6	1014551	26675
chr17	987876	1187876	harbor1	chr17	1014870	1015135	DNA/hAT-Charlie	974	-	132	1015002	27126
chr17	987876	1187876	harbor1	chr17	1015436	1015457	DNA/hAT-Charlie	974	-	10	1015446	27570
chr17	987876	1187876	harbor1	chr17	1016038	1016299	DNA/hAT-Charlie	892	-	130	1016168	28292
chr17	987876	1187876	harbor1	chr17	1015758	1015949	DNA/hAT-Charlie	974	-	96	1015854	27978
chr17	15161857	15361857	harbor1	chr17	15246192	15246420	DNA/hAT-Charlie	803	-	114	15246306	84449
chr17	9856590	10056590	harbor1	chr17	9878098	9878416	DNA/hAT-Charlie	920	-	159	9878257	21667
chr17	9856590	10056590	harbor1	chr17	9942683	9942997	DNA/hAT-Charlie	829	-	157	9942840	86250
chr18	26126454	26326454	harbor1	chr18	26129759	26129958	DNA/hAT-Charlie	939	-	100	26129859	3405
chr18	26126454	26326454	harbor1	chr18	26172270	26172486	DNA/hAT-Charlie	773	-	108	26172378	45924
chr18	26126454	26326454	harbor1	chr18	26193686	26193811	DNA/hAT-Charlie	1427	-	62	26193748	67294
chr18	26126454	26326454	harbor1	chr18	26194105	26194266	DNA/hAT-Charlie	1427	-	80	26194185	67731
chr18	26126454	26326454	harbor1	chr18	26203619	26203740	DNA/hAT-Charlie	537	-	60	26203679	77225
chr18	37465330	37665330	harbor1	chr18	37479360	37479528	DNA/hAT-Charlie	918	-	84	37479444	14114
chr18	26126532	26326532	harbor1	chr18	26129759	26129958	DNA/hAT-Charlie	939	-	100	26129859	3327
chr18	26126532	26326532	harbor1	chr18	26172270	26172486	DNA/hAT-Charlie	773	-	108	26172378	45846
chr18	26126532	26326532	harbor1	chr18	26193686	26193811	DNA/hAT-Charlie	1427	-	62	26193748	67216
chr18	26126532	26326532	harbor1	chr18	26194105	26194266	DNA/hAT-Charlie	1427	-	80	26194185	67653
chr18	26126532	26326532	harbor1	chr18	26203619	26203740	DNA/hAT-Charlie	537	-	60	26203679	77147
chr18	49713903	49913903	harbor1	chr18	49759416	49759630	DNA/hAT-Charlie	501	-	107	49759523	45620
chr18	49713903	49913903	harbor1	chr18	49798319	49798468	DNA/hAT-Charlie	608	-	74	49798393	84490
chr18	26126502	26326502	harbor1	chr18	26129759	26129958	DNA/hAT-Charlie	939	-	100	26129859	3357
chr18	26126502	26326502	harbor1	chr18	26172270	26172486	DNA/hAT-Charlie	773	-	108	26172378	45876
chr18	26126502	26326502	harbor1	chr18	26193686	26193811	DNA/hAT-Charlie	1427	-	62	26193748	67246
chr18	26126502	26326502	harbor1	chr18	26194105	26194266	DNA/hAT-Charlie	1427	-	80	26194185	67683
chr18	26126502	26326502	harbor1	chr18	26203619	26203740	DNA/hAT-Charlie	537	-	60	26203679	77177
chr18	31997343	32197343	harbor1	chr18	32044305	32044542	DNA/hAT-Charlie	1017	-	118	32044423	47080
chr18	31997343	32197343	harbor1	chr18	32057775	32057963	DNA/hAT-Charlie	1041	-	94	32057869	60526
chr18	26126451	26326451	harbor1	chr18	26129759	26129958	DNA/hAT-Charlie	939	-	100	26129859	3408
chr18	26126451	26326451	harbor1	chr18	26172270	26172486	DNA/hAT-Charlie	773	-	108	26172378	45927
chr18	26126451	26326451	harbor1	chr18	26193686	26193811	DNA/hAT-Charlie	1427	-	62	26193748	67297
chr18	26126451	26326451	harbor1	chr18	26194105	26194266	DNA/hAT-Charlie	1427	-	80	26194185	67734
chr18	26126451	26326451	harbor1	chr18	26203619	26203740	DNA/hAT-Charlie	537	-	60	26203679	77228
chr18	26126452	26326452	harbor1	chr18	26129759	26129958	DNA/hAT-Charlie	939	-	100	26129859	3407
chr18	26126452	26326452	harbor1	chr18	26172270	26172486	DNA/hAT-Charlie	773	-	108	26172378	45926
chr18	26126452	26326452	harbor1	chr18	26193686	26193811	DNA/hAT-Charlie	1427	-	62	26193748	67296
chr18	26126452	26326452	harbor1	chr18	26194105	26194266	DNA/hAT-Charlie	1427	-	80	26194185	67733
chr18	26126452	26326452	harbor1	chr18	26203619	26203740	DNA/hAT-Charlie	537	-	60	26203679	77227
chr18	42426133	42626133	harbor1	chr18	42480981	42481191	DNA/hAT-Charlie	1058	-	105	42481086	54953
chr18	42426133	42626133	harbor1	chr18	42491554	42491790	DNA/hAT-Charlie	986	-	118	42491672	65539
chr18	42426133	42626133	harbor1	chr18	42495285	42495482	DNA/hAT-Charlie	410	-	98	42495383	69250
chr18	74356692	74556692	harbor1	chr18	74379192	74379718	DNA/hAT-Charlie	3674	-	263	74379455	22763
chr18	74356692	74556692	harbor1	chr18	74444473	74444637	DNA/hAT-Charlie	698	-	82	74444555	87863
chr18	74356714	74556714	harbor1	chr18	74379192	74379718	DNA/hAT-Charlie	3674	-	263	74379455	22741
chr18	74356714	74556714	harbor1	chr18	74444473	74444637	DNA/hAT-Charlie	698	-	82	74444555	87841
chr18	23734554	23934554	harbor1	chr18	23833121	23833196	DNA/hAT-Charlie	483	-	38	23833159	98605
chr18	74356712	74556712	harbor1	chr18	74379192	74379718	DNA/hAT-Charlie	3674	-	263	74379455	22743
chr18	74356712	74556712	harbor1	chr18	74444473	74444637	DNA/hAT-Charlie	698	-	82	74444555	87843
chr18	25820834	26020834	harbor1	chr18	25861460	25861648	DNA/hAT-Charlie	840	-	94	25861554	40720
chr18	26126453	26326453	harbor1	chr18	26129759	26129958	DNA/hAT-Charlie	939	-	100	26129859	3406
chr18	26126453	26326453	harbor1	chr18	26172270	26172486	DNA/hAT-Charlie	773	-	108	26172378	45925
chr18	26126453	26326453	harbor1	chr18	26193686	26193811	DNA/hAT-Charlie	1427	-	62	26193748	67295
chr18	26126453	26326453	harbor1	chr18	26194105	26194266	DNA/hAT-Charlie	1427	-	80	26194185	67732
chr18	26126453	26326453	harbor1	chr18	26203619	26203740	DNA/hAT-Charlie	537	-	60	26203679	77226
chr18	79688392	79888392	harbor1	chr18	79756541	79756922	DNA/hAT-Charlie	848	-	190	79756731	68339
chr18	37465383	37665383	harbor1	chr18	37479360	37479528	DNA/hAT-Charlie	918	-	84	37479444	14061
chr18	46333461	46533461	harbor1	chr18	46348719	46348900	DNA/hAT-Charlie	688	-	90	46348809	15348
chr18	46333461	46533461	harbor1	chr18	46348949	46348998	DNA/hAT-Charlie	688	-	24	46348973	15512
chr18	46333461	46533461	harbor1	chr18	46395311	46395438	DNA/hAT-Charlie	705	-	64	46395375	61914
chr18	46333461	46533461	harbor1	chr18	46417692	46417720	DNA/hAT-Charlie	826	-	14	46417706	84245
chr18	46333461	46533461	harbor1	chr18	46418011	46418074	DNA/hAT-Charlie	826	-	32	46418043	84582
chr18	46333461	46533461	harbor1	chr18	46418366	46418552	DNA/hAT-Charlie	826	-	93	46418459	84998
chr18	75105267	75305267	harbor1	chr18	75119447	75119645	DNA/hAT-Charlie	990	-	99	75119546	14279
chr18	75105267	75305267	harbor1	chr18	75152797	75152970	DNA/hAT-Charlie	498	-	86	75152883	47616
chr18	57486434	57686434	harbor1	chr18	57514498	57514816	DNA/hAT-Charlie	1437	-	159	57514657	28223
chr18	57486434	57686434	harbor1	chr18	57538712	57538859	DNA/hAT-Charlie	404	-	74	57538786	52352
chr18	57486434	57686434	harbor1	chr18	57576011	57576235	DNA/hAT-Charlie	1003	-	112	57576123	89689
chr18	42910981	43110981	harbor1	chr18	42916065	42916255	DNA/hAT-Charlie	772	-	95	42916160	5179
chr18	42910981	43110981	harbor1	chr18	42946255	42946333	DNA/hAT-Charlie	399	-	39	42946294	35313
chr18	42910981	43110981	harbor1	chr18	42989241	42989370	DNA/hAT-Charlie	626	-	64	42989305	78324
chr18	42910981	43110981	harbor1	chr18	42989376	42989687	DNA/hAT-Charlie	1082	-	156	42989532	78551
chr18	59165754	59365754	harbor1	chr18	59179850	59180014	DNA/hAT-Charlie	853	-	82	59179932	14178
chr18	59165754	59365754	harbor1	chr18	59208442	59208684	DNA/hAT-Charlie	972	-	121	59208563	42809
chr18	59165754	59365754	harbor1	chr18	59216959	59217202	DNA/hAT-Charlie	1001	-	122	59217081	51327
chr18	59165754	59365754	harbor1	chr18	59230178	59230325	DNA/hAT-Charlie	903	-	74	59230252	64498
chr18	11589068	11789068	harbor1	chr18	11630013	11630126	DNA/hAT-Charlie	1146	-	56	11630069	41001
chr18	11589068	11789068	harbor1	chr18	11630743	11630842	DNA/hAT-Charlie	1146	-	50	11630793	41725
chr18	11589068	11789068	harbor1	chr18	11640707	11640912	DNA/hAT-Charlie	435	-	102	11640809	51741
chr18	11589068	11789068	harbor1	chr18	11666672	11666977	DNA/hAT-Charlie	572	-	152	11666824	77756
chr18	11589068	11789068	harbor1	chr18	11684848	11685054	DNA/hAT-Charlie	802	-	103	11684951	95883
chr18	46488673	46688673	harbor1	chr18	46491206	46491314	DNA/hAT-Charlie	416	-	54	46491260	2587
chr18	46488673	46688673	harbor1	chr18	46491311	46491483	DNA/hAT-Charlie	872	-	86	46491397	2724
chr18	46488673	46688673	harbor1	chr18	46562699	46562877	DNA/hAT-Charlie	461	-	89	46562788	74115
chr18	46488673	46688673	harbor1	chr18	46570646	46570860	DNA/hAT-Charlie	1550	-	107	46570753	82080
chr18	25890292	26090292	harbor1	chr18	25949516	25949742	DNA/hAT-Charlie	437	-	113	25949629	59337
chr18	12207967	12407967	harbor1	chr18	12268752	12268830	DNA/hAT-Charlie	2276	-	39	12268791	60824
chr18	12207967	12407967	harbor1	chr18	12269118	12269625	DNA/hAT-Charlie	2276	-	254	12269372	61405
chr18	65651295	65851295	harbor1	chr18	65657585	65657711	DNA/hAT-Charlie	453	-	63	65657648	6353
chr18	65651295	65851295	harbor1	chr18	65660834	65661039	DNA/hAT-Charlie	403	-	102	65660936	9641
chr18	65651295	65851295	harbor1	chr18	65714255	65714511	DNA/hAT-Charlie	961	-	128	65714383	63088
chr18	65651295	65851295	harbor1	chr18	65723165	65723317	DNA/hAT-Charlie	678	-	76	65723241	71946
chr18	74356740	74556740	harbor1	chr18	74379192	74379718	DNA/hAT-Charlie	3674	-	263	74379455	22715
chr18	74356740	74556740	harbor1	chr18	74444473	74444637	DNA/hAT-Charlie	698	-	82	74444555	87815
chr18	48702843	48902843	harbor1	chr18	48730039	48730178	DNA/hAT-Charlie	441	-	70	48730109	27266
chr18	48702843	48902843	harbor1	chr18	48731814	48732033	DNA/hAT-Charlie	1008	-	110	48731924	29081
chr18	48702843	48902843	harbor1	chr18	48766167	48766330	DNA/hAT-Charlie	790	-	82	48766249	63406
chr18	59165766	59365766	harbor1	chr18	59179850	59180014	DNA/hAT-Charlie	853	-	82	59179932	14166
chr18	59165766	59365766	harbor1	chr18	59208442	59208684	DNA/hAT-Charlie	972	-	121	59208563	42797
chr18	59165766	59365766	harbor1	chr18	59216959	59217202	DNA/hAT-Charlie	1001	-	122	59217081	51315
chr18	59165766	59365766	harbor1	chr18	59230178	59230325	DNA/hAT-Charlie	903	-	74	59230252	64486
chr18	59165800	59365800	harbor1	chr18	59179850	59180014	DNA/hAT-Charlie	853	-	82	59179932	14132
chr18	59165800	59365800	harbor1	chr18	59208442	59208684	DNA/hAT-Charlie	972	-	121	59208563	42763
chr18	59165800	59365800	harbor1	chr18	59216959	59217202	DNA/hAT-Charlie	1001	-	122	59217081	51281
chr18	59165800	59365800	harbor1	chr18	59230178	59230325	DNA/hAT-Charlie	903	-	74	59230252	64452
chr18	65651274	65851274	harbor1	chr18	65657585	65657711	DNA/hAT-Charlie	453	-	63	65657648	6374
chr18	65651274	65851274	harbor1	chr18	65660834	65661039	DNA/hAT-Charlie	403	-	102	65660936	9662
chr18	65651274	65851274	harbor1	chr18	65714255	65714511	DNA/hAT-Charlie	961	-	128	65714383	63109
chr18	65651274	65851274	harbor1	chr18	65723165	65723317	DNA/hAT-Charlie	678	-	76	65723241	71967
chr19	19441368	19641368	harbor1	chr19	19478838	19479240	DNA/hAT-Charlie	943	-	201	19479039	37671
chr19	19441368	19641368	harbor1	chr19	19480216	19480490	DNA/hAT-Charlie	935	-	137	19480353	38985
chr19	49461215	49661215	harbor1	chr19	49482573	49482627	DNA/hAT-Charlie	803	-	27	49482600	21385
chr19	49461215	49661215	harbor1	chr19	49482925	49483116	DNA/hAT-Charlie	803	-	96	49483021	21806
chr19	49461215	49661215	harbor1	chr19	49483415	49483517	DNA/hAT-Charlie	803	-	51	49483466	22251
chr19	9669009	9869009	harbor1	chr19	9762672	9762844	DNA/hAT-Charlie	1044	-	86	9762758	93749
chr19	49751331	49951331	harbor1	chr19	49779518	49779606	DNA/hAT-Charlie	775	-	44	49779562	28231
chr19	49751331	49951331	harbor1	chr19	49779718	49779872	DNA/hAT-Charlie	775	-	77	49779795	28464
chr19	49751331	49951331	harbor1	chr19	49823784	49824003	DNA/hAT-Charlie	1108	-	110	49823894	72563
chr19	56021024	56221024	harbor1	chr19	56094687	56094828	DNA/hAT-Charlie	1959	-	70	56094757	73733
chr19	56021024	56221024	harbor1	chr19	56095125	56095318	DNA/hAT-Charlie	1959	-	96	56095221	74197
chr19	5027258	5227258	harbor1	chr19	5037627	5037833	DNA/hAT-Charlie	832	-	103	5037730	10472
chr19	5027258	5227258	harbor1	chr19	5105740	5105933	DNA/hAT-Charlie	884	-	96	5105836	78578
chr19	5027258	5227258	harbor1	chr19	5112283	5112351	DNA/hAT-Charlie	669	-	34	5112317	85059
chr19	5027258	5227258	harbor1	chr19	5111710	5111971	DNA/hAT-Charlie	669	-	130	5111840	84582
chr19	5034078	5234078	harbor1	chr19	5037627	5037833	DNA/hAT-Charlie	832	-	103	5037730	3652
chr19	5034078	5234078	harbor1	chr19	5105740	5105933	DNA/hAT-Charlie	884	-	96	5105836	71758
chr19	5034078	5234078	harbor1	chr19	5112283	5112351	DNA/hAT-Charlie	669	-	34	5112317	78239
chr19	5034078	5234078	harbor1	chr19	5111710	5111971	DNA/hAT-Charlie	669	-	130	5111840	77762
chr19	1350382	1550382	harbor1	chr19	1384438	1384803	DNA/hAT-Charlie	1139	-	182	1384620	34238
chr19	1350382	1550382	harbor1	chr19	1406676	1406890	DNA/hAT-Charlie	898	-	107	1406783	56401
chr19	19403431	19603431	harbor1	chr19	19478838	19479240	DNA/hAT-Charlie	943	-	201	19479039	75608
chr19	19403431	19603431	harbor1	chr19	19480216	19480490	DNA/hAT-Charlie	935	-	137	19480353	76922
chr19	19432673	19632673	harbor1	chr19	19478838	19479240	DNA/hAT-Charlie	943	-	201	19479039	46366
chr19	19432673	19632673	harbor1	chr19	19480216	19480490	DNA/hAT-Charlie	935	-	137	19480353	47680
chr19	1350427	1550427	harbor1	chr19	1384438	1384803	DNA/hAT-Charlie	1139	-	182	1384620	34193
chr19	1350427	1550427	harbor1	chr19	1406676	1406890	DNA/hAT-Charlie	898	-	107	1406783	56356
chr19	3283783	3483783	harbor1	chr19	3328788	3328973	DNA/hAT-Charlie	933	-	92	3328880	45097
chr19	3283783	3483783	harbor1	chr19	3330415	3330451	DNA/hAT-Charlie	933	-	18	3330433	46650
chr19	3283783	3483783	harbor1	chr19	3343701	3343922	DNA/hAT-Charlie	811	-	110	3343811	60028
chr19	49751333	49951333	harbor1	chr19	49779518	49779606	DNA/hAT-Charlie	775	-	44	49779562	28229
chr19	49751333	49951333	harbor1	chr19	49779718	49779872	DNA/hAT-Charlie	775	-	77	49779795	28462
chr19	49751333	49951333	harbor1	chr19	49823784	49824003	DNA/hAT-Charlie	1108	-	110	49823894	72561
chr19	10073322	10273322	harbor1	chr19	10163592	10163760	DNA/hAT-Charlie	713	-	84	10163676	90354
chr19	12912166	13112166	harbor1	chr19	12934827	12934855	DNA/hAT-Charlie	774	-	14	12934841	22675
chr19	12912166	13112166	harbor1	chr19	12935150	12935293	DNA/hAT-Charlie	774	-	72	12935222	23056
chr19	35101286	35301286	harbor1	chr19	35172002	35172190	DNA/hAT-Charlie	863	-	94	35172096	70810
chr19	35101286	35301286	harbor1	chr19	35172494	35172619	DNA/hAT-Charlie	863	-	62	35172556	71270
chr19	35101286	35301286	harbor1	chr19	35181600	35181917	DNA/hAT-Charlie	1376	-	158	35181758	80472
chr19	5489614	5689614	harbor1	chr19	5506432	5506643	DNA/hAT-Charlie	883	-	106	5506538	16924
chr19	767419	967419	harbor1	chr19	840292	840491	DNA/hAT-Charlie	652	-	100	840392	72973
chr19	7856194	8056194	harbor1	chr19	7949298	7949493	DNA/hAT-Charlie	1049	-	98	7949396	93202
chr19	2710214	2910214	harbor1	chr19	2728719	2728921	DNA/hAT-Charlie	732	-	101	2728820	18606
chr19	2710214	2910214	harbor1	chr19	2750776	2750979	DNA/hAT-Charlie	890	-	102	2750878	40664
chr19	2710214	2910214	harbor1	chr19	2760070	2760236	DNA/hAT-Charlie	711	-	83	2760153	49939
chr19	2710214	2910214	harbor1	chr19	2760550	2760588	DNA/hAT-Charlie	711	-	19	2760569	50355
chr19	2710214	2910214	harbor1	chr19	2781344	2781557	DNA/hAT-Charlie	882	-	106	2781450	71236
chr19	2710214	2910214	harbor1	chr19	2782096	2782289	DNA/hAT-Charlie	725	-	96	2782192	71978
chr19	49751330	49951330	harbor1	chr19	49779518	49779606	DNA/hAT-Charlie	775	-	44	49779562	28232
chr19	49751330	49951330	harbor1	chr19	49779718	49779872	DNA/hAT-Charlie	775	-	77	49779795	28465
chr19	49751330	49951330	harbor1	chr19	49823784	49824003	DNA/hAT-Charlie	1108	-	110	49823894	72564
chr19	54982219	55182219	harbor1	chr19	55003838	55004050	DNA/hAT-Charlie	653	-	106	55003944	21725
chr19	54982219	55182219	harbor1	chr19	55065536	55065731	DNA/hAT-Charlie	780	-	98	55065634	83415
chr19	49751332	49951332	harbor1	chr19	49779518	49779606	DNA/hAT-Charlie	775	-	44	49779562	28230
chr19	49751332	49951332	harbor1	chr19	49779718	49779872	DNA/hAT-Charlie	775	-	77	49779795	28463
chr19	49751332	49951332	harbor1	chr19	49823784	49824003	DNA/hAT-Charlie	1108	-	110	49823894	72562
chr19	35166986	35366986	harbor1	chr19	35172002	35172190	DNA/hAT-Charlie	863	-	94	35172096	5110
chr19	35166986	35366986	harbor1	chr19	35172494	35172619	DNA/hAT-Charlie	863	-	62	35172556	5570
chr19	35166986	35366986	harbor1	chr19	35181600	35181917	DNA/hAT-Charlie	1376	-	158	35181758	14772
chr19	35166986	35366986	harbor1	chr19	35256292	35256631	DNA/hAT-Charlie	733	-	170	35256462	89476
chr19	35166986	35366986	harbor1	chr19	35260840	35260996	DNA/hAT-Charlie	643	-	78	35260918	93932
chr19	2710232	2910232	harbor1	chr19	2728719	2728921	DNA/hAT-Charlie	732	-	101	2728820	18588
chr19	2710232	2910232	harbor1	chr19	2750776	2750979	DNA/hAT-Charlie	890	-	102	2750878	40646
chr19	2710232	2910232	harbor1	chr19	2760070	2760236	DNA/hAT-Charlie	711	-	83	2760153	49921
chr19	2710232	2910232	harbor1	chr19	2760550	2760588	DNA/hAT-Charlie	711	-	19	2760569	50337
chr19	2710232	2910232	harbor1	chr19	2781344	2781557	DNA/hAT-Charlie	882	-	106	2781450	71218
chr19	2710232	2910232	harbor1	chr19	2782096	2782289	DNA/hAT-Charlie	725	-	96	2782192	71960
chr19	1464901	1664901	harbor1	chr19	1477564	1477814	DNA/hAT-Charlie	788	-	125	1477689	12788
chr19	7530548	7730548	harbor1	chr19	7539030	7539196	DNA/hAT-Charlie	828	-	83	7539113	8565
chr19	7530548	7730548	harbor1	chr19	7539781	7539820	DNA/hAT-Charlie	828	-	20	7539801	9253
chr19	7530548	7730548	harbor1	chr19	7547982	7548064	DNA/hAT-Charlie	1533	-	41	7548023	17475
chr19	7530548	7730548	harbor1	chr19	7548364	7548521	DNA/hAT-Charlie	1533	-	78	7548442	17894
chr19	7530548	7730548	harbor1	chr19	7609525	7610004	DNA/hAT-Charlie	2870	-	240	7609765	79217
chr19	32305852	32505852	harbor1	chr19	32402828	32402994	DNA/hAT-Charlie	776	-	83	32402911	97059
chr19	56018924	56218924	harbor1	chr19	56094687	56094828	DNA/hAT-Charlie	1959	-	70	56094757	75833
chr19	56018924	56218924	harbor1	chr19	56095125	56095318	DNA/hAT-Charlie	1959	-	96	56095221	76297
chr19	39407220	39607220	harbor1	chr19	39453858	39454271	DNA/hAT-Charlie	1305	-	206	39454064	46844
chr19	39407220	39607220	harbor1	chr19	39484461	39484663	DNA/hAT-Charlie	830	-	101	39484562	77342
chr19	41922838	42122838	harbor1	chr19	41953509	41953597	DNA/hAT-Charlie	748	-	44	41953553	30715
chr19	41922838	42122838	harbor1	chr19	41954192	41954332	DNA/hAT-Charlie	748	-	70	41954262	31424
chr19	41922838	42122838	harbor1	chr19	41959692	41959853	DNA/hAT-Charlie	737	-	80	41959772	36934
chr19	49751427	49951427	harbor1	chr19	49779518	49779606	DNA/hAT-Charlie	775	-	44	49779562	28135
chr19	49751427	49951427	harbor1	chr19	49779718	49779872	DNA/hAT-Charlie	775	-	77	49779795	28368
chr19	49751427	49951427	harbor1	chr19	49823784	49824003	DNA/hAT-Charlie	1108	-	110	49823894	72467
chr19	13726269	13926269	harbor1	chr19	13733319	13733440	DNA/hAT-Charlie	854	-	60	13733379	7110
chr19	13726269	13926269	harbor1	chr19	13733736	13733845	DNA/hAT-Charlie	854	-	54	13733790	7521
chr19	13726269	13926269	harbor1	chr19	13797520	13797642	DNA/hAT-Charlie	1425	-	61	13797581	71312
chr19	13726269	13926269	harbor1	chr19	13797955	13798052	DNA/hAT-Charlie	1425	-	48	13798003	71734
chr19	1350400	1550400	harbor1	chr19	1384438	1384803	DNA/hAT-Charlie	1139	-	182	1384620	34220
chr19	1350400	1550400	harbor1	chr19	1406676	1406890	DNA/hAT-Charlie	898	-	107	1406783	56383
chr19	1160927	1360927	harbor1	chr19	1185662	1185860	DNA/hAT-Charlie	664	-	99	1185761	24834
chr19	49750827	49950827	harbor1	chr19	49779518	49779606	DNA/hAT-Charlie	775	-	44	49779562	28735
chr19	49750827	49950827	harbor1	chr19	49779718	49779872	DNA/hAT-Charlie	775	-	77	49779795	28968
chr19	49750827	49950827	harbor1	chr19	49823784	49824003	DNA/hAT-Charlie	1108	-	110	49823894	73067
chr19	9484484	9684484	harbor1	chr19	9490512	9490725	DNA/hAT-Charlie	798	-	106	9490618	6134
chr19	9484484	9684484	harbor1	chr19	9523590	9523915	DNA/hAT-Charlie	2142	-	162	9523752	39268
chr19	9484484	9684484	harbor1	chr19	9567463	9567937	DNA/hAT-Charlie	2859	-	237	9567700	83216
chr19	9484484	9684484	harbor1	chr19	9571097	9571297	DNA/hAT-Charlie	937	-	100	9571197	86713
chr19	19952525	20152525	harbor1	chr19	20021023	20021226	DNA/hAT-Charlie	1351	-	102	20021125	68600
chr19	317396	517396	harbor1	chr19	352738	353011	DNA/hAT-Charlie	1007	-	136	352874	35478
chr19	8046259	8246259	harbor1	chr19	8073547	8073703	DNA/hAT-Charlie	674	-	78	8073625	27366
chr19	8046259	8246259	harbor1	chr19	8073943	8074045	DNA/hAT-Charlie	674	-	51	8073994	27735
chr19	8046259	8246259	harbor1	chr19	8080004	8080199	DNA/hAT-Charlie	699	-	98	8080102	33843
chr19	8046259	8246259	harbor1	chr19	8081604	8081804	DNA/hAT-Charlie	837	-	100	8081704	35445
chr19	8046259	8246259	harbor1	chr19	8104684	8104881	DNA/hAT-Charlie	832	-	98	8104782	58523
chr19	8046259	8246259	harbor1	chr19	8129520	8129720	DNA/hAT-Charlie	782	-	100	8129620	83361
chr19	9986276	10186276	harbor1	chr19	10067479	10067647	DNA/hAT-Charlie	874	-	84	10067563	81287
chr19	1460984	1660984	harbor1	chr19	1477564	1477814	DNA/hAT-Charlie	788	-	125	1477689	16705
chr19	8877739	9077739	harbor1	chr19	8930443	8930561	DNA/hAT-Charlie	703	-	59	8930502	52763
chr19	8877739	9077739	harbor1	chr19	8970487	8970627	DNA/hAT-Charlie	1275	-	70	8970557	92818
chr19	8877739	9077739	harbor1	chr19	8971020	8971339	DNA/hAT-Charlie	1275	-	160	8971180	93441
chr19	36005131	36205131	harbor1	chr19	36020627	36020782	DNA/hAT-Charlie	828	-	78	36020705	15574
chr19	36005131	36205131	harbor1	chr19	36044255	36044478	DNA/hAT-Charlie	747	-	112	36044367	39236
chr19	36005131	36205131	harbor1	chr19	36044788	36044846	DNA/hAT-Charlie	747	-	29	36044817	39686
chr19	483635	683635	harbor1	chr19	515009	515205	DNA/hAT-Charlie	746	-	98	515107	31472
chr19	9728412	9928412	harbor1	chr19	9762672	9762844	DNA/hAT-Charlie	1044	-	86	9762758	34346
chr19	9728412	9928412	harbor1	chr19	9796600	9796793	DNA/hAT-Charlie	1397	-	96	9796696	68284
chr19	12885297	13085297	harbor1	chr19	12934827	12934855	DNA/hAT-Charlie	774	-	14	12934841	49544
chr19	12885297	13085297	harbor1	chr19	12935150	12935293	DNA/hAT-Charlie	774	-	72	12935222	49925
chr19	55254096	55454096	harbor1	chr19	55256277	55256490	DNA/hAT-Charlie	871	-	106	55256383	2287
chr19	55254096	55454096	harbor1	chr19	55269113	55269330	DNA/hAT-Charlie	1278	-	108	55269221	15125
chr19	55254096	55454096	harbor1	chr19	55350180	55350379	DNA/hAT-Charlie	699	-	100	55350280	96184
chr19	190676	390676	harbor1	chr19	201674	202093	DNA/hAT-Charlie	2447	-	210	201884	11208
chr19	190676	390676	harbor1	chr19	205088	205507	DNA/hAT-Charlie	2493	-	210	205298	14622
chr19	190676	390676	harbor1	chr19	208824	209255	DNA/hAT-Charlie	2989	-	216	209040	18364
chr19	37894961	38094961	harbor1	chr19	37916649	37916677	DNA/hAT-Charlie	1461	-	14	37916663	21702
chr19	37894961	38094961	harbor1	chr19	37916972	37917268	DNA/hAT-Charlie	1461	-	148	37917120	22159
chr19	37894961	38094961	harbor1	chr19	37928266	37928288	DNA/hAT-Charlie	676	-	11	37928277	33316
chr19	37894961	38094961	harbor1	chr19	37928594	37928751	DNA/hAT-Charlie	676	-	78	37928672	33711
chr19	37894961	38094961	harbor1	chr19	37953993	37954248	DNA/hAT-Charlie	767	-	128	37954121	59160
chr19	37894961	38094961	harbor1	chr19	37972231	37972420	DNA/hAT-Charlie	1192	-	94	37972325	77364
chr19	37894961	38094961	harbor1	chr19	37972724	37972901	DNA/hAT-Charlie	1192	-	88	37972812	77851
chr19	37894961	38094961	harbor1	chr19	37987420	37987625	DNA/hAT-Charlie	776	-	102	37987522	92561
chr19	1467965	1667965	harbor1	chr19	1477564	1477814	DNA/hAT-Charlie	788	-	125	1477689	9724
chr19	14106923	14306923	harbor1	chr19	14118741	14118959	DNA/hAT-Charlie	809	-	109	14118850	11927
chr19	14106923	14306923	harbor1	chr19	14142837	14143034	DNA/hAT-Charlie	819	-	98	14142935	36012
chr19	5499898	5699898	harbor1	chr19	5506432	5506643	DNA/hAT-Charlie	883	-	106	5506538	6640
chr19	31989361	32189361	harbor1	chr19	32062326	32062472	DNA/hAT-Charlie	687	-	73	32062399	73038
chr19	12938463	13138463	harbor1	chr19	13034906	13035121	DNA/hAT-Charlie	1011	-	108	13035014	96551
chr19	49751463	49951463	harbor1	chr19	49779518	49779606	DNA/hAT-Charlie	775	-	44	49779562	28099
chr19	49751463	49951463	harbor1	chr19	49779718	49779872	DNA/hAT-Charlie	775	-	77	49779795	28332
chr19	49751463	49951463	harbor1	chr19	49823784	49824003	DNA/hAT-Charlie	1108	-	110	49823894	72431
chr19	10320198	10520198	harbor1	chr19	10366637	10366763	DNA/hAT-Charlie	1480	-	63	10366700	46502
chr19	10320198	10520198	harbor1	chr19	10367060	10367169	DNA/hAT-Charlie	1480	-	54	10367114	46916
chr19	10320198	10520198	harbor1	chr19	10392156	10392365	DNA/hAT-Charlie	758	-	104	10392260	72062
chr19	10171312	10371312	harbor1	chr19	10203726	10203948	DNA/hAT-Charlie	1057	-	111	10203837	32525
chr19	38117750	38317750	harbor1	chr19	38165664	38165762	DNA/hAT-Charlie	655	-	49	38165713	47963
chr19	38117750	38317750	harbor1	chr19	38166062	38166132	DNA/hAT-Charlie	655	-	35	38166097	48347
chr19	2356892	2556892	harbor1	chr19	2399638	2399705	DNA/hAT-Charlie	923	-	34	2399672	42780
chr19	2356892	2556892	harbor1	chr19	2400027	2400209	DNA/hAT-Charlie	923	-	91	2400118	43226
chr19	2356892	2556892	harbor1	chr19	2439399	2439590	DNA/hAT-Charlie	663	-	96	2439495	82603
chr19	1467960	1667960	harbor1	chr19	1477564	1477814	DNA/hAT-Charlie	788	-	125	1477689	9729
chr19	16789062	16989062	harbor1	chr19	16828935	16829240	DNA/hAT-Charlie	1240	-	152	16829087	40025
chr19	16789062	16989062	harbor1	chr19	16832910	16833107	DNA/hAT-Charlie	875	-	98	16833008	43946
chr19	16789062	16989062	harbor1	chr19	16849236	16849410	DNA/hAT-Charlie	772	-	87	16849323	60261
chr19	19416225	19616225	harbor1	chr19	19478838	19479240	DNA/hAT-Charlie	943	-	201	19479039	62814
chr19	19416225	19616225	harbor1	chr19	19480216	19480490	DNA/hAT-Charlie	935	-	137	19480353	64128
chr19	2131495	2331495	harbor1	chr19	2160758	2160964	DNA/hAT-Charlie	744	-	103	2160861	29366
chr19	940126	1140126	harbor1	chr19	940198	940382	DNA/hAT-Charlie	1041	-	92	940290	164
chr19	940126	1140126	harbor1	chr19	1022734	1022980	DNA/hAT-Charlie	1144	-	123	1022857	82731
chr19	2356895	2556895	harbor1	chr19	2399638	2399705	DNA/hAT-Charlie	923	-	34	2399672	42777
chr19	2356895	2556895	harbor1	chr19	2400027	2400209	DNA/hAT-Charlie	923	-	91	2400118	43223
chr19	2356895	2556895	harbor1	chr19	2439399	2439590	DNA/hAT-Charlie	663	-	96	2439495	82600
chr19	41650423	41850423	harbor1	chr19	41702079	41702266	DNA/hAT-Charlie	761	-	94	41702173	51750
chr19	49750826	49950826	harbor1	chr19	49779518	49779606	DNA/hAT-Charlie	775	-	44	49779562	28736
chr19	49750826	49950826	harbor1	chr19	49779718	49779872	DNA/hAT-Charlie	775	-	77	49779795	28969
chr19	49750826	49950826	harbor1	chr19	49823784	49824003	DNA/hAT-Charlie	1108	-	110	49823894	73068
chr19	32305891	32505891	harbor1	chr19	32402828	32402994	DNA/hAT-Charlie	776	-	83	32402911	97020
chr19	2356896	2556896	harbor1	chr19	2399638	2399705	DNA/hAT-Charlie	923	-	34	2399672	42776
chr19	2356896	2556896	harbor1	chr19	2400027	2400209	DNA/hAT-Charlie	923	-	91	2400118	43222
chr19	2356896	2556896	harbor1	chr19	2439399	2439590	DNA/hAT-Charlie	663	-	96	2439495	82599
chr19	32305909	32505909	harbor1	chr19	32402828	32402994	DNA/hAT-Charlie	776	-	83	32402911	97002
chr19	317267	517267	harbor1	chr19	352738	353011	DNA/hAT-Charlie	1007	-	136	352874	35607
chr19	35167341	35367341	harbor1	chr19	35172002	35172190	DNA/hAT-Charlie	863	-	94	35172096	4755
chr19	35167341	35367341	harbor1	chr19	35172494	35172619	DNA/hAT-Charlie	863	-	62	35172556	5215
chr19	35167341	35367341	harbor1	chr19	35181600	35181917	DNA/hAT-Charlie	1376	-	158	35181758	14417
chr19	35167341	35367341	harbor1	chr19	35256292	35256631	DNA/hAT-Charlie	733	-	170	35256462	89121
chr19	35167341	35367341	harbor1	chr19	35260840	35260996	DNA/hAT-Charlie	643	-	78	35260918	93577
chr19	1	171208	harbor1	chr19	88504	88703	DNA/hAT-Charlie	923	-	100	88604	88603
chr19	4691699	4891699	harbor1	chr19	4694196	4694413	DNA/hAT-Charlie	1063	-	108	4694304	2605
chr19	4691699	4891699	harbor1	chr19	4706848	4707058	DNA/hAT-Charlie	725	-	105	4706953	15254
chr19	4691699	4891699	harbor1	chr19	4754930	4755118	DNA/hAT-Charlie	654	-	94	4755024	63325
chr19	49239891	49439891	harbor1	chr19	49325694	49325882	DNA/hAT-Charlie	1709	-	94	49325788	85897
chr19	49239891	49439891	harbor1	chr19	49326198	49326471	DNA/hAT-Charlie	1709	-	136	49326334	86443
chr19	39990768	40190768	harbor1	chr19	39990961	39991287	DNA/hAT-Charlie	2148	-	163	39991124	356
chr19	39990768	40190768	harbor1	chr19	40000757	40001283	DNA/hAT-Charlie	3651	-	263	40001020	10252
chr19	39990768	40190768	harbor1	chr19	40016540	40016744	DNA/hAT-Charlie	735	-	102	40016642	25874
chr19	39990768	40190768	harbor1	chr19	40052168	40052343	DNA/hAT-Charlie	727	-	88	40052256	61488
chr19	39990768	40190768	harbor1	chr19	40087238	40087411	DNA/hAT-Charlie	686	-	86	40087324	96556
chr19	1413306	1613306	harbor1	chr19	1477564	1477814	DNA/hAT-Charlie	788	-	125	1477689	64383
chr19	32305831	32505831	harbor1	chr19	32402828	32402994	DNA/hAT-Charlie	776	-	83	32402911	97080
chr19	1467959	1667959	harbor1	chr19	1477564	1477814	DNA/hAT-Charlie	788	-	125	1477689	9730
chr19	19414965	19614965	harbor1	chr19	19478838	19479240	DNA/hAT-Charlie	943	-	201	19479039	64074
chr19	19414965	19614965	harbor1	chr19	19480216	19480490	DNA/hAT-Charlie	935	-	137	19480353	65388
chr19	1466241	1666241	harbor1	chr19	1477564	1477814	DNA/hAT-Charlie	788	-	125	1477689	11448
chr19	1	160441	harbor1	chr19	88504	88703	DNA/hAT-Charlie	923	-	100	88604	88603
chr19	208646	408646	harbor1	chr19	208824	209255	DNA/hAT-Charlie	2989	-	216	209040	394
chr19	10189421	10389421	harbor1	chr19	10203726	10203948	DNA/hAT-Charlie	1057	-	111	10203837	14416
chr19	10295939	10495939	harbor1	chr19	10366637	10366763	DNA/hAT-Charlie	1480	-	63	10366700	70761
chr19	10295939	10495939	harbor1	chr19	10367060	10367169	DNA/hAT-Charlie	1480	-	54	10367114	71175
chr19	10295939	10495939	harbor1	chr19	10392156	10392365	DNA/hAT-Charlie	758	-	104	10392260	96321
chr19	49707032	49907032	harbor1	chr19	49779518	49779606	DNA/hAT-Charlie	775	-	44	49779562	72530
chr19	49707032	49907032	harbor1	chr19	49779718	49779872	DNA/hAT-Charlie	775	-	77	49779795	72763
chr19	15279126	15479126	harbor1	chr19	15286584	15286782	DNA/hAT-Charlie	895	-	99	15286683	7557
chr19	15279126	15479126	harbor1	chr19	15340352	15340448	DNA/hAT-Charlie	966	-	48	15340400	61274
chr19	15279126	15479126	harbor1	chr19	15341357	15341521	DNA/hAT-Charlie	966	-	82	15341439	62313
chr19	15279126	15479126	harbor1	chr19	15341847	15341946	DNA/hAT-Charlie	966	-	50	15341897	62771
chr19	1154283	1354283	harbor1	chr19	1185662	1185860	DNA/hAT-Charlie	664	-	99	1185761	31478
chr19	12922472	13122472	harbor1	chr19	12934827	12934855	DNA/hAT-Charlie	774	-	14	12934841	12369
chr19	12922472	13122472	harbor1	chr19	12935150	12935293	DNA/hAT-Charlie	774	-	72	12935222	12750
chr19	409019	609019	harbor1	chr19	452752	452897	DNA/hAT-Charlie	660	-	72	452824	43805
chr19	409019	609019	harbor1	chr19	481733	481770	DNA/hAT-Charlie	1115	-	18	481751	72732
chr19	409019	609019	harbor1	chr19	482076	482335	DNA/hAT-Charlie	1115	-	130	482206	73187
chr19	54981488	55181488	harbor1	chr19	55003838	55004050	DNA/hAT-Charlie	653	-	106	55003944	22456
chr19	54981488	55181488	harbor1	chr19	55065536	55065731	DNA/hAT-Charlie	780	-	98	55065634	84146
chr19	9719420	9919420	harbor1	chr19	9762672	9762844	DNA/hAT-Charlie	1044	-	86	9762758	43338
chr19	9719420	9919420	harbor1	chr19	9796600	9796793	DNA/hAT-Charlie	1397	-	96	9796696	77276
chr19	6129382	6329382	harbor1	chr19	6162685	6162872	DNA/hAT-Charlie	832	-	94	6162779	33397
chr19	6129382	6329382	harbor1	chr19	6186188	6186486	DNA/hAT-Charlie	899	-	149	6186337	56955
chr19	6129382	6329382	harbor1	chr19	6204319	6204508	DNA/hAT-Charlie	708	-	94	6204413	75031
chr19	5504847	5704847	harbor1	chr19	5506432	5506643	DNA/hAT-Charlie	883	-	106	5506538	1691
chr19	44993164	45193164	harbor1	chr19	45015928	45015986	DNA/hAT-Charlie	890	-	29	45015957	22793
chr19	44993164	45193164	harbor1	chr19	45016285	45016618	DNA/hAT-Charlie	890	-	166	45016451	23287
chr19	19952303	20152303	harbor1	chr19	20021023	20021226	DNA/hAT-Charlie	1351	-	102	20021125	68822
chr19	18421887	18621887	harbor1	chr19	18471907	18471956	DNA/hAT-Charlie	1811	-	24	18471931	50044
chr19	18421887	18621887	harbor1	chr19	18472263	18472555	DNA/hAT-Charlie	1811	-	146	18472409	50522
chr19	18421887	18621887	harbor1	chr19	18508662	18508868	DNA/hAT-Charlie	780	-	103	18508765	86878
chr19	7762917	7962917	harbor1	chr19	7770828	7771348	DNA/hAT-Charlie	3555	-	260	7771088	8171
chr19	49751494	49951494	harbor1	chr19	49779518	49779606	DNA/hAT-Charlie	775	-	44	49779562	28068
chr19	49751494	49951494	harbor1	chr19	49779718	49779872	DNA/hAT-Charlie	775	-	77	49779795	28301
chr19	49751494	49951494	harbor1	chr19	49823784	49824003	DNA/hAT-Charlie	1108	-	110	49823894	72400
chr19	10192772	10392772	harbor1	chr19	10203726	10203948	DNA/hAT-Charlie	1057	-	111	10203837	11065
chr19	1350403	1550403	harbor1	chr19	1384438	1384803	DNA/hAT-Charlie	1139	-	182	1384620	34217
chr19	1350403	1550403	harbor1	chr19	1406676	1406890	DNA/hAT-Charlie	898	-	107	1406783	56380
chr19	5491922	5691922	harbor1	chr19	5506432	5506643	DNA/hAT-Charlie	883	-	106	5506538	14616
chr19	3288086	3488086	harbor1	chr19	3328788	3328973	DNA/hAT-Charlie	933	-	92	3328880	40794
chr19	3288086	3488086	harbor1	chr19	3330415	3330451	DNA/hAT-Charlie	933	-	18	3330433	42347
chr19	3288086	3488086	harbor1	chr19	3343701	3343922	DNA/hAT-Charlie	811	-	110	3343811	55725
chr19	2685572	2885572	harbor1	chr19	2693569	2693765	DNA/hAT-Charlie	638	-	98	2693667	8095
chr19	2685572	2885572	harbor1	chr19	2728719	2728921	DNA/hAT-Charlie	732	-	101	2728820	43248
chr19	2685572	2885572	harbor1	chr19	2750776	2750979	DNA/hAT-Charlie	890	-	102	2750878	65306
chr19	2685572	2885572	harbor1	chr19	2760070	2760236	DNA/hAT-Charlie	711	-	83	2760153	74581
chr19	2685572	2885572	harbor1	chr19	2760550	2760588	DNA/hAT-Charlie	711	-	19	2760569	74997
chr19	2685572	2885572	harbor1	chr19	2781344	2781557	DNA/hAT-Charlie	882	-	106	2781450	95878
chr19	2685572	2885572	harbor1	chr19	2782096	2782289	DNA/hAT-Charlie	725	-	96	2782192	96620
chr19	49751467	49951467	harbor1	chr19	49779518	49779606	DNA/hAT-Charlie	775	-	44	49779562	28095
chr19	49751467	49951467	harbor1	chr19	49779718	49779872	DNA/hAT-Charlie	775	-	77	49779795	28328
chr19	49751467	49951467	harbor1	chr19	49823784	49824003	DNA/hAT-Charlie	1108	-	110	49823894	72427
chr19	15333247	15533247	harbor1	chr19	15340352	15340448	DNA/hAT-Charlie	966	-	48	15340400	7153
chr19	15333247	15533247	harbor1	chr19	15341357	15341521	DNA/hAT-Charlie	966	-	82	15341439	8192
chr19	15333247	15533247	harbor1	chr19	15341847	15341946	DNA/hAT-Charlie	966	-	50	15341897	8650
chr19	15333247	15533247	harbor1	chr19	15417373	15417584	DNA/hAT-Charlie	978	-	106	15417479	84232
chr19	15660032	15860032	harbor1	chr19	15662873	15663057	DNA/hAT-Charlie	692	-	92	15662965	2933
chr19	15660032	15860032	harbor1	chr19	15699457	15699765	DNA/hAT-Charlie	1374	-	154	15699611	39579
chr19	317228	517228	harbor1	chr19	352738	353011	DNA/hAT-Charlie	1007	-	136	352874	35646
chr19	1413296	1613296	harbor1	chr19	1477564	1477814	DNA/hAT-Charlie	788	-	125	1477689	64393
chr19	1003009	1203009	harbor1	chr19	1022734	1022980	DNA/hAT-Charlie	1144	-	123	1022857	19848
chr19	15010518	15210518	harbor1	chr19	15016700	15016871	DNA/hAT-Charlie	707	-	86	15016786	6268
chr19	15010518	15210518	harbor1	chr19	15092450	15092713	DNA/hAT-Charlie	1130	-	132	15092582	82064
chr19	15010518	15210518	harbor1	chr19	15093033	15093097	DNA/hAT-Charlie	1130	-	32	15093065	82547
chr19	15010518	15210518	harbor1	chr19	15099654	15099873	DNA/hAT-Charlie	1559	-	110	15099764	89246
chr19	12939121	13139121	harbor1	chr19	13034906	13035121	DNA/hAT-Charlie	1011	-	108	13035014	95893
chr19	1299305	1499305	harbor1	chr19	1384438	1384803	DNA/hAT-Charlie	1139	-	182	1384620	85315
chr19	1128779	1328779	harbor1	chr19	1185662	1185860	DNA/hAT-Charlie	664	-	99	1185761	56982
chr19	1128836	1328836	harbor1	chr19	1185662	1185860	DNA/hAT-Charlie	664	-	99	1185761	56925
chr19	49751344	49951344	harbor1	chr19	49779518	49779606	DNA/hAT-Charlie	775	-	44	49779562	28218
chr19	49751344	49951344	harbor1	chr19	49779718	49779872	DNA/hAT-Charlie	775	-	77	49779795	28451
chr19	49751344	49951344	harbor1	chr19	49823784	49824003	DNA/hAT-Charlie	1108	-	110	49823894	72550
chr19	2537219	2737219	harbor1	chr19	2566641	2566814	DNA/hAT-Charlie	771	-	86	2566727	29508
chr19	2537219	2737219	harbor1	chr19	2569638	2569880	DNA/hAT-Charlie	649	-	121	2569759	32540
chr19	2537219	2737219	harbor1	chr19	2600183	2600468	DNA/hAT-Charlie	1399	-	142	2600325	63106
chr19	2537219	2737219	harbor1	chr19	2600775	2600864	DNA/hAT-Charlie	1399	-	44	2600819	63600
chr19	2537219	2737219	harbor1	chr19	2617107	2617290	DNA/hAT-Charlie	644	-	92	2617199	79980
chr19	2537219	2737219	harbor1	chr19	2634210	2634413	DNA/hAT-Charlie	691	-	102	2634312	97093
chr19	48342797	48542797	harbor1	chr19	48366724	48366871	DNA/hAT-Charlie	939	-	74	48366798	24001
chr19	48342797	48542797	harbor1	chr19	48367447	48367502	DNA/hAT-Charlie	939	-	28	48367475	24678
chr19	48342797	48542797	harbor1	chr19	48377737	48377822	DNA/hAT-Charlie	1423	-	42	48377779	34982
chr19	48342797	48542797	harbor1	chr19	48378112	48378334	DNA/hAT-Charlie	1423	-	111	48378223	35426
chr19	48342797	48542797	harbor1	chr19	48420098	48420146	DNA/hAT-Charlie	660	-	24	48420122	77325
chr19	48342797	48542797	harbor1	chr19	48420442	48420543	DNA/hAT-Charlie	660	-	50	48420492	77695
chr19	48342797	48542797	harbor1	chr19	48420842	48420990	DNA/hAT-Charlie	660	-	74	48420916	78119
chr19	48342797	48542797	harbor1	chr19	48424255	48424265	DNA/hAT-Charlie	762	-	5	48424260	81463
chr19	48342797	48542797	harbor1	chr19	48424569	48424794	DNA/hAT-Charlie	762	-	112	48424681	81884
chr19	16442283	16642283	harbor1	chr19	16464665	16464729	DNA/hAT-Charlie	1251	-	32	16464697	22414
chr19	16442283	16642283	harbor1	chr19	16464773	16464805	DNA/hAT-Charlie	1251	-	16	16464789	22506
chr19	16442283	16642283	harbor1	chr19	16465095	16465198	DNA/hAT-Charlie	1251	-	52	16465147	22864
chr19	16442283	16642283	harbor1	chr19	16488845	16489174	DNA/hAT-Charlie	1511	-	164	16489009	46726
chr19	51194759	51394759	harbor1	chr19	51240404	51240563	DNA/hAT-Charlie	762	-	80	51240484	45725
chr19	51194759	51394759	harbor1	chr19	51246431	51246504	DNA/hAT-Charlie	663	-	36	51246467	51708
chr19	51194759	51394759	harbor1	chr19	51247172	51247323	DNA/hAT-Charlie	663	-	76	51247248	52489
chr19	15279128	15479128	harbor1	chr19	15286584	15286782	DNA/hAT-Charlie	895	-	99	15286683	7555
chr19	15279128	15479128	harbor1	chr19	15340352	15340448	DNA/hAT-Charlie	966	-	48	15340400	61272
chr19	15279128	15479128	harbor1	chr19	15341357	15341521	DNA/hAT-Charlie	966	-	82	15341439	62311
chr19	15279128	15479128	harbor1	chr19	15341847	15341946	DNA/hAT-Charlie	966	-	50	15341897	62769
chr19	2356931	2556931	harbor1	chr19	2399638	2399705	DNA/hAT-Charlie	923	-	34	2399672	42741
chr19	2356931	2556931	harbor1	chr19	2400027	2400209	DNA/hAT-Charlie	923	-	91	2400118	43187
chr19	2356931	2556931	harbor1	chr19	2439399	2439590	DNA/hAT-Charlie	663	-	96	2439495	82564
chr19	12938763	13138763	harbor1	chr19	13034906	13035121	DNA/hAT-Charlie	1011	-	108	13035014	96251
chr19	10130588	10330588	harbor1	chr19	10163592	10163760	DNA/hAT-Charlie	713	-	84	10163676	33088
chr19	10130588	10330588	harbor1	chr19	10203726	10203948	DNA/hAT-Charlie	1057	-	111	10203837	73249
chr19	46919957	47119957	harbor1	chr19	47016526	47016671	DNA/hAT-Charlie	667	-	72	47016598	96641
chr19	19427893	19627893	harbor1	chr19	19478838	19479240	DNA/hAT-Charlie	943	-	201	19479039	51146
chr19	19427893	19627893	harbor1	chr19	19480216	19480490	DNA/hAT-Charlie	935	-	137	19480353	52460
chr19	46919998	47119998	harbor1	chr19	47016526	47016671	DNA/hAT-Charlie	667	-	72	47016598	96600
chr19	5237563	5437563	harbor1	chr19	5307630	5307814	DNA/hAT-Charlie	876	-	92	5307722	70159
chr19	5237563	5437563	harbor1	chr19	5331437	5331645	DNA/hAT-Charlie	862	-	104	5331541	93978
chr19	49750828	49950828	harbor1	chr19	49779518	49779606	DNA/hAT-Charlie	775	-	44	49779562	28734
chr19	49750828	49950828	harbor1	chr19	49779718	49779872	DNA/hAT-Charlie	775	-	77	49779795	28967
chr19	49750828	49950828	harbor1	chr19	49823784	49824003	DNA/hAT-Charlie	1108	-	110	49823894	73066
chr19	208555	408555	harbor1	chr19	208824	209255	DNA/hAT-Charlie	2989	-	216	209040	485
chr19	12912451	13112451	harbor1	chr19	12934827	12934855	DNA/hAT-Charlie	774	-	14	12934841	22390
chr19	12912451	13112451	harbor1	chr19	12935150	12935293	DNA/hAT-Charlie	774	-	72	12935222	22771
chr19	12914910	13114910	harbor1	chr19	12934827	12934855	DNA/hAT-Charlie	774	-	14	12934841	19931
chr19	12914910	13114910	harbor1	chr19	12935150	12935293	DNA/hAT-Charlie	774	-	72	12935222	20312
chr19	34913533	35113533	harbor1	chr19	34973560	34973603	DNA/hAT-Charlie	783	-	22	34973582	60049
chr19	34913533	35113533	harbor1	chr19	34973935	34974068	DNA/hAT-Charlie	783	-	66	34974001	60468
chr19	44861009	45061009	harbor1	chr19	44956902	44957126	DNA/hAT-Charlie	1396	-	112	44957014	96005
chr19	1017116	1217116	harbor1	chr19	1022734	1022980	DNA/hAT-Charlie	1144	-	123	1022857	5741
chr19	19470530	19670530	harbor1	chr19	19478838	19479240	DNA/hAT-Charlie	943	-	201	19479039	8509
chr19	19470530	19670530	harbor1	chr19	19480216	19480490	DNA/hAT-Charlie	935	-	137	19480353	9823
chr19	1134099	1334099	harbor1	chr19	1185662	1185860	DNA/hAT-Charlie	664	-	99	1185761	51662
chr19	12938709	13138709	harbor1	chr19	13034906	13035121	DNA/hAT-Charlie	1011	-	108	13035014	96305
chr19	44791136	44991136	harbor1	chr19	44831378	44831565	DNA/hAT-Charlie	807	-	94	44831472	40336
chr19	12690073	12890073	harbor1	chr19	12733412	12733630	DNA/hAT-Charlie	1163	-	109	12733521	43448
chr19	5486695	5686695	harbor1	chr19	5506432	5506643	DNA/hAT-Charlie	883	-	106	5506538	19843
chr19	780237	980237	harbor1	chr19	840292	840491	DNA/hAT-Charlie	652	-	100	840392	60155
chr19	12875018	13075018	harbor1	chr19	12934827	12934855	DNA/hAT-Charlie	774	-	14	12934841	59823
chr19	12875018	13075018	harbor1	chr19	12935150	12935293	DNA/hAT-Charlie	774	-	72	12935222	60204
chr19	12938716	13138716	harbor1	chr19	13034906	13035121	DNA/hAT-Charlie	1011	-	108	13035014	96298
chr19	2483587	2683587	harbor1	chr19	2566641	2566814	DNA/hAT-Charlie	771	-	86	2566727	83140
chr19	2483587	2683587	harbor1	chr19	2569638	2569880	DNA/hAT-Charlie	649	-	121	2569759	86172
chr19	56021112	56221112	harbor1	chr19	56094687	56094828	DNA/hAT-Charlie	1959	-	70	56094757	73645
chr19	56021112	56221112	harbor1	chr19	56095125	56095318	DNA/hAT-Charlie	1959	-	96	56095221	74109
chr19	1	171197	harbor1	chr19	88504	88703	DNA/hAT-Charlie	923	-	100	88604	88603
chr19	12938727	13138727	harbor1	chr19	13034906	13035121	DNA/hAT-Charlie	1011	-	108	13035014	96287
chr19	49767567	49967567	harbor1	chr19	49779518	49779606	DNA/hAT-Charlie	775	-	44	49779562	11995
chr19	49767567	49967567	harbor1	chr19	49779718	49779872	DNA/hAT-Charlie	775	-	77	49779795	12228
chr19	49767567	49967567	harbor1	chr19	49823784	49824003	DNA/hAT-Charlie	1108	-	110	49823894	56327
chr19	49751409	49951409	harbor1	chr19	49779518	49779606	DNA/hAT-Charlie	775	-	44	49779562	28153
chr19	49751409	49951409	harbor1	chr19	49779718	49779872	DNA/hAT-Charlie	775	-	77	49779795	28386
chr19	49751409	49951409	harbor1	chr19	49823784	49824003	DNA/hAT-Charlie	1108	-	110	49823894	72485
chr19	1350373	1550373	harbor1	chr19	1384438	1384803	DNA/hAT-Charlie	1139	-	182	1384620	34247
chr19	1350373	1550373	harbor1	chr19	1406676	1406890	DNA/hAT-Charlie	898	-	107	1406783	56410
chr19	13905974	14105974	harbor1	chr19	13999360	13999664	DNA/hAT-Charlie	1442	-	152	13999512	93538
chr19	12938873	13138873	harbor1	chr19	13034906	13035121	DNA/hAT-Charlie	1011	-	108	13035014	96141
chr19	3288104	3488104	harbor1	chr19	3328788	3328973	DNA/hAT-Charlie	933	-	92	3328880	40776
chr19	3288104	3488104	harbor1	chr19	3330415	3330451	DNA/hAT-Charlie	933	-	18	3330433	42329
chr19	3288104	3488104	harbor1	chr19	3343701	3343922	DNA/hAT-Charlie	811	-	110	3343811	55707
chr19	12889997	13089997	harbor1	chr19	12934827	12934855	DNA/hAT-Charlie	774	-	14	12934841	44844
chr19	12889997	13089997	harbor1	chr19	12935150	12935293	DNA/hAT-Charlie	774	-	72	12935222	45225
chr20	34725542	34925542	harbor1	chr20	34770979	34771129	DNA/hAT-Charlie	1144	-	75	34771054	45512
chr20	34725542	34925542	harbor1	chr20	34771435	34771596	DNA/hAT-Charlie	1144	-	80	34771515	45973
chr20	34725542	34925542	harbor1	chr20	34781371	34781702	DNA/hAT-Charlie	645	-	166	34781537	55995
chr20	34725542	34925542	harbor1	chr20	34819272	34819492	DNA/hAT-Charlie	516	-	110	34819382	93840
chr20	34725542	34925542	harbor1	chr20	34821162	34821378	DNA/hAT-Charlie	992	-	108	34821270	95728
chr20	34725654	34925654	harbor1	chr20	34770979	34771129	DNA/hAT-Charlie	1144	-	75	34771054	45400
chr20	34725654	34925654	harbor1	chr20	34771435	34771596	DNA/hAT-Charlie	1144	-	80	34771515	45861
chr20	34725654	34925654	harbor1	chr20	34781371	34781702	DNA/hAT-Charlie	645	-	166	34781537	55883
chr20	34725654	34925654	harbor1	chr20	34819272	34819492	DNA/hAT-Charlie	516	-	110	34819382	93728
chr20	34725654	34925654	harbor1	chr20	34821162	34821378	DNA/hAT-Charlie	992	-	108	34821270	95616
chr20	34725628	34925628	harbor1	chr20	34770979	34771129	DNA/hAT-Charlie	1144	-	75	34771054	45426
chr20	34725628	34925628	harbor1	chr20	34771435	34771596	DNA/hAT-Charlie	1144	-	80	34771515	45887
chr20	34725628	34925628	harbor1	chr20	34781371	34781702	DNA/hAT-Charlie	645	-	166	34781537	55909
chr20	34725628	34925628	harbor1	chr20	34819272	34819492	DNA/hAT-Charlie	516	-	110	34819382	93754
chr20	34725628	34925628	harbor1	chr20	34821162	34821378	DNA/hAT-Charlie	992	-	108	34821270	95642
chr20	34725550	34925550	harbor1	chr20	34770979	34771129	DNA/hAT-Charlie	1144	-	75	34771054	45504
chr20	34725550	34925550	harbor1	chr20	34771435	34771596	DNA/hAT-Charlie	1144	-	80	34771515	45965
chr20	34725550	34925550	harbor1	chr20	34781371	34781702	DNA/hAT-Charlie	645	-	166	34781537	55987
chr20	34725550	34925550	harbor1	chr20	34819272	34819492	DNA/hAT-Charlie	516	-	110	34819382	93832
chr20	34725550	34925550	harbor1	chr20	34821162	34821378	DNA/hAT-Charlie	992	-	108	34821270	95720
chr20	2740647	2940647	harbor1	chr20	2744793	2745071	DNA/hAT-Charlie	1386	-	139	2744932	4285
chr20	2740647	2940647	harbor1	chr20	2745080	2745224	DNA/hAT-Charlie	588	-	72	2745152	4505
chr20	34725652	34925652	harbor1	chr20	34770979	34771129	DNA/hAT-Charlie	1144	-	75	34771054	45402
chr20	34725652	34925652	harbor1	chr20	34771435	34771596	DNA/hAT-Charlie	1144	-	80	34771515	45863
chr20	34725652	34925652	harbor1	chr20	34781371	34781702	DNA/hAT-Charlie	645	-	166	34781537	55885
chr20	34725652	34925652	harbor1	chr20	34819272	34819492	DNA/hAT-Charlie	516	-	110	34819382	93730
chr20	34725652	34925652	harbor1	chr20	34821162	34821378	DNA/hAT-Charlie	992	-	108	34821270	95618
chr20	34903928	35103928	harbor1	chr20	34948459	34948503	DNA/hAT-Charlie	704	-	22	34948481	44553
chr20	34903928	35103928	harbor1	chr20	34948800	34949100	DNA/hAT-Charlie	704	-	150	34948950	45022
chr20	44866470	45066470	harbor1	chr20	44883713	44883975	DNA/hAT-Charlie	685	-	131	44883844	17374
chr20	44866470	45066470	harbor1	chr20	44928373	44928554	DNA/hAT-Charlie	570	-	90	44928463	61993
chr20	44866470	45066470	harbor1	chr20	44964715	44964876	DNA/hAT-Charlie	780	-	80	44964795	98325
chr20	62322429	62522429	harbor1	chr20	62341384	62341595	DNA/hAT-Charlie	989	-	106	62341490	19061
chr20	34904026	35104026	harbor1	chr20	34948459	34948503	DNA/hAT-Charlie	704	-	22	34948481	44455
chr20	34904026	35104026	harbor1	chr20	34948800	34949100	DNA/hAT-Charlie	704	-	150	34948950	44924
chr20	330383	530383	harbor1	chr20	373979	374017	DNA/hAT-Charlie	974	-	19	373998	43615
chr20	330383	530383	harbor1	chr20	374339	374581	DNA/hAT-Charlie	974	-	121	374460	44077
chr20	330383	530383	harbor1	chr20	374910	374928	DNA/hAT-Charlie	974	-	9	374919	44536
chr20	330383	530383	harbor1	chr20	375235	375403	DNA/hAT-Charlie	974	-	84	375319	44936
chr20	1018818	1218818	harbor1	chr20	1057320	1057562	DNA/hAT-Charlie	673	-	121	1057441	38623
chr20	1018818	1218818	harbor1	chr20	1062854	1063034	DNA/hAT-Charlie	996	-	90	1062944	44126
chr20	1018818	1218818	harbor1	chr20	1063067	1063239	DNA/hAT-Charlie	713	-	86	1063153	44335
chr20	1018818	1218818	harbor1	chr20	1075077	1075233	DNA/hAT-Charlie	1195	-	78	1075155	56337
chr20	1018818	1218818	harbor1	chr20	1075368	1075574	DNA/hAT-Charlie	1195	-	103	1075471	56653
chr20	1018818	1218818	harbor1	chr20	1079993	1080253	DNA/hAT-Charlie	805	-	130	1080123	61305
chr20	1018818	1218818	harbor1	chr20	1080782	1080826	DNA/hAT-Charlie	805	-	22	1080804	61986
chr20	1018818	1218818	harbor1	chr20	1084327	1084480	DNA/hAT-Charlie	554	-	76	1084403	65585
chr20	1018818	1218818	harbor1	chr20	1089187	1089374	DNA/hAT-Charlie	845	-	94	1089281	70463
chr20	3686183	3886183	harbor1	chr20	3736685	3736740	DNA/hAT-Charlie	1103	-	28	3736713	50530
chr20	3686183	3886183	harbor1	chr20	3737107	3737223	DNA/hAT-Charlie	1103	-	58	3737165	50982
chr20	2370770	2570770	harbor1	chr20	2375221	2375630	DNA/hAT-Charlie	1768	-	204	2375425	4655
chr20	2370770	2570770	harbor1	chr20	2382774	2382925	DNA/hAT-Charlie	514	-	76	2382850	12080
chr20	2370770	2570770	harbor1	chr20	2389556	2389762	DNA/hAT-Charlie	531	-	103	2389659	18889
chr20	2370770	2570770	harbor1	chr20	2396883	2397058	DNA/hAT-Charlie	931	-	88	2396971	26201
chr20	2370770	2570770	harbor1	chr20	2397486	2397648	DNA/hAT-Charlie	591	-	81	2397567	26797
chr20	2370770	2570770	harbor1	chr20	2428463	2428542	DNA/hAT-Charlie	590	-	40	2428503	57733
chr20	2370770	2570770	harbor1	chr20	2435451	2435669	DNA/hAT-Charlie	1250	-	109	2435560	64790
chr20	4586429	4786429	harbor1	chr20	4662776	4662968	DNA/hAT-Charlie	1414	-	96	4662872	76443
chr20	4586429	4786429	harbor1	chr20	4669831	4669996	DNA/hAT-Charlie	971	-	82	4669913	83484
chr20	22734563	22934563	harbor1	chr20	22761099	22761305	DNA/hAT-Charlie	652	-	103	22761202	26639
chr20	22734563	22934563	harbor1	chr20	22787436	22787625	DNA/hAT-Charlie	743	-	94	22787530	52967
chr20	2739816	2939816	harbor1	chr20	2739967	2740030	DNA/hAT-Charlie	746	-	32	2739999	183
chr20	2739816	2939816	harbor1	chr20	2740323	2740426	DNA/hAT-Charlie	746	-	52	2740375	559
chr20	2739816	2939816	harbor1	chr20	2744793	2745071	DNA/hAT-Charlie	1386	-	139	2744932	5116
chr20	2739816	2939816	harbor1	chr20	2745080	2745224	DNA/hAT-Charlie	588	-	72	2745152	5336
chr20	49710583	49910583	harbor1	chr20	49728595	49728782	DNA/hAT-Charlie	877	-	94	49728689	18106
chr20	49710583	49910583	harbor1	chr20	49748523	49748766	DNA/hAT-Charlie	1022	-	122	49748645	38062
chr20	49710583	49910583	harbor1	chr20	49756750	49756864	DNA/hAT-Charlie	498	-	57	49756807	46224
chr20	49710583	49910583	harbor1	chr20	49771695	49771907	DNA/hAT-Charlie	887	-	106	49771801	61218
chr20	49710583	49910583	harbor1	chr20	49772617	49772827	DNA/hAT-Charlie	1086	-	105	49772722	62139
chr20	34725660	34925660	harbor1	chr20	34770979	34771129	DNA/hAT-Charlie	1144	-	75	34771054	45394
chr20	34725660	34925660	harbor1	chr20	34771435	34771596	DNA/hAT-Charlie	1144	-	80	34771515	45855
chr20	34725660	34925660	harbor1	chr20	34781371	34781702	DNA/hAT-Charlie	645	-	166	34781537	55877
chr20	34725660	34925660	harbor1	chr20	34819272	34819492	DNA/hAT-Charlie	516	-	110	34819382	93722
chr20	34725660	34925660	harbor1	chr20	34821162	34821378	DNA/hAT-Charlie	992	-	108	34821270	95610
chr20	2740637	2940637	harbor1	chr20	2744793	2745071	DNA/hAT-Charlie	1386	-	139	2744932	4295
chr20	2740637	2940637	harbor1	chr20	2745080	2745224	DNA/hAT-Charlie	588	-	72	2745152	4515
chr20	57552168	57752168	harbor1	chr20	57571767	57571971	DNA/hAT-Charlie	609	-	102	57571869	19701
chr20	57552168	57752168	harbor1	chr20	57583055	57583273	DNA/hAT-Charlie	907	-	109	57583164	30996
chr20	57552168	57752168	harbor1	chr20	57646429	57646647	DNA/hAT-Charlie	1092	-	109	57646538	94370
chr20	2740649	2940649	harbor1	chr20	2744793	2745071	DNA/hAT-Charlie	1386	-	139	2744932	4283
chr20	2740649	2940649	harbor1	chr20	2745080	2745224	DNA/hAT-Charlie	588	-	72	2745152	4503
chr20	38574510	38774510	harbor1	chr20	38609270	38609437	DNA/hAT-Charlie	1005	-	84	38609354	34844
chr20	38574510	38774510	harbor1	chr20	38612070	38612352	DNA/hAT-Charlie	1245	-	141	38612211	37701
chr20	38574510	38774510	harbor1	chr20	38649153	38649295	DNA/hAT-Charlie	500	-	71	38649224	74714
chr20	43583080	43783080	harbor1	chr20	43600063	43600299	DNA/hAT-Charlie	1177	-	118	43600181	17101
chr20	43583080	43783080	harbor1	chr20	43600575	43600689	DNA/hAT-Charlie	1177	-	57	43600632	17552
chr20	43583080	43783080	harbor1	chr20	43600982	43601147	DNA/hAT-Charlie	1177	-	82	43601064	17984
chr20	32383338	32583338	harbor1	chr20	32396883	32397028	DNA/hAT-Charlie	1116	-	72	32396955	13617
chr20	32383338	32583338	harbor1	chr20	32397699	32397828	DNA/hAT-Charlie	1116	-	64	32397763	14425
chr20	32383338	32583338	harbor1	chr20	32416715	32416954	DNA/hAT-Charlie	2031	-	120	32416835	33497
chr20	32383338	32583338	harbor1	chr20	32417286	32417708	DNA/hAT-Charlie	2031	-	211	32417497	34159
chr20	32383338	32583338	harbor1	chr20	32464686	32464973	DNA/hAT-Charlie	984	-	144	32464830	81492
chr20	34901268	35101268	harbor1	chr20	34948459	34948503	DNA/hAT-Charlie	704	-	22	34948481	47213
chr20	34901268	35101268	harbor1	chr20	34948800	34949100	DNA/hAT-Charlie	704	-	150	34948950	47682
chr20	34725622	34925622	harbor1	chr20	34770979	34771129	DNA/hAT-Charlie	1144	-	75	34771054	45432
chr20	34725622	34925622	harbor1	chr20	34771435	34771596	DNA/hAT-Charlie	1144	-	80	34771515	45893
chr20	34725622	34925622	harbor1	chr20	34781371	34781702	DNA/hAT-Charlie	645	-	166	34781537	55915
chr20	34725622	34925622	harbor1	chr20	34819272	34819492	DNA/hAT-Charlie	516	-	110	34819382	93760
chr20	34725622	34925622	harbor1	chr20	34821162	34821378	DNA/hAT-Charlie	992	-	108	34821270	95648
chr20	4799071	4999071	harbor1	chr20	4801701	4801730	DNA/hAT-Charlie	787	-	14	4801715	2644
chr20	4799071	4999071	harbor1	chr20	4802039	4802065	DNA/hAT-Charlie	787	-	13	4802052	2981
chr20	4799071	4999071	harbor1	chr20	4802236	4802387	DNA/hAT-Charlie	787	-	76	4802312	3241
chr20	4799071	4999071	harbor1	chr20	4812526	4812687	DNA/hAT-Charlie	758	-	80	4812606	13535
chr20	4799071	4999071	harbor1	chr20	4826199	4826593	DNA/hAT-Charlie	1879	-	197	4826396	27325
chr20	4799071	4999071	harbor1	chr20	4850650	4850755	DNA/hAT-Charlie	1344	-	52	4850702	51631
chr20	4799071	4999071	harbor1	chr20	4851063	4851160	DNA/hAT-Charlie	1344	-	48	4851111	52040
chr20	48275448	48475448	harbor1	chr20	48334234	48334388	DNA/hAT-Charlie	563	-	77	48334311	58863
chr20	48275448	48475448	harbor1	chr20	48357035	48357188	DNA/hAT-Charlie	849	-	76	48357111	81663
chr20	48275448	48475448	harbor1	chr20	48358043	48358218	DNA/hAT-Charlie	595	-	88	48358131	82683
chr20	48275448	48475448	harbor1	chr20	48359602	48359776	DNA/hAT-Charlie	513	-	87	48359689	84241
chr20	3686190	3886190	harbor1	chr20	3736685	3736740	DNA/hAT-Charlie	1103	-	28	3736713	50523
chr20	3686190	3886190	harbor1	chr20	3737107	3737223	DNA/hAT-Charlie	1103	-	58	3737165	50975
chr20	21818150	22018150	harbor1	chr20	21822948	21823112	DNA/hAT-Charlie	627	-	82	21823030	4880
chr20	21818150	22018150	harbor1	chr20	21836481	21836652	DNA/hAT-Charlie	774	-	86	21836567	18417
chr20	21818150	22018150	harbor1	chr20	21851031	21851558	DNA/hAT-Charlie	3845	-	264	21851295	33145
chr20	21818150	22018150	harbor1	chr20	21871094	21871363	DNA/hAT-Charlie	747	-	134	21871228	53078
chr20	21818150	22018150	harbor1	chr20	21894693	21895157	DNA/hAT-Charlie	1180	-	232	21894925	76775
chr20	21818150	22018150	harbor1	chr20	21910237	21910525	DNA/hAT-Charlie	864	-	144	21910381	92231
chr20	33594101	33794101	harbor1	chr20	33627683	33627905	DNA/hAT-Charlie	547	-	111	33627794	33693
chr20	40589402	40789402	harbor1	chr20	40635924	40636104	DNA/hAT-Charlie	1086	-	90	40636014	46612
chr20	40589402	40789402	harbor1	chr20	40642640	40642858	DNA/hAT-Charlie	1130	-	109	40642749	53347
chr20	40589402	40789402	harbor1	chr20	40678249	40678410	DNA/hAT-Charlie	874	-	80	40678329	88927
chr20	34725651	34925651	harbor1	chr20	34770979	34771129	DNA/hAT-Charlie	1144	-	75	34771054	45403
chr20	34725651	34925651	harbor1	chr20	34771435	34771596	DNA/hAT-Charlie	1144	-	80	34771515	45864
chr20	34725651	34925651	harbor1	chr20	34781371	34781702	DNA/hAT-Charlie	645	-	166	34781537	55886
chr20	34725651	34925651	harbor1	chr20	34819272	34819492	DNA/hAT-Charlie	516	-	110	34819382	93731
chr20	34725651	34925651	harbor1	chr20	34821162	34821378	DNA/hAT-Charlie	992	-	108	34821270	95619
chr20	2740727	2940727	harbor1	chr20	2744793	2745071	DNA/hAT-Charlie	1386	-	139	2744932	4205
chr20	2740727	2940727	harbor1	chr20	2745080	2745224	DNA/hAT-Charlie	588	-	72	2745152	4425
chr20	50269813	50469813	harbor1	chr20	50288507	50288721	DNA/hAT-Charlie	947	-	107	50288614	18801
chr20	50269813	50469813	harbor1	chr20	50289578	50289769	DNA/hAT-Charlie	1249	-	96	50289674	19861
chr20	50269813	50469813	harbor1	chr20	50323948	50324168	DNA/hAT-Charlie	1207	-	110	50324058	54245
chr20	50269813	50469813	harbor1	chr20	50347742	50347954	DNA/hAT-Charlie	1072	-	106	50347848	78035
chr20	50269813	50469813	harbor1	chr20	50358619	50358809	DNA/hAT-Charlie	688	-	95	50358714	88901
chr20	50269813	50469813	harbor1	chr20	50361439	50361860	DNA/hAT-Charlie	1772	-	210	50361649	91836
chr20	50269813	50469813	harbor1	chr20	50362145	50362253	DNA/hAT-Charlie	1772	-	54	50362199	92386
chr20	4071169	4271169	harbor1	chr20	4087210	4087545	DNA/hAT-Charlie	2242	-	168	4087378	16209
chr20	4071169	4271169	harbor1	chr20	4093696	4093809	DNA/hAT-Charlie	1260	-	56	4093752	22583
chr20	4071169	4271169	harbor1	chr20	4094102	4094294	DNA/hAT-Charlie	1260	-	96	4094198	23029
chr20	4071169	4271169	harbor1	chr20	4101916	4102120	DNA/hAT-Charlie	831	-	102	4102018	30849
chr20	4071169	4271169	harbor1	chr20	4154261	4154366	DNA/hAT-Charlie	761	-	52	4154313	83144
chr20	4071169	4271169	harbor1	chr20	4154663	4154736	DNA/hAT-Charlie	761	-	36	4154699	83530
chr20	43408519	43608519	harbor1	chr20	43452172	43452398	DNA/hAT-Charlie	952	-	113	43452285	43766
chr20	43408519	43608519	harbor1	chr20	43454804	43455013	DNA/hAT-Charlie	1141	-	104	43454908	46389
chr20	5027110	5227110	harbor1	chr20	5033308	5033416	DNA/hAT-Charlie	689	-	54	5033362	6252
chr20	5027110	5227110	harbor1	chr20	5041522	5041679	DNA/hAT-Charlie	686	-	78	5041600	14490
chr20	5027110	5227110	harbor1	chr20	5061254	5061344	DNA/hAT-Charlie	520	-	45	5061299	34189
chr20	5027110	5227110	harbor1	chr20	5061495	5061525	DNA/hAT-Charlie	520	-	15	5061510	34400
chr20	5027110	5227110	harbor1	chr20	5095737	5095856	DNA/hAT-Charlie	570	-	60	5095797	68687
chr20	38574499	38774499	harbor1	chr20	38609270	38609437	DNA/hAT-Charlie	1005	-	84	38609354	34855
chr20	38574499	38774499	harbor1	chr20	38612070	38612352	DNA/hAT-Charlie	1245	-	141	38612211	37712
chr20	38574499	38774499	harbor1	chr20	38649153	38649295	DNA/hAT-Charlie	500	-	71	38649224	74725
chr20	62083219	62283219	harbor1	chr20	62141927	62142139	DNA/hAT-Charlie	570	-	106	62142033	58814
chr20	62083219	62283219	harbor1	chr20	62176964	62177116	DNA/hAT-Charlie	643	-	76	62177040	93821
chr20	61271130	61471130	harbor1	chr20	61284792	61284990	DNA/hAT-Charlie	807	-	99	61284891	13761
chr20	61271130	61471130	harbor1	chr20	61310325	61310663	DNA/hAT-Charlie	1979	-	169	61310494	39364
chr20	61271130	61471130	harbor1	chr20	61317577	61317725	DNA/hAT-Charlie	652	-	74	61317651	46521
chr20	61271130	61471130	harbor1	chr20	61342156	61342676	DNA/hAT-Charlie	3470	-	260	61342416	71286
chr20	61271130	61471130	harbor1	chr20	61357655	61357811	DNA/hAT-Charlie	548	-	78	61357733	86603
chr20	33574220	33774220	harbor1	chr20	33589759	33589957	DNA/hAT-Charlie	583	-	99	33589858	15638
chr20	33574220	33774220	harbor1	chr20	33593371	33593391	DNA/hAT-Charlie	812	-	10	33593381	19161
chr20	33574220	33774220	harbor1	chr20	33593693	33593922	DNA/hAT-Charlie	812	-	114	33593807	19587
chr20	33574220	33774220	harbor1	chr20	33627683	33627905	DNA/hAT-Charlie	547	-	111	33627794	53574
chr20	54108072	54308072	harbor1	chr20	54110770	54110960	DNA/hAT-Charlie	596	-	95	54110865	2793
chr20	54108072	54308072	harbor1	chr20	54120216	54120532	DNA/hAT-Charlie	737	-	158	54120374	12302
chr20	54108072	54308072	harbor1	chr20	54121151	54121298	DNA/hAT-Charlie	551	-	74	54121225	13153
chr20	54108072	54308072	harbor1	chr20	54121597	54121765	DNA/hAT-Charlie	551	-	84	54121681	13609
chr20	54108072	54308072	harbor1	chr20	54142000	54142340	DNA/hAT-Charlie	2107	-	170	54142170	34098
chr20	54108072	54308072	harbor1	chr20	54163063	54163220	DNA/hAT-Charlie	811	-	78	54163141	55069
chr20	2740635	2940635	harbor1	chr20	2744793	2745071	DNA/hAT-Charlie	1386	-	139	2744932	4297
chr20	2740635	2940635	harbor1	chr20	2745080	2745224	DNA/hAT-Charlie	588	-	72	2745152	4517
chr20	38705777	38905777	harbor1	chr20	38716050	38716320	DNA/hAT-Charlie	521	-	135	38716185	10408
chr20	38705777	38905777	harbor1	chr20	38745137	38745197	DNA/hAT-Charlie	887	-	30	38745167	39390
chr20	38705777	38905777	harbor1	chr20	38745511	38745681	DNA/hAT-Charlie	887	-	85	38745596	39819
chr20	1018817	1218817	harbor1	chr20	1057320	1057562	DNA/hAT-Charlie	673	-	121	1057441	38624
chr20	1018817	1218817	harbor1	chr20	1062854	1063034	DNA/hAT-Charlie	996	-	90	1062944	44127
chr20	1018817	1218817	harbor1	chr20	1063067	1063239	DNA/hAT-Charlie	713	-	86	1063153	44336
chr20	1018817	1218817	harbor1	chr20	1075077	1075233	DNA/hAT-Charlie	1195	-	78	1075155	56338
chr20	1018817	1218817	harbor1	chr20	1075368	1075574	DNA/hAT-Charlie	1195	-	103	1075471	56654
chr20	1018817	1218817	harbor1	chr20	1079993	1080253	DNA/hAT-Charlie	805	-	130	1080123	61306
chr20	1018817	1218817	harbor1	chr20	1080782	1080826	DNA/hAT-Charlie	805	-	22	1080804	61987
chr20	1018817	1218817	harbor1	chr20	1084327	1084480	DNA/hAT-Charlie	554	-	76	1084403	65586
chr20	1018817	1218817	harbor1	chr20	1089187	1089374	DNA/hAT-Charlie	845	-	94	1089281	70464
chr20	35599405	35799405	harbor1	chr20	35610770	35611134	DNA/hAT-Charlie	2381	-	182	35610952	11547
chr20	37933379	38133379	harbor1	chr20	37954607	37954937	DNA/hAT-Charlie	2274	-	165	37954772	21393
chr20	37933379	38133379	harbor1	chr20	37957941	37958139	DNA/hAT-Charlie	1027	-	99	37958040	24661
chr20	37933379	38133379	harbor1	chr20	38010893	38011054	DNA/hAT-Charlie	660	-	80	38010973	77594
chr20	37933379	38133379	harbor1	chr20	38019726	38019957	DNA/hAT-Charlie	1089	-	116	38019842	86463
chr20	34992759	35192759	harbor1	chr20	35023416	35023640	DNA/hAT-Charlie	562	-	112	35023528	30769
chr20	59833005	60033005	harbor1	chr20	59834832	59835048	DNA/hAT-Charlie	1243	-	108	59834940	1935
chr20	50269781	50469781	harbor1	chr20	50288507	50288721	DNA/hAT-Charlie	947	-	107	50288614	18833
chr20	50269781	50469781	harbor1	chr20	50289578	50289769	DNA/hAT-Charlie	1249	-	96	50289674	19893
chr20	50269781	50469781	harbor1	chr20	50323948	50324168	DNA/hAT-Charlie	1207	-	110	50324058	54277
chr20	50269781	50469781	harbor1	chr20	50347742	50347954	DNA/hAT-Charlie	1072	-	106	50347848	78067
chr20	50269781	50469781	harbor1	chr20	50358619	50358809	DNA/hAT-Charlie	688	-	95	50358714	88933
chr20	50269781	50469781	harbor1	chr20	50361439	50361860	DNA/hAT-Charlie	1772	-	210	50361649	91868
chr20	50269781	50469781	harbor1	chr20	50362145	50362253	DNA/hAT-Charlie	1772	-	54	50362199	92418
chr20	36114483	36314483	harbor1	chr20	36145019	36145161	DNA/hAT-Charlie	597	-	71	36145090	30607
chr20	36114483	36314483	harbor1	chr20	36145415	36145461	DNA/hAT-Charlie	597	-	23	36145438	30955
chr20	36114483	36314483	harbor1	chr20	36149913	36150062	DNA/hAT-Charlie	964	-	74	36149987	35504
chr20	36114483	36314483	harbor1	chr20	36150359	36150505	DNA/hAT-Charlie	964	-	73	36150432	35949
chr20	36114483	36314483	harbor1	chr20	36181600	36181778	DNA/hAT-Charlie	581	-	89	36181689	67206
chr20	36114483	36314483	harbor1	chr20	36193501	36193702	DNA/hAT-Charlie	808	-	100	36193601	79118
chr21	29198953	29398953	harbor1	chr21	29215812	29216024	DNA/hAT-Charlie	1088	-	106	29215918	16965
chr21	29198953	29398953	harbor1	chr21	29224742	29224950	DNA/hAT-Charlie	746	-	104	29224846	25893
chr21	29198953	29398953	harbor1	chr21	29292199	29292434	DNA/hAT-Charlie	483	-	118	29292317	93364
chr21	44576686	44776686	harbor1	chr21	44657344	44657552	DNA/hAT-Charlie	888	-	104	44657448	80762
chr21	14337769	14537769	harbor1	chr21	14340274	14340425	DNA/hAT-Charlie	571	-	76	14340350	2581
chr21	14337769	14537769	harbor1	chr21	14346259	14346574	DNA/hAT-Charlie	1245	-	158	14346417	8648
chr21	14337769	14537769	harbor1	chr21	14435261	14435395	DNA/hAT-Charlie	485	-	67	14435328	97559
chr21	5028567	5228567	harbor1	chr21	5065934	5066098	DNA/hAT-Charlie	707	-	82	5066016	37449
chr21	5028567	5228567	harbor1	chr21	5070098	5070406	DNA/hAT-Charlie	1588	-	154	5070252	41685
chr21	14337822	14537822	harbor1	chr21	14340274	14340425	DNA/hAT-Charlie	571	-	76	14340350	2528
chr21	14337822	14537822	harbor1	chr21	14346259	14346574	DNA/hAT-Charlie	1245	-	158	14346417	8595
chr21	14337822	14537822	harbor1	chr21	14435261	14435395	DNA/hAT-Charlie	485	-	67	14435328	97506
chr21	41771682	41971682	harbor1	chr21	41773082	41773247	DNA/hAT-Charlie	473	-	82	41773164	1482
chr21	41771682	41971682	harbor1	chr21	41773918	41774333	DNA/hAT-Charlie	1362	-	208	41774126	2444
chr21	41771682	41971682	harbor1	chr21	41831266	41831436	DNA/hAT-Charlie	526	-	85	41831351	59669
chr21	41771682	41971682	harbor1	chr21	41870176	41870371	DNA/hAT-Charlie	561	-	98	41870274	98592
chr21	29199129	29399129	harbor1	chr21	29215812	29216024	DNA/hAT-Charlie	1088	-	106	29215918	16789
chr21	29199129	29399129	harbor1	chr21	29224742	29224950	DNA/hAT-Charlie	746	-	104	29224846	25717
chr21	29199129	29399129	harbor1	chr21	29292199	29292434	DNA/hAT-Charlie	483	-	118	29292317	93188
chr21	29198948	29398948	harbor1	chr21	29215812	29216024	DNA/hAT-Charlie	1088	-	106	29215918	16970
chr21	29198948	29398948	harbor1	chr21	29224742	29224950	DNA/hAT-Charlie	746	-	104	29224846	25898
chr21	29198948	29398948	harbor1	chr21	29292199	29292434	DNA/hAT-Charlie	483	-	118	29292317	93369
chr21	39008447	39208447	harbor1	chr21	39016783	39016931	DNA/hAT-Charlie	1255	-	74	39016857	8410
chr21	39008447	39208447	harbor1	chr21	39017397	39017589	DNA/hAT-Charlie	1255	-	96	39017493	9046
chr21	39008447	39208447	harbor1	chr21	39068108	39068223	DNA/hAT-Charlie	606	-	58	39068166	59719
chr21	39008447	39208447	harbor1	chr21	39077820	39078024	DNA/hAT-Charlie	1143	-	102	39077922	69475
chr21	39008447	39208447	harbor1	chr21	39089166	39089608	DNA/hAT-Charlie	2621	-	221	39089387	80940
chr21	39008447	39208447	harbor1	chr21	39093164	39093607	DNA/hAT-Charlie	1100	-	222	39093386	84939
chr21	42275771	42475771	harbor1	chr21	42309161	42309700	DNA/hAT-Charlie	536	-	270	42309431	33660
chr21	42275771	42475771	harbor1	chr21	42314319	42314371	DNA/hAT-Charlie	584	-	26	42314345	38574
chr21	42275771	42475771	harbor1	chr21	42314661	42314776	DNA/hAT-Charlie	584	-	58	42314719	38948
chr21	5008533	5208533	harbor1	chr21	5065934	5066098	DNA/hAT-Charlie	707	-	82	5066016	57483
chr21	5008533	5208533	harbor1	chr21	5070098	5070406	DNA/hAT-Charlie	1588	-	154	5070252	61719
chr21	14337781	14537781	harbor1	chr21	14340274	14340425	DNA/hAT-Charlie	571	-	76	14340350	2569
chr21	14337781	14537781	harbor1	chr21	14346259	14346574	DNA/hAT-Charlie	1245	-	158	14346417	8636
chr21	14337781	14537781	harbor1	chr21	14435261	14435395	DNA/hAT-Charlie	485	-	67	14435328	97547
chr21	14337791	14537791	harbor1	chr21	14340274	14340425	DNA/hAT-Charlie	571	-	76	14340350	2559
chr21	14337791	14537791	harbor1	chr21	14346259	14346574	DNA/hAT-Charlie	1245	-	158	14346417	8626
chr21	14337791	14537791	harbor1	chr21	14435261	14435395	DNA/hAT-Charlie	485	-	67	14435328	97537
chr21	29199041	29399041	harbor1	chr21	29215812	29216024	DNA/hAT-Charlie	1088	-	106	29215918	16877
chr21	29199041	29399041	harbor1	chr21	29224742	29224950	DNA/hAT-Charlie	746	-	104	29224846	25805
chr21	29199041	29399041	harbor1	chr21	29292199	29292434	DNA/hAT-Charlie	483	-	118	29292317	93276
chr21	14336442	14536442	harbor1	chr21	14340274	14340425	DNA/hAT-Charlie	571	-	76	14340350	3908
chr21	14336442	14536442	harbor1	chr21	14346259	14346574	DNA/hAT-Charlie	1245	-	158	14346417	9975
chr21	14336442	14536442	harbor1	chr21	14435261	14435395	DNA/hAT-Charlie	485	-	67	14435328	98886
chr21	14337826	14537826	harbor1	chr21	14340274	14340425	DNA/hAT-Charlie	571	-	76	14340350	2524
chr21	14337826	14537826	harbor1	chr21	14346259	14346574	DNA/hAT-Charlie	1245	-	158	14346417	8591
chr21	14337826	14537826	harbor1	chr21	14435261	14435395	DNA/hAT-Charlie	485	-	67	14435328	97502
chr21	39008502	39208502	harbor1	chr21	39016783	39016931	DNA/hAT-Charlie	1255	-	74	39016857	8355
chr21	39008502	39208502	harbor1	chr21	39017397	39017589	DNA/hAT-Charlie	1255	-	96	39017493	8991
chr21	39008502	39208502	harbor1	chr21	39068108	39068223	DNA/hAT-Charlie	606	-	58	39068166	59664
chr21	39008502	39208502	harbor1	chr21	39077820	39078024	DNA/hAT-Charlie	1143	-	102	39077922	69420
chr21	39008502	39208502	harbor1	chr21	39089166	39089608	DNA/hAT-Charlie	2621	-	221	39089387	80885
chr21	39008502	39208502	harbor1	chr21	39093164	39093607	DNA/hAT-Charlie	1100	-	222	39093386	84884
chr21	14337835	14537835	harbor1	chr21	14340274	14340425	DNA/hAT-Charlie	571	-	76	14340350	2515
chr21	14337835	14537835	harbor1	chr21	14346259	14346574	DNA/hAT-Charlie	1245	-	158	14346417	8582
chr21	14337835	14537835	harbor1	chr21	14435261	14435395	DNA/hAT-Charlie	485	-	67	14435328	97493
chr21	42275718	42475718	harbor1	chr21	42309161	42309700	DNA/hAT-Charlie	536	-	270	42309431	33713
chr21	42275718	42475718	harbor1	chr21	42314319	42314371	DNA/hAT-Charlie	584	-	26	42314345	38627
chr21	42275718	42475718	harbor1	chr21	42314661	42314776	DNA/hAT-Charlie	584	-	58	42314719	39001
chr21	29199063	29399063	harbor1	chr21	29215812	29216024	DNA/hAT-Charlie	1088	-	106	29215918	16855
chr21	29199063	29399063	harbor1	chr21	29224742	29224950	DNA/hAT-Charlie	746	-	104	29224846	25783
chr21	29199063	29399063	harbor1	chr21	29292199	29292434	DNA/hAT-Charlie	483	-	118	29292317	93254
chr21	29198984	29398984	harbor1	chr21	29215812	29216024	DNA/hAT-Charlie	1088	-	106	29215918	16934
chr21	29198984	29398984	harbor1	chr21	29224742	29224950	DNA/hAT-Charlie	746	-	104	29224846	25862
chr21	29198984	29398984	harbor1	chr21	29292199	29292434	DNA/hAT-Charlie	483	-	118	29292317	93333
chr21	39008480	39208480	harbor1	chr21	39016783	39016931	DNA/hAT-Charlie	1255	-	74	39016857	8377
chr21	39008480	39208480	harbor1	chr21	39017397	39017589	DNA/hAT-Charlie	1255	-	96	39017493	9013
chr21	39008480	39208480	harbor1	chr21	39068108	39068223	DNA/hAT-Charlie	606	-	58	39068166	59686
chr21	39008480	39208480	harbor1	chr21	39077820	39078024	DNA/hAT-Charlie	1143	-	102	39077922	69442
chr21	39008480	39208480	harbor1	chr21	39089166	39089608	DNA/hAT-Charlie	2621	-	221	39089387	80907
chr21	39008480	39208480	harbor1	chr21	39093164	39093607	DNA/hAT-Charlie	1100	-	222	39093386	84906
chr21	33666298	33866298	harbor1	chr21	33670627	33671249	DNA/hAT-Charlie	1181	-	311	33670938	4640
chr21	33666298	33866298	harbor1	chr21	33674394	33674494	DNA/hAT-Charlie	528	-	50	33674444	8146
chr21	33666298	33866298	harbor1	chr21	33759061	33759279	DNA/hAT-Charlie	971	-	109	33759170	92872
chr21	33666298	33866298	harbor1	chr21	33763382	33763602	DNA/hAT-Charlie	1098	-	110	33763492	97194
chr21	42467105	42667105	harbor1	chr21	42473747	42473906	DNA/hAT-Charlie	552	-	80	42473827	6722
chr21	42467105	42667105	harbor1	chr21	42478383	42478549	DNA/hAT-Charlie	775	-	83	42478466	11361
chr21	42467105	42667105	harbor1	chr21	42540988	42541328	DNA/hAT-Charlie	2349	-	170	42541158	74053
chr21	14337834	14537834	harbor1	chr21	14340274	14340425	DNA/hAT-Charlie	571	-	76	14340350	2516
chr21	14337834	14537834	harbor1	chr21	14346259	14346574	DNA/hAT-Charlie	1245	-	158	14346417	8583
chr21	14337834	14537834	harbor1	chr21	14435261	14435395	DNA/hAT-Charlie	485	-	67	14435328	97494
chr21	15625713	15825713	harbor1	chr21	15721277	15721668	DNA/hAT-Charlie	1184	-	196	15721473	95760
chr21	14337784	14537784	harbor1	chr21	14340274	14340425	DNA/hAT-Charlie	571	-	76	14340350	2566
chr21	14337784	14537784	harbor1	chr21	14346259	14346574	DNA/hAT-Charlie	1245	-	158	14346417	8633
chr21	14337784	14537784	harbor1	chr21	14435261	14435395	DNA/hAT-Charlie	485	-	67	14435328	97544
chr21	33734948	33934948	harbor1	chr21	33759061	33759279	DNA/hAT-Charlie	971	-	109	33759170	24222
chr21	33734948	33934948	harbor1	chr21	33763382	33763602	DNA/hAT-Charlie	1098	-	110	33763492	28544
chr21	33734948	33934948	harbor1	chr21	33804763	33804975	DNA/hAT-Charlie	1339	-	106	33804869	69921
chr22	24057065	24257065	harbor1	chr22	24080946	24081267	DNA/hAT-Charlie	1388	-	160	24081106	24041
chr22	24057065	24257065	harbor1	chr22	24100037	24100212	DNA/hAT-Charlie	513	-	88	24100125	43060
chr22	24057065	24257065	harbor1	chr22	24127905	24128102	DNA/hAT-Charlie	945	-	98	24128003	70938
chr22	19075025	19275025	harbor1	chr22	19080274	19080534	DNA/hAT-Charlie	1030	-	130	19080404	5379
chr22	19075025	19275025	harbor1	chr22	19098330	19098551	DNA/hAT-Charlie	630	-	110	19098440	23415
chr22	19075025	19275025	harbor1	chr22	19100690	19100822	DNA/hAT-Charlie	766	-	66	19100756	25731
chr22	19075025	19275025	harbor1	chr22	19104044	19104252	DNA/hAT-Charlie	995	-	104	19104148	29123
chr22	24069874	24269874	harbor1	chr22	24080946	24081267	DNA/hAT-Charlie	1388	-	160	24081106	11232
chr22	24069874	24269874	harbor1	chr22	24100037	24100212	DNA/hAT-Charlie	513	-	88	24100125	30251
chr22	24069874	24269874	harbor1	chr22	24127905	24128102	DNA/hAT-Charlie	945	-	98	24128003	58129
chr22	24069906	24269906	harbor1	chr22	24080946	24081267	DNA/hAT-Charlie	1388	-	160	24081106	11200
chr22	24069906	24269906	harbor1	chr22	24100037	24100212	DNA/hAT-Charlie	513	-	88	24100125	30219
chr22	24069906	24269906	harbor1	chr22	24127905	24128102	DNA/hAT-Charlie	945	-	98	24128003	58097
chr22	38298285	38498285	harbor1	chr22	38308985	38309189	DNA/hAT-Charlie	846	-	102	38309087	10802
chr22	46476611	46676611	harbor1	chr22	46477898	46478024	DNA/hAT-Charlie	491	-	63	46477961	1350
chr22	46476611	46676611	harbor1	chr22	46491109	46491233	DNA/hAT-Charlie	484	-	62	46491171	14560
chr22	24070023	24270023	harbor1	chr22	24080946	24081267	DNA/hAT-Charlie	1388	-	160	24081106	11083
chr22	24070023	24270023	harbor1	chr22	24100037	24100212	DNA/hAT-Charlie	513	-	88	24100125	30102
chr22	24070023	24270023	harbor1	chr22	24127905	24128102	DNA/hAT-Charlie	945	-	98	24128003	57980
chr22	43896078	44096078	harbor1	chr22	43926547	43926824	DNA/hAT-Charlie	1201	-	138	43926685	30607
chr22	26575728	26775728	harbor1	chr22	26581854	26582023	DNA/hAT-Charlie	884	-	84	26581938	6210
chr22	26575728	26775728	harbor1	chr22	26606141	26606270	DNA/hAT-Charlie	525	-	64	26606205	30477
chr22	26575728	26775728	harbor1	chr22	26606274	26606493	DNA/hAT-Charlie	802	-	110	26606384	30656
chr22	26575728	26775728	harbor1	chr22	26625183	26625382	DNA/hAT-Charlie	952	-	100	26625283	49555
chr22	26575728	26775728	harbor1	chr22	26635344	26635428	DNA/hAT-Charlie	514	-	42	26635386	59658
chr22	26575728	26775728	harbor1	chr22	26635556	26635695	DNA/hAT-Charlie	514	-	70	26635626	59898
chr22	43426643	43626643	harbor1	chr22	43471986	43472316	DNA/hAT-Charlie	527	-	165	43472151	45508
chr22	43426643	43626643	harbor1	chr22	43525441	43525581	DNA/hAT-Charlie	435	-	70	43525511	98868
chr22	24065808	24265808	harbor1	chr22	24080946	24081267	DNA/hAT-Charlie	1388	-	160	24081106	15298
chr22	24065808	24265808	harbor1	chr22	24100037	24100212	DNA/hAT-Charlie	513	-	88	24100125	34317
chr22	24065808	24265808	harbor1	chr22	24127905	24128102	DNA/hAT-Charlie	945	-	98	24128003	62195
chr22	50054112	50254112	harbor1	chr22	50094878	50094942	DNA/hAT-Charlie	535	-	32	50094910	40798
chr22	50054112	50254112	harbor1	chr22	50095050	50095147	DNA/hAT-Charlie	535	-	48	50095098	40986
chr22	50054112	50254112	harbor1	chr22	50103804	50104300	DNA/hAT-Charlie	3422	-	248	50104052	49940
chr22	50054112	50254112	harbor1	chr22	50140459	50140682	DNA/hAT-Charlie	1381	-	112	50140571	86459
chr22	50054112	50254112	harbor1	chr22	50146829	50147000	DNA/hAT-Charlie	588	-	86	50146915	92803
chr22	39374584	39574584	harbor1	chr22	39404599	39404748	DNA/hAT-Charlie	422	-	74	39404673	30089
chr22	39374584	39574584	harbor1	chr22	39434473	39434729	DNA/hAT-Charlie	486	-	128	39434601	60017
chr22	32075946	32275946	harbor1	chr22	32081559	32081768	DNA/hAT-Charlie	605	-	104	32081663	5717
chr22	32075946	32275946	harbor1	chr22	32134295	32134488	DNA/hAT-Charlie	409	-	96	32134391	58445
chr22	32075946	32275946	harbor1	chr22	32134787	32134916	DNA/hAT-Charlie	409	-	64	32134851	58905
chr22	24069929	24269929	harbor1	chr22	24080946	24081267	DNA/hAT-Charlie	1388	-	160	24081106	11177
chr22	24069929	24269929	harbor1	chr22	24100037	24100212	DNA/hAT-Charlie	513	-	88	24100125	30196
chr22	24069929	24269929	harbor1	chr22	24127905	24128102	DNA/hAT-Charlie	945	-	98	24128003	58074
chr22	24070054	24270054	harbor1	chr22	24080946	24081267	DNA/hAT-Charlie	1388	-	160	24081106	11052
chr22	24070054	24270054	harbor1	chr22	24100037	24100212	DNA/hAT-Charlie	513	-	88	24100125	30071
chr22	24070054	24270054	harbor1	chr22	24127905	24128102	DNA/hAT-Charlie	945	-	98	24128003	57949
chr22	36675743	36875743	harbor1	chr22	36690150	36690432	DNA/hAT-Charlie	548	-	141	36690291	14548
chr22	49664026	49864026	harbor1	chr22	49666499	49666676	DNA/hAT-Charlie	569	-	88	49666587	2561
chr22	49664089	49864089	harbor1	chr22	49666499	49666676	DNA/hAT-Charlie	569	-	88	49666587	2498
chr22	44201115	44401115	harbor1	chr22	44203282	44203487	DNA/hAT-Charlie	603	-	102	44203384	2269
chr22	23366695	23566695	harbor1	chr22	23369618	23369757	DNA/hAT-Charlie	418	-	70	23369688	2993
chr22	23366695	23566695	harbor1	chr22	23429079	23429280	DNA/hAT-Charlie	948	-	100	23429179	62484
chr22	30847282	31047282	harbor1	chr22	30928772	30929023	DNA/hAT-Charlie	629	-	126	30928898	81616
chr22	24069894	24269894	harbor1	chr22	24080946	24081267	DNA/hAT-Charlie	1388	-	160	24081106	11212
chr22	24069894	24269894	harbor1	chr22	24100037	24100212	DNA/hAT-Charlie	513	-	88	24100125	30231
chr22	24069894	24269894	harbor1	chr22	24127905	24128102	DNA/hAT-Charlie	945	-	98	24128003	58109
chr22	24007199	24207199	harbor1	chr22	24012147	24012404	DNA/hAT-Charlie	824	-	128	24012275	5076
chr22	24007199	24207199	harbor1	chr22	24033941	24034284	DNA/hAT-Charlie	2224	-	172	24034113	26914
chr22	24007199	24207199	harbor1	chr22	24052369	24052509	DNA/hAT-Charlie	595	-	70	24052439	45240
chr22	24007199	24207199	harbor1	chr22	24080946	24081267	DNA/hAT-Charlie	1388	-	160	24081106	73907
chr22	24007199	24207199	harbor1	chr22	24100037	24100212	DNA/hAT-Charlie	513	-	88	24100125	92926
chr22	30996891	31196891	harbor1	chr22	31002239	31002337	DNA/hAT-Charlie	575	-	49	31002288	5397
chr22	42597660	42797660	harbor1	chr22	42604349	42604508	DNA/hAT-Charlie	416	-	80	42604429	6769
chr22	19075024	19275024	harbor1	chr22	19080274	19080534	DNA/hAT-Charlie	1030	-	130	19080404	5380
chr22	19075024	19275024	harbor1	chr22	19098330	19098551	DNA/hAT-Charlie	630	-	110	19098440	23416
chr22	19075024	19275024	harbor1	chr22	19100690	19100822	DNA/hAT-Charlie	766	-	66	19100756	25732
chr22	19075024	19275024	harbor1	chr22	19104044	19104252	DNA/hAT-Charlie	995	-	104	19104148	29124
chr22	23366710	23566710	harbor1	chr22	23369618	23369757	DNA/hAT-Charlie	418	-	70	23369688	2978
chr22	23366710	23566710	harbor1	chr22	23429079	23429280	DNA/hAT-Charlie	948	-	100	23429179	62469
chr22	24069914	24269914	harbor1	chr22	24080946	24081267	DNA/hAT-Charlie	1388	-	160	24081106	11192
chr22	24069914	24269914	harbor1	chr22	24100037	24100212	DNA/hAT-Charlie	513	-	88	24100125	30211
chr22	24069914	24269914	harbor1	chr22	24127905	24128102	DNA/hAT-Charlie	945	-	98	24128003	58089
chr22	24069997	24269997	harbor1	chr22	24080946	24081267	DNA/hAT-Charlie	1388	-	160	24081106	11109
chr22	24069997	24269997	harbor1	chr22	24100037	24100212	DNA/hAT-Charlie	513	-	88	24100125	30128
chr22	24069997	24269997	harbor1	chr22	24127905	24128102	DNA/hAT-Charlie	945	-	98	24128003	58006
chr22	50167794	50367794	harbor1	chr22	50207679	50207775	DNA/hAT-Charlie	486	-	48	50207727	39933
chr22	43471950	43671950	harbor1	chr22	43471986	43472316	DNA/hAT-Charlie	527	-	165	43472151	201
chr22	43471950	43671950	harbor1	chr22	43525441	43525581	DNA/hAT-Charlie	435	-	70	43525511	53561
chr22	36918777	37118777	harbor1	chr22	36985688	36985840	DNA/hAT-Charlie	418	-	76	36985764	66987
chr22	36918807	37118807	harbor1	chr22	36985688	36985840	DNA/hAT-Charlie	418	-	76	36985764	66957
chr22	24062659	24262659	harbor1	chr22	24080946	24081267	DNA/hAT-Charlie	1388	-	160	24081106	18447
chr22	24062659	24262659	harbor1	chr22	24100037	24100212	DNA/hAT-Charlie	513	-	88	24100125	37466
chr22	24062659	24262659	harbor1	chr22	24127905	24128102	DNA/hAT-Charlie	945	-	98	24128003	65344
chr22	20568033	20768033	harbor1	chr22	20575776	20575945	DNA/hAT-Charlie	486	-	84	20575860	7827
chr22	20568033	20768033	harbor1	chr22	20623699	20623921	DNA/hAT-Charlie	1248	-	111	20623810	55777
chr22	20568033	20768033	harbor1	chr22	20651886	20652025	DNA/hAT-Charlie	719	-	70	20651956	83923
chr22	20568033	20768033	harbor1	chr22	20652329	20652400	DNA/hAT-Charlie	719	-	36	20652365	84332
chr22	32529769	32729769	harbor1	chr22	32540220	32540337	DNA/hAT-Charlie	464	-	58	32540278	10509
chr22	32529769	32729769	harbor1	chr22	32556056	32556601	DNA/hAT-Charlie	2551	-	272	32556328	26559
chr22	32529769	32729769	harbor1	chr22	32565320	32565418	DNA/hAT-Charlie	498	-	49	32565369	35600
chr22	32529769	32729769	harbor1	chr22	32566147	32566352	DNA/hAT-Charlie	862	-	102	32566249	36480
chr22	32529769	32729769	harbor1	chr22	32578802	32579015	DNA/hAT-Charlie	941	-	106	32578908	49139
chr22	32529769	32729769	harbor1	chr22	32582278	32582354	DNA/hAT-Charlie	552	-	38	32582316	52547
chr22	32529769	32729769	harbor1	chr22	32582682	32582759	DNA/hAT-Charlie	552	-	38	32582720	52951
chr22	32529769	32729769	harbor1	chr22	32591690	32591709	DNA/hAT-Charlie	925	-	10	32591700	61931
chr22	32529769	32729769	harbor1	chr22	32592154	32592334	DNA/hAT-Charlie	925	-	90	32592244	62475
chr22	32529769	32729769	harbor1	chr22	32599962	32600492	DNA/hAT-Charlie	3692	-	265	32600227	70458
chr22	32529769	32729769	harbor1	chr22	32621018	32621032	DNA/hAT-Charlie	725	-	7	32621025	91256
chr22	32529769	32729769	harbor1	chr22	32620348	32620726	DNA/hAT-Charlie	725	-	189	32620537	90768
chr22	24017128	24217128	harbor1	chr22	24033941	24034284	DNA/hAT-Charlie	2224	-	172	24034113	16985
chr22	24017128	24217128	harbor1	chr22	24052369	24052509	DNA/hAT-Charlie	595	-	70	24052439	35311
chr22	24017128	24217128	harbor1	chr22	24080946	24081267	DNA/hAT-Charlie	1388	-	160	24081106	63978
chr22	24017128	24217128	harbor1	chr22	24100037	24100212	DNA/hAT-Charlie	513	-	88	24100125	82997
chrX	18253915	18453915	harbor1	chrX	18267492	18267574	DNA/hAT-Charlie	605	-	41	18267533	13618
chrX	18253915	18453915	harbor1	chrX	18267896	18268014	DNA/hAT-Charlie	605	-	59	18267955	14040
chrX	130071758	130271758	harbor1	chrX	130077107	130077295	DNA/hAT-Charlie	968	-	94	130077201	5443
chrX	130071758	130271758	harbor1	chrX	130077594	130077624	DNA/hAT-Charlie	968	-	15	130077609	5851
chrX	130071758	130271758	harbor1	chrX	130130518	130130722	DNA/hAT-Charlie	1034	-	102	130130620	58862
chrX	130071758	130271758	harbor1	chrX	130157449	130157684	DNA/hAT-Charlie	1598	-	118	130157567	85809
chrX	130071758	130271758	harbor1	chrX	130158293	130158384	DNA/hAT-Charlie	1598	-	46	130158339	86581
chrX	130071758	130271758	harbor1	chrX	130158394	130158590	DNA/hAT-Charlie	971	-	98	130158492	86734
chrX	130071758	130271758	harbor1	chrX	130158602	130158788	DNA/hAT-Charlie	1267	-	93	130158695	86937
chrX	72043976	72243976	harbor1	chrX	72099681	72099947	DNA/hAT-Charlie	1462	-	133	72099814	55838
chrX	72043976	72243976	harbor1	chrX	72136700	72136874	DNA/hAT-Charlie	665	-	87	72136787	92811
chrX	129832695	130032695	harbor1	chrX	129909151	129909206	DNA/hAT-Charlie	628	-	28	129909179	76484
chrX	129832695	130032695	harbor1	chrX	129909509	129909720	DNA/hAT-Charlie	777	-	106	129909615	76920
chrX	18253792	18453792	harbor1	chrX	18267492	18267574	DNA/hAT-Charlie	605	-	41	18267533	13741
chrX	18253792	18453792	harbor1	chrX	18267896	18268014	DNA/hAT-Charlie	605	-	59	18267955	14163
chrX	153488191	153688191	harbor1	chrX	153521756	153521890	DNA/hAT-Charlie	575	-	67	153521823	33632
chrX	153488191	153688191	harbor1	chrX	153524307	153524524	DNA/hAT-Charlie	1081	-	108	153524415	36224
chrX	109902871	110102871	harbor1	chrX	109942851	109943083	DNA/hAT-Charlie	1067	-	116	109942967	40096
chrX	109902871	110102871	harbor1	chrX	109995912	109996455	DNA/hAT-Charlie	3999	-	272	109996184	93313
chrX	37578419	37778419	harbor1	chrX	37580972	37581120	DNA/hAT-Charlie	594	-	74	37581046	2627
chrX	37578419	37778419	harbor1	chrX	37590778	37590945	DNA/hAT-Charlie	718	-	84	37590862	12443
chrX	37578419	37778419	harbor1	chrX	37599333	37599501	DNA/hAT-Charlie	733	-	84	37599417	20998
chrX	37578419	37778419	harbor1	chrX	37608272	37608457	DNA/hAT-Charlie	1003	-	92	37608364	29945
chrX	37578419	37778419	harbor1	chrX	37615169	37615331	DNA/hAT-Charlie	954	-	81	37615250	36831
chrX	37578419	37778419	harbor1	chrX	37644786	37644963	DNA/hAT-Charlie	845	-	88	37644874	66455
chrX	37578419	37778419	harbor1	chrX	37659095	37659305	DNA/hAT-Charlie	1116	-	105	37659200	80781
chrX	37578419	37778419	harbor1	chrX	37659891	37660174	DNA/hAT-Charlie	997	-	142	37660033	81614
chrX	72029896	72229896	harbor1	chrX	72041330	72041520	DNA/hAT-Charlie	814	-	95	72041425	11529
chrX	72029896	72229896	harbor1	chrX	72099681	72099947	DNA/hAT-Charlie	1462	-	133	72099814	69918
chrX	49064231	49264231	harbor1	chrX	49092442	49092879	DNA/hAT-Charlie	1529	-	218	49092660	28429
chrX	19445154	19645154	harbor1	chrX	19457762	19457966	DNA/hAT-Charlie	692	-	102	19457864	12710
chrX	19445154	19645154	harbor1	chrX	19474927	19475433	DNA/hAT-Charlie	3552	-	253	19475180	30026
chrX	19445154	19645154	harbor1	chrX	19487900	19488073	DNA/hAT-Charlie	727	-	86	19487986	42832
chrX	19445154	19645154	harbor1	chrX	19514136	19514291	DNA/hAT-Charlie	576	-	78	19514214	69060
chrX	19445154	19645154	harbor1	chrX	19527000	19527188	DNA/hAT-Charlie	986	-	94	19527094	81940
chrX	19445154	19645154	harbor1	chrX	19527904	19528156	DNA/hAT-Charlie	556	-	126	19528030	82876
chrX	48792105	48992105	harbor1	chrX	48792807	48792954	DNA/hAT-Charlie	632	-	74	48792881	776
chrX	48792105	48992105	harbor1	chrX	48798106	48798417	DNA/hAT-Charlie	1416	-	156	48798262	6157
chrX	7048274	7248274	harbor1	chrX	7066358	7066696	DNA/hAT-Charlie	2128	-	169	7066527	18253
chrX	7048274	7248274	harbor1	chrX	7147335	7147545	DNA/hAT-Charlie	728	-	105	7147440	99166
