H_chr	H_start	H_end	Harbor	TE_chr	TE_start	TE_end	TE	score	TE_strand	TE_half	TE_middle_pos	TE_dis
chr1	77659514	77859514	harbor2	chr1	77663391	77663672	LINE/CR1	463	-	140	77663531	4017
chr1	201845418	202045418	harbor2	chr1	201919659	201919970	LINE/CR1	547	-	156	201919815	74397
chr1	65260750	65460750	harbor2	chr1	65314944	65315256	LINE/CR1	576	-	156	65315100	54350
chr1	168036739	168236739	harbor2	chr1	168106102	168106302	LINE/CR1	1064	-	100	168106202	69463
chr1	168036739	168236739	harbor2	chr1	168106591	168106885	LINE/CR1	1064	-	147	168106738	69999
chr1	33270603	33470603	harbor2	chr1	33337171	33337437	LINE/CR1	746	-	133	33337304	66701
chr1	204585865	204785865	harbor2	chr1	204598784	204599210	LINE/CR1	691	-	213	204598997	13132
chr1	205492013	205692013	harbor2	chr1	205587163	205587287	LINE/CR1	439	-	62	205587225	95212
chr1	205649090	205849090	harbor2	chr1	205737314	205737681	LINE/CR1	786	-	184	205737498	88408
chr1	53227374	53427374	harbor2	chr1	53247640	53247935	LINE/CR1	470	-	148	53247788	20414
chr1	94138719	94338719	harbor2	chr1	94155726	94156040	LINE/CR1	562	-	157	94155883	17164
chr1	94138719	94338719	harbor2	chr1	94187301	94187699	LINE/CR1	870	-	199	94187500	48781
chr1	229333991	229533991	harbor2	chr1	229370106	229370595	LINE/CR1	696	-	244	229370350	36359
chr1	160901756	161101756	harbor2	chr1	160993500	160993735	LINE/CR1	488	-	118	160993618	91862
chr1	7558962	7758962	harbor2	chr1	7629354	7629669	LINE/CR1	521	-	158	7629512	70550
chr1	110575275	110775275	harbor2	chr1	110613933	110614351	LINE/CR1	462	-	209	110614142	38867
chr1	26600726	26800726	harbor2	chr1	26616520	26616938	LINE/CR1	655	-	209	26616729	16003
chr1	214586377	214786377	harbor2	chr1	214626983	214627070	LINE/CR1	445	-	44	214627027	40650
chr1	214586377	214786377	harbor2	chr1	214627359	214627369	LINE/CR1	445	-	5	214627364	40987
chr1	214586377	214786377	harbor2	chr1	214627676	214627967	LINE/CR1	445	-	146	214627822	41445
chr1	14862929	15062929	harbor2	chr1	14940252	14940498	LINE/CR1	585	-	123	14940375	77446
chr1	46294779	46494779	harbor2	chr1	46296628	46297451	LINE/CR1	1349	-	412	46297040	2261
chr1	230941728	231141728	harbor2	chr1	230960351	230960474	LINE/CR1	451	-	62	230960413	18685
chr1	201882904	202082904	harbor2	chr1	201919659	201919970	LINE/CR1	547	-	156	201919815	36911
chr1	206973128	207173128	harbor2	chr1	206977950	206978249	LINE/CR1	759	-	150	206978100	4972
chr1	230940319	231140319	harbor2	chr1	230960351	230960474	LINE/CR1	451	-	62	230960413	20094
chr1	230539629	230739629	harbor2	chr1	230589205	230589726	LINE/CR1	624	-	260	230589465	49836
chr2	70453855	70653855	harbor2	chr2	70481346	70481544	LINE/CR1	545	-	99	70481445	27590
chr2	70453855	70653855	harbor2	chr2	70482432	70484458	LINE/CR1	1764	-	1013	70483445	29590
chr2	26950509	27150509	harbor2	chr2	26997853	26998456	LINE/CR1	965	-	302	26998155	47646
chr2	26956547	27156547	harbor2	chr2	26997853	26998456	LINE/CR1	965	-	302	26998155	41608
chr2	71056951	71256951	harbor2	chr2	71069458	71069970	LINE/CR1	924	-	256	71069714	12763
chr2	217854217	218054217	harbor2	chr2	217861088	217861560	LINE/CR1	499	-	236	217861324	7107
chr2	217854217	218054217	harbor2	chr2	217903614	217903790	LINE/CR1	488	-	88	217903702	49485
chr2	85228038	85428038	harbor2	chr2	85232239	85232687	LINE/CR1	463	-	224	85232463	4425
chr2	26950619	27150619	harbor2	chr2	26997853	26998456	LINE/CR1	965	-	302	26998155	47536
chr2	87467266	87667266	harbor2	chr2	87481416	87481710	LINE/CR1	445	-	147	87481563	14297
chr2	87467266	87667266	harbor2	chr2	87482527	87482606	LINE/CR1	445	-	40	87482567	15301
chr2	200603208	200803208	harbor2	chr2	200684844	200685497	LINE/CR1	999	-	326	200685170	81962
chr2	113497566	113697566	harbor2	chr2	113593027	113593581	LINE/CR1	979	-	277	113593304	95738
chr2	26957456	27157456	harbor2	chr2	26997853	26998456	LINE/CR1	965	-	302	26998155	40699
chr2	219343736	219543736	harbor2	chr2	219429111	219429352	LINE/CR1	467	-	120	219429231	85495
chr2	26950608	27150608	harbor2	chr2	26997853	26998456	LINE/CR1	965	-	302	26998155	47547
chr2	56148544	56348544	harbor2	chr2	56225797	56226117	LINE/CR1	572	-	160	56225957	77413
chr2	160417009	160617009	harbor2	chr2	160446173	160446554	LINE/CR1	713	-	190	160446363	29354
chr2	26950206	27150206	harbor2	chr2	26997853	26998456	LINE/CR1	965	-	302	26998155	47949
chr2	120666618	120866618	harbor2	chr2	120722050	120722400	LINE/CR1	635	-	175	120722225	55607
chr2	120666618	120866618	harbor2	chr2	120722448	120722871	LINE/CR1	472	-	212	120722660	56042
chr2	26950220	27150220	harbor2	chr2	26997853	26998456	LINE/CR1	965	-	302	26998155	47935
chr2	26950698	27150698	harbor2	chr2	26997853	26998456	LINE/CR1	965	-	302	26998155	47457
chr2	26969295	27169295	harbor2	chr2	26997853	26998456	LINE/CR1	965	-	302	26998155	28860
chr2	26982677	27182677	harbor2	chr2	26997853	26998456	LINE/CR1	965	-	302	26998155	15478
chr2	217119672	217319672	harbor2	chr2	217178769	217179070	LINE/CR1	1243	-	150	217178919	59247
chr2	217119672	217319672	harbor2	chr2	217179682	217180024	LINE/CR1	1243	-	171	217179853	60181
chr2	219387359	219587359	harbor2	chr2	219429111	219429352	LINE/CR1	467	-	120	219429231	41872
chr2	72971510	73171510	harbor2	chr2	72981217	72981676	LINE/CR1	889	-	230	72981447	9937
chr2	26982780	27182780	harbor2	chr2	26997853	26998456	LINE/CR1	965	-	302	26998155	15375
chr2	26960509	27160509	harbor2	chr2	26997853	26998456	LINE/CR1	965	-	302	26998155	37646
chr2	120635614	120835614	harbor2	chr2	120722050	120722400	LINE/CR1	635	-	175	120722225	86611
chr2	120635614	120835614	harbor2	chr2	120722448	120722871	LINE/CR1	472	-	212	120722660	87046
chr3	132356932	132556932	harbor2	chr3	132429881	132431097	LINE/CR1	986	-	608	132430489	73557
chr3	108053599	108253599	harbor2	chr3	108111839	108112686	LINE/CR1	1954	-	424	108112263	58664
chr3	108053599	108253599	harbor2	chr3	108113026	108113281	LINE/CR1	697	-	128	108113154	59555
chr3	187645815	187845815	harbor2	chr3	187715188	187715396	LINE/CR1	462	-	104	187715292	69477
chr3	108053564	108253564	harbor2	chr3	108111839	108112686	LINE/CR1	1954	-	424	108112263	58699
chr3	108053564	108253564	harbor2	chr3	108113026	108113281	LINE/CR1	697	-	128	108113154	59590
chr3	127270146	127470146	harbor2	chr3	127339886	127340176	LINE/CR1	1112	-	145	127340031	69885
chr3	108018365	108218365	harbor2	chr3	108111839	108112686	LINE/CR1	1954	-	424	108112263	93898
chr3	108018365	108218365	harbor2	chr3	108113026	108113281	LINE/CR1	697	-	128	108113154	94789
chr3	129022332	129222332	harbor2	chr3	129026364	129026713	LINE/CR1	423	-	174	129026538	4206
chr3	189960849	190160849	harbor2	chr3	189962923	189963170	LINE/CR1	520	-	124	189963047	2198
chr3	189960849	190160849	harbor2	chr3	190016695	190016959	LINE/CR1	423	-	132	190016827	55978
chr3	189960849	190160849	harbor2	chr3	190050093	190051027	LINE/CR1	686	-	467	190050560	89711
chr3	126930017	127130017	harbor2	chr3	126929858	126930492	LINE/CR1	957	-	317	126930175	158
chr3	128484655	128684655	harbor2	chr3	128568311	128568463	LINE/CR1	401	-	76	128568387	83732
chr3	116673098	116873098	harbor2	chr3	116716733	116717266	LINE/CR1	848	-	266	116716999	43901
chr3	116673098	116873098	harbor2	chr3	116717326	116717573	LINE/CR1	409	-	124	116717450	44352
chr3	116673098	116873098	harbor2	chr3	116750084	116750618	LINE/CR1	690	-	267	116750351	77253
chr3	123399935	123599935	harbor2	chr3	123441444	123441961	LINE/CR1	587	-	258	123441702	41767
chr3	108026049	108226049	harbor2	chr3	108111839	108112686	LINE/CR1	1954	-	424	108112263	86214
chr3	108026049	108226049	harbor2	chr3	108113026	108113281	LINE/CR1	697	-	128	108113154	87105
chr3	108053563	108253563	harbor2	chr3	108111839	108112686	LINE/CR1	1954	-	424	108112263	58700
chr3	108053563	108253563	harbor2	chr3	108113026	108113281	LINE/CR1	697	-	128	108113154	59591
chr3	108053682	108253682	harbor2	chr3	108111839	108112686	LINE/CR1	1954	-	424	108112263	58581
chr3	108053682	108253682	harbor2	chr3	108113026	108113281	LINE/CR1	697	-	128	108113154	59472
chr3	142529008	142729008	harbor2	chr3	142610218	142610538	LINE/CR1	663	-	160	142610378	81370
chr3	142529008	142729008	harbor2	chr3	142624946	142625072	LINE/CR1	415	-	63	142625009	96001
chr3	126911046	127111046	harbor2	chr3	126928914	126929573	LINE/CR1	957	-	330	126929244	18198
chr3	126911046	127111046	harbor2	chr3	126929858	126930492	LINE/CR1	957	-	317	126930175	19129
chr3	108359237	108559237	harbor2	chr3	108437877	108438318	LINE/CR1	675	-	220	108438097	78860
chr3	108053525	108253525	harbor2	chr3	108111839	108112686	LINE/CR1	1954	-	424	108112263	58738
chr3	108053525	108253525	harbor2	chr3	108113026	108113281	LINE/CR1	697	-	128	108113154	59629
chr4	159002962	159202962	harbor2	chr4	159010260	159011058	LINE/CR1	1385	-	399	159010659	7697
chr4	120823311	121023311	harbor2	chr4	120859690	120860063	LINE/CR1	564	-	186	120859876	36565
chr4	120823311	121023311	harbor2	chr4	120870978	120871631	LINE/CR1	919	-	326	120871304	47993
chr4	120823311	121023311	harbor2	chr4	120873391	120873928	LINE/CR1	623	-	268	120873659	50348
chr4	189959153	190159153	harbor2	chr4	189971186	189971330	LINE/CR1	470	-	72	189971258	12105
chr4	120822652	121022652	harbor2	chr4	120859690	120860063	LINE/CR1	564	-	186	120859876	37224
chr4	120822652	121022652	harbor2	chr4	120870978	120871631	LINE/CR1	919	-	326	120871304	48652
chr4	120822652	121022652	harbor2	chr4	120873391	120873928	LINE/CR1	623	-	268	120873659	51007
chr4	7569422	7769422	harbor2	chr4	7664912	7665174	LINE/CR1	511	-	131	7665043	95621
chr4	189959360	190159360	harbor2	chr4	189971186	189971330	LINE/CR1	470	-	72	189971258	11898
chr4	189957449	190157449	harbor2	chr4	189971186	189971330	LINE/CR1	470	-	72	189971258	13809
chr5	115444451	115644451	harbor2	chr5	115476836	115477299	LINE/CR1	781	-	232	115477068	32617
chr5	150970772	151170772	harbor2	chr5	151031173	151031514	LINE/CR1	475	-	170	151031343	60571
chr5	150970772	151170772	harbor2	chr5	151065182	151065387	LINE/CR1	573	-	102	151065284	94512
chr5	52700040	52900040	harbor2	chr5	52711032	52711639	LINE/CR1	722	-	304	52711336	11296
chr5	176018013	176218013	harbor2	chr5	176041103	176041278	LINE/CR1	454	-	88	176041191	23178
chr5	42530223	42730223	harbor2	chr5	42588556	42589322	LINE/CR1	1007	-	383	42588939	58716
chr5	178021742	178221742	harbor2	chr5	178078344	178078789	LINE/CR1	669	-	222	178078566	56824
chr5	52700035	52900035	harbor2	chr5	52711032	52711639	LINE/CR1	722	-	304	52711336	11301
chr5	52705069	52905069	harbor2	chr5	52711032	52711639	LINE/CR1	722	-	304	52711336	6267
chr5	94829534	95029534	harbor2	chr5	94880610	94880874	LINE/CR1	475	-	132	94880742	51208
chr5	94829534	95029534	harbor2	chr5	94882217	94882484	LINE/CR1	437	-	134	94882351	52817
chr5	75136870	75336870	harbor2	chr5	75166529	75166899	LINE/CR1	694	-	185	75166714	29844
chr5	52700409	52900409	harbor2	chr5	52711032	52711639	LINE/CR1	722	-	304	52711336	10927
chr5	133166465	133366465	harbor2	chr5	133247986	133248347	LINE/CR1	555	-	180	133248166	81701
chr6	30621444	30821444	harbor2	chr6	30661938	30662436	LINE/CR1	738	-	249	30662187	40743
chr6	125225390	125425390	harbor2	chr6	125293457	125293681	LINE/CR1	453	-	112	125293569	68179
chr6	125225390	125425390	harbor2	chr6	125294697	125294905	LINE/CR1	551	-	104	125294801	69411
chr6	125225390	125425390	harbor2	chr6	125295746	125296058	LINE/CR1	1930	-	156	125295902	70512
chr6	125225390	125425390	harbor2	chr6	125296348	125297033	LINE/CR1	1930	-	342	125296690	71300
chr6	37071463	37271463	harbor2	chr6	37163490	37163655	LINE/CR1	491	-	82	37163572	92109
chr6	118834580	119034580	harbor2	chr6	118921098	118921579	LINE/CR1	500	-	240	118921338	86758
chr6	139275464	139475464	harbor2	chr6	139306528	139307172	LINE/CR1	1239	-	322	139306850	31386
chr6	139275450	139475450	harbor2	chr6	139306528	139307172	LINE/CR1	1239	-	322	139306850	31400
chr6	139275453	139475453	harbor2	chr6	139306528	139307172	LINE/CR1	1239	-	322	139306850	31397
chr6	37071432	37271432	harbor2	chr6	37163490	37163655	LINE/CR1	491	-	82	37163572	92140
chr6	139275439	139475439	harbor2	chr6	139306528	139307172	LINE/CR1	1239	-	322	139306850	31411
chr6	90487353	90687353	harbor2	chr6	90570713	90571009	LINE/CR1	609	-	148	90570861	83508
chr6	37074400	37274400	harbor2	chr6	37163490	37163655	LINE/CR1	491	-	82	37163572	89172
chr6	139292147	139492147	harbor2	chr6	139306528	139307172	LINE/CR1	1239	-	322	139306850	14703
chr6	139275441	139475441	harbor2	chr6	139306528	139307172	LINE/CR1	1239	-	322	139306850	31409
chr6	43872696	44072696	harbor2	chr6	43947681	43948306	LINE/CR1	759	-	312	43947993	75297
chr6	43872696	44072696	harbor2	chr6	43948792	43949165	LINE/CR1	787	-	186	43948978	76282
chr6	37189816	37389816	harbor2	chr6	37265002	37265497	LINE/CR1	815	-	248	37265250	75434
chr6	139275444	139475444	harbor2	chr6	139306528	139307172	LINE/CR1	1239	-	322	139306850	31406
chr6	37073934	37273934	harbor2	chr6	37163490	37163655	LINE/CR1	491	-	82	37163572	89638
chr6	37072538	37272538	harbor2	chr6	37163490	37163655	LINE/CR1	491	-	82	37163572	91034
chr6	152219275	152419275	harbor2	chr6	152240940	152241176	LINE/CR1	529	-	118	152241058	21783
chr6	52583140	52783140	harbor2	chr6	52653679	52653818	LINE/CR1	446	-	70	52653749	70609
chr6	139275438	139475438	harbor2	chr6	139306528	139307172	LINE/CR1	1239	-	322	139306850	31412
chr6	37253997	37453997	harbor2	chr6	37265002	37265497	LINE/CR1	815	-	248	37265250	11253
chr6	30621530	30821530	harbor2	chr6	30661938	30662436	LINE/CR1	738	-	249	30662187	40657
chr6	139336768	139536768	harbor2	chr6	139407805	139408129	LINE/CR1	586	-	162	139407967	71199
chr6	139336768	139536768	harbor2	chr6	139418526	139419054	LINE/CR1	528	-	264	139418790	82022
chr6	42953847	43153847	harbor2	chr6	42988236	42988890	LINE/CR1	981	-	327	42988563	34716
chr6	139373354	139573354	harbor2	chr6	139407805	139408129	LINE/CR1	586	-	162	139407967	34613
chr6	139373354	139573354	harbor2	chr6	139418526	139419054	LINE/CR1	528	-	264	139418790	45436
chr6	139275442	139475442	harbor2	chr6	139306528	139307172	LINE/CR1	1239	-	322	139306850	31408
chr6	146813947	147013947	harbor2	chr6	146862848	146863166	LINE/CR1	502	-	159	146863007	49060
chr6	37072323	37272323	harbor2	chr6	37163490	37163655	LINE/CR1	491	-	82	37163572	91249
chr6	139276317	139476317	harbor2	chr6	139306528	139307172	LINE/CR1	1239	-	322	139306850	30533
chr6	37071349	37271349	harbor2	chr6	37163490	37163655	LINE/CR1	491	-	82	37163572	92223
chr6	139275455	139475455	harbor2	chr6	139306528	139307172	LINE/CR1	1239	-	322	139306850	31395
chr6	37072379	37272379	harbor2	chr6	37163490	37163655	LINE/CR1	491	-	82	37163572	91193
chr6	37071596	37271596	harbor2	chr6	37163490	37163655	LINE/CR1	491	-	82	37163572	91976
chr6	37070833	37270833	harbor2	chr6	37163490	37163655	LINE/CR1	491	-	82	37163572	92739
chr6	139275447	139475447	harbor2	chr6	139306528	139307172	LINE/CR1	1239	-	322	139306850	31403
chr6	37073886	37273886	harbor2	chr6	37163490	37163655	LINE/CR1	491	-	82	37163572	89686
chr6	30621455	30821455	harbor2	chr6	30661938	30662436	LINE/CR1	738	-	249	30662187	40732
chr6	147926214	148126214	harbor2	chr6	147967180	147967560	LINE/CR1	1094	-	190	147967370	41156
chr6	147926214	148126214	harbor2	chr6	147967866	147967998	LINE/CR1	1094	-	66	147967932	41718
chr6	149646190	149846190	harbor2	chr6	149704951	149705611	LINE/CR1	752	-	330	149705281	59091
chr6	158127245	158327245	harbor2	chr6	158226612	158226905	LINE/CR1	509	-	146	158226758	99513
chr7	72825583	73025583	harbor2	chr7	72873257	72873575	LINE/CR1	505	-	159	72873416	47833
chr7	148599806	148799806	harbor2	chr7	148696632	148696744	LINE/CR1	492	-	56	148696688	96882
chr7	142754209	142954209	harbor2	chr7	142807714	142808252	LINE/CR1	487	-	269	142807983	53774
chr7	135684417	135884417	harbor2	chr7	135716885	135717236	LINE/CR1	455	-	176	135717061	32644
chr7	159003487	159203487	harbor2	chr7	159009693	159010026	LINE/CR1	587	-	166	159009859	6372
chr7	128769421	128969421	harbor2	chr7	128819834	128820425	LINE/CR1	751	-	296	128820130	50709
chr7	70311624	70511624	harbor2	chr7	70345407	70347012	LINE/CR1	1376	-	802	70346209	34585
chr7	128756973	128956973	harbor2	chr7	128819834	128820425	LINE/CR1	751	-	296	128820130	63157
chr7	41382564	41582564	harbor2	chr7	41431647	41431980	LINE/CR1	628	-	166	41431813	49249
chr8	23428848	23628848	harbor2	chr8	23474005	23474347	LINE/CR1	637	-	171	23474176	45328
chr8	23429416	23629416	harbor2	chr8	23474005	23474347	LINE/CR1	637	-	171	23474176	44760
chr8	23428811	23628811	harbor2	chr8	23474005	23474347	LINE/CR1	637	-	171	23474176	45365
chr8	23439328	23639328	harbor2	chr8	23474005	23474347	LINE/CR1	637	-	171	23474176	34848
chr8	23428778	23628778	harbor2	chr8	23474005	23474347	LINE/CR1	637	-	171	23474176	45398
chr8	23428784	23628784	harbor2	chr8	23474005	23474347	LINE/CR1	637	-	171	23474176	45392
chr8	23428892	23628892	harbor2	chr8	23474005	23474347	LINE/CR1	637	-	171	23474176	45284
chr8	23429271	23629271	harbor2	chr8	23474005	23474347	LINE/CR1	637	-	171	23474176	44905
chr8	23430686	23630686	harbor2	chr8	23474005	23474347	LINE/CR1	637	-	171	23474176	43490
chr8	23429353	23629353	harbor2	chr8	23474005	23474347	LINE/CR1	637	-	171	23474176	44823
chr8	23428870	23628870	harbor2	chr8	23474005	23474347	LINE/CR1	637	-	171	23474176	45306
chr8	23429241	23629241	harbor2	chr8	23474005	23474347	LINE/CR1	637	-	171	23474176	44935
chr8	23428834	23628834	harbor2	chr8	23474005	23474347	LINE/CR1	637	-	171	23474176	45342
chr8	29150120	29350120	harbor2	chr8	29185528	29186017	LINE/CR1	435	-	244	29185772	35652
chr8	23428832	23628832	harbor2	chr8	23474005	23474347	LINE/CR1	637	-	171	23474176	45344
chr8	23428810	23628810	harbor2	chr8	23474005	23474347	LINE/CR1	637	-	171	23474176	45366
chr8	23432814	23632814	harbor2	chr8	23474005	23474347	LINE/CR1	637	-	171	23474176	41362
chr8	23430803	23630803	harbor2	chr8	23474005	23474347	LINE/CR1	637	-	171	23474176	43373
chr8	11492953	11692953	harbor2	chr8	11589226	11589363	LINE/CR1	437	-	68	11589294	96341
chr8	23428809	23628809	harbor2	chr8	23474005	23474347	LINE/CR1	637	-	171	23474176	45367
chr8	23428725	23628725	harbor2	chr8	23474005	23474347	LINE/CR1	637	-	171	23474176	45451
chr8	23429172	23629172	harbor2	chr8	23474005	23474347	LINE/CR1	637	-	171	23474176	45004
chr8	23428835	23628835	harbor2	chr8	23474005	23474347	LINE/CR1	637	-	171	23474176	45341
chr8	23429068	23629068	harbor2	chr8	23474005	23474347	LINE/CR1	637	-	171	23474176	45108
chr8	23428926	23628926	harbor2	chr8	23474005	23474347	LINE/CR1	637	-	171	23474176	45250
chr8	23428913	23628913	harbor2	chr8	23474005	23474347	LINE/CR1	637	-	171	23474176	45263
chr8	23429294	23629294	harbor2	chr8	23474005	23474347	LINE/CR1	637	-	171	23474176	44882
chr8	23429109	23629109	harbor2	chr8	23474005	23474347	LINE/CR1	637	-	171	23474176	45067
chr8	23428807	23628807	harbor2	chr8	23474005	23474347	LINE/CR1	637	-	171	23474176	45369
chr8	23431300	23631300	harbor2	chr8	23474005	23474347	LINE/CR1	637	-	171	23474176	42876
chr8	23428847	23628847	harbor2	chr8	23474005	23474347	LINE/CR1	637	-	171	23474176	45329
chr8	23429149	23629149	harbor2	chr8	23474005	23474347	LINE/CR1	637	-	171	23474176	45027
chr8	23430721	23630721	harbor2	chr8	23474005	23474347	LINE/CR1	637	-	171	23474176	43455
chr8	27226138	27426138	harbor2	chr8	27289585	27289762	LINE/CR1	577	-	88	27289673	63535
chr8	23428862	23628862	harbor2	chr8	23474005	23474347	LINE/CR1	637	-	171	23474176	45314
chr8	23429308	23629308	harbor2	chr8	23474005	23474347	LINE/CR1	637	-	171	23474176	44868
chr8	23428822	23628822	harbor2	chr8	23474005	23474347	LINE/CR1	637	-	171	23474176	45354
chr8	23432595	23632595	harbor2	chr8	23474005	23474347	LINE/CR1	637	-	171	23474176	41581
chr8	23428886	23628886	harbor2	chr8	23474005	23474347	LINE/CR1	637	-	171	23474176	45290
chr8	23428849	23628849	harbor2	chr8	23474005	23474347	LINE/CR1	637	-	171	23474176	45327
chr8	23428839	23628839	harbor2	chr8	23474005	23474347	LINE/CR1	637	-	171	23474176	45337
chr8	23447867	23647867	harbor2	chr8	23474005	23474347	LINE/CR1	637	-	171	23474176	26309
chr8	23428736	23628736	harbor2	chr8	23474005	23474347	LINE/CR1	637	-	171	23474176	45440
chr8	23429123	23629123	harbor2	chr8	23474005	23474347	LINE/CR1	637	-	171	23474176	45053
chr8	42742785	42942785	harbor2	chr8	42819414	42819592	LINE/CR1	496	-	89	42819503	76718
chr8	23428733	23628733	harbor2	chr8	23474005	23474347	LINE/CR1	637	-	171	23474176	45443
chr8	23429202	23629202	harbor2	chr8	23474005	23474347	LINE/CR1	637	-	171	23474176	44974
chr8	23430734	23630734	harbor2	chr8	23474005	23474347	LINE/CR1	637	-	171	23474176	43442
chr8	23428636	23628636	harbor2	chr8	23474005	23474347	LINE/CR1	637	-	171	23474176	45540
chr8	23428840	23628840	harbor2	chr8	23474005	23474347	LINE/CR1	637	-	171	23474176	45336
chr8	27543509	27743509	harbor2	chr8	27616722	27617316	LINE/CR1	729	-	297	27617019	73510
chr8	27543509	27743509	harbor2	chr8	27619910	27619956	LINE/CR1	578	-	23	27619933	76424
chr8	27543509	27743509	harbor2	chr8	27620268	27620584	LINE/CR1	578	-	158	27620426	76917
chr8	27543509	27743509	harbor2	chr8	27624064	27624290	LINE/CR1	454	-	113	27624177	80668
chr8	23428828	23628828	harbor2	chr8	23474005	23474347	LINE/CR1	637	-	171	23474176	45348
chr8	23428920	23628920	harbor2	chr8	23474005	23474347	LINE/CR1	637	-	171	23474176	45256
chr8	23428899	23628899	harbor2	chr8	23474005	23474347	LINE/CR1	637	-	171	23474176	45277
chr8	23651754	23851754	harbor2	chr8	23671511	23671745	LINE/CR1	518	-	117	23671628	19874
chr8	600587	800587	harbor2	chr8	672230	672565	LINE/CR1	491	-	168	672398	71811
chr8	23456020	23656020	harbor2	chr8	23474005	23474347	LINE/CR1	637	-	171	23474176	18156
chr8	23428854	23628854	harbor2	chr8	23474005	23474347	LINE/CR1	637	-	171	23474176	45322
chr8	23428795	23628795	harbor2	chr8	23474005	23474347	LINE/CR1	637	-	171	23474176	45381
chr8	22818594	23018594	harbor2	chr8	22835620	22835892	LINE/CR1	501	-	136	22835756	17162
chr8	138813637	139013637	harbor2	chr8	138911021	138911440	LINE/CR1	601	-	210	138911231	97594
chr8	23429259	23629259	harbor2	chr8	23474005	23474347	LINE/CR1	637	-	171	23474176	44917
chr8	23428874	23628874	harbor2	chr8	23474005	23474347	LINE/CR1	637	-	171	23474176	45302
chr9	109158501	109358501	harbor2	chr9	109228232	109228681	LINE/CR1	942	-	224	109228456	69955
chr9	109158501	109358501	harbor2	chr9	109229160	109229383	LINE/CR1	514	-	112	109229272	70771
chr9	97416346	97616346	harbor2	chr9	97511446	97511574	LINE/CR1	498	-	64	97511510	95164
chr9	97416346	97616346	harbor2	chr9	97511884	97512085	LINE/CR1	498	-	100	97511984	95638
chr9	97416346	97616346	harbor2	chr9	97512997	97513199	LINE/CR1	520	-	101	97513098	96752
chr9	91323874	91523874	harbor2	chr9	91407532	91407770	LINE/CR1	551	-	119	91407651	83777
chr9	99191390	99391390	harbor2	chr9	99265441	99265713	LINE/CR1	481	-	136	99265577	74187
chr9	99191390	99391390	harbor2	chr9	99290789	99290985	LINE/CR1	539	-	98	99290887	99497
chr9	68607235	68807235	harbor2	chr9	68625859	68626064	LINE/CR1	505	-	102	68625961	18726
chr9	68607235	68807235	harbor2	chr9	68626608	68626831	LINE/CR1	521	-	112	68626720	19485
chr9	68619252	68819252	harbor2	chr9	68625859	68626064	LINE/CR1	505	-	102	68625961	6709
chr9	68619252	68819252	harbor2	chr9	68626608	68626831	LINE/CR1	521	-	112	68626720	7468
chr9	105154708	105354708	harbor2	chr9	105241885	105242231	LINE/CR1	581	-	173	105242058	87350
chr9	38155453	38355453	harbor2	chr9	38237579	38237963	LINE/CR1	650	-	192	38237771	82318
chr9	123915711	124115711	harbor2	chr9	123991280	123992018	LINE/CR1	1161	-	369	123991649	75938
chr9	123915711	124115711	harbor2	chr9	123992817	123992858	LINE/CR1	1161	-	20	123992837	77126
chr9	36902991	37102991	harbor2	chr9	36950401	36950730	LINE/CR1	887	-	164	36950565	47574
chr9	36902991	37102991	harbor2	chr9	36951034	36951099	LINE/CR1	887	-	32	36951066	48075
chr9	36902991	37102991	harbor2	chr9	36998014	36998260	LINE/CR1	507	-	123	36998137	95146
chr9	36902991	37102991	harbor2	chr9	37000623	37001139	LINE/CR1	937	-	258	37000881	97890
chr9	99259961	99459961	harbor2	chr9	99265441	99265713	LINE/CR1	481	-	136	99265577	5616
chr9	99259961	99459961	harbor2	chr9	99290789	99290985	LINE/CR1	539	-	98	99290887	30926
chr10	48742186	48942186	harbor2	chr10	48823135	48823424	LINE/CR1	465	-	144	48823279	81093
chr10	102141600	102341600	harbor2	chr10	102238840	102239039	LINE/CR1	613	-	100	102238940	97340
chr10	102141600	102341600	harbor2	chr10	102239243	102239390	LINE/CR1	488	-	74	102239317	97717
chr10	102141612	102341612	harbor2	chr10	102238840	102239039	LINE/CR1	613	-	100	102238940	97328
chr10	102141612	102341612	harbor2	chr10	102239243	102239390	LINE/CR1	488	-	74	102239317	97705
chr10	75729207	75929207	harbor2	chr10	75730473	75730727	LINE/CR1	804	-	127	75730600	1393
chr10	97778537	97978537	harbor2	chr10	97809000	97809214	LINE/CR1	574	-	107	97809107	30570
chr10	102141599	102341599	harbor2	chr10	102238840	102239039	LINE/CR1	613	-	100	102238940	97341
chr10	102141599	102341599	harbor2	chr10	102239243	102239390	LINE/CR1	488	-	74	102239317	97718
chr10	102141615	102341615	harbor2	chr10	102238840	102239039	LINE/CR1	613	-	100	102238940	97325
chr10	102141615	102341615	harbor2	chr10	102239243	102239390	LINE/CR1	488	-	74	102239317	97702
chr10	130028498	130228498	harbor2	chr10	130085831	130086533	LINE/CR1	501	-	351	130086182	57684
chr10	71364878	71564878	harbor2	chr10	71449332	71449509	LINE/CR1	546	-	88	71449420	84542
chr10	71364878	71564878	harbor2	chr10	71449835	71450036	LINE/CR1	504	-	100	71449935	85057
chr10	131033279	131233279	harbor2	chr10	131121451	131121616	LINE/CR1	597	-	82	131121533	88254
chr10	102144633	102344633	harbor2	chr10	102238840	102239039	LINE/CR1	613	-	100	102238940	94307
chr10	102144633	102344633	harbor2	chr10	102239243	102239390	LINE/CR1	488	-	74	102239317	94684
chr10	89151733	89351733	harbor2	chr10	89159830	89160255	LINE/CR1	755	-	212	89160042	8309
chr10	102141601	102341601	harbor2	chr10	102238840	102239039	LINE/CR1	613	-	100	102238940	97339
chr10	102141601	102341601	harbor2	chr10	102239243	102239390	LINE/CR1	488	-	74	102239317	97716
chr10	131311786	131511786	harbor2	chr10	131320188	131320339	LINE/CR1	473	-	76	131320264	8478
chr10	131311983	131511983	harbor2	chr10	131320188	131320339	LINE/CR1	473	-	76	131320264	8281
chr10	131312053	131512053	harbor2	chr10	131320188	131320339	LINE/CR1	473	-	76	131320264	8211
chr10	102141624	102341624	harbor2	chr10	102238840	102239039	LINE/CR1	613	-	100	102238940	97316
chr10	102141624	102341624	harbor2	chr10	102239243	102239390	LINE/CR1	488	-	74	102239317	97693
chr10	30719277	30919277	harbor2	chr10	30788408	30788789	LINE/CR1	708	-	190	30788598	69321
chr11	6471157	6671157	harbor2	chr11	6508611	6508746	LINE/CR1	426	-	68	6508679	37522
chr11	65969869	66169869	harbor2	chr11	66047570	66047915	LINE/CR1	735	-	172	66047742	77873
chr11	32346594	32546594	harbor2	chr11	32404570	32405003	LINE/CR1	766	-	216	32404786	58192
chr11	111441454	111641454	harbor2	chr11	111500312	111500793	LINE/CR1	844	-	240	111500552	59098
chr11	64914593	65114593	harbor2	chr11	64937655	64937892	LINE/CR1	519	-	118	64937773	23180
chr11	124701200	124901200	harbor2	chr11	124749898	124750295	LINE/CR1	889	-	198	124750096	48896
chr11	69543435	69743435	harbor2	chr11	69625086	69625274	LINE/CR1	424	-	94	69625180	81745
chr11	46517295	46717295	harbor2	chr11	46576464	46576711	LINE/CR1	453	-	124	46576588	59293
chr11	84774083	84974083	harbor2	chr11	84855904	84856222	LINE/CR1	748	-	159	84856063	81980
chr11	43448895	43648895	harbor2	chr11	43532235	43532605	LINE/CR1	461	-	185	43532420	83525
chr11	61487515	61687515	harbor2	chr11	61560732	61561123	LINE/CR1	834	-	196	61560928	73413
chr11	69540352	69740352	harbor2	chr11	69625086	69625274	LINE/CR1	424	-	94	69625180	84828
chr11	32377105	32577105	harbor2	chr11	32404570	32405003	LINE/CR1	766	-	216	32404786	27681
chr11	69543489	69743489	harbor2	chr11	69625086	69625274	LINE/CR1	424	-	94	69625180	81691
chr11	69540160	69740160	harbor2	chr11	69625086	69625274	LINE/CR1	424	-	94	69625180	85020
chr11	65948857	66148857	harbor2	chr11	66047570	66047915	LINE/CR1	735	-	172	66047742	98885
chr11	3737914	3937914	harbor2	chr11	3815154	3815304	LINE/CR1	619	-	75	3815229	77315
chr11	3737914	3937914	harbor2	chr11	3815553	3815817	LINE/CR1	619	-	132	3815685	77771
chr11	3994569	4194569	harbor2	chr11	4024466	4024781	LINE/CR1	587	-	158	4024624	30055
chr11	67369200	67569200	harbor2	chr11	67382991	67383143	LINE/CR1	756	-	76	67383067	13867
chr11	111441731	111641731	harbor2	chr11	111500312	111500793	LINE/CR1	844	-	240	111500552	58821
chr11	120127774	120327774	harbor2	chr11	120142367	120142589	LINE/CR1	452	-	111	120142478	14704
chr11	67369215	67569215	harbor2	chr11	67382991	67383143	LINE/CR1	756	-	76	67383067	13852
chr11	126376674	126576674	harbor2	chr11	126429671	126429854	LINE/CR1	427	-	92	126429763	53089
chr11	126376674	126576674	harbor2	chr11	126454794	126455041	LINE/CR1	445	-	124	126454918	78244
chr11	134094872	134294872	harbor2	chr11	134182200	134182770	LINE/CR1	957	-	285	134182485	87613
chr11	61396732	61596732	harbor2	chr11	61476330	61476497	LINE/CR1	452	-	84	61476414	79682
chr11	118813698	119013698	harbor2	chr11	118888100	118888793	LINE/CR1	1021	-	346	118888446	74748
chr11	117457689	117657689	harbor2	chr11	117534328	117534602	LINE/CR1	659	-	137	117534465	76776
chr11	117457689	117657689	harbor2	chr11	117534891	117535353	LINE/CR1	659	-	231	117535122	77433
chr11	69540884	69740884	harbor2	chr11	69625086	69625274	LINE/CR1	424	-	94	69625180	84296
chr11	62571717	62771717	harbor2	chr11	62620714	62620988	LINE/CR1	450	-	137	62620851	49134
chr11	62588670	62788670	harbor2	chr11	62620714	62620988	LINE/CR1	450	-	137	62620851	32181
chr11	124700459	124900459	harbor2	chr11	124749898	124750295	LINE/CR1	889	-	198	124750096	49637
chr12	49267227	49467227	harbor2	chr12	49358470	49358751	LINE/CR1	611	-	140	49358610	91383
chr12	49268103	49468103	harbor2	chr12	49358470	49358751	LINE/CR1	611	-	140	49358610	90507
chr12	49267993	49467993	harbor2	chr12	49358470	49358751	LINE/CR1	611	-	140	49358610	90617
chr12	49268819	49468819	harbor2	chr12	49358470	49358751	LINE/CR1	611	-	140	49358610	89791
chr12	49268101	49468101	harbor2	chr12	49358470	49358751	LINE/CR1	611	-	140	49358610	90509
chr12	49267230	49467230	harbor2	chr12	49358470	49358751	LINE/CR1	611	-	140	49358610	91380
chr12	49267981	49467981	harbor2	chr12	49358470	49358751	LINE/CR1	611	-	140	49358610	90629
chr12	49268099	49468099	harbor2	chr12	49358470	49358751	LINE/CR1	611	-	140	49358610	90511
chr12	49267239	49467239	harbor2	chr12	49358470	49358751	LINE/CR1	611	-	140	49358610	91371
chr12	49267955	49467955	harbor2	chr12	49358470	49358751	LINE/CR1	611	-	140	49358610	90655
chr12	49268838	49468838	harbor2	chr12	49358470	49358751	LINE/CR1	611	-	140	49358610	89772
chr12	49267136	49467136	harbor2	chr12	49358470	49358751	LINE/CR1	611	-	140	49358610	91474
chr12	49268155	49468155	harbor2	chr12	49358470	49358751	LINE/CR1	611	-	140	49358610	90455
chr12	49268224	49468224	harbor2	chr12	49358470	49358751	LINE/CR1	611	-	140	49358610	90386
chr13	20315477	20515477	harbor2	chr13	20334744	20335155	LINE/CR1	474	-	206	20334950	19473
chr13	30104569	30304569	harbor2	chr13	30188330	30188739	LINE/CR1	913	-	204	30188534	83965
chr13	20317804	20517804	harbor2	chr13	20334744	20335155	LINE/CR1	474	-	206	20334950	17146
chr13	20327632	20527632	harbor2	chr13	20334744	20335155	LINE/CR1	474	-	206	20334950	7318
chr13	20317117	20517117	harbor2	chr13	20334744	20335155	LINE/CR1	474	-	206	20334950	17833
chr14	99493150	99693150	harbor2	chr14	99531786	99531986	LINE/CR1	432	-	100	99531886	38736
chr14	20990974	21190974	harbor2	chr14	21063843	21064062	LINE/CR1	592	-	110	21063953	72979
chr14	99493147	99693147	harbor2	chr14	99531786	99531986	LINE/CR1	432	-	100	99531886	38739
chr14	81176400	81376400	harbor2	chr14	81181882	81182165	LINE/CR1	574	-	142	81182024	5624
chr14	81176400	81376400	harbor2	chr14	81266140	81266784	LINE/CR1	1143	-	322	81266462	90062
chr14	21356189	21556189	harbor2	chr14	21429933	21430101	LINE/CR1	491	-	84	21430017	73828
chr14	76886650	77086650	harbor2	chr14	76929803	76930357	LINE/CR1	466	-	277	76930080	43430
chr14	21337322	21537322	harbor2	chr14	21429933	21430101	LINE/CR1	491	-	84	21430017	92695
chr14	76928705	77128705	harbor2	chr14	76929803	76930357	LINE/CR1	466	-	277	76930080	1375
chr14	99496893	99696893	harbor2	chr14	99531786	99531986	LINE/CR1	432	-	100	99531886	34993
chr14	99462315	99662315	harbor2	chr14	99531786	99531986	LINE/CR1	432	-	100	99531886	69571
chr14	21007545	21207545	harbor2	chr14	21063843	21064062	LINE/CR1	592	-	110	21063953	56408
chr14	21337315	21537315	harbor2	chr14	21429933	21430101	LINE/CR1	491	-	84	21430017	92702
chr14	21337330	21537330	harbor2	chr14	21429933	21430101	LINE/CR1	491	-	84	21430017	92687
chr14	64194993	64394993	harbor2	chr14	64268445	64268736	LINE/CR1	684	-	146	64268591	73598
chr14	76928673	77128673	harbor2	chr14	76929803	76930357	LINE/CR1	466	-	277	76930080	1407
chr15	45378429	45578429	harbor2	chr15	45416549	45416714	LINE/CR1	499	-	82	45416631	38202
chr15	36495947	36695947	harbor2	chr15	36502856	36503149	LINE/CR1	730	-	146	36503002	7055
chr15	36491544	36691544	harbor2	chr15	36502856	36503149	LINE/CR1	730	-	146	36503002	11458
chr15	36787076	36987076	harbor2	chr15	36801504	36801722	LINE/CR1	495	-	109	36801613	14537
chr15	36787076	36987076	harbor2	chr15	36803532	36804000	LINE/CR1	697	-	234	36803766	16690
chr15	29945312	30145312	harbor2	chr15	29998284	29998565	LINE/CR1	435	-	140	29998424	53112
chr15	101876518	102076518	harbor2	chr15	101970556	101970989	LINE/CR1	993	-	216	101970772	94254
chr15	101875496	102075496	harbor2	chr15	101970556	101970989	LINE/CR1	993	-	216	101970772	95276
chr15	41872068	42072068	harbor2	chr15	41967661	41968179	LINE/CR1	811	-	259	41967920	95852
chr15	50808701	51008701	harbor2	chr15	50826526	50826682	LINE/CR1	442	-	78	50826604	17903
chr15	50808701	51008701	harbor2	chr15	50826984	50827040	LINE/CR1	442	-	28	50827012	18311
chr15	100177694	100377694	harbor2	chr15	100185441	100185964	LINE/CR1	565	-	262	100185703	8009
chr15	100177694	100377694	harbor2	chr15	100186489	100187120	LINE/CR1	902	-	316	100186805	9111
chr15	79823750	80023750	harbor2	chr15	79884793	79885152	LINE/CR1	470	-	180	79884973	61223
chr15	49055735	49255735	harbor2	chr15	49083368	49083744	LINE/CR1	504	-	188	49083556	27821
chr15	49055735	49255735	harbor2	chr15	49091427	49091635	LINE/CR1	433	-	104	49091531	35796
chr17	79533790	79733790	harbor2	chr17	79565897	79566241	LINE/CR1	742	-	172	79566069	32279
chr17	72949343	73149343	harbor2	chr17	73032520	73032744	LINE/CR1	664	-	112	73032632	83289
chr17	47938395	48138395	harbor2	chr17	48006492	48006674	LINE/CR1	1146	-	91	48006583	68188
chr17	47938395	48138395	harbor2	chr17	48006986	48007407	LINE/CR1	1146	-	210	48007196	68801
chr17	47938395	48138395	harbor2	chr17	48007695	48008068	LINE/CR1	1146	-	186	48007881	69486
chr17	32776669	32976669	harbor2	chr17	32835508	32835938	LINE/CR1	671	-	215	32835723	59054
chr17	47912946	48112946	harbor2	chr17	48006492	48006674	LINE/CR1	1146	-	91	48006583	93637
chr17	47912946	48112946	harbor2	chr17	48006986	48007407	LINE/CR1	1146	-	210	48007196	94250
chr17	47912946	48112946	harbor2	chr17	48007695	48008068	LINE/CR1	1146	-	186	48007881	94935
chr17	63512433	63712433	harbor2	chr17	63515405	63515603	LINE/CR1	607	-	99	63515504	3071
chr17	8926421	9126421	harbor2	chr17	8957232	8957626	LINE/CR1	687	-	197	8957429	31008
chr17	8926421	9126421	harbor2	chr17	9013545	9014007	LINE/CR1	895	-	231	9013776	87355
chr18	63267857	63467857	harbor2	chr18	63346855	63347028	LINE/CR1	583	-	86	63346941	79084
chr18	65651749	65851749	harbor2	chr18	65735275	65735541	LINE/CR1	554	-	133	65735408	83659
chr19	12939635	13139635	harbor2	chr19	13030387	13030763	LINE/CR1	686	-	188	13030575	90940
chr19	12938720	13138720	harbor2	chr19	13030387	13030763	LINE/CR1	686	-	188	13030575	91855
chr19	12938715	13138715	harbor2	chr19	13030387	13030763	LINE/CR1	686	-	188	13030575	91860
chr19	12939660	13139660	harbor2	chr19	13030387	13030763	LINE/CR1	686	-	188	13030575	90915
chr19	12938736	13138736	harbor2	chr19	13030387	13030763	LINE/CR1	686	-	188	13030575	91839
chr19	39309648	39509648	harbor2	chr19	39352953	39353130	LINE/CR1	653	-	88	39353041	43393
chr19	12951095	13151095	harbor2	chr19	13030387	13030763	LINE/CR1	686	-	188	13030575	79480
chr19	12938726	13138726	harbor2	chr19	13030387	13030763	LINE/CR1	686	-	188	13030575	91849
chr19	12938728	13138728	harbor2	chr19	13030387	13030763	LINE/CR1	686	-	188	13030575	91847
chr20	4624774	4824774	harbor2	chr20	4677331	4677524	LINE/CR1	535	-	96	4677427	52653
chr20	3127157	3327157	harbor2	chr20	3127932	3128226	LINE/CR1	463	-	147	3128079	922
chr20	35362392	35562392	harbor2	chr20	35391996	35392226	LINE/CR1	541	-	115	35392111	29719
chr20	35362392	35562392	harbor2	chr20	35428888	35428951	LINE/CR1	622	-	32	35428920	66528
chr20	35362392	35562392	harbor2	chr20	35429242	35429733	LINE/CR1	622	-	246	35429488	67096
chr20	35138054	35338054	harbor2	chr20	35228700	35229619	LINE/CR1	1406	-	460	35229160	91106
chr20	35138054	35338054	harbor2	chr20	35230999	35231158	LINE/CR1	457	-	80	35231079	93025
chr20	4587587	4787587	harbor2	chr20	4677331	4677524	LINE/CR1	535	-	96	4677427	89840
chr21	34275890	34475890	harbor2	chr21	34317977	34318170	LINE/CR1	483	-	96	34318073	42183
chr21	14673851	14873851	harbor2	chr21	14710271	14710521	LINE/CR1	655	-	125	14710396	36545
chr21	41945270	42145270	harbor2	chr21	41975069	41975207	LINE/CR1	457	-	69	41975138	29868
chr22	39579346	39779346	harbor2	chr22	39605230	39605467	LINE/CR1	468	-	118	39605348	26002
chr22	39579346	39779346	harbor2	chr22	39606428	39606527	LINE/CR1	484	-	50	39606478	27132
chr22	39579346	39779346	harbor2	chr22	39606832	39606979	LINE/CR1	484	-	74	39606906	27560
chr22	36465130	36665130	harbor2	chr22	36494475	36494642	LINE/CR1	473	-	84	36494559	29429
chr22	36465130	36665130	harbor2	chr22	36495259	36495388	LINE/CR1	473	-	64	36495323	30193
chr22	36407158	36607158	harbor2	chr22	36494475	36494642	LINE/CR1	473	-	84	36494559	87401
chr22	36407158	36607158	harbor2	chr22	36495259	36495388	LINE/CR1	473	-	64	36495323	88165
chr22	36407144	36607144	harbor2	chr22	36494475	36494642	LINE/CR1	473	-	84	36494559	87415
chr22	36407144	36607144	harbor2	chr22	36495259	36495388	LINE/CR1	473	-	64	36495323	88179
chr22	39579321	39779321	harbor2	chr22	39605230	39605467	LINE/CR1	468	-	118	39605348	26027
chr22	39579321	39779321	harbor2	chr22	39606428	39606527	LINE/CR1	484	-	50	39606478	27157
chr22	39579321	39779321	harbor2	chr22	39606832	39606979	LINE/CR1	484	-	74	39606906	27585
chr22	39579203	39779203	harbor2	chr22	39605230	39605467	LINE/CR1	468	-	118	39605348	26145
chr22	39579203	39779203	harbor2	chr22	39606428	39606527	LINE/CR1	484	-	50	39606478	27275
chr22	39579203	39779203	harbor2	chr22	39606832	39606979	LINE/CR1	484	-	74	39606906	27703
chr22	28342388	28542388	harbor2	chr22	28410223	28410447	LINE/CR1	454	-	112	28410335	67947
chr22	24395407	24595407	harbor2	chr22	24438026	24438208	LINE/CR1	572	-	91	24438117	42710
chr22	24395407	24595407	harbor2	chr22	24485747	24485924	LINE/CR1	580	-	88	24485835	90428
chr22	24395407	24595407	harbor2	chr22	24486227	24486374	LINE/CR1	580	-	74	24486301	90894
chr22	32100450	32300450	harbor2	chr22	32179927	32180655	LINE/CR1	955	-	364	32180291	79841
chr22	39579207	39779207	harbor2	chr22	39605230	39605467	LINE/CR1	468	-	118	39605348	26141
chr22	39579207	39779207	harbor2	chr22	39606428	39606527	LINE/CR1	484	-	50	39606478	27271
chr22	39579207	39779207	harbor2	chr22	39606832	39606979	LINE/CR1	484	-	74	39606906	27699
chrX	72046619	72246619	harbor2	chrX	72125009	72125362	LINE/CR1	743	-	176	72125185	78566
