H_chr	H_start	H_end	Harbor	TE_chr	TE_start	TE_end	TE	score	TE_strand	TE_half	TE_middle_pos	TE_dis
chr1	33553586	33753586	harbor2	chr1	33578204	33578307	LINE/L2	446	-	52	33578256	24670
chr1	33553586	33753586	harbor2	chr1	33650152	33650604	LINE/L2	552	-	226	33650378	96792
chr1	33553586	33753586	harbor2	chr1	33651039	33651934	LINE/L2	491	-	448	33651487	97901
chr1	16544783	16744783	harbor2	chr1	16608757	16608897	LINE/L2	474	-	70	16608827	64044
chr1	39476409	39676409	harbor2	chr1	39483301	39483610	LINE/L2	511	-	154	39483455	7046
chr1	39476409	39676409	harbor2	chr1	39496164	39496308	LINE/L2	612	-	72	39496236	19827
chr1	39476409	39676409	harbor2	chr1	39513320	39514368	LINE/L2	1156	-	524	39513844	37435
chr1	39476409	39676409	harbor2	chr1	39524468	39524890	LINE/L2	510	-	211	39524679	48270
chr1	39476409	39676409	harbor2	chr1	39538376	39538984	LINE/L2	1145	-	304	39538680	62271
chr1	39476409	39676409	harbor2	chr1	39540465	39540806	LINE/L2	609	-	170	39540635	64226
chr1	39476409	39676409	harbor2	chr1	39547764	39548514	LINE/L2	675	-	375	39548139	71730
chr1	63223447	63423447	harbor2	chr1	63299813	63299933	LINE/L2	596	-	60	63299873	76426
chr1	8230832	8430832	harbor2	chr1	8235189	8235388	LINE/L2	484	-	100	8235289	4457
chr1	8230832	8430832	harbor2	chr1	8257163	8257379	LINE/L2	549	-	108	8257271	26439
chr1	8230832	8430832	harbor2	chr1	8257411	8257979	LINE/L2	610	-	284	8257695	26863
chr1	150462182	150662182	harbor2	chr1	150532641	150533176	LINE/L2	714	-	268	150532909	70727
chr1	21991636	22191636	harbor2	chr1	22042786	22043228	LINE/L2	781	-	221	22043007	51371
chr1	51231071	51431071	harbor2	chr1	51235304	51235811	LINE/L2	653	-	254	51235558	4487
chr1	51231071	51431071	harbor2	chr1	51290156	51290475	LINE/L2	647	-	160	51290316	59245
chr1	51231071	51431071	harbor2	chr1	51306772	51307282	LINE/L2	700	-	255	51307027	75956
chr1	16544721	16744721	harbor2	chr1	16608757	16608897	LINE/L2	474	-	70	16608827	64106
chr1	196878094	197078094	harbor2	chr1	196942110	196942463	LINE/L2	664	-	176	196942286	64192
chr1	196878094	197078094	harbor2	chr1	196974982	196976153	LINE/L2	1706	-	586	196975568	97474
chr1	196878094	197078094	harbor2	chr1	196935123	196935933	LINE/L2	989	-	405	196935528	57434
chr1	16545193	16745193	harbor2	chr1	16608757	16608897	LINE/L2	474	-	70	16608827	63634
chr1	16544779	16744779	harbor2	chr1	16608757	16608897	LINE/L2	474	-	70	16608827	64048
chr1	44562804	44762804	harbor2	chr1	44599852	44600334	LINE/L2	546	-	241	44600093	37289
chr1	44562804	44762804	harbor2	chr1	44601187	44601916	LINE/L2	445	-	364	44601551	38747
chr1	44562804	44762804	harbor2	chr1	44605453	44605773	LINE/L2	670	-	160	44605613	42809
chr1	44562804	44762804	harbor2	chr1	44623646	44623953	LINE/L2	474	-	154	44623800	60996
chr1	16597141	16797141	harbor2	chr1	16608757	16608897	LINE/L2	474	-	70	16608827	11686
chr1	89907751	90107751	harbor2	chr1	89929043	89929419	LINE/L2	669	-	188	89929231	21480
chr1	89907751	90107751	harbor2	chr1	89999800	89999957	LINE/L2	629	-	78	89999878	92127
chr1	89907751	90107751	harbor2	chr1	90000001	90000180	LINE/L2	444	-	90	90000091	92340
chr1	89907751	90107751	harbor2	chr1	90000826	90001030	LINE/L2	1310	-	102	90000928	93177
chr1	89907751	90107751	harbor2	chr1	90001243	90001499	LINE/L2	1310	-	128	90001371	93620
chr1	193014143	193214143	harbor2	chr1	193031665	193031774	LINE/L2	496	-	54	193031719	17576
chr1	16544785	16744785	harbor2	chr1	16608757	16608897	LINE/L2	474	-	70	16608827	64042
chr1	230009530	230209530	harbor2	chr1	230075558	230075876	LINE/L2	742	-	159	230075717	66187
chr1	16603811	16803811	harbor2	chr1	16608757	16608897	LINE/L2	474	-	70	16608827	5016
chr1	16545192	16745192	harbor2	chr1	16608757	16608897	LINE/L2	474	-	70	16608827	63635
chr1	227442365	227642365	harbor2	chr1	227454367	227454984	LINE/L2	615	-	308	227454675	12310
chr1	227442365	227642365	harbor2	chr1	227459277	227459303	LINE/L2	497	-	13	227459290	16925
chr1	227442365	227642365	harbor2	chr1	227459614	227459828	LINE/L2	497	-	107	227459721	17356
chr1	227442365	227642365	harbor2	chr1	227460123	227460443	LINE/L2	1228	-	160	227460283	17918
chr1	227442365	227642365	harbor2	chr1	227460744	227460765	LINE/L2	1228	-	10	227460754	18389
chr1	227442365	227642365	harbor2	chr1	227461053	227461521	LINE/L2	1228	-	234	227461287	18922
chr1	227442365	227642365	harbor2	chr1	227472960	227473580	LINE/L2	629	-	310	227473270	30905
chr1	16544750	16744750	harbor2	chr1	16608757	16608897	LINE/L2	474	-	70	16608827	64077
chr1	145350740	145550740	harbor2	chr1	145420734	145420874	LINE/L2	458	-	70	145420804	70064
chr1	77659514	77859514	harbor2	chr1	77666626	77667000	LINE/L2	441	-	187	77666813	7299
chr1	77659514	77859514	harbor2	chr1	77686624	77686781	LINE/L2	504	-	78	77686702	27188
chr1	77659514	77859514	harbor2	chr1	77689059	77689494	LINE/L2	638	-	218	77689277	29763
chr1	16544770	16744770	harbor2	chr1	16608757	16608897	LINE/L2	474	-	70	16608827	64057
chr1	7671936	7871936	harbor2	chr1	7674840	7675502	LINE/L2	612	-	331	7675171	3235
chr1	7671936	7871936	harbor2	chr1	7686118	7687349	LINE/L2	1266	-	616	7686734	14798
chr1	7671936	7871936	harbor2	chr1	7690931	7691530	LINE/L2	532	-	300	7691231	19295
chr1	6689234	6889234	harbor2	chr1	6707661	6708464	LINE/L2	1192	-	402	6708063	18829
chr1	17341836	17541836	harbor2	chr1	17350710	17350905	LINE/L2	1197	-	98	17350808	8972
chr1	17341836	17541836	harbor2	chr1	17351223	17351309	LINE/L2	1197	-	43	17351266	9430
chr1	17341836	17541836	harbor2	chr1	17351635	17351888	LINE/L2	1197	-	126	17351761	9925
chr1	17341836	17541836	harbor2	chr1	17352256	17352897	LINE/L2	603	-	320	17352576	10740
chr1	17341836	17541836	harbor2	chr1	17354896	17355269	LINE/L2	690	-	186	17355082	13246
chr1	17341836	17541836	harbor2	chr1	17356534	17356911	LINE/L2	562	-	188	17356722	14886
chr1	17341836	17541836	harbor2	chr1	17385198	17385898	LINE/L2	478	-	350	17385548	43712
chr1	17341836	17541836	harbor2	chr1	17440310	17440738	LINE/L2	584	-	214	17440524	98688
chr1	16544787	16744787	harbor2	chr1	16608757	16608897	LINE/L2	474	-	70	16608827	64040
chr1	16545135	16745135	harbor2	chr1	16608757	16608897	LINE/L2	474	-	70	16608827	63692
chr1	16545197	16745197	harbor2	chr1	16608757	16608897	LINE/L2	474	-	70	16608827	63630
chr1	53847484	54047484	harbor2	chr1	53887380	53887648	LINE/L2	1149	-	134	53887514	40030
chr1	53847484	54047484	harbor2	chr1	53915145	53915326	LINE/L2	597	-	90	53915235	67751
chr1	53847484	54047484	harbor2	chr1	53915575	53915782	LINE/L2	529	-	104	53915679	68195
chr1	53847484	54047484	harbor2	chr1	53886797	53887072	LINE/L2	1149	-	138	53886935	39451
chr1	26401378	26601378	harbor2	chr1	26462757	26463276	LINE/L2	626	-	260	26463017	61639
chr1	26401378	26601378	harbor2	chr1	26489127	26489223	LINE/L2	482	-	48	26489175	87797
chr1	26401378	26601378	harbor2	chr1	26492164	26492345	LINE/L2	606	-	90	26492254	90876
chr1	26401378	26601378	harbor2	chr1	26492645	26492820	LINE/L2	537	-	88	26492733	91355
chr1	16544771	16744771	harbor2	chr1	16608757	16608897	LINE/L2	474	-	70	16608827	64056
chr1	6685470	6885470	harbor2	chr1	6707661	6708464	LINE/L2	1192	-	402	6708063	22593
chr1	240671354	240871354	harbor2	chr1	240700385	240700527	LINE/L2	503	-	71	240700456	29102
chr1	240671354	240871354	harbor2	chr1	240700795	240700982	LINE/L2	503	-	94	240700889	29535
chr1	240671354	240871354	harbor2	chr1	240701146	240701206	LINE/L2	603	-	30	240701176	29822
chr1	240671354	240871354	harbor2	chr1	240701504	240701975	LINE/L2	603	-	236	240701740	30386
chr1	240671354	240871354	harbor2	chr1	240702184	240702524	LINE/L2	1271	-	170	240702354	31000
chr1	240671354	240871354	harbor2	chr1	240702833	240703149	LINE/L2	1271	-	158	240702991	31637
chr1	240671354	240871354	harbor2	chr1	240724722	240724843	LINE/L2	682	-	60	240724782	53428
chr1	240671354	240871354	harbor2	chr1	240725145	240725423	LINE/L2	682	-	139	240725284	53930
chr1	240671354	240871354	harbor2	chr1	240726498	240726950	LINE/L2	957	-	226	240726724	55370
chr1	240671354	240871354	harbor2	chr1	240727491	240727621	LINE/L2	957	-	65	240727556	56202
chr1	156560138	156760138	harbor2	chr1	156575431	156575943	LINE/L2	453	-	256	156575687	15549
chr1	156560138	156760138	harbor2	chr1	156596834	156597499	LINE/L2	492	-	332	156597166	37028
chr1	156560138	156760138	harbor2	chr1	156603727	156603962	LINE/L2	490	-	118	156603845	43707
chr1	227442270	227642270	harbor2	chr1	227454367	227454984	LINE/L2	615	-	308	227454675	12405
chr1	227442270	227642270	harbor2	chr1	227459277	227459303	LINE/L2	497	-	13	227459290	17020
chr1	227442270	227642270	harbor2	chr1	227459614	227459828	LINE/L2	497	-	107	227459721	17451
chr1	227442270	227642270	harbor2	chr1	227460123	227460443	LINE/L2	1228	-	160	227460283	18013
chr1	227442270	227642270	harbor2	chr1	227460744	227460765	LINE/L2	1228	-	10	227460754	18484
chr1	227442270	227642270	harbor2	chr1	227461053	227461521	LINE/L2	1228	-	234	227461287	19017
chr1	227442270	227642270	harbor2	chr1	227472960	227473580	LINE/L2	629	-	310	227473270	31000
chr1	156560141	156760141	harbor2	chr1	156575431	156575943	LINE/L2	453	-	256	156575687	15546
chr1	156560141	156760141	harbor2	chr1	156596834	156597499	LINE/L2	492	-	332	156597166	37025
chr1	156560141	156760141	harbor2	chr1	156603727	156603962	LINE/L2	490	-	118	156603845	43704
chr1	6685464	6885464	harbor2	chr1	6707661	6708464	LINE/L2	1192	-	402	6708063	22599
chr1	53374991	53574991	harbor2	chr1	53375221	53375980	LINE/L2	706	-	380	53375601	610
chr1	53374991	53574991	harbor2	chr1	53406749	53407146	LINE/L2	522	-	198	53406947	31956
chr1	53374991	53574991	harbor2	chr1	53440355	53440503	LINE/L2	501	-	74	53440429	65438
chr1	53374991	53574991	harbor2	chr1	53440718	53440903	LINE/L2	501	-	92	53440810	65819
chr1	16545159	16745159	harbor2	chr1	16608757	16608897	LINE/L2	474	-	70	16608827	63668
chr1	225783160	225983160	harbor2	chr1	225811865	225812118	LINE/L2	627	-	126	225811991	28831
chr1	225783160	225983160	harbor2	chr1	225818247	225818555	LINE/L2	567	-	154	225818401	35241
chr1	225783160	225983160	harbor2	chr1	225818702	225818819	LINE/L2	558	-	58	225818760	35600
chr1	225783160	225983160	harbor2	chr1	225819414	225819734	LINE/L2	558	-	160	225819574	36414
chr1	225783160	225983160	harbor2	chr1	225834838	225835148	LINE/L2	684	-	155	225834993	51833
chr1	225783160	225983160	harbor2	chr1	225853901	225854325	LINE/L2	803	-	212	225854113	70953
chr1	225783160	225983160	harbor2	chr1	225854346	225855031	LINE/L2	1382	-	342	225854688	71528
chr1	23859371	24059371	harbor2	chr1	23927006	23927127	LINE/L2	598	-	60	23927066	67695
chr1	53944027	54144027	harbor2	chr1	53949943	53950379	LINE/L2	704	-	218	53950161	6134
chr1	53944027	54144027	harbor2	chr1	53972744	53973148	LINE/L2	604	-	202	53972946	28919
chr1	53944027	54144027	harbor2	chr1	53978480	53978906	LINE/L2	450	-	213	53978693	34666
chr1	53944027	54144027	harbor2	chr1	54011635	54012015	LINE/L2	795	-	190	54011825	67798
chr1	211034336	211234336	harbor2	chr1	211050888	211050987	LINE/L2	676	-	50	211050938	16602
chr1	211034336	211234336	harbor2	chr1	211051297	211051777	LINE/L2	676	-	240	211051537	17201
chr1	211034336	211234336	harbor2	chr1	211084831	211085322	LINE/L2	978	-	246	211085077	50741
chr1	211034336	211234336	harbor2	chr1	211103756	211104312	LINE/L2	545	-	278	211104034	69698
chr1	201845418	202045418	harbor2	chr1	201920920	201921207	LINE/L2	489	-	144	201921064	75646
chr1	201845418	202045418	harbor2	chr1	201921515	201921642	LINE/L2	489	-	64	201921579	76161
chr1	201845418	202045418	harbor2	chr1	201929718	201931252	LINE/L2	825	-	767	201930485	85067
chr1	201845418	202045418	harbor2	chr1	201931565	201931755	LINE/L2	784	-	95	201931660	86242
chr1	201845418	202045418	harbor2	chr1	201931914	201932145	LINE/L2	784	-	116	201932030	86612
chr1	201845418	202045418	harbor2	chr1	201935073	201935229	LINE/L2	505	-	78	201935151	89733
chr1	201845418	202045418	harbor2	chr1	201942183	201942461	LINE/L2	492	-	139	201942322	96904
chr1	226638243	226838243	harbor2	chr1	226671450	226672119	LINE/L2	1165	-	334	226671784	33541
chr1	6685487	6885487	harbor2	chr1	6707661	6708464	LINE/L2	1192	-	402	6708063	22576
chr1	16544788	16744788	harbor2	chr1	16608757	16608897	LINE/L2	474	-	70	16608827	64039
chr1	46124232	46324232	harbor2	chr1	46137198	46137459	LINE/L2	507	-	130	46137328	13096
chr1	155589258	155789258	harbor2	chr1	155680874	155681019	LINE/L2	457	-	72	155680946	91688
chr1	54391077	54591077	harbor2	chr1	54415452	54415684	LINE/L2	466	-	116	54415568	24491
chr1	54391077	54591077	harbor2	chr1	54441168	54441194	LINE/L2	447	-	13	54441181	50104
chr1	54391077	54591077	harbor2	chr1	54441486	54441783	LINE/L2	447	-	148	54441634	50557
chr1	54391077	54591077	harbor2	chr1	54480014	54480134	LINE/L2	527	-	60	54480074	88997
chr1	6685468	6885468	harbor2	chr1	6707661	6708464	LINE/L2	1192	-	402	6708063	22595
chr1	6871137	7071137	harbor2	chr1	6881995	6882033	LINE/L2	1429	-	19	6882014	10877
chr1	6871137	7071137	harbor2	chr1	6882355	6882959	LINE/L2	1429	-	302	6882657	11520
chr1	6871137	7071137	harbor2	chr1	6883192	6883387	LINE/L2	1429	-	98	6883290	12153
chr1	6871137	7071137	harbor2	chr1	6883451	6883766	LINE/L2	653	-	158	6883609	12472
chr1	6871137	7071137	harbor2	chr1	6884054	6884156	LINE/L2	653	-	51	6884105	12968
chr1	6871137	7071137	harbor2	chr1	6916778	6917195	LINE/L2	584	-	208	6916986	45849
chr1	6871137	7071137	harbor2	chr1	6924113	6924358	LINE/L2	513	-	122	6924235	53098
chr1	6871137	7071137	harbor2	chr1	6968468	6968944	LINE/L2	462	-	238	6968706	97569
chr1	6871137	7071137	harbor2	chr1	6881184	6881685	LINE/L2	1429	-	250	6881434	10297
chr1	65260750	65460750	harbor2	chr1	65296886	65297372	LINE/L2	632	-	243	65297129	36379
chr1	65260750	65460750	harbor2	chr1	65320594	65321053	LINE/L2	730	-	230	65320824	60074
chr1	65260750	65460750	harbor2	chr1	65335417	65336000	LINE/L2	1439	-	292	65335709	74959
chr1	160440370	160640370	harbor2	chr1	160472243	160473945	LINE/L2	5302	-	851	160473094	32724
chr1	160440370	160640370	harbor2	chr1	160473991	160474558	LINE/L2	5302	-	284	160474275	33905
chr1	160440370	160640370	harbor2	chr1	160483115	160483181	LINE/L2	895	-	33	160483148	42778
chr1	160440370	160640370	harbor2	chr1	160483474	160483834	LINE/L2	895	-	180	160483654	43284
chr1	160440370	160640370	harbor2	chr1	160484828	160485044	LINE/L2	646	-	108	160484936	44566
chr1	160440370	160640370	harbor2	chr1	160485352	160485926	LINE/L2	799	-	287	160485639	45269
chr1	160440370	160640370	harbor2	chr1	160539722	160540045	LINE/L2	449	-	162	160539884	99514
chr1	168036739	168236739	harbor2	chr1	168039892	168040547	LINE/L2	1373	-	328	168040220	3481
chr1	168036739	168236739	harbor2	chr1	168074474	168074805	LINE/L2	519	-	166	168074640	37901
chr1	168036739	168236739	harbor2	chr1	168128937	168129622	LINE/L2	823	-	342	168129279	92540
chr1	16544790	16744790	harbor2	chr1	16608757	16608897	LINE/L2	474	-	70	16608827	64037
chr1	16545176	16745176	harbor2	chr1	16608757	16608897	LINE/L2	474	-	70	16608827	63651
chr1	16545073	16745073	harbor2	chr1	16608757	16608897	LINE/L2	474	-	70	16608827	63754
chr1	53939662	54139662	harbor2	chr1	53949943	53950379	LINE/L2	704	-	218	53950161	10499
chr1	53939662	54139662	harbor2	chr1	53972744	53973148	LINE/L2	604	-	202	53972946	33284
chr1	53939662	54139662	harbor2	chr1	53978480	53978906	LINE/L2	450	-	213	53978693	39031
chr1	53939662	54139662	harbor2	chr1	54011635	54012015	LINE/L2	795	-	190	54011825	72163
chr1	226011849	226211849	harbor2	chr1	226058560	226059064	LINE/L2	452	-	252	226058812	46963
chr1	226011849	226211849	harbor2	chr1	226076862	226076999	LINE/L2	1278	-	68	226076930	65081
chr1	226011849	226211849	harbor2	chr1	226078284	226079226	LINE/L2	3487	-	471	226078755	66906
chr1	226011849	226211849	harbor2	chr1	226079536	226079858	LINE/L2	3487	-	161	226079697	67848
chr1	205330793	205530793	harbor2	chr1	205428402	205428657	LINE/L2	584	-	128	205428530	97737
chr1	16545165	16745165	harbor2	chr1	16608757	16608897	LINE/L2	474	-	70	16608827	63662
chr1	16546378	16746378	harbor2	chr1	16608757	16608897	LINE/L2	474	-	70	16608827	62449
chr1	16544815	16744815	harbor2	chr1	16608757	16608897	LINE/L2	474	-	70	16608827	64012
chr1	33270603	33470603	harbor2	chr1	33270478	33270620	LINE/L2	517	-	71	33270549	54
chr1	33270603	33470603	harbor2	chr1	33277402	33277847	LINE/L2	615	-	222	33277624	7021
chr1	33270603	33470603	harbor2	chr1	33282362	33282491	LINE/L2	645	-	64	33282426	11823
chr1	33270603	33470603	harbor2	chr1	33289698	33290084	LINE/L2	589	-	193	33289891	19288
chr1	33270603	33470603	harbor2	chr1	33315799	33316427	LINE/L2	527	-	314	33316113	45510
chr1	33270603	33470603	harbor2	chr1	33359517	33359909	LINE/L2	662	-	196	33359713	89110
chr1	211033758	211233758	harbor2	chr1	211050888	211050987	LINE/L2	676	-	50	211050938	17180
chr1	211033758	211233758	harbor2	chr1	211051297	211051777	LINE/L2	676	-	240	211051537	17779
chr1	211033758	211233758	harbor2	chr1	211084831	211085322	LINE/L2	978	-	246	211085077	51319
chr1	211033758	211233758	harbor2	chr1	211103756	211104312	LINE/L2	545	-	278	211104034	70276
chr1	227442279	227642279	harbor2	chr1	227454367	227454984	LINE/L2	615	-	308	227454675	12396
chr1	227442279	227642279	harbor2	chr1	227459277	227459303	LINE/L2	497	-	13	227459290	17011
chr1	227442279	227642279	harbor2	chr1	227459614	227459828	LINE/L2	497	-	107	227459721	17442
chr1	227442279	227642279	harbor2	chr1	227460123	227460443	LINE/L2	1228	-	160	227460283	18004
chr1	227442279	227642279	harbor2	chr1	227460744	227460765	LINE/L2	1228	-	10	227460754	18475
chr1	227442279	227642279	harbor2	chr1	227461053	227461521	LINE/L2	1228	-	234	227461287	19008
chr1	227442279	227642279	harbor2	chr1	227472960	227473580	LINE/L2	629	-	310	227473270	30991
chr1	16546331	16746331	harbor2	chr1	16608757	16608897	LINE/L2	474	-	70	16608827	62496
chr1	154985521	155185521	harbor2	chr1	154995931	154996118	LINE/L2	558	-	94	154996025	10504
chr1	154985521	155185521	harbor2	chr1	154996112	154996409	LINE/L2	855	-	148	154996260	10739
chr1	154985521	155185521	harbor2	chr1	155038093	155038557	LINE/L2	1248	-	232	155038325	52804
chr1	154985521	155185521	harbor2	chr1	155065081	155065204	LINE/L2	536	-	62	155065143	79622
chr1	154985521	155185521	harbor2	chr1	155072951	155073237	LINE/L2	484	-	143	155073094	87573
chr1	19188141	19388141	harbor2	chr1	19253140	19253658	LINE/L2	710	-	259	19253399	65258
chr1	10693996	10893996	harbor2	chr1	10737961	10738296	LINE/L2	485	-	168	10738129	44133
chr1	16544753	16744753	harbor2	chr1	16608757	16608897	LINE/L2	474	-	70	16608827	64074
chr1	16544725	16744725	harbor2	chr1	16608757	16608897	LINE/L2	474	-	70	16608827	64102
chr1	16821931	17021931	harbor2	chr1	16915726	16915897	LINE/L2	725	-	86	16915812	93881
chr1	16821931	17021931	harbor2	chr1	16916193	16916425	LINE/L2	725	-	116	16916309	94378
chr1	145858041	146058041	harbor2	chr1	145946599	145946825	LINE/L2	493	-	113	145946712	88671
chr1	145858041	146058041	harbor2	chr1	145949173	145949661	LINE/L2	593	-	244	145949417	91376
chr1	202857893	203057893	harbor2	chr1	202913436	202913802	LINE/L2	580	-	183	202913619	55726
chr1	202857893	203057893	harbor2	chr1	202913997	202914337	LINE/L2	580	-	170	202914167	56274
chr1	53371603	53571603	harbor2	chr1	53375221	53375980	LINE/L2	706	-	380	53375601	3998
chr1	53371603	53571603	harbor2	chr1	53406749	53407146	LINE/L2	522	-	198	53406947	35344
chr1	53371603	53571603	harbor2	chr1	53440355	53440503	LINE/L2	501	-	74	53440429	68826
chr1	53371603	53571603	harbor2	chr1	53440718	53440903	LINE/L2	501	-	92	53440810	69207
chr1	204585865	204785865	harbor2	chr1	204592902	204593026	LINE/L2	507	-	62	204592964	7099
chr1	204585865	204785865	harbor2	chr1	204650699	204650878	LINE/L2	472	-	90	204650789	64924
chr1	204585865	204785865	harbor2	chr1	204667511	204667907	LINE/L2	575	-	198	204667709	81844
chr1	204585865	204785865	harbor2	chr1	204669366	204669942	LINE/L2	665	-	288	204669654	83789
chr1	204585865	204785865	harbor2	chr1	204670076	204671395	LINE/L2	1811	-	660	204670736	84871
chr1	204585865	204785865	harbor2	chr1	204671439	204671647	LINE/L2	1811	-	104	204671543	85678
chr1	204585865	204785865	harbor2	chr1	204602870	204603524	LINE/L2	1089	-	327	204603197	17332
chr1	16544708	16744708	harbor2	chr1	16608757	16608897	LINE/L2	474	-	70	16608827	64119
chr1	205492013	205692013	harbor2	chr1	205498596	205499017	LINE/L2	564	-	210	205498806	6793
chr1	205492013	205692013	harbor2	chr1	205513999	205514272	LINE/L2	437	-	136	205514135	22122
chr1	205492013	205692013	harbor2	chr1	205535313	205535590	LINE/L2	723	-	138	205535451	43438
chr1	205492013	205692013	harbor2	chr1	205535891	205536028	LINE/L2	723	-	68	205535959	43946
chr1	205492013	205692013	harbor2	chr1	205574485	205574784	LINE/L2	448	-	150	205574635	82622
chr1	205492013	205692013	harbor2	chr1	205589763	205590304	LINE/L2	638	-	270	205590033	98020
chr1	17636788	17836788	harbor2	chr1	17647542	17647837	LINE/L2	531	-	148	17647690	10902
chr1	17636788	17836788	harbor2	chr1	17649542	17650127	LINE/L2	596	-	292	17649834	13046
chr1	17636788	17836788	harbor2	chr1	17658604	17659005	LINE/L2	753	-	200	17658804	22016
chr1	17636788	17836788	harbor2	chr1	17700207	17700564	LINE/L2	776	-	178	17700385	63597
chr1	17636788	17836788	harbor2	chr1	17700592	17701435	LINE/L2	1532	-	422	17701014	64226
chr1	154985525	155185525	harbor2	chr1	154995931	154996118	LINE/L2	558	-	94	154996025	10500
chr1	154985525	155185525	harbor2	chr1	154996112	154996409	LINE/L2	855	-	148	154996260	10735
chr1	154985525	155185525	harbor2	chr1	155038093	155038557	LINE/L2	1248	-	232	155038325	52800
chr1	154985525	155185525	harbor2	chr1	155065081	155065204	LINE/L2	536	-	62	155065143	79618
chr1	154985525	155185525	harbor2	chr1	155072951	155073237	LINE/L2	484	-	143	155073094	87569
chr1	216443727	216643727	harbor2	chr1	216477334	216477546	LINE/L2	578	-	106	216477440	33713
chr1	216443727	216643727	harbor2	chr1	216536847	216537061	LINE/L2	598	-	107	216536954	93227
chr1	216443727	216643727	harbor2	chr1	216537430	216537690	LINE/L2	659	-	130	216537560	93833
chr1	211400835	211600835	harbor2	chr1	211428047	211428427	LINE/L2	513	-	190	211428237	27402
chr1	211033756	211233756	harbor2	chr1	211050888	211050987	LINE/L2	676	-	50	211050938	17182
chr1	211033756	211233756	harbor2	chr1	211051297	211051777	LINE/L2	676	-	240	211051537	17781
chr1	211033756	211233756	harbor2	chr1	211084831	211085322	LINE/L2	978	-	246	211085077	51321
chr1	211033756	211233756	harbor2	chr1	211103756	211104312	LINE/L2	545	-	278	211104034	70278
chr1	16544789	16744789	harbor2	chr1	16608757	16608897	LINE/L2	474	-	70	16608827	64038
chr1	53371621	53571621	harbor2	chr1	53375221	53375980	LINE/L2	706	-	380	53375601	3980
chr1	53371621	53571621	harbor2	chr1	53406749	53407146	LINE/L2	522	-	198	53406947	35326
chr1	53371621	53571621	harbor2	chr1	53440355	53440503	LINE/L2	501	-	74	53440429	68808
chr1	53371621	53571621	harbor2	chr1	53440718	53440903	LINE/L2	501	-	92	53440810	69189
chr1	16544734	16744734	harbor2	chr1	16608757	16608897	LINE/L2	474	-	70	16608827	64093
chr1	18514441	18714441	harbor2	chr1	18556469	18556624	LINE/L2	892	-	78	18556547	42106
chr1	18514441	18714441	harbor2	chr1	18557108	18557195	LINE/L2	892	-	44	18557152	42711
chr1	18514441	18714441	harbor2	chr1	18557490	18557679	LINE/L2	892	-	94	18557584	43143
chr1	18514441	18714441	harbor2	chr1	18559101	18559377	LINE/L2	959	-	138	18559239	44798
chr1	18514441	18714441	harbor2	chr1	18559604	18559742	LINE/L2	959	-	69	18559673	45232
chr1	18514441	18714441	harbor2	chr1	18569995	18570229	LINE/L2	481	-	117	18570112	55671
chr1	18514441	18714441	harbor2	chr1	18577983	18578513	LINE/L2	1155	-	265	18578248	63807
chr1	18514441	18714441	harbor2	chr1	18579095	18579266	LINE/L2	646	-	86	18579181	64740
chr1	18514441	18714441	harbor2	chr1	18579640	18579674	LINE/L2	646	-	17	18579657	65216
chr1	18514441	18714441	harbor2	chr1	18582365	18582691	LINE/L2	631	-	163	18582528	68087
chr1	18514441	18714441	harbor2	chr1	18597101	18597238	LINE/L2	554	-	68	18597169	82728
chr1	53227374	53427374	harbor2	chr1	53232282	53232822	LINE/L2	662	-	270	53232552	5178
chr1	53227374	53427374	harbor2	chr1	53233122	53233195	LINE/L2	472	-	36	53233158	5784
chr1	53227374	53427374	harbor2	chr1	53240960	53241495	LINE/L2	506	-	268	53241228	13854
chr1	53227374	53427374	harbor2	chr1	53241955	53242183	LINE/L2	583	-	114	53242069	14695
chr1	53227374	53427374	harbor2	chr1	53249858	53250089	LINE/L2	525	-	116	53249974	22600
chr1	16545038	16745038	harbor2	chr1	16608757	16608897	LINE/L2	474	-	70	16608827	63789
chr1	36756807	36956807	harbor2	chr1	36763889	36764430	LINE/L2	1039	-	270	36764159	7352
chr1	36756807	36956807	harbor2	chr1	36802919	36803386	LINE/L2	1035	-	234	36803153	46346
chr1	36756807	36956807	harbor2	chr1	36804628	36804874	LINE/L2	622	-	123	36804751	47944
chr1	36756807	36956807	harbor2	chr1	36765384	36765710	LINE/L2	544	-	163	36765547	8740
chr1	94138719	94338719	harbor2	chr1	94190732	94191298	LINE/L2	474	-	283	94191015	52296
chr1	145758969	145958969	harbor2	chr1	145827250	145827369	LINE/L2	502	-	60	145827310	68341
chr1	145758969	145958969	harbor2	chr1	145827951	145828195	LINE/L2	502	-	122	145828073	69104
chr1	145758969	145958969	harbor2	chr1	145830305	145830517	LINE/L2	1136	-	106	145830411	71442
chr1	145758969	145958969	harbor2	chr1	145830815	145830826	LINE/L2	1136	-	6	145830821	71852
chr1	145758969	145958969	harbor2	chr1	145831114	145831236	LINE/L2	1136	-	61	145831175	72206
chr1	145758969	145958969	harbor2	chr1	145831532	145831759	LINE/L2	1136	-	114	145831646	72677
chr1	145758969	145958969	harbor2	chr1	145832055	145832741	LINE/L2	1136	-	343	145832398	73429
chr1	145758969	145958969	harbor2	chr1	145833040	145833152	LINE/L2	834	-	56	145833096	74127
chr1	211034401	211234401	harbor2	chr1	211050888	211050987	LINE/L2	676	-	50	211050938	16537
chr1	211034401	211234401	harbor2	chr1	211051297	211051777	LINE/L2	676	-	240	211051537	17136
chr1	211034401	211234401	harbor2	chr1	211084831	211085322	LINE/L2	978	-	246	211085077	50676
chr1	211034401	211234401	harbor2	chr1	211103756	211104312	LINE/L2	545	-	278	211104034	69633
chr1	185217222	185417222	harbor2	chr1	185228667	185229305	LINE/L2	1467	-	319	185228986	11764
chr1	185217222	185417222	harbor2	chr1	185260383	185260663	LINE/L2	462	-	140	185260523	43301
chr1	9226709	9426709	harbor2	chr1	9237841	9238779	LINE/L2	1539	-	469	9238310	11601
chr1	9226709	9426709	harbor2	chr1	9325568	9325992	LINE/L2	885	-	212	9325780	99071
chr1	157038937	157238937	harbor2	chr1	157082327	157082990	LINE/L2	1047	-	332	157082659	43722
chr1	157038937	157238937	harbor2	chr1	157119101	157119399	LINE/L2	578	-	149	157119250	80313
chr1	43458974	43658974	harbor2	chr1	43494933	43495429	LINE/L2	1060	-	248	43495181	36207
chr1	43458974	43658974	harbor2	chr1	43500311	43500435	LINE/L2	628	-	62	43500373	41399
chr1	43458974	43658974	harbor2	chr1	43521441	43521734	LINE/L2	682	-	146	43521587	62613
chr1	43458974	43658974	harbor2	chr1	43522548	43523633	LINE/L2	1267	-	542	43523090	64116
chr1	43458974	43658974	harbor2	chr1	43524528	43525317	LINE/L2	454	-	394	43524922	65948
chr1	43458974	43658974	harbor2	chr1	43527941	43528112	LINE/L2	530	-	86	43528027	69053
chr1	43458974	43658974	harbor2	chr1	43537443	43537857	LINE/L2	651	-	207	43537650	78676
chr1	16544754	16744754	harbor2	chr1	16608757	16608897	LINE/L2	474	-	70	16608827	64073
chr1	53371668	53571668	harbor2	chr1	53375221	53375980	LINE/L2	706	-	380	53375601	3933
chr1	53371668	53571668	harbor2	chr1	53406749	53407146	LINE/L2	522	-	198	53406947	35279
chr1	53371668	53571668	harbor2	chr1	53440355	53440503	LINE/L2	501	-	74	53440429	68761
chr1	53371668	53571668	harbor2	chr1	53440718	53440903	LINE/L2	501	-	92	53440810	69142
chr1	154985519	155185519	harbor2	chr1	154995931	154996118	LINE/L2	558	-	94	154996025	10506
chr1	154985519	155185519	harbor2	chr1	154996112	154996409	LINE/L2	855	-	148	154996260	10741
chr1	154985519	155185519	harbor2	chr1	155038093	155038557	LINE/L2	1248	-	232	155038325	52806
chr1	154985519	155185519	harbor2	chr1	155065081	155065204	LINE/L2	536	-	62	155065143	79624
chr1	154985519	155185519	harbor2	chr1	155072951	155073237	LINE/L2	484	-	143	155073094	87575
chr1	92386040	92586040	harbor2	chr1	92408815	92409309	LINE/L2	852	-	247	92409062	23022
chr1	92386040	92586040	harbor2	chr1	92421633	92421770	LINE/L2	472	-	68	92421701	35661
chr1	92386040	92586040	harbor2	chr1	92422076	92422242	LINE/L2	472	-	83	92422159	36119
chr1	6351783	6551783	harbor2	chr1	6431814	6431922	LINE/L2	506	-	54	6431868	80085
chr1	204636318	204836318	harbor2	chr1	204650699	204650878	LINE/L2	472	-	90	204650789	14471
chr1	204636318	204836318	harbor2	chr1	204667511	204667907	LINE/L2	575	-	198	204667709	31391
chr1	204636318	204836318	harbor2	chr1	204669366	204669942	LINE/L2	665	-	288	204669654	33336
chr1	204636318	204836318	harbor2	chr1	204670076	204671395	LINE/L2	1811	-	660	204670736	34418
chr1	204636318	204836318	harbor2	chr1	204671439	204671647	LINE/L2	1811	-	104	204671543	35225
chr1	204636318	204836318	harbor2	chr1	204716653	204717124	LINE/L2	1177	-	236	204716889	80571
chr1	204636318	204836318	harbor2	chr1	204734042	204734484	LINE/L2	974	-	221	204734263	97945
chr1	47352962	47552962	harbor2	chr1	47450922	47451087	LINE/L2	495	-	82	47451004	98042
chr1	15277447	15477447	harbor2	chr1	15303047	15303203	LINE/L2	503	-	78	15303125	25678
chr1	15277447	15477447	harbor2	chr1	15309310	15309560	LINE/L2	652	-	125	15309435	31988
chr1	15277447	15477447	harbor2	chr1	15309792	15310075	LINE/L2	652	-	142	15309934	32487
chr1	15277447	15477447	harbor2	chr1	15360175	15360392	LINE/L2	552	-	108	15360283	82836
chr1	15277447	15477447	harbor2	chr1	15371926	15372258	LINE/L2	562	-	166	15372092	94645
chr1	116384166	116584166	harbor2	chr1	116469702	116469924	LINE/L2	509	-	111	116469813	85647
chr1	116384166	116584166	harbor2	chr1	116473280	116473412	LINE/L2	523	-	66	116473346	89180
chr1	92387184	92587184	harbor2	chr1	92408815	92409309	LINE/L2	852	-	247	92409062	21878
chr1	92387184	92587184	harbor2	chr1	92421633	92421770	LINE/L2	472	-	68	92421701	34517
chr1	92387184	92587184	harbor2	chr1	92422076	92422242	LINE/L2	472	-	83	92422159	34975
chr1	153261923	153461923	harbor2	chr1	153286718	153287508	LINE/L2	1839	-	395	153287113	25190
chr1	153261923	153461923	harbor2	chr1	153289036	153289386	LINE/L2	513	-	175	153289211	27288
chr1	153261923	153461923	harbor2	chr1	153358614	153358918	LINE/L2	474	-	152	153358766	96843
chr1	211033759	211233759	harbor2	chr1	211050888	211050987	LINE/L2	676	-	50	211050938	17179
chr1	211033759	211233759	harbor2	chr1	211051297	211051777	LINE/L2	676	-	240	211051537	17778
chr1	211033759	211233759	harbor2	chr1	211084831	211085322	LINE/L2	978	-	246	211085077	51318
chr1	211033759	211233759	harbor2	chr1	211103756	211104312	LINE/L2	545	-	278	211104034	70275
chr1	211034198	211234198	harbor2	chr1	211050888	211050987	LINE/L2	676	-	50	211050938	16740
chr1	211034198	211234198	harbor2	chr1	211051297	211051777	LINE/L2	676	-	240	211051537	17339
chr1	211034198	211234198	harbor2	chr1	211084831	211085322	LINE/L2	978	-	246	211085077	50879
chr1	211034198	211234198	harbor2	chr1	211103756	211104312	LINE/L2	545	-	278	211104034	69836
chr1	6086924	6286924	harbor2	chr1	6097435	6098169	LINE/L2	659	-	367	6097802	10878
chr1	6685458	6885458	harbor2	chr1	6707661	6708464	LINE/L2	1192	-	402	6708063	22605
chr1	31972874	32172874	harbor2	chr1	31972456	31972940	LINE/L2	1486	-	242	31972698	176
chr1	31972874	32172874	harbor2	chr1	32056815	32057156	LINE/L2	617	-	170	32056985	84111
chr1	16545147	16745147	harbor2	chr1	16608757	16608897	LINE/L2	474	-	70	16608827	63680
chr1	20561543	20761543	harbor2	chr1	20569304	20569539	LINE/L2	552	-	118	20569422	7879
chr1	20561543	20761543	harbor2	chr1	20570132	20570291	LINE/L2	691	-	80	20570212	8669
chr1	20561543	20761543	harbor2	chr1	20572238	20572876	LINE/L2	450	-	319	20572557	11014
chr1	20561543	20761543	harbor2	chr1	20573401	20573912	LINE/L2	1165	-	256	20573657	12114
chr1	20561543	20761543	harbor2	chr1	20575031	20575179	LINE/L2	527	-	74	20575105	13562
chr1	20561543	20761543	harbor2	chr1	20591457	20591559	LINE/L2	484	-	51	20591508	29965
chr1	20561543	20761543	harbor2	chr1	20598866	20599334	LINE/L2	1078	-	234	20599100	37557
chr1	20561543	20761543	harbor2	chr1	20614077	20614343	LINE/L2	591	-	133	20614210	52667
chr1	20561543	20761543	harbor2	chr1	20614565	20614863	LINE/L2	591	-	149	20614714	53171
chr1	20561543	20761543	harbor2	chr1	20657046	20657626	LINE/L2	809	-	290	20657336	95793
chr1	70743302	70943302	harbor2	chr1	70787928	70788328	LINE/L2	459	-	200	70788128	44826
chr1	201550981	201750981	harbor2	chr1	201580364	201580491	LINE/L2	447	-	64	201580428	29447
chr1	201550981	201750981	harbor2	chr1	201580790	201581082	LINE/L2	447	-	146	201580936	29955
chr1	201550981	201750981	harbor2	chr1	201596648	201596790	LINE/L2	470	-	71	201596719	45738
chr1	201550981	201750981	harbor2	chr1	201597126	201597280	LINE/L2	470	-	77	201597203	46222
chr1	7558962	7758962	harbor2	chr1	7585217	7585682	LINE/L2	524	-	232	7585449	26487
chr1	7558962	7758962	harbor2	chr1	7594247	7595093	LINE/L2	920	-	423	7594670	35708
chr1	152207691	152407691	harbor2	chr1	152221856	152222390	LINE/L2	533	-	267	152222123	14432
chr1	152207691	152407691	harbor2	chr1	152243015	152243352	LINE/L2	827	-	168	152243183	35492
chr1	209557754	209757754	harbor2	chr1	209600978	209601542	LINE/L2	583	-	282	209601260	43506
chr1	209557754	209757754	harbor2	chr1	209620173	209620518	LINE/L2	553	-	172	209620345	62591
chr1	209557754	209757754	harbor2	chr1	209621804	209622378	LINE/L2	530	-	287	209622091	64337
chr1	209557754	209757754	harbor2	chr1	209639228	209639347	LINE/L2	548	-	60	209639288	81534
chr1	53846652	54046652	harbor2	chr1	53887380	53887648	LINE/L2	1149	-	134	53887514	40862
chr1	53846652	54046652	harbor2	chr1	53915145	53915326	LINE/L2	597	-	90	53915235	68583
chr1	53846652	54046652	harbor2	chr1	53915575	53915782	LINE/L2	529	-	104	53915679	69027
chr1	53846652	54046652	harbor2	chr1	53886797	53887072	LINE/L2	1149	-	138	53886935	40283
chr1	153558724	153758724	harbor2	chr1	153578200	153578782	LINE/L2	721	-	291	153578491	19767
chr1	153558724	153758724	harbor2	chr1	153593966	153594209	LINE/L2	537	-	122	153594088	35364
chr1	153558724	153758724	harbor2	chr1	153623250	153623375	LINE/L2	2426	-	62	153623312	64588
chr1	153558724	153758724	harbor2	chr1	153623624	153624656	LINE/L2	2426	-	516	153624140	65416
chr1	153558724	153758724	harbor2	chr1	153625240	153625297	LINE/L2	2426	-	28	153625268	66544
chr1	25763699	25963699	harbor2	chr1	25784775	25785087	LINE/L2	539	-	156	25784931	21232
chr1	25763699	25963699	harbor2	chr1	25790646	25790827	LINE/L2	539	-	90	25790736	27037
chr1	25763699	25963699	harbor2	chr1	25791192	25791300	LINE/L2	539	-	54	25791246	27547
chr1	25763699	25963699	harbor2	chr1	25813323	25813615	LINE/L2	661	-	146	25813469	49770
chr1	44408152	44608152	harbor2	chr1	44422944	44423243	LINE/L2	481	-	150	44423094	14942
chr1	44408152	44608152	harbor2	chr1	44434179	44434426	LINE/L2	516	-	124	44434303	26151
chr1	44408152	44608152	harbor2	chr1	44434730	44434807	LINE/L2	516	-	38	44434768	26616
chr1	44408152	44608152	harbor2	chr1	44438497	44438608	LINE/L2	448	-	56	44438553	30401
chr1	44408152	44608152	harbor2	chr1	44441763	44441997	LINE/L2	490	-	117	44441880	33728
chr1	44408152	44608152	harbor2	chr1	44456483	44456606	LINE/L2	594	-	62	44456545	48393
chr1	44408152	44608152	harbor2	chr1	44469924	44470376	LINE/L2	606	-	226	44470150	61998
chr1	44408152	44608152	harbor2	chr1	44480442	44480619	LINE/L2	890	-	88	44480530	72378
chr1	44408152	44608152	harbor2	chr1	44480912	44481140	LINE/L2	890	-	114	44481026	72874
chr1	44408152	44608152	harbor2	chr1	44481695	44481950	LINE/L2	890	-	128	44481823	73671
chr1	110575275	110775275	harbor2	chr1	110583134	110583407	LINE/L2	723	-	136	110583270	7995
chr1	110575275	110775275	harbor2	chr1	110631620	110632811	LINE/L2	740	-	596	110632216	56941
chr1	110575275	110775275	harbor2	chr1	110648058	110648655	LINE/L2	644	-	298	110648356	73081
chr1	110575275	110775275	harbor2	chr1	110664624	110665500	LINE/L2	2203	-	438	110665062	89787
chr1	110575275	110775275	harbor2	chr1	110666424	110666823	LINE/L2	654	-	200	110666624	91349
chr1	110682470	110882470	harbor2	chr1	110696456	110697132	LINE/L2	756	-	338	110696794	14324
chr1	110682470	110882470	harbor2	chr1	110708236	110708302	LINE/L2	1384	-	33	110708269	25799
chr1	110682470	110882470	harbor2	chr1	110708611	110709298	LINE/L2	1649	-	344	110708955	26485
chr1	110682470	110882470	harbor2	chr1	110726447	110727077	LINE/L2	945	-	315	110726762	44292
chr1	110682470	110882470	harbor2	chr1	110748919	110749573	LINE/L2	756	-	327	110749246	66776
chr1	110682470	110882470	harbor2	chr1	110758268	110758391	LINE/L2	442	-	62	110758330	75860
chr1	110682470	110882470	harbor2	chr1	110778852	110779254	LINE/L2	538	-	201	110779053	96583
chr1	44170897	44370897	harbor2	chr1	44217276	44217643	LINE/L2	603	-	184	44217460	46563
chr1	44170897	44370897	harbor2	chr1	44236280	44236718	LINE/L2	677	-	219	44236499	65602
chr1	44170897	44370897	harbor2	chr1	44258490	44258730	LINE/L2	568	-	120	44258610	87713
chr1	53858393	54058393	harbor2	chr1	53887380	53887648	LINE/L2	1149	-	134	53887514	29121
chr1	53858393	54058393	harbor2	chr1	53915145	53915326	LINE/L2	597	-	90	53915235	56842
chr1	53858393	54058393	harbor2	chr1	53915575	53915782	LINE/L2	529	-	104	53915679	57286
chr1	53858393	54058393	harbor2	chr1	53949943	53950379	LINE/L2	704	-	218	53950161	91768
chr1	53858393	54058393	harbor2	chr1	53886797	53887072	LINE/L2	1149	-	138	53886935	28542
chr1	16544782	16744782	harbor2	chr1	16608757	16608897	LINE/L2	474	-	70	16608827	64045
chr1	155510028	155710028	harbor2	chr1	155536139	155536420	LINE/L2	679	-	140	155536279	26251
chr1	16545055	16745055	harbor2	chr1	16608757	16608897	LINE/L2	474	-	70	16608827	63772
chr1	16544767	16744767	harbor2	chr1	16608757	16608897	LINE/L2	474	-	70	16608827	64060
chr1	53313469	53513469	harbor2	chr1	53345861	53346105	LINE/L2	685	-	122	53345983	32514
chr1	53313469	53513469	harbor2	chr1	53375221	53375980	LINE/L2	706	-	380	53375601	62132
chr1	53313469	53513469	harbor2	chr1	53406749	53407146	LINE/L2	522	-	198	53406947	93478
chr1	53313469	53513469	harbor2	chr1	53329507	53329950	LINE/L2	705	-	222	53329729	16260
chr1	109523805	109723805	harbor2	chr1	109570350	109570958	LINE/L2	712	-	304	109570654	46849
chr1	109523805	109723805	harbor2	chr1	109571108	109571371	LINE/L2	797	-	132	109571240	47435
chr1	109523805	109723805	harbor2	chr1	109571600	109571635	LINE/L2	2478	-	18	109571618	47813
chr1	109523805	109723805	harbor2	chr1	109571929	109572025	LINE/L2	2478	-	48	109571977	48172
chr1	109523805	109723805	harbor2	chr1	109572313	109573205	LINE/L2	2478	-	446	109572759	48954
chr1	31972868	32172868	harbor2	chr1	31972456	31972940	LINE/L2	1486	-	242	31972698	170
chr1	31972868	32172868	harbor2	chr1	32056815	32057156	LINE/L2	617	-	170	32056985	84117
chr1	33670823	33870823	harbor2	chr1	33756317	33756703	LINE/L2	449	-	193	33756510	85687
chr1	16544952	16744952	harbor2	chr1	16608757	16608897	LINE/L2	474	-	70	16608827	63875
chr1	16546359	16746359	harbor2	chr1	16608757	16608897	LINE/L2	474	-	70	16608827	62468
chr1	19615803	19815803	harbor2	chr1	19627353	19627761	LINE/L2	441	-	204	19627557	11754
chr1	38817717	39017717	harbor2	chr1	38888229	38888661	LINE/L2	1355	-	216	38888445	70728
chr1	38817717	39017717	harbor2	chr1	38888945	38889094	LINE/L2	1094	-	74	38889019	71302
chr1	38817717	39017717	harbor2	chr1	38889396	38889521	LINE/L2	1094	-	62	38889458	71741
chr1	22610841	22810841	harbor2	chr1	22681877	22682055	LINE/L2	469	-	89	22681966	71125
chr1	6689187	6889187	harbor2	chr1	6707661	6708464	LINE/L2	1192	-	402	6708063	18876
chr1	211034098	211234098	harbor2	chr1	211050888	211050987	LINE/L2	676	-	50	211050938	16840
chr1	211034098	211234098	harbor2	chr1	211051297	211051777	LINE/L2	676	-	240	211051537	17439
chr1	211034098	211234098	harbor2	chr1	211084831	211085322	LINE/L2	978	-	246	211085077	50979
chr1	211034098	211234098	harbor2	chr1	211103756	211104312	LINE/L2	545	-	278	211104034	69936
chr1	22502707	22702707	harbor2	chr1	22514856	22515355	LINE/L2	1319	-	250	22515106	12399
chr1	22502707	22702707	harbor2	chr1	22515815	22516264	LINE/L2	1319	-	224	22516039	13332
chr1	22502707	22702707	harbor2	chr1	22516315	22516511	LINE/L2	1319	-	98	22516413	13706
chr1	22502707	22702707	harbor2	chr1	22540277	22540871	LINE/L2	1279	-	297	22540574	37867
chr1	22502707	22702707	harbor2	chr1	22541003	22541223	LINE/L2	463	-	110	22541113	38406
chr1	22502707	22702707	harbor2	chr1	22556687	22557101	LINE/L2	484	-	207	22556894	54187
chr1	26600726	26800726	harbor2	chr1	26605474	26605711	LINE/L2	1206	-	118	26605592	4866
chr1	26600726	26800726	harbor2	chr1	26606011	26606298	LINE/L2	1690	-	144	26606155	5429
chr1	26600726	26800726	harbor2	chr1	26606611	26606720	LINE/L2	1690	-	54	26606665	5939
chr1	26600726	26800726	harbor2	chr1	26606985	26607292	LINE/L2	1690	-	154	26607139	6413
chr1	26600726	26800726	harbor2	chr1	26661160	26661696	LINE/L2	1333	-	268	26661428	60702
chr1	26600726	26800726	harbor2	chr1	26661999	26662038	LINE/L2	1333	-	20	26662019	61293
chr1	26600726	26800726	harbor2	chr1	26664826	26665189	LINE/L2	1101	-	182	26665008	64282
chr1	207652046	207852046	harbor2	chr1	207699731	207699960	LINE/L2	488	-	114	207699845	47799
chr1	207903426	208103426	harbor2	chr1	207950512	207950819	LINE/L2	587	-	154	207950666	47240
chr1	211034399	211234399	harbor2	chr1	211050888	211050987	LINE/L2	676	-	50	211050938	16539
chr1	211034399	211234399	harbor2	chr1	211051297	211051777	LINE/L2	676	-	240	211051537	17138
chr1	211034399	211234399	harbor2	chr1	211084831	211085322	LINE/L2	978	-	246	211085077	50678
chr1	211034399	211234399	harbor2	chr1	211103756	211104312	LINE/L2	545	-	278	211104034	69635
chr1	41949951	42149951	harbor2	chr1	41972383	41972723	LINE/L2	483	-	170	41972553	22602
chr1	41949951	42149951	harbor2	chr1	41987050	41987170	LINE/L2	454	-	60	41987110	37159
chr1	41949951	42149951	harbor2	chr1	42020641	42021761	LINE/L2	2055	-	560	42021201	71250
chr1	214586377	214786377	harbor2	chr1	214623643	214623884	LINE/L2	556	-	120	214623763	37386
chr1	214586377	214786377	harbor2	chr1	214650363	214650619	LINE/L2	533	-	128	214650491	64114
chr1	214586377	214786377	harbor2	chr1	214650954	214651146	LINE/L2	468	-	96	214651050	64673
chr1	214586377	214786377	harbor2	chr1	214651161	214651540	LINE/L2	579	-	190	214651351	64974
chr1	14862929	15062929	harbor2	chr1	14873188	14874198	LINE/L2	2074	-	505	14873693	10764
chr1	14862929	15062929	harbor2	chr1	14881517	14881634	LINE/L2	485	-	58	14881575	18646
chr1	14862929	15062929	harbor2	chr1	14895884	14896028	LINE/L2	440	-	72	14895956	33027
chr1	14862929	15062929	harbor2	chr1	14900953	14901693	LINE/L2	1173	-	370	14901323	38394
chr1	14862929	15062929	harbor2	chr1	14927265	14927572	LINE/L2	753	-	154	14927419	64490
chr1	14862929	15062929	harbor2	chr1	14958939	14959133	LINE/L2	448	-	97	14959036	96107
chr1	167355689	167555689	harbor2	chr1	167382051	167382650	LINE/L2	597	-	300	167382351	26662
chr1	40217340	40417340	harbor2	chr1	40218755	40218871	LINE/L2	547	-	58	40218813	1473
chr1	40217340	40417340	harbor2	chr1	40274528	40275059	LINE/L2	1333	-	266	40274794	57454
chr1	40217340	40417340	harbor2	chr1	40276197	40276324	LINE/L2	534	-	64	40276261	58921
chr1	40217340	40417340	harbor2	chr1	40296413	40296595	LINE/L2	930	-	91	40296504	79164
chr1	40217340	40417340	harbor2	chr1	40296902	40297022	LINE/L2	930	-	60	40296962	79622
chr1	40217340	40417340	harbor2	chr1	40297024	40297719	LINE/L2	2820	-	348	40297372	80032
chr1	40217340	40417340	harbor2	chr1	40298735	40299175	LINE/L2	666	-	220	40298955	81615
chr1	32102226	32302226	harbor2	chr1	32104536	32104799	LINE/L2	565	-	132	32104668	2442
chr1	32102226	32302226	harbor2	chr1	32105431	32105614	LINE/L2	565	-	92	32105523	3297
chr1	32102226	32302226	harbor2	chr1	32106316	32106482	LINE/L2	586	-	83	32106399	4173
chr1	32102226	32302226	harbor2	chr1	32119452	32119574	LINE/L2	486	-	61	32119513	17287
chr1	32102226	32302226	harbor2	chr1	32186156	32186796	LINE/L2	653	-	320	32186476	84250
chr1	32102226	32302226	harbor2	chr1	32187369	32187640	LINE/L2	533	-	136	32187505	85279
chr1	202249918	202449918	harbor2	chr1	202277620	202278363	LINE/L2	541	-	372	202277992	28074
chr1	202249918	202449918	harbor2	chr1	202294161	202294325	LINE/L2	476	-	82	202294243	44325
chr1	202249918	202449918	harbor2	chr1	202294821	202295031	LINE/L2	648	-	105	202294926	45008
chr1	202249918	202449918	harbor2	chr1	202329472	202330099	LINE/L2	885	-	314	202329786	79868
chr1	161077890	161277890	harbor2	chr1	161092375	161092502	LINE/L2	461	-	64	161092439	14549
chr1	161077890	161277890	harbor2	chr1	161133306	161133568	LINE/L2	465	-	131	161133437	55547
chr1	161077890	161277890	harbor2	chr1	161154988	161156042	LINE/L2	1034	-	527	161155515	77625
chr1	211033781	211233781	harbor2	chr1	211050888	211050987	LINE/L2	676	-	50	211050938	17157
chr1	211033781	211233781	harbor2	chr1	211051297	211051777	LINE/L2	676	-	240	211051537	17756
chr1	211033781	211233781	harbor2	chr1	211084831	211085322	LINE/L2	978	-	246	211085077	51296
chr1	211033781	211233781	harbor2	chr1	211103756	211104312	LINE/L2	545	-	278	211104034	70253
chr1	16544805	16744805	harbor2	chr1	16608757	16608897	LINE/L2	474	-	70	16608827	64022
chr1	225365084	225565084	harbor2	chr1	225459732	225460097	LINE/L2	465	-	182	225459914	94830
chr1	205431580	205631580	harbor2	chr1	205458091	205458507	LINE/L2	468	-	208	205458299	26719
chr1	205431580	205631580	harbor2	chr1	205498596	205499017	LINE/L2	564	-	210	205498806	67226
chr1	205431580	205631580	harbor2	chr1	205513999	205514272	LINE/L2	437	-	136	205514135	82555
chr1	16546385	16746385	harbor2	chr1	16608757	16608897	LINE/L2	474	-	70	16608827	62442
chr1	145920756	146120756	harbor2	chr1	145946599	145946825	LINE/L2	493	-	113	145946712	25956
chr1	145920756	146120756	harbor2	chr1	145949173	145949661	LINE/L2	593	-	244	145949417	28661
chr1	206353548	206553548	harbor2	chr1	206359584	206359798	LINE/L2	1488	-	107	206359691	6143
chr1	206353548	206553548	harbor2	chr1	206360106	206360745	LINE/L2	1595	-	320	206360426	6878
chr1	206353548	206553548	harbor2	chr1	206431582	206432217	LINE/L2	819	-	318	206431900	78352
chr1	206353548	206553548	harbor2	chr1	206440158	206440488	LINE/L2	493	-	165	206440323	86775
chr1	206353548	206553548	harbor2	chr1	206440874	206441325	LINE/L2	687	-	226	206441100	87552
chr1	33905807	34105807	harbor2	chr1	33906211	33907115	LINE/L2	882	-	452	33906663	856
chr1	33905807	34105807	harbor2	chr1	33907427	33907565	LINE/L2	882	-	69	33907496	1689
chr1	33905807	34105807	harbor2	chr1	33919833	33920246	LINE/L2	1704	-	206	33920039	14232
chr1	33905807	34105807	harbor2	chr1	33920566	33920908	LINE/L2	1704	-	171	33920737	14930
chr1	33905807	34105807	harbor2	chr1	33937214	33937466	LINE/L2	454	-	126	33937340	31533
chr1	33905807	34105807	harbor2	chr1	33960461	33960652	LINE/L2	452	-	96	33960557	54750
chr1	33905807	34105807	harbor2	chr1	33978332	33978714	LINE/L2	649	-	191	33978523	72716
chr1	226638205	226838205	harbor2	chr1	226671450	226672119	LINE/L2	1165	-	334	226671784	33579
chr1	161528751	161728751	harbor2	chr1	161552947	161553487	LINE/L2	718	-	270	161553217	24466
chr1	161528751	161728751	harbor2	chr1	161564831	161565333	LINE/L2	799	-	251	161565082	36331
chr1	161528751	161728751	harbor2	chr1	161583774	161584566	LINE/L2	722	-	396	161584170	55419
chr1	161528751	161728751	harbor2	chr1	161585067	161585863	LINE/L2	959	-	398	161585465	56714
chr1	36055774	36255774	harbor2	chr1	36143133	36143530	LINE/L2	764	-	198	36143331	87557
chr1	113990947	114190947	harbor2	chr1	114060904	114061017	LINE/L2	453	-	56	114060960	70013
chr1	113990947	114190947	harbor2	chr1	114064130	114064496	LINE/L2	604	-	183	114064313	73366
chr1	113990947	114190947	harbor2	chr1	114064509	114064946	LINE/L2	676	-	218	114064727	73780
chr1	113990947	114190947	harbor2	chr1	114077033	114077418	LINE/L2	563	-	192	114077225	86278
chr1	46294779	46494779	harbor2	chr1	46369341	46369455	LINE/L2	451	-	57	46369398	74619
chr1	211034391	211234391	harbor2	chr1	211050888	211050987	LINE/L2	676	-	50	211050938	16547
chr1	211034391	211234391	harbor2	chr1	211051297	211051777	LINE/L2	676	-	240	211051537	17146
chr1	211034391	211234391	harbor2	chr1	211084831	211085322	LINE/L2	978	-	246	211085077	50686
chr1	211034391	211234391	harbor2	chr1	211103756	211104312	LINE/L2	545	-	278	211104034	69643
chr1	230941728	231141728	harbor2	chr1	230970234	230970685	LINE/L2	800	-	226	230970460	28732
chr1	201549927	201749927	harbor2	chr1	201580364	201580491	LINE/L2	447	-	64	201580428	30501
chr1	201549927	201749927	harbor2	chr1	201580790	201581082	LINE/L2	447	-	146	201580936	31009
chr1	201549927	201749927	harbor2	chr1	201596648	201596790	LINE/L2	470	-	71	201596719	46792
chr1	201549927	201749927	harbor2	chr1	201597126	201597280	LINE/L2	470	-	77	201597203	47276
chr1	31973222	32173222	harbor2	chr1	32056815	32057156	LINE/L2	617	-	170	32056985	83763
chr1	10913141	11113141	harbor2	chr1	10969587	10969932	LINE/L2	555	-	172	10969759	56618
chr1	156192114	156392114	harbor2	chr1	156234457	156234502	LINE/L2	466	-	22	156234479	42365
chr1	156192114	156392114	harbor2	chr1	156234809	156234891	LINE/L2	466	-	41	156234850	42736
chr1	156192114	156392114	harbor2	chr1	156264383	156264743	LINE/L2	661	-	180	156264563	72449
chr1	17337716	17537716	harbor2	chr1	17340186	17340729	LINE/L2	1206	-	272	17340458	2742
chr1	17337716	17537716	harbor2	chr1	17350710	17350905	LINE/L2	1197	-	98	17350808	13092
chr1	17337716	17537716	harbor2	chr1	17351223	17351309	LINE/L2	1197	-	43	17351266	13550
chr1	17337716	17537716	harbor2	chr1	17351635	17351888	LINE/L2	1197	-	126	17351761	14045
chr1	17337716	17537716	harbor2	chr1	17352256	17352897	LINE/L2	603	-	320	17352576	14860
chr1	17337716	17537716	harbor2	chr1	17354896	17355269	LINE/L2	690	-	186	17355082	17366
chr1	17337716	17537716	harbor2	chr1	17356534	17356911	LINE/L2	562	-	188	17356722	19006
chr1	17337716	17537716	harbor2	chr1	17385198	17385898	LINE/L2	478	-	350	17385548	47832
chr1	201882904	202082904	harbor2	chr1	201920920	201921207	LINE/L2	489	-	144	201921064	38160
chr1	201882904	202082904	harbor2	chr1	201921515	201921642	LINE/L2	489	-	64	201921579	38675
chr1	201882904	202082904	harbor2	chr1	201929718	201931252	LINE/L2	825	-	767	201930485	47581
chr1	201882904	202082904	harbor2	chr1	201931565	201931755	LINE/L2	784	-	95	201931660	48756
chr1	201882904	202082904	harbor2	chr1	201931914	201932145	LINE/L2	784	-	116	201932030	49126
chr1	201882904	202082904	harbor2	chr1	201935073	201935229	LINE/L2	505	-	78	201935151	52247
chr1	201882904	202082904	harbor2	chr1	201942183	201942461	LINE/L2	492	-	139	201942322	59418
chr1	201882904	202082904	harbor2	chr1	201965854	201966019	LINE/L2	495	-	82	201965936	83032
chr1	53312834	53512834	harbor2	chr1	53345861	53346105	LINE/L2	685	-	122	53345983	33149
chr1	53312834	53512834	harbor2	chr1	53375221	53375980	LINE/L2	706	-	380	53375601	62767
chr1	53312834	53512834	harbor2	chr1	53406749	53407146	LINE/L2	522	-	198	53406947	94113
chr1	53312834	53512834	harbor2	chr1	53329507	53329950	LINE/L2	705	-	222	53329729	16895
chr1	16544742	16744742	harbor2	chr1	16608757	16608897	LINE/L2	474	-	70	16608827	64085
chr1	7926217	8126217	harbor2	chr1	7986368	7986800	LINE/L2	577	-	216	7986584	60367
chr1	27281347	27481347	harbor2	chr1	27299210	27299754	LINE/L2	478	-	272	27299482	18135
chr1	27281347	27481347	harbor2	chr1	27302147	27302452	LINE/L2	560	-	152	27302299	20952
chr1	27281347	27481347	harbor2	chr1	27302761	27302869	LINE/L2	560	-	54	27302815	21468
chr1	27281347	27481347	harbor2	chr1	27318148	27318560	LINE/L2	525	-	206	27318354	37007
chr1	27281347	27481347	harbor2	chr1	27319688	27320166	LINE/L2	707	-	239	27319927	38580
chr1	27281347	27481347	harbor2	chr1	27327942	27328475	LINE/L2	799	-	266	27328208	46861
chr1	206973128	207173128	harbor2	chr1	207012747	207013004	LINE/L2	530	-	128	207012875	39747
chr1	206973128	207173128	harbor2	chr1	207013211	207013247	LINE/L2	530	-	18	207013229	40101
chr1	230940319	231140319	harbor2	chr1	230970234	230970685	LINE/L2	800	-	226	230970460	30141
chr1	117032433	117232433	harbor2	chr1	117051200	117051766	LINE/L2	635	-	283	117051483	19050
chr1	117032433	117232433	harbor2	chr1	117107733	117107882	LINE/L2	822	-	74	117107807	75374
chr1	117032433	117232433	harbor2	chr1	117108170	117108567	LINE/L2	822	-	198	117108368	75935
chr1	117032433	117232433	harbor2	chr1	117108577	117108798	LINE/L2	821	-	110	117108687	76254
chr1	117032433	117232433	harbor2	chr1	117109209	117110164	LINE/L2	2501	-	478	117109687	77254
chr1	117032433	117232433	harbor2	chr1	117110694	117110888	LINE/L2	2501	-	97	117110791	78358
chr1	117032433	117232433	harbor2	chr1	117127388	117127488	LINE/L2	1255	-	50	117127438	95005
chr1	117032433	117232433	harbor2	chr1	117127778	117128093	LINE/L2	1255	-	158	117127936	95503
chr1	19187949	19387949	harbor2	chr1	19253140	19253658	LINE/L2	710	-	259	19253399	65450
chr1	230539629	230739629	harbor2	chr1	230629043	230629118	LINE/L2	486	-	38	230629081	89452
chr1	230539629	230739629	harbor2	chr1	230629651	230629886	LINE/L2	486	-	118	230629769	90140
chr1	230539629	230739629	harbor2	chr1	230631360	230631504	LINE/L2	576	-	72	230631432	91803
chr1	230539629	230739629	harbor2	chr1	230631832	230632357	LINE/L2	2788	-	262	230632094	92465
chr1	230539629	230739629	harbor2	chr1	230632578	230633027	LINE/L2	2788	-	224	230632802	93173
chr1	230539629	230739629	harbor2	chr1	230633860	230634190	LINE/L2	568	-	165	230634025	94396
chr2	46198427	46398427	harbor2	chr2	46276468	46276804	LINE/L2	566	-	168	46276636	78209
chr2	46198427	46398427	harbor2	chr2	46284110	46284550	LINE/L2	575	-	220	46284330	85903
chr2	219078277	219278277	harbor2	chr2	219083068	219083253	LINE/L2	772	-	92	219083160	4883
chr2	219078277	219278277	harbor2	chr2	219096377	219096984	LINE/L2	2719	-	304	219096681	18404
chr2	219078277	219278277	harbor2	chr2	219097268	219097456	LINE/L2	2719	-	94	219097362	19085
chr2	219078277	219278277	harbor2	chr2	219097585	219097852	LINE/L2	2719	-	134	219097719	19442
chr2	219078277	219278277	harbor2	chr2	219097854	219098351	LINE/L2	457	-	248	219098102	19825
chr2	219078277	219278277	harbor2	chr2	219098386	219098668	LINE/L2	2683	-	141	219098527	20250
chr2	219078277	219278277	harbor2	chr2	219098793	219099198	LINE/L2	2683	-	202	219098995	20718
chr2	219078277	219278277	harbor2	chr2	219099417	219099962	LINE/L2	2683	-	272	219099689	21412
chr2	219078277	219278277	harbor2	chr2	219110075	219110254	LINE/L2	1606	-	90	219110165	31888
chr2	219078277	219278277	harbor2	chr2	219110535	219110840	LINE/L2	1606	-	152	219110687	32410
chr2	219078277	219278277	harbor2	chr2	219126577	219127180	LINE/L2	807	-	302	219126879	48602
chr2	219078277	219278277	harbor2	chr2	219138516	219138847	LINE/L2	935	-	166	219138682	60405
chr2	219078277	219278277	harbor2	chr2	219140040	219140828	LINE/L2	2314	-	394	219140434	62157
chr2	219078277	219278277	harbor2	chr2	219140840	219141097	LINE/L2	811	-	128	219140968	62691
chr2	219078277	219278277	harbor2	chr2	219141391	219141893	LINE/L2	811	-	251	219141642	63365
chr2	219078277	219278277	harbor2	chr2	219144260	219144725	LINE/L2	631	-	232	219144492	66215
chr2	231298236	231498236	harbor2	chr2	231333142	231333394	LINE/L2	485	-	126	231333268	35032
chr2	219078262	219278262	harbor2	chr2	219083068	219083253	LINE/L2	772	-	92	219083160	4898
chr2	219078262	219278262	harbor2	chr2	219096377	219096984	LINE/L2	2719	-	304	219096681	18419
chr2	219078262	219278262	harbor2	chr2	219097268	219097456	LINE/L2	2719	-	94	219097362	19100
chr2	219078262	219278262	harbor2	chr2	219097585	219097852	LINE/L2	2719	-	134	219097719	19457
chr2	219078262	219278262	harbor2	chr2	219097854	219098351	LINE/L2	457	-	248	219098102	19840
chr2	219078262	219278262	harbor2	chr2	219098386	219098668	LINE/L2	2683	-	141	219098527	20265
chr2	219078262	219278262	harbor2	chr2	219098793	219099198	LINE/L2	2683	-	202	219098995	20733
chr2	219078262	219278262	harbor2	chr2	219099417	219099962	LINE/L2	2683	-	272	219099689	21427
chr2	219078262	219278262	harbor2	chr2	219110075	219110254	LINE/L2	1606	-	90	219110165	31903
chr2	219078262	219278262	harbor2	chr2	219110535	219110840	LINE/L2	1606	-	152	219110687	32425
chr2	219078262	219278262	harbor2	chr2	219126577	219127180	LINE/L2	807	-	302	219126879	48617
chr2	219078262	219278262	harbor2	chr2	219138516	219138847	LINE/L2	935	-	166	219138682	60420
chr2	219078262	219278262	harbor2	chr2	219140040	219140828	LINE/L2	2314	-	394	219140434	62172
chr2	219078262	219278262	harbor2	chr2	219140840	219141097	LINE/L2	811	-	128	219140968	62706
chr2	219078262	219278262	harbor2	chr2	219141391	219141893	LINE/L2	811	-	251	219141642	63380
chr2	219078262	219278262	harbor2	chr2	219144260	219144725	LINE/L2	631	-	232	219144492	66230
chr2	219078276	219278276	harbor2	chr2	219083068	219083253	LINE/L2	772	-	92	219083160	4884
chr2	219078276	219278276	harbor2	chr2	219096377	219096984	LINE/L2	2719	-	304	219096681	18405
chr2	219078276	219278276	harbor2	chr2	219097268	219097456	LINE/L2	2719	-	94	219097362	19086
chr2	219078276	219278276	harbor2	chr2	219097585	219097852	LINE/L2	2719	-	134	219097719	19443
chr2	219078276	219278276	harbor2	chr2	219097854	219098351	LINE/L2	457	-	248	219098102	19826
chr2	219078276	219278276	harbor2	chr2	219098386	219098668	LINE/L2	2683	-	141	219098527	20251
chr2	219078276	219278276	harbor2	chr2	219098793	219099198	LINE/L2	2683	-	202	219098995	20719
chr2	219078276	219278276	harbor2	chr2	219099417	219099962	LINE/L2	2683	-	272	219099689	21413
chr2	219078276	219278276	harbor2	chr2	219110075	219110254	LINE/L2	1606	-	90	219110165	31889
chr2	219078276	219278276	harbor2	chr2	219110535	219110840	LINE/L2	1606	-	152	219110687	32411
chr2	219078276	219278276	harbor2	chr2	219126577	219127180	LINE/L2	807	-	302	219126879	48603
chr2	219078276	219278276	harbor2	chr2	219138516	219138847	LINE/L2	935	-	166	219138682	60406
chr2	219078276	219278276	harbor2	chr2	219140040	219140828	LINE/L2	2314	-	394	219140434	62158
chr2	219078276	219278276	harbor2	chr2	219140840	219141097	LINE/L2	811	-	128	219140968	62692
chr2	219078276	219278276	harbor2	chr2	219141391	219141893	LINE/L2	811	-	251	219141642	63366
chr2	219078276	219278276	harbor2	chr2	219144260	219144725	LINE/L2	631	-	232	219144492	66216
chr2	43055480	43255480	harbor2	chr2	43131894	43132186	LINE/L2	702	-	146	43132040	76560
chr2	43055480	43255480	harbor2	chr2	43134807	43134894	LINE/L2	788	-	44	43134851	79371
chr2	43055480	43255480	harbor2	chr2	43135205	43135263	LINE/L2	788	-	29	43135234	79754
chr2	43055480	43255480	harbor2	chr2	43135551	43135836	LINE/L2	788	-	142	43135693	80213
chr2	219078261	219278261	harbor2	chr2	219083068	219083253	LINE/L2	772	-	92	219083160	4899
chr2	219078261	219278261	harbor2	chr2	219096377	219096984	LINE/L2	2719	-	304	219096681	18420
chr2	219078261	219278261	harbor2	chr2	219097268	219097456	LINE/L2	2719	-	94	219097362	19101
chr2	219078261	219278261	harbor2	chr2	219097585	219097852	LINE/L2	2719	-	134	219097719	19458
chr2	219078261	219278261	harbor2	chr2	219097854	219098351	LINE/L2	457	-	248	219098102	19841
chr2	219078261	219278261	harbor2	chr2	219098386	219098668	LINE/L2	2683	-	141	219098527	20266
chr2	219078261	219278261	harbor2	chr2	219098793	219099198	LINE/L2	2683	-	202	219098995	20734
chr2	219078261	219278261	harbor2	chr2	219099417	219099962	LINE/L2	2683	-	272	219099689	21428
chr2	219078261	219278261	harbor2	chr2	219110075	219110254	LINE/L2	1606	-	90	219110165	31904
chr2	219078261	219278261	harbor2	chr2	219110535	219110840	LINE/L2	1606	-	152	219110687	32426
chr2	219078261	219278261	harbor2	chr2	219126577	219127180	LINE/L2	807	-	302	219126879	48618
chr2	219078261	219278261	harbor2	chr2	219138516	219138847	LINE/L2	935	-	166	219138682	60421
chr2	219078261	219278261	harbor2	chr2	219140040	219140828	LINE/L2	2314	-	394	219140434	62173
chr2	219078261	219278261	harbor2	chr2	219140840	219141097	LINE/L2	811	-	128	219140968	62707
chr2	219078261	219278261	harbor2	chr2	219141391	219141893	LINE/L2	811	-	251	219141642	63381
chr2	219078261	219278261	harbor2	chr2	219144260	219144725	LINE/L2	631	-	232	219144492	66231
chr2	70453855	70653855	harbor2	chr2	70496727	70497246	LINE/L2	1065	-	260	70496987	43132
chr2	218223269	218423269	harbor2	chr2	218295235	218295681	LINE/L2	656	-	223	218295458	72189
chr2	218223269	218423269	harbor2	chr2	218301849	218302067	LINE/L2	626	-	109	218301958	78689
chr2	218223269	218423269	harbor2	chr2	218302367	218302673	LINE/L2	626	-	153	218302520	79251
chr2	218223269	218423269	harbor2	chr2	218318622	218318886	LINE/L2	636	-	132	218318754	95485
chr2	219116402	219316402	harbor2	chr2	219126577	219127180	LINE/L2	807	-	302	219126879	10477
chr2	219116402	219316402	harbor2	chr2	219138516	219138847	LINE/L2	935	-	166	219138682	22280
chr2	219116402	219316402	harbor2	chr2	219140040	219140828	LINE/L2	2314	-	394	219140434	24032
chr2	219116402	219316402	harbor2	chr2	219140840	219141097	LINE/L2	811	-	128	219140968	24566
chr2	219116402	219316402	harbor2	chr2	219141391	219141893	LINE/L2	811	-	251	219141642	25240
chr2	219116402	219316402	harbor2	chr2	219144260	219144725	LINE/L2	631	-	232	219144492	28090
chr2	219078283	219278283	harbor2	chr2	219083068	219083253	LINE/L2	772	-	92	219083160	4877
chr2	219078283	219278283	harbor2	chr2	219096377	219096984	LINE/L2	2719	-	304	219096681	18398
chr2	219078283	219278283	harbor2	chr2	219097268	219097456	LINE/L2	2719	-	94	219097362	19079
chr2	219078283	219278283	harbor2	chr2	219097585	219097852	LINE/L2	2719	-	134	219097719	19436
chr2	219078283	219278283	harbor2	chr2	219097854	219098351	LINE/L2	457	-	248	219098102	19819
chr2	219078283	219278283	harbor2	chr2	219098386	219098668	LINE/L2	2683	-	141	219098527	20244
chr2	219078283	219278283	harbor2	chr2	219098793	219099198	LINE/L2	2683	-	202	219098995	20712
chr2	219078283	219278283	harbor2	chr2	219099417	219099962	LINE/L2	2683	-	272	219099689	21406
chr2	219078283	219278283	harbor2	chr2	219110075	219110254	LINE/L2	1606	-	90	219110165	31882
chr2	219078283	219278283	harbor2	chr2	219110535	219110840	LINE/L2	1606	-	152	219110687	32404
chr2	219078283	219278283	harbor2	chr2	219126577	219127180	LINE/L2	807	-	302	219126879	48596
chr2	219078283	219278283	harbor2	chr2	219138516	219138847	LINE/L2	935	-	166	219138682	60399
chr2	219078283	219278283	harbor2	chr2	219140040	219140828	LINE/L2	2314	-	394	219140434	62151
chr2	219078283	219278283	harbor2	chr2	219140840	219141097	LINE/L2	811	-	128	219140968	62685
chr2	219078283	219278283	harbor2	chr2	219141391	219141893	LINE/L2	811	-	251	219141642	63359
chr2	219078283	219278283	harbor2	chr2	219144260	219144725	LINE/L2	631	-	232	219144492	66209
chr2	26950509	27150509	harbor2	chr2	26966653	26966822	LINE/L2	475	-	84	26966737	16228
chr2	219078282	219278282	harbor2	chr2	219083068	219083253	LINE/L2	772	-	92	219083160	4878
chr2	219078282	219278282	harbor2	chr2	219096377	219096984	LINE/L2	2719	-	304	219096681	18399
chr2	219078282	219278282	harbor2	chr2	219097268	219097456	LINE/L2	2719	-	94	219097362	19080
chr2	219078282	219278282	harbor2	chr2	219097585	219097852	LINE/L2	2719	-	134	219097719	19437
chr2	219078282	219278282	harbor2	chr2	219097854	219098351	LINE/L2	457	-	248	219098102	19820
chr2	219078282	219278282	harbor2	chr2	219098386	219098668	LINE/L2	2683	-	141	219098527	20245
chr2	219078282	219278282	harbor2	chr2	219098793	219099198	LINE/L2	2683	-	202	219098995	20713
chr2	219078282	219278282	harbor2	chr2	219099417	219099962	LINE/L2	2683	-	272	219099689	21407
chr2	219078282	219278282	harbor2	chr2	219110075	219110254	LINE/L2	1606	-	90	219110165	31883
chr2	219078282	219278282	harbor2	chr2	219110535	219110840	LINE/L2	1606	-	152	219110687	32405
chr2	219078282	219278282	harbor2	chr2	219126577	219127180	LINE/L2	807	-	302	219126879	48597
chr2	219078282	219278282	harbor2	chr2	219138516	219138847	LINE/L2	935	-	166	219138682	60400
chr2	219078282	219278282	harbor2	chr2	219140040	219140828	LINE/L2	2314	-	394	219140434	62152
chr2	219078282	219278282	harbor2	chr2	219140840	219141097	LINE/L2	811	-	128	219140968	62686
chr2	219078282	219278282	harbor2	chr2	219141391	219141893	LINE/L2	811	-	251	219141642	63360
chr2	219078282	219278282	harbor2	chr2	219144260	219144725	LINE/L2	631	-	232	219144492	66210
chr2	72043327	72243327	harbor2	chr2	72099038	72099324	LINE/L2	879	-	143	72099181	55854
chr2	72043327	72243327	harbor2	chr2	72106914	72107271	LINE/L2	447	-	178	72107092	63765
chr2	219145524	219345524	harbor2	chr2	219221528	219221989	LINE/L2	1142	-	230	219221758	76234
chr2	219145524	219345524	harbor2	chr2	219241551	219241989	LINE/L2	1491	-	219	219241770	96246
chr2	219079117	219279117	harbor2	chr2	219083068	219083253	LINE/L2	772	-	92	219083160	4043
chr2	219079117	219279117	harbor2	chr2	219096377	219096984	LINE/L2	2719	-	304	219096681	17564
chr2	219079117	219279117	harbor2	chr2	219097268	219097456	LINE/L2	2719	-	94	219097362	18245
chr2	219079117	219279117	harbor2	chr2	219097585	219097852	LINE/L2	2719	-	134	219097719	18602
chr2	219079117	219279117	harbor2	chr2	219097854	219098351	LINE/L2	457	-	248	219098102	18985
chr2	219079117	219279117	harbor2	chr2	219098386	219098668	LINE/L2	2683	-	141	219098527	19410
chr2	219079117	219279117	harbor2	chr2	219098793	219099198	LINE/L2	2683	-	202	219098995	19878
chr2	219079117	219279117	harbor2	chr2	219099417	219099962	LINE/L2	2683	-	272	219099689	20572
chr2	219079117	219279117	harbor2	chr2	219110075	219110254	LINE/L2	1606	-	90	219110165	31048
chr2	219079117	219279117	harbor2	chr2	219110535	219110840	LINE/L2	1606	-	152	219110687	31570
chr2	219079117	219279117	harbor2	chr2	219126577	219127180	LINE/L2	807	-	302	219126879	47762
chr2	219079117	219279117	harbor2	chr2	219138516	219138847	LINE/L2	935	-	166	219138682	59565
chr2	219079117	219279117	harbor2	chr2	219140040	219140828	LINE/L2	2314	-	394	219140434	61317
chr2	219079117	219279117	harbor2	chr2	219140840	219141097	LINE/L2	811	-	128	219140968	61851
chr2	219079117	219279117	harbor2	chr2	219141391	219141893	LINE/L2	811	-	251	219141642	62525
chr2	219079117	219279117	harbor2	chr2	219144260	219144725	LINE/L2	631	-	232	219144492	65375
chr2	26406627	26606627	harbor2	chr2	26429917	26430141	LINE/L2	678	-	112	26430029	23402
chr2	219078255	219278255	harbor2	chr2	219083068	219083253	LINE/L2	772	-	92	219083160	4905
chr2	219078255	219278255	harbor2	chr2	219096377	219096984	LINE/L2	2719	-	304	219096681	18426
chr2	219078255	219278255	harbor2	chr2	219097268	219097456	LINE/L2	2719	-	94	219097362	19107
chr2	219078255	219278255	harbor2	chr2	219097585	219097852	LINE/L2	2719	-	134	219097719	19464
chr2	219078255	219278255	harbor2	chr2	219097854	219098351	LINE/L2	457	-	248	219098102	19847
chr2	219078255	219278255	harbor2	chr2	219098386	219098668	LINE/L2	2683	-	141	219098527	20272
chr2	219078255	219278255	harbor2	chr2	219098793	219099198	LINE/L2	2683	-	202	219098995	20740
chr2	219078255	219278255	harbor2	chr2	219099417	219099962	LINE/L2	2683	-	272	219099689	21434
chr2	219078255	219278255	harbor2	chr2	219110075	219110254	LINE/L2	1606	-	90	219110165	31910
chr2	219078255	219278255	harbor2	chr2	219110535	219110840	LINE/L2	1606	-	152	219110687	32432
chr2	219078255	219278255	harbor2	chr2	219126577	219127180	LINE/L2	807	-	302	219126879	48624
chr2	219078255	219278255	harbor2	chr2	219138516	219138847	LINE/L2	935	-	166	219138682	60427
chr2	219078255	219278255	harbor2	chr2	219140040	219140828	LINE/L2	2314	-	394	219140434	62179
chr2	219078255	219278255	harbor2	chr2	219140840	219141097	LINE/L2	811	-	128	219140968	62713
chr2	219078255	219278255	harbor2	chr2	219141391	219141893	LINE/L2	811	-	251	219141642	63387
chr2	219078255	219278255	harbor2	chr2	219144260	219144725	LINE/L2	631	-	232	219144492	66237
chr2	219081059	219281059	harbor2	chr2	219083068	219083253	LINE/L2	772	-	92	219083160	2101
chr2	219081059	219281059	harbor2	chr2	219096377	219096984	LINE/L2	2719	-	304	219096681	15622
chr2	219081059	219281059	harbor2	chr2	219097268	219097456	LINE/L2	2719	-	94	219097362	16303
chr2	219081059	219281059	harbor2	chr2	219097585	219097852	LINE/L2	2719	-	134	219097719	16660
chr2	219081059	219281059	harbor2	chr2	219097854	219098351	LINE/L2	457	-	248	219098102	17043
chr2	219081059	219281059	harbor2	chr2	219098386	219098668	LINE/L2	2683	-	141	219098527	17468
chr2	219081059	219281059	harbor2	chr2	219098793	219099198	LINE/L2	2683	-	202	219098995	17936
chr2	219081059	219281059	harbor2	chr2	219099417	219099962	LINE/L2	2683	-	272	219099689	18630
chr2	219081059	219281059	harbor2	chr2	219110075	219110254	LINE/L2	1606	-	90	219110165	29106
chr2	219081059	219281059	harbor2	chr2	219110535	219110840	LINE/L2	1606	-	152	219110687	29628
chr2	219081059	219281059	harbor2	chr2	219126577	219127180	LINE/L2	807	-	302	219126879	45820
chr2	219081059	219281059	harbor2	chr2	219138516	219138847	LINE/L2	935	-	166	219138682	57623
chr2	219081059	219281059	harbor2	chr2	219140040	219140828	LINE/L2	2314	-	394	219140434	59375
chr2	219081059	219281059	harbor2	chr2	219140840	219141097	LINE/L2	811	-	128	219140968	59909
chr2	219081059	219281059	harbor2	chr2	219141391	219141893	LINE/L2	811	-	251	219141642	60583
chr2	219081059	219281059	harbor2	chr2	219144260	219144725	LINE/L2	631	-	232	219144492	63433
chr2	219078275	219278275	harbor2	chr2	219083068	219083253	LINE/L2	772	-	92	219083160	4885
chr2	219078275	219278275	harbor2	chr2	219096377	219096984	LINE/L2	2719	-	304	219096681	18406
chr2	219078275	219278275	harbor2	chr2	219097268	219097456	LINE/L2	2719	-	94	219097362	19087
chr2	219078275	219278275	harbor2	chr2	219097585	219097852	LINE/L2	2719	-	134	219097719	19444
chr2	219078275	219278275	harbor2	chr2	219097854	219098351	LINE/L2	457	-	248	219098102	19827
chr2	219078275	219278275	harbor2	chr2	219098386	219098668	LINE/L2	2683	-	141	219098527	20252
chr2	219078275	219278275	harbor2	chr2	219098793	219099198	LINE/L2	2683	-	202	219098995	20720
chr2	219078275	219278275	harbor2	chr2	219099417	219099962	LINE/L2	2683	-	272	219099689	21414
chr2	219078275	219278275	harbor2	chr2	219110075	219110254	LINE/L2	1606	-	90	219110165	31890
chr2	219078275	219278275	harbor2	chr2	219110535	219110840	LINE/L2	1606	-	152	219110687	32412
chr2	219078275	219278275	harbor2	chr2	219126577	219127180	LINE/L2	807	-	302	219126879	48604
chr2	219078275	219278275	harbor2	chr2	219138516	219138847	LINE/L2	935	-	166	219138682	60407
chr2	219078275	219278275	harbor2	chr2	219140040	219140828	LINE/L2	2314	-	394	219140434	62159
chr2	219078275	219278275	harbor2	chr2	219140840	219141097	LINE/L2	811	-	128	219140968	62693
chr2	219078275	219278275	harbor2	chr2	219141391	219141893	LINE/L2	811	-	251	219141642	63367
chr2	219078275	219278275	harbor2	chr2	219144260	219144725	LINE/L2	631	-	232	219144492	66217
chr2	43056095	43256095	harbor2	chr2	43131894	43132186	LINE/L2	702	-	146	43132040	75945
chr2	43056095	43256095	harbor2	chr2	43134807	43134894	LINE/L2	788	-	44	43134851	78756
chr2	43056095	43256095	harbor2	chr2	43135205	43135263	LINE/L2	788	-	29	43135234	79139
chr2	43056095	43256095	harbor2	chr2	43135551	43135836	LINE/L2	788	-	142	43135693	79598
chr2	26956547	27156547	harbor2	chr2	26966653	26966822	LINE/L2	475	-	84	26966737	10190
chr2	26404185	26604185	harbor2	chr2	26429917	26430141	LINE/L2	678	-	112	26430029	25844
chr2	219078258	219278258	harbor2	chr2	219083068	219083253	LINE/L2	772	-	92	219083160	4902
chr2	219078258	219278258	harbor2	chr2	219096377	219096984	LINE/L2	2719	-	304	219096681	18423
chr2	219078258	219278258	harbor2	chr2	219097268	219097456	LINE/L2	2719	-	94	219097362	19104
chr2	219078258	219278258	harbor2	chr2	219097585	219097852	LINE/L2	2719	-	134	219097719	19461
chr2	219078258	219278258	harbor2	chr2	219097854	219098351	LINE/L2	457	-	248	219098102	19844
chr2	219078258	219278258	harbor2	chr2	219098386	219098668	LINE/L2	2683	-	141	219098527	20269
chr2	219078258	219278258	harbor2	chr2	219098793	219099198	LINE/L2	2683	-	202	219098995	20737
chr2	219078258	219278258	harbor2	chr2	219099417	219099962	LINE/L2	2683	-	272	219099689	21431
chr2	219078258	219278258	harbor2	chr2	219110075	219110254	LINE/L2	1606	-	90	219110165	31907
chr2	219078258	219278258	harbor2	chr2	219110535	219110840	LINE/L2	1606	-	152	219110687	32429
chr2	219078258	219278258	harbor2	chr2	219126577	219127180	LINE/L2	807	-	302	219126879	48621
chr2	219078258	219278258	harbor2	chr2	219138516	219138847	LINE/L2	935	-	166	219138682	60424
chr2	219078258	219278258	harbor2	chr2	219140040	219140828	LINE/L2	2314	-	394	219140434	62176
chr2	219078258	219278258	harbor2	chr2	219140840	219141097	LINE/L2	811	-	128	219140968	62710
chr2	219078258	219278258	harbor2	chr2	219141391	219141893	LINE/L2	811	-	251	219141642	63384
chr2	219078258	219278258	harbor2	chr2	219144260	219144725	LINE/L2	631	-	232	219144492	66234
chr2	219078269	219278269	harbor2	chr2	219083068	219083253	LINE/L2	772	-	92	219083160	4891
chr2	219078269	219278269	harbor2	chr2	219096377	219096984	LINE/L2	2719	-	304	219096681	18412
chr2	219078269	219278269	harbor2	chr2	219097268	219097456	LINE/L2	2719	-	94	219097362	19093
chr2	219078269	219278269	harbor2	chr2	219097585	219097852	LINE/L2	2719	-	134	219097719	19450
chr2	219078269	219278269	harbor2	chr2	219097854	219098351	LINE/L2	457	-	248	219098102	19833
chr2	219078269	219278269	harbor2	chr2	219098386	219098668	LINE/L2	2683	-	141	219098527	20258
chr2	219078269	219278269	harbor2	chr2	219098793	219099198	LINE/L2	2683	-	202	219098995	20726
chr2	219078269	219278269	harbor2	chr2	219099417	219099962	LINE/L2	2683	-	272	219099689	21420
chr2	219078269	219278269	harbor2	chr2	219110075	219110254	LINE/L2	1606	-	90	219110165	31896
chr2	219078269	219278269	harbor2	chr2	219110535	219110840	LINE/L2	1606	-	152	219110687	32418
chr2	219078269	219278269	harbor2	chr2	219126577	219127180	LINE/L2	807	-	302	219126879	48610
chr2	219078269	219278269	harbor2	chr2	219138516	219138847	LINE/L2	935	-	166	219138682	60413
chr2	219078269	219278269	harbor2	chr2	219140040	219140828	LINE/L2	2314	-	394	219140434	62165
chr2	219078269	219278269	harbor2	chr2	219140840	219141097	LINE/L2	811	-	128	219140968	62699
chr2	219078269	219278269	harbor2	chr2	219141391	219141893	LINE/L2	811	-	251	219141642	63373
chr2	219078269	219278269	harbor2	chr2	219144260	219144725	LINE/L2	631	-	232	219144492	66223
chr2	219078253	219278253	harbor2	chr2	219083068	219083253	LINE/L2	772	-	92	219083160	4907
chr2	219078253	219278253	harbor2	chr2	219096377	219096984	LINE/L2	2719	-	304	219096681	18428
chr2	219078253	219278253	harbor2	chr2	219097268	219097456	LINE/L2	2719	-	94	219097362	19109
chr2	219078253	219278253	harbor2	chr2	219097585	219097852	LINE/L2	2719	-	134	219097719	19466
chr2	219078253	219278253	harbor2	chr2	219097854	219098351	LINE/L2	457	-	248	219098102	19849
chr2	219078253	219278253	harbor2	chr2	219098386	219098668	LINE/L2	2683	-	141	219098527	20274
chr2	219078253	219278253	harbor2	chr2	219098793	219099198	LINE/L2	2683	-	202	219098995	20742
chr2	219078253	219278253	harbor2	chr2	219099417	219099962	LINE/L2	2683	-	272	219099689	21436
chr2	219078253	219278253	harbor2	chr2	219110075	219110254	LINE/L2	1606	-	90	219110165	31912
chr2	219078253	219278253	harbor2	chr2	219110535	219110840	LINE/L2	1606	-	152	219110687	32434
chr2	219078253	219278253	harbor2	chr2	219126577	219127180	LINE/L2	807	-	302	219126879	48626
chr2	219078253	219278253	harbor2	chr2	219138516	219138847	LINE/L2	935	-	166	219138682	60429
chr2	219078253	219278253	harbor2	chr2	219140040	219140828	LINE/L2	2314	-	394	219140434	62181
chr2	219078253	219278253	harbor2	chr2	219140840	219141097	LINE/L2	811	-	128	219140968	62715
chr2	219078253	219278253	harbor2	chr2	219141391	219141893	LINE/L2	811	-	251	219141642	63389
chr2	219078253	219278253	harbor2	chr2	219144260	219144725	LINE/L2	631	-	232	219144492	66239
chr2	3480298	3680298	harbor2	chr2	3535534	3535961	LINE/L2	646	-	214	3535748	55450
chr2	241049610	241249610	harbor2	chr2	241082927	241083495	LINE/L2	577	-	284	241083211	33601
chr2	85502763	85702763	harbor2	chr2	85507794	85507945	LINE/L2	1141	-	76	85507870	5107
chr2	85502763	85702763	harbor2	chr2	85509844	85510114	LINE/L2	1141	-	135	85509979	7216
chr2	27279123	27479123	harbor2	chr2	27343694	27343764	LINE/L2	501	-	35	27343729	64606
chr2	27279123	27479123	harbor2	chr2	27343897	27344018	LINE/L2	501	-	60	27343957	64834
chr2	113484990	113684990	harbor2	chr2	113560447	113561039	LINE/L2	1085	-	296	113560743	75753
chr2	113484990	113684990	harbor2	chr2	113567023	113567074	LINE/L2	906	-	26	113567049	82059
chr2	113484990	113684990	harbor2	chr2	113568479	113568810	LINE/L2	906	-	166	113568645	83655
chr2	113484990	113684990	harbor2	chr2	113568847	113568988	LINE/L2	616	-	70	113568917	83927
chr2	113484990	113684990	harbor2	chr2	113569295	113569672	LINE/L2	616	-	188	113569483	84493
chr2	113484990	113684990	harbor2	chr2	113572532	113572548	LINE/L2	780	-	8	113572540	87550
chr2	113484990	113684990	harbor2	chr2	113572829	113573146	LINE/L2	780	-	158	113572987	87997
chr2	113484990	113684990	harbor2	chr2	113575263	113575395	LINE/L2	588	-	66	113575329	90339
chr2	219078252	219278252	harbor2	chr2	219083068	219083253	LINE/L2	772	-	92	219083160	4908
chr2	219078252	219278252	harbor2	chr2	219096377	219096984	LINE/L2	2719	-	304	219096681	18429
chr2	219078252	219278252	harbor2	chr2	219097268	219097456	LINE/L2	2719	-	94	219097362	19110
chr2	219078252	219278252	harbor2	chr2	219097585	219097852	LINE/L2	2719	-	134	219097719	19467
chr2	219078252	219278252	harbor2	chr2	219097854	219098351	LINE/L2	457	-	248	219098102	19850
chr2	219078252	219278252	harbor2	chr2	219098386	219098668	LINE/L2	2683	-	141	219098527	20275
chr2	219078252	219278252	harbor2	chr2	219098793	219099198	LINE/L2	2683	-	202	219098995	20743
chr2	219078252	219278252	harbor2	chr2	219099417	219099962	LINE/L2	2683	-	272	219099689	21437
chr2	219078252	219278252	harbor2	chr2	219110075	219110254	LINE/L2	1606	-	90	219110165	31913
chr2	219078252	219278252	harbor2	chr2	219110535	219110840	LINE/L2	1606	-	152	219110687	32435
chr2	219078252	219278252	harbor2	chr2	219126577	219127180	LINE/L2	807	-	302	219126879	48627
chr2	219078252	219278252	harbor2	chr2	219138516	219138847	LINE/L2	935	-	166	219138682	60430
chr2	219078252	219278252	harbor2	chr2	219140040	219140828	LINE/L2	2314	-	394	219140434	62182
chr2	219078252	219278252	harbor2	chr2	219140840	219141097	LINE/L2	811	-	128	219140968	62716
chr2	219078252	219278252	harbor2	chr2	219141391	219141893	LINE/L2	811	-	251	219141642	63390
chr2	219078252	219278252	harbor2	chr2	219144260	219144725	LINE/L2	631	-	232	219144492	66240
chr2	219179881	219379881	harbor2	chr2	219221528	219221989	LINE/L2	1142	-	230	219221758	41877
chr2	219179881	219379881	harbor2	chr2	219241551	219241989	LINE/L2	1491	-	219	219241770	61889
chr2	219179881	219379881	harbor2	chr2	219263993	219264013	LINE/L2	973	-	10	219264003	84122
chr2	219179881	219379881	harbor2	chr2	219264848	219265127	LINE/L2	973	-	140	219264988	85107
chr2	242029286	242229286	harbor2	chr2	242077561	242077839	LINE/L2	761	-	139	242077700	48414
chr2	242029286	242229286	harbor2	chr2	242099935	242100750	LINE/L2	1348	-	408	242100343	71057
chr2	242029286	242229286	harbor2	chr2	242127175	242127725	LINE/L2	532	-	275	242127450	98164
chr2	242029286	242229286	harbor2	chr2	242127737	242127849	LINE/L2	565	-	56	242127793	98507
chr2	74426974	74626974	harbor2	chr2	74456289	74456689	LINE/L2	516	-	200	74456489	29515
chr2	74426974	74626974	harbor2	chr2	74456678	74456977	LINE/L2	767	-	150	74456828	29854
chr2	74426974	74626974	harbor2	chr2	74486389	74486610	LINE/L2	1105	-	110	74486499	59525
chr2	74426974	74626974	harbor2	chr2	74486909	74487141	LINE/L2	1105	-	116	74487025	60051
chr2	74426974	74626974	harbor2	chr2	74520137	74520592	LINE/L2	774	-	228	74520365	93391
chr2	74426974	74626974	harbor2	chr2	74521838	74522515	LINE/L2	640	-	338	74522176	95202
chr2	217854217	218054217	harbor2	chr2	217917290	217917547	LINE/L2	1114	-	128	217917418	63201
chr2	217854217	218054217	harbor2	chr2	217917851	217918187	LINE/L2	1114	-	168	217918019	63802
chr2	217854217	218054217	harbor2	chr2	217931028	217931203	LINE/L2	476	-	88	217931116	76899
chr2	113484950	113684950	harbor2	chr2	113560447	113561039	LINE/L2	1085	-	296	113560743	75793
chr2	113484950	113684950	harbor2	chr2	113567023	113567074	LINE/L2	906	-	26	113567049	82099
chr2	113484950	113684950	harbor2	chr2	113568479	113568810	LINE/L2	906	-	166	113568645	83695
chr2	113484950	113684950	harbor2	chr2	113568847	113568988	LINE/L2	616	-	70	113568917	83967
chr2	113484950	113684950	harbor2	chr2	113569295	113569672	LINE/L2	616	-	188	113569483	84533
chr2	113484950	113684950	harbor2	chr2	113572532	113572548	LINE/L2	780	-	8	113572540	87590
chr2	113484950	113684950	harbor2	chr2	113572829	113573146	LINE/L2	780	-	158	113572987	88037
chr2	113484950	113684950	harbor2	chr2	113575263	113575395	LINE/L2	588	-	66	113575329	90379
chr2	72787348	72987348	harbor2	chr2	72817487	72817665	LINE/L2	618	-	89	72817576	30228
chr2	72787348	72987348	harbor2	chr2	72845061	72845166	LINE/L2	529	-	52	72845113	57765
chr2	72787348	72987348	harbor2	chr2	72845210	72845253	LINE/L2	529	-	22	72845232	57884
chr2	72787348	72987348	harbor2	chr2	72846600	72846898	LINE/L2	529	-	149	72846749	59401
chr2	72787348	72987348	harbor2	chr2	72846877	72847131	LINE/L2	482	-	127	72847004	59656
chr2	72787348	72987348	harbor2	chr2	72847594	72847658	LINE/L2	482	-	32	72847626	60278
chr2	72787348	72987348	harbor2	chr2	72848348	72849362	LINE/L2	2218	-	507	72848855	61507
chr2	43459411	43659411	harbor2	chr2	43459408	43459565	LINE/L2	556	-	78	43459486	75
chr2	2617889	2817889	harbor2	chr2	2654910	2655137	LINE/L2	615	-	114	2655024	37135
chr2	2617889	2817889	harbor2	chr2	2670948	2671280	LINE/L2	470	-	166	2671114	53225
chr2	2617889	2817889	harbor2	chr2	2671617	2672182	LINE/L2	470	-	282	2671899	54010
chr2	2617889	2817889	harbor2	chr2	2681842	2682702	LINE/L2	1121	-	430	2682272	64383
chr2	43055466	43255466	harbor2	chr2	43131894	43132186	LINE/L2	702	-	146	43132040	76574
chr2	43055466	43255466	harbor2	chr2	43134807	43134894	LINE/L2	788	-	44	43134851	79385
chr2	43055466	43255466	harbor2	chr2	43135205	43135263	LINE/L2	788	-	29	43135234	79768
chr2	43055466	43255466	harbor2	chr2	43135551	43135836	LINE/L2	788	-	142	43135693	80227
chr2	85228038	85428038	harbor2	chr2	85238519	85238774	LINE/L2	575	-	128	85238647	10609
chr2	85228038	85428038	harbor2	chr2	85244018	85244534	LINE/L2	1149	-	258	85244276	16238
chr2	42069370	42269370	harbor2	chr2	42087332	42087448	LINE/L2	472	-	58	42087390	18020
chr2	42069370	42269370	harbor2	chr2	42092767	42093204	LINE/L2	579	-	218	42092985	23615
chr2	42069370	42269370	harbor2	chr2	42093396	42093466	LINE/L2	540	-	35	42093431	24061
chr2	42069370	42269370	harbor2	chr2	42093765	42093971	LINE/L2	540	-	103	42093868	24498
chr2	42069370	42269370	harbor2	chr2	42163001	42163101	LINE/L2	652	-	50	42163051	93681
chr2	242055177	242255177	harbor2	chr2	242077561	242077839	LINE/L2	761	-	139	242077700	22523
chr2	242055177	242255177	harbor2	chr2	242099935	242100750	LINE/L2	1348	-	408	242100343	45166
chr2	242055177	242255177	harbor2	chr2	242127175	242127725	LINE/L2	532	-	275	242127450	72273
chr2	242055177	242255177	harbor2	chr2	242127737	242127849	LINE/L2	565	-	56	242127793	72616
chr2	242055177	242255177	harbor2	chr2	242134557	242135213	LINE/L2	1346	-	328	242134885	79708
chr2	242055177	242255177	harbor2	chr2	242139006	242139543	LINE/L2	577	-	268	242139274	84097
chr2	219078268	219278268	harbor2	chr2	219083068	219083253	LINE/L2	772	-	92	219083160	4892
chr2	219078268	219278268	harbor2	chr2	219096377	219096984	LINE/L2	2719	-	304	219096681	18413
chr2	219078268	219278268	harbor2	chr2	219097268	219097456	LINE/L2	2719	-	94	219097362	19094
chr2	219078268	219278268	harbor2	chr2	219097585	219097852	LINE/L2	2719	-	134	219097719	19451
chr2	219078268	219278268	harbor2	chr2	219097854	219098351	LINE/L2	457	-	248	219098102	19834
chr2	219078268	219278268	harbor2	chr2	219098386	219098668	LINE/L2	2683	-	141	219098527	20259
chr2	219078268	219278268	harbor2	chr2	219098793	219099198	LINE/L2	2683	-	202	219098995	20727
chr2	219078268	219278268	harbor2	chr2	219099417	219099962	LINE/L2	2683	-	272	219099689	21421
chr2	219078268	219278268	harbor2	chr2	219110075	219110254	LINE/L2	1606	-	90	219110165	31897
chr2	219078268	219278268	harbor2	chr2	219110535	219110840	LINE/L2	1606	-	152	219110687	32419
chr2	219078268	219278268	harbor2	chr2	219126577	219127180	LINE/L2	807	-	302	219126879	48611
chr2	219078268	219278268	harbor2	chr2	219138516	219138847	LINE/L2	935	-	166	219138682	60414
chr2	219078268	219278268	harbor2	chr2	219140040	219140828	LINE/L2	2314	-	394	219140434	62166
chr2	219078268	219278268	harbor2	chr2	219140840	219141097	LINE/L2	811	-	128	219140968	62700
chr2	219078268	219278268	harbor2	chr2	219141391	219141893	LINE/L2	811	-	251	219141642	63374
chr2	219078268	219278268	harbor2	chr2	219144260	219144725	LINE/L2	631	-	232	219144492	66224
chr2	86515479	86715479	harbor2	chr2	86525792	86526046	LINE/L2	589	-	127	86525919	10440
chr2	86515479	86715479	harbor2	chr2	86588316	86588691	LINE/L2	466	-	188	86588504	73025
chr2	46271422	46471422	harbor2	chr2	46276468	46276804	LINE/L2	566	-	168	46276636	5214
chr2	46271422	46471422	harbor2	chr2	46284110	46284550	LINE/L2	575	-	220	46284330	12908
chr2	190914208	191114208	harbor2	chr2	190943188	190943568	LINE/L2	710	-	190	190943378	29170
chr2	190914208	191114208	harbor2	chr2	190949785	190950511	LINE/L2	574	-	363	190950148	35940
chr2	190914208	191114208	harbor2	chr2	190950756	190950971	LINE/L2	520	-	108	190950864	36656
chr2	113779869	113979869	harbor2	chr2	113811834	113812397	LINE/L2	622	-	282	113812116	32247
chr2	113779869	113979869	harbor2	chr2	113827408	113828110	LINE/L2	689	-	351	113827759	47890
chr2	43055483	43255483	harbor2	chr2	43131894	43132186	LINE/L2	702	-	146	43132040	76557
chr2	43055483	43255483	harbor2	chr2	43134807	43134894	LINE/L2	788	-	44	43134851	79368
chr2	43055483	43255483	harbor2	chr2	43135205	43135263	LINE/L2	788	-	29	43135234	79751
chr2	43055483	43255483	harbor2	chr2	43135551	43135836	LINE/L2	788	-	142	43135693	80210
chr2	219078246	219278246	harbor2	chr2	219083068	219083253	LINE/L2	772	-	92	219083160	4914
chr2	219078246	219278246	harbor2	chr2	219096377	219096984	LINE/L2	2719	-	304	219096681	18435
chr2	219078246	219278246	harbor2	chr2	219097268	219097456	LINE/L2	2719	-	94	219097362	19116
chr2	219078246	219278246	harbor2	chr2	219097585	219097852	LINE/L2	2719	-	134	219097719	19473
chr2	219078246	219278246	harbor2	chr2	219097854	219098351	LINE/L2	457	-	248	219098102	19856
chr2	219078246	219278246	harbor2	chr2	219098386	219098668	LINE/L2	2683	-	141	219098527	20281
chr2	219078246	219278246	harbor2	chr2	219098793	219099198	LINE/L2	2683	-	202	219098995	20749
chr2	219078246	219278246	harbor2	chr2	219099417	219099962	LINE/L2	2683	-	272	219099689	21443
chr2	219078246	219278246	harbor2	chr2	219110075	219110254	LINE/L2	1606	-	90	219110165	31919
chr2	219078246	219278246	harbor2	chr2	219110535	219110840	LINE/L2	1606	-	152	219110687	32441
chr2	219078246	219278246	harbor2	chr2	219126577	219127180	LINE/L2	807	-	302	219126879	48633
chr2	219078246	219278246	harbor2	chr2	219138516	219138847	LINE/L2	935	-	166	219138682	60436
chr2	219078246	219278246	harbor2	chr2	219140040	219140828	LINE/L2	2314	-	394	219140434	62188
chr2	219078246	219278246	harbor2	chr2	219140840	219141097	LINE/L2	811	-	128	219140968	62722
chr2	219078246	219278246	harbor2	chr2	219141391	219141893	LINE/L2	811	-	251	219141642	63396
chr2	219078246	219278246	harbor2	chr2	219144260	219144725	LINE/L2	631	-	232	219144492	66246
chr2	26950619	27150619	harbor2	chr2	26966653	26966822	LINE/L2	475	-	84	26966737	16118
chr2	168551031	168751031	harbor2	chr2	168575954	168576124	LINE/L2	448	-	85	168576039	25008
chr2	168551031	168751031	harbor2	chr2	168576808	168577855	LINE/L2	2433	-	524	168577332	26301
chr2	42261218	42461218	harbor2	chr2	42269388	42269769	LINE/L2	698	-	190	42269578	8360
chr2	127929061	128129061	harbor2	chr2	127978482	127978674	LINE/L2	469	-	96	127978578	49517
chr2	127929061	128129061	harbor2	chr2	127982120	127983072	LINE/L2	1254	-	476	127982596	53535
chr2	127929061	128129061	harbor2	chr2	127983427	127983678	LINE/L2	525	-	126	127983553	54492
chr2	87467266	87667266	harbor2	chr2	87556346	87556727	LINE/L2	477	-	190	87556536	89270
chr2	70771714	70971714	harbor2	chr2	70813264	70813482	LINE/L2	460	-	109	70813373	41659
chr2	70771714	70971714	harbor2	chr2	70813975	70814385	LINE/L2	460	-	205	70814180	42466
chr2	200603208	200803208	harbor2	chr2	200672509	200673107	LINE/L2	997	-	299	200672808	69600
chr2	111955657	112155657	harbor2	chr2	111998401	111998724	LINE/L2	536	-	162	111998563	42906
chr2	113497566	113697566	harbor2	chr2	113560447	113561039	LINE/L2	1085	-	296	113560743	63177
chr2	113497566	113697566	harbor2	chr2	113567023	113567074	LINE/L2	906	-	26	113567049	69483
chr2	113497566	113697566	harbor2	chr2	113568479	113568810	LINE/L2	906	-	166	113568645	71079
chr2	113497566	113697566	harbor2	chr2	113568847	113568988	LINE/L2	616	-	70	113568917	71351
chr2	113497566	113697566	harbor2	chr2	113569295	113569672	LINE/L2	616	-	188	113569483	71917
chr2	113497566	113697566	harbor2	chr2	113572532	113572548	LINE/L2	780	-	8	113572540	74974
chr2	113497566	113697566	harbor2	chr2	113572829	113573146	LINE/L2	780	-	158	113572987	75421
chr2	113497566	113697566	harbor2	chr2	113575263	113575395	LINE/L2	588	-	66	113575329	77763
chr2	86976784	87176784	harbor2	chr2	87027676	87027967	LINE/L2	516	-	146	87027822	51038
chr2	86976784	87176784	harbor2	chr2	87028410	87028456	LINE/L2	516	-	23	87028433	51649
chr2	86976784	87176784	harbor2	chr2	87028623	87028938	LINE/L2	794	-	158	87028781	51997
chr2	86976784	87176784	harbor2	chr2	87029153	87029521	LINE/L2	794	-	184	87029337	52553
chr2	86976784	87176784	harbor2	chr2	87057591	87058173	LINE/L2	2073	-	291	87057882	81098
chr2	86976784	87176784	harbor2	chr2	87058466	87058685	LINE/L2	2073	-	110	87058576	81792
chr2	86976784	87176784	harbor2	chr2	87058930	87059134	LINE/L2	2073	-	102	87059032	82248
chr2	86976784	87176784	harbor2	chr2	87059160	87059527	LINE/L2	2073	-	184	87059344	82560
chr2	63489005	63689005	harbor2	chr2	63587164	63587403	LINE/L2	484	-	120	63587284	98279
chr2	26957456	27157456	harbor2	chr2	26966653	26966822	LINE/L2	475	-	84	26966737	9281
chr2	42069378	42269378	harbor2	chr2	42087332	42087448	LINE/L2	472	-	58	42087390	18012
chr2	42069378	42269378	harbor2	chr2	42092767	42093204	LINE/L2	579	-	218	42092985	23607
chr2	42069378	42269378	harbor2	chr2	42093396	42093466	LINE/L2	540	-	35	42093431	24053
chr2	42069378	42269378	harbor2	chr2	42093765	42093971	LINE/L2	540	-	103	42093868	24490
chr2	42069378	42269378	harbor2	chr2	42163001	42163101	LINE/L2	652	-	50	42163051	93673
chr2	74415881	74615881	harbor2	chr2	74456289	74456689	LINE/L2	516	-	200	74456489	40608
chr2	74415881	74615881	harbor2	chr2	74456678	74456977	LINE/L2	767	-	150	74456828	40947
chr2	74415881	74615881	harbor2	chr2	74486389	74486610	LINE/L2	1105	-	110	74486499	70618
chr2	74415881	74615881	harbor2	chr2	74486909	74487141	LINE/L2	1105	-	116	74487025	71144
chr2	120748875	120948875	harbor2	chr2	120811871	120812068	LINE/L2	527	-	98	120811969	63094
chr2	203717178	203917178	harbor2	chr2	203733340	203733819	LINE/L2	883	-	240	203733580	16402
chr2	203717178	203917178	harbor2	chr2	203748720	203749138	LINE/L2	822	-	209	203748929	31751
chr2	203717178	203917178	harbor2	chr2	203750285	203750529	LINE/L2	527	-	122	203750407	33229
chr2	219343736	219543736	harbor2	chr2	219397510	219397714	LINE/L2	646	-	102	219397612	53876
chr2	74427953	74627953	harbor2	chr2	74456289	74456689	LINE/L2	516	-	200	74456489	28536
chr2	74427953	74627953	harbor2	chr2	74456678	74456977	LINE/L2	767	-	150	74456828	28875
chr2	74427953	74627953	harbor2	chr2	74486389	74486610	LINE/L2	1105	-	110	74486499	58546
chr2	74427953	74627953	harbor2	chr2	74486909	74487141	LINE/L2	1105	-	116	74487025	59072
chr2	74427953	74627953	harbor2	chr2	74520137	74520592	LINE/L2	774	-	228	74520365	92412
chr2	74427953	74627953	harbor2	chr2	74521838	74522515	LINE/L2	640	-	338	74522176	94223
chr2	26950608	27150608	harbor2	chr2	26966653	26966822	LINE/L2	475	-	84	26966737	16129
chr2	240592789	240792789	harbor2	chr2	240611536	240612013	LINE/L2	752	-	238	240611774	18985
chr2	56085624	56285624	harbor2	chr2	56166773	56167551	LINE/L2	2079	-	389	56167162	81538
chr2	56085624	56285624	harbor2	chr2	56147586	56148039	LINE/L2	558	-	226	56147812	62188
chr2	56148544	56348544	harbor2	chr2	56166773	56167551	LINE/L2	2079	-	389	56167162	18618
chr2	56148544	56348544	harbor2	chr2	56219780	56220171	LINE/L2	499	-	196	56219976	71432
chr2	6845395	7045395	harbor2	chr2	6942386	6942701	LINE/L2	1218	-	158	6942544	97149
chr2	6845395	7045395	harbor2	chr2	6942987	6943311	LINE/L2	1218	-	162	6943149	97754
chr2	70771713	70971713	harbor2	chr2	70813264	70813482	LINE/L2	460	-	109	70813373	41660
chr2	70771713	70971713	harbor2	chr2	70813975	70814385	LINE/L2	460	-	205	70814180	42467
chr2	130084190	130284190	harbor2	chr2	130095909	130096659	LINE/L2	2013	-	375	130096284	12094
chr2	130084190	130284190	harbor2	chr2	130096961	130097332	LINE/L2	2013	-	186	130097147	12957
chr2	162740814	162940814	harbor2	chr2	162749336	162749657	LINE/L2	725	-	160	162749496	8682
chr2	162740814	162940814	harbor2	chr2	162782162	162782672	LINE/L2	1416	-	255	162782417	41603
chr2	27272823	27472823	harbor2	chr2	27273053	27273092	LINE/L2	566	-	20	27273073	250
chr2	27272823	27472823	harbor2	chr2	27273123	27273417	LINE/L2	566	-	147	27273270	447
chr2	27272823	27472823	harbor2	chr2	27343694	27343764	LINE/L2	501	-	35	27343729	70906
chr2	27272823	27472823	harbor2	chr2	27343897	27344018	LINE/L2	501	-	60	27343957	71134
chr2	26246115	26446115	harbor2	chr2	26295915	26296018	LINE/L2	450	-	52	26295967	49852
chr2	26246115	26446115	harbor2	chr2	26335963	26336253	LINE/L2	492	-	145	26336108	89993
chr2	26403683	26603683	harbor2	chr2	26429917	26430141	LINE/L2	678	-	112	26430029	26346
chr2	74272719	74472719	harbor2	chr2	74359434	74359851	LINE/L2	463	-	208	74359642	86923
chr2	207669644	207869644	harbor2	chr2	207743980	207744352	LINE/L2	559	-	186	207744166	74522
chr2	74415899	74615899	harbor2	chr2	74456289	74456689	LINE/L2	516	-	200	74456489	40590
chr2	74415899	74615899	harbor2	chr2	74456678	74456977	LINE/L2	767	-	150	74456828	40929
chr2	74415899	74615899	harbor2	chr2	74486389	74486610	LINE/L2	1105	-	110	74486499	70600
chr2	74415899	74615899	harbor2	chr2	74486909	74487141	LINE/L2	1105	-	116	74487025	71126
chr2	46225653	46425653	harbor2	chr2	46276468	46276804	LINE/L2	566	-	168	46276636	50983
chr2	46225653	46425653	harbor2	chr2	46284110	46284550	LINE/L2	575	-	220	46284330	58677
chr2	219497764	219697764	harbor2	chr2	219502643	219502844	LINE/L2	556	-	100	219502743	4979
chr2	219497764	219697764	harbor2	chr2	219533363	219533750	LINE/L2	495	-	194	219533557	35793
chr2	219497764	219697764	harbor2	chr2	219548239	219548891	LINE/L2	836	-	326	219548565	50801
chr2	219081092	219281092	harbor2	chr2	219083068	219083253	LINE/L2	772	-	92	219083160	2068
chr2	219081092	219281092	harbor2	chr2	219096377	219096984	LINE/L2	2719	-	304	219096681	15589
chr2	219081092	219281092	harbor2	chr2	219097268	219097456	LINE/L2	2719	-	94	219097362	16270
chr2	219081092	219281092	harbor2	chr2	219097585	219097852	LINE/L2	2719	-	134	219097719	16627
chr2	219081092	219281092	harbor2	chr2	219097854	219098351	LINE/L2	457	-	248	219098102	17010
chr2	219081092	219281092	harbor2	chr2	219098386	219098668	LINE/L2	2683	-	141	219098527	17435
chr2	219081092	219281092	harbor2	chr2	219098793	219099198	LINE/L2	2683	-	202	219098995	17903
chr2	219081092	219281092	harbor2	chr2	219099417	219099962	LINE/L2	2683	-	272	219099689	18597
chr2	219081092	219281092	harbor2	chr2	219110075	219110254	LINE/L2	1606	-	90	219110165	29073
chr2	219081092	219281092	harbor2	chr2	219110535	219110840	LINE/L2	1606	-	152	219110687	29595
chr2	219081092	219281092	harbor2	chr2	219126577	219127180	LINE/L2	807	-	302	219126879	45787
chr2	219081092	219281092	harbor2	chr2	219138516	219138847	LINE/L2	935	-	166	219138682	57590
chr2	219081092	219281092	harbor2	chr2	219140040	219140828	LINE/L2	2314	-	394	219140434	59342
chr2	219081092	219281092	harbor2	chr2	219140840	219141097	LINE/L2	811	-	128	219140968	59876
chr2	219081092	219281092	harbor2	chr2	219141391	219141893	LINE/L2	811	-	251	219141642	60550
chr2	219081092	219281092	harbor2	chr2	219144260	219144725	LINE/L2	631	-	232	219144492	63400
chr2	160417009	160617009	harbor2	chr2	160454292	160454821	LINE/L2	493	-	264	160454556	37547
chr2	219116633	219316633	harbor2	chr2	219126577	219127180	LINE/L2	807	-	302	219126879	10246
chr2	219116633	219316633	harbor2	chr2	219138516	219138847	LINE/L2	935	-	166	219138682	22049
chr2	219116633	219316633	harbor2	chr2	219140040	219140828	LINE/L2	2314	-	394	219140434	23801
chr2	219116633	219316633	harbor2	chr2	219140840	219141097	LINE/L2	811	-	128	219140968	24335
chr2	219116633	219316633	harbor2	chr2	219141391	219141893	LINE/L2	811	-	251	219141642	25009
chr2	219116633	219316633	harbor2	chr2	219144260	219144725	LINE/L2	631	-	232	219144492	27859
chr2	28765454	28965454	harbor2	chr2	28854128	28854329	LINE/L2	570	-	100	28854228	88774
chr2	28765454	28965454	harbor2	chr2	28854933	28855297	LINE/L2	570	-	182	28855115	89661
chr2	219078263	219278263	harbor2	chr2	219083068	219083253	LINE/L2	772	-	92	219083160	4897
chr2	219078263	219278263	harbor2	chr2	219096377	219096984	LINE/L2	2719	-	304	219096681	18418
chr2	219078263	219278263	harbor2	chr2	219097268	219097456	LINE/L2	2719	-	94	219097362	19099
chr2	219078263	219278263	harbor2	chr2	219097585	219097852	LINE/L2	2719	-	134	219097719	19456
chr2	219078263	219278263	harbor2	chr2	219097854	219098351	LINE/L2	457	-	248	219098102	19839
chr2	219078263	219278263	harbor2	chr2	219098386	219098668	LINE/L2	2683	-	141	219098527	20264
chr2	219078263	219278263	harbor2	chr2	219098793	219099198	LINE/L2	2683	-	202	219098995	20732
chr2	219078263	219278263	harbor2	chr2	219099417	219099962	LINE/L2	2683	-	272	219099689	21426
chr2	219078263	219278263	harbor2	chr2	219110075	219110254	LINE/L2	1606	-	90	219110165	31902
chr2	219078263	219278263	harbor2	chr2	219110535	219110840	LINE/L2	1606	-	152	219110687	32424
chr2	219078263	219278263	harbor2	chr2	219126577	219127180	LINE/L2	807	-	302	219126879	48616
chr2	219078263	219278263	harbor2	chr2	219138516	219138847	LINE/L2	935	-	166	219138682	60419
chr2	219078263	219278263	harbor2	chr2	219140040	219140828	LINE/L2	2314	-	394	219140434	62171
chr2	219078263	219278263	harbor2	chr2	219140840	219141097	LINE/L2	811	-	128	219140968	62705
chr2	219078263	219278263	harbor2	chr2	219141391	219141893	LINE/L2	811	-	251	219141642	63379
chr2	219078263	219278263	harbor2	chr2	219144260	219144725	LINE/L2	631	-	232	219144492	66229
chr2	53795907	53995907	harbor2	chr2	53828888	53829646	LINE/L2	1864	-	379	53829267	33360
chr2	70826505	71026505	harbor2	chr2	70924720	70925145	LINE/L2	727	-	212	70924932	98427
chr2	219169703	219369703	harbor2	chr2	219221528	219221989	LINE/L2	1142	-	230	219221758	52055
chr2	219169703	219369703	harbor2	chr2	219241551	219241989	LINE/L2	1491	-	219	219241770	72067
chr2	219169703	219369703	harbor2	chr2	219263993	219264013	LINE/L2	973	-	10	219264003	94300
chr2	219169703	219369703	harbor2	chr2	219264848	219265127	LINE/L2	973	-	140	219264988	95285
chr2	74372415	74572415	harbor2	chr2	74456289	74456689	LINE/L2	516	-	200	74456489	84074
chr2	74372415	74572415	harbor2	chr2	74456678	74456977	LINE/L2	767	-	150	74456828	84413
chr2	26950206	27150206	harbor2	chr2	26966653	26966822	LINE/L2	475	-	84	26966737	16531
chr2	111955694	112155694	harbor2	chr2	111998401	111998724	LINE/L2	536	-	162	111998563	42869
chr2	26416022	26616022	harbor2	chr2	26429917	26430141	LINE/L2	678	-	112	26430029	14007
chr2	219078270	219278270	harbor2	chr2	219083068	219083253	LINE/L2	772	-	92	219083160	4890
chr2	219078270	219278270	harbor2	chr2	219096377	219096984	LINE/L2	2719	-	304	219096681	18411
chr2	219078270	219278270	harbor2	chr2	219097268	219097456	LINE/L2	2719	-	94	219097362	19092
chr2	219078270	219278270	harbor2	chr2	219097585	219097852	LINE/L2	2719	-	134	219097719	19449
chr2	219078270	219278270	harbor2	chr2	219097854	219098351	LINE/L2	457	-	248	219098102	19832
chr2	219078270	219278270	harbor2	chr2	219098386	219098668	LINE/L2	2683	-	141	219098527	20257
chr2	219078270	219278270	harbor2	chr2	219098793	219099198	LINE/L2	2683	-	202	219098995	20725
chr2	219078270	219278270	harbor2	chr2	219099417	219099962	LINE/L2	2683	-	272	219099689	21419
chr2	219078270	219278270	harbor2	chr2	219110075	219110254	LINE/L2	1606	-	90	219110165	31895
chr2	219078270	219278270	harbor2	chr2	219110535	219110840	LINE/L2	1606	-	152	219110687	32417
chr2	219078270	219278270	harbor2	chr2	219126577	219127180	LINE/L2	807	-	302	219126879	48609
chr2	219078270	219278270	harbor2	chr2	219138516	219138847	LINE/L2	935	-	166	219138682	60412
chr2	219078270	219278270	harbor2	chr2	219140040	219140828	LINE/L2	2314	-	394	219140434	62164
chr2	219078270	219278270	harbor2	chr2	219140840	219141097	LINE/L2	811	-	128	219140968	62698
chr2	219078270	219278270	harbor2	chr2	219141391	219141893	LINE/L2	811	-	251	219141642	63372
chr2	219078270	219278270	harbor2	chr2	219144260	219144725	LINE/L2	631	-	232	219144492	66222
chr2	120666618	120866618	harbor2	chr2	120699596	120699837	LINE/L2	452	-	120	120699716	33098
chr2	120666618	120866618	harbor2	chr2	120700307	120700321	LINE/L2	452	-	7	120700314	33696
chr2	120666618	120866618	harbor2	chr2	120723392	120723574	LINE/L2	466	-	91	120723483	56865
chr2	70771742	70971742	harbor2	chr2	70813264	70813482	LINE/L2	460	-	109	70813373	41631
chr2	70771742	70971742	harbor2	chr2	70813975	70814385	LINE/L2	460	-	205	70814180	42438
chr2	217616860	217816860	harbor2	chr2	217642032	217642599	LINE/L2	1077	-	284	217642316	25456
chr2	26950220	27150220	harbor2	chr2	26966653	26966822	LINE/L2	475	-	84	26966737	16517
chr2	178350868	178550868	harbor2	chr2	178391882	178391991	LINE/L2	468	-	54	178391936	41068
chr2	178350868	178550868	harbor2	chr2	178448639	178449127	LINE/L2	622	-	244	178448883	98015
chr2	26950698	27150698	harbor2	chr2	26966653	26966822	LINE/L2	475	-	84	26966737	16039
chr2	111956912	112156912	harbor2	chr2	111998401	111998724	LINE/L2	536	-	162	111998563	41651
chr2	43173998	43373998	harbor2	chr2	43180994	43181891	LINE/L2	734	-	448	43181442	7444
chr2	43173998	43373998	harbor2	chr2	43271499	43271612	LINE/L2	938	-	56	43271555	97557
chr2	43173998	43373998	harbor2	chr2	43271915	43272434	LINE/L2	938	-	260	43272175	98177
chr2	48215708	48415708	harbor2	chr2	48252293	48254630	LINE/L2	6119	-	1168	48253461	37753
chr2	48215708	48415708	harbor2	chr2	48254995	48256174	LINE/L2	6119	-	590	48255585	39877
chr2	48215708	48415708	harbor2	chr2	48256175	48256508	LINE/L2	549	-	166	48256341	40633
chr2	48215708	48415708	harbor2	chr2	48263066	48263397	LINE/L2	726	-	166	48263232	47524
chr2	48215708	48415708	harbor2	chr2	48295611	48296364	LINE/L2	1356	-	376	48295987	80279
chr2	148421838	148621838	harbor2	chr2	148442432	148442556	LINE/L2	484	-	62	148442494	20656
chr2	148421838	148621838	harbor2	chr2	148487519	148487712	LINE/L2	488	-	96	148487615	65777
chr2	148421838	148621838	harbor2	chr2	148518171	148518707	LINE/L2	453	-	268	148518439	96601
chr2	148421838	148621838	harbor2	chr2	148487900	148488522	LINE/L2	509	-	311	148488211	66373
chr2	65025318	65225318	harbor2	chr2	65034182	65034604	LINE/L2	1100	-	211	65034393	9075
chr2	219501939	219701939	harbor2	chr2	219502643	219502844	LINE/L2	556	-	100	219502743	804
chr2	219501939	219701939	harbor2	chr2	219533363	219533750	LINE/L2	495	-	194	219533557	31618
chr2	219501939	219701939	harbor2	chr2	219548239	219548891	LINE/L2	836	-	326	219548565	46626
chr2	113484926	113684926	harbor2	chr2	113560447	113561039	LINE/L2	1085	-	296	113560743	75817
chr2	113484926	113684926	harbor2	chr2	113567023	113567074	LINE/L2	906	-	26	113567049	82123
chr2	113484926	113684926	harbor2	chr2	113568479	113568810	LINE/L2	906	-	166	113568645	83719
chr2	113484926	113684926	harbor2	chr2	113568847	113568988	LINE/L2	616	-	70	113568917	83991
chr2	113484926	113684926	harbor2	chr2	113569295	113569672	LINE/L2	616	-	188	113569483	84557
chr2	113484926	113684926	harbor2	chr2	113572532	113572548	LINE/L2	780	-	8	113572540	87614
chr2	113484926	113684926	harbor2	chr2	113572829	113573146	LINE/L2	780	-	158	113572987	88061
chr2	113484926	113684926	harbor2	chr2	113575263	113575395	LINE/L2	588	-	66	113575329	90403
chr2	218180022	218380022	harbor2	chr2	218192085	218192370	LINE/L2	515	-	142	218192227	12205
chr2	219078284	219278284	harbor2	chr2	219083068	219083253	LINE/L2	772	-	92	219083160	4876
chr2	219078284	219278284	harbor2	chr2	219096377	219096984	LINE/L2	2719	-	304	219096681	18397
chr2	219078284	219278284	harbor2	chr2	219097268	219097456	LINE/L2	2719	-	94	219097362	19078
chr2	219078284	219278284	harbor2	chr2	219097585	219097852	LINE/L2	2719	-	134	219097719	19435
chr2	219078284	219278284	harbor2	chr2	219097854	219098351	LINE/L2	457	-	248	219098102	19818
chr2	219078284	219278284	harbor2	chr2	219098386	219098668	LINE/L2	2683	-	141	219098527	20243
chr2	219078284	219278284	harbor2	chr2	219098793	219099198	LINE/L2	2683	-	202	219098995	20711
chr2	219078284	219278284	harbor2	chr2	219099417	219099962	LINE/L2	2683	-	272	219099689	21405
chr2	219078284	219278284	harbor2	chr2	219110075	219110254	LINE/L2	1606	-	90	219110165	31881
chr2	219078284	219278284	harbor2	chr2	219110535	219110840	LINE/L2	1606	-	152	219110687	32403
chr2	219078284	219278284	harbor2	chr2	219126577	219127180	LINE/L2	807	-	302	219126879	48595
chr2	219078284	219278284	harbor2	chr2	219138516	219138847	LINE/L2	935	-	166	219138682	60398
chr2	219078284	219278284	harbor2	chr2	219140040	219140828	LINE/L2	2314	-	394	219140434	62150
chr2	219078284	219278284	harbor2	chr2	219140840	219141097	LINE/L2	811	-	128	219140968	62684
chr2	219078284	219278284	harbor2	chr2	219141391	219141893	LINE/L2	811	-	251	219141642	63358
chr2	219078284	219278284	harbor2	chr2	219144260	219144725	LINE/L2	631	-	232	219144492	66208
chr2	219387359	219587359	harbor2	chr2	219397510	219397714	LINE/L2	646	-	102	219397612	10253
chr2	42069367	42269367	harbor2	chr2	42087332	42087448	LINE/L2	472	-	58	42087390	18023
chr2	42069367	42269367	harbor2	chr2	42092767	42093204	LINE/L2	579	-	218	42092985	23618
chr2	42069367	42269367	harbor2	chr2	42093396	42093466	LINE/L2	540	-	35	42093431	24064
chr2	42069367	42269367	harbor2	chr2	42093765	42093971	LINE/L2	540	-	103	42093868	24501
chr2	42069367	42269367	harbor2	chr2	42163001	42163101	LINE/L2	652	-	50	42163051	93684
chr2	26246633	26446633	harbor2	chr2	26295915	26296018	LINE/L2	450	-	52	26295967	49334
chr2	26246633	26446633	harbor2	chr2	26335963	26336253	LINE/L2	492	-	145	26336108	89475
chr2	42069757	42269757	harbor2	chr2	42087332	42087448	LINE/L2	472	-	58	42087390	17633
chr2	42069757	42269757	harbor2	chr2	42092767	42093204	LINE/L2	579	-	218	42092985	23228
chr2	42069757	42269757	harbor2	chr2	42093396	42093466	LINE/L2	540	-	35	42093431	23674
chr2	42069757	42269757	harbor2	chr2	42093765	42093971	LINE/L2	540	-	103	42093868	24111
chr2	42069757	42269757	harbor2	chr2	42163001	42163101	LINE/L2	652	-	50	42163051	93294
chr2	219118932	219318932	harbor2	chr2	219126577	219127180	LINE/L2	807	-	302	219126879	7947
chr2	219118932	219318932	harbor2	chr2	219138516	219138847	LINE/L2	935	-	166	219138682	19750
chr2	219118932	219318932	harbor2	chr2	219140040	219140828	LINE/L2	2314	-	394	219140434	21502
chr2	219118932	219318932	harbor2	chr2	219140840	219141097	LINE/L2	811	-	128	219140968	22036
chr2	219118932	219318932	harbor2	chr2	219141391	219141893	LINE/L2	811	-	251	219141642	22710
chr2	219118932	219318932	harbor2	chr2	219144260	219144725	LINE/L2	631	-	232	219144492	25560
chr2	105442419	105642419	harbor2	chr2	105467480	105467825	LINE/L2	847	-	172	105467652	25233
chr2	105442419	105642419	harbor2	chr2	105468462	105468771	LINE/L2	847	-	154	105468616	26197
chr2	113484846	113684846	harbor2	chr2	113560447	113561039	LINE/L2	1085	-	296	113560743	75897
chr2	113484846	113684846	harbor2	chr2	113567023	113567074	LINE/L2	906	-	26	113567049	82203
chr2	113484846	113684846	harbor2	chr2	113568479	113568810	LINE/L2	906	-	166	113568645	83799
chr2	113484846	113684846	harbor2	chr2	113568847	113568988	LINE/L2	616	-	70	113568917	84071
chr2	113484846	113684846	harbor2	chr2	113569295	113569672	LINE/L2	616	-	188	113569483	84637
chr2	113484846	113684846	harbor2	chr2	113572532	113572548	LINE/L2	780	-	8	113572540	87694
chr2	113484846	113684846	harbor2	chr2	113572829	113573146	LINE/L2	780	-	158	113572987	88141
chr2	113484846	113684846	harbor2	chr2	113575263	113575395	LINE/L2	588	-	66	113575329	90483
chr2	72971510	73171510	harbor2	chr2	72982482	72982909	LINE/L2	480	-	214	72982696	11186
chr2	72971510	73171510	harbor2	chr2	73033202	73033790	LINE/L2	1790	-	294	73033496	61986
chr2	72971510	73171510	harbor2	chr2	73034007	73034139	LINE/L2	1114	-	66	73034073	62563
chr2	72971510	73171510	harbor2	chr2	73068622	73069516	LINE/L2	677	-	447	73069069	97559
chr2	26960509	27160509	harbor2	chr2	26966653	26966822	LINE/L2	475	-	84	26966737	6228
chr2	199357332	199557332	harbor2	chr2	199401570	199402063	LINE/L2	730	-	246	199401816	44484
chr2	199357332	199557332	harbor2	chr2	199376634	199376924	LINE/L2	501	-	145	199376779	19447
chr2	218241926	218441926	harbor2	chr2	218295235	218295681	LINE/L2	656	-	223	218295458	53532
chr2	218241926	218441926	harbor2	chr2	218301849	218302067	LINE/L2	626	-	109	218301958	60032
chr2	218241926	218441926	harbor2	chr2	218302367	218302673	LINE/L2	626	-	153	218302520	60594
chr2	218241926	218441926	harbor2	chr2	218318622	218318886	LINE/L2	636	-	132	218318754	76828
chr2	96108919	96308919	harbor2	chr2	96152139	96152814	LINE/L2	551	-	338	96152477	43558
chr2	96108919	96308919	harbor2	chr2	96161802	96162031	LINE/L2	710	-	114	96161916	52997
chr2	219467910	219667910	harbor2	chr2	219502643	219502844	LINE/L2	556	-	100	219502743	34833
chr2	219467910	219667910	harbor2	chr2	219533363	219533750	LINE/L2	495	-	194	219533557	65647
chr2	219467910	219667910	harbor2	chr2	219548239	219548891	LINE/L2	836	-	326	219548565	80655
chr2	111957164	112157164	harbor2	chr2	111998401	111998724	LINE/L2	536	-	162	111998563	41399
chr2	120635614	120835614	harbor2	chr2	120699596	120699837	LINE/L2	452	-	120	120699716	64102
chr2	120635614	120835614	harbor2	chr2	120700307	120700321	LINE/L2	452	-	7	120700314	64700
chr2	120635614	120835614	harbor2	chr2	120723392	120723574	LINE/L2	466	-	91	120723483	87869
chr3	107992947	108192947	harbor2	chr3	108073561	108073826	LINE/L2	545	-	132	108073693	80746
chr3	107992058	108192058	harbor2	chr3	108073561	108073826	LINE/L2	545	-	132	108073693	81635
chr3	107999874	108199874	harbor2	chr3	108073561	108073826	LINE/L2	545	-	132	108073693	73819
chr3	54754036	54954036	harbor2	chr3	54760103	54760966	LINE/L2	1257	-	432	54760535	6499
chr3	178973707	179173707	harbor2	chr3	179037812	179038145	LINE/L2	550	-	166	179037978	64271
chr3	178973707	179173707	harbor2	chr3	179038134	179038298	LINE/L2	431	-	82	179038216	64509
chr3	178973707	179173707	harbor2	chr3	179045841	179046264	LINE/L2	650	-	212	179046053	72346
chr3	32471408	32671408	harbor2	chr3	32493444	32494090	LINE/L2	405	-	323	32493767	22359
chr3	51941658	52141658	harbor2	chr3	51952331	51952537	LINE/L2	913	-	103	51952434	10776
chr3	51941658	52141658	harbor2	chr3	51953147	51953545	LINE/L2	1238	-	199	51953346	11688
chr3	51941658	52141658	harbor2	chr3	51953994	51954396	LINE/L2	1238	-	201	51954195	12537
chr3	51941658	52141658	harbor2	chr3	51996824	51997118	LINE/L2	410	-	147	51996971	55313
chr3	51940304	52140304	harbor2	chr3	51952331	51952537	LINE/L2	913	-	103	51952434	12130
chr3	51940304	52140304	harbor2	chr3	51953147	51953545	LINE/L2	1238	-	199	51953346	13042
chr3	51940304	52140304	harbor2	chr3	51953994	51954396	LINE/L2	1238	-	201	51954195	13891
chr3	51940304	52140304	harbor2	chr3	51996824	51997118	LINE/L2	410	-	147	51996971	56667
chr3	49589436	49789436	harbor2	chr3	49619880	49620190	LINE/L2	615	-	155	49620035	30599
chr3	49589436	49789436	harbor2	chr3	49620455	49620706	LINE/L2	2090	-	126	49620581	31145
chr3	49589436	49789436	harbor2	chr3	49620956	49621714	LINE/L2	2090	-	379	49621335	31899
chr3	49589436	49789436	harbor2	chr3	49621887	49622364	LINE/L2	776	-	238	49622125	32689
chr3	49589436	49789436	harbor2	chr3	49666353	49666842	LINE/L2	752	-	244	49666597	77161
chr3	132356932	132556932	harbor2	chr3	132362395	132362832	LINE/L2	511	-	218	132362613	5681
chr3	132356932	132556932	harbor2	chr3	132365112	132365700	LINE/L2	2498	-	294	132365406	8474
chr3	132356932	132556932	harbor2	chr3	132366004	132366018	LINE/L2	2498	-	7	132366011	9079
chr3	132356932	132556932	harbor2	chr3	132431158	132431543	LINE/L2	817	-	192	132431350	74418
chr3	132356932	132556932	harbor2	chr3	132366316	132366803	LINE/L2	2498	-	244	132366560	9628
chr3	156989183	157189183	harbor2	chr3	157021995	157022064	LINE/L2	633	-	34	157022029	32846
chr3	156989183	157189183	harbor2	chr3	157022243	157022739	LINE/L2	633	-	248	157022491	33308
chr3	156989183	157189183	harbor2	chr3	157037727	157038336	LINE/L2	1083	-	304	157038031	48848
chr3	156989183	157189183	harbor2	chr3	157038430	157038691	LINE/L2	646	-	130	157038560	49377
chr3	156989183	157189183	harbor2	chr3	157084055	157084644	LINE/L2	401	-	294	157084349	95166
chr3	156989183	157189183	harbor2	chr3	157007832	157007964	LINE/L2	455	-	66	157007898	18715
chr3	107993020	108193020	harbor2	chr3	108073561	108073826	LINE/L2	545	-	132	108073693	80673
chr3	127490780	127690780	harbor2	chr3	127526393	127526877	LINE/L2	806	-	242	127526635	35855
chr3	127490780	127690780	harbor2	chr3	127543382	127543911	LINE/L2	801	-	264	127543646	52866
chr3	127490780	127690780	harbor2	chr3	127544969	127545342	LINE/L2	411	-	186	127545155	54375
chr3	127490780	127690780	harbor2	chr3	127557051	127557336	LINE/L2	406	-	142	127557193	66413
chr3	127490780	127690780	harbor2	chr3	127559901	127560109	LINE/L2	544	-	104	127560005	69225
chr3	127490780	127690780	harbor2	chr3	127585172	127585692	LINE/L2	582	-	260	127585432	94652
chr3	51939426	52139426	harbor2	chr3	51952331	51952537	LINE/L2	913	-	103	51952434	13008
chr3	51939426	52139426	harbor2	chr3	51953147	51953545	LINE/L2	1238	-	199	51953346	13920
chr3	51939426	52139426	harbor2	chr3	51953994	51954396	LINE/L2	1238	-	201	51954195	14769
chr3	51939426	52139426	harbor2	chr3	51996824	51997118	LINE/L2	410	-	147	51996971	57545
chr3	49589430	49789430	harbor2	chr3	49619880	49620190	LINE/L2	615	-	155	49620035	30605
chr3	49589430	49789430	harbor2	chr3	49620455	49620706	LINE/L2	2090	-	126	49620581	31151
chr3	49589430	49789430	harbor2	chr3	49620956	49621714	LINE/L2	2090	-	379	49621335	31905
chr3	49589430	49789430	harbor2	chr3	49621887	49622364	LINE/L2	776	-	238	49622125	32695
chr3	49589430	49789430	harbor2	chr3	49666353	49666842	LINE/L2	752	-	244	49666597	77167
chr3	140273579	140473579	harbor2	chr3	140364795	140365135	LINE/L2	553	-	170	140364965	91386
chr3	49369842	49569842	harbor2	chr3	49397822	49398078	LINE/L2	763	-	128	49397950	28108
chr3	49369842	49569842	harbor2	chr3	49398362	49398536	LINE/L2	763	-	87	49398449	28607
chr3	50169875	50369875	harbor2	chr3	50223429	50223677	LINE/L2	570	-	124	50223553	53678
chr3	50169875	50369875	harbor2	chr3	50224007	50224357	LINE/L2	1408	-	175	50224182	54307
chr3	50169875	50369875	harbor2	chr3	50224655	50225105	LINE/L2	1408	-	225	50224880	55005
chr3	49589470	49789470	harbor2	chr3	49619880	49620190	LINE/L2	615	-	155	49620035	30565
chr3	49589470	49789470	harbor2	chr3	49620455	49620706	LINE/L2	2090	-	126	49620581	31111
chr3	49589470	49789470	harbor2	chr3	49620956	49621714	LINE/L2	2090	-	379	49621335	31865
chr3	49589470	49789470	harbor2	chr3	49621887	49622364	LINE/L2	776	-	238	49622125	32655
chr3	49589470	49789470	harbor2	chr3	49666353	49666842	LINE/L2	752	-	244	49666597	77127
chr3	143035218	143235218	harbor2	chr3	143065216	143065758	LINE/L2	653	-	271	143065487	30269
chr3	108053599	108253599	harbor2	chr3	108073561	108073826	LINE/L2	545	-	132	108073693	20094
chr3	108053599	108253599	harbor2	chr3	108102813	108103385	LINE/L2	1297	-	286	108103099	49500
chr3	108053599	108253599	harbor2	chr3	108103588	108103848	LINE/L2	758	-	130	108103718	50119
chr3	108053599	108253599	harbor2	chr3	108107346	108107928	LINE/L2	428	-	291	108107637	54038
chr3	197860224	198060224	harbor2	chr3	197871522	197872075	LINE/L2	856	-	276	197871798	11574
chr3	107992017	108192017	harbor2	chr3	108073561	108073826	LINE/L2	545	-	132	108073693	81676
chr3	23724816	23924816	harbor2	chr3	23782774	23783204	LINE/L2	422	-	215	23782989	58173
chr3	23724816	23924816	harbor2	chr3	23785641	23785806	LINE/L2	470	-	82	23785723	60907
chr3	23724816	23924816	harbor2	chr3	23821454	23822229	LINE/L2	625	-	388	23821842	97026
chr3	43899144	44099144	harbor2	chr3	43922297	43922654	LINE/L2	477	-	178	43922475	23331
chr3	50416036	50616036	harbor2	chr3	50508686	50509002	LINE/L2	404	-	158	50508844	92808
chr3	126375275	126575275	harbor2	chr3	126395395	126395832	LINE/L2	565	-	218	126395613	20338
chr3	126375275	126575275	harbor2	chr3	126424590	126424937	LINE/L2	640	-	174	126424764	49489
chr3	49619512	49819512	harbor2	chr3	49619880	49620190	LINE/L2	615	-	155	49620035	523
chr3	49619512	49819512	harbor2	chr3	49620455	49620706	LINE/L2	2090	-	126	49620581	1069
chr3	49619512	49819512	harbor2	chr3	49620956	49621714	LINE/L2	2090	-	379	49621335	1823
chr3	49619512	49819512	harbor2	chr3	49621887	49622364	LINE/L2	776	-	238	49622125	2613
chr3	49619512	49819512	harbor2	chr3	49666353	49666842	LINE/L2	752	-	244	49666597	47085
chr3	184134394	184334394	harbor2	chr3	184165515	184165734	LINE/L2	540	-	110	184165625	31231
chr3	51948441	52148441	harbor2	chr3	51952331	51952537	LINE/L2	913	-	103	51952434	3993
chr3	51948441	52148441	harbor2	chr3	51953147	51953545	LINE/L2	1238	-	199	51953346	4905
chr3	51948441	52148441	harbor2	chr3	51953994	51954396	LINE/L2	1238	-	201	51954195	5754
chr3	51948441	52148441	harbor2	chr3	51996824	51997118	LINE/L2	410	-	147	51996971	48530
chr3	108122047	108322047	harbor2	chr3	108203634	108203878	LINE/L2	461	-	122	108203756	81709
chr3	184130424	184330424	harbor2	chr3	184131871	184131984	LINE/L2	587	-	56	184131927	1503
chr3	184130424	184330424	harbor2	chr3	184165515	184165734	LINE/L2	540	-	110	184165625	35201
chr3	52085449	52285449	harbor2	chr3	52182820	52182950	LINE/L2	507	-	65	52182885	97436
chr3	128265711	128465711	harbor2	chr3	128277776	128278579	LINE/L2	760	-	402	128278178	12467
chr3	128265711	128465711	harbor2	chr3	128335148	128336032	LINE/L2	886	-	442	128335590	69879
chr3	184086443	184286443	harbor2	chr3	184131871	184131984	LINE/L2	587	-	56	184131927	45484
chr3	184086443	184286443	harbor2	chr3	184165515	184165734	LINE/L2	540	-	110	184165625	79182
chr3	153062933	153262933	harbor2	chr3	153076324	153076579	LINE/L2	409	-	128	153076452	13519
chr3	153062933	153262933	harbor2	chr3	153114920	153115147	LINE/L2	518	-	114	153115034	52101
chr3	153062933	153262933	harbor2	chr3	153115452	153115551	LINE/L2	518	-	50	153115502	52569
chr3	187645815	187845815	harbor2	chr3	187657395	187657602	LINE/L2	429	-	104	187657499	11684
chr3	187645815	187845815	harbor2	chr3	187674009	187674408	LINE/L2	574	-	200	187674209	28394
chr3	108053564	108253564	harbor2	chr3	108073561	108073826	LINE/L2	545	-	132	108073693	20129
chr3	108053564	108253564	harbor2	chr3	108102813	108103385	LINE/L2	1297	-	286	108103099	49535
chr3	108053564	108253564	harbor2	chr3	108103588	108103848	LINE/L2	758	-	130	108103718	50154
chr3	108053564	108253564	harbor2	chr3	108107346	108107928	LINE/L2	428	-	291	108107637	54073
chr3	127270146	127470146	harbor2	chr3	127323337	127323864	LINE/L2	692	-	264	127323601	53455
chr3	127270146	127470146	harbor2	chr3	127327985	127328244	LINE/L2	422	-	130	127328115	57969
chr3	107996441	108196441	harbor2	chr3	108073561	108073826	LINE/L2	545	-	132	108073693	77252
chr3	107993193	108193193	harbor2	chr3	108073561	108073826	LINE/L2	545	-	132	108073693	80500
chr3	107996552	108196552	harbor2	chr3	108073561	108073826	LINE/L2	545	-	132	108073693	77141
chr3	23715795	23915795	harbor2	chr3	23782774	23783204	LINE/L2	422	-	215	23782989	67194
chr3	23715795	23915795	harbor2	chr3	23785641	23785806	LINE/L2	470	-	82	23785723	69928
chr3	49589464	49789464	harbor2	chr3	49619880	49620190	LINE/L2	615	-	155	49620035	30571
chr3	49589464	49789464	harbor2	chr3	49620455	49620706	LINE/L2	2090	-	126	49620581	31117
chr3	49589464	49789464	harbor2	chr3	49620956	49621714	LINE/L2	2090	-	379	49621335	31871
chr3	49589464	49789464	harbor2	chr3	49621887	49622364	LINE/L2	776	-	238	49622125	32661
chr3	49589464	49789464	harbor2	chr3	49666353	49666842	LINE/L2	752	-	244	49666597	77133
chr3	4926654	5126654	harbor2	chr3	4937873	4938134	LINE/L2	568	-	130	4938003	11349
chr3	4926654	5126654	harbor2	chr3	5000842	5000952	LINE/L2	562	-	55	5000897	74243
chr3	4926654	5126654	harbor2	chr3	5001087	5001197	LINE/L2	435	-	55	5001142	74488
chr3	4926654	5126654	harbor2	chr3	5016683	5016887	LINE/L2	409	-	102	5016785	90131
chr3	108018365	108218365	harbor2	chr3	108073561	108073826	LINE/L2	545	-	132	108073693	55328
chr3	108018365	108218365	harbor2	chr3	108102813	108103385	LINE/L2	1297	-	286	108103099	84734
chr3	108018365	108218365	harbor2	chr3	108103588	108103848	LINE/L2	758	-	130	108103718	85353
chr3	108018365	108218365	harbor2	chr3	108107346	108107928	LINE/L2	428	-	291	108107637	89272
chr3	107992129	108192129	harbor2	chr3	108073561	108073826	LINE/L2	545	-	132	108073693	81564
chr3	107993138	108193138	harbor2	chr3	108073561	108073826	LINE/L2	545	-	132	108073693	80555
chr3	4726044	4926044	harbor2	chr3	4752816	4753120	LINE/L2	612	-	152	4752968	26924
chr3	4726044	4926044	harbor2	chr3	4764378	4764691	LINE/L2	555	-	156	4764534	38490
chr3	4726044	4926044	harbor2	chr3	4799995	4800338	LINE/L2	414	-	172	4800167	74123
chr3	4726044	4926044	harbor2	chr3	4784000	4784563	LINE/L2	444	-	282	4784282	58238
chr3	129022332	129222332	harbor2	chr3	129025009	129025715	LINE/L2	926	-	353	129025362	3030
chr3	129022332	129222332	harbor2	chr3	129033619	129034078	LINE/L2	752	-	230	129033849	11517
chr3	129022332	129222332	harbor2	chr3	129057079	129057601	LINE/L2	1091	-	261	129057340	35008
chr3	129022332	129222332	harbor2	chr3	129057671	129057827	LINE/L2	598	-	78	129057749	35417
chr3	129022332	129222332	harbor2	chr3	129058142	129058275	LINE/L2	598	-	66	129058208	35876
chr3	129022332	129222332	harbor2	chr3	129101335	129101839	LINE/L2	595	-	252	129101587	79255
chr3	129022332	129222332	harbor2	chr3	129117911	129118229	LINE/L2	549	-	159	129118070	95738
chr3	185486328	185686328	harbor2	chr3	185504246	185504401	LINE/L2	458	-	78	185504324	17996
chr3	49589463	49789463	harbor2	chr3	49619880	49620190	LINE/L2	615	-	155	49620035	30572
chr3	49589463	49789463	harbor2	chr3	49620455	49620706	LINE/L2	2090	-	126	49620581	31118
chr3	49589463	49789463	harbor2	chr3	49620956	49621714	LINE/L2	2090	-	379	49621335	31872
chr3	49589463	49789463	harbor2	chr3	49621887	49622364	LINE/L2	776	-	238	49622125	32662
chr3	49589463	49789463	harbor2	chr3	49666353	49666842	LINE/L2	752	-	244	49666597	77134
chr3	53155971	53355971	harbor2	chr3	53178779	53178997	LINE/L2	570	-	109	53178888	22917
chr3	128329156	128529156	harbor2	chr3	128402839	128403220	LINE/L2	889	-	190	128403029	73873
chr3	128329156	128529156	harbor2	chr3	128335148	128336032	LINE/L2	886	-	442	128335590	6434
chr3	51939700	52139700	harbor2	chr3	51952331	51952537	LINE/L2	913	-	103	51952434	12734
chr3	51939700	52139700	harbor2	chr3	51953147	51953545	LINE/L2	1238	-	199	51953346	13646
chr3	51939700	52139700	harbor2	chr3	51953994	51954396	LINE/L2	1238	-	201	51954195	14495
chr3	51939700	52139700	harbor2	chr3	51996824	51997118	LINE/L2	410	-	147	51996971	57271
chr3	123552608	123752608	harbor2	chr3	123586508	123586842	LINE/L2	899	-	167	123586675	34067
chr3	123552608	123752608	harbor2	chr3	123587244	123587282	LINE/L2	899	-	19	123587263	34655
chr3	50517037	50717037	harbor2	chr3	50594289	50594430	LINE/L2	465	-	70	50594359	77322
chr3	51939851	52139851	harbor2	chr3	51952331	51952537	LINE/L2	913	-	103	51952434	12583
chr3	51939851	52139851	harbor2	chr3	51953147	51953545	LINE/L2	1238	-	199	51953346	13495
chr3	51939851	52139851	harbor2	chr3	51953994	51954396	LINE/L2	1238	-	201	51954195	14344
chr3	51939851	52139851	harbor2	chr3	51996824	51997118	LINE/L2	410	-	147	51996971	57120
chr3	51939435	52139435	harbor2	chr3	51952331	51952537	LINE/L2	913	-	103	51952434	12999
chr3	51939435	52139435	harbor2	chr3	51953147	51953545	LINE/L2	1238	-	199	51953346	13911
chr3	51939435	52139435	harbor2	chr3	51953994	51954396	LINE/L2	1238	-	201	51954195	14760
chr3	51939435	52139435	harbor2	chr3	51996824	51997118	LINE/L2	410	-	147	51996971	57536
chr3	107992955	108192955	harbor2	chr3	108073561	108073826	LINE/L2	545	-	132	108073693	80738
chr3	108004632	108204632	harbor2	chr3	108073561	108073826	LINE/L2	545	-	132	108073693	69061
chr3	108004632	108204632	harbor2	chr3	108102813	108103385	LINE/L2	1297	-	286	108103099	98467
chr3	108004632	108204632	harbor2	chr3	108103588	108103848	LINE/L2	758	-	130	108103718	99086
chr3	107992065	108192065	harbor2	chr3	108073561	108073826	LINE/L2	545	-	132	108073693	81628
chr3	123560147	123760147	harbor2	chr3	123586508	123586842	LINE/L2	899	-	167	123586675	26528
chr3	123560147	123760147	harbor2	chr3	123587244	123587282	LINE/L2	899	-	19	123587263	27116
chr3	197860219	198060219	harbor2	chr3	197871522	197872075	LINE/L2	856	-	276	197871798	11579
chr3	189960849	190160849	harbor2	chr3	190000325	190000939	LINE/L2	853	-	307	190000632	39783
chr3	107992067	108192067	harbor2	chr3	108073561	108073826	LINE/L2	545	-	132	108073693	81626
chr3	157028447	157228447	harbor2	chr3	157037727	157038336	LINE/L2	1083	-	304	157038031	9584
chr3	157028447	157228447	harbor2	chr3	157038430	157038691	LINE/L2	646	-	130	157038560	10113
chr3	157028447	157228447	harbor2	chr3	157084055	157084644	LINE/L2	401	-	294	157084349	55902
chr3	157028447	157228447	harbor2	chr3	157090538	157091260	LINE/L2	784	-	361	157090899	62452
chr3	142864715	143064715	harbor2	chr3	142874747	142874923	LINE/L2	450	-	88	142874835	10120
chr3	142864715	143064715	harbor2	chr3	142902605	142902933	LINE/L2	578	-	164	142902769	38054
chr3	128484655	128684655	harbor2	chr3	128533928	128534638	LINE/L2	630	-	355	128534283	49628
chr3	128484655	128684655	harbor2	chr3	128540090	128540263	LINE/L2	428	-	86	128540176	55521
chr3	128484655	128684655	harbor2	chr3	128563211	128563475	LINE/L2	825	-	132	128563343	78688
chr3	193982932	194182932	harbor2	chr3	194052662	194052856	LINE/L2	1416	-	97	194052759	69827
chr3	193982932	194182932	harbor2	chr3	194053145	194053608	LINE/L2	1416	-	232	194053377	70445
chr3	107993135	108193135	harbor2	chr3	108073561	108073826	LINE/L2	545	-	132	108073693	80558
chr3	53411237	53611237	harbor2	chr3	53431377	53431556	LINE/L2	519	-	90	53431467	20230
chr3	53411237	53611237	harbor2	chr3	53455297	53455416	LINE/L2	425	-	60	53455357	44120
chr3	53411237	53611237	harbor2	chr3	53455956	53457201	LINE/L2	1159	-	622	53456578	45341
chr3	116673098	116873098	harbor2	chr3	116692494	116692582	LINE/L2	459	-	44	116692538	19440
chr3	116673098	116873098	harbor2	chr3	116692768	116693042	LINE/L2	466	-	137	116692905	19807
chr3	116673098	116873098	harbor2	chr3	116762478	116762951	LINE/L2	771	-	236	116762714	89616
chr3	51939445	52139445	harbor2	chr3	51952331	51952537	LINE/L2	913	-	103	51952434	12989
chr3	51939445	52139445	harbor2	chr3	51953147	51953545	LINE/L2	1238	-	199	51953346	13901
chr3	51939445	52139445	harbor2	chr3	51953994	51954396	LINE/L2	1238	-	201	51954195	14750
chr3	51939445	52139445	harbor2	chr3	51996824	51997118	LINE/L2	410	-	147	51996971	57526
chr3	127490762	127690762	harbor2	chr3	127526393	127526877	LINE/L2	806	-	242	127526635	35873
chr3	127490762	127690762	harbor2	chr3	127543382	127543911	LINE/L2	801	-	264	127543646	52884
chr3	127490762	127690762	harbor2	chr3	127544969	127545342	LINE/L2	411	-	186	127545155	54393
chr3	127490762	127690762	harbor2	chr3	127557051	127557336	LINE/L2	406	-	142	127557193	66431
chr3	127490762	127690762	harbor2	chr3	127559901	127560109	LINE/L2	544	-	104	127560005	69243
chr3	127490762	127690762	harbor2	chr3	127585172	127585692	LINE/L2	582	-	260	127585432	94670
chr3	12963496	13163496	harbor2	chr3	13031574	13031870	LINE/L2	587	-	148	13031722	68226
chr3	128381321	128581321	harbor2	chr3	128402839	128403220	LINE/L2	889	-	190	128403029	21708
chr3	128381321	128581321	harbor2	chr3	128430609	128430906	LINE/L2	433	-	148	128430757	49436
chr3	128381321	128581321	harbor2	chr3	128431715	128432547	LINE/L2	1116	-	416	128432131	50810
chr3	128381321	128581321	harbor2	chr3	128443628	128444271	LINE/L2	704	-	322	128443950	62629
chr3	128381321	128581321	harbor2	chr3	128470262	128470464	LINE/L2	426	-	101	128470363	89042
chr3	13750265	13950265	harbor2	chr3	13765067	13765296	LINE/L2	582	-	114	13765181	14916
chr3	13750265	13950265	harbor2	chr3	13802275	13802634	LINE/L2	869	-	180	13802455	52190
chr3	13750265	13950265	harbor2	chr3	13841770	13842315	LINE/L2	982	-	272	13842042	91777
chr3	13750265	13950265	harbor2	chr3	13842492	13842868	LINE/L2	795	-	188	13842680	92415
chr3	13750265	13950265	harbor2	chr3	13849491	13849911	LINE/L2	914	-	210	13849701	99436
chr3	64313402	64513402	harbor2	chr3	64314085	64314301	LINE/L2	439	-	108	64314193	791
chr3	64313402	64513402	harbor2	chr3	64318369	64318461	LINE/L2	460	-	46	64318415	5013
chr3	64313402	64513402	harbor2	chr3	64319413	64319923	LINE/L2	1176	-	255	64319668	6266
chr3	64313402	64513402	harbor2	chr3	64331397	64331525	LINE/L2	423	-	64	64331461	18059
chr3	64313402	64513402	harbor2	chr3	64345942	64346630	LINE/L2	1074	-	344	64346286	32884
chr3	64313402	64513402	harbor2	chr3	64347902	64348461	LINE/L2	693	-	280	64348182	34780
chr3	64313402	64513402	harbor2	chr3	64348770	64349013	LINE/L2	663	-	122	64348892	35490
chr3	64313402	64513402	harbor2	chr3	64369848	64370224	LINE/L2	655	-	188	64370036	56634
chr3	64313402	64513402	harbor2	chr3	64374234	64375067	LINE/L2	695	-	416	64374650	61248
chr3	161006321	161206321	harbor2	chr3	161007050	161007539	LINE/L2	1361	-	244	161007294	973
chr3	161006321	161206321	harbor2	chr3	161007760	161007938	LINE/L2	861	-	89	161007849	1528
chr3	161006321	161206321	harbor2	chr3	161008594	161009086	LINE/L2	1596	-	246	161008840	2519
chr3	161006321	161206321	harbor2	chr3	161059546	161059637	LINE/L2	671	-	46	161059592	53271
chr3	161006321	161206321	harbor2	chr3	161060051	161060409	LINE/L2	671	-	179	161060230	53909
chr3	161006321	161206321	harbor2	chr3	161060436	161060651	LINE/L2	512	-	108	161060544	54223
chr3	161006321	161206321	harbor2	chr3	161066274	161066545	LINE/L2	560	-	136	161066410	60089
chr3	197860204	198060204	harbor2	chr3	197871522	197872075	LINE/L2	856	-	276	197871798	11594
chr3	123399935	123599935	harbor2	chr3	123475284	123475595	LINE/L2	425	-	156	123475440	75505
chr3	123399935	123599935	harbor2	chr3	123485185	123485540	LINE/L2	800	-	178	123485363	85428
chr3	107992061	108192061	harbor2	chr3	108073561	108073826	LINE/L2	545	-	132	108073693	81632
chr3	36670495	36870495	harbor2	chr3	36709220	36709761	LINE/L2	853	-	270	36709490	38995
chr3	36670495	36870495	harbor2	chr3	36713213	36713428	LINE/L2	421	-	108	36713321	42826
chr3	36670495	36870495	harbor2	chr3	36730388	36730578	LINE/L2	1068	-	95	36730483	59988
chr3	36670495	36870495	harbor2	chr3	36730759	36731103	LINE/L2	1068	-	172	36730931	60436
chr3	36670495	36870495	harbor2	chr3	36735832	36736033	LINE/L2	399	-	100	36735932	65437
chr3	36670495	36870495	harbor2	chr3	36765658	36765842	LINE/L2	428	-	92	36765750	95255
chr3	196916551	197116551	harbor2	chr3	197005093	197005454	LINE/L2	922	-	180	197005273	88722
chr3	196916551	197116551	harbor2	chr3	197005855	197005938	LINE/L2	854	-	42	197005897	89346
chr3	196916551	197116551	harbor2	chr3	197006240	197006421	LINE/L2	854	-	90	197006330	89779
chr3	51860342	52060342	harbor2	chr3	51952331	51952537	LINE/L2	913	-	103	51952434	92092
chr3	51860342	52060342	harbor2	chr3	51953147	51953545	LINE/L2	1238	-	199	51953346	93004
chr3	51860342	52060342	harbor2	chr3	51953994	51954396	LINE/L2	1238	-	201	51954195	93853
chr3	108026049	108226049	harbor2	chr3	108073561	108073826	LINE/L2	545	-	132	108073693	47644
chr3	108026049	108226049	harbor2	chr3	108102813	108103385	LINE/L2	1297	-	286	108103099	77050
chr3	108026049	108226049	harbor2	chr3	108103588	108103848	LINE/L2	758	-	130	108103718	77669
chr3	108026049	108226049	harbor2	chr3	108107346	108107928	LINE/L2	428	-	291	108107637	81588
chr3	107992090	108192090	harbor2	chr3	108073561	108073826	LINE/L2	545	-	132	108073693	81603
chr3	45419104	45619104	harbor2	chr3	45437770	45438050	LINE/L2	750	-	140	45437910	18806
chr3	45419104	45619104	harbor2	chr3	45461354	45461790	LINE/L2	833	-	218	45461572	42468
chr3	49589456	49789456	harbor2	chr3	49619880	49620190	LINE/L2	615	-	155	49620035	30579
chr3	49589456	49789456	harbor2	chr3	49620455	49620706	LINE/L2	2090	-	126	49620581	31125
chr3	49589456	49789456	harbor2	chr3	49620956	49621714	LINE/L2	2090	-	379	49621335	31879
chr3	49589456	49789456	harbor2	chr3	49621887	49622364	LINE/L2	776	-	238	49622125	32669
chr3	49589456	49789456	harbor2	chr3	49666353	49666842	LINE/L2	752	-	244	49666597	77141
chr3	108053563	108253563	harbor2	chr3	108073561	108073826	LINE/L2	545	-	132	108073693	20130
chr3	108053563	108253563	harbor2	chr3	108102813	108103385	LINE/L2	1297	-	286	108103099	49536
chr3	108053563	108253563	harbor2	chr3	108103588	108103848	LINE/L2	758	-	130	108103718	50155
chr3	108053563	108253563	harbor2	chr3	108107346	108107928	LINE/L2	428	-	291	108107637	54074
chr3	123544944	123744944	harbor2	chr3	123586508	123586842	LINE/L2	899	-	167	123586675	41731
chr3	123544944	123744944	harbor2	chr3	123587244	123587282	LINE/L2	899	-	19	123587263	42319
chr3	108053682	108253682	harbor2	chr3	108073561	108073826	LINE/L2	545	-	132	108073693	20011
chr3	108053682	108253682	harbor2	chr3	108102813	108103385	LINE/L2	1297	-	286	108103099	49417
chr3	108053682	108253682	harbor2	chr3	108103588	108103848	LINE/L2	758	-	130	108103718	50036
chr3	108053682	108253682	harbor2	chr3	108107346	108107928	LINE/L2	428	-	291	108107637	53955
chr3	136086110	136286110	harbor2	chr3	136141025	136141603	LINE/L2	464	-	289	136141314	55204
chr3	136086110	136286110	harbor2	chr3	136141786	136142212	LINE/L2	399	-	213	136141999	55889
chr3	107993195	108193195	harbor2	chr3	108073561	108073826	LINE/L2	545	-	132	108073693	80498
chr3	138339763	138539763	harbor2	chr3	138358579	138358788	LINE/L2	525	-	104	138358683	18920
chr3	138339763	138539763	harbor2	chr3	138383692	138385156	LINE/L2	2953	-	732	138384424	44661
chr3	138339763	138539763	harbor2	chr3	138385446	138385504	LINE/L2	2953	-	29	138385475	45712
chr3	138339763	138539763	harbor2	chr3	138385815	138386052	LINE/L2	2953	-	118	138385933	46170
chr3	138339763	138539763	harbor2	chr3	138386998	138387320	LINE/L2	466	-	161	138387159	47396
chr3	138339763	138539763	harbor2	chr3	138406278	138406364	LINE/L2	481	-	43	138406321	66558
chr3	138339763	138539763	harbor2	chr3	138432633	138432735	LINE/L2	417	-	51	138432684	92921
chr3	51948342	52148342	harbor2	chr3	51952331	51952537	LINE/L2	913	-	103	51952434	4092
chr3	51948342	52148342	harbor2	chr3	51953147	51953545	LINE/L2	1238	-	199	51953346	5004
chr3	51948342	52148342	harbor2	chr3	51953994	51954396	LINE/L2	1238	-	201	51954195	5853
chr3	51948342	52148342	harbor2	chr3	51996824	51997118	LINE/L2	410	-	147	51996971	48629
chr3	49618697	49818697	harbor2	chr3	49619880	49620190	LINE/L2	615	-	155	49620035	1338
chr3	49618697	49818697	harbor2	chr3	49620455	49620706	LINE/L2	2090	-	126	49620581	1884
chr3	49618697	49818697	harbor2	chr3	49620956	49621714	LINE/L2	2090	-	379	49621335	2638
chr3	49618697	49818697	harbor2	chr3	49621887	49622364	LINE/L2	776	-	238	49622125	3428
chr3	49618697	49818697	harbor2	chr3	49666353	49666842	LINE/L2	752	-	244	49666597	47900
chr3	48894246	49094246	harbor2	chr3	48899105	48899581	LINE/L2	1151	-	238	48899343	5097
chr3	48894246	49094246	harbor2	chr3	48900287	48900502	LINE/L2	793	-	108	48900395	6149
chr3	48894246	49094246	harbor2	chr3	48900825	48900848	LINE/L2	793	-	12	48900837	6591
chr3	48894246	49094246	harbor2	chr3	48910284	48910467	LINE/L2	1211	-	92	48910376	16130
chr3	48894246	49094246	harbor2	chr3	48910773	48911089	LINE/L2	1211	-	158	48910931	16685
chr3	48894246	49094246	harbor2	chr3	48992106	48992278	LINE/L2	610	-	86	48992192	97946
chr3	108000209	108200209	harbor2	chr3	108073561	108073826	LINE/L2	545	-	132	108073693	73484
chr3	51940436	52140436	harbor2	chr3	51952331	51952537	LINE/L2	913	-	103	51952434	11998
chr3	51940436	52140436	harbor2	chr3	51953147	51953545	LINE/L2	1238	-	199	51953346	12910
chr3	51940436	52140436	harbor2	chr3	51953994	51954396	LINE/L2	1238	-	201	51954195	13759
chr3	51940436	52140436	harbor2	chr3	51996824	51997118	LINE/L2	410	-	147	51996971	56535
chr3	182693462	182893462	harbor2	chr3	182708805	182708931	LINE/L2	406	-	63	182708868	15406
chr3	142529008	142729008	harbor2	chr3	142545096	142545989	LINE/L2	1359	-	446	142545542	16534
chr3	142529008	142729008	harbor2	chr3	142546474	142546898	LINE/L2	911	-	212	142546686	17678
chr3	142529008	142729008	harbor2	chr3	142575741	142576479	LINE/L2	1764	-	369	142576110	47102
chr3	126911046	127111046	harbor2	chr3	126918346	126918787	LINE/L2	661	-	220	126918566	7520
chr3	23711708	23911708	harbor2	chr3	23782774	23783204	LINE/L2	422	-	215	23782989	71281
chr3	23711708	23911708	harbor2	chr3	23785641	23785806	LINE/L2	470	-	82	23785723	74015
chr3	125112713	125312713	harbor2	chr3	125132372	125133189	LINE/L2	1142	-	408	125132780	20067
chr3	125112713	125312713	harbor2	chr3	125209546	125209911	LINE/L2	491	-	182	125209728	97015
chr3	23710838	23910838	harbor2	chr3	23782774	23783204	LINE/L2	422	-	215	23782989	72151
chr3	23710838	23910838	harbor2	chr3	23785641	23785806	LINE/L2	470	-	82	23785723	74885
chr3	108468945	108668945	harbor2	chr3	108481304	108481763	LINE/L2	859	-	230	108481534	12589
chr3	108468945	108668945	harbor2	chr3	108481841	108482290	LINE/L2	825	-	224	108482065	13120
chr3	108468945	108668945	harbor2	chr3	108493545	108493668	LINE/L2	550	-	62	108493607	24662
chr3	108468945	108668945	harbor2	chr3	108493735	108493912	LINE/L2	463	-	88	108493823	24878
chr3	108468945	108668945	harbor2	chr3	108556851	108556958	LINE/L2	439	-	54	108556905	87960
chr3	108468945	108668945	harbor2	chr3	108558492	108559651	LINE/L2	473	-	580	108559072	90127
chr3	52126019	52326019	harbor2	chr3	52182820	52182950	LINE/L2	507	-	65	52182885	56866
chr3	157015013	157215013	harbor2	chr3	157021995	157022064	LINE/L2	633	-	34	157022029	7016
chr3	157015013	157215013	harbor2	chr3	157022243	157022739	LINE/L2	633	-	248	157022491	7478
chr3	157015013	157215013	harbor2	chr3	157037727	157038336	LINE/L2	1083	-	304	157038031	23018
chr3	157015013	157215013	harbor2	chr3	157038430	157038691	LINE/L2	646	-	130	157038560	23547
chr3	157015013	157215013	harbor2	chr3	157084055	157084644	LINE/L2	401	-	294	157084349	69336
chr3	157015013	157215013	harbor2	chr3	157090538	157091260	LINE/L2	784	-	361	157090899	75886
chr3	131281884	131481884	harbor2	chr3	131329392	131330497	LINE/L2	2154	-	552	131329944	48060
chr3	131281884	131481884	harbor2	chr3	131342943	131343504	LINE/L2	873	-	280	131343223	61339
chr3	131281884	131481884	harbor2	chr3	131346349	131347058	LINE/L2	928	-	354	131346703	64819
chr3	184086432	184286432	harbor2	chr3	184131871	184131984	LINE/L2	587	-	56	184131927	45495
chr3	184086432	184286432	harbor2	chr3	184165515	184165734	LINE/L2	540	-	110	184165625	79193
chr3	51995390	52195390	harbor2	chr3	51996824	51997118	LINE/L2	410	-	147	51996971	1581
chr3	51995390	52195390	harbor2	chr3	52069277	52069658	LINE/L2	711	-	190	52069467	74077
chr3	108359237	108559237	harbor2	chr3	108389573	108389781	LINE/L2	744	-	104	108389677	30440
chr3	108359237	108559237	harbor2	chr3	108407765	108407827	LINE/L2	474	-	31	108407796	48559
chr3	108359237	108559237	harbor2	chr3	108407981	108408032	LINE/L2	474	-	26	108408007	48770
chr3	108359237	108559237	harbor2	chr3	108415693	108415882	LINE/L2	443	-	94	108415787	56550
chr3	108359237	108559237	harbor2	chr3	108420190	108420690	LINE/L2	755	-	250	108420440	61203
chr3	183916164	184116164	harbor2	chr3	184000451	184000584	LINE/L2	427	-	66	184000517	84353
chr3	52045019	52245019	harbor2	chr3	52069277	52069658	LINE/L2	711	-	190	52069467	24448
chr3	51939791	52139791	harbor2	chr3	51952331	51952537	LINE/L2	913	-	103	51952434	12643
chr3	51939791	52139791	harbor2	chr3	51953147	51953545	LINE/L2	1238	-	199	51953346	13555
chr3	51939791	52139791	harbor2	chr3	51953994	51954396	LINE/L2	1238	-	201	51954195	14404
chr3	51939791	52139791	harbor2	chr3	51996824	51997118	LINE/L2	410	-	147	51996971	57180
chr3	148724778	148924778	harbor2	chr3	148765715	148765892	LINE/L2	445	-	88	148765803	41025
chr3	148724778	148924778	harbor2	chr3	148767192	148767365	LINE/L2	400	-	86	148767278	42500
chr3	148724778	148924778	harbor2	chr3	148766607	148766841	LINE/L2	651	-	117	148766724	41946
chr3	129875421	130075421	harbor2	chr3	129944214	129945139	LINE/L2	1864	-	462	129944676	69255
chr3	129875421	130075421	harbor2	chr3	129947958	129948232	LINE/L2	553	-	137	129948095	72674
chr3	129875421	130075421	harbor2	chr3	129967065	129967256	LINE/L2	489	-	96	129967161	91740
chr3	182693567	182893567	harbor2	chr3	182708805	182708931	LINE/L2	406	-	63	182708868	15301
chr3	51940440	52140440	harbor2	chr3	51952331	51952537	LINE/L2	913	-	103	51952434	11994
chr3	51940440	52140440	harbor2	chr3	51953147	51953545	LINE/L2	1238	-	199	51953346	12906
chr3	51940440	52140440	harbor2	chr3	51953994	51954396	LINE/L2	1238	-	201	51954195	13755
chr3	51940440	52140440	harbor2	chr3	51996824	51997118	LINE/L2	410	-	147	51996971	56531
chr3	127490198	127690198	harbor2	chr3	127526393	127526877	LINE/L2	806	-	242	127526635	36437
chr3	127490198	127690198	harbor2	chr3	127543382	127543911	LINE/L2	801	-	264	127543646	53448
chr3	127490198	127690198	harbor2	chr3	127544969	127545342	LINE/L2	411	-	186	127545155	54957
chr3	127490198	127690198	harbor2	chr3	127557051	127557336	LINE/L2	406	-	142	127557193	66995
chr3	127490198	127690198	harbor2	chr3	127559901	127560109	LINE/L2	544	-	104	127560005	69807
chr3	127490198	127690198	harbor2	chr3	127585172	127585692	LINE/L2	582	-	260	127585432	95234
chr3	123518827	123718827	harbor2	chr3	123586508	123586842	LINE/L2	899	-	167	123586675	67848
chr3	123518827	123718827	harbor2	chr3	123587244	123587282	LINE/L2	899	-	19	123587263	68436
chr3	108053525	108253525	harbor2	chr3	108073561	108073826	LINE/L2	545	-	132	108073693	20168
chr3	108053525	108253525	harbor2	chr3	108102813	108103385	LINE/L2	1297	-	286	108103099	49574
chr3	108053525	108253525	harbor2	chr3	108103588	108103848	LINE/L2	758	-	130	108103718	50193
chr3	108053525	108253525	harbor2	chr3	108107346	108107928	LINE/L2	428	-	291	108107637	54112
chr3	195800094	196000094	harbor2	chr3	195833110	195833557	LINE/L2	439	-	224	195833334	33240
chr3	195800094	196000094	harbor2	chr3	195852600	195852716	LINE/L2	608	-	58	195852658	52564
chr3	127581132	127781132	harbor2	chr3	127585172	127585692	LINE/L2	582	-	260	127585432	4300
chr3	127581132	127781132	harbor2	chr3	127623334	127623703	LINE/L2	536	-	184	127623518	42386
chr3	127581132	127781132	harbor2	chr3	127624002	127624170	LINE/L2	536	-	84	127624086	42954
chr3	127581132	127781132	harbor2	chr3	127633612	127634100	LINE/L2	439	-	244	127633856	52724
chr3	182297276	182497276	harbor2	chr3	182302582	182302907	LINE/L2	408	-	162	182302744	5468
chr3	182297276	182497276	harbor2	chr3	182332421	182332660	LINE/L2	1089	-	120	182332541	35265
chr3	182297276	182497276	harbor2	chr3	182332956	182334086	LINE/L2	2161	-	565	182333521	36245
chr4	39082469	39282469	harbor2	chr4	39088698	39089362	LINE/L2	693	-	332	39089030	6561
chr4	98161348	98361348	harbor2	chr4	98206327	98206365	LINE/L2	1065	-	19	98206346	44998
chr4	98161348	98361348	harbor2	chr4	98206489	98206531	LINE/L2	1065	-	21	98206510	45162
chr4	98161348	98361348	harbor2	chr4	98206739	98207171	LINE/L2	1065	-	216	98206955	45607
chr4	98161348	98361348	harbor2	chr4	98217799	98218081	LINE/L2	595	-	141	98217940	56592
chr4	98161348	98361348	harbor2	chr4	98243403	98243855	LINE/L2	1180	-	226	98243629	82281
chr4	98161348	98361348	harbor2	chr4	98244257	98244557	LINE/L2	1180	-	150	98244407	83059
chr4	98161348	98361348	harbor2	chr4	98244851	98245171	LINE/L2	1180	-	160	98245011	83663
chr4	98161348	98361348	harbor2	chr4	98258153	98258539	LINE/L2	828	-	193	98258346	96998
chr4	103098506	103298506	harbor2	chr4	103146280	103147058	LINE/L2	505	-	389	103146669	48163
chr4	103098506	103298506	harbor2	chr4	103186547	103187109	LINE/L2	632	-	281	103186828	88322
chr4	38573365	38773365	harbor2	chr4	38659280	38659508	LINE/L2	535	-	114	38659394	86029
chr4	38573365	38773365	harbor2	chr4	38660208	38660299	LINE/L2	535	-	46	38660254	86889
chr4	159002962	159202962	harbor2	chr4	159100516	159100650	LINE/L2	468	-	67	159100583	97621
chr4	159002962	159202962	harbor2	chr4	159100974	159101611	LINE/L2	1737	-	318	159101292	98330
chr4	176095954	176295954	harbor2	chr4	176114515	176115038	LINE/L2	574	-	262	176114777	18823
chr4	176095954	176295954	harbor2	chr4	176157964	176158724	LINE/L2	672	-	380	176158344	62390
chr4	55295797	55495797	harbor2	chr4	55323828	55324866	LINE/L2	1926	-	519	55324347	28550
chr4	55295797	55495797	harbor2	chr4	55343756	55343902	LINE/L2	745	-	73	55343829	48032
chr4	55295797	55495797	harbor2	chr4	55389401	55389738	LINE/L2	1213	-	168	55389569	93772
chr4	55295797	55495797	harbor2	chr4	55390050	55390530	LINE/L2	1213	-	240	55390290	94493
chr4	89737944	89937944	harbor2	chr4	89774232	89774540	LINE/L2	564	-	154	89774386	36442
chr4	89737944	89937944	harbor2	chr4	89808477	89808950	LINE/L2	1189	-	236	89808713	70769
chr4	89737944	89937944	harbor2	chr4	89820993	89821237	LINE/L2	464	-	122	89821115	83171
chr4	911518	1111518	harbor2	chr4	934124	935059	LINE/L2	801	-	468	934592	23074
chr4	120823311	121023311	harbor2	chr4	120826675	120826860	LINE/L2	603	-	92	120826767	3456
chr4	120823311	121023311	harbor2	chr4	120854566	120855026	LINE/L2	827	-	230	120854796	31485
chr4	2363014	2563014	harbor2	chr4	2396867	2397032	LINE/L2	455	-	82	2396949	33935
chr4	2363014	2563014	harbor2	chr4	2434118	2434429	LINE/L2	480	-	156	2434274	71260
chr4	2363014	2563014	harbor2	chr4	2448508	2448754	LINE/L2	451	-	123	2448631	85617
chr4	120822652	121022652	harbor2	chr4	120826675	120826860	LINE/L2	603	-	92	120826767	4115
chr4	120822652	121022652	harbor2	chr4	120854566	120855026	LINE/L2	827	-	230	120854796	32144
chr4	122858241	123058241	harbor2	chr4	122878020	122879112	LINE/L2	1017	-	546	122878566	20325
chr4	122858241	123058241	harbor2	chr4	122913989	122914184	LINE/L2	900	-	98	122914087	55846
chr4	122858241	123058241	harbor2	chr4	122914753	122915195	LINE/L2	1009	-	221	122914974	56733
chr4	2318802	2518802	harbor2	chr4	2396867	2397032	LINE/L2	455	-	82	2396949	78147
chr4	12478041	12678041	harbor2	chr4	12521344	12521477	LINE/L2	471	-	66	12521410	43369
chr4	911393	1111393	harbor2	chr4	934124	935059	LINE/L2	801	-	468	934592	23199
chr4	103098509	103298509	harbor2	chr4	103146280	103147058	LINE/L2	505	-	389	103146669	48160
chr4	103098509	103298509	harbor2	chr4	103186547	103187109	LINE/L2	632	-	281	103186828	88319
chr4	103098505	103298505	harbor2	chr4	103146280	103147058	LINE/L2	505	-	389	103146669	48164
chr4	103098505	103298505	harbor2	chr4	103186547	103187109	LINE/L2	632	-	281	103186828	88323
chr4	145413737	145613737	harbor2	chr4	145477562	145477670	LINE/L2	478	-	54	145477616	63879
chr4	145413737	145613737	harbor2	chr4	145479491	145479704	LINE/L2	648	-	106	145479597	65860
chr4	187837772	188037772	harbor2	chr4	187855737	187856003	LINE/L2	993	-	133	187855870	18098
chr4	187837772	188037772	harbor2	chr4	187856454	187856742	LINE/L2	993	-	144	187856598	18826
chr4	187837772	188037772	harbor2	chr4	187862924	187863679	LINE/L2	1676	-	378	187863302	25530
chr4	187837772	188037772	harbor2	chr4	187900358	187900713	LINE/L2	626	-	178	187900536	62764
chr4	187837772	188037772	harbor2	chr4	187901250	187901627	LINE/L2	739	-	188	187901438	63666
chr4	187837772	188037772	harbor2	chr4	187901633	187901898	LINE/L2	502	-	132	187901765	63993
chr4	187837772	188037772	harbor2	chr4	187902490	187902561	LINE/L2	502	-	36	187902526	64754
chr4	187837772	188037772	harbor2	chr4	187918544	187918646	LINE/L2	617	-	51	187918595	80823
chr4	187837772	188037772	harbor2	chr4	187918984	187919218	LINE/L2	617	-	117	187919101	81329
chr4	187837772	188037772	harbor2	chr4	187930744	187931016	LINE/L2	538	-	136	187930880	93108
chr4	6251701	6451701	harbor2	chr4	6252973	6253538	LINE/L2	780	-	282	6253255	1554
chr4	6251701	6451701	harbor2	chr4	6257578	6257877	LINE/L2	629	-	150	6257728	6027
chr4	6251701	6451701	harbor2	chr4	6335091	6335601	LINE/L2	611	-	255	6335346	83645
chr4	2364000	2564000	harbor2	chr4	2396867	2397032	LINE/L2	455	-	82	2396949	32949
chr4	2364000	2564000	harbor2	chr4	2434118	2434429	LINE/L2	480	-	156	2434274	70274
chr4	2364000	2564000	harbor2	chr4	2448508	2448754	LINE/L2	451	-	123	2448631	84631
chr4	2151563	2351563	harbor2	chr4	2197121	2197573	LINE/L2	1204	-	226	2197347	45784
chr4	2363979	2563979	harbor2	chr4	2396867	2397032	LINE/L2	455	-	82	2396949	32970
chr4	2363979	2563979	harbor2	chr4	2434118	2434429	LINE/L2	480	-	156	2434274	70295
chr4	2363979	2563979	harbor2	chr4	2448508	2448754	LINE/L2	451	-	123	2448631	84652
chr4	103098514	103298514	harbor2	chr4	103146280	103147058	LINE/L2	505	-	389	103146669	48155
chr4	103098514	103298514	harbor2	chr4	103186547	103187109	LINE/L2	632	-	281	103186828	88314
chr4	17477327	17677327	harbor2	chr4	17559826	17560114	LINE/L2	653	-	144	17559970	82643
chr4	7569422	7769422	harbor2	chr4	7617402	7617711	LINE/L2	586	-	154	7617556	48134
chr4	2701308	2901308	harbor2	chr4	2766193	2766458	LINE/L2	588	-	132	2766325	65017
chr4	2701308	2901308	harbor2	chr4	2789446	2789963	LINE/L2	571	-	258	2789704	88396
chr4	871018	1071018	harbor2	chr4	934124	935059	LINE/L2	801	-	468	934592	63574
chr4	6889753	7089753	harbor2	chr4	6931766	6932078	LINE/L2	886	-	156	6931922	42169
chr4	6889753	7089753	harbor2	chr4	6932394	6932461	LINE/L2	886	-	34	6932428	42675
chr4	6889753	7089753	harbor2	chr4	6933754	6934168	LINE/L2	504	-	207	6933961	44208
chr4	6889753	7089753	harbor2	chr4	6935116	6935481	LINE/L2	684	-	182	6935298	45545
chr4	911525	1111525	harbor2	chr4	934124	935059	LINE/L2	801	-	468	934592	23067
chr4	911521	1111521	harbor2	chr4	934124	935059	LINE/L2	801	-	468	934592	23071
chr4	86792393	86992393	harbor2	chr4	86808753	86809222	LINE/L2	889	-	234	86808987	16594
chr4	86792393	86992393	harbor2	chr4	86811972	86812028	LINE/L2	1106	-	28	86812000	19607
chr4	86792393	86992393	harbor2	chr4	86812334	86813048	LINE/L2	1106	-	357	86812691	20298
chr4	86792393	86992393	harbor2	chr4	86863384	86863820	LINE/L2	487	-	218	86863602	71209
chr4	86792393	86992393	harbor2	chr4	86869164	86869543	LINE/L2	961	-	190	86869354	76961
chr4	103098758	103298758	harbor2	chr4	103146280	103147058	LINE/L2	505	-	389	103146669	47911
chr4	103098758	103298758	harbor2	chr4	103186547	103187109	LINE/L2	632	-	281	103186828	88070
chr4	86993241	87193241	harbor2	chr4	87051768	87052150	LINE/L2	549	-	191	87051959	58718
chr4	86993241	87193241	harbor2	chr4	87052413	87053142	LINE/L2	1057	-	364	87052777	59536
chr4	86993241	87193241	harbor2	chr4	87053652	87054017	LINE/L2	644	-	182	87053834	60593
chr4	867539	1067539	harbor2	chr4	934124	935059	LINE/L2	801	-	468	934592	67053
chr4	911387	1111387	harbor2	chr4	934124	935059	LINE/L2	801	-	468	934592	23205
chr4	3394897	3594897	harbor2	chr4	3397528	3397838	LINE/L2	878	-	155	3397683	2786
chr4	103098495	103298495	harbor2	chr4	103146280	103147058	LINE/L2	505	-	389	103146669	48174
chr4	103098495	103298495	harbor2	chr4	103186547	103187109	LINE/L2	632	-	281	103186828	88333
chr4	867048	1067048	harbor2	chr4	934124	935059	LINE/L2	801	-	468	934592	67544
chr4	76849477	77049477	harbor2	chr4	76905425	76905841	LINE/L2	704	-	208	76905633	56156
chr4	76849477	77049477	harbor2	chr4	76905910	76906323	LINE/L2	1390	-	206	76906116	56639
chr4	76849477	77049477	harbor2	chr4	76906732	76907006	LINE/L2	1390	-	137	76906869	57392
chr4	2363019	2563019	harbor2	chr4	2396867	2397032	LINE/L2	455	-	82	2396949	33930
chr4	2363019	2563019	harbor2	chr4	2434118	2434429	LINE/L2	480	-	156	2434274	71255
chr4	2363019	2563019	harbor2	chr4	2448508	2448754	LINE/L2	451	-	123	2448631	85612
chr4	55296360	55496360	harbor2	chr4	55323828	55324866	LINE/L2	1926	-	519	55324347	27987
chr4	55296360	55496360	harbor2	chr4	55343756	55343902	LINE/L2	745	-	73	55343829	47469
chr4	55296360	55496360	harbor2	chr4	55389401	55389738	LINE/L2	1213	-	168	55389569	93209
chr4	55296360	55496360	harbor2	chr4	55390050	55390530	LINE/L2	1213	-	240	55390290	93930
chr5	115444451	115644451	harbor2	chr5	115458762	115459354	LINE/L2	961	-	296	115459058	14607
chr5	10341874	10541874	harbor2	chr5	10357723	10357966	LINE/L2	1042	-	122	10357845	15971
chr5	10341874	10541874	harbor2	chr5	10358045	10358386	LINE/L2	1042	-	170	10358215	16341
chr5	10341874	10541874	harbor2	chr5	10409275	10409867	LINE/L2	1318	-	296	10409571	67697
chr5	10341874	10541874	harbor2	chr5	10409876	10410077	LINE/L2	645	-	100	10409976	68102
chr5	10341874	10541874	harbor2	chr5	10430106	10430286	LINE/L2	470	-	90	10430196	88322
chr5	150970772	151170772	harbor2	chr5	151011329	151011561	LINE/L2	551	-	116	151011445	40673
chr5	150970772	151170772	harbor2	chr5	151066005	151066318	LINE/L2	770	-	156	151066161	95389
chr5	10341865	10541865	harbor2	chr5	10357723	10357966	LINE/L2	1042	-	122	10357845	15980
chr5	10341865	10541865	harbor2	chr5	10358045	10358386	LINE/L2	1042	-	170	10358215	16350
chr5	10341865	10541865	harbor2	chr5	10409275	10409867	LINE/L2	1318	-	296	10409571	67706
chr5	10341865	10541865	harbor2	chr5	10409876	10410077	LINE/L2	645	-	100	10409976	68111
chr5	10341865	10541865	harbor2	chr5	10430106	10430286	LINE/L2	470	-	90	10430196	88331
chr5	41804360	42004360	harbor2	chr5	41818067	41818241	LINE/L2	512	-	87	41818154	13794
chr5	112319140	112519140	harbor2	chr5	112372447	112372935	LINE/L2	732	-	244	112372691	53551
chr5	112319140	112519140	harbor2	chr5	112407831	112407944	LINE/L2	436	-	56	112407887	88747
chr5	10341837	10541837	harbor2	chr5	10357723	10357966	LINE/L2	1042	-	122	10357845	16008
chr5	10341837	10541837	harbor2	chr5	10358045	10358386	LINE/L2	1042	-	170	10358215	16378
chr5	10341837	10541837	harbor2	chr5	10409275	10409867	LINE/L2	1318	-	296	10409571	67734
chr5	10341837	10541837	harbor2	chr5	10409876	10410077	LINE/L2	645	-	100	10409976	68139
chr5	10341837	10541837	harbor2	chr5	10430106	10430286	LINE/L2	470	-	90	10430196	88359
chr5	134425024	134625024	harbor2	chr5	134441461	134442002	LINE/L2	450	-	270	134441731	16707
chr5	134425024	134625024	harbor2	chr5	134449847	134449964	LINE/L2	494	-	58	134449905	24881
chr5	134425024	134625024	harbor2	chr5	134450274	134450665	LINE/L2	494	-	196	134450470	25446
chr5	134425024	134625024	harbor2	chr5	134457849	134458198	LINE/L2	724	-	174	134458023	32999
chr5	6533324	6733324	harbor2	chr5	6540631	6541314	LINE/L2	998	-	342	6540973	7649
chr5	52700040	52900040	harbor2	chr5	52707646	52707778	LINE/L2	487	-	66	52707712	7672
chr5	52700040	52900040	harbor2	chr5	52707922	52708177	LINE/L2	410	-	128	52708050	8010
chr5	135980728	136180728	harbor2	chr5	135990218	135990520	LINE/L2	467	-	151	135990369	9641
chr5	135980728	136180728	harbor2	chr5	135990591	135990754	LINE/L2	467	-	82	135990673	9945
chr5	135980728	136180728	harbor2	chr5	136007891	136008408	LINE/L2	733	-	258	136008149	27421
chr5	135980728	136180728	harbor2	chr5	136017477	136017797	LINE/L2	478	-	160	136017637	36909
chr5	135980728	136180728	harbor2	chr5	136048397	136048842	LINE/L2	636	-	222	136048619	67891
chr5	135980728	136180728	harbor2	chr5	136069310	136070139	LINE/L2	1538	-	414	136069724	88996
chr5	135980728	136180728	harbor2	chr5	136077613	136077789	LINE/L2	470	-	88	136077701	96973
chr5	10348809	10548809	harbor2	chr5	10357723	10357966	LINE/L2	1042	-	122	10357845	9036
chr5	10348809	10548809	harbor2	chr5	10358045	10358386	LINE/L2	1042	-	170	10358215	9406
chr5	10348809	10548809	harbor2	chr5	10409275	10409867	LINE/L2	1318	-	296	10409571	60762
chr5	10348809	10548809	harbor2	chr5	10409876	10410077	LINE/L2	645	-	100	10409976	61167
chr5	10348809	10548809	harbor2	chr5	10430106	10430286	LINE/L2	470	-	90	10430196	81387
chr5	76930492	77130492	harbor2	chr5	76959961	76960546	LINE/L2	742	-	292	76960253	29761
chr5	133511231	133711231	harbor2	chr5	133580389	133580659	LINE/L2	547	-	135	133580524	69293
chr5	154684770	154884770	harbor2	chr5	154703940	154704108	LINE/L2	569	-	84	154704024	19254
chr5	154684770	154884770	harbor2	chr5	154704184	154704251	LINE/L2	436	-	34	154704218	19448
chr5	154684770	154884770	harbor2	chr5	154741324	154741751	LINE/L2	555	-	214	154741538	56768
chr5	154684770	154884770	harbor2	chr5	154769899	154770215	LINE/L2	412	-	158	154770057	85287
chr5	14760188	14960188	harbor2	chr5	14775574	14776497	LINE/L2	794	-	462	14776036	15848
chr5	42530223	42730223	harbor2	chr5	42541074	42542555	LINE/L2	3227	-	740	42541814	11591
chr5	42530223	42730223	harbor2	chr5	42580216	42580446	LINE/L2	452	-	115	42580331	50108
chr5	42530223	42730223	harbor2	chr5	42616079	42617025	LINE/L2	2384	-	473	42616552	86329
chr5	178021742	178221742	harbor2	chr5	178094299	178094859	LINE/L2	937	-	280	178094579	72837
chr5	132222297	132422297	harbor2	chr5	132276844	132277229	LINE/L2	809	-	192	132277036	54739
chr5	132222297	132422297	harbor2	chr5	132277958	132278109	LINE/L2	869	-	76	132278034	55737
chr5	52700035	52900035	harbor2	chr5	52707646	52707778	LINE/L2	487	-	66	52707712	7677
chr5	52700035	52900035	harbor2	chr5	52707922	52708177	LINE/L2	410	-	128	52708050	8015
chr5	79137556	79337556	harbor2	chr5	79154725	79155163	LINE/L2	449	-	219	79154944	17388
chr5	10341873	10541873	harbor2	chr5	10357723	10357966	LINE/L2	1042	-	122	10357845	15972
chr5	10341873	10541873	harbor2	chr5	10358045	10358386	LINE/L2	1042	-	170	10358215	16342
chr5	10341873	10541873	harbor2	chr5	10409275	10409867	LINE/L2	1318	-	296	10409571	67698
chr5	10341873	10541873	harbor2	chr5	10409876	10410077	LINE/L2	645	-	100	10409976	68103
chr5	10341873	10541873	harbor2	chr5	10430106	10430286	LINE/L2	470	-	90	10430196	88323
chr5	10341897	10541897	harbor2	chr5	10357723	10357966	LINE/L2	1042	-	122	10357845	15948
chr5	10341897	10541897	harbor2	chr5	10358045	10358386	LINE/L2	1042	-	170	10358215	16318
chr5	10341897	10541897	harbor2	chr5	10409275	10409867	LINE/L2	1318	-	296	10409571	67674
chr5	10341897	10541897	harbor2	chr5	10409876	10410077	LINE/L2	645	-	100	10409976	68079
chr5	10341897	10541897	harbor2	chr5	10430106	10430286	LINE/L2	470	-	90	10430196	88299
chr5	10341909	10541909	harbor2	chr5	10357723	10357966	LINE/L2	1042	-	122	10357845	15936
chr5	10341909	10541909	harbor2	chr5	10358045	10358386	LINE/L2	1042	-	170	10358215	16306
chr5	10341909	10541909	harbor2	chr5	10409275	10409867	LINE/L2	1318	-	296	10409571	67662
chr5	10341909	10541909	harbor2	chr5	10409876	10410077	LINE/L2	645	-	100	10409976	68067
chr5	10341909	10541909	harbor2	chr5	10430106	10430286	LINE/L2	470	-	90	10430196	88287
chr5	12782680	12982680	harbor2	chr5	12841965	12842899	LINE/L2	898	-	467	12842432	59752
chr5	12782680	12982680	harbor2	chr5	12862358	12863410	LINE/L2	1395	-	526	12862884	80204
chr5	52705069	52905069	harbor2	chr5	52707646	52707778	LINE/L2	487	-	66	52707712	2643
chr5	52705069	52905069	harbor2	chr5	52707922	52708177	LINE/L2	410	-	128	52708050	2981
chr5	6617520	6817520	harbor2	chr5	6710996	6711292	LINE/L2	890	-	148	6711144	93624
chr5	6617520	6817520	harbor2	chr5	6711661	6711926	LINE/L2	890	-	132	6711793	94273
chr5	10341893	10541893	harbor2	chr5	10357723	10357966	LINE/L2	1042	-	122	10357845	15952
chr5	10341893	10541893	harbor2	chr5	10358045	10358386	LINE/L2	1042	-	170	10358215	16322
chr5	10341893	10541893	harbor2	chr5	10409275	10409867	LINE/L2	1318	-	296	10409571	67678
chr5	10341893	10541893	harbor2	chr5	10409876	10410077	LINE/L2	645	-	100	10409976	68083
chr5	10341893	10541893	harbor2	chr5	10430106	10430286	LINE/L2	470	-	90	10430196	88303
chr5	6630162	6830162	harbor2	chr5	6710996	6711292	LINE/L2	890	-	148	6711144	80982
chr5	6630162	6830162	harbor2	chr5	6711661	6711926	LINE/L2	890	-	132	6711793	81631
chr5	10527792	10727792	harbor2	chr5	10584641	10585072	LINE/L2	674	-	216	10584857	57065
chr5	94829534	95029534	harbor2	chr5	94874967	94875668	LINE/L2	1181	-	350	94875317	45783
chr5	94829534	95029534	harbor2	chr5	94876875	94877061	LINE/L2	477	-	93	94876968	47434
chr5	94829534	95029534	harbor2	chr5	94878657	94879223	LINE/L2	885	-	283	94878940	49406
chr5	94829534	95029534	harbor2	chr5	94904817	94905784	LINE/L2	1950	-	484	94905301	75767
chr5	10401998	10601998	harbor2	chr5	10409275	10409867	LINE/L2	1318	-	296	10409571	7573
chr5	10401998	10601998	harbor2	chr5	10409876	10410077	LINE/L2	645	-	100	10409976	7978
chr5	10401998	10601998	harbor2	chr5	10430106	10430286	LINE/L2	470	-	90	10430196	28198
chr5	10401998	10601998	harbor2	chr5	10453803	10453920	LINE/L2	491	-	58	10453861	51863
chr5	37741093	37941093	harbor2	chr5	37799395	37799725	LINE/L2	762	-	165	37799560	58467
chr5	135008272	135208272	harbor2	chr5	135045417	135045732	LINE/L2	490	-	158	135045575	37303
chr5	135008272	135208272	harbor2	chr5	135102772	135103267	LINE/L2	540	-	248	135103020	94748
chr5	147722928	147922928	harbor2	chr5	147742425	147742634	LINE/L2	595	-	104	147742529	19601
chr5	147722928	147922928	harbor2	chr5	147752630	147752957	LINE/L2	624	-	164	147752794	29866
chr5	147722928	147922928	harbor2	chr5	147759815	147760892	LINE/L2	1905	-	538	147760353	37425
chr5	147722928	147922928	harbor2	chr5	147788237	147788901	LINE/L2	613	-	332	147788569	65641
chr5	178133234	178333234	harbor2	chr5	178134014	178134339	LINE/L2	453	-	162	178134176	942
chr5	178133234	178333234	harbor2	chr5	178180377	178180531	LINE/L2	544	-	77	178180454	47220
chr5	178133234	178333234	harbor2	chr5	178199694	178199850	LINE/L2	439	-	78	178199772	66538
chr5	178133234	178333234	harbor2	chr5	178227435	178228437	LINE/L2	1346	-	501	178227936	94702
chr5	9115023	9315023	harbor2	chr5	9213251	9213577	LINE/L2	567	-	163	9213414	98391
chr5	75136870	75336870	harbor2	chr5	75152635	75152842	LINE/L2	701	-	104	75152739	15869
chr5	75136870	75336870	harbor2	chr5	75153401	75153666	LINE/L2	588	-	132	75153533	16663
chr5	91180678	91380678	harbor2	chr5	91194030	91194344	LINE/L2	746	-	157	91194187	13509
chr5	91180678	91380678	harbor2	chr5	91234789	91235253	LINE/L2	860	-	232	91235021	54343
chr5	91180678	91380678	harbor2	chr5	91193101	91193526	LINE/L2	576	-	212	91193313	12635
chr5	143113893	143313893	harbor2	chr5	143154076	143154316	LINE/L2	574	-	120	143154196	40303
chr5	132010466	132210466	harbor2	chr5	132016072	132016195	LINE/L2	603	-	62	132016134	5668
chr5	132010466	132210466	harbor2	chr5	132022352	132022453	LINE/L2	501	-	50	132022402	11936
chr5	132010466	132210466	harbor2	chr5	132029919	132030346	LINE/L2	599	-	214	132030133	19667
chr5	132010466	132210466	harbor2	chr5	132095993	132096163	LINE/L2	515	-	85	132096078	85612
chr5	132010466	132210466	harbor2	chr5	132096356	132096461	LINE/L2	515	-	52	132096408	85942
chr5	10341849	10541849	harbor2	chr5	10357723	10357966	LINE/L2	1042	-	122	10357845	15996
chr5	10341849	10541849	harbor2	chr5	10358045	10358386	LINE/L2	1042	-	170	10358215	16366
chr5	10341849	10541849	harbor2	chr5	10409275	10409867	LINE/L2	1318	-	296	10409571	67722
chr5	10341849	10541849	harbor2	chr5	10409876	10410077	LINE/L2	645	-	100	10409976	68127
chr5	10341849	10541849	harbor2	chr5	10430106	10430286	LINE/L2	470	-	90	10430196	88347
chr5	134446054	134646054	harbor2	chr5	134449847	134449964	LINE/L2	494	-	58	134449905	3851
chr5	134446054	134646054	harbor2	chr5	134450274	134450665	LINE/L2	494	-	196	134450470	4416
chr5	134446054	134646054	harbor2	chr5	134457849	134458198	LINE/L2	724	-	174	134458023	11969
chr5	134446054	134646054	harbor2	chr5	134531079	134531441	LINE/L2	686	-	181	134531260	85206
chr5	134446054	134646054	harbor2	chr5	134531576	134531589	LINE/L2	686	-	6	134531582	85528
chr5	134446054	134646054	harbor2	chr5	134532181	134532343	LINE/L2	686	-	81	134532262	86208
chr5	134446054	134646054	harbor2	chr5	134538104	134538512	LINE/L2	462	-	204	134538308	92254
chr5	132394503	132594503	harbor2	chr5	132423301	132423746	LINE/L2	882	-	222	132423523	29020
chr5	132394503	132594503	harbor2	chr5	132428316	132428619	LINE/L2	777	-	152	132428468	33965
chr5	132394503	132594503	harbor2	chr5	132428774	132429110	LINE/L2	657	-	168	132428942	34439
chr5	132394503	132594503	harbor2	chr5	132460729	132460862	LINE/L2	421	-	66	132460795	66292
chr5	10341903	10541903	harbor2	chr5	10357723	10357966	LINE/L2	1042	-	122	10357845	15942
chr5	10341903	10541903	harbor2	chr5	10358045	10358386	LINE/L2	1042	-	170	10358215	16312
chr5	10341903	10541903	harbor2	chr5	10409275	10409867	LINE/L2	1318	-	296	10409571	67668
chr5	10341903	10541903	harbor2	chr5	10409876	10410077	LINE/L2	645	-	100	10409976	68073
chr5	10341903	10541903	harbor2	chr5	10430106	10430286	LINE/L2	470	-	90	10430196	88293
chr5	10341907	10541907	harbor2	chr5	10357723	10357966	LINE/L2	1042	-	122	10357845	15938
chr5	10341907	10541907	harbor2	chr5	10358045	10358386	LINE/L2	1042	-	170	10358215	16308
chr5	10341907	10541907	harbor2	chr5	10409275	10409867	LINE/L2	1318	-	296	10409571	67664
chr5	10341907	10541907	harbor2	chr5	10409876	10410077	LINE/L2	645	-	100	10409976	68069
chr5	10341907	10541907	harbor2	chr5	10430106	10430286	LINE/L2	470	-	90	10430196	88289
chr5	10341896	10541896	harbor2	chr5	10357723	10357966	LINE/L2	1042	-	122	10357845	15949
chr5	10341896	10541896	harbor2	chr5	10358045	10358386	LINE/L2	1042	-	170	10358215	16319
chr5	10341896	10541896	harbor2	chr5	10409275	10409867	LINE/L2	1318	-	296	10409571	67675
chr5	10341896	10541896	harbor2	chr5	10409876	10410077	LINE/L2	645	-	100	10409976	68080
chr5	10341896	10541896	harbor2	chr5	10430106	10430286	LINE/L2	470	-	90	10430196	88300
chr5	133511227	133711227	harbor2	chr5	133580389	133580659	LINE/L2	547	-	135	133580524	69297
chr5	9115156	9315156	harbor2	chr5	9213251	9213577	LINE/L2	567	-	163	9213414	98258
chr5	135009155	135209155	harbor2	chr5	135045417	135045732	LINE/L2	490	-	158	135045575	36420
chr5	135009155	135209155	harbor2	chr5	135102772	135103267	LINE/L2	540	-	248	135103020	93865
chr5	134461279	134661279	harbor2	chr5	134531079	134531441	LINE/L2	686	-	181	134531260	69981
chr5	134461279	134661279	harbor2	chr5	134531576	134531589	LINE/L2	686	-	6	134531582	70303
chr5	134461279	134661279	harbor2	chr5	134532181	134532343	LINE/L2	686	-	81	134532262	70983
chr5	134461279	134661279	harbor2	chr5	134538104	134538512	LINE/L2	462	-	204	134538308	77029
chr5	134461279	134661279	harbor2	chr5	134546341	134546485	LINE/L2	438	-	72	134546413	85134
chr5	134461279	134661279	harbor2	chr5	134547763	134548047	LINE/L2	473	-	142	134547905	86626
chr5	135034308	135234308	harbor2	chr5	135045417	135045732	LINE/L2	490	-	158	135045575	11267
chr5	135034308	135234308	harbor2	chr5	135102772	135103267	LINE/L2	540	-	248	135103020	68712
chr5	53009476	53209476	harbor2	chr5	53024459	53024903	LINE/L2	642	-	222	53024681	15205
chr5	53009476	53209476	harbor2	chr5	53065224	53065534	LINE/L2	653	-	155	53065379	55903
chr5	168386830	168586830	harbor2	chr5	168424347	168424845	LINE/L2	494	-	249	168424596	37766
chr5	73405863	73605863	harbor2	chr5	73457510	73457889	LINE/L2	742	-	190	73457700	51837
chr5	73405863	73605863	harbor2	chr5	73492959	73493367	LINE/L2	753	-	204	73493163	87300
chr5	73405863	73605863	harbor2	chr5	73501305	73501780	LINE/L2	1114	-	238	73501543	95680
chr5	177412942	177612942	harbor2	chr5	177437914	177438086	LINE/L2	765	-	86	177438000	25058
chr5	177412942	177612942	harbor2	chr5	177438383	177438649	LINE/L2	765	-	133	177438516	25574
chr5	177412942	177612942	harbor2	chr5	177502044	177502574	LINE/L2	627	-	265	177502309	89367
chr5	7883420	8083420	harbor2	chr5	7902548	7902832	LINE/L2	629	-	142	7902690	19270
chr5	7883420	8083420	harbor2	chr5	7903436	7903587	LINE/L2	629	-	76	7903512	20092
chr5	10387001	10587001	harbor2	chr5	10409275	10409867	LINE/L2	1318	-	296	10409571	22570
chr5	10387001	10587001	harbor2	chr5	10409876	10410077	LINE/L2	645	-	100	10409976	22975
chr5	10387001	10587001	harbor2	chr5	10430106	10430286	LINE/L2	470	-	90	10430196	43195
chr5	10387001	10587001	harbor2	chr5	10453803	10453920	LINE/L2	491	-	58	10453861	66860
chr5	52700409	52900409	harbor2	chr5	52707646	52707778	LINE/L2	487	-	66	52707712	7303
chr5	52700409	52900409	harbor2	chr5	52707922	52708177	LINE/L2	410	-	128	52708050	7641
chr5	78833634	79033634	harbor2	chr5	78916864	78917185	LINE/L2	534	-	160	78917024	83390
chr5	137654191	137854191	harbor2	chr5	137698677	137698854	LINE/L2	440	-	88	137698765	44574
chr5	137654191	137854191	harbor2	chr5	137699099	137699590	LINE/L2	440	-	246	137699345	45154
chr5	137654191	137854191	harbor2	chr5	137702007	137702757	LINE/L2	805	-	375	137702382	48191
chr5	137654191	137854191	harbor2	chr5	137706785	137707114	LINE/L2	494	-	164	137706949	52758
chr5	137654191	137854191	harbor2	chr5	137708518	137708848	LINE/L2	649	-	165	137708683	54492
chr5	137654191	137854191	harbor2	chr5	137713009	137713121	LINE/L2	426	-	56	137713065	58874
chr5	137654191	137854191	harbor2	chr5	137720906	137721484	LINE/L2	762	-	289	137721195	67004
chr5	6613124	6813124	harbor2	chr5	6710996	6711292	LINE/L2	890	-	148	6711144	98020
chr5	6613124	6813124	harbor2	chr5	6711661	6711926	LINE/L2	890	-	132	6711793	98669
chr5	132774151	132974151	harbor2	chr5	132787061	132787185	LINE/L2	413	-	62	132787123	12972
chr5	10762842	10962842	harbor2	chr5	10801133	10801335	LINE/L2	673	-	101	10801234	38392
chr5	133166465	133366465	harbor2	chr5	133259070	133259507	LINE/L2	547	-	218	133259288	92823
chr5	133166465	133366465	harbor2	chr5	133259599	133259906	LINE/L2	509	-	154	133259753	93288
chr5	133166465	133366465	harbor2	chr5	133262973	133263375	LINE/L2	634	-	201	133263174	96709
chr5	133166465	133366465	harbor2	chr5	133263656	133263988	LINE/L2	516	-	166	133263822	97357
chr5	133511241	133711241	harbor2	chr5	133580389	133580659	LINE/L2	547	-	135	133580524	69283
chr5	135088316	135288316	harbor2	chr5	135102772	135103267	LINE/L2	540	-	248	135103020	14704
chr5	135088316	135288316	harbor2	chr5	135148888	135149035	LINE/L2	439	-	74	135148962	60646
chr5	135088316	135288316	harbor2	chr5	135164047	135164595	LINE/L2	624	-	274	135164321	76005
chr5	135088316	135288316	harbor2	chr5	135166315	135166411	LINE/L2	793	-	48	135166363	78047
chr5	135088316	135288316	harbor2	chr5	135166707	135166936	LINE/L2	793	-	114	135166821	78505
chr5	135088316	135288316	harbor2	chr5	135168111	135168251	LINE/L2	486	-	70	135168181	79865
chr5	135088316	135288316	harbor2	chr5	135176773	135177094	LINE/L2	514	-	160	135176933	88617
chr5	37740773	37940773	harbor2	chr5	37799395	37799725	LINE/L2	762	-	165	37799560	58787
chr5	10342482	10542482	harbor2	chr5	10357723	10357966	LINE/L2	1042	-	122	10357845	15363
chr5	10342482	10542482	harbor2	chr5	10358045	10358386	LINE/L2	1042	-	170	10358215	15733
chr5	10342482	10542482	harbor2	chr5	10409275	10409867	LINE/L2	1318	-	296	10409571	67089
chr5	10342482	10542482	harbor2	chr5	10409876	10410077	LINE/L2	645	-	100	10409976	67494
chr5	10342482	10542482	harbor2	chr5	10430106	10430286	LINE/L2	470	-	90	10430196	87714
chr5	135018132	135218132	harbor2	chr5	135045417	135045732	LINE/L2	490	-	158	135045575	27443
chr5	135018132	135218132	harbor2	chr5	135102772	135103267	LINE/L2	540	-	248	135103020	84888
chr5	50869990	51069990	harbor2	chr5	50886001	50886603	LINE/L2	518	-	301	50886302	16312
chr5	50869990	51069990	harbor2	chr5	50899108	50899541	LINE/L2	483	-	216	50899324	29334
chr5	50869990	51069990	harbor2	chr5	50905456	50905534	LINE/L2	814	-	39	50905495	35505
chr5	50869990	51069990	harbor2	chr5	50905842	50905980	LINE/L2	814	-	69	50905911	35921
chr5	50869990	51069990	harbor2	chr5	50906018	50907377	LINE/L2	2602	-	680	50906698	36708
chr5	50869990	51069990	harbor2	chr5	50931081	50931861	LINE/L2	939	-	390	50931471	61481
chr5	6533029	6733029	harbor2	chr5	6540631	6541314	LINE/L2	998	-	342	6540973	7944
chr5	139797098	139997098	harbor2	chr5	139805404	139805977	LINE/L2	936	-	286	139805690	8592
chr5	139797098	139997098	harbor2	chr5	139812070	139812454	LINE/L2	945	-	192	139812262	15164
chr5	139797098	139997098	harbor2	chr5	139825517	139825951	LINE/L2	538	-	217	139825734	28636
chr5	139797098	139997098	harbor2	chr5	139825970	139826211	LINE/L2	410	-	120	139826090	28992
chr5	139797098	139997098	harbor2	chr5	139827231	139827567	LINE/L2	771	-	168	139827399	30301
chr5	139797098	139997098	harbor2	chr5	139827921	139828053	LINE/L2	771	-	66	139827987	30889
chr5	139797098	139997098	harbor2	chr5	139835387	139835536	LINE/L2	432	-	74	139835461	38363
chr5	139797098	139997098	harbor2	chr5	139853414	139853625	LINE/L2	433	-	106	139853520	56422
chr5	53460613	53660613	harbor2	chr5	53469504	53469677	LINE/L2	466	-	86	53469590	8977
chr5	53460613	53660613	harbor2	chr5	53517897	53518604	LINE/L2	579	-	354	53518251	57638
chr5	53460613	53660613	harbor2	chr5	53553328	53553772	LINE/L2	1132	-	222	53553550	92937
chr5	53460613	53660613	harbor2	chr5	53554516	53555164	LINE/L2	2007	-	324	53554840	94227
chr6	7720332	7920332	harbor2	chr6	7782732	7783270	LINE/L2	827	-	269	7783001	62669
chr6	7720332	7920332	harbor2	chr6	7795556	7796096	LINE/L2	489	-	270	7795826	75494
chr6	7720332	7920332	harbor2	chr6	7781994	7782430	LINE/L2	827	-	218	7782212	61880
chr6	147104110	147304110	harbor2	chr6	147163614	147164078	LINE/L2	639	-	232	147163846	59736
chr6	147104110	147304110	harbor2	chr6	147192610	147192832	LINE/L2	724	-	111	147192721	88611
chr6	147104110	147304110	harbor2	chr6	147193173	147193664	LINE/L2	1111	-	246	147193419	89309
chr6	152902804	153102804	harbor2	chr6	152947790	152947893	LINE/L2	478	-	52	152947842	45038
chr6	152902804	153102804	harbor2	chr6	152980529	152980844	LINE/L2	555	-	158	152980687	77883
chr6	7626958	7826958	harbor2	chr6	7673825	7674099	LINE/L2	796	-	137	7673962	47004
chr6	30621444	30821444	harbor2	chr6	30630970	30631201	LINE/L2	945	-	116	30631086	9642
chr6	30621444	30821444	harbor2	chr6	30631799	30632026	LINE/L2	2317	-	114	30631913	10469
chr6	30621444	30821444	harbor2	chr6	30632586	30632656	LINE/L2	2317	-	35	30632621	11177
chr6	30621444	30821444	harbor2	chr6	30632957	30633415	LINE/L2	2317	-	229	30633186	11742
chr6	30621444	30821444	harbor2	chr6	30635239	30635316	LINE/L2	1763	-	38	30635277	13833
chr6	30621444	30821444	harbor2	chr6	30635614	30636108	LINE/L2	1763	-	247	30635861	14417
chr6	125225390	125425390	harbor2	chr6	125231945	125232176	LINE/L2	452	-	116	125232061	6671
chr6	125225390	125425390	harbor2	chr6	125237007	125237482	LINE/L2	1465	-	238	125237245	11855
chr6	125225390	125425390	harbor2	chr6	125302449	125303141	LINE/L2	1598	-	346	125302795	77405
chr6	32870211	33070211	harbor2	chr6	32940454	32940651	LINE/L2	467	-	98	32940552	70341
chr6	32870211	33070211	harbor2	chr6	32954244	32954701	LINE/L2	514	-	228	32954472	84261
chr6	29530473	29730473	harbor2	chr6	29547817	29548503	LINE/L2	4421	-	343	29548160	17687
chr6	29530473	29730473	harbor2	chr6	29548848	29549784	LINE/L2	4421	-	468	29549316	18843
chr6	29530473	29730473	harbor2	chr6	29549802	29550008	LINE/L2	535	-	103	29549905	19432
chr6	37002837	37202837	harbor2	chr6	37056913	37057453	LINE/L2	1792	-	270	37057183	54346
chr6	10445756	10645756	harbor2	chr6	10462848	10463091	LINE/L2	1284	-	122	10462970	17214
chr6	10445756	10645756	harbor2	chr6	10463673	10464061	LINE/L2	1284	-	194	10463867	18111
chr6	7626956	7826956	harbor2	chr6	7673825	7674099	LINE/L2	796	-	137	7673962	47006
chr6	139488617	139688617	harbor2	chr6	139494325	139494613	LINE/L2	582	-	144	139494469	5852
chr6	89850691	90050691	harbor2	chr6	89936067	89936321	LINE/L2	491	-	127	89936194	85503
chr6	89850691	90050691	harbor2	chr6	89936442	89936529	LINE/L2	491	-	44	89936486	85795
chr6	45543677	45743677	harbor2	chr6	45571169	45571439	LINE/L2	530	-	135	45571304	27627
chr6	45543677	45743677	harbor2	chr6	45623351	45623670	LINE/L2	693	-	160	45623511	79834
chr6	45543677	45743677	harbor2	chr6	45636188	45636393	LINE/L2	703	-	102	45636290	92613
chr6	41537706	41737706	harbor2	chr6	41635109	41635536	LINE/L2	705	-	214	41635323	97617
chr6	43073296	43273296	harbor2	chr6	43135294	43135758	LINE/L2	1662	-	232	43135526	62230
chr6	43073296	43273296	harbor2	chr6	43137122	43137682	LINE/L2	1662	-	280	43137402	64106
chr6	7772024	7972024	harbor2	chr6	7782732	7783270	LINE/L2	827	-	269	7783001	10977
chr6	7772024	7972024	harbor2	chr6	7795556	7796096	LINE/L2	489	-	270	7795826	23802
chr6	7772024	7972024	harbor2	chr6	7823396	7824209	LINE/L2	930	-	406	7823802	51778
chr6	7772024	7972024	harbor2	chr6	7781994	7782430	LINE/L2	827	-	218	7782212	10188
chr6	45541160	45741160	harbor2	chr6	45571169	45571439	LINE/L2	530	-	135	45571304	30144
chr6	45541160	45741160	harbor2	chr6	45623351	45623670	LINE/L2	693	-	160	45623511	82351
chr6	45541160	45741160	harbor2	chr6	45636188	45636393	LINE/L2	703	-	102	45636290	95130
chr6	63473867	63673867	harbor2	chr6	63479865	63479996	LINE/L2	610	-	66	63479931	6064
chr6	7629037	7829037	harbor2	chr6	7673825	7674099	LINE/L2	796	-	137	7673962	44925
chr6	41095053	41295053	harbor2	chr6	41102880	41103560	LINE/L2	975	-	340	41103220	8167
chr6	41095053	41295053	harbor2	chr6	41103881	41104928	LINE/L2	1408	-	524	41104405	9352
chr6	41095053	41295053	harbor2	chr6	41135696	41136940	LINE/L2	3328	-	622	41136318	41265
chr6	45542351	45742351	harbor2	chr6	45571169	45571439	LINE/L2	530	-	135	45571304	28953
chr6	45542351	45742351	harbor2	chr6	45623351	45623670	LINE/L2	693	-	160	45623511	81160
chr6	45542351	45742351	harbor2	chr6	45636188	45636393	LINE/L2	703	-	102	45636290	93939
chr6	35469329	35669329	harbor2	chr6	35514799	35515081	LINE/L2	581	-	141	35514940	45611
chr6	35469329	35669329	harbor2	chr6	35515378	35515389	LINE/L2	581	-	6	35515384	46055
chr6	35469329	35669329	harbor2	chr6	35515707	35515740	LINE/L2	581	-	16	35515723	46394
chr6	35469329	35669329	harbor2	chr6	35516039	35516134	LINE/L2	581	-	48	35516087	46758
chr6	35469329	35669329	harbor2	chr6	35521389	35521485	LINE/L2	451	-	48	35521437	52108
chr6	13879117	14079117	harbor2	chr6	13916998	13917410	LINE/L2	740	-	206	13917204	38087
chr6	13879117	14079117	harbor2	chr6	13934828	13935211	LINE/L2	682	-	192	13935020	55903
chr6	13879117	14079117	harbor2	chr6	13936559	13937085	LINE/L2	443	-	263	13936822	57705
chr6	13879117	14079117	harbor2	chr6	13959198	13960186	LINE/L2	1651	-	494	13959692	80575
chr6	90487353	90687353	harbor2	chr6	90548394	90549688	LINE/L2	3284	-	647	90549041	61688
chr6	90487353	90687353	harbor2	chr6	90576544	90577662	LINE/L2	1572	-	559	90577103	89750
chr6	167863275	168063275	harbor2	chr6	167930778	167931458	LINE/L2	489	-	340	167931118	67843
chr6	7626983	7826983	harbor2	chr6	7673825	7674099	LINE/L2	796	-	137	7673962	46979
chr6	161064077	161264077	harbor2	chr6	161068062	161068434	LINE/L2	479	-	186	161068248	4171
chr6	6447005	6647005	harbor2	chr6	6447968	6448419	LINE/L2	907	-	226	6448194	1189
chr6	6447005	6647005	harbor2	chr6	6503577	6503666	LINE/L2	464	-	44	6503621	56616
chr6	45540928	45740928	harbor2	chr6	45571169	45571439	LINE/L2	530	-	135	45571304	30376
chr6	45540928	45740928	harbor2	chr6	45623351	45623670	LINE/L2	693	-	160	45623511	82583
chr6	45540928	45740928	harbor2	chr6	45636188	45636393	LINE/L2	703	-	102	45636290	95362
chr6	138473227	138673227	harbor2	chr6	138501293	138501525	LINE/L2	463	-	116	138501409	28182
chr6	138473227	138673227	harbor2	chr6	138535026	138535281	LINE/L2	931	-	128	138535154	61927
chr6	138473227	138673227	harbor2	chr6	138535567	138535776	LINE/L2	931	-	104	138535671	62444
chr6	138473227	138673227	harbor2	chr6	138563688	138563967	LINE/L2	452	-	140	138563828	90601
chr6	138473227	138673227	harbor2	chr6	138564607	138564923	LINE/L2	471	-	158	138564765	91538
chr6	63703058	63903058	harbor2	chr6	63732815	63733200	LINE/L2	728	-	192	63733007	29949
chr6	63703058	63903058	harbor2	chr6	63734372	63734834	LINE/L2	1574	-	231	63734603	31545
chr6	7628030	7828030	harbor2	chr6	7673825	7674099	LINE/L2	796	-	137	7673962	45932
chr6	166057634	166257634	harbor2	chr6	166093126	166093555	LINE/L2	780	-	214	166093340	35706
chr6	43872696	44072696	harbor2	chr6	43873237	43873931	LINE/L2	1575	-	347	43873584	888
chr6	43872696	44072696	harbor2	chr6	43930328	43930479	LINE/L2	1148	-	76	43930404	57708
chr6	43872696	44072696	harbor2	chr6	43930772	43931035	LINE/L2	1148	-	132	43930904	58208
chr6	37189816	37389816	harbor2	chr6	37209755	37210245	LINE/L2	1264	-	245	37210000	20184
chr6	37189816	37389816	harbor2	chr6	37254675	37254790	LINE/L2	565	-	58	37254733	64917
chr6	37189816	37389816	harbor2	chr6	37255199	37255399	LINE/L2	797	-	100	37255299	65483
chr6	37189816	37389816	harbor2	chr6	37255699	37255830	LINE/L2	797	-	66	37255765	65949
chr6	37189816	37389816	harbor2	chr6	37207620	37208528	LINE/L2	1760	-	454	37208074	18258
chr6	167863262	168063262	harbor2	chr6	167930778	167931458	LINE/L2	489	-	340	167931118	67856
chr6	165561181	165761181	harbor2	chr6	165624647	165625519	LINE/L2	842	-	436	165625083	63902
chr6	165561181	165761181	harbor2	chr6	165625872	165626077	LINE/L2	842	-	102	165625974	64793
chr6	33522490	33722490	harbor2	chr6	33592235	33592656	LINE/L2	737	-	210	33592445	69955
chr6	127169085	127369085	harbor2	chr6	127216023	127216401	LINE/L2	1135	-	189	127216212	47127
chr6	127169085	127369085	harbor2	chr6	127219438	127219968	LINE/L2	1152	-	265	127219703	50618
chr6	127169085	127369085	harbor2	chr6	127250807	127251184	LINE/L2	471	-	188	127250995	81910
chr6	127169085	127369085	harbor2	chr6	127264711	127265489	LINE/L2	953	-	389	127265100	96015
chr6	152219275	152419275	harbor2	chr6	152237982	152238286	LINE/L2	452	-	152	152238134	18859
chr6	52583140	52783140	harbor2	chr6	52615213	52615525	LINE/L2	523	-	156	52615369	32229
chr6	52583140	52783140	harbor2	chr6	52680058	52680391	LINE/L2	503	-	166	52680224	97084
chr6	37253997	37453997	harbor2	chr6	37254675	37254790	LINE/L2	565	-	58	37254733	736
chr6	37253997	37453997	harbor2	chr6	37255199	37255399	LINE/L2	797	-	100	37255299	1302
chr6	37253997	37453997	harbor2	chr6	37255699	37255830	LINE/L2	797	-	66	37255765	1768
chr6	37253997	37453997	harbor2	chr6	37304805	37305038	LINE/L2	591	-	116	37304921	50924
chr6	37253997	37453997	harbor2	chr6	37317455	37318678	LINE/L2	2646	-	612	37318067	64070
chr6	127168838	127368838	harbor2	chr6	127216023	127216401	LINE/L2	1135	-	189	127216212	47374
chr6	127168838	127368838	harbor2	chr6	127219438	127219968	LINE/L2	1152	-	265	127219703	50865
chr6	127168838	127368838	harbor2	chr6	127250807	127251184	LINE/L2	471	-	188	127250995	82157
chr6	127168838	127368838	harbor2	chr6	127264711	127265489	LINE/L2	953	-	389	127265100	96262
chr6	45542549	45742549	harbor2	chr6	45571169	45571439	LINE/L2	530	-	135	45571304	28755
chr6	45542549	45742549	harbor2	chr6	45623351	45623670	LINE/L2	693	-	160	45623511	80962
chr6	45542549	45742549	harbor2	chr6	45636188	45636393	LINE/L2	703	-	102	45636290	93741
chr6	47581748	47781748	harbor2	chr6	47649660	47650062	LINE/L2	730	-	201	47649861	68113
chr6	47581748	47781748	harbor2	chr6	47650405	47650461	LINE/L2	730	-	28	47650433	68685
chr6	47581748	47781748	harbor2	chr6	47650462	47650697	LINE/L2	1118	-	118	47650580	68832
chr6	47581748	47781748	harbor2	chr6	47651099	47651853	LINE/L2	1118	-	377	47651476	69728
chr6	47581748	47781748	harbor2	chr6	47652662	47652878	LINE/L2	577	-	108	47652770	71022
chr6	30621530	30821530	harbor2	chr6	30630970	30631201	LINE/L2	945	-	116	30631086	9556
chr6	30621530	30821530	harbor2	chr6	30631799	30632026	LINE/L2	2317	-	114	30631913	10383
chr6	30621530	30821530	harbor2	chr6	30632586	30632656	LINE/L2	2317	-	35	30632621	11091
chr6	30621530	30821530	harbor2	chr6	30632957	30633415	LINE/L2	2317	-	229	30633186	11656
chr6	30621530	30821530	harbor2	chr6	30635239	30635316	LINE/L2	1763	-	38	30635277	13747
chr6	30621530	30821530	harbor2	chr6	30635614	30636108	LINE/L2	1763	-	247	30635861	14331
chr6	139336768	139536768	harbor2	chr6	139423119	139423315	LINE/L2	500	-	98	139423217	86449
chr6	43739619	43939619	harbor2	chr6	43813248	43813422	LINE/L2	455	-	87	43813335	73716
chr6	43739619	43939619	harbor2	chr6	43813477	43813849	LINE/L2	602	-	186	43813663	74044
chr6	43739619	43939619	harbor2	chr6	43821830	43822021	LINE/L2	970	-	96	43821926	82307
chr6	43739619	43939619	harbor2	chr6	43822329	43822447	LINE/L2	970	-	59	43822388	82769
chr6	42953847	43153847	harbor2	chr6	43000847	43001123	LINE/L2	483	-	138	43000985	47138
chr6	42953847	43153847	harbor2	chr6	43023813	43023858	LINE/L2	461	-	22	43023835	69988
chr6	42953847	43153847	harbor2	chr6	43024152	43024653	LINE/L2	680	-	250	43024402	70555
chr6	52477059	52677059	harbor2	chr6	52479968	52479986	LINE/L2	1354	-	9	52479977	2918
chr6	52477059	52677059	harbor2	chr6	52480401	52481504	LINE/L2	3093	-	552	52480953	3894
chr6	52477059	52677059	harbor2	chr6	52481811	52481963	LINE/L2	3093	-	76	52481887	4828
chr6	52477059	52677059	harbor2	chr6	52483798	52484219	LINE/L2	1638	-	210	52484008	6949
chr6	52477059	52677059	harbor2	chr6	52484720	52484883	LINE/L2	1638	-	82	52484802	7743
chr6	52477059	52677059	harbor2	chr6	52485109	52485210	LINE/L2	513	-	50	52485159	8100
chr6	52477059	52677059	harbor2	chr6	52513349	52513944	LINE/L2	674	-	298	52513647	36588
chr6	52477059	52677059	harbor2	chr6	52514109	52514228	LINE/L2	674	-	60	52514169	37110
chr6	127285001	127485001	harbor2	chr6	127290699	127291237	LINE/L2	828	-	269	127290968	5967
chr6	45541342	45741342	harbor2	chr6	45571169	45571439	LINE/L2	530	-	135	45571304	29962
chr6	45541342	45741342	harbor2	chr6	45623351	45623670	LINE/L2	693	-	160	45623511	82169
chr6	45541342	45741342	harbor2	chr6	45636188	45636393	LINE/L2	703	-	102	45636290	94948
chr6	43416854	43616854	harbor2	chr6	43476462	43476825	LINE/L2	1205	-	182	43476644	59790
chr6	43416854	43616854	harbor2	chr6	43476838	43477114	LINE/L2	530	-	138	43476976	60122
chr6	37002843	37202843	harbor2	chr6	37056913	37057453	LINE/L2	1792	-	270	37057183	54340
chr6	108995339	109195339	harbor2	chr6	109071095	109071321	LINE/L2	637	-	113	109071208	75869
chr6	4985270	5185270	harbor2	chr6	5039278	5039391	LINE/L2	569	-	56	5039334	54064
chr6	139373354	139573354	harbor2	chr6	139423119	139423315	LINE/L2	500	-	98	139423217	49863
chr6	30946660	31146660	harbor2	chr6	30958207	30958353	LINE/L2	486	-	73	30958280	11620
chr6	52185079	52385079	harbor2	chr6	52214206	52214489	LINE/L2	1437	-	142	52214348	29269
chr6	52185079	52385079	harbor2	chr6	52214532	52214970	LINE/L2	1437	-	219	52214751	29672
chr6	52185079	52385079	harbor2	chr6	52215341	52216307	LINE/L2	807	-	483	52215824	30745
chr6	31940012	32140012	harbor2	chr6	31942582	31942881	LINE/L2	906	-	150	31942732	2720
chr6	31940012	32140012	harbor2	chr6	32003425	32003864	LINE/L2	583	-	220	32003645	63633
chr6	31940012	32140012	harbor2	chr6	32036162	32036601	LINE/L2	583	-	220	32036382	96370
chr6	151352799	151552799	harbor2	chr6	151384248	151384768	LINE/L2	558	-	260	151384508	31709
chr6	125542072	125742072	harbor2	chr6	125555907	125556049	LINE/L2	500	-	71	125555978	13906
chr6	125542072	125742072	harbor2	chr6	125556261	125556923	LINE/L2	1889	-	331	125556592	14520
chr6	125542072	125742072	harbor2	chr6	125575238	125575495	LINE/L2	462	-	128	125575366	33294
chr6	125542072	125742072	harbor2	chr6	125576985	125577535	LINE/L2	1643	-	275	125577260	35188
chr6	125542072	125742072	harbor2	chr6	125623369	125623813	LINE/L2	981	-	222	125623591	81519
chr6	146813947	147013947	harbor2	chr6	146814336	146814570	LINE/L2	491	-	117	146814453	506
chr6	45541330	45741330	harbor2	chr6	45571169	45571439	LINE/L2	530	-	135	45571304	29974
chr6	45541330	45741330	harbor2	chr6	45623351	45623670	LINE/L2	693	-	160	45623511	82181
chr6	45541330	45741330	harbor2	chr6	45636188	45636393	LINE/L2	703	-	102	45636290	94960
chr6	106533593	106733593	harbor2	chr6	106532924	106534018	LINE/L2	1895	-	547	106533471	122
chr6	106533593	106733593	harbor2	chr6	106614326	106614849	LINE/L2	507	-	262	106614588	80995
chr6	106533593	106733593	harbor2	chr6	106625300	106625645	LINE/L2	1289	-	172	106625472	91879
chr6	106533593	106733593	harbor2	chr6	106625956	106626198	LINE/L2	1289	-	121	106626077	92484
chr6	133854144	134054144	harbor2	chr6	133869053	133869071	LINE/L2	686	-	9	133869062	14918
chr6	133854144	134054144	harbor2	chr6	133869414	133869786	LINE/L2	686	-	186	133869600	15456
chr6	133854144	134054144	harbor2	chr6	133882443	133882641	LINE/L2	446	-	99	133882542	28398
chr6	133854144	134054144	harbor2	chr6	133883469	133883919	LINE/L2	529	-	225	133883694	29550
chr6	41092984	41292984	harbor2	chr6	41102880	41103560	LINE/L2	975	-	340	41103220	10236
chr6	41092984	41292984	harbor2	chr6	41103881	41104928	LINE/L2	1408	-	524	41104405	11421
chr6	41092984	41292984	harbor2	chr6	41135696	41136940	LINE/L2	3328	-	622	41136318	43334
chr6	127167575	127367575	harbor2	chr6	127216023	127216401	LINE/L2	1135	-	189	127216212	48637
chr6	127167575	127367575	harbor2	chr6	127219438	127219968	LINE/L2	1152	-	265	127219703	52128
chr6	127167575	127367575	harbor2	chr6	127250807	127251184	LINE/L2	471	-	188	127250995	83420
chr6	127167575	127367575	harbor2	chr6	127264711	127265489	LINE/L2	953	-	389	127265100	97525
chr6	124977679	125177679	harbor2	chr6	124979451	124979907	LINE/L2	826	-	228	124979679	2000
chr6	124977679	125177679	harbor2	chr6	125013121	125013345	LINE/L2	825	-	112	125013233	35554
chr6	124977679	125177679	harbor2	chr6	125013390	125013549	LINE/L2	825	-	80	125013470	35791
chr6	124977679	125177679	harbor2	chr6	125022929	125023318	LINE/L2	666	-	194	125023123	45444
chr6	124977679	125177679	harbor2	chr6	125024766	125025204	LINE/L2	547	-	219	125024985	47306
chr6	37002888	37202888	harbor2	chr6	37056913	37057453	LINE/L2	1792	-	270	37057183	54295
chr6	45543573	45743573	harbor2	chr6	45571169	45571439	LINE/L2	530	-	135	45571304	27731
chr6	45543573	45743573	harbor2	chr6	45623351	45623670	LINE/L2	693	-	160	45623511	79938
chr6	45543573	45743573	harbor2	chr6	45636188	45636393	LINE/L2	703	-	102	45636290	92717
chr6	139419971	139619971	harbor2	chr6	139423119	139423315	LINE/L2	500	-	98	139423217	3246
chr6	139419971	139619971	harbor2	chr6	139477488	139477809	LINE/L2	456	-	160	139477648	57677
chr6	139419971	139619971	harbor2	chr6	139494325	139494613	LINE/L2	582	-	144	139494469	74498
chr6	37003451	37203451	harbor2	chr6	37056913	37057453	LINE/L2	1792	-	270	37057183	53732
chr6	11912017	12112017	harbor2	chr6	11964815	11964967	LINE/L2	745	-	76	11964891	52874
chr6	11912017	12112017	harbor2	chr6	11965319	11965612	LINE/L2	745	-	146	11965465	53448
chr6	56126551	56326551	harbor2	chr6	56138396	56139119	LINE/L2	1374	-	362	56138758	12207
chr6	56126551	56326551	harbor2	chr6	56199782	56200304	LINE/L2	774	-	261	56200043	73492
chr6	33105578	33305578	harbor2	chr6	33141519	33142411	LINE/L2	614	-	446	33141965	36387
chr6	41839250	42039250	harbor2	chr6	41924687	41925178	LINE/L2	953	-	246	41924933	85683
chr6	24674917	24874917	harbor2	chr6	24691333	24691717	LINE/L2	734	-	192	24691525	16608
chr6	32071139	32271139	harbor2	chr6	32136970	32137237	LINE/L2	1053	-	134	32137104	65965
chr6	32071139	32271139	harbor2	chr6	32137518	32138010	LINE/L2	1053	-	246	32137764	66625
chr6	32071139	32271139	harbor2	chr6	32140897	32141150	LINE/L2	607	-	126	32141023	69884
chr6	32071139	32271139	harbor2	chr6	32141667	32142496	LINE/L2	1403	-	414	32142081	70942
chr6	32071139	32271139	harbor2	chr6	32158510	32158976	LINE/L2	1038	-	233	32158743	87604
chr6	42647524	42847524	harbor2	chr6	42688778	42689153	LINE/L2	726	-	188	42688966	41442
chr6	42647524	42847524	harbor2	chr6	42709440	42709602	LINE/L2	533	-	81	42709521	61997
chr6	167863251	168063251	harbor2	chr6	167930778	167931458	LINE/L2	489	-	340	167931118	67867
chr6	41449219	41649219	harbor2	chr6	41458728	41458865	LINE/L2	557	-	68	41458796	9577
chr6	41449219	41649219	harbor2	chr6	41459226	41459401	LINE/L2	645	-	88	41459314	10095
chr6	41449219	41649219	harbor2	chr6	41491337	41491973	LINE/L2	1463	-	318	41491655	42436
chr6	41449219	41649219	harbor2	chr6	41520482	41520801	LINE/L2	789	-	160	41520642	71423
chr6	41449219	41649219	harbor2	chr6	41536409	41537000	LINE/L2	535	-	296	41536705	87486
chr6	41449219	41649219	harbor2	chr6	41537454	41537483	LINE/L2	535	-	14	41537468	88249
chr6	52190864	52390864	harbor2	chr6	52214206	52214489	LINE/L2	1437	-	142	52214348	23484
chr6	52190864	52390864	harbor2	chr6	52214532	52214970	LINE/L2	1437	-	219	52214751	23887
chr6	52190864	52390864	harbor2	chr6	52215341	52216307	LINE/L2	807	-	483	52215824	24960
chr6	23317064	23517064	harbor2	chr6	23415699	23416411	LINE/L2	1591	-	356	23416055	98991
chr6	41462100	41662100	harbor2	chr6	41491337	41491973	LINE/L2	1463	-	318	41491655	29555
chr6	41462100	41662100	harbor2	chr6	41520482	41520801	LINE/L2	789	-	160	41520642	58542
chr6	41462100	41662100	harbor2	chr6	41536409	41537000	LINE/L2	535	-	296	41536705	74605
chr6	41462100	41662100	harbor2	chr6	41537454	41537483	LINE/L2	535	-	14	41537468	75368
chr6	167863272	168063272	harbor2	chr6	167930778	167931458	LINE/L2	489	-	340	167931118	67846
chr6	30621455	30821455	harbor2	chr6	30630970	30631201	LINE/L2	945	-	116	30631086	9631
chr6	30621455	30821455	harbor2	chr6	30631799	30632026	LINE/L2	2317	-	114	30631913	10458
chr6	30621455	30821455	harbor2	chr6	30632586	30632656	LINE/L2	2317	-	35	30632621	11166
chr6	30621455	30821455	harbor2	chr6	30632957	30633415	LINE/L2	2317	-	229	30633186	11731
chr6	30621455	30821455	harbor2	chr6	30635239	30635316	LINE/L2	1763	-	38	30635277	13822
chr6	30621455	30821455	harbor2	chr6	30635614	30636108	LINE/L2	1763	-	247	30635861	14406
chr6	34138363	34338363	harbor2	chr6	34139870	34140432	LINE/L2	1363	-	281	34140151	1788
chr6	34138363	34338363	harbor2	chr6	34200362	34200564	LINE/L2	602	-	101	34200463	62100
chr6	34138363	34338363	harbor2	chr6	34201465	34201594	LINE/L2	580	-	64	34201529	63166
chr6	34138363	34338363	harbor2	chr6	34201904	34202020	LINE/L2	580	-	58	34201962	63599
chr6	34138363	34338363	harbor2	chr6	34203293	34203502	LINE/L2	580	-	104	34203397	65034
chr6	34138363	34338363	harbor2	chr6	34230148	34230407	LINE/L2	1216	-	130	34230278	91915
chr6	34138363	34338363	harbor2	chr6	34230667	34230970	LINE/L2	1216	-	152	34230819	92456
chr6	170478408	170678408	harbor2	chr6	170512191	170512638	LINE/L2	471	-	224	170512415	34007
chr6	170478408	170678408	harbor2	chr6	170512838	170513502	LINE/L2	1201	-	332	170513170	34762
chr6	7770431	7970431	harbor2	chr6	7782732	7783270	LINE/L2	827	-	269	7783001	12570
chr6	7770431	7970431	harbor2	chr6	7795556	7796096	LINE/L2	489	-	270	7795826	25395
chr6	7770431	7970431	harbor2	chr6	7823396	7824209	LINE/L2	930	-	406	7823802	53371
chr6	7770431	7970431	harbor2	chr6	7781994	7782430	LINE/L2	827	-	218	7782212	11781
chr6	107718911	107918911	harbor2	chr6	107746112	107746335	LINE/L2	647	-	112	107746224	27313
chr6	107718911	107918911	harbor2	chr6	107751011	107751572	LINE/L2	2469	-	280	107751291	32380
chr6	107718911	107918911	harbor2	chr6	107751933	107752702	LINE/L2	2469	-	384	107752317	33406
chr6	107718911	107918911	harbor2	chr6	107752754	107752897	LINE/L2	464	-	72	107752826	33915
chr6	107718911	107918911	harbor2	chr6	107753677	107754128	LINE/L2	1142	-	226	107753903	34992
chr6	107718911	107918911	harbor2	chr6	107758084	107758186	LINE/L2	497	-	51	107758135	39224
chr6	107718911	107918911	harbor2	chr6	107758200	107758437	LINE/L2	607	-	118	107758318	39407
chr6	107718911	107918911	harbor2	chr6	107758883	107758990	LINE/L2	607	-	54	107758937	40026
chr6	107718911	107918911	harbor2	chr6	107759368	107759535	LINE/L2	607	-	84	107759452	40541
chr6	107718911	107918911	harbor2	chr6	107802076	107802566	LINE/L2	1345	-	245	107802321	83410
chr6	56333514	56533514	harbor2	chr6	56376083	56376542	LINE/L2	604	-	230	56376313	42799
chr6	56333514	56533514	harbor2	chr6	56419825	56419942	LINE/L2	518	-	58	56419883	86369
chr6	7634787	7834787	harbor2	chr6	7673825	7674099	LINE/L2	796	-	137	7673962	39175
chr6	7628065	7828065	harbor2	chr6	7673825	7674099	LINE/L2	796	-	137	7673962	45897
chr6	149646190	149846190	harbor2	chr6	149688608	149688885	LINE/L2	460	-	138	149688746	42556
chr6	149646190	149846190	harbor2	chr6	149689180	149689308	LINE/L2	460	-	64	149689244	43054
chr6	158127245	158327245	harbor2	chr6	158157658	158157871	LINE/L2	474	-	106	158157764	30519
chr7	44442212	44642212	harbor2	chr7	44501873	44502184	LINE/L2	550	-	156	44502029	59817
chr7	149524712	149724712	harbor2	chr7	149536774	149537083	LINE/L2	479	-	154	149536928	12216
chr7	149524712	149724712	harbor2	chr7	149591558	149591727	LINE/L2	467	-	84	149591642	66930
chr7	149524712	149724712	harbor2	chr7	149615542	149615934	LINE/L2	527	-	196	149615738	91026
chr7	72825583	73025583	harbor2	chr7	72896794	72896938	LINE/L2	1008	-	72	72896866	71283
chr7	72825583	73025583	harbor2	chr7	72897171	72897738	LINE/L2	1843	-	284	72897455	71872
chr7	72825583	73025583	harbor2	chr7	72898036	72898278	LINE/L2	1843	-	121	72898157	72574
chr7	72825583	73025583	harbor2	chr7	72898393	72898515	LINE/L2	1843	-	61	72898454	72871
chr7	72825583	73025583	harbor2	chr7	72898818	72898881	LINE/L2	1843	-	32	72898850	73267
chr7	72825583	73025583	harbor2	chr7	72912224	72912494	LINE/L2	507	-	135	72912359	86776
chr7	72825583	73025583	harbor2	chr7	72912785	72912873	LINE/L2	507	-	44	72912829	87246
chr7	50204488	50404488	harbor2	chr7	50297052	50297563	LINE/L2	872	-	256	50297308	92820
chr7	1830988	2030988	harbor2	chr7	1915107	1915507	LINE/L2	471	-	200	1915307	84319
chr7	100516880	100716880	harbor2	chr7	100542834	100543027	LINE/L2	545	-	96	100542930	26050
chr7	28134889	28334889	harbor2	chr7	28158958	28159205	LINE/L2	520	-	124	28159082	24193
chr7	28134889	28334889	harbor2	chr7	28204374	28204460	LINE/L2	481	-	43	28204417	69528
chr7	152335429	152535429	harbor2	chr7	152355810	152356279	LINE/L2	1164	-	234	152356044	20615
chr7	152335429	152535429	harbor2	chr7	152361981	152362443	LINE/L2	778	-	231	152362212	26783
chr7	152335429	152535429	harbor2	chr7	152354383	152355627	LINE/L2	1337	-	622	152355005	19576
chr7	26995485	27195485	harbor2	chr7	27080774	27081089	LINE/L2	531	-	158	27080932	85447
chr7	25270423	25470423	harbor2	chr7	25320220	25320706	LINE/L2	1401	-	243	25320463	50040
chr7	25270423	25470423	harbor2	chr7	25347442	25347837	LINE/L2	597	-	198	25347640	77217
chr7	28080572	28280572	harbor2	chr7	28126221	28126632	LINE/L2	672	-	206	28126427	45855
chr7	28080572	28280572	harbor2	chr7	28158958	28159205	LINE/L2	520	-	124	28159082	78510
chr7	28080572	28280572	harbor2	chr7	28114640	28115002	LINE/L2	529	-	181	28114821	34249
chr7	148599806	148799806	harbor2	chr7	148662427	148662886	LINE/L2	741	-	230	148662657	62851
chr7	123649533	123849533	harbor2	chr7	123659606	123659828	LINE/L2	464	-	111	123659717	10184
chr7	123649533	123849533	harbor2	chr7	123667053	123667169	LINE/L2	491	-	58	123667111	17578
chr7	123649533	123849533	harbor2	chr7	123668970	123669599	LINE/L2	486	-	314	123669284	19751
chr7	123649533	123849533	harbor2	chr7	123704824	123705535	LINE/L2	1574	-	356	123705180	55647
chr7	28082123	28282123	harbor2	chr7	28126221	28126632	LINE/L2	672	-	206	28126427	44304
chr7	28082123	28282123	harbor2	chr7	28158958	28159205	LINE/L2	520	-	124	28159082	76959
chr7	28082123	28282123	harbor2	chr7	28114640	28115002	LINE/L2	529	-	181	28114821	32698
chr7	44507353	44707353	harbor2	chr7	44586826	44586920	LINE/L2	538	-	47	44586873	79520
chr7	44507353	44707353	harbor2	chr7	44587216	44587332	LINE/L2	538	-	58	44587274	79921
chr7	27005184	27205184	harbor2	chr7	27080774	27081089	LINE/L2	531	-	158	27080932	75748
chr7	50204289	50404289	harbor2	chr7	50297052	50297563	LINE/L2	872	-	256	50297308	93019
chr7	100028636	100228636	harbor2	chr7	100052459	100052772	LINE/L2	1193	-	156	100052615	23979
chr7	2609918	2809918	harbor2	chr7	2666615	2666885	LINE/L2	836	-	135	2666750	56832
chr7	2609918	2809918	harbor2	chr7	2667337	2667576	LINE/L2	2059	-	120	2667457	57539
chr7	2609918	2809918	harbor2	chr7	2667869	2668683	LINE/L2	2059	-	407	2668276	58358
chr7	2609918	2809918	harbor2	chr7	2668974	2669007	LINE/L2	2059	-	16	2668990	59072
chr7	2609918	2809918	harbor2	chr7	2669581	2669629	LINE/L2	2059	-	24	2669605	59687
chr7	2609918	2809918	harbor2	chr7	2669825	2670104	LINE/L2	2059	-	140	2669965	60047
chr7	50204573	50404573	harbor2	chr7	50297052	50297563	LINE/L2	872	-	256	50297308	92735
chr7	32328390	32528390	harbor2	chr7	32331516	32331789	LINE/L2	472	-	136	32331652	3262
chr7	32328390	32528390	harbor2	chr7	32385084	32385323	LINE/L2	633	-	120	32385204	56814
chr7	32328390	32528390	harbor2	chr7	32395125	32395535	LINE/L2	531	-	205	32395330	66940
chr7	123650448	123850448	harbor2	chr7	123659606	123659828	LINE/L2	464	-	111	123659717	9269
chr7	123650448	123850448	harbor2	chr7	123667053	123667169	LINE/L2	491	-	58	123667111	16663
chr7	123650448	123850448	harbor2	chr7	123668970	123669599	LINE/L2	486	-	314	123669284	18836
chr7	123650448	123850448	harbor2	chr7	123704824	123705535	LINE/L2	1574	-	356	123705180	54732
chr7	20777006	20977006	harbor2	chr7	20854968	20855158	LINE/L2	483	-	95	20855063	78057
chr7	20777006	20977006	harbor2	chr7	20858904	20859086	LINE/L2	544	-	91	20858995	81989
chr7	123649492	123849492	harbor2	chr7	123659606	123659828	LINE/L2	464	-	111	123659717	10225
chr7	123649492	123849492	harbor2	chr7	123667053	123667169	LINE/L2	491	-	58	123667111	17619
chr7	123649492	123849492	harbor2	chr7	123668970	123669599	LINE/L2	486	-	314	123669284	19792
chr7	123649492	123849492	harbor2	chr7	123704824	123705535	LINE/L2	1574	-	356	123705180	55688
chr7	44507472	44707472	harbor2	chr7	44586826	44586920	LINE/L2	538	-	47	44586873	79401
chr7	44507472	44707472	harbor2	chr7	44587216	44587332	LINE/L2	538	-	58	44587274	79802
chr7	123650423	123850423	harbor2	chr7	123659606	123659828	LINE/L2	464	-	111	123659717	9294
chr7	123650423	123850423	harbor2	chr7	123667053	123667169	LINE/L2	491	-	58	123667111	16688
chr7	123650423	123850423	harbor2	chr7	123668970	123669599	LINE/L2	486	-	314	123669284	18861
chr7	123650423	123850423	harbor2	chr7	123704824	123705535	LINE/L2	1574	-	356	123705180	54757
chr7	100329872	100529872	harbor2	chr7	100384782	100385047	LINE/L2	743	-	132	100384914	55042
chr7	44440642	44640642	harbor2	chr7	44501873	44502184	LINE/L2	550	-	156	44502029	61387
chr7	26112552	26312552	harbor2	chr7	26173738	26174113	LINE/L2	821	-	188	26173926	61374
chr7	26112552	26312552	harbor2	chr7	26174268	26174589	LINE/L2	712	-	160	26174428	61876
chr7	28725300	28925300	harbor2	chr7	28799969	28800478	LINE/L2	514	-	254	28800223	74923
chr7	128769421	128969421	harbor2	chr7	128796207	128796739	LINE/L2	2494	-	266	128796473	27052
chr7	128769421	128969421	harbor2	chr7	128797041	128797820	LINE/L2	2494	-	390	128797431	28010
chr7	128769421	128969421	harbor2	chr7	128867067	128867568	LINE/L2	587	-	250	128867317	97896
chr7	128769421	128969421	harbor2	chr7	128867861	128867952	LINE/L2	587	-	46	128867907	98486
chr7	28081559	28281559	harbor2	chr7	28126221	28126632	LINE/L2	672	-	206	28126427	44868
chr7	28081559	28281559	harbor2	chr7	28158958	28159205	LINE/L2	520	-	124	28159082	77523
chr7	28081559	28281559	harbor2	chr7	28114640	28115002	LINE/L2	529	-	181	28114821	33262
chr7	149153981	149353981	harbor2	chr7	149155587	149155707	LINE/L2	530	-	60	149155647	1666
chr7	149153981	149353981	harbor2	chr7	149156026	149156221	LINE/L2	530	-	98	149156124	2143
chr7	149153981	149353981	harbor2	chr7	149158112	149158458	LINE/L2	774	-	173	149158285	4304
chr7	149153981	149353981	harbor2	chr7	149218121	149218596	LINE/L2	670	-	238	149218359	64378
chr7	149153981	149353981	harbor2	chr7	149219393	149219564	LINE/L2	544	-	86	149219479	65498
chr7	149153981	149353981	harbor2	chr7	149219859	149220053	LINE/L2	544	-	97	149219956	65975
chr7	149153981	149353981	harbor2	chr7	149238409	149238630	LINE/L2	508	-	110	149238519	84538
chr7	27008623	27208623	harbor2	chr7	27080774	27081089	LINE/L2	531	-	158	27080932	72309
chr7	44696651	44896651	harbor2	chr7	44727387	44727684	LINE/L2	596	-	148	44727535	30884
chr7	100500037	100700037	harbor2	chr7	100542834	100543027	LINE/L2	545	-	96	100542930	42893
chr7	90497085	90697085	harbor2	chr7	90512151	90512592	LINE/L2	472	-	220	90512371	15286
chr7	90497085	90697085	harbor2	chr7	90574820	90575102	LINE/L2	738	-	141	90574961	77876
chr7	90497085	90697085	harbor2	chr7	90575680	90576202	LINE/L2	1296	-	261	90575941	78856
chr7	90497085	90697085	harbor2	chr7	90577624	90577911	LINE/L2	604	-	144	90577768	80683
chr7	73523245	73723245	harbor2	chr7	73568965	73569396	LINE/L2	790	-	216	73569181	45936
chr7	25269994	25469994	harbor2	chr7	25320220	25320706	LINE/L2	1401	-	243	25320463	50469
chr7	25269994	25469994	harbor2	chr7	25347442	25347837	LINE/L2	597	-	198	25347640	77646
chr7	150420511	150620511	harbor2	chr7	150453984	150454420	LINE/L2	712	-	218	150454202	33691
chr7	28089121	28289121	harbor2	chr7	28126221	28126632	LINE/L2	672	-	206	28126427	37306
chr7	28089121	28289121	harbor2	chr7	28158958	28159205	LINE/L2	520	-	124	28159082	69961
chr7	28089121	28289121	harbor2	chr7	28114640	28115002	LINE/L2	529	-	181	28114821	25700
chr7	155712041	155912041	harbor2	chr7	155712352	155714438	LINE/L2	2045	-	1043	155713395	1354
chr7	100501445	100701445	harbor2	chr7	100542834	100543027	LINE/L2	545	-	96	100542930	41485
chr7	44441524	44641524	harbor2	chr7	44501873	44502184	LINE/L2	550	-	156	44502029	60505
chr7	25270014	25470014	harbor2	chr7	25320220	25320706	LINE/L2	1401	-	243	25320463	50449
chr7	25270014	25470014	harbor2	chr7	25347442	25347837	LINE/L2	597	-	198	25347640	77626
chr7	50617957	50817957	harbor2	chr7	50647908	50648462	LINE/L2	656	-	277	50648185	30228
chr7	50617957	50817957	harbor2	chr7	50649119	50650841	LINE/L2	663	-	861	50649980	32023
chr7	28080611	28280611	harbor2	chr7	28126221	28126632	LINE/L2	672	-	206	28126427	45816
chr7	28080611	28280611	harbor2	chr7	28158958	28159205	LINE/L2	520	-	124	28159082	78471
chr7	28080611	28280611	harbor2	chr7	28114640	28115002	LINE/L2	529	-	181	28114821	34210
chr7	128756973	128956973	harbor2	chr7	128796207	128796739	LINE/L2	2494	-	266	128796473	39500
chr7	128756973	128956973	harbor2	chr7	128797041	128797820	LINE/L2	2494	-	390	128797431	40458
chr7	127993775	128193775	harbor2	chr7	128091001	128091228	LINE/L2	745	-	114	128091115	97340
chr7	127993775	128193775	harbor2	chr7	128091510	128091683	LINE/L2	745	-	86	128091596	97821
chr7	27027581	27227581	harbor2	chr7	27080774	27081089	LINE/L2	531	-	158	27080932	53351
chr7	104911716	105111716	harbor2	chr7	104914723	104914913	LINE/L2	958	-	95	104914818	3102
chr7	104911716	105111716	harbor2	chr7	104915206	104915549	LINE/L2	958	-	172	104915378	3662
chr7	104911716	105111716	harbor2	chr7	104915848	104916090	LINE/L2	958	-	121	104915969	4253
chr7	123649199	123849199	harbor2	chr7	123659606	123659828	LINE/L2	464	-	111	123659717	10518
chr7	123649199	123849199	harbor2	chr7	123667053	123667169	LINE/L2	491	-	58	123667111	17912
chr7	123649199	123849199	harbor2	chr7	123668970	123669599	LINE/L2	486	-	314	123669284	20085
chr7	123649199	123849199	harbor2	chr7	123704824	123705535	LINE/L2	1574	-	356	123705180	55981
chr7	50253328	50453328	harbor2	chr7	50297052	50297563	LINE/L2	872	-	256	50297308	43980
chr7	155288885	155488885	harbor2	chr7	155321460	155321539	LINE/L2	834	-	40	155321500	32615
chr7	155288885	155488885	harbor2	chr7	155321827	155322046	LINE/L2	834	-	110	155321937	33052
chr7	31973371	32173371	harbor2	chr7	32003737	32003983	LINE/L2	452	-	123	32003860	30489
chr7	31973371	32173371	harbor2	chr7	32019205	32020051	LINE/L2	933	-	423	32019628	46257
chr7	31973371	32173371	harbor2	chr7	32067253	32067459	LINE/L2	662	-	103	32067356	93985
chr7	44697576	44897576	harbor2	chr7	44727387	44727684	LINE/L2	596	-	148	44727535	29959
chr7	44441056	44641056	harbor2	chr7	44501873	44502184	LINE/L2	550	-	156	44502029	60973
chr7	90496247	90696247	harbor2	chr7	90512151	90512592	LINE/L2	472	-	220	90512371	16124
chr7	90496247	90696247	harbor2	chr7	90574820	90575102	LINE/L2	738	-	141	90574961	78714
chr7	90496247	90696247	harbor2	chr7	90575680	90576202	LINE/L2	1296	-	261	90575941	79694
chr7	90496247	90696247	harbor2	chr7	90577624	90577911	LINE/L2	604	-	144	90577768	81521
chr7	90145189	90345189	harbor2	chr7	90145767	90146100	LINE/L2	630	-	166	90145933	744
chr7	90145189	90345189	harbor2	chr7	90213922	90214387	LINE/L2	902	-	232	90214154	68965
chr7	90145189	90345189	harbor2	chr7	90214474	90215200	LINE/L2	863	-	363	90214837	69648
chr7	41382564	41582564	harbor2	chr7	41407172	41407557	LINE/L2	554	-	192	41407364	24800
chr7	41382564	41582564	harbor2	chr7	41422247	41422615	LINE/L2	899	-	184	41422431	39867
chr7	41382564	41582564	harbor2	chr7	41461662	41461997	LINE/L2	500	-	168	41461830	79266
chr7	37907099	38107099	harbor2	chr7	37960213	37961056	LINE/L2	874	-	422	37960635	53536
chr7	37907099	38107099	harbor2	chr7	37969320	37969757	LINE/L2	605	-	218	37969538	62439
chr7	37907099	38107099	harbor2	chr7	37982200	37982643	LINE/L2	2141	-	222	37982422	75323
chr7	37907099	38107099	harbor2	chr7	37982821	37983187	LINE/L2	2141	-	183	37983004	75905
chr7	37907099	38107099	harbor2	chr7	37983651	37983978	LINE/L2	2141	-	164	37983815	76716
chr7	28110460	28310460	harbor2	chr7	28126221	28126632	LINE/L2	672	-	206	28126427	15967
chr7	28110460	28310460	harbor2	chr7	28158958	28159205	LINE/L2	520	-	124	28159082	48622
chr7	28110460	28310460	harbor2	chr7	28204374	28204460	LINE/L2	481	-	43	28204417	93957
chr7	28110460	28310460	harbor2	chr7	28114640	28115002	LINE/L2	529	-	181	28114821	4361
chr7	129414069	129614069	harbor2	chr7	129416252	129416516	LINE/L2	1255	-	132	129416384	2315
chr7	129414069	129614069	harbor2	chr7	129416824	129416841	LINE/L2	1255	-	8	129416832	2763
chr7	129414069	129614069	harbor2	chr7	129417756	129418289	LINE/L2	973	-	266	129418022	3953
chr7	129414069	129614069	harbor2	chr7	129418599	129418626	LINE/L2	973	-	14	129418613	4544
chr7	129414069	129614069	harbor2	chr7	129418755	129418959	LINE/L2	973	-	102	129418857	4788
chr7	129414069	129614069	harbor2	chr7	129460491	129461182	LINE/L2	750	-	346	129460837	46768
chr7	129414069	129614069	harbor2	chr7	129461510	129462256	LINE/L2	1475	-	373	129461883	47814
chr7	129414069	129614069	harbor2	chr7	129417137	129417509	LINE/L2	1255	-	186	129417323	3254
chr7	157236951	157436951	harbor2	chr7	157238240	157239065	LINE/L2	1283	-	412	157238652	1701
chr7	157236951	157436951	harbor2	chr7	157240423	157241144	LINE/L2	1085	-	360	157240783	3832
chr7	123649212	123849212	harbor2	chr7	123659606	123659828	LINE/L2	464	-	111	123659717	10505
chr7	123649212	123849212	harbor2	chr7	123667053	123667169	LINE/L2	491	-	58	123667111	17899
chr7	123649212	123849212	harbor2	chr7	123668970	123669599	LINE/L2	486	-	314	123669284	20072
chr7	123649212	123849212	harbor2	chr7	123704824	123705535	LINE/L2	1574	-	356	123705180	55968
chr7	26995482	27195482	harbor2	chr7	27080774	27081089	LINE/L2	531	-	158	27080932	85450
chr7	147804168	148004168	harbor2	chr7	147811816	147812243	LINE/L2	752	-	214	147812030	7862
chr7	147804168	148004168	harbor2	chr7	147821352	147821894	LINE/L2	587	-	271	147821623	17455
chr7	147804168	148004168	harbor2	chr7	147821943	147822174	LINE/L2	499	-	116	147822059	17891
chr7	147804168	148004168	harbor2	chr7	147880288	147880848	LINE/L2	607	-	280	147880568	76400
chr7	147804168	148004168	harbor2	chr7	147883811	147884230	LINE/L2	915	-	210	147884021	79853
chr7	50204529	50404529	harbor2	chr7	50297052	50297563	LINE/L2	872	-	256	50297308	92779
chr7	28082522	28282522	harbor2	chr7	28126221	28126632	LINE/L2	672	-	206	28126427	43905
chr7	28082522	28282522	harbor2	chr7	28158958	28159205	LINE/L2	520	-	124	28159082	76560
chr7	28082522	28282522	harbor2	chr7	28114640	28115002	LINE/L2	529	-	181	28114821	32299
chr7	50208813	50408813	harbor2	chr7	50297052	50297563	LINE/L2	872	-	256	50297308	88495
chr7	44466421	44666421	harbor2	chr7	44501873	44502184	LINE/L2	550	-	156	44502029	35608
chr7	127292472	127492472	harbor2	chr7	127345159	127345848	LINE/L2	726	-	344	127345503	53031
chr7	127292472	127492472	harbor2	chr7	127345850	127346677	LINE/L2	1144	-	414	127346264	53792
chr7	127292472	127492472	harbor2	chr7	127347126	127347256	LINE/L2	1144	-	65	127347191	54719
chr7	128305619	128505619	harbor2	chr7	128309143	128309350	LINE/L2	704	-	104	128309247	3628
chr7	128305619	128505619	harbor2	chr7	128309659	128310009	LINE/L2	704	-	175	128309834	4215
chr7	128305619	128505619	harbor2	chr7	128344499	128344623	LINE/L2	478	-	62	128344561	38942
chr7	128305619	128505619	harbor2	chr7	128385378	128385965	LINE/L2	1683	-	294	128385672	80053
chr7	128305619	128505619	harbor2	chr7	128386266	128386396	LINE/L2	1683	-	65	128386331	80712
chr7	128305619	128505619	harbor2	chr7	128401504	128401806	LINE/L2	466	-	151	128401655	96036
chr7	50249530	50449530	harbor2	chr7	50297052	50297563	LINE/L2	872	-	256	50297308	47778
chr8	23428848	23628848	harbor2	chr8	23515922	23516027	LINE/L2	453	-	52	23515974	87126
chr8	38169595	38369595	harbor2	chr8	38248423	38248555	LINE/L2	421	-	66	38248489	78894
chr8	23429416	23629416	harbor2	chr8	23515922	23516027	LINE/L2	453	-	52	23515974	86558
chr8	23428811	23628811	harbor2	chr8	23515922	23516027	LINE/L2	453	-	52	23515974	87163
chr8	23439328	23639328	harbor2	chr8	23515922	23516027	LINE/L2	453	-	52	23515974	76646
chr8	23428778	23628778	harbor2	chr8	23515922	23516027	LINE/L2	453	-	52	23515974	87196
chr8	23428784	23628784	harbor2	chr8	23515922	23516027	LINE/L2	453	-	52	23515974	87190
chr8	23428892	23628892	harbor2	chr8	23515922	23516027	LINE/L2	453	-	52	23515974	87082
chr8	23429271	23629271	harbor2	chr8	23515922	23516027	LINE/L2	453	-	52	23515974	86703
chr8	23430686	23630686	harbor2	chr8	23515922	23516027	LINE/L2	453	-	52	23515974	85288
chr8	17985030	18185030	harbor2	chr8	18000063	18000635	LINE/L2	647	-	286	18000349	15319
chr8	17985030	18185030	harbor2	chr8	18000904	18001081	LINE/L2	647	-	88	18000992	15962
chr8	23429353	23629353	harbor2	chr8	23515922	23516027	LINE/L2	453	-	52	23515974	86621
chr8	23428870	23628870	harbor2	chr8	23515922	23516027	LINE/L2	453	-	52	23515974	87104
chr8	23429241	23629241	harbor2	chr8	23515922	23516027	LINE/L2	453	-	52	23515974	86733
chr8	10823758	11023758	harbor2	chr8	10833177	10833527	LINE/L2	702	-	175	10833352	9594
chr8	10823758	11023758	harbor2	chr8	10833772	10834422	LINE/L2	1339	-	325	10834097	10339
chr8	23428834	23628834	harbor2	chr8	23515922	23516027	LINE/L2	453	-	52	23515974	87140
chr8	29150120	29350120	harbor2	chr8	29206638	29206968	LINE/L2	843	-	165	29206803	56683
chr8	23428832	23628832	harbor2	chr8	23515922	23516027	LINE/L2	453	-	52	23515974	87142
chr8	23428810	23628810	harbor2	chr8	23515922	23516027	LINE/L2	453	-	52	23515974	87164
chr8	23432814	23632814	harbor2	chr8	23515922	23516027	LINE/L2	453	-	52	23515974	83160
chr8	23430803	23630803	harbor2	chr8	23515922	23516027	LINE/L2	453	-	52	23515974	85171
chr8	11492953	11692953	harbor2	chr8	11517002	11517412	LINE/L2	744	-	205	11517207	24254
chr8	11492953	11692953	harbor2	chr8	11539660	11539814	LINE/L2	415	-	77	11539737	46784
chr8	11492953	11692953	harbor2	chr8	11583929	11584361	LINE/L2	568	-	216	11584145	91192
chr8	38169968	38369968	harbor2	chr8	38248423	38248555	LINE/L2	421	-	66	38248489	78521
chr8	23428809	23628809	harbor2	chr8	23515922	23516027	LINE/L2	453	-	52	23515974	87165
chr8	23428725	23628725	harbor2	chr8	23515922	23516027	LINE/L2	453	-	52	23515974	87249
chr8	23429172	23629172	harbor2	chr8	23515922	23516027	LINE/L2	453	-	52	23515974	86802
chr8	23428835	23628835	harbor2	chr8	23515922	23516027	LINE/L2	453	-	52	23515974	87139
chr8	23429068	23629068	harbor2	chr8	23515922	23516027	LINE/L2	453	-	52	23515974	86906
chr8	38169167	38369167	harbor2	chr8	38248423	38248555	LINE/L2	421	-	66	38248489	79322
chr8	23428926	23628926	harbor2	chr8	23515922	23516027	LINE/L2	453	-	52	23515974	87048
chr8	23428913	23628913	harbor2	chr8	23515922	23516027	LINE/L2	453	-	52	23515974	87061
chr8	90979035	91179035	harbor2	chr8	91051499	91052126	LINE/L2	596	-	314	91051813	72778
chr8	90979035	91179035	harbor2	chr8	91064854	91065053	LINE/L2	489	-	100	91064954	85919
chr8	23429294	23629294	harbor2	chr8	23515922	23516027	LINE/L2	453	-	52	23515974	86680
chr8	25357718	25557718	harbor2	chr8	25385572	25386000	LINE/L2	718	-	214	25385786	28068
chr8	38169193	38369193	harbor2	chr8	38248423	38248555	LINE/L2	421	-	66	38248489	79296
chr8	30073247	30273247	harbor2	chr8	30084868	30085007	LINE/L2	590	-	70	30084938	11691
chr8	30073247	30273247	harbor2	chr8	30085368	30085649	LINE/L2	590	-	140	30085508	12261
chr8	30073247	30273247	harbor2	chr8	30123740	30124035	LINE/L2	454	-	148	30123888	50641
chr8	30073247	30273247	harbor2	chr8	30146730	30146853	LINE/L2	421	-	62	30146792	73545
chr8	30073247	30273247	harbor2	chr8	30164402	30164514	LINE/L2	445	-	56	30164458	91211
chr8	23429109	23629109	harbor2	chr8	23515922	23516027	LINE/L2	453	-	52	23515974	86865
chr8	102557354	102757354	harbor2	chr8	102646155	102646382	LINE/L2	602	-	114	102646269	88915
chr8	23428807	23628807	harbor2	chr8	23515922	23516027	LINE/L2	453	-	52	23515974	87167
chr8	23431300	23631300	harbor2	chr8	23515922	23516027	LINE/L2	453	-	52	23515974	84674
chr8	89802895	90002895	harbor2	chr8	89886305	89886640	LINE/L2	765	-	168	89886473	83578
chr8	89802895	90002895	harbor2	chr8	89889650	89889777	LINE/L2	443	-	64	89889714	86819
chr8	23428847	23628847	harbor2	chr8	23515922	23516027	LINE/L2	453	-	52	23515974	87127
chr8	23429149	23629149	harbor2	chr8	23515922	23516027	LINE/L2	453	-	52	23515974	86825
chr8	23430721	23630721	harbor2	chr8	23515922	23516027	LINE/L2	453	-	52	23515974	85253
chr8	27226138	27426138	harbor2	chr8	27297490	27298162	LINE/L2	653	-	336	27297826	71688
chr8	23428862	23628862	harbor2	chr8	23515922	23516027	LINE/L2	453	-	52	23515974	87112
chr8	23429308	23629308	harbor2	chr8	23515922	23516027	LINE/L2	453	-	52	23515974	86666
chr8	90973852	91173852	harbor2	chr8	91051499	91052126	LINE/L2	596	-	314	91051813	77961
chr8	90973852	91173852	harbor2	chr8	91064854	91065053	LINE/L2	489	-	100	91064954	91102
chr8	38172676	38372676	harbor2	chr8	38248423	38248555	LINE/L2	421	-	66	38248489	75813
chr8	23428822	23628822	harbor2	chr8	23515922	23516027	LINE/L2	453	-	52	23515974	87152
chr8	23432595	23632595	harbor2	chr8	23515922	23516027	LINE/L2	453	-	52	23515974	83379
chr8	2870768	3070768	harbor2	chr8	2890641	2891223	LINE/L2	804	-	291	2890932	20164
chr8	23428886	23628886	harbor2	chr8	23515922	23516027	LINE/L2	453	-	52	23515974	87088
chr8	23428849	23628849	harbor2	chr8	23515922	23516027	LINE/L2	453	-	52	23515974	87125
chr8	23428839	23628839	harbor2	chr8	23515922	23516027	LINE/L2	453	-	52	23515974	87135
chr8	23447867	23647867	harbor2	chr8	23515922	23516027	LINE/L2	453	-	52	23515974	68107
chr8	42040647	42240647	harbor2	chr8	42132385	42132496	LINE/L2	460	-	56	42132441	91794
chr8	12337432	12537432	harbor2	chr8	12399031	12399268	LINE/L2	602	-	118	12399149	61717
chr8	30013870	30213870	harbor2	chr8	30050218	30050483	LINE/L2	687	-	132	30050350	36480
chr8	30013870	30213870	harbor2	chr8	30084868	30085007	LINE/L2	590	-	70	30084938	71068
chr8	30013870	30213870	harbor2	chr8	30085368	30085649	LINE/L2	590	-	140	30085508	71638
chr8	141311590	141511590	harbor2	chr8	141405790	141406132	LINE/L2	747	-	171	141405961	94371
chr8	23428736	23628736	harbor2	chr8	23515922	23516027	LINE/L2	453	-	52	23515974	87238
chr8	23429123	23629123	harbor2	chr8	23515922	23516027	LINE/L2	453	-	52	23515974	86851
chr8	9052098	9252098	harbor2	chr8	9057547	9058294	LINE/L2	685	-	374	9057921	5823
chr8	96040962	96240962	harbor2	chr8	96047629	96048397	LINE/L2	1403	-	384	96048013	7051
chr8	96040962	96240962	harbor2	chr8	96086272	96086727	LINE/L2	748	-	228	96086500	45538
chr8	96040962	96240962	harbor2	chr8	96107288	96107713	LINE/L2	511	-	212	96107500	66538
chr8	96040962	96240962	harbor2	chr8	96140369	96140477	LINE/L2	443	-	54	96140423	99461
chr8	141003841	141203841	harbor2	chr8	141031777	141032401	LINE/L2	724	-	312	141032089	28248
chr8	38169170	38369170	harbor2	chr8	38248423	38248555	LINE/L2	421	-	66	38248489	79319
chr8	42742785	42942785	harbor2	chr8	42759983	42760174	LINE/L2	499	-	96	42760079	17294
chr8	23428733	23628733	harbor2	chr8	23515922	23516027	LINE/L2	453	-	52	23515974	87241
chr8	23429202	23629202	harbor2	chr8	23515922	23516027	LINE/L2	453	-	52	23515974	86772
chr8	125678475	125878475	harbor2	chr8	125707989	125708385	LINE/L2	446	-	198	125708187	29712
chr8	125678475	125878475	harbor2	chr8	125724441	125724631	LINE/L2	959	-	95	125724536	46061
chr8	125678475	125878475	harbor2	chr8	125724929	125725144	LINE/L2	959	-	108	125725037	46562
chr8	125678475	125878475	harbor2	chr8	125746688	125746901	LINE/L2	533	-	106	125746794	68319
chr8	125678475	125878475	harbor2	chr8	125753241	125753641	LINE/L2	1318	-	200	125753441	74966
chr8	23430734	23630734	harbor2	chr8	23515922	23516027	LINE/L2	453	-	52	23515974	85240
chr8	38169192	38369192	harbor2	chr8	38248423	38248555	LINE/L2	421	-	66	38248489	79297
chr8	23428636	23628636	harbor2	chr8	23515922	23516027	LINE/L2	453	-	52	23515974	87338
chr8	23428840	23628840	harbor2	chr8	23515922	23516027	LINE/L2	453	-	52	23515974	87134
chr8	27543509	27743509	harbor2	chr8	27561110	27561501	LINE/L2	426	-	196	27561306	17797
chr8	27543509	27743509	harbor2	chr8	27639686	27639886	LINE/L2	436	-	100	27639786	96277
chr8	25085369	25285369	harbor2	chr8	25134213	25134832	LINE/L2	578	-	310	25134523	49154
chr8	23428828	23628828	harbor2	chr8	23515922	23516027	LINE/L2	453	-	52	23515974	87146
chr8	23428920	23628920	harbor2	chr8	23515922	23516027	LINE/L2	453	-	52	23515974	87054
chr8	141309378	141509378	harbor2	chr8	141405790	141406132	LINE/L2	747	-	171	141405961	96583
chr8	29983300	30183300	harbor2	chr8	30050218	30050483	LINE/L2	687	-	132	30050350	67050
chr8	23428899	23628899	harbor2	chr8	23515922	23516027	LINE/L2	453	-	52	23515974	87075
chr8	23651754	23851754	harbor2	chr8	23718322	23719416	LINE/L2	2571	-	547	23718869	67115
chr8	23651754	23851754	harbor2	chr8	23719879	23719997	LINE/L2	599	-	59	23719938	68184
chr8	23651754	23851754	harbor2	chr8	23720293	23720382	LINE/L2	599	-	44	23720337	68583
chr8	41429283	41629283	harbor2	chr8	41500056	41500593	LINE/L2	589	-	268	41500324	71041
chr8	41429283	41629283	harbor2	chr8	41500729	41500900	LINE/L2	589	-	86	41500815	71532
chr8	143960530	144160530	harbor2	chr8	144011999	144012361	LINE/L2	517	-	181	144012180	51650
chr8	143960530	144160530	harbor2	chr8	144017836	144018579	LINE/L2	795	-	372	144018208	57678
chr8	48821299	49021299	harbor2	chr8	48824794	48825013	LINE/L2	432	-	110	48824904	3605
chr8	48821299	49021299	harbor2	chr8	48905350	48905708	LINE/L2	697	-	179	48905529	84230
chr8	38169185	38369185	harbor2	chr8	38248423	38248555	LINE/L2	421	-	66	38248489	79304
chr8	141314854	141514854	harbor2	chr8	141405790	141406132	LINE/L2	747	-	171	141405961	91107
chr8	102203037	102403037	harbor2	chr8	102217573	102218363	LINE/L2	613	-	395	102217968	14931
chr8	38172009	38372009	harbor2	chr8	38248423	38248555	LINE/L2	421	-	66	38248489	76480
chr8	23456020	23656020	harbor2	chr8	23515922	23516027	LINE/L2	453	-	52	23515974	59954
chr8	38175043	38375043	harbor2	chr8	38248423	38248555	LINE/L2	421	-	66	38248489	73446
chr8	23428854	23628854	harbor2	chr8	23515922	23516027	LINE/L2	453	-	52	23515974	87120
chr8	23428795	23628795	harbor2	chr8	23515922	23516027	LINE/L2	453	-	52	23515974	87179
chr8	143982665	144182665	harbor2	chr8	144011999	144012361	LINE/L2	517	-	181	144012180	29515
chr8	143982665	144182665	harbor2	chr8	144017836	144018579	LINE/L2	795	-	372	144018208	35543
chr8	42040637	42240637	harbor2	chr8	42132385	42132496	LINE/L2	460	-	56	42132441	91804
chr8	10960481	11160481	harbor2	chr8	11011477	11011801	LINE/L2	894	-	162	11011639	51158
chr8	38169198	38369198	harbor2	chr8	38248423	38248555	LINE/L2	421	-	66	38248489	79291
chr8	22818594	23018594	harbor2	chr8	22818180	22819222	LINE/L2	1683	-	521	22818701	107
chr8	22818594	23018594	harbor2	chr8	22819490	22819594	LINE/L2	953	-	52	22819542	948
chr8	22818594	23018594	harbor2	chr8	22819906	22820421	LINE/L2	953	-	258	22820164	1570
chr8	22818594	23018594	harbor2	chr8	22831480	22831921	LINE/L2	453	-	220	22831700	13106
chr8	22818594	23018594	harbor2	chr8	22906726	22907176	LINE/L2	1250	-	225	22906951	88357
chr8	22818594	23018594	harbor2	chr8	22907531	22907944	LINE/L2	1250	-	206	22907737	89143
chr8	22818594	23018594	harbor2	chr8	22908030	22908365	LINE/L2	1250	-	168	22908198	89604
chr8	22818594	23018594	harbor2	chr8	22908397	22908487	LINE/L2	1250	-	45	22908442	89848
chr8	41849522	42049522	harbor2	chr8	41877488	41877976	LINE/L2	742	-	244	41877732	28210
chr8	138813637	139013637	harbor2	chr8	138841189	138841638	LINE/L2	563	-	224	138841413	27776
chr8	138813637	139013637	harbor2	chr8	138852227	138852412	LINE/L2	420	-	92	138852319	38682
chr8	138813637	139013637	harbor2	chr8	138852557	138852866	LINE/L2	850	-	154	138852711	39074
chr8	138813637	139013637	harbor2	chr8	138853184	138853314	LINE/L2	850	-	65	138853249	39612
chr8	138813637	139013637	harbor2	chr8	138873445	138873596	LINE/L2	450	-	76	138873521	59884
chr8	138813637	139013637	harbor2	chr8	138888110	138888483	LINE/L2	511	-	186	138888296	74659
chr8	138813637	139013637	harbor2	chr8	138893792	138893987	LINE/L2	704	-	98	138893890	80253
chr8	138813637	139013637	harbor2	chr8	138900726	138900947	LINE/L2	565	-	110	138900836	87199
chr8	102598762	102798762	harbor2	chr8	102646155	102646382	LINE/L2	602	-	114	102646269	47507
chr8	102598762	102798762	harbor2	chr8	102658408	102658525	LINE/L2	426	-	58	102658466	59704
chr8	102598762	102798762	harbor2	chr8	102658557	102658890	LINE/L2	426	-	166	102658723	59961
chr8	102598762	102798762	harbor2	chr8	102661533	102662033	LINE/L2	433	-	250	102661783	63021
chr8	102598762	102798762	harbor2	chr8	102662349	102662465	LINE/L2	433	-	58	102662407	63645
chr8	102598762	102798762	harbor2	chr8	102693858	102694003	LINE/L2	463	-	72	102693930	95168
chr8	23429259	23629259	harbor2	chr8	23515922	23516027	LINE/L2	453	-	52	23515974	86715
chr8	30059382	30259382	harbor2	chr8	30084868	30085007	LINE/L2	590	-	70	30084938	25556
chr8	30059382	30259382	harbor2	chr8	30085368	30085649	LINE/L2	590	-	140	30085508	26126
chr8	30059382	30259382	harbor2	chr8	30123740	30124035	LINE/L2	454	-	148	30123888	64506
chr8	30059382	30259382	harbor2	chr8	30146730	30146853	LINE/L2	421	-	62	30146792	87410
chr8	30068591	30268591	harbor2	chr8	30084868	30085007	LINE/L2	590	-	70	30084938	16347
chr8	30068591	30268591	harbor2	chr8	30085368	30085649	LINE/L2	590	-	140	30085508	16917
chr8	30068591	30268591	harbor2	chr8	30123740	30124035	LINE/L2	454	-	148	30123888	55297
chr8	30068591	30268591	harbor2	chr8	30146730	30146853	LINE/L2	421	-	62	30146792	78201
chr8	30068591	30268591	harbor2	chr8	30164402	30164514	LINE/L2	445	-	56	30164458	95867
chr8	89884671	90084671	harbor2	chr8	89886305	89886640	LINE/L2	765	-	168	89886473	1802
chr8	89884671	90084671	harbor2	chr8	89889650	89889777	LINE/L2	443	-	64	89889714	5043
chr8	104533858	104733858	harbor2	chr8	104581549	104581787	LINE/L2	439	-	119	104581668	47810
chr8	104533858	104733858	harbor2	chr8	104597336	104597713	LINE/L2	452	-	188	104597524	63666
chr8	104533858	104733858	harbor2	chr8	104618422	104619341	LINE/L2	921	-	460	104618882	85024
chr8	104533858	104733858	harbor2	chr8	104620196	104621385	LINE/L2	1867	-	594	104620790	86932
chr8	23428874	23628874	harbor2	chr8	23515922	23516027	LINE/L2	453	-	52	23515974	87100
chr8	38169188	38369188	harbor2	chr8	38248423	38248555	LINE/L2	421	-	66	38248489	79301
chr8	73779046	73979046	harbor2	chr8	73870708	73871384	LINE/L2	884	-	338	73871046	92000
chr8	23744917	23944917	harbor2	chr8	23762461	23762739	LINE/L2	422	-	139	23762600	17683
chr8	23744917	23944917	harbor2	chr8	23792970	23793172	LINE/L2	624	-	101	23793071	48154
chr8	23744917	23944917	harbor2	chr8	23835732	23835901	LINE/L2	519	-	84	23835816	90899
chr8	23744917	23944917	harbor2	chr8	23836291	23836475	LINE/L2	519	-	92	23836383	91466
chr8	23744917	23944917	harbor2	chr8	23836646	23838472	LINE/L2	1468	-	913	23837559	92642
chr8	23744917	23944917	harbor2	chr8	23838561	23839242	LINE/L2	1468	-	340	23838901	93984
chr9	134333456	134533456	harbor2	chr9	134374894	134375272	LINE/L2	531	-	189	134375083	41627
chr9	21909388	22109388	harbor2	chr9	21910170	21910646	LINE/L2	703	-	238	21910408	1020
chr9	21909388	22109388	harbor2	chr9	21916910	21917496	LINE/L2	2079	-	293	21917203	7815
chr9	21909388	22109388	harbor2	chr9	21919020	21919192	LINE/L2	529	-	86	21919106	9718
chr9	21909388	22109388	harbor2	chr9	21919496	21919836	LINE/L2	768	-	170	21919666	10278
chr9	21909388	22109388	harbor2	chr9	21943034	21943423	LINE/L2	499	-	194	21943228	33840
chr9	4966574	5166574	harbor2	chr9	5008371	5008637	LINE/L2	818	-	133	5008504	41930
chr9	4966574	5166574	harbor2	chr9	5012862	5013099	LINE/L2	632	-	118	5012980	46406
chr9	4692826	4892826	harbor2	chr9	4745747	4745925	LINE/L2	470	-	89	4745836	53010
chr9	4692826	4892826	harbor2	chr9	4748998	4749561	LINE/L2	1588	-	282	4749280	56454
chr9	4692782	4892782	harbor2	chr9	4745747	4745925	LINE/L2	470	-	89	4745836	53054
chr9	4692782	4892782	harbor2	chr9	4748998	4749561	LINE/L2	1588	-	282	4749280	56498
chr9	4692810	4892810	harbor2	chr9	4745747	4745925	LINE/L2	470	-	89	4745836	53026
chr9	4692810	4892810	harbor2	chr9	4748998	4749561	LINE/L2	1588	-	282	4749280	56470
chr9	112389442	112589442	harbor2	chr9	112429529	112429809	LINE/L2	896	-	140	112429669	40227
chr9	112389442	112589442	harbor2	chr9	112430106	112430122	LINE/L2	2683	-	8	112430114	40672
chr9	112389442	112589442	harbor2	chr9	112430160	112430770	LINE/L2	2683	-	305	112430465	41023
chr9	112389442	112589442	harbor2	chr9	112431084	112431490	LINE/L2	2683	-	203	112431287	41845
chr9	112389442	112589442	harbor2	chr9	112432222	112432275	LINE/L2	2683	-	26	112432248	42806
chr9	4694791	4894791	harbor2	chr9	4745747	4745925	LINE/L2	470	-	89	4745836	51045
chr9	4694791	4894791	harbor2	chr9	4748998	4749561	LINE/L2	1588	-	282	4749280	54489
chr9	79476304	79676304	harbor2	chr9	79523333	79523560	LINE/L2	568	-	114	79523447	47143
chr9	112387666	112587666	harbor2	chr9	112429529	112429809	LINE/L2	896	-	140	112429669	42003
chr9	112387666	112587666	harbor2	chr9	112430106	112430122	LINE/L2	2683	-	8	112430114	42448
chr9	112387666	112587666	harbor2	chr9	112430160	112430770	LINE/L2	2683	-	305	112430465	42799
chr9	112387666	112587666	harbor2	chr9	112431084	112431490	LINE/L2	2683	-	203	112431287	43621
chr9	112387666	112587666	harbor2	chr9	112432222	112432275	LINE/L2	2683	-	26	112432248	44582
chr9	4909381	5109381	harbor2	chr9	5008371	5008637	LINE/L2	818	-	133	5008504	99123
chr9	4692766	4892766	harbor2	chr9	4745747	4745925	LINE/L2	470	-	89	4745836	53070
chr9	4692766	4892766	harbor2	chr9	4748998	4749561	LINE/L2	1588	-	282	4749280	56514
chr9	4692809	4892809	harbor2	chr9	4745747	4745925	LINE/L2	470	-	89	4745836	53027
chr9	4692809	4892809	harbor2	chr9	4748998	4749561	LINE/L2	1588	-	282	4749280	56471
chr9	4730682	4930682	harbor2	chr9	4745747	4745925	LINE/L2	470	-	89	4745836	15154
chr9	4730682	4930682	harbor2	chr9	4748998	4749561	LINE/L2	1588	-	282	4749280	18598
chr9	4692868	4892868	harbor2	chr9	4745747	4745925	LINE/L2	470	-	89	4745836	52968
chr9	4692868	4892868	harbor2	chr9	4748998	4749561	LINE/L2	1588	-	282	4749280	56412
chr9	111797010	111997010	harbor2	chr9	111849957	111850468	LINE/L2	645	-	256	111850213	53203
chr9	4693721	4893721	harbor2	chr9	4745747	4745925	LINE/L2	470	-	89	4745836	52115
chr9	4693721	4893721	harbor2	chr9	4748998	4749561	LINE/L2	1588	-	282	4749280	55559
chr9	22103804	22303804	harbor2	chr9	22116300	22116840	LINE/L2	715	-	270	22116570	12766
chr9	22103804	22303804	harbor2	chr9	22137874	22138333	LINE/L2	537	-	230	22138104	34300
chr9	4974186	5174186	harbor2	chr9	5008371	5008637	LINE/L2	818	-	133	5008504	34318
chr9	4974186	5174186	harbor2	chr9	5012862	5013099	LINE/L2	632	-	118	5012980	38794
chr9	4974186	5174186	harbor2	chr9	5068307	5068768	LINE/L2	476	-	230	5068537	94351
chr9	4729013	4929013	harbor2	chr9	4745747	4745925	LINE/L2	470	-	89	4745836	16823
chr9	4729013	4929013	harbor2	chr9	4748998	4749561	LINE/L2	1588	-	282	4749280	20267
chr9	112387642	112587642	harbor2	chr9	112429529	112429809	LINE/L2	896	-	140	112429669	42027
chr9	112387642	112587642	harbor2	chr9	112430106	112430122	LINE/L2	2683	-	8	112430114	42472
chr9	112387642	112587642	harbor2	chr9	112430160	112430770	LINE/L2	2683	-	305	112430465	42823
chr9	112387642	112587642	harbor2	chr9	112431084	112431490	LINE/L2	2683	-	203	112431287	43645
chr9	112387642	112587642	harbor2	chr9	112432222	112432275	LINE/L2	2683	-	26	112432248	44606
chr9	4692828	4892828	harbor2	chr9	4745747	4745925	LINE/L2	470	-	89	4745836	53008
chr9	4692828	4892828	harbor2	chr9	4748998	4749561	LINE/L2	1588	-	282	4749280	56452
chr9	134036094	134236094	harbor2	chr9	134073635	134073786	LINE/L2	504	-	76	134073711	37617
chr9	5596372	5796372	harbor2	chr9	5694920	5695247	LINE/L2	717	-	164	5695084	98712
chr9	35657125	35857125	harbor2	chr9	35666972	35666991	LINE/L2	858	-	10	35666982	9857
chr9	35657125	35857125	harbor2	chr9	35667326	35667788	LINE/L2	779	-	231	35667557	10432
chr9	35657125	35857125	harbor2	chr9	35668154	35668704	LINE/L2	1026	-	275	35668429	11304
chr9	35657125	35857125	harbor2	chr9	35700844	35701303	LINE/L2	822	-	230	35701074	43949
chr9	35657125	35857125	harbor2	chr9	35701571	35702008	LINE/L2	822	-	218	35701789	44664
chr9	4692895	4892895	harbor2	chr9	4745747	4745925	LINE/L2	470	-	89	4745836	52941
chr9	4692895	4892895	harbor2	chr9	4748998	4749561	LINE/L2	1588	-	282	4749280	56385
chr9	69292250	69492250	harbor2	chr9	69317515	69317852	LINE/L2	693	-	168	69317683	25433
chr9	69292250	69492250	harbor2	chr9	69378786	69379037	LINE/L2	505	-	126	69378912	86662
chr9	4693416	4893416	harbor2	chr9	4745747	4745925	LINE/L2	470	-	89	4745836	52420
chr9	4693416	4893416	harbor2	chr9	4748998	4749561	LINE/L2	1588	-	282	4749280	55864
chr9	4693543	4893543	harbor2	chr9	4745747	4745925	LINE/L2	470	-	89	4745836	52293
chr9	4693543	4893543	harbor2	chr9	4748998	4749561	LINE/L2	1588	-	282	4749280	55737
chr9	4969354	5169354	harbor2	chr9	5008371	5008637	LINE/L2	818	-	133	5008504	39150
chr9	4969354	5169354	harbor2	chr9	5012862	5013099	LINE/L2	632	-	118	5012980	43626
chr9	4969354	5169354	harbor2	chr9	5068307	5068768	LINE/L2	476	-	230	5068537	99183
chr9	5062622	5262622	harbor2	chr9	5068307	5068768	LINE/L2	476	-	230	5068537	5915
chr9	112387652	112587652	harbor2	chr9	112429529	112429809	LINE/L2	896	-	140	112429669	42017
chr9	112387652	112587652	harbor2	chr9	112430106	112430122	LINE/L2	2683	-	8	112430114	42462
chr9	112387652	112587652	harbor2	chr9	112430160	112430770	LINE/L2	2683	-	305	112430465	42813
chr9	112387652	112587652	harbor2	chr9	112431084	112431490	LINE/L2	2683	-	203	112431287	43635
chr9	112387652	112587652	harbor2	chr9	112432222	112432275	LINE/L2	2683	-	26	112432248	44596
chr9	134036118	134236118	harbor2	chr9	134073635	134073786	LINE/L2	504	-	76	134073711	37593
chr9	4694621	4894621	harbor2	chr9	4745747	4745925	LINE/L2	470	-	89	4745836	51215
chr9	4694621	4894621	harbor2	chr9	4748998	4749561	LINE/L2	1588	-	282	4749280	54659
chr9	4692744	4892744	harbor2	chr9	4745747	4745925	LINE/L2	470	-	89	4745836	53092
chr9	4692744	4892744	harbor2	chr9	4748998	4749561	LINE/L2	1588	-	282	4749280	56536
chr9	4693371	4893371	harbor2	chr9	4745747	4745925	LINE/L2	470	-	89	4745836	52465
chr9	4693371	4893371	harbor2	chr9	4748998	4749561	LINE/L2	1588	-	282	4749280	55909
chr9	4693463	4893463	harbor2	chr9	4745747	4745925	LINE/L2	470	-	89	4745836	52373
chr9	4693463	4893463	harbor2	chr9	4748998	4749561	LINE/L2	1588	-	282	4749280	55817
chr9	4728727	4928727	harbor2	chr9	4745747	4745925	LINE/L2	470	-	89	4745836	17109
chr9	4728727	4928727	harbor2	chr9	4748998	4749561	LINE/L2	1588	-	282	4749280	20553
chr9	112647605	112847605	harbor2	chr9	112652968	112653339	LINE/L2	529	-	186	112653154	5549
chr9	112647605	112847605	harbor2	chr9	112677666	112678008	LINE/L2	801	-	171	112677837	30232
chr9	112647605	112847605	harbor2	chr9	112691126	112691727	LINE/L2	545	-	300	112691426	43821
chr9	112647605	112847605	harbor2	chr9	112692036	112692285	LINE/L2	545	-	124	112692160	44555
chr9	35657155	35857155	harbor2	chr9	35666972	35666991	LINE/L2	858	-	10	35666982	9827
chr9	35657155	35857155	harbor2	chr9	35667326	35667788	LINE/L2	779	-	231	35667557	10402
chr9	35657155	35857155	harbor2	chr9	35668154	35668704	LINE/L2	1026	-	275	35668429	11274
chr9	35657155	35857155	harbor2	chr9	35700844	35701303	LINE/L2	822	-	230	35701074	43919
chr9	35657155	35857155	harbor2	chr9	35701571	35702008	LINE/L2	822	-	218	35701789	44634
chr9	4692900	4892900	harbor2	chr9	4745747	4745925	LINE/L2	470	-	89	4745836	52936
chr9	4692900	4892900	harbor2	chr9	4748998	4749561	LINE/L2	1588	-	282	4749280	56380
chr9	112422739	112622739	harbor2	chr9	112429529	112429809	LINE/L2	896	-	140	112429669	6930
chr9	112422739	112622739	harbor2	chr9	112430106	112430122	LINE/L2	2683	-	8	112430114	7375
chr9	112422739	112622739	harbor2	chr9	112430160	112430770	LINE/L2	2683	-	305	112430465	7726
chr9	112422739	112622739	harbor2	chr9	112431084	112431490	LINE/L2	2683	-	203	112431287	8548
chr9	112422739	112622739	harbor2	chr9	112432222	112432275	LINE/L2	2683	-	26	112432248	9509
chr9	112422739	112622739	harbor2	chr9	112502965	112503371	LINE/L2	1309	-	203	112503168	80429
chr9	112422739	112622739	harbor2	chr9	112503637	112503742	LINE/L2	1309	-	52	112503689	80950
chr9	112422739	112622739	harbor2	chr9	112510683	112511182	LINE/L2	827	-	250	112510933	88194
chr9	79473605	79673605	harbor2	chr9	79523333	79523560	LINE/L2	568	-	114	79523447	49842
chr9	4692825	4892825	harbor2	chr9	4745747	4745925	LINE/L2	470	-	89	4745836	53011
chr9	4692825	4892825	harbor2	chr9	4748998	4749561	LINE/L2	1588	-	282	4749280	56455
chr9	4692909	4892909	harbor2	chr9	4745747	4745925	LINE/L2	470	-	89	4745836	52927
chr9	4692909	4892909	harbor2	chr9	4748998	4749561	LINE/L2	1588	-	282	4749280	56371
chr9	4693624	4893624	harbor2	chr9	4745747	4745925	LINE/L2	470	-	89	4745836	52212
chr9	4693624	4893624	harbor2	chr9	4748998	4749561	LINE/L2	1588	-	282	4749280	55656
chr9	4692802	4892802	harbor2	chr9	4745747	4745925	LINE/L2	470	-	89	4745836	53034
chr9	4692802	4892802	harbor2	chr9	4748998	4749561	LINE/L2	1588	-	282	4749280	56478
chr9	112387662	112587662	harbor2	chr9	112429529	112429809	LINE/L2	896	-	140	112429669	42007
chr9	112387662	112587662	harbor2	chr9	112430106	112430122	LINE/L2	2683	-	8	112430114	42452
chr9	112387662	112587662	harbor2	chr9	112430160	112430770	LINE/L2	2683	-	305	112430465	42803
chr9	112387662	112587662	harbor2	chr9	112431084	112431490	LINE/L2	2683	-	203	112431287	43625
chr9	112387662	112587662	harbor2	chr9	112432222	112432275	LINE/L2	2683	-	26	112432248	44586
chr9	4693135	4893135	harbor2	chr9	4745747	4745925	LINE/L2	470	-	89	4745836	52701
chr9	4693135	4893135	harbor2	chr9	4748998	4749561	LINE/L2	1588	-	282	4749280	56145
chr9	4692731	4892731	harbor2	chr9	4745747	4745925	LINE/L2	470	-	89	4745836	53105
chr9	4692731	4892731	harbor2	chr9	4748998	4749561	LINE/L2	1588	-	282	4749280	56549
chr9	109158501	109358501	harbor2	chr9	109214512	109215015	LINE/L2	483	-	252	109214764	56263
chr9	109158501	109358501	harbor2	chr9	109238494	109239580	LINE/L2	569	-	543	109239037	80536
chr9	4734149	4934149	harbor2	chr9	4745747	4745925	LINE/L2	470	-	89	4745836	11687
chr9	4734149	4934149	harbor2	chr9	4748998	4749561	LINE/L2	1588	-	282	4749280	15131
chr9	4693367	4893367	harbor2	chr9	4745747	4745925	LINE/L2	470	-	89	4745836	52469
chr9	4693367	4893367	harbor2	chr9	4748998	4749561	LINE/L2	1588	-	282	4749280	55913
chr9	97416346	97616346	harbor2	chr9	97416808	97417534	LINE/L2	1279	-	363	97417171	825
chr9	97416346	97616346	harbor2	chr9	97445300	97445732	LINE/L2	1028	-	216	97445516	29170
chr9	97416346	97616346	harbor2	chr9	97467702	97468405	LINE/L2	1620	-	352	97468054	51708
chr9	20286384	20486384	harbor2	chr9	20311620	20312720	LINE/L2	1335	-	550	20312170	25786
chr9	20286384	20486384	harbor2	chr9	20339499	20339641	LINE/L2	533	-	71	20339570	53186
chr9	122142319	122342319	harbor2	chr9	122144526	122144938	LINE/L2	610	-	206	122144732	2413
chr9	122142319	122342319	harbor2	chr9	122174896	122175304	LINE/L2	680	-	204	122175100	32781
chr9	122142319	122342319	harbor2	chr9	122194254	122194560	LINE/L2	752	-	153	122194407	52088
chr9	122142319	122342319	harbor2	chr9	122233987	122234277	LINE/L2	631	-	145	122234132	91813
chr9	122142319	122342319	harbor2	chr9	122238207	122238991	LINE/L2	1431	-	392	122238599	96280
chr9	4694263	4894263	harbor2	chr9	4745747	4745925	LINE/L2	470	-	89	4745836	51573
chr9	4694263	4894263	harbor2	chr9	4748998	4749561	LINE/L2	1588	-	282	4749280	55017
chr9	4692878	4892878	harbor2	chr9	4745747	4745925	LINE/L2	470	-	89	4745836	52958
chr9	4692878	4892878	harbor2	chr9	4748998	4749561	LINE/L2	1588	-	282	4749280	56402
chr9	131637199	131837199	harbor2	chr9	131718160	131718759	LINE/L2	773	-	300	131718460	81261
chr9	134036111	134236111	harbor2	chr9	134073635	134073786	LINE/L2	504	-	76	134073711	37600
chr9	5394375	5594375	harbor2	chr9	5468850	5469048	LINE/L2	510	-	99	5468949	74574
chr9	5394375	5594375	harbor2	chr9	5486824	5487347	LINE/L2	675	-	262	5487086	92711
chr9	99191390	99391390	harbor2	chr9	99225124	99225527	LINE/L2	767	-	202	99225326	33936
chr9	67768338	67968338	harbor2	chr9	67784126	67784567	LINE/L2	688	-	220	67784346	16008
chr9	67768338	67968338	harbor2	chr9	67854937	67855456	LINE/L2	1031	-	260	67855197	86859
chr9	130839891	131039891	harbor2	chr9	130862191	130862550	LINE/L2	658	-	180	130862371	22480
chr9	19342296	19542296	harbor2	chr9	19425443	19425703	LINE/L2	538	-	130	19425573	83277
chr9	4692808	4892808	harbor2	chr9	4745747	4745925	LINE/L2	470	-	89	4745836	53028
chr9	4692808	4892808	harbor2	chr9	4748998	4749561	LINE/L2	1588	-	282	4749280	56472
chr9	4692907	4892907	harbor2	chr9	4745747	4745925	LINE/L2	470	-	89	4745836	52929
chr9	4692907	4892907	harbor2	chr9	4748998	4749561	LINE/L2	1588	-	282	4749280	56373
chr9	4694161	4894161	harbor2	chr9	4745747	4745925	LINE/L2	470	-	89	4745836	51675
chr9	4694161	4894161	harbor2	chr9	4748998	4749561	LINE/L2	1588	-	282	4749280	55119
chr9	68607235	68807235	harbor2	chr9	68623434	68623986	LINE/L2	1091	-	276	68623710	16475
chr9	68607235	68807235	harbor2	chr9	68684251	68684667	LINE/L2	755	-	208	68684459	77224
chr9	108349469	108549469	harbor2	chr9	108442776	108443163	LINE/L2	613	-	194	108442970	93501
chr9	134036117	134236117	harbor2	chr9	134073635	134073786	LINE/L2	504	-	76	134073711	37594
chr9	4693547	4893547	harbor2	chr9	4745747	4745925	LINE/L2	470	-	89	4745836	52289
chr9	4693547	4893547	harbor2	chr9	4748998	4749561	LINE/L2	1588	-	282	4749280	55733
chr9	4692770	4892770	harbor2	chr9	4745747	4745925	LINE/L2	470	-	89	4745836	53066
chr9	4692770	4892770	harbor2	chr9	4748998	4749561	LINE/L2	1588	-	282	4749280	56510
chr9	97885753	98085753	harbor2	chr9	97940960	97941732	LINE/L2	1211	-	386	97941346	55593
chr9	4692800	4892800	harbor2	chr9	4745747	4745925	LINE/L2	470	-	89	4745836	53036
chr9	4692800	4892800	harbor2	chr9	4748998	4749561	LINE/L2	1588	-	282	4749280	56480
chr9	68619252	68819252	harbor2	chr9	68623434	68623986	LINE/L2	1091	-	276	68623710	4458
chr9	68619252	68819252	harbor2	chr9	68684251	68684667	LINE/L2	755	-	208	68684459	65207
chr9	85705754	85905754	harbor2	chr9	85709496	85709830	LINE/L2	479	-	167	85709663	3909
chr9	85705754	85905754	harbor2	chr9	85715773	85715907	LINE/L2	476	-	67	85715840	10086
chr9	85705754	85905754	harbor2	chr9	85795892	85796146	LINE/L2	664	-	127	85796019	90265
chr9	130120234	130320234	harbor2	chr9	130186132	130186378	LINE/L2	490	-	123	130186255	66021
chr9	130120234	130320234	harbor2	chr9	130204910	130205307	LINE/L2	545	-	198	130205108	84874
chr9	4692867	4892867	harbor2	chr9	4745747	4745925	LINE/L2	470	-	89	4745836	52969
chr9	4692867	4892867	harbor2	chr9	4748998	4749561	LINE/L2	1588	-	282	4749280	56413
chr9	112726256	112926256	harbor2	chr9	112755033	112755595	LINE/L2	716	-	281	112755314	29058
chr9	27249897	27449897	harbor2	chr9	27259958	27261000	LINE/L2	580	-	521	27260479	10582
chr9	27249897	27449897	harbor2	chr9	27314698	27315119	LINE/L2	1346	-	210	27314908	65011
chr9	35657152	35857152	harbor2	chr9	35666972	35666991	LINE/L2	858	-	10	35666982	9830
chr9	35657152	35857152	harbor2	chr9	35667326	35667788	LINE/L2	779	-	231	35667557	10405
chr9	35657152	35857152	harbor2	chr9	35668154	35668704	LINE/L2	1026	-	275	35668429	11277
chr9	35657152	35857152	harbor2	chr9	35700844	35701303	LINE/L2	822	-	230	35701074	43922
chr9	35657152	35857152	harbor2	chr9	35701571	35702008	LINE/L2	822	-	218	35701789	44637
chr9	4692804	4892804	harbor2	chr9	4745747	4745925	LINE/L2	470	-	89	4745836	53032
chr9	4692804	4892804	harbor2	chr9	4748998	4749561	LINE/L2	1588	-	282	4749280	56476
chr9	4734367	4934367	harbor2	chr9	4745747	4745925	LINE/L2	470	-	89	4745836	11469
chr9	4734367	4934367	harbor2	chr9	4748998	4749561	LINE/L2	1588	-	282	4749280	14913
chr9	128981398	129181398	harbor2	chr9	128996907	128997411	LINE/L2	740	-	252	128997159	15761
chr9	5027062	5227062	harbor2	chr9	5068307	5068768	LINE/L2	476	-	230	5068537	41475
chr9	4692864	4892864	harbor2	chr9	4745747	4745925	LINE/L2	470	-	89	4745836	52972
chr9	4692864	4892864	harbor2	chr9	4748998	4749561	LINE/L2	1588	-	282	4749280	56416
chr9	112749826	112949826	harbor2	chr9	112755033	112755595	LINE/L2	716	-	281	112755314	5488
chr9	112749826	112949826	harbor2	chr9	112843353	112843626	LINE/L2	1698	-	136	112843489	93663
chr9	112749826	112949826	harbor2	chr9	112843876	112844648	LINE/L2	1698	-	386	112844262	94436
chr9	4692777	4892777	harbor2	chr9	4745747	4745925	LINE/L2	470	-	89	4745836	53059
chr9	4692777	4892777	harbor2	chr9	4748998	4749561	LINE/L2	1588	-	282	4749280	56503
chr9	4743685	4943685	harbor2	chr9	4745747	4745925	LINE/L2	470	-	89	4745836	2151
chr9	4743685	4943685	harbor2	chr9	4748998	4749561	LINE/L2	1588	-	282	4749280	5595
chr9	35629934	35829934	harbor2	chr9	35666972	35666991	LINE/L2	858	-	10	35666982	37048
chr9	35629934	35829934	harbor2	chr9	35667326	35667788	LINE/L2	779	-	231	35667557	37623
chr9	35629934	35829934	harbor2	chr9	35668154	35668704	LINE/L2	1026	-	275	35668429	38495
chr9	35629934	35829934	harbor2	chr9	35700844	35701303	LINE/L2	822	-	230	35701074	71140
chr9	35629934	35829934	harbor2	chr9	35701571	35702008	LINE/L2	822	-	218	35701789	71855
chr9	38155453	38355453	harbor2	chr9	38213660	38213814	LINE/L2	470	-	77	38213737	58284
chr9	4725632	4925632	harbor2	chr9	4745747	4745925	LINE/L2	470	-	89	4745836	20204
chr9	4725632	4925632	harbor2	chr9	4748998	4749561	LINE/L2	1588	-	282	4749280	23648
chr9	4693424	4893424	harbor2	chr9	4745747	4745925	LINE/L2	470	-	89	4745836	52412
chr9	4693424	4893424	harbor2	chr9	4748998	4749561	LINE/L2	1588	-	282	4749280	55856
chr9	136986144	137186144	harbor2	chr9	136990384	136990533	LINE/L2	553	-	74	136990458	4314
chr9	123915711	124115711	harbor2	chr9	123951103	123951490	LINE/L2	738	-	194	123951297	35586
chr9	123915711	124115711	harbor2	chr9	123971419	123971833	LINE/L2	706	-	207	123971626	55915
chr9	6727745	6927745	harbor2	chr9	6794120	6794243	LINE/L2	488	-	62	6794182	66437
chr9	4694515	4894515	harbor2	chr9	4745747	4745925	LINE/L2	470	-	89	4745836	51321
chr9	4694515	4894515	harbor2	chr9	4748998	4749561	LINE/L2	1588	-	282	4749280	54765
chr9	114075574	114275574	harbor2	chr9	114075546	114076529	LINE/L2	889	-	492	114076038	464
chr9	114075574	114275574	harbor2	chr9	114101712	114102196	LINE/L2	1523	-	242	114101954	26380
chr9	114075574	114275574	harbor2	chr9	114102502	114102552	LINE/L2	527	-	25	114102527	26953
chr9	114075574	114275574	harbor2	chr9	114160492	114160556	LINE/L2	472	-	32	114160524	84950
chr9	114075574	114275574	harbor2	chr9	114160691	114160922	LINE/L2	472	-	116	114160807	85233
chr9	36902991	37102991	harbor2	chr9	36989830	36990153	LINE/L2	581	-	162	36989992	87001
chr9	4693490	4893490	harbor2	chr9	4745747	4745925	LINE/L2	470	-	89	4745836	52346
chr9	4693490	4893490	harbor2	chr9	4748998	4749561	LINE/L2	1588	-	282	4749280	55790
chr9	4692797	4892797	harbor2	chr9	4745747	4745925	LINE/L2	470	-	89	4745836	53039
chr9	4692797	4892797	harbor2	chr9	4748998	4749561	LINE/L2	1588	-	282	4749280	56483
chr9	134036096	134236096	harbor2	chr9	134073635	134073786	LINE/L2	504	-	76	134073711	37615
chr9	4641242	4841242	harbor2	chr9	4675599	4676069	LINE/L2	832	-	235	4675834	34592
chr9	4641242	4841242	harbor2	chr9	4677301	4677910	LINE/L2	1205	-	304	4677605	36363
chr9	126299693	126499693	harbor2	chr9	126311916	126312417	LINE/L2	577	-	250	126312166	12473
chr9	126299693	126499693	harbor2	chr9	126314789	126315097	LINE/L2	1123	-	154	126314943	15250
chr9	126299693	126499693	harbor2	chr9	126344141	126344308	LINE/L2	527	-	84	126344225	44532
chr9	126299693	126499693	harbor2	chr9	126392498	126392912	LINE/L2	475	-	207	126392705	93012
chr9	133248112	133448112	harbor2	chr9	133339706	133339984	LINE/L2	570	-	139	133339845	91733
chr9	111563686	111763686	harbor2	chr9	111566673	111566890	LINE/L2	666	-	108	111566781	3095
chr9	111563686	111763686	harbor2	chr9	111567500	111567793	LINE/L2	571	-	146	111567646	3960
chr9	111563686	111763686	harbor2	chr9	111568840	111569495	LINE/L2	2640	-	328	111569168	5482
chr9	111563686	111763686	harbor2	chr9	111569761	111570075	LINE/L2	2640	-	157	111569918	6232
chr9	4692893	4892893	harbor2	chr9	4745747	4745925	LINE/L2	470	-	89	4745836	52943
chr9	4692893	4892893	harbor2	chr9	4748998	4749561	LINE/L2	1588	-	282	4749280	56387
chr9	4694556	4894556	harbor2	chr9	4745747	4745925	LINE/L2	470	-	89	4745836	51280
chr9	4694556	4894556	harbor2	chr9	4748998	4749561	LINE/L2	1588	-	282	4749280	54724
chr9	134333445	134533445	harbor2	chr9	134374894	134375272	LINE/L2	531	-	189	134375083	41638
chr9	4692786	4892786	harbor2	chr9	4745747	4745925	LINE/L2	470	-	89	4745836	53050
chr9	4692786	4892786	harbor2	chr9	4748998	4749561	LINE/L2	1588	-	282	4749280	56494
chr9	134036081	134236081	harbor2	chr9	134073635	134073786	LINE/L2	504	-	76	134073711	37630
chr9	108356062	108556062	harbor2	chr9	108442776	108443163	LINE/L2	613	-	194	108442970	86908
chr9	99259961	99459961	harbor2	chr9	99303571	99303932	LINE/L2	507	-	180	99303751	43790
chr10	48742186	48942186	harbor2	chr10	48794395	48795444	LINE/L2	1312	-	524	48794919	52733
chr10	48742186	48942186	harbor2	chr10	48835066	48835489	LINE/L2	852	-	212	48835278	93092
chr10	103893614	104093614	harbor2	chr10	103896173	103896430	LINE/L2	539	-	128	103896301	2687
chr10	122407392	122607392	harbor2	chr10	122438285	122438693	LINE/L2	3080	-	204	122438489	31097
chr10	122407392	122607392	harbor2	chr10	122437209	122437976	LINE/L2	3080	-	384	122437593	30201
chr10	75729207	75929207	harbor2	chr10	75753184	75753988	LINE/L2	713	-	402	75753586	24379
chr10	75729207	75929207	harbor2	chr10	75809282	75809361	LINE/L2	662	-	40	75809322	80115
chr10	75729207	75929207	harbor2	chr10	75809663	75809837	LINE/L2	662	-	87	75809750	80543
chr10	75729207	75929207	harbor2	chr10	75810020	75810528	LINE/L2	662	-	254	75810274	81067
chr10	103552962	103752962	harbor2	chr10	103562022	103562104	LINE/L2	581	-	41	103562063	9101
chr10	103552962	103752962	harbor2	chr10	103562411	103562473	LINE/L2	581	-	31	103562442	9480
chr10	103552962	103752962	harbor2	chr10	103562666	103562918	LINE/L2	581	-	126	103562792	9830
chr10	103552962	103752962	harbor2	chr10	103609562	103609682	LINE/L2	476	-	60	103609622	56660
chr10	14779254	14979254	harbor2	chr10	14799774	14800522	LINE/L2	1286	-	374	14800148	20894
chr10	14779254	14979254	harbor2	chr10	14831934	14832839	LINE/L2	1894	-	452	14832386	53132
chr10	14779254	14979254	harbor2	chr10	14833159	14833192	LINE/L2	2090	-	16	14833175	53921
chr10	14779254	14979254	harbor2	chr10	14833603	14833934	LINE/L2	951	-	166	14833769	54515
chr10	14779254	14979254	harbor2	chr10	14876840	14877141	LINE/L2	670	-	150	14876990	97736
chr10	14779254	14979254	harbor2	chr10	14860251	14861251	LINE/L2	1163	-	500	14860751	81497
chr10	97778537	97978537	harbor2	chr10	97802376	97802526	LINE/L2	516	-	75	97802451	23914
chr10	97778537	97978537	harbor2	chr10	97831787	97832207	LINE/L2	692	-	210	97831997	53460
chr10	97778537	97978537	harbor2	chr10	97836983	97837427	LINE/L2	577	-	222	97837205	58668
chr10	97778537	97978537	harbor2	chr10	97838607	97838796	LINE/L2	538	-	94	97838701	60164
chr10	14778679	14978679	harbor2	chr10	14799774	14800522	LINE/L2	1286	-	374	14800148	21469
chr10	14778679	14978679	harbor2	chr10	14831934	14832839	LINE/L2	1894	-	452	14832386	53707
chr10	14778679	14978679	harbor2	chr10	14833159	14833192	LINE/L2	2090	-	16	14833175	54496
chr10	14778679	14978679	harbor2	chr10	14833603	14833934	LINE/L2	951	-	166	14833769	55090
chr10	14778679	14978679	harbor2	chr10	14876840	14877141	LINE/L2	670	-	150	14876990	98311
chr10	14778679	14978679	harbor2	chr10	14860251	14861251	LINE/L2	1163	-	500	14860751	82072
chr10	103296527	103496527	harbor2	chr10	103373731	103374006	LINE/L2	502	-	138	103373869	77342
chr10	97398820	97598820	harbor2	chr10	97412809	97413206	LINE/L2	533	-	198	97413007	14187
chr10	22337523	22537523	harbor2	chr10	22353622	22354250	LINE/L2	483	-	314	22353936	16413
chr10	22337523	22537523	harbor2	chr10	22410213	22410692	LINE/L2	636	-	240	22410453	72930
chr10	14778676	14978676	harbor2	chr10	14799774	14800522	LINE/L2	1286	-	374	14800148	21472
chr10	14778676	14978676	harbor2	chr10	14831934	14832839	LINE/L2	1894	-	452	14832386	53710
chr10	14778676	14978676	harbor2	chr10	14833159	14833192	LINE/L2	2090	-	16	14833175	54499
chr10	14778676	14978676	harbor2	chr10	14833603	14833934	LINE/L2	951	-	166	14833769	55093
chr10	14778676	14978676	harbor2	chr10	14876840	14877141	LINE/L2	670	-	150	14876990	98314
chr10	14778676	14978676	harbor2	chr10	14860251	14861251	LINE/L2	1163	-	500	14860751	82075
chr10	97673442	97873442	harbor2	chr10	97738046	97738223	LINE/L2	527	-	88	97738134	64692
chr10	97673442	97873442	harbor2	chr10	97744436	97744670	LINE/L2	491	-	117	97744553	71111
chr10	97678598	97878598	harbor2	chr10	97738046	97738223	LINE/L2	527	-	88	97738134	59536
chr10	97678598	97878598	harbor2	chr10	97744436	97744670	LINE/L2	491	-	117	97744553	65955
chr10	122404740	122604740	harbor2	chr10	122438285	122438693	LINE/L2	3080	-	204	122438489	33749
chr10	122404740	122604740	harbor2	chr10	122437209	122437976	LINE/L2	3080	-	384	122437593	32853
chr10	97678599	97878599	harbor2	chr10	97738046	97738223	LINE/L2	527	-	88	97738134	59535
chr10	97678599	97878599	harbor2	chr10	97744436	97744670	LINE/L2	491	-	117	97744553	65954
chr10	23340660	23540660	harbor2	chr10	23367792	23368001	LINE/L2	471	-	104	23367896	27236
chr10	122405982	122605982	harbor2	chr10	122438285	122438693	LINE/L2	3080	-	204	122438489	32507
chr10	122405982	122605982	harbor2	chr10	122437209	122437976	LINE/L2	3080	-	384	122437593	31611
chr10	130648896	130848896	harbor2	chr10	130680011	130680658	LINE/L2	653	-	324	130680335	31439
chr10	130648896	130848896	harbor2	chr10	130735151	130736126	LINE/L2	1928	-	488	130735639	86743
chr10	130648896	130848896	harbor2	chr10	130739059	130740222	LINE/L2	683	-	582	130739641	90745
chr10	97398798	97598798	harbor2	chr10	97412809	97413206	LINE/L2	533	-	198	97413007	14209
chr10	75111508	75311508	harbor2	chr10	75154358	75154888	LINE/L2	1716	-	265	75154623	43115
chr10	75111508	75311508	harbor2	chr10	75155188	75155406	LINE/L2	1716	-	109	75155297	43789
chr10	75111508	75311508	harbor2	chr10	75157289	75157877	LINE/L2	1333	-	294	75157583	46075
chr10	75111508	75311508	harbor2	chr10	75158181	75158219	LINE/L2	1333	-	19	75158200	46692
chr10	75111508	75311508	harbor2	chr10	75185720	75185849	LINE/L2	537	-	64	75185784	74276
chr10	75111508	75311508	harbor2	chr10	75186688	75186939	LINE/L2	557	-	126	75186814	75306
chr10	75111508	75311508	harbor2	chr10	75187239	75187373	LINE/L2	557	-	67	75187306	75798
chr10	72361013	72561013	harbor2	chr10	72393143	72393628	LINE/L2	643	-	242	72393385	32372
chr10	102013280	102213280	harbor2	chr10	102045209	102045590	LINE/L2	781	-	190	102045399	32119
chr10	14778686	14978686	harbor2	chr10	14799774	14800522	LINE/L2	1286	-	374	14800148	21462
chr10	14778686	14978686	harbor2	chr10	14831934	14832839	LINE/L2	1894	-	452	14832386	53700
chr10	14778686	14978686	harbor2	chr10	14833159	14833192	LINE/L2	2090	-	16	14833175	54489
chr10	14778686	14978686	harbor2	chr10	14833603	14833934	LINE/L2	951	-	166	14833769	55083
chr10	14778686	14978686	harbor2	chr10	14876840	14877141	LINE/L2	670	-	150	14876990	98304
chr10	14778686	14978686	harbor2	chr10	14860251	14861251	LINE/L2	1163	-	500	14860751	82065
chr10	22337530	22537530	harbor2	chr10	22353622	22354250	LINE/L2	483	-	314	22353936	16406
chr10	22337530	22537530	harbor2	chr10	22410213	22410692	LINE/L2	636	-	240	22410453	72923
chr10	122908712	123108712	harbor2	chr10	122939127	122939344	LINE/L2	499	-	108	122939235	30523
chr10	122908712	123108712	harbor2	chr10	122946579	122947166	LINE/L2	591	-	294	122946873	38161
chr10	122908712	123108712	harbor2	chr10	122987137	122987538	LINE/L2	861	-	200	122987337	78625
chr10	100679685	100879685	harbor2	chr10	100697473	100698053	LINE/L2	648	-	290	100697763	18078
chr10	97398789	97598789	harbor2	chr10	97412809	97413206	LINE/L2	533	-	198	97413007	14218
chr10	23210069	23410069	harbor2	chr10	23278452	23278789	LINE/L2	491	-	168	23278620	68551
chr10	75120756	75320756	harbor2	chr10	75154358	75154888	LINE/L2	1716	-	265	75154623	33867
chr10	75120756	75320756	harbor2	chr10	75155188	75155406	LINE/L2	1716	-	109	75155297	34541
chr10	75120756	75320756	harbor2	chr10	75157289	75157877	LINE/L2	1333	-	294	75157583	36827
chr10	75120756	75320756	harbor2	chr10	75158181	75158219	LINE/L2	1333	-	19	75158200	37444
chr10	75120756	75320756	harbor2	chr10	75185720	75185849	LINE/L2	537	-	64	75185784	65028
chr10	75120756	75320756	harbor2	chr10	75186688	75186939	LINE/L2	557	-	126	75186814	66058
chr10	75120756	75320756	harbor2	chr10	75187239	75187373	LINE/L2	557	-	67	75187306	66550
chr10	43151417	43351417	harbor2	chr10	43163245	43163506	LINE/L2	538	-	130	43163375	11958
chr10	43151417	43351417	harbor2	chr10	43174055	43174186	LINE/L2	665	-	66	43174121	22704
chr10	43151417	43351417	harbor2	chr10	43248759	43249181	LINE/L2	608	-	211	43248970	97553
chr10	97398825	97598825	harbor2	chr10	97412809	97413206	LINE/L2	533	-	198	97413007	14182
chr10	100908386	101108386	harbor2	chr10	100932594	100932692	LINE/L2	656	-	49	100932643	24257
chr10	100908386	101108386	harbor2	chr10	100932722	100932891	LINE/L2	656	-	84	100932806	24420
chr10	100908386	101108386	harbor2	chr10	100945699	100946015	LINE/L2	854	-	158	100945857	37471
chr10	100908386	101108386	harbor2	chr10	100982281	100982510	LINE/L2	690	-	114	100982395	74009
chr10	100908386	101108386	harbor2	chr10	100982815	100983143	LINE/L2	690	-	164	100982979	74593
chr10	100908386	101108386	harbor2	chr10	100993676	100994070	LINE/L2	854	-	197	100993873	85487
chr10	14854787	15054787	harbor2	chr10	14876840	14877141	LINE/L2	670	-	150	14876990	22203
chr10	14854787	15054787	harbor2	chr10	14886657	14886936	LINE/L2	513	-	140	14886797	32010
chr10	14854787	15054787	harbor2	chr10	14887634	14888205	LINE/L2	497	-	286	14887920	33133
chr10	14854787	15054787	harbor2	chr10	14860251	14861251	LINE/L2	1163	-	500	14860751	5964
chr10	43005484	43205484	harbor2	chr10	43102739	43103465	LINE/L2	505	-	363	43103102	97618
chr10	114721684	114921684	harbor2	chr10	114770218	114770342	LINE/L2	545	-	62	114770280	48596
chr10	114721684	114921684	harbor2	chr10	114782415	114782999	LINE/L2	890	-	292	114782707	61023
chr10	114721684	114921684	harbor2	chr10	114783299	114783561	LINE/L2	890	-	131	114783430	61746
chr10	73817058	74017058	harbor2	chr10	73864035	73864062	LINE/L2	1065	-	14	73864049	46991
chr10	73817058	74017058	harbor2	chr10	73864311	73864626	LINE/L2	1065	-	158	73864469	47411
chr10	100897092	101097092	harbor2	chr10	100932594	100932692	LINE/L2	656	-	49	100932643	35551
chr10	100897092	101097092	harbor2	chr10	100932722	100932891	LINE/L2	656	-	84	100932806	35714
chr10	100897092	101097092	harbor2	chr10	100945699	100946015	LINE/L2	854	-	158	100945857	48765
chr10	100897092	101097092	harbor2	chr10	100982281	100982510	LINE/L2	690	-	114	100982395	85303
chr10	100897092	101097092	harbor2	chr10	100982815	100983143	LINE/L2	690	-	164	100982979	85887
chr10	100897092	101097092	harbor2	chr10	100993676	100994070	LINE/L2	854	-	197	100993873	96781
chr10	97402257	97602257	harbor2	chr10	97412809	97413206	LINE/L2	533	-	198	97413007	10750
chr10	69630792	69830792	harbor2	chr10	69724106	69724434	LINE/L2	631	-	164	69724270	93478
chr10	14908036	15108036	harbor2	chr10	14956683	14956776	LINE/L2	486	-	46	14956729	48693
chr10	14908036	15108036	harbor2	chr10	14957459	14957631	LINE/L2	777	-	86	14957545	49509
chr10	14908036	15108036	harbor2	chr10	14957946	14958304	LINE/L2	777	-	179	14958125	50089
chr10	14782782	14982782	harbor2	chr10	14799774	14800522	LINE/L2	1286	-	374	14800148	17366
chr10	14782782	14982782	harbor2	chr10	14831934	14832839	LINE/L2	1894	-	452	14832386	49604
chr10	14782782	14982782	harbor2	chr10	14833159	14833192	LINE/L2	2090	-	16	14833175	50393
chr10	14782782	14982782	harbor2	chr10	14833603	14833934	LINE/L2	951	-	166	14833769	50987
chr10	14782782	14982782	harbor2	chr10	14876840	14877141	LINE/L2	670	-	150	14876990	94208
chr10	14782782	14982782	harbor2	chr10	14860251	14861251	LINE/L2	1163	-	500	14860751	77969
chr10	46182801	46382801	harbor2	chr10	46255473	46255648	LINE/L2	519	-	88	46255561	72760
chr10	71364878	71564878	harbor2	chr10	71455500	71455696	LINE/L2	793	-	98	71455598	90720
chr10	68161589	68361589	harbor2	chr10	68186658	68186967	LINE/L2	487	-	154	68186812	25223
chr10	68161589	68361589	harbor2	chr10	68187518	68188099	LINE/L2	879	-	290	68187808	26219
chr10	68161589	68361589	harbor2	chr10	68188410	68188421	LINE/L2	879	-	6	68188416	26827
chr10	100085958	100285958	harbor2	chr10	100128230	100128457	LINE/L2	499	-	114	100128344	42386
chr10	100085958	100285958	harbor2	chr10	100128756	100129099	LINE/L2	499	-	172	100128928	42970
chr10	100085958	100285958	harbor2	chr10	100170484	100170832	LINE/L2	632	-	174	100170658	84700
chr10	131033279	131233279	harbor2	chr10	131123189	131123654	LINE/L2	466	-	232	131123421	90142
chr10	13710585	13910585	harbor2	chr10	13720463	13720781	LINE/L2	622	-	159	13720622	10037
chr10	97399300	97599300	harbor2	chr10	97412809	97413206	LINE/L2	533	-	198	97413007	13707
chr10	48300059	48500059	harbor2	chr10	48317862	48318032	LINE/L2	505	-	85	48317947	17888
chr10	48300059	48500059	harbor2	chr10	48318855	48319078	LINE/L2	479	-	112	48318967	18908
chr10	48300059	48500059	harbor2	chr10	48341568	48342115	LINE/L2	796	-	274	48341842	41783
chr10	48300059	48500059	harbor2	chr10	48342405	48343077	LINE/L2	762	-	336	48342741	42682
chr10	48300059	48500059	harbor2	chr10	48343541	48343607	LINE/L2	762	-	33	48343574	43515
chr10	48300059	48500059	harbor2	chr10	48369134	48370022	LINE/L2	1154	-	444	48369578	69519
chr10	48300059	48500059	harbor2	chr10	48389652	48389905	LINE/L2	582	-	126	48389778	89719
chr10	97398808	97598808	harbor2	chr10	97412809	97413206	LINE/L2	533	-	198	97413007	14199
chr10	48455826	48655826	harbor2	chr10	48502752	48502942	LINE/L2	504	-	95	48502847	47021
chr10	10822731	11022731	harbor2	chr10	10835848	10836523	LINE/L2	888	-	338	10836186	13455
chr10	75111469	75311469	harbor2	chr10	75154358	75154888	LINE/L2	1716	-	265	75154623	43154
chr10	75111469	75311469	harbor2	chr10	75155188	75155406	LINE/L2	1716	-	109	75155297	43828
chr10	75111469	75311469	harbor2	chr10	75157289	75157877	LINE/L2	1333	-	294	75157583	46114
chr10	75111469	75311469	harbor2	chr10	75158181	75158219	LINE/L2	1333	-	19	75158200	46731
chr10	75111469	75311469	harbor2	chr10	75185720	75185849	LINE/L2	537	-	64	75185784	74315
chr10	75111469	75311469	harbor2	chr10	75186688	75186939	LINE/L2	557	-	126	75186814	75345
chr10	75111469	75311469	harbor2	chr10	75187239	75187373	LINE/L2	557	-	67	75187306	75837
chr10	89151733	89351733	harbor2	chr10	89155820	89157079	LINE/L2	3042	-	630	89156450	4717
chr10	89151733	89351733	harbor2	chr10	89230159	89230284	LINE/L2	472	-	62	89230221	78488
chr10	47354780	47554780	harbor2	chr10	47364271	47364523	LINE/L2	713	-	126	47364397	9617
chr10	47354780	47554780	harbor2	chr10	47365495	47365773	LINE/L2	576	-	139	47365634	10854
chr10	22337540	22537540	harbor2	chr10	22353622	22354250	LINE/L2	483	-	314	22353936	16396
chr10	22337540	22537540	harbor2	chr10	22410213	22410692	LINE/L2	636	-	240	22410453	72913
chr10	14778685	14978685	harbor2	chr10	14799774	14800522	LINE/L2	1286	-	374	14800148	21463
chr10	14778685	14978685	harbor2	chr10	14831934	14832839	LINE/L2	1894	-	452	14832386	53701
chr10	14778685	14978685	harbor2	chr10	14833159	14833192	LINE/L2	2090	-	16	14833175	54490
chr10	14778685	14978685	harbor2	chr10	14833603	14833934	LINE/L2	951	-	166	14833769	55084
chr10	14778685	14978685	harbor2	chr10	14876840	14877141	LINE/L2	670	-	150	14876990	98305
chr10	14778685	14978685	harbor2	chr10	14860251	14861251	LINE/L2	1163	-	500	14860751	82066
chr10	31829542	32029542	harbor2	chr10	31837859	31838388	LINE/L2	799	-	264	31838123	8581
chr10	14778673	14978673	harbor2	chr10	14799774	14800522	LINE/L2	1286	-	374	14800148	21475
chr10	14778673	14978673	harbor2	chr10	14831934	14832839	LINE/L2	1894	-	452	14832386	53713
chr10	14778673	14978673	harbor2	chr10	14833159	14833192	LINE/L2	2090	-	16	14833175	54502
chr10	14778673	14978673	harbor2	chr10	14833603	14833934	LINE/L2	951	-	166	14833769	55096
chr10	14778673	14978673	harbor2	chr10	14876840	14877141	LINE/L2	670	-	150	14876990	98317
chr10	14778673	14978673	harbor2	chr10	14860251	14861251	LINE/L2	1163	-	500	14860751	82078
chr10	72255024	72455024	harbor2	chr10	72318266	72318604	LINE/L2	512	-	169	72318435	63411
chr10	100907566	101107566	harbor2	chr10	100932594	100932692	LINE/L2	656	-	49	100932643	25077
chr10	100907566	101107566	harbor2	chr10	100932722	100932891	LINE/L2	656	-	84	100932806	25240
chr10	100907566	101107566	harbor2	chr10	100945699	100946015	LINE/L2	854	-	158	100945857	38291
chr10	100907566	101107566	harbor2	chr10	100982281	100982510	LINE/L2	690	-	114	100982395	74829
chr10	100907566	101107566	harbor2	chr10	100982815	100983143	LINE/L2	690	-	164	100982979	75413
chr10	100907566	101107566	harbor2	chr10	100993676	100994070	LINE/L2	854	-	197	100993873	86307
chr10	97402365	97602365	harbor2	chr10	97412809	97413206	LINE/L2	533	-	198	97413007	10642
chr10	14778687	14978687	harbor2	chr10	14799774	14800522	LINE/L2	1286	-	374	14800148	21461
chr10	14778687	14978687	harbor2	chr10	14831934	14832839	LINE/L2	1894	-	452	14832386	53699
chr10	14778687	14978687	harbor2	chr10	14833159	14833192	LINE/L2	2090	-	16	14833175	54488
chr10	14778687	14978687	harbor2	chr10	14833603	14833934	LINE/L2	951	-	166	14833769	55082
chr10	14778687	14978687	harbor2	chr10	14876840	14877141	LINE/L2	670	-	150	14876990	98303
chr10	14778687	14978687	harbor2	chr10	14860251	14861251	LINE/L2	1163	-	500	14860751	82064
chr10	30719277	30919277	harbor2	chr10	30779991	30780267	LINE/L2	549	-	138	30780129	60852
chr10	72255019	72455019	harbor2	chr10	72318266	72318604	LINE/L2	512	-	169	72318435	63416
chr10	43456881	43656881	harbor2	chr10	43476854	43477092	LINE/L2	469	-	119	43476973	20092
chr10	43456881	43656881	harbor2	chr10	43497398	43497658	LINE/L2	569	-	130	43497528	40647
chr10	14778684	14978684	harbor2	chr10	14799774	14800522	LINE/L2	1286	-	374	14800148	21464
chr10	14778684	14978684	harbor2	chr10	14831934	14832839	LINE/L2	1894	-	452	14832386	53702
chr10	14778684	14978684	harbor2	chr10	14833159	14833192	LINE/L2	2090	-	16	14833175	54491
chr10	14778684	14978684	harbor2	chr10	14833603	14833934	LINE/L2	951	-	166	14833769	55085
chr10	14778684	14978684	harbor2	chr10	14876840	14877141	LINE/L2	670	-	150	14876990	98306
chr10	14778684	14978684	harbor2	chr10	14860251	14861251	LINE/L2	1163	-	500	14860751	82067
chr11	6471157	6671157	harbor2	chr11	6480702	6480806	LINE/L2	471	-	52	6480754	9597
chr11	6471157	6671157	harbor2	chr11	6493256	6493569	LINE/L2	942	-	156	6493412	22255
chr11	6471157	6671157	harbor2	chr11	6495724	6496479	LINE/L2	1961	-	378	6496102	24945
chr11	6471157	6671157	harbor2	chr11	6527195	6527510	LINE/L2	937	-	158	6527353	56196
chr11	6471157	6671157	harbor2	chr11	6537362	6537650	LINE/L2	1228	-	144	6537506	66349
chr11	6471157	6671157	harbor2	chr11	6537944	6538148	LINE/L2	1228	-	102	6538046	66889
chr11	6471157	6671157	harbor2	chr11	6541565	6541886	LINE/L2	619	-	160	6541725	70568
chr11	6471157	6671157	harbor2	chr11	6561705	6562571	LINE/L2	837	-	433	6562138	90981
chr11	6471157	6671157	harbor2	chr11	6568985	6569202	LINE/L2	961	-	108	6569093	97936
chr11	6471157	6671157	harbor2	chr11	6471528	6471814	LINE/L2	675	-	143	6471671	514
chr11	6471157	6671157	harbor2	chr11	6569493	6569987	LINE/L2	961	-	247	6569740	98583
chr11	76587360	76787360	harbor2	chr11	76597104	76597375	LINE/L2	419	-	136	76597240	9880
chr11	123512081	123712081	harbor2	chr11	123514006	123514298	LINE/L2	516	-	146	123514152	2071
chr11	123512081	123712081	harbor2	chr11	123566808	123567260	LINE/L2	669	-	226	123567034	54953
chr11	123512081	123712081	harbor2	chr11	123603567	123604472	LINE/L2	1967	-	452	123604019	91938
chr11	5270094	5470094	harbor2	chr11	5277226	5277653	LINE/L2	906	-	214	5277440	7346
chr11	5270094	5470094	harbor2	chr11	5277807	5278123	LINE/L2	1029	-	158	5277965	7871
chr11	5270094	5470094	harbor2	chr11	5344677	5345578	LINE/L2	759	-	450	5345127	75033
chr11	63803936	64003936	harbor2	chr11	63814934	63815312	LINE/L2	1010	-	189	63815123	11187
chr11	63803936	64003936	harbor2	chr11	63815333	63815658	LINE/L2	768	-	162	63815495	11559
chr11	63803936	64003936	harbor2	chr11	63816235	63816451	LINE/L2	463	-	108	63816343	12407
chr11	65969869	66169869	harbor2	chr11	65971707	65971926	LINE/L2	439	-	110	65971817	1948
chr11	65969869	66169869	harbor2	chr11	65997828	65998008	LINE/L2	424	-	90	65997918	28049
chr11	65969869	66169869	harbor2	chr11	66044597	66044709	LINE/L2	404	-	56	66044653	74784
chr11	65969869	66169869	harbor2	chr11	66067180	66067405	LINE/L2	562	-	112	66067292	97423
chr11	24165672	24365672	harbor2	chr11	24187073	24187637	LINE/L2	727	-	282	24187355	21683
chr11	24165672	24365672	harbor2	chr11	24225155	24225611	LINE/L2	569	-	228	24225383	59711
chr11	24165672	24365672	harbor2	chr11	24244961	24245409	LINE/L2	787	-	224	24245185	79513
chr11	5191443	5391443	harbor2	chr11	5277226	5277653	LINE/L2	906	-	214	5277440	85997
chr11	5191443	5391443	harbor2	chr11	5277807	5278123	LINE/L2	1029	-	158	5277965	86522
chr11	57400290	57600290	harbor2	chr11	57429208	57429330	LINE/L2	406	-	61	57429269	28979
chr11	57400290	57600290	harbor2	chr11	57444938	57445218	LINE/L2	831	-	140	57445078	44788
chr11	57400290	57600290	harbor2	chr11	57445529	57445553	LINE/L2	831	-	12	57445541	45251
chr11	57400290	57600290	harbor2	chr11	57469173	57469325	LINE/L2	401	-	76	57469249	68959
chr11	57400290	57600290	harbor2	chr11	57471708	57471847	LINE/L2	499	-	70	57471778	71488
chr11	57400290	57600290	harbor2	chr11	57487520	57488381	LINE/L2	1345	-	430	57487950	87660
chr11	76580960	76780960	harbor2	chr11	76597104	76597375	LINE/L2	419	-	136	76597240	16280
chr11	119281619	119481619	harbor2	chr11	119286808	119287162	LINE/L2	573	-	177	119286985	5366
chr11	119281619	119481619	harbor2	chr11	119323986	119324252	LINE/L2	572	-	133	119324119	42500
chr11	32346594	32546594	harbor2	chr11	32350609	32351044	LINE/L2	598	-	218	32350827	4233
chr11	108021913	108221913	harbor2	chr11	108074921	108075186	LINE/L2	962	-	132	108075053	53140
chr11	108021913	108221913	harbor2	chr11	108076742	108077355	LINE/L2	1820	-	306	108077048	55135
chr11	6373185	6573185	harbor2	chr11	6372922	6373200	LINE/L2	556	-	139	6373061	124
chr11	6373185	6573185	harbor2	chr11	6377203	6377497	LINE/L2	531	-	147	6377350	4165
chr11	6373185	6573185	harbor2	chr11	6377809	6378100	LINE/L2	531	-	146	6377955	4770
chr11	6373185	6573185	harbor2	chr11	6417564	6418432	LINE/L2	1583	-	434	6417998	44813
chr11	6373185	6573185	harbor2	chr11	6420848	6421191	LINE/L2	774	-	172	6421020	47835
chr11	6373185	6573185	harbor2	chr11	6423693	6424140	LINE/L2	659	-	224	6423917	50732
chr11	6373185	6573185	harbor2	chr11	6451656	6452195	LINE/L2	721	-	270	6451926	78741
chr11	6373185	6573185	harbor2	chr11	6459602	6460321	LINE/L2	735	-	360	6459962	86777
chr11	6373185	6573185	harbor2	chr11	6467022	6467483	LINE/L2	1331	-	230	6467252	94067
chr11	6373185	6573185	harbor2	chr11	6467780	6468001	LINE/L2	1331	-	110	6467890	94705
chr11	6373185	6573185	harbor2	chr11	6468135	6468766	LINE/L2	1331	-	316	6468451	95266
chr11	6373185	6573185	harbor2	chr11	6469961	6470402	LINE/L2	899	-	220	6470181	96996
chr11	6373185	6573185	harbor2	chr11	6470568	6471084	LINE/L2	899	-	258	6470826	97641
chr11	6373185	6573185	harbor2	chr11	6373333	6373498	LINE/L2	556	-	82	6373415	230
chr11	6373185	6573185	harbor2	chr11	6438860	6439306	LINE/L2	756	-	223	6439083	65898
chr11	6373185	6573185	harbor2	chr11	6471528	6471814	LINE/L2	675	-	143	6471671	98486
chr11	6373185	6573185	harbor2	chr11	6422239	6422670	LINE/L2	774	-	216	6422455	49270
chr11	5226186	5426186	harbor2	chr11	5277226	5277653	LINE/L2	906	-	214	5277440	51254
chr11	5226186	5426186	harbor2	chr11	5277807	5278123	LINE/L2	1029	-	158	5277965	51779
chr11	5201291	5401291	harbor2	chr11	5277226	5277653	LINE/L2	906	-	214	5277440	76149
chr11	5201291	5401291	harbor2	chr11	5277807	5278123	LINE/L2	1029	-	158	5277965	76674
chr11	65472319	65672319	harbor2	chr11	65528810	65528951	LINE/L2	448	-	70	65528880	56561
chr11	65472319	65672319	harbor2	chr11	65534429	65534703	LINE/L2	834	-	137	65534566	62247
chr11	65472319	65672319	harbor2	chr11	65549959	65550127	LINE/L2	697	-	84	65550043	77724
chr11	65472319	65672319	harbor2	chr11	65550446	65550531	LINE/L2	697	-	42	65550488	78169
chr11	65472319	65672319	harbor2	chr11	65560453	65560976	LINE/L2	516	-	262	65560715	88396
chr11	108021542	108221542	harbor2	chr11	108074921	108075186	LINE/L2	962	-	132	108075053	53511
chr11	108021542	108221542	harbor2	chr11	108076742	108077355	LINE/L2	1820	-	306	108077048	55506
chr11	119644666	119844666	harbor2	chr11	119705251	119705781	LINE/L2	731	-	265	119705516	60850
chr11	119644666	119844666	harbor2	chr11	119710359	119710776	LINE/L2	581	-	208	119710567	65901
chr11	76580967	76780967	harbor2	chr11	76597104	76597375	LINE/L2	419	-	136	76597240	16273
chr11	57399778	57599778	harbor2	chr11	57429208	57429330	LINE/L2	406	-	61	57429269	29491
chr11	57399778	57599778	harbor2	chr11	57444938	57445218	LINE/L2	831	-	140	57445078	45300
chr11	57399778	57599778	harbor2	chr11	57445529	57445553	LINE/L2	831	-	12	57445541	45763
chr11	57399778	57599778	harbor2	chr11	57469173	57469325	LINE/L2	401	-	76	57469249	69471
chr11	57399778	57599778	harbor2	chr11	57471708	57471847	LINE/L2	499	-	70	57471778	72000
chr11	57399778	57599778	harbor2	chr11	57487520	57488381	LINE/L2	1345	-	430	57487950	88172
chr11	19833606	20033606	harbor2	chr11	19840828	19840946	LINE/L2	524	-	59	19840887	7281
chr11	19833606	20033606	harbor2	chr11	19863488	19863601	LINE/L2	429	-	56	19863544	29938
chr11	19833606	20033606	harbor2	chr11	19882043	19882434	LINE/L2	688	-	196	19882239	48633
chr11	19833606	20033606	harbor2	chr11	19904248	19904427	LINE/L2	418	-	90	19904338	70732
chr11	20632633	20832633	harbor2	chr11	20664929	20665736	LINE/L2	1002	-	404	20665333	32700
chr11	20632633	20832633	harbor2	chr11	20666843	20667070	LINE/L2	745	-	114	20666957	34324
chr11	20632633	20832633	harbor2	chr11	20671629	20671985	LINE/L2	424	-	178	20671807	39174
chr11	128776611	128976611	harbor2	chr11	128801758	128801991	LINE/L2	619	-	116	128801874	25263
chr11	44479732	44679732	harbor2	chr11	44507066	44507531	LINE/L2	507	-	232	44507298	27566
chr11	44479732	44679732	harbor2	chr11	44514240	44514430	LINE/L2	1022	-	95	44514335	34603
chr11	44479732	44679732	harbor2	chr11	44514865	44515197	LINE/L2	1022	-	166	44515031	35299
chr11	44479732	44679732	harbor2	chr11	44534079	44534544	LINE/L2	1046	-	232	44534311	54579
chr11	44479732	44679732	harbor2	chr11	44540941	44541499	LINE/L2	1034	-	279	44541220	61488
chr11	44479732	44679732	harbor2	chr11	44541806	44542185	LINE/L2	1034	-	190	44541996	62264
chr11	5181711	5381711	harbor2	chr11	5277226	5277653	LINE/L2	906	-	214	5277440	95729
chr11	5181711	5381711	harbor2	chr11	5277807	5278123	LINE/L2	1029	-	158	5277965	96254
chr11	5221268	5421268	harbor2	chr11	5277226	5277653	LINE/L2	906	-	214	5277440	56172
chr11	5221268	5421268	harbor2	chr11	5277807	5278123	LINE/L2	1029	-	158	5277965	56697
chr11	108021539	108221539	harbor2	chr11	108074921	108075186	LINE/L2	962	-	132	108075053	53514
chr11	108021539	108221539	harbor2	chr11	108076742	108077355	LINE/L2	1820	-	306	108077048	55509
chr11	111441454	111641454	harbor2	chr11	111517533	111517784	LINE/L2	704	-	126	111517659	76205
chr11	111441454	111641454	harbor2	chr11	111525718	111525813	LINE/L2	823	-	48	111525766	84312
chr11	111441454	111641454	harbor2	chr11	111525890	111526196	LINE/L2	823	-	153	111526043	84589
chr11	111441454	111641454	harbor2	chr11	111526222	111526763	LINE/L2	940	-	270	111526492	85038
chr11	73152931	73352931	harbor2	chr11	73190348	73190826	LINE/L2	567	-	239	73190587	37656
chr11	73152931	73352931	harbor2	chr11	73212990	73213265	LINE/L2	457	-	138	73213128	60197
chr11	73152931	73352931	harbor2	chr11	73244283	73244382	LINE/L2	1200	-	50	73244333	91402
chr11	73152931	73352931	harbor2	chr11	73244699	73245368	LINE/L2	1200	-	334	73245033	92102
chr11	64914593	65114593	harbor2	chr11	64941243	64941373	LINE/L2	442	-	65	64941308	26715
chr11	64914593	65114593	harbor2	chr11	64941677	64941904	LINE/L2	442	-	114	64941791	27198
chr11	64914593	65114593	harbor2	chr11	64967714	64968278	LINE/L2	1428	-	282	64967996	53403
chr11	64914593	65114593	harbor2	chr11	64968852	64969384	LINE/L2	1428	-	266	64969118	54525
chr11	64914593	65114593	harbor2	chr11	64969387	64969657	LINE/L2	461	-	135	64969522	54929
chr11	64914593	65114593	harbor2	chr11	64995389	64995536	LINE/L2	522	-	74	64995463	80870
chr11	64914593	65114593	harbor2	chr11	65005077	65005371	LINE/L2	758	-	147	65005224	90631
chr11	64914593	65114593	harbor2	chr11	65005500	65005650	LINE/L2	496	-	75	65005575	90982
chr11	64914593	65114593	harbor2	chr11	65006225	65006241	LINE/L2	496	-	8	65006233	91640
chr11	64914593	65114593	harbor2	chr11	65006537	65006625	LINE/L2	496	-	44	65006581	91988
chr11	124701200	124901200	harbor2	chr11	124726572	124726648	LINE/L2	428	-	38	124726610	25410
chr11	69543435	69743435	harbor2	chr11	69616764	69616946	LINE/L2	865	-	91	69616855	73420
chr11	69543435	69743435	harbor2	chr11	69617263	69617644	LINE/L2	865	-	190	69617453	74018
chr11	69543435	69743435	harbor2	chr11	69617963	69618458	LINE/L2	1170	-	248	69618211	74776
chr11	76580928	76780928	harbor2	chr11	76597104	76597375	LINE/L2	419	-	136	76597240	16312
chr11	5270036	5470036	harbor2	chr11	5277226	5277653	LINE/L2	906	-	214	5277440	7404
chr11	5270036	5470036	harbor2	chr11	5277807	5278123	LINE/L2	1029	-	158	5277965	7929
chr11	5270036	5470036	harbor2	chr11	5344677	5345578	LINE/L2	759	-	450	5345127	75091
chr11	5191352	5391352	harbor2	chr11	5277226	5277653	LINE/L2	906	-	214	5277440	86088
chr11	5191352	5391352	harbor2	chr11	5277807	5278123	LINE/L2	1029	-	158	5277965	86613
chr11	67383369	67583369	harbor2	chr11	67388439	67388521	LINE/L2	463	-	41	67388480	5111
chr11	67383369	67583369	harbor2	chr11	67389148	67389838	LINE/L2	750	-	345	67389493	6124
chr11	67383369	67583369	harbor2	chr11	67417009	67417115	LINE/L2	431	-	53	67417062	33693
chr11	67383369	67583369	harbor2	chr11	67465318	67465595	LINE/L2	502	-	138	67465456	82087
chr11	67383369	67583369	harbor2	chr11	67470531	67470949	LINE/L2	502	-	209	67470740	87371
chr11	68651712	68851712	harbor2	chr11	68741635	68741896	LINE/L2	446	-	130	68741765	90053
chr11	105168684	105368684	harbor2	chr11	105240183	105240526	LINE/L2	466	-	172	105240355	71671
chr11	105168684	105368684	harbor2	chr11	105241033	105241779	LINE/L2	760	-	373	105241406	72722
chr11	105168684	105368684	harbor2	chr11	105255548	105255729	LINE/L2	548	-	90	105255638	86954
chr11	73279444	73479444	harbor2	chr11	73284751	73285067	LINE/L2	1088	-	158	73284909	5465
chr11	73279444	73479444	harbor2	chr11	73297945	73298234	LINE/L2	548	-	144	73298089	18645
chr11	73279444	73479444	harbor2	chr11	73316272	73316954	LINE/L2	1178	-	341	73316613	37169
chr11	73279444	73479444	harbor2	chr11	73341039	73341295	LINE/L2	633	-	128	73341167	61723
chr11	73279444	73479444	harbor2	chr11	73341612	73341774	LINE/L2	633	-	81	73341693	62249
chr11	73279444	73479444	harbor2	chr11	73347319	73347524	LINE/L2	466	-	102	73347421	67977
chr11	73279444	73479444	harbor2	chr11	73348837	73349041	LINE/L2	516	-	102	73348939	69495
chr11	108021866	108221866	harbor2	chr11	108074921	108075186	LINE/L2	962	-	132	108075053	53187
chr11	108021866	108221866	harbor2	chr11	108076742	108077355	LINE/L2	1820	-	306	108077048	55182
chr11	108021556	108221556	harbor2	chr11	108074921	108075186	LINE/L2	962	-	132	108075053	53497
chr11	108021556	108221556	harbor2	chr11	108076742	108077355	LINE/L2	1820	-	306	108077048	55492
chr11	20061870	20261870	harbor2	chr11	20085301	20085546	LINE/L2	492	-	122	20085423	23553
chr11	20061870	20261870	harbor2	chr11	20086681	20087215	LINE/L2	862	-	267	20086948	25078
chr11	5503303	5703303	harbor2	chr11	5510284	5511429	LINE/L2	2122	-	572	5510856	7553
chr11	5503303	5703303	harbor2	chr11	5511872	5511895	LINE/L2	2122	-	12	5511884	8581
chr11	5503303	5703303	harbor2	chr11	5512081	5512242	LINE/L2	2122	-	80	5512161	8858
chr11	5503303	5703303	harbor2	chr11	5512287	5512848	LINE/L2	716	-	280	5512567	9264
chr11	5503303	5703303	harbor2	chr11	5554339	5554619	LINE/L2	415	-	140	5554479	51176
chr11	5503303	5703303	harbor2	chr11	5555968	5556411	LINE/L2	507	-	222	5556190	52887
chr11	5503303	5703303	harbor2	chr11	5602002	5602158	LINE/L2	626	-	78	5602080	98777
chr11	5503303	5703303	harbor2	chr11	5602438	5602627	LINE/L2	626	-	94	5602532	99229
chr11	64807264	65007264	harbor2	chr11	64813808	64814127	LINE/L2	492	-	160	64813968	6704
chr11	64807264	65007264	harbor2	chr11	64815597	64815793	LINE/L2	711	-	98	64815695	8431
chr11	64807264	65007264	harbor2	chr11	64817505	64818305	LINE/L2	1363	-	400	64817905	10641
chr11	64807264	65007264	harbor2	chr11	64890728	64890973	LINE/L2	401	-	122	64890850	83586
chr11	6583608	6783608	harbor2	chr11	6596215	6596596	LINE/L2	911	-	190	6596405	12797
chr11	6583608	6783608	harbor2	chr11	6604474	6605505	LINE/L2	1118	-	516	6604990	21382
chr11	6583608	6783608	harbor2	chr11	6612778	6612969	LINE/L2	429	-	96	6612874	29266
chr11	6583608	6783608	harbor2	chr11	6642250	6643080	LINE/L2	675	-	415	6642665	59057
chr11	6583608	6783608	harbor2	chr11	6648085	6648533	LINE/L2	631	-	224	6648309	64701
chr11	6583608	6783608	harbor2	chr11	6658617	6659157	LINE/L2	767	-	270	6658887	75279
chr11	6583608	6783608	harbor2	chr11	6659768	6660290	LINE/L2	530	-	261	6660029	76421
chr11	6583608	6783608	harbor2	chr11	6660580	6660792	LINE/L2	530	-	106	6660686	77078
chr11	6583608	6783608	harbor2	chr11	6677847	6678320	LINE/L2	486	-	236	6678083	94475
chr11	6583608	6783608	harbor2	chr11	6651227	6652796	LINE/L2	1243	-	784	6652011	68403
chr11	46517295	46717295	harbor2	chr11	46536176	46536444	LINE/L2	517	-	134	46536310	19015
chr11	46517295	46717295	harbor2	chr11	46561939	46562437	LINE/L2	453	-	249	46562188	44893
chr11	46517295	46717295	harbor2	chr11	46562438	46562628	LINE/L2	457	-	95	46562533	45238
chr11	125492737	125692737	harbor2	chr11	125587556	125587693	LINE/L2	440	-	68	125587624	94887
chr11	6512776	6712776	harbor2	chr11	6527195	6527510	LINE/L2	937	-	158	6527353	14577
chr11	6512776	6712776	harbor2	chr11	6537362	6537650	LINE/L2	1228	-	144	6537506	24730
chr11	6512776	6712776	harbor2	chr11	6537944	6538148	LINE/L2	1228	-	102	6538046	25270
chr11	6512776	6712776	harbor2	chr11	6541565	6541886	LINE/L2	619	-	160	6541725	28949
chr11	6512776	6712776	harbor2	chr11	6561705	6562571	LINE/L2	837	-	433	6562138	49362
chr11	6512776	6712776	harbor2	chr11	6568985	6569202	LINE/L2	961	-	108	6569093	56317
chr11	6512776	6712776	harbor2	chr11	6572499	6573356	LINE/L2	1164	-	428	6572927	60151
chr11	6512776	6712776	harbor2	chr11	6596215	6596596	LINE/L2	911	-	190	6596405	83629
chr11	6512776	6712776	harbor2	chr11	6604474	6605505	LINE/L2	1118	-	516	6604990	92214
chr11	6512776	6712776	harbor2	chr11	6569493	6569987	LINE/L2	961	-	247	6569740	56964
chr11	5211379	5411379	harbor2	chr11	5277226	5277653	LINE/L2	906	-	214	5277440	66061
chr11	5211379	5411379	harbor2	chr11	5277807	5278123	LINE/L2	1029	-	158	5277965	66586
chr11	63816020	64016020	harbor2	chr11	63816235	63816451	LINE/L2	463	-	108	63816343	323
chr11	108021552	108221552	harbor2	chr11	108074921	108075186	LINE/L2	962	-	132	108075053	53501
chr11	108021552	108221552	harbor2	chr11	108076742	108077355	LINE/L2	1820	-	306	108077048	55496
chr11	64540474	64740474	harbor2	chr11	64576443	64576592	LINE/L2	467	-	74	64576517	36043
chr11	64540474	64740474	harbor2	chr11	64587811	64588691	LINE/L2	1813	-	440	64588251	47777
chr11	64540474	64740474	harbor2	chr11	64596934	64597037	LINE/L2	446	-	52	64596986	56512
chr11	76580957	76780957	harbor2	chr11	76597104	76597375	LINE/L2	419	-	136	76597240	16283
chr11	67172236	67372236	harbor2	chr11	67246278	67246367	LINE/L2	433	-	44	67246322	74086
chr11	67172236	67372236	harbor2	chr11	67262772	67263512	LINE/L2	796	-	370	67263142	90906
chr11	5199897	5399897	harbor2	chr11	5277226	5277653	LINE/L2	906	-	214	5277440	77543
chr11	5199897	5399897	harbor2	chr11	5277807	5278123	LINE/L2	1029	-	158	5277965	78068
chr11	5269991	5469991	harbor2	chr11	5277226	5277653	LINE/L2	906	-	214	5277440	7449
chr11	5269991	5469991	harbor2	chr11	5277807	5278123	LINE/L2	1029	-	158	5277965	7974
chr11	5269991	5469991	harbor2	chr11	5344677	5345578	LINE/L2	759	-	450	5345127	75136
chr11	129795685	129995685	harbor2	chr11	129825290	129825601	LINE/L2	547	-	156	129825446	29761
chr11	129795685	129995685	harbor2	chr11	129846523	129847076	LINE/L2	911	-	276	129846799	51114
chr11	64545468	64745468	harbor2	chr11	64576443	64576592	LINE/L2	467	-	74	64576517	31049
chr11	64545468	64745468	harbor2	chr11	64587811	64588691	LINE/L2	1813	-	440	64588251	42783
chr11	64545468	64745468	harbor2	chr11	64596934	64597037	LINE/L2	446	-	52	64596986	51518
chr11	5280964	5480964	harbor2	chr11	5344677	5345578	LINE/L2	759	-	450	5345127	64163
chr11	119007408	119207408	harbor2	chr11	119079932	119080060	LINE/L2	627	-	64	119079996	72588
chr11	119007408	119207408	harbor2	chr11	119080358	119080368	LINE/L2	627	-	5	119080363	72955
chr11	119007408	119207408	harbor2	chr11	119080669	119080824	LINE/L2	627	-	78	119080747	73339
chr11	43955448	44155448	harbor2	chr11	43991130	43991240	LINE/L2	538	-	55	43991185	35737
chr11	43955448	44155448	harbor2	chr11	43995417	43995836	LINE/L2	445	-	210	43995627	40179
chr11	43955448	44155448	harbor2	chr11	43996274	43996703	LINE/L2	445	-	214	43996488	41040
chr11	43955448	44155448	harbor2	chr11	44001071	44001198	LINE/L2	455	-	64	44001135	45687
chr11	43955448	44155448	harbor2	chr11	44016998	44017294	LINE/L2	467	-	148	44017146	61698
chr11	43955448	44155448	harbor2	chr11	44037921	44038347	LINE/L2	1253	-	213	44038134	82686
chr11	43955448	44155448	harbor2	chr11	44038345	44038667	LINE/L2	470	-	161	44038506	83058
chr11	78110765	78310765	harbor2	chr11	78190551	78190834	LINE/L2	459	-	142	78190693	79928
chr11	78110765	78310765	harbor2	chr11	78194750	78195042	LINE/L2	486	-	146	78194896	84131
chr11	84774083	84974083	harbor2	chr11	84811713	84812008	LINE/L2	481	-	148	84811861	37778
chr11	84774083	84974083	harbor2	chr11	84845323	84845463	LINE/L2	573	-	70	84845393	71310
chr11	84774083	84974083	harbor2	chr11	84860944	84861332	LINE/L2	458	-	194	84861138	87055
chr11	84774083	84974083	harbor2	chr11	84872340	84872631	LINE/L2	490	-	146	84872486	98403
chr11	64349298	64549298	harbor2	chr11	64410959	64411230	LINE/L2	596	-	136	64411095	61797
chr11	64349298	64549298	harbor2	chr11	64411294	64411661	LINE/L2	463	-	184	64411478	62180
chr11	64349298	64549298	harbor2	chr11	64411973	64412081	LINE/L2	463	-	54	64412027	62729
chr11	64349298	64549298	harbor2	chr11	64413484	64413609	LINE/L2	452	-	62	64413546	64248
chr11	64349298	64549298	harbor2	chr11	64414911	64415363	LINE/L2	452	-	226	64415137	65839
chr11	108021537	108221537	harbor2	chr11	108074921	108075186	LINE/L2	962	-	132	108075053	53516
chr11	108021537	108221537	harbor2	chr11	108076742	108077355	LINE/L2	1820	-	306	108077048	55511
chr11	5191359	5391359	harbor2	chr11	5277226	5277653	LINE/L2	906	-	214	5277440	86081
chr11	5191359	5391359	harbor2	chr11	5277807	5278123	LINE/L2	1029	-	158	5277965	86606
chr11	5191377	5391377	harbor2	chr11	5277226	5277653	LINE/L2	906	-	214	5277440	86063
chr11	5191377	5391377	harbor2	chr11	5277807	5278123	LINE/L2	1029	-	158	5277965	86588
chr11	73152932	73352932	harbor2	chr11	73190348	73190826	LINE/L2	567	-	239	73190587	37655
chr11	73152932	73352932	harbor2	chr11	73212990	73213265	LINE/L2	457	-	138	73213128	60196
chr11	73152932	73352932	harbor2	chr11	73244283	73244382	LINE/L2	1200	-	50	73244333	91401
chr11	73152932	73352932	harbor2	chr11	73244699	73245368	LINE/L2	1200	-	334	73245033	92101
chr11	27326376	27526376	harbor2	chr11	27349714	27349845	LINE/L2	418	-	66	27349780	23404
chr11	27326376	27526376	harbor2	chr11	27387203	27387718	LINE/L2	628	-	258	27387461	61085
chr11	74202004	74402004	harbor2	chr11	74208351	74208481	LINE/L2	437	-	65	74208416	6412
chr11	74202004	74402004	harbor2	chr11	74233894	74235105	LINE/L2	2830	-	606	74234500	32496
chr11	74202004	74402004	harbor2	chr11	74277968	74278274	LINE/L2	423	-	153	74278121	76117
chr11	74202004	74402004	harbor2	chr11	74298477	74298873	LINE/L2	499	-	198	74298675	96671
chr11	5227113	5427113	harbor2	chr11	5277226	5277653	LINE/L2	906	-	214	5277440	50327
chr11	5227113	5427113	harbor2	chr11	5277807	5278123	LINE/L2	1029	-	158	5277965	50852
chr11	43448895	43648895	harbor2	chr11	43480193	43480301	LINE/L2	444	-	54	43480247	31352
chr11	43448895	43648895	harbor2	chr11	43507108	43507544	LINE/L2	567	-	218	43507326	58431
chr11	43448895	43648895	harbor2	chr11	43508087	43508347	LINE/L2	463	-	130	43508217	59322
chr11	43448895	43648895	harbor2	chr11	43511577	43511937	LINE/L2	489	-	180	43511757	62862
chr11	61487515	61687515	harbor2	chr11	61501030	61501197	LINE/L2	480	-	84	61501114	13599
chr11	61487515	61687515	harbor2	chr11	61502253	61502363	LINE/L2	480	-	55	61502308	14793
chr11	133733618	133933618	harbor2	chr11	133799668	133800426	LINE/L2	995	-	379	133800047	66429
chr11	133733618	133933618	harbor2	chr11	133820210	133820510	LINE/L2	613	-	150	133820360	86742
chr11	27266585	27466585	harbor2	chr11	27349714	27349845	LINE/L2	418	-	66	27349780	83195
chr11	46346052	46546052	harbor2	chr11	46386723	46387105	LINE/L2	486	-	191	46386914	40862
chr11	46346052	46546052	harbor2	chr11	46432063	46432470	LINE/L2	467	-	204	46432267	86215
chr11	68333728	68533728	harbor2	chr11	68351737	68352301	LINE/L2	505	-	282	68352019	18291
chr11	69540352	69740352	harbor2	chr11	69616764	69616946	LINE/L2	865	-	91	69616855	76503
chr11	69540352	69740352	harbor2	chr11	69617263	69617644	LINE/L2	865	-	190	69617453	77101
chr11	69540352	69740352	harbor2	chr11	69617963	69618458	LINE/L2	1170	-	248	69618211	77859
chr11	108021538	108221538	harbor2	chr11	108074921	108075186	LINE/L2	962	-	132	108075053	53515
chr11	108021538	108221538	harbor2	chr11	108076742	108077355	LINE/L2	1820	-	306	108077048	55510
chr11	9360730	9560730	harbor2	chr11	9398199	9398560	LINE/L2	509	-	180	9398379	37649
chr11	5199336	5399336	harbor2	chr11	5277226	5277653	LINE/L2	906	-	214	5277440	78104
chr11	5199336	5399336	harbor2	chr11	5277807	5278123	LINE/L2	1029	-	158	5277965	78629
chr11	45786822	45986822	harbor2	chr11	45791815	45791958	LINE/L2	399	-	72	45791887	5065
chr11	45786822	45986822	harbor2	chr11	45817719	45817975	LINE/L2	527	-	128	45817847	31025
chr11	45786822	45986822	harbor2	chr11	45818112	45818427	LINE/L2	1287	-	158	45818270	31448
chr11	45786822	45986822	harbor2	chr11	45818731	45819010	LINE/L2	1287	-	140	45818871	32049
chr11	45786822	45986822	harbor2	chr11	45820333	45820746	LINE/L2	1016	-	206	45820539	33717
chr11	45786822	45986822	harbor2	chr11	45845505	45845615	LINE/L2	414	-	55	45845560	58738
chr11	45786822	45986822	harbor2	chr11	45845919	45846264	LINE/L2	466	-	172	45846091	59269
chr11	45786822	45986822	harbor2	chr11	45849360	45849527	LINE/L2	407	-	84	45849444	62622
chr11	45786822	45986822	harbor2	chr11	45865881	45866585	LINE/L2	1132	-	352	45866233	79411
chr11	45786822	45986822	harbor2	chr11	45871008	45871572	LINE/L2	671	-	282	45871290	84468
chr11	45786822	45986822	harbor2	chr11	45874533	45874663	LINE/L2	583	-	65	45874598	87776
chr11	45786822	45986822	harbor2	chr11	45874954	45875012	LINE/L2	583	-	29	45874983	88161
chr11	10799794	10999794	harbor2	chr11	10814346	10814604	LINE/L2	444	-	129	10814475	14681
chr11	10799794	10999794	harbor2	chr11	10827180	10827378	LINE/L2	526	-	99	10827279	27485
chr11	10799794	10999794	harbor2	chr11	10844267	10844371	LINE/L2	432	-	52	10844319	44525
chr11	10799794	10999794	harbor2	chr11	10888705	10889115	LINE/L2	571	-	205	10888910	89116
chr11	10799794	10999794	harbor2	chr11	10891416	10891811	LINE/L2	409	-	198	10891614	91820
chr11	47115696	47315696	harbor2	chr11	47151056	47151144	LINE/L2	550	-	44	47151100	35404
chr11	47115696	47315696	harbor2	chr11	47151413	47151673	LINE/L2	550	-	130	47151543	35847
chr11	47115696	47315696	harbor2	chr11	47179638	47179945	LINE/L2	416	-	154	47179792	64096
chr11	69543489	69743489	harbor2	chr11	69616764	69616946	LINE/L2	865	-	91	69616855	73366
chr11	69543489	69743489	harbor2	chr11	69617263	69617644	LINE/L2	865	-	190	69617453	73964
chr11	69543489	69743489	harbor2	chr11	69617963	69618458	LINE/L2	1170	-	248	69618211	74722
chr11	65110704	65310704	harbor2	chr11	65136380	65136930	LINE/L2	983	-	275	65136655	25951
chr11	65110704	65310704	harbor2	chr11	65137240	65137345	LINE/L2	877	-	52	65137292	26588
chr11	65110704	65310704	harbor2	chr11	65144142	65144268	LINE/L2	540	-	63	65144205	33501
chr11	65110704	65310704	harbor2	chr11	65151389	65151602	LINE/L2	442	-	106	65151495	40791
chr11	69540160	69740160	harbor2	chr11	69616764	69616946	LINE/L2	865	-	91	69616855	76695
chr11	69540160	69740160	harbor2	chr11	69617263	69617644	LINE/L2	865	-	190	69617453	77293
chr11	69540160	69740160	harbor2	chr11	69617963	69618458	LINE/L2	1170	-	248	69618211	78051
chr11	22729649	22929649	harbor2	chr11	22778275	22778640	LINE/L2	465	-	182	22778457	48808
chr11	22729649	22929649	harbor2	chr11	22795296	22795948	LINE/L2	1299	-	326	22795622	65973
chr11	22729649	22929649	harbor2	chr11	22828387	22828641	LINE/L2	510	-	127	22828514	98865
chr11	5204580	5404580	harbor2	chr11	5277226	5277653	LINE/L2	906	-	214	5277440	72860
chr11	5204580	5404580	harbor2	chr11	5277807	5278123	LINE/L2	1029	-	158	5277965	73385
chr11	38440721	38640721	harbor2	chr11	38464116	38464856	LINE/L2	576	-	370	38464486	23765
chr11	108021971	108221971	harbor2	chr11	108074921	108075186	LINE/L2	962	-	132	108075053	53082
chr11	108021971	108221971	harbor2	chr11	108076742	108077355	LINE/L2	1820	-	306	108077048	55077
chr11	126632918	126832918	harbor2	chr11	126675682	126676330	LINE/L2	610	-	324	126676006	43088
chr11	63743240	63943240	harbor2	chr11	63745377	63745544	LINE/L2	512	-	84	63745461	2221
chr11	63743240	63943240	harbor2	chr11	63814934	63815312	LINE/L2	1010	-	189	63815123	71883
chr11	63743240	63943240	harbor2	chr11	63815333	63815658	LINE/L2	768	-	162	63815495	72255
chr11	63743240	63943240	harbor2	chr11	63816235	63816451	LINE/L2	463	-	108	63816343	73103
chr11	64541790	64741790	harbor2	chr11	64576443	64576592	LINE/L2	467	-	74	64576517	34727
chr11	64541790	64741790	harbor2	chr11	64587811	64588691	LINE/L2	1813	-	440	64588251	46461
chr11	64541790	64741790	harbor2	chr11	64596934	64597037	LINE/L2	446	-	52	64596986	55196
chr11	67175747	67375747	harbor2	chr11	67246278	67246367	LINE/L2	433	-	44	67246322	70575
chr11	67175747	67375747	harbor2	chr11	67262772	67263512	LINE/L2	796	-	370	67263142	87395
chr11	65948857	66148857	harbor2	chr11	65962526	65963442	LINE/L2	958	-	458	65962984	14127
chr11	65948857	66148857	harbor2	chr11	65971707	65971926	LINE/L2	439	-	110	65971817	22960
chr11	65948857	66148857	harbor2	chr11	65997828	65998008	LINE/L2	424	-	90	65997918	49061
chr11	65948857	66148857	harbor2	chr11	66044597	66044709	LINE/L2	404	-	56	66044653	95796
chr11	936654	1136654	harbor2	chr11	942762	943120	LINE/L2	417	-	179	942941	6287
chr11	936654	1136654	harbor2	chr11	943580	943726	LINE/L2	417	-	73	943653	6999
chr11	936654	1136654	harbor2	chr11	944338	944524	LINE/L2	551	-	93	944431	7777
chr11	936654	1136654	harbor2	chr11	944525	944954	LINE/L2	785	-	214	944739	8085
chr11	65488849	65688849	harbor2	chr11	65528810	65528951	LINE/L2	448	-	70	65528880	40031
chr11	65488849	65688849	harbor2	chr11	65534429	65534703	LINE/L2	834	-	137	65534566	45717
chr11	65488849	65688849	harbor2	chr11	65549959	65550127	LINE/L2	697	-	84	65550043	61194
chr11	65488849	65688849	harbor2	chr11	65550446	65550531	LINE/L2	697	-	42	65550488	61639
chr11	65488849	65688849	harbor2	chr11	65560453	65560976	LINE/L2	516	-	262	65560715	71866
chr11	9520097	9720097	harbor2	chr11	9606782	9606996	LINE/L2	465	-	107	9606889	86792
chr11	9520097	9720097	harbor2	chr11	9608792	9608987	LINE/L2	1495	-	98	9608890	88793
chr11	9520097	9720097	harbor2	chr11	9609273	9609606	LINE/L2	1495	-	166	9609439	89342
chr11	9520097	9720097	harbor2	chr11	9610303	9610454	LINE/L2	587	-	76	9610379	90282
chr11	9520097	9720097	harbor2	chr11	9616537	9616618	LINE/L2	622	-	40	9616577	96480
chr11	9520097	9720097	harbor2	chr11	9616929	9617247	LINE/L2	650	-	159	9617088	96991
chr11	9520097	9720097	harbor2	chr11	9617751	9618064	LINE/L2	595	-	156	9617907	97810
chr11	58480005	58680005	harbor2	chr11	58551559	58552234	LINE/L2	1118	-	338	58551897	71892
chr11	58480005	58680005	harbor2	chr11	58564624	58565049	LINE/L2	839	-	212	58564836	84831
chr11	58480005	58680005	harbor2	chr11	58568858	58569020	LINE/L2	746	-	81	58568939	88934
chr11	3116281	3316281	harbor2	chr11	3175504	3176054	LINE/L2	755	-	275	3175779	59498
chr11	3116281	3316281	harbor2	chr11	3161893	3162376	LINE/L2	410	-	242	3162135	45854
chr11	76580984	76780984	harbor2	chr11	76597104	76597375	LINE/L2	419	-	136	76597240	16256
chr11	76580958	76780958	harbor2	chr11	76597104	76597375	LINE/L2	419	-	136	76597240	16282
chr11	119275286	119475286	harbor2	chr11	119286808	119287162	LINE/L2	573	-	177	119286985	11699
chr11	119275286	119475286	harbor2	chr11	119323986	119324252	LINE/L2	572	-	133	119324119	48833
chr11	11446354	11646354	harbor2	chr11	11474088	11474653	LINE/L2	578	-	282	11474370	28016
chr11	11446354	11646354	harbor2	chr11	11504943	11505197	LINE/L2	578	-	127	11505070	58716
chr11	11446354	11646354	harbor2	chr11	11515488	11515917	LINE/L2	781	-	214	11515702	69348
chr11	11446354	11646354	harbor2	chr11	11528531	11528942	LINE/L2	407	-	206	11528737	82383
chr11	11446354	11646354	harbor2	chr11	11534419	11534575	LINE/L2	464	-	78	11534497	88143
chr11	108021777	108221777	harbor2	chr11	108074921	108075186	LINE/L2	962	-	132	108075053	53276
chr11	108021777	108221777	harbor2	chr11	108076742	108077355	LINE/L2	1820	-	306	108077048	55271
chr11	5254996	5454996	harbor2	chr11	5277226	5277653	LINE/L2	906	-	214	5277440	22444
chr11	5254996	5454996	harbor2	chr11	5277807	5278123	LINE/L2	1029	-	158	5277965	22969
chr11	5254996	5454996	harbor2	chr11	5344677	5345578	LINE/L2	759	-	450	5345127	90131
chr11	68333892	68533892	harbor2	chr11	68351737	68352301	LINE/L2	505	-	282	68352019	18127
chr11	3994569	4194569	harbor2	chr11	4056397	4056517	LINE/L2	494	-	60	4056457	61888
chr11	3994569	4194569	harbor2	chr11	4087162	4087492	LINE/L2	507	-	165	4087327	92758
chr11	66161658	66361658	harbor2	chr11	66195715	66195827	LINE/L2	670	-	56	66195771	34113
chr11	66161658	66361658	harbor2	chr11	66206639	66206854	LINE/L2	606	-	108	66206747	45089
chr11	66161658	66361658	harbor2	chr11	66259140	66260025	LINE/L2	1199	-	442	66259582	97924
chr11	5189904	5389904	harbor2	chr11	5277226	5277653	LINE/L2	906	-	214	5277440	87536
chr11	5189904	5389904	harbor2	chr11	5277807	5278123	LINE/L2	1029	-	158	5277965	88061
chr11	68332488	68532488	harbor2	chr11	68351737	68352301	LINE/L2	505	-	282	68352019	19531
chr11	64539119	64739119	harbor2	chr11	64576443	64576592	LINE/L2	467	-	74	64576517	37398
chr11	64539119	64739119	harbor2	chr11	64587811	64588691	LINE/L2	1813	-	440	64588251	49132
chr11	64539119	64739119	harbor2	chr11	64596934	64597037	LINE/L2	446	-	52	64596986	57867
chr11	119644502	119844502	harbor2	chr11	119705251	119705781	LINE/L2	731	-	265	119705516	61014
chr11	119644502	119844502	harbor2	chr11	119710359	119710776	LINE/L2	581	-	208	119710567	66065
chr11	61589431	61789431	harbor2	chr11	61591779	61592648	LINE/L2	2564	-	434	61592213	2782
chr11	61589431	61789431	harbor2	chr11	61593198	61593673	LINE/L2	2564	-	238	61593436	4005
chr11	61589431	61789431	harbor2	chr11	61594288	61594884	LINE/L2	2564	-	298	61594586	5155
chr11	61589431	61789431	harbor2	chr11	61670797	61671257	LINE/L2	417	-	230	61671027	81596
chr11	61589431	61789431	harbor2	chr11	61673611	61673827	LINE/L2	408	-	108	61673719	84288
chr11	5270453	5470453	harbor2	chr11	5277226	5277653	LINE/L2	906	-	214	5277440	6987
chr11	5270453	5470453	harbor2	chr11	5277807	5278123	LINE/L2	1029	-	158	5277965	7512
chr11	5270453	5470453	harbor2	chr11	5344677	5345578	LINE/L2	759	-	450	5345127	74674
chr11	77083641	77283641	harbor2	chr11	77111597	77111987	LINE/L2	531	-	195	77111792	28151
chr11	77083641	77283641	harbor2	chr11	77129512	77129953	LINE/L2	722	-	220	77129732	46091
chr11	77083641	77283641	harbor2	chr11	77152806	77153249	LINE/L2	560	-	222	77153028	69387
chr11	77083641	77283641	harbor2	chr11	77160675	77160845	LINE/L2	501	-	85	77160760	77119
chr11	77083641	77283641	harbor2	chr11	77169657	77169793	LINE/L2	1194	-	68	77169725	86084
chr11	77083641	77283641	harbor2	chr11	77170096	77170571	LINE/L2	1194	-	238	77170334	86693
chr11	77083641	77283641	harbor2	chr11	77170717	77170967	LINE/L2	716	-	125	77170842	87201
chr11	126082252	126282252	harbor2	chr11	126103493	126103623	LINE/L2	404	-	65	126103558	21306
chr11	126082252	126282252	harbor2	chr11	126104103	126104174	LINE/L2	404	-	36	126104139	21887
chr11	126082252	126282252	harbor2	chr11	126120252	126120963	LINE/L2	550	-	356	126120608	38356
chr11	126082252	126282252	harbor2	chr11	126121262	126121846	LINE/L2	550	-	292	126121554	39302
chr11	126082252	126282252	harbor2	chr11	126122158	126122456	LINE/L2	550	-	149	126122307	40055
chr11	126082252	126282252	harbor2	chr11	126168344	126168381	LINE/L2	547	-	18	126168362	86110
chr11	126082252	126282252	harbor2	chr11	126169063	126169247	LINE/L2	547	-	92	126169155	86903
chr11	67369200	67569200	harbor2	chr11	67388439	67388521	LINE/L2	463	-	41	67388480	19280
chr11	67369200	67569200	harbor2	chr11	67389148	67389838	LINE/L2	750	-	345	67389493	20293
chr11	67369200	67569200	harbor2	chr11	67417009	67417115	LINE/L2	431	-	53	67417062	47862
chr11	67369200	67569200	harbor2	chr11	67465318	67465595	LINE/L2	502	-	138	67465456	96256
chr11	6206956	6406956	harbor2	chr11	6227473	6227949	LINE/L2	676	-	238	6227711	20755
chr11	6206956	6406956	harbor2	chr11	6230744	6231463	LINE/L2	448	-	360	6231104	24148
chr11	6206956	6406956	harbor2	chr11	6261138	6261384	LINE/L2	459	-	123	6261261	54305
chr11	6206956	6406956	harbor2	chr11	6261780	6262686	LINE/L2	1305	-	453	6262233	55277
chr11	6206956	6406956	harbor2	chr11	6262726	6262980	LINE/L2	1305	-	127	6262853	55897
chr11	6206956	6406956	harbor2	chr11	6265979	6266189	LINE/L2	519	-	105	6266084	59128
chr11	6206956	6406956	harbor2	chr11	6281337	6281492	LINE/L2	409	-	78	6281415	74459
chr11	6206956	6406956	harbor2	chr11	6281792	6281804	LINE/L2	409	-	6	6281798	74842
chr11	117887566	118087566	harbor2	chr11	117930446	117930744	LINE/L2	873	-	149	117930595	43029
chr11	117887566	118087566	harbor2	chr11	117944162	117944350	LINE/L2	440	-	94	117944256	56690
chr11	67892044	68092044	harbor2	chr11	67956205	67956645	LINE/L2	440	-	220	67956425	64381
chr11	67892044	68092044	harbor2	chr11	67960241	67960402	LINE/L2	404	-	80	67960321	68277
chr11	67892044	68092044	harbor2	chr11	67960638	67960809	LINE/L2	478	-	86	67960724	68680
chr11	67892044	68092044	harbor2	chr11	67961106	67961796	LINE/L2	478	-	345	67961451	69407
chr11	5216243	5416243	harbor2	chr11	5277226	5277653	LINE/L2	906	-	214	5277440	61197
chr11	5216243	5416243	harbor2	chr11	5277807	5278123	LINE/L2	1029	-	158	5277965	61722
chr11	64643001	64843001	harbor2	chr11	64689483	64689845	LINE/L2	478	-	181	64689664	46663
chr11	64643001	64843001	harbor2	chr11	64740334	64740672	LINE/L2	771	-	169	64740503	97502
chr11	57400308	57600308	harbor2	chr11	57429208	57429330	LINE/L2	406	-	61	57429269	28961
chr11	57400308	57600308	harbor2	chr11	57444938	57445218	LINE/L2	831	-	140	57445078	44770
chr11	57400308	57600308	harbor2	chr11	57445529	57445553	LINE/L2	831	-	12	57445541	45233
chr11	57400308	57600308	harbor2	chr11	57469173	57469325	LINE/L2	401	-	76	57469249	68941
chr11	57400308	57600308	harbor2	chr11	57471708	57471847	LINE/L2	499	-	70	57471778	71470
chr11	57400308	57600308	harbor2	chr11	57487520	57488381	LINE/L2	1345	-	430	57487950	87642
chr11	76580941	76780941	harbor2	chr11	76597104	76597375	LINE/L2	419	-	136	76597240	16299
chr11	76587997	76787997	harbor2	chr11	76597104	76597375	LINE/L2	419	-	136	76597240	9243
chr11	111441731	111641731	harbor2	chr11	111517533	111517784	LINE/L2	704	-	126	111517659	75928
chr11	111441731	111641731	harbor2	chr11	111525718	111525813	LINE/L2	823	-	48	111525766	84035
chr11	111441731	111641731	harbor2	chr11	111525890	111526196	LINE/L2	823	-	153	111526043	84312
chr11	111441731	111641731	harbor2	chr11	111526222	111526763	LINE/L2	940	-	270	111526492	84761
chr11	120127774	120327774	harbor2	chr11	120140993	120141204	LINE/L2	402	-	106	120141099	13325
chr11	120127774	120327774	harbor2	chr11	120189015	120189332	LINE/L2	419	-	158	120189173	61399
chr11	6519524	6719524	harbor2	chr11	6527195	6527510	LINE/L2	937	-	158	6527353	7829
chr11	6519524	6719524	harbor2	chr11	6537362	6537650	LINE/L2	1228	-	144	6537506	17982
chr11	6519524	6719524	harbor2	chr11	6537944	6538148	LINE/L2	1228	-	102	6538046	18522
chr11	6519524	6719524	harbor2	chr11	6541565	6541886	LINE/L2	619	-	160	6541725	22201
chr11	6519524	6719524	harbor2	chr11	6561705	6562571	LINE/L2	837	-	433	6562138	42614
chr11	6519524	6719524	harbor2	chr11	6568985	6569202	LINE/L2	961	-	108	6569093	49569
chr11	6519524	6719524	harbor2	chr11	6572499	6573356	LINE/L2	1164	-	428	6572927	53403
chr11	6519524	6719524	harbor2	chr11	6596215	6596596	LINE/L2	911	-	190	6596405	76881
chr11	6519524	6719524	harbor2	chr11	6604474	6605505	LINE/L2	1118	-	516	6604990	85466
chr11	6519524	6719524	harbor2	chr11	6612778	6612969	LINE/L2	429	-	96	6612874	93350
chr11	6519524	6719524	harbor2	chr11	6569493	6569987	LINE/L2	961	-	247	6569740	50216
chr11	33600881	33800881	harbor2	chr11	33603162	33603524	LINE/L2	742	-	181	33603343	2462
chr11	33600881	33800881	harbor2	chr11	33603831	33604089	LINE/L2	742	-	129	33603960	3079
chr11	33600881	33800881	harbor2	chr11	33635783	33635880	LINE/L2	689	-	48	33635831	34950
chr11	33600881	33800881	harbor2	chr11	33636856	33637137	LINE/L2	689	-	140	33636996	36115
chr11	33600881	33800881	harbor2	chr11	33655474	33655859	LINE/L2	463	-	192	33655666	54785
chr11	33600881	33800881	harbor2	chr11	33688976	33689231	LINE/L2	558	-	128	33689104	88223
chr11	64142038	64342038	harbor2	chr11	64180853	64181225	LINE/L2	1111	-	186	64181039	39001
chr11	5180299	5380299	harbor2	chr11	5277226	5277653	LINE/L2	906	-	214	5277440	97141
chr11	5180299	5380299	harbor2	chr11	5277807	5278123	LINE/L2	1029	-	158	5277965	97666
chr11	67369215	67569215	harbor2	chr11	67388439	67388521	LINE/L2	463	-	41	67388480	19265
chr11	67369215	67569215	harbor2	chr11	67389148	67389838	LINE/L2	750	-	345	67389493	20278
chr11	67369215	67569215	harbor2	chr11	67417009	67417115	LINE/L2	431	-	53	67417062	47847
chr11	67369215	67569215	harbor2	chr11	67465318	67465595	LINE/L2	502	-	138	67465456	96241
chr11	63953820	64153820	harbor2	chr11	63991736	63991935	LINE/L2	1085	-	100	63991836	38016
chr11	63953820	64153820	harbor2	chr11	63992229	63992433	LINE/L2	1085	-	102	63992331	38511
chr11	63953820	64153820	harbor2	chr11	63994634	63995036	LINE/L2	721	-	201	63994835	41015
chr11	63953820	64153820	harbor2	chr11	63995627	63995742	LINE/L2	721	-	58	63995685	41865
chr11	63953820	64153820	harbor2	chr11	64013143	64013640	LINE/L2	951	-	248	64013391	59571
chr11	126376674	126576674	harbor2	chr11	126395203	126395305	LINE/L2	409	-	51	126395254	18580
chr11	126376674	126576674	harbor2	chr11	126401006	126401294	LINE/L2	750	-	144	126401150	24476
chr11	126376674	126576674	harbor2	chr11	126401586	126402136	LINE/L2	750	-	275	126401861	25187
chr11	126376674	126576674	harbor2	chr11	126404357	126404588	LINE/L2	477	-	116	126404473	27799
chr11	126376674	126576674	harbor2	chr11	126427258	126427974	LINE/L2	530	-	358	126427616	50942
chr11	67408273	67608273	harbor2	chr11	67417009	67417115	LINE/L2	431	-	53	67417062	8789
chr11	67408273	67608273	harbor2	chr11	67465318	67465595	LINE/L2	502	-	138	67465456	57183
chr11	67408273	67608273	harbor2	chr11	67470531	67470949	LINE/L2	502	-	209	67470740	62467
chr11	67408273	67608273	harbor2	chr11	67502927	67503372	LINE/L2	1040	-	222	67503149	94876
chr11	74188388	74388388	harbor2	chr11	74208351	74208481	LINE/L2	437	-	65	74208416	20028
chr11	74188388	74388388	harbor2	chr11	74233894	74235105	LINE/L2	2830	-	606	74234500	46112
chr11	74188388	74388388	harbor2	chr11	74277968	74278274	LINE/L2	423	-	153	74278121	89733
chr11	57399755	57599755	harbor2	chr11	57429208	57429330	LINE/L2	406	-	61	57429269	29514
chr11	57399755	57599755	harbor2	chr11	57444938	57445218	LINE/L2	831	-	140	57445078	45323
chr11	57399755	57599755	harbor2	chr11	57445529	57445553	LINE/L2	831	-	12	57445541	45786
chr11	57399755	57599755	harbor2	chr11	57469173	57469325	LINE/L2	401	-	76	57469249	69494
chr11	57399755	57599755	harbor2	chr11	57471708	57471847	LINE/L2	499	-	70	57471778	72023
chr11	57399755	57599755	harbor2	chr11	57487520	57488381	LINE/L2	1345	-	430	57487950	88195
chr11	65525168	65725168	harbor2	chr11	65528810	65528951	LINE/L2	448	-	70	65528880	3712
chr11	65525168	65725168	harbor2	chr11	65534429	65534703	LINE/L2	834	-	137	65534566	9398
chr11	65525168	65725168	harbor2	chr11	65549959	65550127	LINE/L2	697	-	84	65550043	24875
chr11	65525168	65725168	harbor2	chr11	65550446	65550531	LINE/L2	697	-	42	65550488	25320
chr11	65525168	65725168	harbor2	chr11	65560453	65560976	LINE/L2	516	-	262	65560715	35547
chr11	6519523	6719523	harbor2	chr11	6527195	6527510	LINE/L2	937	-	158	6527353	7830
chr11	6519523	6719523	harbor2	chr11	6537362	6537650	LINE/L2	1228	-	144	6537506	17983
chr11	6519523	6719523	harbor2	chr11	6537944	6538148	LINE/L2	1228	-	102	6538046	18523
chr11	6519523	6719523	harbor2	chr11	6541565	6541886	LINE/L2	619	-	160	6541725	22202
chr11	6519523	6719523	harbor2	chr11	6561705	6562571	LINE/L2	837	-	433	6562138	42615
chr11	6519523	6719523	harbor2	chr11	6568985	6569202	LINE/L2	961	-	108	6569093	49570
chr11	6519523	6719523	harbor2	chr11	6572499	6573356	LINE/L2	1164	-	428	6572927	53404
chr11	6519523	6719523	harbor2	chr11	6596215	6596596	LINE/L2	911	-	190	6596405	76882
chr11	6519523	6719523	harbor2	chr11	6604474	6605505	LINE/L2	1118	-	516	6604990	85467
chr11	6519523	6719523	harbor2	chr11	6612778	6612969	LINE/L2	429	-	96	6612874	93351
chr11	6519523	6719523	harbor2	chr11	6569493	6569987	LINE/L2	961	-	247	6569740	50217
chr11	76580976	76780976	harbor2	chr11	76597104	76597375	LINE/L2	419	-	136	76597240	16264
chr11	118813698	119013698	harbor2	chr11	118838982	118839245	LINE/L2	520	-	132	118839114	25416
chr11	118813698	119013698	harbor2	chr11	118856264	118856522	LINE/L2	461	-	129	118856393	42695
chr11	64996252	65196252	harbor2	chr11	65005077	65005371	LINE/L2	758	-	147	65005224	8972
chr11	64996252	65196252	harbor2	chr11	65005500	65005650	LINE/L2	496	-	75	65005575	9323
chr11	64996252	65196252	harbor2	chr11	65006225	65006241	LINE/L2	496	-	8	65006233	9981
chr11	64996252	65196252	harbor2	chr11	65006537	65006625	LINE/L2	496	-	44	65006581	10329
chr11	64996252	65196252	harbor2	chr11	65015455	65015638	LINE/L2	451	-	92	65015547	19295
chr11	64996252	65196252	harbor2	chr11	65015757	65015923	LINE/L2	451	-	83	65015840	19588
chr11	64996252	65196252	harbor2	chr11	65016220	65016460	LINE/L2	451	-	120	65016340	20088
chr11	64996252	65196252	harbor2	chr11	65016854	65017186	LINE/L2	891	-	166	65017020	20768
chr11	64996252	65196252	harbor2	chr11	65017496	65017581	LINE/L2	891	-	42	65017538	21286
chr11	64996252	65196252	harbor2	chr11	65080725	65081141	LINE/L2	974	-	208	65080933	84681
chr11	66182603	66382603	harbor2	chr11	66195715	66195827	LINE/L2	670	-	56	66195771	13168
chr11	66182603	66382603	harbor2	chr11	66206639	66206854	LINE/L2	606	-	108	66206747	24144
chr11	66182603	66382603	harbor2	chr11	66259140	66260025	LINE/L2	1199	-	442	66259582	76979
chr11	133740735	133940735	harbor2	chr11	133799668	133800426	LINE/L2	995	-	379	133800047	59312
chr11	133740735	133940735	harbor2	chr11	133820210	133820510	LINE/L2	613	-	150	133820360	79625
chr11	5191433	5391433	harbor2	chr11	5277226	5277653	LINE/L2	906	-	214	5277440	86007
chr11	5191433	5391433	harbor2	chr11	5277807	5278123	LINE/L2	1029	-	158	5277965	86532
chr11	117457689	117657689	harbor2	chr11	117483413	117483757	LINE/L2	405	-	172	117483585	25896
chr11	117457689	117657689	harbor2	chr11	117530543	117530688	LINE/L2	402	-	72	117530615	72926
chr11	69540884	69740884	harbor2	chr11	69616764	69616946	LINE/L2	865	-	91	69616855	75971
chr11	69540884	69740884	harbor2	chr11	69617263	69617644	LINE/L2	865	-	190	69617453	76569
chr11	69540884	69740884	harbor2	chr11	69617963	69618458	LINE/L2	1170	-	248	69618211	77327
chr11	119646005	119846005	harbor2	chr11	119705251	119705781	LINE/L2	731	-	265	119705516	59511
chr11	119646005	119846005	harbor2	chr11	119710359	119710776	LINE/L2	581	-	208	119710567	64562
chr11	66182673	66382673	harbor2	chr11	66195715	66195827	LINE/L2	670	-	56	66195771	13098
chr11	66182673	66382673	harbor2	chr11	66206639	66206854	LINE/L2	606	-	108	66206747	24074
chr11	66182673	66382673	harbor2	chr11	66259140	66260025	LINE/L2	1199	-	442	66259582	76909
chr11	62571717	62771717	harbor2	chr11	62621150	62621731	LINE/L2	1531	-	290	62621440	49723
chr11	6201662	6401662	harbor2	chr11	6227473	6227949	LINE/L2	676	-	238	6227711	26049
chr11	6201662	6401662	harbor2	chr11	6230744	6231463	LINE/L2	448	-	360	6231104	29442
chr11	6201662	6401662	harbor2	chr11	6261138	6261384	LINE/L2	459	-	123	6261261	59599
chr11	6201662	6401662	harbor2	chr11	6261780	6262686	LINE/L2	1305	-	453	6262233	60571
chr11	6201662	6401662	harbor2	chr11	6262726	6262980	LINE/L2	1305	-	127	6262853	61191
chr11	6201662	6401662	harbor2	chr11	6265979	6266189	LINE/L2	519	-	105	6266084	64422
chr11	6201662	6401662	harbor2	chr11	6281337	6281492	LINE/L2	409	-	78	6281415	79753
chr11	6201662	6401662	harbor2	chr11	6281792	6281804	LINE/L2	409	-	6	6281798	80136
chr11	76599762	76799762	harbor2	chr11	76688114	76688493	LINE/L2	596	-	190	76688304	88542
chr11	76599762	76799762	harbor2	chr11	76688796	76689635	LINE/L2	596	-	420	76689216	89454
chr11	76599762	76799762	harbor2	chr11	76695671	76696040	LINE/L2	634	-	184	76695855	96093
chr11	62588670	62788670	harbor2	chr11	62621150	62621731	LINE/L2	1531	-	290	62621440	32770
chr11	124700459	124900459	harbor2	chr11	124726572	124726648	LINE/L2	428	-	38	124726610	26151
chr11	76580924	76780924	harbor2	chr11	76597104	76597375	LINE/L2	419	-	136	76597240	16316
chr11	57579843	57779843	harbor2	chr11	57588990	57589192	LINE/L2	693	-	101	57589091	9248
chr11	57579843	57779843	harbor2	chr11	57658403	57658585	LINE/L2	431	-	91	57658494	78651
chr11	57579843	57779843	harbor2	chr11	57662632	57663082	LINE/L2	778	-	225	57662857	83014
chr11	57579843	57779843	harbor2	chr11	57664550	57664901	LINE/L2	533	-	176	57664726	84883
chr12	62967049	63167049	harbor2	chr12	62969481	62970065	LINE/L2	1343	-	292	62969773	2724
chr12	62967049	63167049	harbor2	chr12	62970366	62970515	LINE/L2	984	-	74	62970440	3391
chr12	62967049	63167049	harbor2	chr12	62978489	62979180	LINE/L2	861	-	346	62978835	11786
chr12	62967049	63167049	harbor2	chr12	62979563	62980009	LINE/L2	861	-	223	62979786	12737
chr12	62967049	63167049	harbor2	chr12	62980341	62980946	LINE/L2	861	-	302	62980643	13594
chr12	62967049	63167049	harbor2	chr12	62998225	62999998	LINE/L2	4013	-	886	62999111	32062
chr12	57104810	57304810	harbor2	chr12	57116865	57117293	LINE/L2	602	-	214	57117079	12269
chr12	57104810	57304810	harbor2	chr12	57117606	57117652	LINE/L2	602	-	23	57117629	12819
chr12	57104810	57304810	harbor2	chr12	57157133	57157329	LINE/L2	1017	-	98	57157231	52421
chr12	57104810	57304810	harbor2	chr12	57157640	57158104	LINE/L2	1017	-	232	57157872	53062
chr12	57104810	57304810	harbor2	chr12	57164803	57165142	LINE/L2	857	-	170	57164973	60163
chr12	57104810	57304810	harbor2	chr12	57196363	57196831	LINE/L2	1021	-	234	57196597	91787
chr12	49415274	49615274	harbor2	chr12	49438806	49439719	LINE/L2	1621	-	456	49439262	23988
chr12	49415274	49615274	harbor2	chr12	49456263	49456739	LINE/L2	1224	-	238	49456501	41227
chr12	49267227	49467227	harbor2	chr12	49301789	49302188	LINE/L2	855	-	200	49301989	34762
chr12	49267227	49467227	harbor2	chr12	49327611	49328214	LINE/L2	1393	-	302	49327913	60686
chr12	49267227	49467227	harbor2	chr12	49328522	49328583	LINE/L2	957	-	30	49328552	61325
chr12	109780548	109980548	harbor2	chr12	109820053	109820272	LINE/L2	634	-	110	109820163	39615
chr12	49268103	49468103	harbor2	chr12	49301789	49302188	LINE/L2	855	-	200	49301989	33886
chr12	49268103	49468103	harbor2	chr12	49327611	49328214	LINE/L2	1393	-	302	49327913	59810
chr12	49268103	49468103	harbor2	chr12	49328522	49328583	LINE/L2	957	-	30	49328552	60449
chr12	6863231	7063231	harbor2	chr12	6906763	6907082	LINE/L2	901	-	160	6906923	43692
chr12	6863231	7063231	harbor2	chr12	6947182	6947387	LINE/L2	1087	-	102	6947284	84053
chr12	6863231	7063231	harbor2	chr12	6947693	6947964	LINE/L2	1087	-	136	6947829	84598
chr12	118276406	118476406	harbor2	chr12	118294788	118295056	LINE/L2	715	-	134	118294922	18516
chr12	118276406	118476406	harbor2	chr12	118362098	118362215	LINE/L2	582	-	58	118362156	85750
chr12	118276406	118476406	harbor2	chr12	118362462	118362547	LINE/L2	582	-	42	118362504	86098
chr12	53898513	54098513	harbor2	chr12	53909478	53909757	LINE/L2	986	-	140	53909618	11105
chr12	53898513	54098513	harbor2	chr12	53910075	53910184	LINE/L2	986	-	54	53910129	11616
chr12	53898513	54098513	harbor2	chr12	53911469	53912136	LINE/L2	1175	-	334	53911803	13290
chr12	6864781	7064781	harbor2	chr12	6906763	6907082	LINE/L2	901	-	160	6906923	42142
chr12	6864781	7064781	harbor2	chr12	6947182	6947387	LINE/L2	1087	-	102	6947284	82503
chr12	6864781	7064781	harbor2	chr12	6947693	6947964	LINE/L2	1087	-	136	6947829	83048
chr12	6863232	7063232	harbor2	chr12	6906763	6907082	LINE/L2	901	-	160	6906923	43691
chr12	6863232	7063232	harbor2	chr12	6947182	6947387	LINE/L2	1087	-	102	6947284	84052
chr12	6863232	7063232	harbor2	chr12	6947693	6947964	LINE/L2	1087	-	136	6947829	84597
chr12	53854927	54054927	harbor2	chr12	53909478	53909757	LINE/L2	986	-	140	53909618	54691
chr12	53854927	54054927	harbor2	chr12	53910075	53910184	LINE/L2	986	-	54	53910129	55202
chr12	53854927	54054927	harbor2	chr12	53911469	53912136	LINE/L2	1175	-	334	53911803	56876
chr12	2592290	2792290	harbor2	chr12	2637994	2639029	LINE/L2	1008	-	518	2638512	46222
chr12	2592290	2792290	harbor2	chr12	2689722	2689969	LINE/L2	784	-	124	2689846	97556
chr12	49484425	49684425	harbor2	chr12	49570661	49571332	LINE/L2	1562	-	336	49570997	86572
chr12	2591481	2791481	harbor2	chr12	2637994	2639029	LINE/L2	1008	-	518	2638512	47031
chr12	2591481	2791481	harbor2	chr12	2689722	2689969	LINE/L2	784	-	124	2689846	98365
chr12	49490552	49690552	harbor2	chr12	49570661	49571332	LINE/L2	1562	-	336	49570997	80445
chr12	6862957	7062957	harbor2	chr12	6906763	6907082	LINE/L2	901	-	160	6906923	43966
chr12	6862957	7062957	harbor2	chr12	6947182	6947387	LINE/L2	1087	-	102	6947284	84327
chr12	6862957	7062957	harbor2	chr12	6947693	6947964	LINE/L2	1087	-	136	6947829	84872
chr12	49267993	49467993	harbor2	chr12	49301789	49302188	LINE/L2	855	-	200	49301989	33996
chr12	49267993	49467993	harbor2	chr12	49327611	49328214	LINE/L2	1393	-	302	49327913	59920
chr12	49267993	49467993	harbor2	chr12	49328522	49328583	LINE/L2	957	-	30	49328552	60559
chr12	49268819	49468819	harbor2	chr12	49301789	49302188	LINE/L2	855	-	200	49301989	33170
chr12	49268819	49468819	harbor2	chr12	49327611	49328214	LINE/L2	1393	-	302	49327913	59094
chr12	49268819	49468819	harbor2	chr12	49328522	49328583	LINE/L2	957	-	30	49328552	59733
chr12	51140362	51340362	harbor2	chr12	51150813	51151334	LINE/L2	692	-	260	51151073	10711
chr12	49268101	49468101	harbor2	chr12	49301789	49302188	LINE/L2	855	-	200	49301989	33888
chr12	49268101	49468101	harbor2	chr12	49327611	49328214	LINE/L2	1393	-	302	49327913	59812
chr12	49268101	49468101	harbor2	chr12	49328522	49328583	LINE/L2	957	-	30	49328552	60451
chr12	131686732	131886732	harbor2	chr12	131747687	131747975	LINE/L2	671	-	144	131747831	61099
chr12	131246816	131446816	harbor2	chr12	131296074	131296291	LINE/L2	602	-	108	131296182	49366
chr12	49267230	49467230	harbor2	chr12	49301789	49302188	LINE/L2	855	-	200	49301989	34759
chr12	49267230	49467230	harbor2	chr12	49327611	49328214	LINE/L2	1393	-	302	49327913	60683
chr12	49267230	49467230	harbor2	chr12	49328522	49328583	LINE/L2	957	-	30	49328552	61322
chr12	52767744	52967744	harbor2	chr12	52783970	52784302	LINE/L2	637	-	166	52784136	16392
chr12	6863195	7063195	harbor2	chr12	6906763	6907082	LINE/L2	901	-	160	6906923	43728
chr12	6863195	7063195	harbor2	chr12	6947182	6947387	LINE/L2	1087	-	102	6947284	84089
chr12	6863195	7063195	harbor2	chr12	6947693	6947964	LINE/L2	1087	-	136	6947829	84634
chr12	49267981	49467981	harbor2	chr12	49301789	49302188	LINE/L2	855	-	200	49301989	34008
chr12	49267981	49467981	harbor2	chr12	49327611	49328214	LINE/L2	1393	-	302	49327913	59932
chr12	49267981	49467981	harbor2	chr12	49328522	49328583	LINE/L2	957	-	30	49328552	60571
chr12	49268099	49468099	harbor2	chr12	49301789	49302188	LINE/L2	855	-	200	49301989	33890
chr12	49268099	49468099	harbor2	chr12	49327611	49328214	LINE/L2	1393	-	302	49327913	59814
chr12	49268099	49468099	harbor2	chr12	49328522	49328583	LINE/L2	957	-	30	49328552	60453
chr12	116779945	116979945	harbor2	chr12	116814200	116814605	LINE/L2	1038	-	202	116814402	34457
chr12	116779945	116979945	harbor2	chr12	116826795	116826940	LINE/L2	607	-	72	116826867	46922
chr12	116779945	116979945	harbor2	chr12	116827250	116827458	LINE/L2	607	-	104	116827354	47409
chr12	21402003	21602003	harbor2	chr12	21407145	21407518	LINE/L2	776	-	186	21407331	5328
chr12	21402003	21602003	harbor2	chr12	21407837	21408012	LINE/L2	776	-	88	21407925	5922
chr12	21402003	21602003	harbor2	chr12	21480112	21480506	LINE/L2	768	-	197	21480309	78306
chr12	110181171	110381171	harbor2	chr12	110239974	110240386	LINE/L2	579	-	206	110240180	59009
chr12	110181171	110381171	harbor2	chr12	110240588	110240633	LINE/L2	622	-	22	110240610	59439
chr12	110181171	110381171	harbor2	chr12	110240920	110241226	LINE/L2	622	-	153	110241073	59902
chr12	49267239	49467239	harbor2	chr12	49301789	49302188	LINE/L2	855	-	200	49301989	34750
chr12	49267239	49467239	harbor2	chr12	49327611	49328214	LINE/L2	1393	-	302	49327913	60674
chr12	49267239	49467239	harbor2	chr12	49328522	49328583	LINE/L2	957	-	30	49328552	61313
chr12	57144828	57344828	harbor2	chr12	57157133	57157329	LINE/L2	1017	-	98	57157231	12403
chr12	57144828	57344828	harbor2	chr12	57157640	57158104	LINE/L2	1017	-	232	57157872	13044
chr12	57144828	57344828	harbor2	chr12	57164803	57165142	LINE/L2	857	-	170	57164973	20145
chr12	57144828	57344828	harbor2	chr12	57196363	57196831	LINE/L2	1021	-	234	57196597	51769
chr12	49382161	49582161	harbor2	chr12	49385576	49385827	LINE/L2	3630	-	126	49385702	3541
chr12	49382161	49582161	harbor2	chr12	49386466	49387354	LINE/L2	3630	-	444	49386910	4749
chr12	49382161	49582161	harbor2	chr12	49387663	49387903	LINE/L2	3630	-	120	49387783	5622
chr12	49382161	49582161	harbor2	chr12	49400057	49400864	LINE/L2	1806	-	404	49400461	18300
chr12	49382161	49582161	harbor2	chr12	49402204	49403286	LINE/L2	3242	-	541	49402745	20584
chr12	49382161	49582161	harbor2	chr12	49404005	49404274	LINE/L2	634	-	134	49404139	21978
chr12	49382161	49582161	harbor2	chr12	49404578	49404649	LINE/L2	634	-	36	49404614	22453
chr12	49382161	49582161	harbor2	chr12	49438806	49439719	LINE/L2	1621	-	456	49439262	57101
chr12	49382161	49582161	harbor2	chr12	49456263	49456739	LINE/L2	1224	-	238	49456501	74340
chr12	102856603	103056603	harbor2	chr12	102864013	102864263	LINE/L2	664	-	125	102864138	7535
chr12	102856603	103056603	harbor2	chr12	102895920	102896630	LINE/L2	1070	-	355	102896275	39672
chr12	102856603	103056603	harbor2	chr12	102901824	102902549	LINE/L2	1240	-	362	102902186	45583
chr12	102856603	103056603	harbor2	chr12	102926016	102926490	LINE/L2	576	-	237	102926253	69650
chr12	102856603	103056603	harbor2	chr12	102929370	102929886	LINE/L2	598	-	258	102929628	73025
chr12	49267955	49467955	harbor2	chr12	49301789	49302188	LINE/L2	855	-	200	49301989	34034
chr12	49267955	49467955	harbor2	chr12	49327611	49328214	LINE/L2	1393	-	302	49327913	59958
chr12	49267955	49467955	harbor2	chr12	49328522	49328583	LINE/L2	957	-	30	49328552	60597
chr12	56884786	57084786	harbor2	chr12	56932688	56932883	LINE/L2	792	-	98	56932786	48000
chr12	49268838	49468838	harbor2	chr12	49301789	49302188	LINE/L2	855	-	200	49301989	33151
chr12	49268838	49468838	harbor2	chr12	49327611	49328214	LINE/L2	1393	-	302	49327913	59075
chr12	49268838	49468838	harbor2	chr12	49328522	49328583	LINE/L2	957	-	30	49328552	59714
chr12	57102487	57302487	harbor2	chr12	57116865	57117293	LINE/L2	602	-	214	57117079	14592
chr12	57102487	57302487	harbor2	chr12	57117606	57117652	LINE/L2	602	-	23	57117629	15142
chr12	57102487	57302487	harbor2	chr12	57157133	57157329	LINE/L2	1017	-	98	57157231	54744
chr12	57102487	57302487	harbor2	chr12	57157640	57158104	LINE/L2	1017	-	232	57157872	55385
chr12	57102487	57302487	harbor2	chr12	57164803	57165142	LINE/L2	857	-	170	57164973	62486
chr12	57102487	57302487	harbor2	chr12	57196363	57196831	LINE/L2	1021	-	234	57196597	94110
chr12	121197141	121397141	harbor2	chr12	121272942	121273456	LINE/L2	940	-	257	121273199	76058
chr12	50497735	50697735	harbor2	chr12	50585212	50585838	LINE/L2	805	-	313	50585525	87790
chr12	6363187	6563187	harbor2	chr12	6388925	6389360	LINE/L2	1329	-	218	6389143	25956
chr12	6870704	7070704	harbor2	chr12	6906763	6907082	LINE/L2	901	-	160	6906923	36219
chr12	6870704	7070704	harbor2	chr12	6947182	6947387	LINE/L2	1087	-	102	6947284	76580
chr12	6870704	7070704	harbor2	chr12	6947693	6947964	LINE/L2	1087	-	136	6947829	77125
chr12	49267136	49467136	harbor2	chr12	49301789	49302188	LINE/L2	855	-	200	49301989	34853
chr12	49267136	49467136	harbor2	chr12	49327611	49328214	LINE/L2	1393	-	302	49327913	60777
chr12	49267136	49467136	harbor2	chr12	49328522	49328583	LINE/L2	957	-	30	49328552	61416
chr12	107508160	107708160	harbor2	chr12	107510468	107510632	LINE/L2	826	-	82	107510550	2390
chr12	107508160	107708160	harbor2	chr12	107510943	107511100	LINE/L2	826	-	78	107511021	2861
chr12	107508160	107708160	harbor2	chr12	107562133	107562637	LINE/L2	1358	-	252	107562385	54225
chr12	107508160	107708160	harbor2	chr12	107605197	107606098	LINE/L2	1264	-	450	107605647	97487
chr12	49268155	49468155	harbor2	chr12	49301789	49302188	LINE/L2	855	-	200	49301989	33834
chr12	49268155	49468155	harbor2	chr12	49327611	49328214	LINE/L2	1393	-	302	49327913	59758
chr12	49268155	49468155	harbor2	chr12	49328522	49328583	LINE/L2	957	-	30	49328552	60397
chr12	109618832	109818832	harbor2	chr12	109657100	109657689	LINE/L2	636	-	294	109657394	38562
chr12	109618832	109818832	harbor2	chr12	109708558	109708703	LINE/L2	987	-	72	109708630	89798
chr12	109618832	109818832	harbor2	chr12	109709018	109709338	LINE/L2	987	-	160	109709178	90346
chr12	109618832	109818832	harbor2	chr12	109710736	109711129	LINE/L2	881	-	196	109710932	92100
chr12	122735461	122935461	harbor2	chr12	122763752	122764317	LINE/L2	1108	-	282	122764034	28573
chr12	122735461	122935461	harbor2	chr12	122830655	122831069	LINE/L2	645	-	207	122830862	95401
chr12	6863214	7063214	harbor2	chr12	6906763	6907082	LINE/L2	901	-	160	6906923	43709
chr12	6863214	7063214	harbor2	chr12	6947182	6947387	LINE/L2	1087	-	102	6947284	84070
chr12	6863214	7063214	harbor2	chr12	6947693	6947964	LINE/L2	1087	-	136	6947829	84615
chr12	6864775	7064775	harbor2	chr12	6906763	6907082	LINE/L2	901	-	160	6906923	42148
chr12	6864775	7064775	harbor2	chr12	6947182	6947387	LINE/L2	1087	-	102	6947284	82509
chr12	6864775	7064775	harbor2	chr12	6947693	6947964	LINE/L2	1087	-	136	6947829	83054
chr12	94973026	95173026	harbor2	chr12	95062982	95063562	LINE/L2	906	-	290	95063272	90246
chr12	94973026	95173026	harbor2	chr12	95063690	95063747	LINE/L2	685	-	28	95063718	90692
chr12	94973026	95173026	harbor2	chr12	95064349	95064664	LINE/L2	685	-	158	95064507	91481
chr12	94973026	95173026	harbor2	chr12	94977721	94978467	LINE/L2	904	-	373	94978094	5068
chr12	120614111	120814111	harbor2	chr12	120670838	120671127	LINE/L2	788	-	144	120670982	56871
chr12	120614111	120814111	harbor2	chr12	120671389	120671550	LINE/L2	788	-	80	120671469	57358
chr12	49268224	49468224	harbor2	chr12	49301789	49302188	LINE/L2	855	-	200	49301989	33765
chr12	49268224	49468224	harbor2	chr12	49327611	49328214	LINE/L2	1393	-	302	49327913	59689
chr12	49268224	49468224	harbor2	chr12	49328522	49328583	LINE/L2	957	-	30	49328552	60328
chr12	6863226	7063226	harbor2	chr12	6906763	6907082	LINE/L2	901	-	160	6906923	43697
chr12	6863226	7063226	harbor2	chr12	6947182	6947387	LINE/L2	1087	-	102	6947284	84058
chr12	6863226	7063226	harbor2	chr12	6947693	6947964	LINE/L2	1087	-	136	6947829	84603
chr13	39962056	40162056	harbor2	chr13	40017447	40017916	LINE/L2	520	-	234	40017681	55625
chr13	39962056	40162056	harbor2	chr13	40018328	40019099	LINE/L2	1227	-	386	40018714	56658
chr13	48136920	48336920	harbor2	chr13	48141351	48141691	LINE/L2	772	-	170	48141521	4601
chr13	48136920	48336920	harbor2	chr13	48141984	48142162	LINE/L2	772	-	89	48142073	5153
chr13	48136920	48336920	harbor2	chr13	48177284	48177598	LINE/L2	440	-	157	48177441	40521
chr13	72960669	73160669	harbor2	chr13	72979500	72979641	LINE/L2	551	-	70	72979570	18901
chr13	72960669	73160669	harbor2	chr13	72979944	72980513	LINE/L2	551	-	284	72980228	19559
chr13	72960669	73160669	harbor2	chr13	72980831	72980963	LINE/L2	551	-	66	72980897	20228
chr13	72960669	73160669	harbor2	chr13	72981279	72981587	LINE/L2	551	-	154	72981433	20764
chr13	72960669	73160669	harbor2	chr13	73008508	73008692	LINE/L2	624	-	92	73008600	47931
chr13	29490355	29690355	harbor2	chr13	29561034	29561153	LINE/L2	435	-	60	29561094	70739
chr13	75382379	75582379	harbor2	chr13	75412899	75413111	LINE/L2	461	-	106	75413005	30626
chr13	30104569	30304569	harbor2	chr13	30135849	30136075	LINE/L2	445	-	113	30135962	31393
chr13	30104569	30304569	harbor2	chr13	30187884	30187986	LINE/L2	448	-	51	30187935	83366
chr13	72960985	73160985	harbor2	chr13	72979500	72979641	LINE/L2	551	-	70	72979570	18585
chr13	72960985	73160985	harbor2	chr13	72979944	72980513	LINE/L2	551	-	284	72980228	19243
chr13	72960985	73160985	harbor2	chr13	72980831	72980963	LINE/L2	551	-	66	72980897	19912
chr13	72960985	73160985	harbor2	chr13	72981279	72981587	LINE/L2	551	-	154	72981433	20448
chr13	72960985	73160985	harbor2	chr13	73008508	73008692	LINE/L2	624	-	92	73008600	47615
chr13	71672155	71872155	harbor2	chr13	71674081	71674175	LINE/L2	424	-	47	71674128	1973
chr13	49768516	49968516	harbor2	chr13	49840867	49841114	LINE/L2	568	-	124	49840991	72475
chr13	49768516	49968516	harbor2	chr13	49841861	49842072	LINE/L2	512	-	106	49841967	73451
chr13	49768516	49968516	harbor2	chr13	49842649	49842901	LINE/L2	512	-	126	49842775	74259
chr13	49768516	49968516	harbor2	chr13	49843341	49843734	LINE/L2	863	-	196	49843537	75021
chr13	49768516	49968516	harbor2	chr13	49863439	49864023	LINE/L2	726	-	292	49863731	95215
chr13	21574582	21774582	harbor2	chr13	21658221	21658558	LINE/L2	429	-	168	21658389	83807
chr13	21574582	21774582	harbor2	chr13	21658630	21659275	LINE/L2	1004	-	322	21658952	84370
chr14	52595606	52795606	harbor2	chr14	52640059	52640468	LINE/L2	725	-	204	52640263	44657
chr14	67142039	67342039	harbor2	chr14	67184274	67185093	LINE/L2	669	-	410	67184684	42645
chr14	67142039	67342039	harbor2	chr14	67209137	67209458	LINE/L2	735	-	160	67209297	67258
chr14	67142039	67342039	harbor2	chr14	67233643	67234011	LINE/L2	1209	-	184	67233827	91788
chr14	67142039	67342039	harbor2	chr14	67234232	67234543	LINE/L2	713	-	156	67234388	92349
chr14	67142840	67342840	harbor2	chr14	67184274	67185093	LINE/L2	669	-	410	67184684	41844
chr14	67142840	67342840	harbor2	chr14	67209137	67209458	LINE/L2	735	-	160	67209297	66457
chr14	67142840	67342840	harbor2	chr14	67233643	67234011	LINE/L2	1209	-	184	67233827	90987
chr14	67142840	67342840	harbor2	chr14	67234232	67234543	LINE/L2	713	-	156	67234388	91548
chr14	75886299	76086299	harbor2	chr14	75901803	75902048	LINE/L2	542	-	122	75901925	15626
chr14	75886299	76086299	harbor2	chr14	75946593	75947180	LINE/L2	808	-	294	75946887	60588
chr14	75886299	76086299	harbor2	chr14	75983475	75983657	LINE/L2	830	-	91	75983566	97267
chr14	75886299	76086299	harbor2	chr14	75983953	75984061	LINE/L2	830	-	54	75984007	97708
chr14	67141953	67341953	harbor2	chr14	67184274	67185093	LINE/L2	669	-	410	67184684	42731
chr14	67141953	67341953	harbor2	chr14	67209137	67209458	LINE/L2	735	-	160	67209297	67344
chr14	67141953	67341953	harbor2	chr14	67233643	67234011	LINE/L2	1209	-	184	67233827	91874
chr14	67141953	67341953	harbor2	chr14	67234232	67234543	LINE/L2	713	-	156	67234388	92435
chr14	104093435	104293435	harbor2	chr14	104131780	104132023	LINE/L2	905	-	122	104131902	38467
chr14	104093435	104293435	harbor2	chr14	104132315	104132497	LINE/L2	905	-	91	104132406	38971
chr14	67141295	67341295	harbor2	chr14	67184274	67185093	LINE/L2	669	-	410	67184684	43389
chr14	67141295	67341295	harbor2	chr14	67209137	67209458	LINE/L2	735	-	160	67209297	68002
chr14	67141295	67341295	harbor2	chr14	67233643	67234011	LINE/L2	1209	-	184	67233827	92532
chr14	67141295	67341295	harbor2	chr14	67234232	67234543	LINE/L2	713	-	156	67234388	93093
chr14	75328348	75528348	harbor2	chr14	75329278	75329619	LINE/L2	436	-	170	75329448	1100
chr14	75328348	75528348	harbor2	chr14	75330425	75331046	LINE/L2	754	-	310	75330735	2387
chr14	75328348	75528348	harbor2	chr14	75331031	75331070	LINE/L2	456	-	20	75331051	2703
chr14	75328348	75528348	harbor2	chr14	75331373	75331671	LINE/L2	456	-	149	75331522	3174
chr14	75328348	75528348	harbor2	chr14	75395643	75396079	LINE/L2	630	-	218	75395861	67513
chr14	67141983	67341983	harbor2	chr14	67184274	67185093	LINE/L2	669	-	410	67184684	42701
chr14	67141983	67341983	harbor2	chr14	67209137	67209458	LINE/L2	735	-	160	67209297	67314
chr14	67141983	67341983	harbor2	chr14	67233643	67234011	LINE/L2	1209	-	184	67233827	91844
chr14	67141983	67341983	harbor2	chr14	67234232	67234543	LINE/L2	713	-	156	67234388	92405
chr14	75331153	75531153	harbor2	chr14	75331373	75331671	LINE/L2	456	-	149	75331522	369
chr14	75331153	75531153	harbor2	chr14	75395643	75396079	LINE/L2	630	-	218	75395861	64708
chr14	75330515	75530515	harbor2	chr14	75330425	75331046	LINE/L2	754	-	310	75330735	220
chr14	75330515	75530515	harbor2	chr14	75331031	75331070	LINE/L2	456	-	20	75331051	536
chr14	75330515	75530515	harbor2	chr14	75331373	75331671	LINE/L2	456	-	149	75331522	1007
chr14	75330515	75530515	harbor2	chr14	75395643	75396079	LINE/L2	630	-	218	75395861	65346
chr14	104224547	104424547	harbor2	chr14	104235578	104236254	LINE/L2	840	-	338	104235916	11369
chr14	104093615	104293615	harbor2	chr14	104131780	104132023	LINE/L2	905	-	122	104131902	38287
chr14	104093615	104293615	harbor2	chr14	104132315	104132497	LINE/L2	905	-	91	104132406	38791
chr14	104093669	104293669	harbor2	chr14	104131780	104132023	LINE/L2	905	-	122	104131902	38233
chr14	104093669	104293669	harbor2	chr14	104132315	104132497	LINE/L2	905	-	91	104132406	38737
chr14	75336525	75536525	harbor2	chr14	75395643	75396079	LINE/L2	630	-	218	75395861	59336
chr14	67141303	67341303	harbor2	chr14	67184274	67185093	LINE/L2	669	-	410	67184684	43381
chr14	67141303	67341303	harbor2	chr14	67209137	67209458	LINE/L2	735	-	160	67209297	67994
chr14	67141303	67341303	harbor2	chr14	67233643	67234011	LINE/L2	1209	-	184	67233827	92524
chr14	67141303	67341303	harbor2	chr14	67234232	67234543	LINE/L2	713	-	156	67234388	93085
chr14	67141247	67341247	harbor2	chr14	67184274	67185093	LINE/L2	669	-	410	67184684	43437
chr14	67141247	67341247	harbor2	chr14	67209137	67209458	LINE/L2	735	-	160	67209297	68050
chr14	67141247	67341247	harbor2	chr14	67233643	67234011	LINE/L2	1209	-	184	67233827	92580
chr14	67141247	67341247	harbor2	chr14	67234232	67234543	LINE/L2	713	-	156	67234388	93141
chr14	75914984	76114984	harbor2	chr14	75946593	75947180	LINE/L2	808	-	294	75946887	31903
chr14	75914984	76114984	harbor2	chr14	75983475	75983657	LINE/L2	830	-	91	75983566	68582
chr14	75914984	76114984	harbor2	chr14	75983953	75984061	LINE/L2	830	-	54	75984007	69023
chr14	75914984	76114984	harbor2	chr14	75986882	75987057	LINE/L2	855	-	88	75986970	71986
chr14	75914984	76114984	harbor2	chr14	75990882	75991008	LINE/L2	534	-	63	75990945	75961
chr14	75914984	76114984	harbor2	chr14	75996849	75997202	LINE/L2	713	-	176	75997025	82041
chr14	75914984	76114984	harbor2	chr14	75998285	75998704	LINE/L2	504	-	210	75998495	83511
chr14	75914984	76114984	harbor2	chr14	75999471	75999831	LINE/L2	476	-	180	75999651	84667
chr14	104096116	104296116	harbor2	chr14	104131780	104132023	LINE/L2	905	-	122	104131902	35786
chr14	104096116	104296116	harbor2	chr14	104132315	104132497	LINE/L2	905	-	91	104132406	36290
chr14	81176400	81376400	harbor2	chr14	81235780	81235928	LINE/L2	1261	-	74	81235854	59454
chr14	81176400	81376400	harbor2	chr14	81237578	81237763	LINE/L2	1261	-	92	81237670	61270
chr14	81176400	81376400	harbor2	chr14	81238208	81238651	LINE/L2	1261	-	222	81238430	62030
chr14	102092831	102292831	harbor2	chr14	102105236	102105630	LINE/L2	431	-	197	102105433	12602
chr14	102092831	102292831	harbor2	chr14	102150920	102151037	LINE/L2	530	-	58	102150978	58147
chr14	88927417	89127417	harbor2	chr14	88956422	88956622	LINE/L2	435	-	100	88956522	29105
chr14	88927417	89127417	harbor2	chr14	88960104	88960390	LINE/L2	546	-	143	88960247	32830
chr14	88927417	89127417	harbor2	chr14	88982185	88983267	LINE/L2	556	-	541	88982726	55309
chr14	88927417	89127417	harbor2	chr14	89004988	89005069	LINE/L2	1255	-	40	89005028	77611
chr14	88927417	89127417	harbor2	chr14	89005430	89005773	LINE/L2	1255	-	172	89005602	78185
chr14	76886650	77086650	harbor2	chr14	76962286	76962610	LINE/L2	621	-	162	76962448	75798
chr14	76886650	77086650	harbor2	chr14	76955627	76955901	LINE/L2	721	-	137	76955764	69114
chr14	102039472	102239472	harbor2	chr14	102105236	102105630	LINE/L2	431	-	197	102105433	65961
chr14	103624423	103824423	harbor2	chr14	103634381	103634692	LINE/L2	461	-	156	103634537	10114
chr14	74823265	75023265	harbor2	chr14	74829649	74830318	LINE/L2	831	-	334	74829983	6718
chr14	74823265	75023265	harbor2	chr14	74865228	74865477	LINE/L2	487	-	124	74865352	42087
chr14	74823265	75023265	harbor2	chr14	74866849	74867112	LINE/L2	929	-	132	74866981	43716
chr14	74823265	75023265	harbor2	chr14	74879611	74879936	LINE/L2	441	-	162	74879773	56508
chr14	74823265	75023265	harbor2	chr14	74883818	74884230	LINE/L2	530	-	206	74884024	60759
chr14	23464322	23664322	harbor2	chr14	23508288	23508545	LINE/L2	1109	-	128	23508416	44094
chr14	23464322	23664322	harbor2	chr14	23508858	23509059	LINE/L2	1109	-	100	23508958	44636
chr14	24047673	24247673	harbor2	chr14	24087666	24087794	LINE/L2	522	-	64	24087730	40057
chr14	24047673	24247673	harbor2	chr14	24089629	24090200	LINE/L2	849	-	286	24089915	42242
chr14	67519986	67719986	harbor2	chr14	67584665	67584952	LINE/L2	575	-	144	67584809	64823
chr14	67519986	67719986	harbor2	chr14	67600984	67601417	LINE/L2	478	-	216	67601200	81214
chr14	76994915	77194915	harbor2	chr14	77054587	77054982	LINE/L2	980	-	198	77054785	59870
chr14	104093579	104293579	harbor2	chr14	104131780	104132023	LINE/L2	905	-	122	104131902	38323
chr14	104093579	104293579	harbor2	chr14	104132315	104132497	LINE/L2	905	-	91	104132406	38827
chr14	74842794	75042794	harbor2	chr14	74865228	74865477	LINE/L2	487	-	124	74865352	22558
chr14	74842794	75042794	harbor2	chr14	74866849	74867112	LINE/L2	929	-	132	74866981	24187
chr14	74842794	75042794	harbor2	chr14	74879611	74879936	LINE/L2	441	-	162	74879773	36979
chr14	74842794	75042794	harbor2	chr14	74883818	74884230	LINE/L2	530	-	206	74884024	41230
chr14	94075512	94275512	harbor2	chr14	94097550	94098124	LINE/L2	981	-	287	94097837	22325
chr14	94075512	94275512	harbor2	chr14	94098996	94099472	LINE/L2	548	-	238	94099234	23722
chr14	94075512	94275512	harbor2	chr14	94100044	94100249	LINE/L2	464	-	102	94100146	24634
chr14	94075512	94275512	harbor2	chr14	94163684	94163791	LINE/L2	429	-	54	94163738	88226
chr14	94075512	94275512	harbor2	chr14	94166418	94166627	LINE/L2	1532	-	104	94166522	91010
chr14	94075512	94275512	harbor2	chr14	94166985	94167243	LINE/L2	1532	-	129	94167114	91602
chr14	94075512	94275512	harbor2	chr14	94167501	94167647	LINE/L2	456	-	73	94167574	92062
chr14	104095926	104295926	harbor2	chr14	104131780	104132023	LINE/L2	905	-	122	104131902	35976
chr14	104095926	104295926	harbor2	chr14	104132315	104132497	LINE/L2	905	-	91	104132406	36480
chr14	103422967	103622967	harbor2	chr14	103505281	103505739	LINE/L2	1210	-	229	103505510	82543
chr14	103422967	103622967	harbor2	chr14	103506033	103506213	LINE/L2	1210	-	90	103506123	83156
chr14	24048856	24248856	harbor2	chr14	24087666	24087794	LINE/L2	522	-	64	24087730	38874
chr14	24048856	24248856	harbor2	chr14	24089629	24090200	LINE/L2	849	-	286	24089915	41059
chr14	75328337	75528337	harbor2	chr14	75329278	75329619	LINE/L2	436	-	170	75329448	1111
chr14	75328337	75528337	harbor2	chr14	75330425	75331046	LINE/L2	754	-	310	75330735	2398
chr14	75328337	75528337	harbor2	chr14	75331031	75331070	LINE/L2	456	-	20	75331051	2714
chr14	75328337	75528337	harbor2	chr14	75331373	75331671	LINE/L2	456	-	149	75331522	3185
chr14	75328337	75528337	harbor2	chr14	75395643	75396079	LINE/L2	630	-	218	75395861	67524
chr14	76998329	77198329	harbor2	chr14	77054587	77054982	LINE/L2	980	-	198	77054785	56456
chr14	21337322	21537322	harbor2	chr14	21339767	21340165	LINE/L2	634	-	199	21339966	2644
chr14	76939921	77139921	harbor2	chr14	76962286	76962610	LINE/L2	621	-	162	76962448	22527
chr14	76939921	77139921	harbor2	chr14	76993966	76994059	LINE/L2	633	-	46	76994012	54091
chr14	76939921	77139921	harbor2	chr14	76994361	76994460	LINE/L2	633	-	50	76994411	54490
chr14	76939921	77139921	harbor2	chr14	76955627	76955901	LINE/L2	721	-	137	76955764	15843
chr14	76942497	77142497	harbor2	chr14	76962286	76962610	LINE/L2	621	-	162	76962448	19951
chr14	76942497	77142497	harbor2	chr14	76993966	76994059	LINE/L2	633	-	46	76994012	51515
chr14	76942497	77142497	harbor2	chr14	76994361	76994460	LINE/L2	633	-	50	76994411	51914
chr14	76942497	77142497	harbor2	chr14	76955627	76955901	LINE/L2	721	-	137	76955764	13267
chr14	51140675	51340675	harbor2	chr14	51141443	51141700	LINE/L2	534	-	128	51141571	896
chr14	51140675	51340675	harbor2	chr14	51227268	51227414	LINE/L2	959	-	73	51227341	86666
chr14	51140675	51340675	harbor2	chr14	51227624	51228030	LINE/L2	959	-	203	51227827	87152
chr14	51140675	51340675	harbor2	chr14	51230600	51231262	LINE/L2	522	-	331	51230931	90256
chr14	51140675	51340675	harbor2	chr14	51237917	51238184	LINE/L2	754	-	134	51238051	97376
chr14	51140675	51340675	harbor2	chr14	51238644	51239172	LINE/L2	754	-	264	51238908	98233
chr14	91481271	91681271	harbor2	chr14	91485040	91485465	LINE/L2	606	-	212	91485252	3981
chr14	76928705	77128705	harbor2	chr14	76962286	76962610	LINE/L2	621	-	162	76962448	33743
chr14	76928705	77128705	harbor2	chr14	76993966	76994059	LINE/L2	633	-	46	76994012	65307
chr14	76928705	77128705	harbor2	chr14	76994361	76994460	LINE/L2	633	-	50	76994411	65706
chr14	76928705	77128705	harbor2	chr14	76955627	76955901	LINE/L2	721	-	137	76955764	27059
chr14	23332799	23532799	harbor2	chr14	23416702	23416794	LINE/L2	571	-	46	23416748	83949
chr14	104092849	104292849	harbor2	chr14	104131780	104132023	LINE/L2	905	-	122	104131902	39053
chr14	104092849	104292849	harbor2	chr14	104132315	104132497	LINE/L2	905	-	91	104132406	39557
chr14	100323696	100523696	harbor2	chr14	100397438	100397839	LINE/L2	599	-	200	100397638	73942
chr14	75915240	76115240	harbor2	chr14	75946593	75947180	LINE/L2	808	-	294	75946887	31647
chr14	75915240	76115240	harbor2	chr14	75983475	75983657	LINE/L2	830	-	91	75983566	68326
chr14	75915240	76115240	harbor2	chr14	75983953	75984061	LINE/L2	830	-	54	75984007	68767
chr14	75915240	76115240	harbor2	chr14	75986882	75987057	LINE/L2	855	-	88	75986970	71730
chr14	75915240	76115240	harbor2	chr14	75990882	75991008	LINE/L2	534	-	63	75990945	75705
chr14	75915240	76115240	harbor2	chr14	75996849	75997202	LINE/L2	713	-	176	75997025	81785
chr14	75915240	76115240	harbor2	chr14	75998285	75998704	LINE/L2	504	-	210	75998495	83255
chr14	75915240	76115240	harbor2	chr14	75999471	75999831	LINE/L2	476	-	180	75999651	84411
chr14	103444240	103644240	harbor2	chr14	103505281	103505739	LINE/L2	1210	-	229	103505510	61270
chr14	103444240	103644240	harbor2	chr14	103506033	103506213	LINE/L2	1210	-	90	103506123	61883
chr14	103444240	103644240	harbor2	chr14	103531122	103531497	LINE/L2	472	-	188	103531310	87070
chr14	99658830	99858830	harbor2	chr14	99751434	99751943	LINE/L2	681	-	254	99751688	92858
chr14	76932189	77132189	harbor2	chr14	76962286	76962610	LINE/L2	621	-	162	76962448	30259
chr14	76932189	77132189	harbor2	chr14	76993966	76994059	LINE/L2	633	-	46	76994012	61823
chr14	76932189	77132189	harbor2	chr14	76994361	76994460	LINE/L2	633	-	50	76994411	62222
chr14	76932189	77132189	harbor2	chr14	76955627	76955901	LINE/L2	721	-	137	76955764	23575
chr14	76959696	77159696	harbor2	chr14	76962286	76962610	LINE/L2	621	-	162	76962448	2752
chr14	76959696	77159696	harbor2	chr14	76993966	76994059	LINE/L2	633	-	46	76994012	34316
chr14	76959696	77159696	harbor2	chr14	76994361	76994460	LINE/L2	633	-	50	76994411	34715
chr14	76959696	77159696	harbor2	chr14	77054587	77054982	LINE/L2	980	-	198	77054785	95089
chr14	75329786	75529786	harbor2	chr14	75330425	75331046	LINE/L2	754	-	310	75330735	949
chr14	75329786	75529786	harbor2	chr14	75331031	75331070	LINE/L2	456	-	20	75331051	1265
chr14	75329786	75529786	harbor2	chr14	75331373	75331671	LINE/L2	456	-	149	75331522	1736
chr14	75329786	75529786	harbor2	chr14	75395643	75396079	LINE/L2	630	-	218	75395861	66075
chr14	104093250	104293250	harbor2	chr14	104131780	104132023	LINE/L2	905	-	122	104131902	38652
chr14	104093250	104293250	harbor2	chr14	104132315	104132497	LINE/L2	905	-	91	104132406	39156
chr14	102111829	102311829	harbor2	chr14	102150920	102151037	LINE/L2	530	-	58	102150978	39149
chr14	102111829	102311829	harbor2	chr14	102197429	102197880	LINE/L2	435	-	226	102197655	85826
chr14	102111829	102311829	harbor2	chr14	102198819	102199081	LINE/L2	442	-	131	102198950	87121
chr14	104102900	104302900	harbor2	chr14	104131780	104132023	LINE/L2	905	-	122	104131902	29002
chr14	104102900	104302900	harbor2	chr14	104132315	104132497	LINE/L2	905	-	91	104132406	29506
chr14	54686838	54886838	harbor2	chr14	54693739	54694619	LINE/L2	1714	-	440	54694179	7341
chr14	54686838	54886838	harbor2	chr14	54707432	54708790	LINE/L2	2915	-	679	54708111	21273
chr14	54686838	54886838	harbor2	chr14	54741713	54742401	LINE/L2	442	-	344	54742057	55219
chr14	54686838	54886838	harbor2	chr14	54783850	54784304	LINE/L2	491	-	227	54784077	97239
chr14	24048951	24248951	harbor2	chr14	24087666	24087794	LINE/L2	522	-	64	24087730	38779
chr14	24048951	24248951	harbor2	chr14	24089629	24090200	LINE/L2	849	-	286	24089915	40964
chr14	103423404	103623404	harbor2	chr14	103505281	103505739	LINE/L2	1210	-	229	103505510	82106
chr14	103423404	103623404	harbor2	chr14	103506033	103506213	LINE/L2	1210	-	90	103506123	82719
chr14	24047661	24247661	harbor2	chr14	24087666	24087794	LINE/L2	522	-	64	24087730	40069
chr14	24047661	24247661	harbor2	chr14	24089629	24090200	LINE/L2	849	-	286	24089915	42254
chr14	21337315	21537315	harbor2	chr14	21339767	21340165	LINE/L2	634	-	199	21339966	2651
chr14	103427586	103627586	harbor2	chr14	103505281	103505739	LINE/L2	1210	-	229	103505510	77924
chr14	103427586	103627586	harbor2	chr14	103506033	103506213	LINE/L2	1210	-	90	103506123	78537
chr14	102409678	102609678	harbor2	chr14	102417986	102418228	LINE/L2	450	-	121	102418107	8429
chr14	24048169	24248169	harbor2	chr14	24087666	24087794	LINE/L2	522	-	64	24087730	39561
chr14	24048169	24248169	harbor2	chr14	24089629	24090200	LINE/L2	849	-	286	24089915	41746
chr14	21337330	21537330	harbor2	chr14	21339767	21340165	LINE/L2	634	-	199	21339966	2636
chr14	104119074	104319074	harbor2	chr14	104131780	104132023	LINE/L2	905	-	122	104131902	12828
chr14	104119074	104319074	harbor2	chr14	104132315	104132497	LINE/L2	905	-	91	104132406	13332
chr14	91474914	91674914	harbor2	chr14	91485040	91485465	LINE/L2	606	-	212	91485252	10338
chr14	100581532	100781532	harbor2	chr14	100612418	100612566	LINE/L2	676	-	74	100612492	30960
chr14	100581532	100781532	harbor2	chr14	100612876	100612915	LINE/L2	511	-	20	100612896	31364
chr14	100581532	100781532	harbor2	chr14	100671794	100672143	LINE/L2	601	-	174	100671968	90436
chr14	75330552	75530552	harbor2	chr14	75330425	75331046	LINE/L2	754	-	310	75330735	183
chr14	75330552	75530552	harbor2	chr14	75331031	75331070	LINE/L2	456	-	20	75331051	499
chr14	75330552	75530552	harbor2	chr14	75331373	75331671	LINE/L2	456	-	149	75331522	970
chr14	75330552	75530552	harbor2	chr14	75395643	75396079	LINE/L2	630	-	218	75395861	65309
chr14	103428564	103628564	harbor2	chr14	103505281	103505739	LINE/L2	1210	-	229	103505510	76946
chr14	103428564	103628564	harbor2	chr14	103506033	103506213	LINE/L2	1210	-	90	103506123	77559
chr14	67500239	67700239	harbor2	chr14	67584665	67584952	LINE/L2	575	-	144	67584809	84570
chr14	104017092	104217092	harbor2	chr14	104039414	104039652	LINE/L2	482	-	119	104039533	22441
chr14	104017092	104217092	harbor2	chr14	104054659	104054907	LINE/L2	525	-	124	104054783	37691
chr14	76928673	77128673	harbor2	chr14	76962286	76962610	LINE/L2	621	-	162	76962448	33775
chr14	76928673	77128673	harbor2	chr14	76993966	76994059	LINE/L2	633	-	46	76994012	65339
chr14	76928673	77128673	harbor2	chr14	76994361	76994460	LINE/L2	633	-	50	76994411	65738
chr14	76928673	77128673	harbor2	chr14	76955627	76955901	LINE/L2	721	-	137	76955764	27091
chr14	101443002	101643002	harbor2	chr14	101483154	101483383	LINE/L2	447	-	114	101483268	40266
chr14	101443002	101643002	harbor2	chr14	101489634	101489869	LINE/L2	500	-	118	101489752	46750
chr14	101443002	101643002	harbor2	chr14	101490287	101490929	LINE/L2	689	-	321	101490608	47606
chr14	101443002	101643002	harbor2	chr14	101503936	101504637	LINE/L2	631	-	350	101504286	61284
chr15	29170198	29370198	harbor2	chr15	29230510	29231024	LINE/L2	900	-	257	29230767	60569
chr15	67422011	67622011	harbor2	chr15	67430726	67430852	LINE/L2	480	-	63	67430789	8778
chr15	67422011	67622011	harbor2	chr15	67491842	67491983	LINE/L2	479	-	70	67491912	69901
chr15	67422011	67622011	harbor2	chr15	67513860	67513996	LINE/L2	649	-	68	67513928	91917
chr15	74947206	75147206	harbor2	chr15	74978515	74978649	LINE/L2	450	-	67	74978582	31376
chr15	74947206	75147206	harbor2	chr15	75014262	75014814	LINE/L2	448	-	276	75014538	67332
chr15	67421689	67621689	harbor2	chr15	67430726	67430852	LINE/L2	480	-	63	67430789	9100
chr15	67421689	67621689	harbor2	chr15	67491842	67491983	LINE/L2	479	-	70	67491912	70223
chr15	67421689	67621689	harbor2	chr15	67513860	67513996	LINE/L2	649	-	68	67513928	92239
chr15	35496867	35696867	harbor2	chr15	35546809	35547535	LINE/L2	928	-	363	35547172	50305
chr15	101861517	102061517	harbor2	chr15	101864618	101864884	LINE/L2	579	-	133	101864751	3234
chr15	101861517	102061517	harbor2	chr15	101935151	101936041	LINE/L2	581	-	445	101935596	74079
chr15	101861517	102061517	harbor2	chr15	101936174	101936480	LINE/L2	536	-	153	101936327	74810
chr15	101861517	102061517	harbor2	chr15	101950336	101950658	LINE/L2	753	-	161	101950497	88980
chr15	101861517	102061517	harbor2	chr15	101952735	101952907	LINE/L2	586	-	86	101952821	91304
chr15	35457632	35657632	harbor2	chr15	35546809	35547535	LINE/L2	928	-	363	35547172	89540
chr15	45030353	45230353	harbor2	chr15	45123055	45123163	LINE/L2	437	-	54	45123109	92756
chr15	35449060	35649060	harbor2	chr15	35546809	35547535	LINE/L2	928	-	363	35547172	98112
chr15	36839296	37039296	harbor2	chr15	36870476	36871493	LINE/L2	792	-	508	36870984	31688
chr15	67441395	67641395	harbor2	chr15	67491842	67491983	LINE/L2	479	-	70	67491912	50517
chr15	67441395	67641395	harbor2	chr15	67513860	67513996	LINE/L2	649	-	68	67513928	72533
chr15	67441395	67641395	harbor2	chr15	67537280	67537416	LINE/L2	1194	-	68	67537348	95953
chr15	67441395	67641395	harbor2	chr15	67537723	67538288	LINE/L2	1194	-	282	67538005	96610
chr15	35449368	35649368	harbor2	chr15	35546809	35547535	LINE/L2	928	-	363	35547172	97804
chr15	25339046	25539046	harbor2	chr15	25395174	25395745	LINE/L2	1161	-	286	25395460	56414
chr15	101861533	102061533	harbor2	chr15	101864618	101864884	LINE/L2	579	-	133	101864751	3218
chr15	101861533	102061533	harbor2	chr15	101935151	101936041	LINE/L2	581	-	445	101935596	74063
chr15	101861533	102061533	harbor2	chr15	101936174	101936480	LINE/L2	536	-	153	101936327	74794
chr15	101861533	102061533	harbor2	chr15	101950336	101950658	LINE/L2	753	-	161	101950497	88964
chr15	101861533	102061533	harbor2	chr15	101952735	101952907	LINE/L2	586	-	86	101952821	91288
chr15	45378429	45578429	harbor2	chr15	45413957	45414456	LINE/L2	593	-	250	45414207	35778
chr15	45378429	45578429	harbor2	chr15	45418740	45419165	LINE/L2	628	-	212	45418952	40523
chr15	45378429	45578429	harbor2	chr15	45419478	45419501	LINE/L2	628	-	12	45419490	41061
chr15	67422183	67622183	harbor2	chr15	67430726	67430852	LINE/L2	480	-	63	67430789	8606
chr15	67422183	67622183	harbor2	chr15	67491842	67491983	LINE/L2	479	-	70	67491912	69729
chr15	67422183	67622183	harbor2	chr15	67513860	67513996	LINE/L2	649	-	68	67513928	91745
chr15	36495947	36695947	harbor2	chr15	36518555	36519090	LINE/L2	649	-	268	36518823	22876
chr15	36495947	36695947	harbor2	chr15	36519371	36519634	LINE/L2	649	-	132	36519503	23556
chr15	36495947	36695947	harbor2	chr15	36541875	36542642	LINE/L2	813	-	384	36542259	46312
chr15	25339082	25539082	harbor2	chr15	25395174	25395745	LINE/L2	1161	-	286	25395460	56378
chr15	35467871	35667871	harbor2	chr15	35546809	35547535	LINE/L2	928	-	363	35547172	79301
chr15	32618800	32818800	harbor2	chr15	32622837	32623263	LINE/L2	882	-	213	32623050	4250
chr15	32618800	32818800	harbor2	chr15	32645379	32645660	LINE/L2	444	-	140	32645519	26719
chr15	32618800	32818800	harbor2	chr15	32651708	32652567	LINE/L2	507	-	430	32652138	33338
chr15	67422192	67622192	harbor2	chr15	67430726	67430852	LINE/L2	480	-	63	67430789	8597
chr15	67422192	67622192	harbor2	chr15	67491842	67491983	LINE/L2	479	-	70	67491912	69720
chr15	67422192	67622192	harbor2	chr15	67513860	67513996	LINE/L2	649	-	68	67513928	91736
chr15	36491544	36691544	harbor2	chr15	36518555	36519090	LINE/L2	649	-	268	36518823	27279
chr15	36491544	36691544	harbor2	chr15	36519371	36519634	LINE/L2	649	-	132	36519503	27959
chr15	36491544	36691544	harbor2	chr15	36541875	36542642	LINE/L2	813	-	384	36542259	50715
chr15	79333661	79533661	harbor2	chr15	79342741	79343178	LINE/L2	857	-	218	79342959	9298
chr15	79333661	79533661	harbor2	chr15	79343593	79344265	LINE/L2	1355	-	336	79343929	10268
chr15	79333661	79533661	harbor2	chr15	79344712	79345010	LINE/L2	585	-	149	79344861	11200
chr15	79333661	79533661	harbor2	chr15	79356420	79356697	LINE/L2	547	-	138	79356558	22897
chr15	67422567	67622567	harbor2	chr15	67430726	67430852	LINE/L2	480	-	63	67430789	8222
chr15	67422567	67622567	harbor2	chr15	67491842	67491983	LINE/L2	479	-	70	67491912	69345
chr15	67422567	67622567	harbor2	chr15	67513860	67513996	LINE/L2	649	-	68	67513928	91361
chr15	36685156	36885156	harbor2	chr15	36744455	36744632	LINE/L2	531	-	88	36744543	59387
chr15	36685156	36885156	harbor2	chr15	36781808	36781929	LINE/L2	436	-	60	36781868	96712
chr15	100818161	101018161	harbor2	chr15	100869822	100870110	LINE/L2	491	-	144	100869966	51805
chr15	100818161	101018161	harbor2	chr15	100911517	100911639	LINE/L2	485	-	61	100911578	93417
chr15	67441016	67641016	harbor2	chr15	67491842	67491983	LINE/L2	479	-	70	67491912	50896
chr15	67441016	67641016	harbor2	chr15	67513860	67513996	LINE/L2	649	-	68	67513928	72912
chr15	67441016	67641016	harbor2	chr15	67537280	67537416	LINE/L2	1194	-	68	67537348	96332
chr15	67441016	67641016	harbor2	chr15	67537723	67538288	LINE/L2	1194	-	282	67538005	96989
chr15	101862196	102062196	harbor2	chr15	101864618	101864884	LINE/L2	579	-	133	101864751	2555
chr15	101862196	102062196	harbor2	chr15	101935151	101936041	LINE/L2	581	-	445	101935596	73400
chr15	101862196	102062196	harbor2	chr15	101936174	101936480	LINE/L2	536	-	153	101936327	74131
chr15	101862196	102062196	harbor2	chr15	101950336	101950658	LINE/L2	753	-	161	101950497	88301
chr15	101862196	102062196	harbor2	chr15	101952735	101952907	LINE/L2	586	-	86	101952821	90625
chr15	34109976	34309976	harbor2	chr15	34147519	34147827	LINE/L2	718	-	154	34147673	37697
chr15	34109976	34309976	harbor2	chr15	34205742	34205859	LINE/L2	460	-	58	34205800	95824
chr15	36787076	36987076	harbor2	chr15	36829720	36830122	LINE/L2	896	-	201	36829921	42845
chr15	36787076	36987076	harbor2	chr15	36837349	36837832	LINE/L2	610	-	242	36837591	50515
chr15	36787076	36987076	harbor2	chr15	36870476	36871493	LINE/L2	792	-	508	36870984	83908
chr15	29945312	30145312	harbor2	chr15	29966601	29966834	LINE/L2	711	-	116	29966717	21405
chr15	35537214	35737214	harbor2	chr15	35546809	35547535	LINE/L2	928	-	363	35547172	9958
chr15	35537214	35737214	harbor2	chr15	35627797	35628377	LINE/L2	1210	-	290	35628087	90873
chr15	101624468	101824468	harbor2	chr15	101713253	101713791	LINE/L2	756	-	269	101713522	89054
chr15	101876518	102076518	harbor2	chr15	101935151	101936041	LINE/L2	581	-	445	101935596	59078
chr15	101876518	102076518	harbor2	chr15	101936174	101936480	LINE/L2	536	-	153	101936327	59809
chr15	101876518	102076518	harbor2	chr15	101950336	101950658	LINE/L2	753	-	161	101950497	73979
chr15	101876518	102076518	harbor2	chr15	101952735	101952907	LINE/L2	586	-	86	101952821	76303
chr15	101875496	102075496	harbor2	chr15	101935151	101936041	LINE/L2	581	-	445	101935596	60100
chr15	101875496	102075496	harbor2	chr15	101936174	101936480	LINE/L2	536	-	153	101936327	60831
chr15	101875496	102075496	harbor2	chr15	101950336	101950658	LINE/L2	753	-	161	101950497	75001
chr15	101875496	102075496	harbor2	chr15	101952735	101952907	LINE/L2	586	-	86	101952821	77325
chr15	74743181	74943181	harbor2	chr15	74824674	74825013	LINE/L2	450	-	170	74824844	81663
chr15	67424695	67624695	harbor2	chr15	67430726	67430852	LINE/L2	480	-	63	67430789	6094
chr15	67424695	67624695	harbor2	chr15	67491842	67491983	LINE/L2	479	-	70	67491912	67217
chr15	67424695	67624695	harbor2	chr15	67513860	67513996	LINE/L2	649	-	68	67513928	89233
chr15	74947209	75147209	harbor2	chr15	74978515	74978649	LINE/L2	450	-	67	74978582	31373
chr15	74947209	75147209	harbor2	chr15	75014262	75014814	LINE/L2	448	-	276	75014538	67329
chr15	25339076	25539076	harbor2	chr15	25395174	25395745	LINE/L2	1161	-	286	25395460	56384
chr15	35569538	35769538	harbor2	chr15	35627797	35628377	LINE/L2	1210	-	290	35628087	58549
chr15	35569538	35769538	harbor2	chr15	35650231	35650641	LINE/L2	518	-	205	35650436	80898
chr15	96462468	96662468	harbor2	chr15	96496880	96497543	LINE/L2	527	-	332	96497212	34744
chr15	38233430	38433430	harbor2	chr15	38285191	38285748	LINE/L2	837	-	278	38285469	52039
chr15	38233430	38433430	harbor2	chr15	38305387	38305691	LINE/L2	801	-	152	38305539	72109
chr15	50808701	51008701	harbor2	chr15	50895823	50895950	LINE/L2	431	-	64	50895887	87186
chr15	101861525	102061525	harbor2	chr15	101864618	101864884	LINE/L2	579	-	133	101864751	3226
chr15	101861525	102061525	harbor2	chr15	101935151	101936041	LINE/L2	581	-	445	101935596	74071
chr15	101861525	102061525	harbor2	chr15	101936174	101936480	LINE/L2	536	-	153	101936327	74802
chr15	101861525	102061525	harbor2	chr15	101950336	101950658	LINE/L2	753	-	161	101950497	88972
chr15	101861525	102061525	harbor2	chr15	101952735	101952907	LINE/L2	586	-	86	101952821	91296
chr15	67422133	67622133	harbor2	chr15	67430726	67430852	LINE/L2	480	-	63	67430789	8656
chr15	67422133	67622133	harbor2	chr15	67491842	67491983	LINE/L2	479	-	70	67491912	69779
chr15	67422133	67622133	harbor2	chr15	67513860	67513996	LINE/L2	649	-	68	67513928	91795
chr15	69999345	70199345	harbor2	chr15	70043716	70044000	LINE/L2	429	-	142	70043858	44513
chr15	74743183	74943183	harbor2	chr15	74824674	74825013	LINE/L2	450	-	170	74824844	81661
chr15	68720982	68920982	harbor2	chr15	68800252	68800464	LINE/L2	928	-	106	68800358	79376
chr15	68720982	68920982	harbor2	chr15	68800772	68801031	LINE/L2	928	-	130	68800902	79920
chr15	101862010	102062010	harbor2	chr15	101864618	101864884	LINE/L2	579	-	133	101864751	2741
chr15	101862010	102062010	harbor2	chr15	101935151	101936041	LINE/L2	581	-	445	101935596	73586
chr15	101862010	102062010	harbor2	chr15	101936174	101936480	LINE/L2	536	-	153	101936327	74317
chr15	101862010	102062010	harbor2	chr15	101950336	101950658	LINE/L2	753	-	161	101950497	88487
chr15	101862010	102062010	harbor2	chr15	101952735	101952907	LINE/L2	586	-	86	101952821	90811
chr15	25339116	25539116	harbor2	chr15	25395174	25395745	LINE/L2	1161	-	286	25395460	56344
chr15	41521437	41721437	harbor2	chr15	41566956	41567212	LINE/L2	453	-	128	41567084	45647
chr15	41521437	41721437	harbor2	chr15	41567761	41568003	LINE/L2	531	-	121	41567882	46445
chr15	41521437	41721437	harbor2	chr15	41610098	41610310	LINE/L2	588	-	106	41610204	88767
chr15	20980576	21180576	harbor2	chr15	20981102	20981294	LINE/L2	1193	-	96	20981198	622
chr15	41417768	41617768	harbor2	chr15	41425701	41425991	LINE/L2	519	-	145	41425846	8078
chr15	39197828	39397828	harbor2	chr15	39250868	39250975	LINE/L2	536	-	54	39250922	53094
chr15	29169893	29369893	harbor2	chr15	29230510	29231024	LINE/L2	900	-	257	29230767	60874
chr15	35569564	35769564	harbor2	chr15	35627797	35628377	LINE/L2	1210	-	290	35628087	58523
chr15	35569564	35769564	harbor2	chr15	35650231	35650641	LINE/L2	518	-	205	35650436	80872
chr15	63405661	63605661	harbor2	chr15	63500787	63500968	LINE/L2	429	-	90	63500877	95216
chr15	21245089	21445089	harbor2	chr15	21245252	21245623	LINE/L2	673	-	186	21245438	349
chr15	21245089	21445089	harbor2	chr15	21245720	21246445	LINE/L2	849	-	362	21246082	993
chr15	48389932	48589932	harbor2	chr15	48390857	48391128	LINE/L2	529	-	136	48390993	1061
chr15	67428161	67628161	harbor2	chr15	67430726	67430852	LINE/L2	480	-	63	67430789	2628
chr15	67428161	67628161	harbor2	chr15	67491842	67491983	LINE/L2	479	-	70	67491912	63751
chr15	67428161	67628161	harbor2	chr15	67513860	67513996	LINE/L2	649	-	68	67513928	85767
chr15	34238104	34438104	harbor2	chr15	34248672	34249027	LINE/L2	436	-	178	34248850	10746
chr15	34238104	34438104	harbor2	chr15	34265239	34265548	LINE/L2	490	-	154	34265393	27289
chr15	34238104	34438104	harbor2	chr15	34265745	34265919	LINE/L2	490	-	87	34265832	27728
chr15	34238104	34438104	harbor2	chr15	34282913	34283061	LINE/L2	643	-	74	34282987	44883
chr15	34238104	34438104	harbor2	chr15	34283371	34283756	LINE/L2	643	-	192	34283563	45459
chr15	34238104	34438104	harbor2	chr15	34284048	34284231	LINE/L2	612	-	92	34284140	46036
chr15	34238104	34438104	harbor2	chr15	34284601	34285464	LINE/L2	1170	-	432	34285033	46929
chr15	34238104	34438104	harbor2	chr15	34299370	34300017	LINE/L2	651	-	324	34299694	61590
chr15	34238104	34438104	harbor2	chr15	34305476	34305664	LINE/L2	536	-	94	34305570	67466
chr15	34238104	34438104	harbor2	chr15	34325755	34325853	LINE/L2	417	-	49	34325804	87700
chr15	69199269	69399269	harbor2	chr15	69201360	69201507	LINE/L2	438	-	74	69201434	2165
chr15	69199269	69399269	harbor2	chr15	69248590	69248654	LINE/L2	1516	-	32	69248622	49353
chr15	69199269	69399269	harbor2	chr15	69248893	69249245	LINE/L2	1516	-	176	69249069	49800
chr15	69199269	69399269	harbor2	chr15	69254393	69255162	LINE/L2	2658	-	384	69254777	55508
chr15	69999529	70199529	harbor2	chr15	70043716	70044000	LINE/L2	429	-	142	70043858	44329
chr15	35616949	35816949	harbor2	chr15	35627797	35628377	LINE/L2	1210	-	290	35628087	11138
chr15	35616949	35816949	harbor2	chr15	35650231	35650641	LINE/L2	518	-	205	35650436	33487
chr15	36837616	37037616	harbor2	chr15	36837349	36837832	LINE/L2	610	-	242	36837591	25
chr15	36837616	37037616	harbor2	chr15	36870476	36871493	LINE/L2	792	-	508	36870984	33368
chr15	100177694	100377694	harbor2	chr15	100233697	100234206	LINE/L2	573	-	254	100233951	56257
chr15	79823750	80023750	harbor2	chr15	79843694	79844440	LINE/L2	675	-	373	79844067	20317
chr15	79823750	80023750	harbor2	chr15	79902118	79902896	LINE/L2	1114	-	389	79902507	78757
chr15	79823750	80023750	harbor2	chr15	79888157	79888798	LINE/L2	1115	-	320	79888477	64727
chr15	45302521	45502521	harbor2	chr15	45307657	45307842	LINE/L2	423	-	92	45307749	5228
chr15	45302521	45502521	harbor2	chr15	45307870	45307900	LINE/L2	423	-	15	45307885	5364
chr15	45302521	45502521	harbor2	chr15	45307963	45308271	LINE/L2	775	-	154	45308117	5596
chr15	45302521	45502521	harbor2	chr15	45348276	45349245	LINE/L2	3351	-	484	45348760	46239
chr15	45302521	45502521	harbor2	chr15	45349556	45350112	LINE/L2	3351	-	278	45349834	47313
chr15	45302521	45502521	harbor2	chr15	45353071	45353455	LINE/L2	518	-	192	45353263	50742
chr15	56979942	57179942	harbor2	chr15	57057601	57057830	LINE/L2	805	-	114	57057715	77773
chr15	74806668	75006668	harbor2	chr15	74824674	74825013	LINE/L2	450	-	170	74824844	18176
chr15	29169897	29369897	harbor2	chr15	29230510	29231024	LINE/L2	900	-	257	29230767	60870
chr15	71630657	71830657	harbor2	chr15	71679066	71679295	LINE/L2	462	-	114	71679180	48523
chr15	71630657	71830657	harbor2	chr15	71679512	71679622	LINE/L2	462	-	55	71679567	48910
chr15	71630657	71830657	harbor2	chr15	71683344	71683622	LINE/L2	560	-	139	71683483	52826
chr15	71630657	71830657	harbor2	chr15	71724108	71724287	LINE/L2	488	-	90	71724198	93541
chr15	71630657	71830657	harbor2	chr15	71724585	71724925	LINE/L2	488	-	170	71724755	94098
chr15	71630657	71830657	harbor2	chr15	71725149	71725808	LINE/L2	1221	-	330	71725479	94822
chr15	35526392	35726392	harbor2	chr15	35546809	35547535	LINE/L2	928	-	363	35547172	20780
chr15	73800179	74000179	harbor2	chr15	73820706	73821063	LINE/L2	427	-	178	73820884	20705
chr15	21245080	21445080	harbor2	chr15	21245252	21245623	LINE/L2	673	-	186	21245438	358
chr15	21245080	21445080	harbor2	chr15	21245720	21246445	LINE/L2	849	-	362	21246082	1002
chr15	101859001	102059001	harbor2	chr15	101864618	101864884	LINE/L2	579	-	133	101864751	5750
chr15	101859001	102059001	harbor2	chr15	101935151	101936041	LINE/L2	581	-	445	101935596	76595
chr15	101859001	102059001	harbor2	chr15	101936174	101936480	LINE/L2	536	-	153	101936327	77326
chr15	101859001	102059001	harbor2	chr15	101950336	101950658	LINE/L2	753	-	161	101950497	91496
chr15	101859001	102059001	harbor2	chr15	101952735	101952907	LINE/L2	586	-	86	101952821	93820
chr15	101624486	101824486	harbor2	chr15	101713253	101713791	LINE/L2	756	-	269	101713522	89036
chr15	45487658	45687658	harbor2	chr15	45489131	45489568	LINE/L2	1111	-	218	45489349	1691
chr15	73826340	74026340	harbor2	chr15	73917883	73918212	LINE/L2	1038	-	164	73918047	91707
chr15	73826340	74026340	harbor2	chr15	73918256	73918446	LINE/L2	659	-	95	73918351	92011
chr15	77545719	77745719	harbor2	chr15	77565953	77566357	LINE/L2	433	-	202	77566155	20436
chr15	77545719	77745719	harbor2	chr15	77566395	77566737	LINE/L2	445	-	171	77566566	20847
chr15	77545719	77745719	harbor2	chr15	77585704	77586304	LINE/L2	873	-	300	77586004	40285
chr15	49055735	49255735	harbor2	chr15	49064782	49065333	LINE/L2	1076	-	276	49065058	9323
chr15	49055735	49255735	harbor2	chr15	49098997	49099687	LINE/L2	1617	-	345	49099342	43607
chr15	49055735	49255735	harbor2	chr15	49135316	49135597	LINE/L2	486	-	140	49135456	79721
chr15	49055735	49255735	harbor2	chr15	49142809	49143612	LINE/L2	1765	-	402	49143211	87476
chr15	35455037	35655037	harbor2	chr15	35546809	35547535	LINE/L2	928	-	363	35547172	92135
chr16	2375115	2575115	harbor2	chr16	2387093	2387430	LINE/L2	551	-	168	2387261	12146
chr16	2375148	2575148	harbor2	chr16	2387093	2387430	LINE/L2	551	-	168	2387261	12113
chr16	67059907	67259907	harbor2	chr16	67143597	67143806	LINE/L2	746	-	104	67143701	83794
chr16	2375144	2575144	harbor2	chr16	2387093	2387430	LINE/L2	551	-	168	2387261	12117
chr16	66712056	66912056	harbor2	chr16	66803912	66804191	LINE/L2	910	-	140	66804052	91996
chr16	67010338	67210338	harbor2	chr16	67040584	67041120	LINE/L2	1717	-	268	67040852	30514
chr16	67010338	67210338	harbor2	chr16	67041237	67041494	LINE/L2	1717	-	128	67041365	31027
chr16	2375110	2575110	harbor2	chr16	2387093	2387430	LINE/L2	551	-	168	2387261	12151
chr16	67009867	67209867	harbor2	chr16	67040584	67041120	LINE/L2	1717	-	268	67040852	30985
chr16	67009867	67209867	harbor2	chr16	67041237	67041494	LINE/L2	1717	-	128	67041365	31498
chr16	2383491	2583491	harbor2	chr16	2387093	2387430	LINE/L2	551	-	168	2387261	3770
chr16	53038047	53238047	harbor2	chr16	53093468	53093591	LINE/L2	630	-	62	53093530	55483
chr16	53038047	53238047	harbor2	chr16	53107748	53108040	LINE/L2	970	-	146	53107894	69847
chr16	53038047	53238047	harbor2	chr16	53134802	53135655	LINE/L2	1002	-	426	53135228	97181
chr16	4085358	4285358	harbor2	chr16	4098556	4098728	LINE/L2	572	-	86	4098642	13284
chr16	4017125	4217125	harbor2	chr16	4098556	4098728	LINE/L2	572	-	86	4098642	81517
chr16	1	168578	harbor2	chr16	52803	53424	LINE/L2	603	-	310	53113	53112
chr16	1	168578	harbor2	chr16	65263	65590	LINE/L2	619	-	164	65427	65426
chr16	2375124	2575124	harbor2	chr16	2387093	2387430	LINE/L2	551	-	168	2387261	12137
chr16	56535582	56735582	harbor2	chr16	56560313	56560815	LINE/L2	1149	-	251	56560564	24982
chr16	56535582	56735582	harbor2	chr16	56561123	56561313	LINE/L2	697	-	95	56561218	25636
chr16	56535582	56735582	harbor2	chr16	56561330	56561500	LINE/L2	573	-	85	56561415	25833
chr16	56535582	56735582	harbor2	chr16	56586146	56586523	LINE/L2	1175	-	188	56586334	50752
chr16	12196224	12396224	harbor2	chr16	12224318	12224615	LINE/L2	567	-	148	12224466	28242
chr16	12196224	12396224	harbor2	chr16	12253240	12254368	LINE/L2	1817	-	564	12253804	57580
chr16	12196224	12396224	harbor2	chr16	12254658	12254981	LINE/L2	1817	-	162	12254820	58596
chr16	71341038	71541038	harbor2	chr16	71341724	71342147	LINE/L2	924	-	212	71341936	898
chr16	71341038	71541038	harbor2	chr16	71393182	71393519	LINE/L2	734	-	168	71393350	52312
chr16	67110694	67310694	harbor2	chr16	67143597	67143806	LINE/L2	746	-	104	67143701	33007
chr16	1	168358	harbor2	chr16	52803	53424	LINE/L2	603	-	310	53113	53112
chr16	1	168358	harbor2	chr16	65263	65590	LINE/L2	619	-	164	65427	65426
chr16	2375150	2575150	harbor2	chr16	2387093	2387430	LINE/L2	551	-	168	2387261	12111
chr16	1	168450	harbor2	chr16	52803	53424	LINE/L2	603	-	310	53113	53112
chr16	1	168450	harbor2	chr16	65263	65590	LINE/L2	619	-	164	65427	65426
chr16	2371372	2571372	harbor2	chr16	2387093	2387430	LINE/L2	551	-	168	2387261	15889
chr16	2375151	2575151	harbor2	chr16	2387093	2387430	LINE/L2	551	-	168	2387261	12110
chr16	31115740	31315740	harbor2	chr16	31211818	31212282	LINE/L2	1111	-	232	31212050	96310
chr16	31042566	31242566	harbor2	chr16	31053817	31053962	LINE/L2	557	-	72	31053889	11323
chr16	57884872	58084872	harbor2	chr16	57949004	57949128	LINE/L2	640	-	62	57949066	64194
chr16	57884872	58084872	harbor2	chr16	57972011	57972564	LINE/L2	825	-	276	57972287	87415
chr16	85109928	85309928	harbor2	chr16	85205867	85206245	LINE/L2	636	-	189	85206056	96128
chr16	66929017	67129017	harbor2	chr16	66997445	66997689	LINE/L2	999	-	122	66997567	68550
chr16	66929017	67129017	harbor2	chr16	66998000	66998307	LINE/L2	999	-	154	66998154	69137
chr16	66929017	67129017	harbor2	chr16	66998881	66999025	LINE/L2	999	-	72	66998953	69936
chr16	66929017	67129017	harbor2	chr16	67003566	67003883	LINE/L2	862	-	158	67003724	74707
chr16	57885293	58085293	harbor2	chr16	57949004	57949128	LINE/L2	640	-	62	57949066	63773
chr16	57885293	58085293	harbor2	chr16	57972011	57972564	LINE/L2	825	-	276	57972287	86994
chr16	56836588	57036588	harbor2	chr16	56912595	56913060	LINE/L2	693	-	232	56912827	76239
chr16	57884864	58084864	harbor2	chr16	57949004	57949128	LINE/L2	640	-	62	57949066	64202
chr16	57884864	58084864	harbor2	chr16	57972011	57972564	LINE/L2	825	-	276	57972287	87423
chr16	57885269	58085269	harbor2	chr16	57949004	57949128	LINE/L2	640	-	62	57949066	63797
chr16	57885269	58085269	harbor2	chr16	57972011	57972564	LINE/L2	825	-	276	57972287	87018
chr16	47360971	47560971	harbor2	chr16	47391898	47392131	LINE/L2	650	-	116	47392014	31043
chr16	47360971	47560971	harbor2	chr16	47392258	47392530	LINE/L2	650	-	136	47392394	31423
chr16	47360971	47560971	harbor2	chr16	47396561	47397357	LINE/L2	628	-	398	47396959	35988
chr16	47360971	47560971	harbor2	chr16	47400491	47401523	LINE/L2	647	-	516	47401007	40036
chr16	47360971	47560971	harbor2	chr16	47406554	47407356	LINE/L2	1900	-	401	47406955	45984
chr16	47360971	47560971	harbor2	chr16	47407647	47407957	LINE/L2	1900	-	155	47407802	46831
chr16	14268480	14468480	harbor2	chr16	14339813	14340383	LINE/L2	574	-	285	14340098	71618
chr16	1	170311	harbor2	chr16	52803	53424	LINE/L2	603	-	310	53113	53112
chr16	1	170311	harbor2	chr16	65263	65590	LINE/L2	619	-	164	65427	65426
chr16	1	168367	harbor2	chr16	52803	53424	LINE/L2	603	-	310	53113	53112
chr16	1	168367	harbor2	chr16	65263	65590	LINE/L2	619	-	164	65427	65426
chr16	67980152	68180152	harbor2	chr16	68027561	68028224	LINE/L2	564	-	332	68027893	47741
chr16	67980152	68180152	harbor2	chr16	68032280	68032687	LINE/L2	882	-	204	68032484	52332
chr16	67980152	68180152	harbor2	chr16	68032929	68033391	LINE/L2	882	-	231	68033160	53008
chr16	67090427	67290427	harbor2	chr16	67143597	67143806	LINE/L2	746	-	104	67143701	53274
chr16	30435060	30635060	harbor2	chr16	30434776	30435222	LINE/L2	741	-	223	30434999	61
chr16	30435060	30635060	harbor2	chr16	30464968	30465143	LINE/L2	577	-	88	30465056	29996
chr16	30435060	30635060	harbor2	chr16	30465437	30465529	LINE/L2	577	-	46	30465483	30423
chr16	30435060	30635060	harbor2	chr16	30482308	30482627	LINE/L2	1347	-	160	30482468	47408
chr16	30435060	30635060	harbor2	chr16	30520542	30520802	LINE/L2	563	-	130	30520672	85612
chr16	4084908	4284908	harbor2	chr16	4098556	4098728	LINE/L2	572	-	86	4098642	13734
chr16	67010349	67210349	harbor2	chr16	67040584	67041120	LINE/L2	1717	-	268	67040852	30503
chr16	67010349	67210349	harbor2	chr16	67041237	67041494	LINE/L2	1717	-	128	67041365	31016
chr16	56508531	56708531	harbor2	chr16	56520469	56520807	LINE/L2	783	-	169	56520638	12107
chr16	56508531	56708531	harbor2	chr16	56560313	56560815	LINE/L2	1149	-	251	56560564	52033
chr16	56508531	56708531	harbor2	chr16	56561123	56561313	LINE/L2	697	-	95	56561218	52687
chr16	56508531	56708531	harbor2	chr16	56561330	56561500	LINE/L2	573	-	85	56561415	52884
chr16	56508531	56708531	harbor2	chr16	56586146	56586523	LINE/L2	1175	-	188	56586334	77803
chr16	4084077	4284077	harbor2	chr16	4098556	4098728	LINE/L2	572	-	86	4098642	14565
chr16	31042549	31242549	harbor2	chr16	31053817	31053962	LINE/L2	557	-	72	31053889	11340
chr16	57891927	58091927	harbor2	chr16	57949004	57949128	LINE/L2	640	-	62	57949066	57139
chr16	57891927	58091927	harbor2	chr16	57972011	57972564	LINE/L2	825	-	276	57972287	80360
chr16	4085175	4285175	harbor2	chr16	4098556	4098728	LINE/L2	572	-	86	4098642	13467
chr16	56536591	56736591	harbor2	chr16	56560313	56560815	LINE/L2	1149	-	251	56560564	23973
chr16	56536591	56736591	harbor2	chr16	56561123	56561313	LINE/L2	697	-	95	56561218	24627
chr16	56536591	56736591	harbor2	chr16	56561330	56561500	LINE/L2	573	-	85	56561415	24824
chr16	56536591	56736591	harbor2	chr16	56586146	56586523	LINE/L2	1175	-	188	56586334	49743
chr16	57884877	58084877	harbor2	chr16	57949004	57949128	LINE/L2	640	-	62	57949066	64189
chr16	57884877	58084877	harbor2	chr16	57972011	57972564	LINE/L2	825	-	276	57972287	87410
chr16	31042564	31242564	harbor2	chr16	31053817	31053962	LINE/L2	557	-	72	31053889	11325
chr16	71270097	71470097	harbor2	chr16	71341724	71342147	LINE/L2	924	-	212	71341936	71839
chr16	67010382	67210382	harbor2	chr16	67040584	67041120	LINE/L2	1717	-	268	67040852	30470
chr16	67010382	67210382	harbor2	chr16	67041237	67041494	LINE/L2	1717	-	128	67041365	30983
chr16	1352047	1552047	harbor2	chr16	1353276	1353526	LINE/L2	761	-	125	1353401	1354
chr16	1352047	1552047	harbor2	chr16	1353779	1353921	LINE/L2	761	-	71	1353850	1803
chr16	56837249	57037249	harbor2	chr16	56912595	56913060	LINE/L2	693	-	232	56912827	75578
chr16	56831966	57031966	harbor2	chr16	56912595	56913060	LINE/L2	693	-	232	56912827	80861
chr16	67299632	67499632	harbor2	chr16	67327527	67327747	LINE/L2	948	-	110	67327637	28005
chr16	67299632	67499632	harbor2	chr16	67368111	67369564	LINE/L2	4888	-	726	67368837	69205
chr16	67299632	67499632	harbor2	chr16	67369926	67370360	LINE/L2	4888	-	217	67370143	70511
chr16	67299632	67499632	harbor2	chr16	67370653	67370914	LINE/L2	4888	-	130	67370783	71151
chr16	67010350	67210350	harbor2	chr16	67040584	67041120	LINE/L2	1717	-	268	67040852	30502
chr16	67010350	67210350	harbor2	chr16	67041237	67041494	LINE/L2	1717	-	128	67041365	31015
chr16	67092199	67292199	harbor2	chr16	67143597	67143806	LINE/L2	746	-	104	67143701	51502
chr16	1	169379	harbor2	chr16	52803	53424	LINE/L2	603	-	310	53113	53112
chr16	1	169379	harbor2	chr16	65263	65590	LINE/L2	619	-	164	65427	65426
chr16	82831292	83031292	harbor2	chr16	82900298	82900729	LINE/L2	559	-	216	82900514	69222
chr16	57892529	58092529	harbor2	chr16	57949004	57949128	LINE/L2	640	-	62	57949066	56537
chr16	57892529	58092529	harbor2	chr16	57972011	57972564	LINE/L2	825	-	276	57972287	79758
chr16	47360977	47560977	harbor2	chr16	47391898	47392131	LINE/L2	650	-	116	47392014	31037
chr16	47360977	47560977	harbor2	chr16	47392258	47392530	LINE/L2	650	-	136	47392394	31417
chr16	47360977	47560977	harbor2	chr16	47396561	47397357	LINE/L2	628	-	398	47396959	35982
chr16	47360977	47560977	harbor2	chr16	47400491	47401523	LINE/L2	647	-	516	47401007	40030
chr16	47360977	47560977	harbor2	chr16	47406554	47407356	LINE/L2	1900	-	401	47406955	45978
chr16	47360977	47560977	harbor2	chr16	47407647	47407957	LINE/L2	1900	-	155	47407802	46825
chr16	4085109	4285109	harbor2	chr16	4098556	4098728	LINE/L2	572	-	86	4098642	13533
chr16	86769708	86969708	harbor2	chr16	86812192	86813117	LINE/L2	1028	-	462	86812654	42946
chr16	86769708	86969708	harbor2	chr16	86822382	86822757	LINE/L2	651	-	188	86822570	52862
chr16	67033235	67233235	harbor2	chr16	67040584	67041120	LINE/L2	1717	-	268	67040852	7617
chr16	67033235	67233235	harbor2	chr16	67041237	67041494	LINE/L2	1717	-	128	67041365	8130
chr16	49564186	49764186	harbor2	chr16	49662479	49662835	LINE/L2	675	-	178	49662657	98471
chr17	7477694	7677694	harbor2	chr17	7485221	7485446	LINE/L2	662	-	112	7485333	7639
chr17	7477694	7677694	harbor2	chr17	7485706	7485716	LINE/L2	662	-	5	7485711	8017
chr17	7477694	7677694	harbor2	chr17	7485856	7486311	LINE/L2	662	-	228	7486084	8390
chr17	7477694	7677694	harbor2	chr17	7491695	7491942	LINE/L2	597	-	124	7491819	14125
chr17	7477694	7677694	harbor2	chr17	7493180	7493599	LINE/L2	689	-	210	7493390	15696
chr17	75009933	75209933	harbor2	chr17	75013418	75014170	LINE/L2	922	-	376	75013794	3861
chr17	75009933	75209933	harbor2	chr17	75014823	75015204	LINE/L2	600	-	190	75015013	5080
chr17	75009933	75209933	harbor2	chr17	75015502	75015738	LINE/L2	600	-	118	75015620	5687
chr17	75009933	75209933	harbor2	chr17	75098946	75099421	LINE/L2	659	-	238	75099184	89251
chr17	75009933	75209933	harbor2	chr17	75099739	75099771	LINE/L2	659	-	16	75099755	89822
chr17	7491992	7691992	harbor2	chr17	7493180	7493599	LINE/L2	689	-	210	7493390	1398
chr17	7477462	7677462	harbor2	chr17	7485221	7485446	LINE/L2	662	-	112	7485333	7871
chr17	7477462	7677462	harbor2	chr17	7485706	7485716	LINE/L2	662	-	5	7485711	8249
chr17	7477462	7677462	harbor2	chr17	7485856	7486311	LINE/L2	662	-	228	7486084	8622
chr17	7477462	7677462	harbor2	chr17	7491695	7491942	LINE/L2	597	-	124	7491819	14357
chr17	7477462	7677462	harbor2	chr17	7493180	7493599	LINE/L2	689	-	210	7493390	15928
chr17	57541742	57741742	harbor2	chr17	57546837	57547736	LINE/L2	1007	-	450	57547287	5545
chr17	57541742	57741742	harbor2	chr17	57621433	57621573	LINE/L2	650	-	70	57621503	79761
chr17	75010357	75210357	harbor2	chr17	75013418	75014170	LINE/L2	922	-	376	75013794	3437
chr17	75010357	75210357	harbor2	chr17	75014823	75015204	LINE/L2	600	-	190	75015013	4656
chr17	75010357	75210357	harbor2	chr17	75015502	75015738	LINE/L2	600	-	118	75015620	5263
chr17	75010357	75210357	harbor2	chr17	75098946	75099421	LINE/L2	659	-	238	75099184	88827
chr17	75010357	75210357	harbor2	chr17	75099739	75099771	LINE/L2	659	-	16	75099755	89398
chr17	7489435	7689435	harbor2	chr17	7491695	7491942	LINE/L2	597	-	124	7491819	2384
chr17	7489435	7689435	harbor2	chr17	7493180	7493599	LINE/L2	689	-	210	7493390	3955
chr17	7475157	7675157	harbor2	chr17	7485221	7485446	LINE/L2	662	-	112	7485333	10176
chr17	7475157	7675157	harbor2	chr17	7485706	7485716	LINE/L2	662	-	5	7485711	10554
chr17	7475157	7675157	harbor2	chr17	7485856	7486311	LINE/L2	662	-	228	7486084	10927
chr17	7475157	7675157	harbor2	chr17	7491695	7491942	LINE/L2	597	-	124	7491819	16662
chr17	7475157	7675157	harbor2	chr17	7493180	7493599	LINE/L2	689	-	210	7493390	18233
chr17	63524434	63724434	harbor2	chr17	63618311	63618931	LINE/L2	1051	-	310	63618621	94187
chr17	63524434	63724434	harbor2	chr17	63619268	63619371	LINE/L2	1051	-	52	63619320	94886
chr17	63524434	63724434	harbor2	chr17	63620044	63620067	LINE/L2	1051	-	12	63620056	95622
chr17	7462624	7662624	harbor2	chr17	7485221	7485446	LINE/L2	662	-	112	7485333	22709
chr17	7462624	7662624	harbor2	chr17	7485706	7485716	LINE/L2	662	-	5	7485711	23087
chr17	7462624	7662624	harbor2	chr17	7485856	7486311	LINE/L2	662	-	228	7486084	23460
chr17	7462624	7662624	harbor2	chr17	7491695	7491942	LINE/L2	597	-	124	7491819	29195
chr17	7462624	7662624	harbor2	chr17	7493180	7493599	LINE/L2	689	-	210	7493390	30766
chr17	33328761	33528761	harbor2	chr17	33346917	33347515	LINE/L2	987	-	299	33347216	18455
chr17	33328761	33528761	harbor2	chr17	33347604	33347820	LINE/L2	1250	-	108	33347712	18951
chr17	33328761	33528761	harbor2	chr17	33348121	33348752	LINE/L2	1250	-	316	33348437	19676
chr17	33328761	33528761	harbor2	chr17	33355768	33356183	LINE/L2	797	-	208	33355976	27215
chr17	33328761	33528761	harbor2	chr17	33375102	33376234	LINE/L2	2755	-	566	33375668	46907
chr17	7832177	8032177	harbor2	chr17	7873250	7874601	LINE/L2	656	-	676	7873926	41749
chr17	18021809	18221809	harbor2	chr17	18074987	18075595	LINE/L2	915	-	304	18075291	53482
chr17	18021809	18221809	harbor2	chr17	18075909	18075930	LINE/L2	915	-	10	18075919	54110
chr17	18021809	18221809	harbor2	chr17	18089121	18089138	LINE/L2	1215	-	8	18089129	67320
chr17	18021809	18221809	harbor2	chr17	18089440	18090104	LINE/L2	1215	-	332	18089772	67963
chr17	18021809	18221809	harbor2	chr17	18094186	18094688	LINE/L2	786	-	251	18094437	72628
chr17	3792936	3992936	harbor2	chr17	3867021	3867614	LINE/L2	937	-	296	3867317	74381
chr17	3792936	3992936	harbor2	chr17	3891167	3891601	LINE/L2	1291	-	217	3891384	98448
chr17	3792936	3992936	harbor2	chr17	3866619	3866723	LINE/L2	937	-	52	3866671	73735
chr17	7473235	7673235	harbor2	chr17	7485221	7485446	LINE/L2	662	-	112	7485333	12098
chr17	7473235	7673235	harbor2	chr17	7485706	7485716	LINE/L2	662	-	5	7485711	12476
chr17	7473235	7673235	harbor2	chr17	7485856	7486311	LINE/L2	662	-	228	7486084	12849
chr17	7473235	7673235	harbor2	chr17	7491695	7491942	LINE/L2	597	-	124	7491819	18584
chr17	7473235	7673235	harbor2	chr17	7493180	7493599	LINE/L2	689	-	210	7493390	20155
chr17	7489456	7689456	harbor2	chr17	7491695	7491942	LINE/L2	597	-	124	7491819	2363
chr17	7489456	7689456	harbor2	chr17	7493180	7493599	LINE/L2	689	-	210	7493390	3934
chr17	7463026	7663026	harbor2	chr17	7485221	7485446	LINE/L2	662	-	112	7485333	22307
chr17	7463026	7663026	harbor2	chr17	7485706	7485716	LINE/L2	662	-	5	7485711	22685
chr17	7463026	7663026	harbor2	chr17	7485856	7486311	LINE/L2	662	-	228	7486084	23058
chr17	7463026	7663026	harbor2	chr17	7491695	7491942	LINE/L2	597	-	124	7491819	28793
chr17	7463026	7663026	harbor2	chr17	7493180	7493599	LINE/L2	689	-	210	7493390	30364
chr17	80705801	80905801	harbor2	chr17	80741319	80742397	LINE/L2	692	-	539	80741858	36057
chr17	47938395	48138395	harbor2	chr17	47979070	47979653	LINE/L2	1574	-	292	47979362	40967
chr17	7687290	7887290	harbor2	chr17	7690255	7690629	LINE/L2	847	-	187	7690442	3152
chr17	7687290	7887290	harbor2	chr17	7691260	7691389	LINE/L2	847	-	64	7691324	4034
chr17	7687290	7887290	harbor2	chr17	7712976	7713181	LINE/L2	711	-	102	7713078	25788
chr17	7687290	7887290	harbor2	chr17	7713505	7713688	LINE/L2	711	-	92	7713597	26307
chr17	7488100	7688100	harbor2	chr17	7491695	7491942	LINE/L2	597	-	124	7491819	3719
chr17	7488100	7688100	harbor2	chr17	7493180	7493599	LINE/L2	689	-	210	7493390	5290
chr17	7477191	7677191	harbor2	chr17	7485221	7485446	LINE/L2	662	-	112	7485333	8142
chr17	7477191	7677191	harbor2	chr17	7485706	7485716	LINE/L2	662	-	5	7485711	8520
chr17	7477191	7677191	harbor2	chr17	7485856	7486311	LINE/L2	662	-	228	7486084	8893
chr17	7477191	7677191	harbor2	chr17	7491695	7491942	LINE/L2	597	-	124	7491819	14628
chr17	7477191	7677191	harbor2	chr17	7493180	7493599	LINE/L2	689	-	210	7493390	16199
chr17	7489503	7689503	harbor2	chr17	7491695	7491942	LINE/L2	597	-	124	7491819	2316
chr17	7489503	7689503	harbor2	chr17	7493180	7493599	LINE/L2	689	-	210	7493390	3887
chr17	7461749	7661749	harbor2	chr17	7485221	7485446	LINE/L2	662	-	112	7485333	23584
chr17	7461749	7661749	harbor2	chr17	7485706	7485716	LINE/L2	662	-	5	7485711	23962
chr17	7461749	7661749	harbor2	chr17	7485856	7486311	LINE/L2	662	-	228	7486084	24335
chr17	7461749	7661749	harbor2	chr17	7491695	7491942	LINE/L2	597	-	124	7491819	30070
chr17	7461749	7661749	harbor2	chr17	7493180	7493599	LINE/L2	689	-	210	7493390	31641
chr17	15162691	15362691	harbor2	chr17	15195453	15195706	LINE/L2	927	-	126	15195579	32888
chr17	15162691	15362691	harbor2	chr17	15196004	15196257	LINE/L2	927	-	126	15196130	33439
chr17	15162691	15362691	harbor2	chr17	15254082	15254675	LINE/L2	698	-	296	15254378	91687
chr17	15162691	15362691	harbor2	chr17	15254962	15255018	LINE/L2	698	-	28	15254990	92299
chr17	7461773	7661773	harbor2	chr17	7485221	7485446	LINE/L2	662	-	112	7485333	23560
chr17	7461773	7661773	harbor2	chr17	7485706	7485716	LINE/L2	662	-	5	7485711	23938
chr17	7461773	7661773	harbor2	chr17	7485856	7486311	LINE/L2	662	-	228	7486084	24311
chr17	7461773	7661773	harbor2	chr17	7491695	7491942	LINE/L2	597	-	124	7491819	30046
chr17	7461773	7661773	harbor2	chr17	7493180	7493599	LINE/L2	689	-	210	7493390	31617
chr17	77288798	77488798	harbor2	chr17	77297640	77298069	LINE/L2	886	-	214	77297854	9056
chr17	77288798	77488798	harbor2	chr17	77328675	77329159	LINE/L2	635	-	242	77328917	40119
chr17	33193427	33393427	harbor2	chr17	33247789	33248475	LINE/L2	3105	-	343	33248132	54705
chr17	33193427	33393427	harbor2	chr17	33248959	33249589	LINE/L2	3105	-	315	33249274	55847
chr17	33193427	33393427	harbor2	chr17	33258196	33258719	LINE/L2	1064	-	262	33258458	65031
chr17	38630351	38830351	harbor2	chr17	38691860	38692095	LINE/L2	661	-	118	38691978	61627
chr17	38630351	38830351	harbor2	chr17	38692392	38692418	LINE/L2	661	-	13	38692405	62054
chr17	38630351	38830351	harbor2	chr17	38692765	38692899	LINE/L2	1648	-	67	38692832	62481
chr17	38630351	38830351	harbor2	chr17	38693207	38693587	LINE/L2	1648	-	190	38693397	63046
chr17	49774727	49974727	harbor2	chr17	49778679	49779224	LINE/L2	1062	-	272	49778951	4224
chr17	49774727	49974727	harbor2	chr17	49800622	49801095	LINE/L2	840	-	236	49800858	26131
chr17	49774727	49974727	harbor2	chr17	49835584	49836095	LINE/L2	640	-	256	49835840	61113
chr17	49774727	49974727	harbor2	chr17	49807073	49808008	LINE/L2	891	-	468	49807541	32814
chr17	7463028	7663028	harbor2	chr17	7485221	7485446	LINE/L2	662	-	112	7485333	22305
chr17	7463028	7663028	harbor2	chr17	7485706	7485716	LINE/L2	662	-	5	7485711	22683
chr17	7463028	7663028	harbor2	chr17	7485856	7486311	LINE/L2	662	-	228	7486084	23056
chr17	7463028	7663028	harbor2	chr17	7491695	7491942	LINE/L2	597	-	124	7491819	28791
chr17	7463028	7663028	harbor2	chr17	7493180	7493599	LINE/L2	689	-	210	7493390	30362
chr17	75009931	75209931	harbor2	chr17	75013418	75014170	LINE/L2	922	-	376	75013794	3863
chr17	75009931	75209931	harbor2	chr17	75014823	75015204	LINE/L2	600	-	190	75015013	5082
chr17	75009931	75209931	harbor2	chr17	75015502	75015738	LINE/L2	600	-	118	75015620	5689
chr17	75009931	75209931	harbor2	chr17	75098946	75099421	LINE/L2	659	-	238	75099184	89253
chr17	75009931	75209931	harbor2	chr17	75099739	75099771	LINE/L2	659	-	16	75099755	89824
chr17	7339726	7539726	harbor2	chr17	7344722	7345216	LINE/L2	965	-	247	7344969	5243
chr17	33193168	33393168	harbor2	chr17	33247789	33248475	LINE/L2	3105	-	343	33248132	54964
chr17	33193168	33393168	harbor2	chr17	33248959	33249589	LINE/L2	3105	-	315	33249274	56106
chr17	33193168	33393168	harbor2	chr17	33258196	33258719	LINE/L2	1064	-	262	33258458	65290
chr17	76300002	76500002	harbor2	chr17	76347522	76347916	LINE/L2	630	-	197	76347719	47717
chr17	7474761	7674761	harbor2	chr17	7485221	7485446	LINE/L2	662	-	112	7485333	10572
chr17	7474761	7674761	harbor2	chr17	7485706	7485716	LINE/L2	662	-	5	7485711	10950
chr17	7474761	7674761	harbor2	chr17	7485856	7486311	LINE/L2	662	-	228	7486084	11323
chr17	7474761	7674761	harbor2	chr17	7491695	7491942	LINE/L2	597	-	124	7491819	17058
chr17	7474761	7674761	harbor2	chr17	7493180	7493599	LINE/L2	689	-	210	7493390	18629
chr17	39497259	39697259	harbor2	chr17	39584030	39584242	LINE/L2	1092	-	106	39584136	86877
chr17	39497259	39697259	harbor2	chr17	39584568	39584905	LINE/L2	1092	-	168	39584736	87477
chr17	39497259	39697259	harbor2	chr17	39589222	39589282	LINE/L2	612	-	30	39589252	91993
chr17	39497259	39697259	harbor2	chr17	39589593	39589907	LINE/L2	612	-	157	39589750	92491
chr17	69432886	69632886	harbor2	chr17	69526798	69527226	LINE/L2	633	-	214	69527012	94126
chr17	75009932	75209932	harbor2	chr17	75013418	75014170	LINE/L2	922	-	376	75013794	3862
chr17	75009932	75209932	harbor2	chr17	75014823	75015204	LINE/L2	600	-	190	75015013	5081
chr17	75009932	75209932	harbor2	chr17	75015502	75015738	LINE/L2	600	-	118	75015620	5688
chr17	75009932	75209932	harbor2	chr17	75098946	75099421	LINE/L2	659	-	238	75099184	89252
chr17	75009932	75209932	harbor2	chr17	75099739	75099771	LINE/L2	659	-	16	75099755	89823
chr17	76146968	76346968	harbor2	chr17	76211884	76212081	LINE/L2	675	-	98	76211982	65014
chr17	7488084	7688084	harbor2	chr17	7491695	7491942	LINE/L2	597	-	124	7491819	3735
chr17	7488084	7688084	harbor2	chr17	7493180	7493599	LINE/L2	689	-	210	7493390	5306
chr17	2838078	3038078	harbor2	chr17	2908170	2908727	LINE/L2	753	-	278	2908448	70370
chr17	2838078	3038078	harbor2	chr17	2909001	2909451	LINE/L2	753	-	225	2909226	71148
chr17	2838639	3038639	harbor2	chr17	2908170	2908727	LINE/L2	753	-	278	2908448	69809
chr17	2838639	3038639	harbor2	chr17	2909001	2909451	LINE/L2	753	-	225	2909226	70587
chr17	7461827	7661827	harbor2	chr17	7485221	7485446	LINE/L2	662	-	112	7485333	23506
chr17	7461827	7661827	harbor2	chr17	7485706	7485716	LINE/L2	662	-	5	7485711	23884
chr17	7461827	7661827	harbor2	chr17	7485856	7486311	LINE/L2	662	-	228	7486084	24257
chr17	7461827	7661827	harbor2	chr17	7491695	7491942	LINE/L2	597	-	124	7491819	29992
chr17	7461827	7661827	harbor2	chr17	7493180	7493599	LINE/L2	689	-	210	7493390	31563
chr17	31389658	31589658	harbor2	chr17	31400389	31400667	LINE/L2	648	-	139	31400528	10870
chr17	40257161	40457161	harbor2	chr17	40265228	40266131	LINE/L2	3463	-	452	40265680	8519
chr17	40257161	40457161	harbor2	chr17	40266258	40267354	LINE/L2	3463	-	548	40266806	9645
chr17	28851871	29051871	harbor2	chr17	28914872	28915251	LINE/L2	860	-	190	28915062	63191
chr17	75415680	75615680	harbor2	chr17	75418559	75418819	LINE/L2	771	-	130	75418689	3009
chr17	75415680	75615680	harbor2	chr17	75419123	75419383	LINE/L2	771	-	130	75419253	3573
chr17	75415680	75615680	harbor2	chr17	75419681	75419725	LINE/L2	771	-	22	75419703	4023
chr17	75415680	75615680	harbor2	chr17	75440928	75441354	LINE/L2	979	-	213	75441141	25461
chr17	75415680	75615680	harbor2	chr17	75442888	75443052	LINE/L2	919	-	82	75442970	27290
chr17	75415680	75615680	harbor2	chr17	75443957	75444184	LINE/L2	897	-	114	75444071	28391
chr17	38634397	38834397	harbor2	chr17	38691860	38692095	LINE/L2	661	-	118	38691978	57581
chr17	38634397	38834397	harbor2	chr17	38692392	38692418	LINE/L2	661	-	13	38692405	58008
chr17	38634397	38834397	harbor2	chr17	38692765	38692899	LINE/L2	1648	-	67	38692832	58435
chr17	38634397	38834397	harbor2	chr17	38693207	38693587	LINE/L2	1648	-	190	38693397	59000
chr17	2902561	3102561	harbor2	chr17	2908170	2908727	LINE/L2	753	-	278	2908448	5887
chr17	2902561	3102561	harbor2	chr17	2909001	2909451	LINE/L2	753	-	225	2909226	6665
chr17	60049882	60249882	harbor2	chr17	60077024	60077413	LINE/L2	597	-	194	60077218	27336
chr17	27992414	28192414	harbor2	chr17	27998585	27999216	LINE/L2	1726	-	316	27998901	6487
chr17	27992414	28192414	harbor2	chr17	28002955	28003738	LINE/L2	2033	-	392	28003347	10933
chr17	27992414	28192414	harbor2	chr17	28004039	28004378	LINE/L2	2033	-	170	28004209	11795
chr17	27992414	28192414	harbor2	chr17	28016162	28016510	LINE/L2	874	-	174	28016336	23922
chr17	2204008	2404008	harbor2	chr17	2222058	2222743	LINE/L2	1266	-	342	2222400	18392
chr17	2204008	2404008	harbor2	chr17	2278929	2279750	LINE/L2	751	-	410	2279339	75331
chr17	7464666	7664666	harbor2	chr17	7485221	7485446	LINE/L2	662	-	112	7485333	20667
chr17	7464666	7664666	harbor2	chr17	7485706	7485716	LINE/L2	662	-	5	7485711	21045
chr17	7464666	7664666	harbor2	chr17	7485856	7486311	LINE/L2	662	-	228	7486084	21418
chr17	7464666	7664666	harbor2	chr17	7491695	7491942	LINE/L2	597	-	124	7491819	27153
chr17	7464666	7664666	harbor2	chr17	7493180	7493599	LINE/L2	689	-	210	7493390	28724
chr17	79837474	80037474	harbor2	chr17	79886544	79887071	LINE/L2	949	-	264	79886808	49334
chr17	79837474	80037474	harbor2	chr17	79887088	79887790	LINE/L2	1372	-	351	79887439	49965
chr17	76284849	76484849	harbor2	chr17	76347522	76347916	LINE/L2	630	-	197	76347719	62870
chr17	61281405	61481405	harbor2	chr17	61339781	61339981	LINE/L2	599	-	100	61339881	58476
chr17	61281405	61481405	harbor2	chr17	61340251	61341372	LINE/L2	2809	-	560	61340811	59406
chr17	61281405	61481405	harbor2	chr17	61347972	61348608	LINE/L2	858	-	318	61348290	66885
chr17	47912946	48112946	harbor2	chr17	47979070	47979653	LINE/L2	1574	-	292	47979362	66416
chr17	7472460	7672460	harbor2	chr17	7485221	7485446	LINE/L2	662	-	112	7485333	12873
chr17	7472460	7672460	harbor2	chr17	7485706	7485716	LINE/L2	662	-	5	7485711	13251
chr17	7472460	7672460	harbor2	chr17	7485856	7486311	LINE/L2	662	-	228	7486084	13624
chr17	7472460	7672460	harbor2	chr17	7491695	7491942	LINE/L2	597	-	124	7491819	19359
chr17	7472460	7672460	harbor2	chr17	7493180	7493599	LINE/L2	689	-	210	7493390	20930
chr17	7461796	7661796	harbor2	chr17	7485221	7485446	LINE/L2	662	-	112	7485333	23537
chr17	7461796	7661796	harbor2	chr17	7485706	7485716	LINE/L2	662	-	5	7485711	23915
chr17	7461796	7661796	harbor2	chr17	7485856	7486311	LINE/L2	662	-	228	7486084	24288
chr17	7461796	7661796	harbor2	chr17	7491695	7491942	LINE/L2	597	-	124	7491819	30023
chr17	7461796	7661796	harbor2	chr17	7493180	7493599	LINE/L2	689	-	210	7493390	31594
chr17	7472419	7672419	harbor2	chr17	7485221	7485446	LINE/L2	662	-	112	7485333	12914
chr17	7472419	7672419	harbor2	chr17	7485706	7485716	LINE/L2	662	-	5	7485711	13292
chr17	7472419	7672419	harbor2	chr17	7485856	7486311	LINE/L2	662	-	228	7486084	13665
chr17	7472419	7672419	harbor2	chr17	7491695	7491942	LINE/L2	597	-	124	7491819	19400
chr17	7472419	7672419	harbor2	chr17	7493180	7493599	LINE/L2	689	-	210	7493390	20971
chr17	63601376	63801376	harbor2	chr17	63618311	63618931	LINE/L2	1051	-	310	63618621	17245
chr17	63601376	63801376	harbor2	chr17	63619268	63619371	LINE/L2	1051	-	52	63619320	17944
chr17	63601376	63801376	harbor2	chr17	63620044	63620067	LINE/L2	1051	-	12	63620056	18680
chr17	63601376	63801376	harbor2	chr17	63670617	63671171	LINE/L2	741	-	277	63670894	69518
chr17	63601376	63801376	harbor2	chr17	63672331	63672763	LINE/L2	867	-	216	63672547	71171
chr17	61309671	61509671	harbor2	chr17	61339781	61339981	LINE/L2	599	-	100	61339881	30210
chr17	61309671	61509671	harbor2	chr17	61340251	61341372	LINE/L2	2809	-	560	61340811	31140
chr17	61309671	61509671	harbor2	chr17	61347972	61348608	LINE/L2	858	-	318	61348290	38619
chr17	44677505	44877505	harbor2	chr17	44707372	44708155	LINE/L2	1458	-	392	44707764	30259
chr17	7618194	7818194	harbor2	chr17	7690255	7690629	LINE/L2	847	-	187	7690442	72248
chr17	7618194	7818194	harbor2	chr17	7691260	7691389	LINE/L2	847	-	64	7691324	73130
chr17	7618194	7818194	harbor2	chr17	7712976	7713181	LINE/L2	711	-	102	7713078	94884
chr17	7618194	7818194	harbor2	chr17	7713505	7713688	LINE/L2	711	-	92	7713597	95403
chr17	62850959	63050959	harbor2	chr17	62900543	62900950	LINE/L2	655	-	204	62900747	49788
chr17	2236511	2436511	harbor2	chr17	2278929	2279750	LINE/L2	751	-	410	2279339	42828
chr17	7472691	7672691	harbor2	chr17	7485221	7485446	LINE/L2	662	-	112	7485333	12642
chr17	7472691	7672691	harbor2	chr17	7485706	7485716	LINE/L2	662	-	5	7485711	13020
chr17	7472691	7672691	harbor2	chr17	7485856	7486311	LINE/L2	662	-	228	7486084	13393
chr17	7472691	7672691	harbor2	chr17	7491695	7491942	LINE/L2	597	-	124	7491819	19128
chr17	7472691	7672691	harbor2	chr17	7493180	7493599	LINE/L2	689	-	210	7493390	20699
chr17	48652372	48852372	harbor2	chr17	48668115	48668464	LINE/L2	904	-	174	48668289	15917
chr17	35649355	35849355	harbor2	chr17	35701982	35702723	LINE/L2	1488	-	370	35702352	52997
chr17	7465556	7665556	harbor2	chr17	7485221	7485446	LINE/L2	662	-	112	7485333	19777
chr17	7465556	7665556	harbor2	chr17	7485706	7485716	LINE/L2	662	-	5	7485711	20155
chr17	7465556	7665556	harbor2	chr17	7485856	7486311	LINE/L2	662	-	228	7486084	20528
chr17	7465556	7665556	harbor2	chr17	7491695	7491942	LINE/L2	597	-	124	7491819	26263
chr17	7465556	7665556	harbor2	chr17	7493180	7493599	LINE/L2	689	-	210	7493390	27834
chr17	44456186	44656186	harbor2	chr17	44516101	44516400	LINE/L2	636	-	150	44516251	60065
chr17	44456186	44656186	harbor2	chr17	44516954	44517043	LINE/L2	789	-	44	44516998	60812
chr17	44456186	44656186	harbor2	chr17	44517340	44517741	LINE/L2	789	-	200	44517540	61354
chr18	26129359	26329359	harbor2	chr18	26137638	26138143	LINE/L2	603	-	252	26137890	8531
chr18	26129359	26329359	harbor2	chr18	26138604	26138985	LINE/L2	515	-	190	26138794	9435
chr18	26129359	26329359	harbor2	chr18	26163027	26163213	LINE/L2	1007	-	93	26163120	33761
chr18	26129359	26329359	harbor2	chr18	26163263	26163501	LINE/L2	1007	-	119	26163382	34023
chr18	26129359	26329359	harbor2	chr18	26163610	26163926	LINE/L2	836	-	158	26163768	34409
chr18	26126451	26326451	harbor2	chr18	26137638	26138143	LINE/L2	603	-	252	26137890	11439
chr18	26126451	26326451	harbor2	chr18	26138604	26138985	LINE/L2	515	-	190	26138794	12343
chr18	26126451	26326451	harbor2	chr18	26163027	26163213	LINE/L2	1007	-	93	26163120	36669
chr18	26126451	26326451	harbor2	chr18	26163263	26163501	LINE/L2	1007	-	119	26163382	36931
chr18	26126451	26326451	harbor2	chr18	26163610	26163926	LINE/L2	836	-	158	26163768	37317
chr18	26128509	26328509	harbor2	chr18	26137638	26138143	LINE/L2	603	-	252	26137890	9381
chr18	26128509	26328509	harbor2	chr18	26138604	26138985	LINE/L2	515	-	190	26138794	10285
chr18	26128509	26328509	harbor2	chr18	26163027	26163213	LINE/L2	1007	-	93	26163120	34611
chr18	26128509	26328509	harbor2	chr18	26163263	26163501	LINE/L2	1007	-	119	26163382	34873
chr18	26128509	26328509	harbor2	chr18	26163610	26163926	LINE/L2	836	-	158	26163768	35259
chr18	26126452	26326452	harbor2	chr18	26137638	26138143	LINE/L2	603	-	252	26137890	11438
chr18	26126452	26326452	harbor2	chr18	26138604	26138985	LINE/L2	515	-	190	26138794	12342
chr18	26126452	26326452	harbor2	chr18	26163027	26163213	LINE/L2	1007	-	93	26163120	36668
chr18	26126452	26326452	harbor2	chr18	26163263	26163501	LINE/L2	1007	-	119	26163382	36930
chr18	26126452	26326452	harbor2	chr18	26163610	26163926	LINE/L2	836	-	158	26163768	37316
chr18	26128609	26328609	harbor2	chr18	26137638	26138143	LINE/L2	603	-	252	26137890	9281
chr18	26128609	26328609	harbor2	chr18	26138604	26138985	LINE/L2	515	-	190	26138794	10185
chr18	26128609	26328609	harbor2	chr18	26163027	26163213	LINE/L2	1007	-	93	26163120	34511
chr18	26128609	26328609	harbor2	chr18	26163263	26163501	LINE/L2	1007	-	119	26163382	34773
chr18	26128609	26328609	harbor2	chr18	26163610	26163926	LINE/L2	836	-	158	26163768	35159
chr18	26126723	26326723	harbor2	chr18	26137638	26138143	LINE/L2	603	-	252	26137890	11167
chr18	26126723	26326723	harbor2	chr18	26138604	26138985	LINE/L2	515	-	190	26138794	12071
chr18	26126723	26326723	harbor2	chr18	26163027	26163213	LINE/L2	1007	-	93	26163120	36397
chr18	26126723	26326723	harbor2	chr18	26163263	26163501	LINE/L2	1007	-	119	26163382	36659
chr18	26126723	26326723	harbor2	chr18	26163610	26163926	LINE/L2	836	-	158	26163768	37045
chr18	37466535	37666535	harbor2	chr18	37466601	37466919	LINE/L2	620	-	159	37466760	225
chr18	26127358	26327358	harbor2	chr18	26137638	26138143	LINE/L2	603	-	252	26137890	10532
chr18	26127358	26327358	harbor2	chr18	26138604	26138985	LINE/L2	515	-	190	26138794	11436
chr18	26127358	26327358	harbor2	chr18	26163027	26163213	LINE/L2	1007	-	93	26163120	35762
chr18	26127358	26327358	harbor2	chr18	26163263	26163501	LINE/L2	1007	-	119	26163382	36024
chr18	26127358	26327358	harbor2	chr18	26163610	26163926	LINE/L2	836	-	158	26163768	36410
chr18	57458489	57658489	harbor2	chr18	57525752	57526077	LINE/L2	925	-	162	57525914	67425
chr18	79329731	79529731	harbor2	chr18	79409717	79410050	LINE/L2	544	-	166	79409883	80152
chr18	65788461	65988461	harbor2	chr18	65788997	65789398	LINE/L2	541	-	200	65789197	736
chr18	65788461	65988461	harbor2	chr18	65856328	65856647	LINE/L2	511	-	160	65856488	68027
chr18	26155998	26355998	harbor2	chr18	26163027	26163213	LINE/L2	1007	-	93	26163120	7122
chr18	26155998	26355998	harbor2	chr18	26163263	26163501	LINE/L2	1007	-	119	26163382	7384
chr18	26155998	26355998	harbor2	chr18	26163610	26163926	LINE/L2	836	-	158	26163768	7770
chr18	12196156	12396156	harbor2	chr18	12235925	12236353	LINE/L2	527	-	214	12236139	39983
chr18	79380291	79580291	harbor2	chr18	79409717	79410050	LINE/L2	544	-	166	79409883	29592
chr18	26127435	26327435	harbor2	chr18	26137638	26138143	LINE/L2	603	-	252	26137890	10455
chr18	26127435	26327435	harbor2	chr18	26138604	26138985	LINE/L2	515	-	190	26138794	11359
chr18	26127435	26327435	harbor2	chr18	26163027	26163213	LINE/L2	1007	-	93	26163120	35685
chr18	26127435	26327435	harbor2	chr18	26163263	26163501	LINE/L2	1007	-	119	26163382	35947
chr18	26127435	26327435	harbor2	chr18	26163610	26163926	LINE/L2	836	-	158	26163768	36333
chr18	27134071	27334071	harbor2	chr18	27167553	27168077	LINE/L2	628	-	262	27167815	33744
chr18	27134071	27334071	harbor2	chr18	27168374	27168548	LINE/L2	628	-	87	27168461	34390
chr18	27134071	27334071	harbor2	chr18	27194428	27194974	LINE/L2	646	-	273	27194701	60630
chr18	63860473	64060473	harbor2	chr18	63898519	63898927	LINE/L2	534	-	204	63898723	38250
chr18	12177247	12377247	harbor2	chr18	12235925	12236353	LINE/L2	527	-	214	12236139	58892
chr18	62778589	62978589	harbor2	chr18	62797308	62797622	LINE/L2	821	-	157	62797465	18876
chr19	49751330	49951330	harbor2	chr19	49768871	49768968	LINE/L2	818	-	48	49768919	17589
chr19	49751330	49951330	harbor2	chr19	49769278	49769881	LINE/L2	1108	-	302	49769580	18250
chr19	49751330	49951330	harbor2	chr19	49770169	49770245	LINE/L2	1108	-	38	49770207	18877
chr19	49751330	49951330	harbor2	chr19	49773515	49774097	LINE/L2	831	-	291	49773806	22476
chr19	17680051	17880051	harbor2	chr19	17764607	17764783	LINE/L2	804	-	88	17764695	84644
chr19	17680051	17880051	harbor2	chr19	17765085	17765379	LINE/L2	804	-	147	17765232	85181
chr19	17680051	17880051	harbor2	chr19	17777125	17777254	LINE/L2	688	-	64	17777189	97138
chr19	17680051	17880051	harbor2	chr19	17777563	17777762	LINE/L2	688	-	100	17777663	97612
chr19	17680051	17880051	harbor2	chr19	17778053	17778097	LINE/L2	688	-	22	17778075	98024
chr19	17680051	17880051	harbor2	chr19	17778935	17779662	LINE/L2	695	-	364	17779299	99248
chr19	10695944	10895944	harbor2	chr19	10747924	10748387	LINE/L2	822	-	232	10748156	52212
chr19	10695944	10895944	harbor2	chr19	10788255	10788586	LINE/L2	706	-	166	10788421	92477
chr19	49752226	49952226	harbor2	chr19	49768871	49768968	LINE/L2	818	-	48	49768919	16693
chr19	49752226	49952226	harbor2	chr19	49769278	49769881	LINE/L2	1108	-	302	49769580	17354
chr19	49752226	49952226	harbor2	chr19	49770169	49770245	LINE/L2	1108	-	38	49770207	17981
chr19	49752226	49952226	harbor2	chr19	49773515	49774097	LINE/L2	831	-	291	49773806	21580
chr19	5522877	5722877	harbor2	chr19	5532241	5532315	LINE/L2	1670	-	37	5532278	9401
chr19	5522877	5722877	harbor2	chr19	5532618	5532793	LINE/L2	1670	-	88	5532706	9829
chr19	5522877	5722877	harbor2	chr19	5533315	5533637	LINE/L2	1670	-	161	5533476	10599
chr19	5522877	5722877	harbor2	chr19	5562444	5562649	LINE/L2	956	-	102	5562546	39669
chr19	5522877	5722877	harbor2	chr19	5562947	5563464	LINE/L2	956	-	258	5563205	40328
chr19	10789145	10989145	harbor2	chr19	10820313	10820865	LINE/L2	782	-	276	10820589	31444
chr19	10789145	10989145	harbor2	chr19	10852509	10852816	LINE/L2	845	-	154	10852663	63518
chr19	9993299	10193299	harbor2	chr19	10067912	10068234	LINE/L2	801	-	161	10068073	74774
chr19	9993299	10193299	harbor2	chr19	10068535	10068545	LINE/L2	801	-	5	10068540	75241
chr19	9993299	10193299	harbor2	chr19	10069349	10069573	LINE/L2	777	-	112	10069461	76162
chr19	9993299	10193299	harbor2	chr19	10069859	10070092	LINE/L2	777	-	116	10069975	76676
chr19	10771152	10971152	harbor2	chr19	10788255	10788586	LINE/L2	706	-	166	10788421	17269
chr19	10771152	10971152	harbor2	chr19	10820313	10820865	LINE/L2	782	-	276	10820589	49437
chr19	10771152	10971152	harbor2	chr19	10852509	10852816	LINE/L2	845	-	154	10852663	81511
chr19	5522866	5722866	harbor2	chr19	5532241	5532315	LINE/L2	1670	-	37	5532278	9412
chr19	5522866	5722866	harbor2	chr19	5532618	5532793	LINE/L2	1670	-	88	5532706	9840
chr19	5522866	5722866	harbor2	chr19	5533315	5533637	LINE/L2	1670	-	161	5533476	10610
chr19	5522866	5722866	harbor2	chr19	5562444	5562649	LINE/L2	956	-	102	5562546	39680
chr19	5522866	5722866	harbor2	chr19	5562947	5563464	LINE/L2	956	-	258	5563205	40339
chr19	5522868	5722868	harbor2	chr19	5532241	5532315	LINE/L2	1670	-	37	5532278	9410
chr19	5522868	5722868	harbor2	chr19	5532618	5532793	LINE/L2	1670	-	88	5532706	9838
chr19	5522868	5722868	harbor2	chr19	5533315	5533637	LINE/L2	1670	-	161	5533476	10608
chr19	5522868	5722868	harbor2	chr19	5562444	5562649	LINE/L2	956	-	102	5562546	39678
chr19	5522868	5722868	harbor2	chr19	5562947	5563464	LINE/L2	956	-	258	5563205	40337
chr19	5590893	5790893	harbor2	chr19	5683455	5683609	LINE/L2	800	-	77	5683532	92639
chr19	5590893	5790893	harbor2	chr19	5683923	5683965	LINE/L2	800	-	21	5683944	93051
chr19	5590893	5790893	harbor2	chr19	5684315	5684729	LINE/L2	800	-	207	5684522	93629
chr19	5522876	5722876	harbor2	chr19	5532241	5532315	LINE/L2	1670	-	37	5532278	9402
chr19	5522876	5722876	harbor2	chr19	5532618	5532793	LINE/L2	1670	-	88	5532706	9830
chr19	5522876	5722876	harbor2	chr19	5533315	5533637	LINE/L2	1670	-	161	5533476	10600
chr19	5522876	5722876	harbor2	chr19	5562444	5562649	LINE/L2	956	-	102	5562546	39670
chr19	5522876	5722876	harbor2	chr19	5562947	5563464	LINE/L2	956	-	258	5563205	40329
chr19	5595790	5795790	harbor2	chr19	5683455	5683609	LINE/L2	800	-	77	5683532	87742
chr19	5595790	5795790	harbor2	chr19	5683923	5683965	LINE/L2	800	-	21	5683944	88154
chr19	5595790	5795790	harbor2	chr19	5684315	5684729	LINE/L2	800	-	207	5684522	88732
chr19	49752043	49952043	harbor2	chr19	49768871	49768968	LINE/L2	818	-	48	49768919	16876
chr19	49752043	49952043	harbor2	chr19	49769278	49769881	LINE/L2	1108	-	302	49769580	17537
chr19	49752043	49952043	harbor2	chr19	49770169	49770245	LINE/L2	1108	-	38	49770207	18164
chr19	49752043	49952043	harbor2	chr19	49773515	49774097	LINE/L2	831	-	291	49773806	21763
chr19	35168139	35368139	harbor2	chr19	35168166	35168571	LINE/L2	693	-	202	35168368	229
chr19	48530447	48730447	harbor2	chr19	48549529	48549881	LINE/L2	781	-	176	48549705	19258
chr19	48530447	48730447	harbor2	chr19	48577731	48577930	LINE/L2	697	-	100	48577831	47384
chr19	48530447	48730447	harbor2	chr19	48588604	48589545	LINE/L2	1415	-	470	48589074	58627
chr19	5522870	5722870	harbor2	chr19	5532241	5532315	LINE/L2	1670	-	37	5532278	9408
chr19	5522870	5722870	harbor2	chr19	5532618	5532793	LINE/L2	1670	-	88	5532706	9836
chr19	5522870	5722870	harbor2	chr19	5533315	5533637	LINE/L2	1670	-	161	5533476	10606
chr19	5522870	5722870	harbor2	chr19	5562444	5562649	LINE/L2	956	-	102	5562546	39676
chr19	5522870	5722870	harbor2	chr19	5562947	5563464	LINE/L2	956	-	258	5563205	40335
chr19	58351599	58551599	harbor2	chr19	58441187	58441695	LINE/L2	692	-	254	58441441	89842
chr19	46921885	47121885	harbor2	chr19	46953065	46953453	LINE/L2	1276	-	194	46953259	31374
chr19	58419902	58619902	harbor2	chr19	58441187	58441695	LINE/L2	692	-	254	58441441	21539
chr19	49758607	49958607	harbor2	chr19	49768871	49768968	LINE/L2	818	-	48	49768919	10312
chr19	49758607	49958607	harbor2	chr19	49769278	49769881	LINE/L2	1108	-	302	49769580	10973
chr19	49758607	49958607	harbor2	chr19	49770169	49770245	LINE/L2	1108	-	38	49770207	11600
chr19	49758607	49958607	harbor2	chr19	49773515	49774097	LINE/L2	831	-	291	49773806	15199
chr19	5522873	5722873	harbor2	chr19	5532241	5532315	LINE/L2	1670	-	37	5532278	9405
chr19	5522873	5722873	harbor2	chr19	5532618	5532793	LINE/L2	1670	-	88	5532706	9833
chr19	5522873	5722873	harbor2	chr19	5533315	5533637	LINE/L2	1670	-	161	5533476	10603
chr19	5522873	5722873	harbor2	chr19	5562444	5562649	LINE/L2	956	-	102	5562546	39673
chr19	5522873	5722873	harbor2	chr19	5562947	5563464	LINE/L2	956	-	258	5563205	40332
chr19	49753274	49953274	harbor2	chr19	49768871	49768968	LINE/L2	818	-	48	49768919	15645
chr19	49753274	49953274	harbor2	chr19	49769278	49769881	LINE/L2	1108	-	302	49769580	16306
chr19	49753274	49953274	harbor2	chr19	49770169	49770245	LINE/L2	1108	-	38	49770207	16933
chr19	49753274	49953274	harbor2	chr19	49773515	49774097	LINE/L2	831	-	291	49773806	20532
chr19	45369318	45569318	harbor2	chr19	45417167	45417622	LINE/L2	1203	-	228	45417395	48077
chr19	45369318	45569318	harbor2	chr19	45424217	45424524	LINE/L2	827	-	154	45424371	55053
chr19	45369318	45569318	harbor2	chr19	45445316	45445885	LINE/L2	1298	-	284	45445600	76282
chr19	45369318	45569318	harbor2	chr19	45446199	45446380	LINE/L2	766	-	90	45446289	76971
chr19	45369318	45569318	harbor2	chr19	45460467	45460833	LINE/L2	1152	-	183	45460650	91332
chr19	49752476	49952476	harbor2	chr19	49768871	49768968	LINE/L2	818	-	48	49768919	16443
chr19	49752476	49952476	harbor2	chr19	49769278	49769881	LINE/L2	1108	-	302	49769580	17104
chr19	49752476	49952476	harbor2	chr19	49770169	49770245	LINE/L2	1108	-	38	49770207	17731
chr19	49752476	49952476	harbor2	chr19	49773515	49774097	LINE/L2	831	-	291	49773806	21330
chr19	18336331	18536331	harbor2	chr19	18401034	18401261	LINE/L2	734	-	114	18401148	64817
chr19	18336331	18536331	harbor2	chr19	18401589	18401714	LINE/L2	734	-	62	18401651	65320
chr19	18336331	18536331	harbor2	chr19	18410897	18410992	LINE/L2	730	-	48	18410945	74614
chr19	18336331	18536331	harbor2	chr19	18411127	18411210	LINE/L2	730	-	42	18411169	74838
chr19	18336331	18536331	harbor2	chr19	18411509	18411691	LINE/L2	730	-	91	18411600	75269
chr19	5522872	5722872	harbor2	chr19	5532241	5532315	LINE/L2	1670	-	37	5532278	9406
chr19	5522872	5722872	harbor2	chr19	5532618	5532793	LINE/L2	1670	-	88	5532706	9834
chr19	5522872	5722872	harbor2	chr19	5533315	5533637	LINE/L2	1670	-	161	5533476	10604
chr19	5522872	5722872	harbor2	chr19	5562444	5562649	LINE/L2	956	-	102	5562546	39674
chr19	5522872	5722872	harbor2	chr19	5562947	5563464	LINE/L2	956	-	258	5563205	40333
chr19	5522856	5722856	harbor2	chr19	5532241	5532315	LINE/L2	1670	-	37	5532278	9422
chr19	5522856	5722856	harbor2	chr19	5532618	5532793	LINE/L2	1670	-	88	5532706	9850
chr19	5522856	5722856	harbor2	chr19	5533315	5533637	LINE/L2	1670	-	161	5533476	10620
chr19	5522856	5722856	harbor2	chr19	5562444	5562649	LINE/L2	956	-	102	5562546	39690
chr19	5522856	5722856	harbor2	chr19	5562947	5563464	LINE/L2	956	-	258	5563205	40349
chr19	5522869	5722869	harbor2	chr19	5532241	5532315	LINE/L2	1670	-	37	5532278	9409
chr19	5522869	5722869	harbor2	chr19	5532618	5532793	LINE/L2	1670	-	88	5532706	9837
chr19	5522869	5722869	harbor2	chr19	5533315	5533637	LINE/L2	1670	-	161	5533476	10607
chr19	5522869	5722869	harbor2	chr19	5562444	5562649	LINE/L2	956	-	102	5562546	39677
chr19	5522869	5722869	harbor2	chr19	5562947	5563464	LINE/L2	956	-	258	5563205	40336
chr19	49752191	49952191	harbor2	chr19	49768871	49768968	LINE/L2	818	-	48	49768919	16728
chr19	49752191	49952191	harbor2	chr19	49769278	49769881	LINE/L2	1108	-	302	49769580	17389
chr19	49752191	49952191	harbor2	chr19	49770169	49770245	LINE/L2	1108	-	38	49770207	18016
chr19	49752191	49952191	harbor2	chr19	49773515	49774097	LINE/L2	831	-	291	49773806	21615
chr19	3558396	3758396	harbor2	chr19	3624205	3624660	LINE/L2	968	-	228	3624433	66037
chr19	49290589	49490589	harbor2	chr19	49327554	49328112	LINE/L2	2692	-	279	49327833	37244
chr19	49290589	49490589	harbor2	chr19	49328467	49328629	LINE/L2	2692	-	81	49328548	37959
chr19	49290589	49490589	harbor2	chr19	49329452	49329501	LINE/L2	2692	-	24	49329476	38887
chr19	49290589	49490589	harbor2	chr19	49330127	49330549	LINE/L2	2692	-	211	49330338	39749
chr19	49290589	49490589	harbor2	chr19	49381324	49381886	LINE/L2	720	-	281	49381605	91016
chr19	12939635	13139635	harbor2	chr19	12965023	12965417	LINE/L2	1003	-	197	12965220	25585
chr19	6273407	6473407	harbor2	chr19	6369010	6369140	LINE/L2	737	-	65	6369075	95668
chr19	6273407	6473407	harbor2	chr19	6369443	6369708	LINE/L2	737	-	132	6369575	96168
chr19	6273407	6473407	harbor2	chr19	6370567	6370802	LINE/L2	692	-	118	6370685	97278
chr19	10618443	10818443	harbor2	chr19	10620577	10620763	LINE/L2	1164	-	93	10620670	2227
chr19	10618443	10818443	harbor2	chr19	10621382	10621424	LINE/L2	1164	-	21	10621403	2960
chr19	10618443	10818443	harbor2	chr19	10622062	10622534	LINE/L2	1164	-	236	10622298	3855
chr19	48865235	49065235	harbor2	chr19	48956481	48956646	LINE/L2	1026	-	82	48956563	91328
chr19	48865235	49065235	harbor2	chr19	48956964	48957254	LINE/L2	1026	-	145	48957109	91874
chr19	48865235	49065235	harbor2	chr19	48957575	48957677	LINE/L2	863	-	51	48957626	92391
chr19	50588275	50788275	harbor2	chr19	50643660	50644079	LINE/L2	768	-	210	50643870	55595
chr19	50588275	50788275	harbor2	chr19	50676319	50676557	LINE/L2	1161	-	119	50676438	88163
chr19	50588275	50788275	harbor2	chr19	50675513	50675720	LINE/L2	1161	-	104	50675617	87342
chr19	42117803	42317803	harbor2	chr19	42166961	42167172	LINE/L2	811	-	106	42167067	49264
chr19	42117803	42317803	harbor2	chr19	42167478	42167719	LINE/L2	811	-	120	42167598	49795
chr19	42117803	42317803	harbor2	chr19	42186602	42187181	LINE/L2	796	-	290	42186892	69089
chr19	42117803	42317803	harbor2	chr19	42187781	42187855	LINE/L2	796	-	37	42187818	70015
chr19	42117803	42317803	harbor2	chr19	42192055	42192348	LINE/L2	662	-	146	42192201	74398
chr19	49752678	49952678	harbor2	chr19	49768871	49768968	LINE/L2	818	-	48	49768919	16241
chr19	49752678	49952678	harbor2	chr19	49769278	49769881	LINE/L2	1108	-	302	49769580	16902
chr19	49752678	49952678	harbor2	chr19	49770169	49770245	LINE/L2	1108	-	38	49770207	17529
chr19	49752678	49952678	harbor2	chr19	49773515	49774097	LINE/L2	831	-	291	49773806	21128
chr19	51470868	51670868	harbor2	chr19	51479413	51479786	LINE/L2	850	-	186	51479599	8731
chr19	12672571	12872571	harbor2	chr19	12716190	12716342	LINE/L2	773	-	76	12716266	43695
chr19	12672571	12872571	harbor2	chr19	12716651	12716932	LINE/L2	773	-	140	12716791	44220
chr19	12672571	12872571	harbor2	chr19	12738818	12739170	LINE/L2	1255	-	176	12738994	66423
chr19	12672571	12872571	harbor2	chr19	12739458	12739760	LINE/L2	1255	-	151	12739609	67038
chr19	10618435	10818435	harbor2	chr19	10620577	10620763	LINE/L2	1164	-	93	10620670	2235
chr19	10618435	10818435	harbor2	chr19	10621382	10621424	LINE/L2	1164	-	21	10621403	2968
chr19	10618435	10818435	harbor2	chr19	10622062	10622534	LINE/L2	1164	-	236	10622298	3863
chr19	10618491	10818491	harbor2	chr19	10620577	10620763	LINE/L2	1164	-	93	10620670	2179
chr19	10618491	10818491	harbor2	chr19	10621382	10621424	LINE/L2	1164	-	21	10621403	2912
chr19	10618491	10818491	harbor2	chr19	10622062	10622534	LINE/L2	1164	-	236	10622298	3807
chr19	12938720	13138720	harbor2	chr19	12965023	12965417	LINE/L2	1003	-	197	12965220	26500
chr19	48529547	48729547	harbor2	chr19	48549529	48549881	LINE/L2	781	-	176	48549705	20158
chr19	48529547	48729547	harbor2	chr19	48577731	48577930	LINE/L2	697	-	100	48577831	48284
chr19	48529547	48729547	harbor2	chr19	48588604	48589545	LINE/L2	1415	-	470	48589074	59527
chr19	49752531	49952531	harbor2	chr19	49768871	49768968	LINE/L2	818	-	48	49768919	16388
chr19	49752531	49952531	harbor2	chr19	49769278	49769881	LINE/L2	1108	-	302	49769580	17049
chr19	49752531	49952531	harbor2	chr19	49770169	49770245	LINE/L2	1108	-	38	49770207	17676
chr19	49752531	49952531	harbor2	chr19	49773515	49774097	LINE/L2	831	-	291	49773806	21275
chr19	45895387	46095387	harbor2	chr19	45907676	45907772	LINE/L2	1008	-	48	45907724	12337
chr19	45895387	46095387	harbor2	chr19	45908782	45909273	LINE/L2	1318	-	246	45909028	13641
chr19	45895387	46095387	harbor2	chr19	45909883	45910093	LINE/L2	1318	-	105	45909988	14601
chr19	45895387	46095387	harbor2	chr19	45922125	45922690	LINE/L2	828	-	282	45922407	27020
chr19	45895387	46095387	harbor2	chr19	45961765	45962264	LINE/L2	893	-	250	45962015	66628
chr19	45895387	46095387	harbor2	chr19	45979218	45979467	LINE/L2	1783	-	124	45979342	83955
chr19	45895387	46095387	harbor2	chr19	45979790	45980080	LINE/L2	1783	-	145	45979935	84548
chr19	45895387	46095387	harbor2	chr19	45980341	45980464	LINE/L2	800	-	62	45980403	85016
chr19	45895387	46095387	harbor2	chr19	45980944	45981098	LINE/L2	800	-	77	45981021	85634
chr19	5522842	5722842	harbor2	chr19	5532241	5532315	LINE/L2	1670	-	37	5532278	9436
chr19	5522842	5722842	harbor2	chr19	5532618	5532793	LINE/L2	1670	-	88	5532706	9864
chr19	5522842	5722842	harbor2	chr19	5533315	5533637	LINE/L2	1670	-	161	5533476	10634
chr19	5522842	5722842	harbor2	chr19	5562444	5562649	LINE/L2	956	-	102	5562546	39704
chr19	5522842	5722842	harbor2	chr19	5562947	5563464	LINE/L2	956	-	258	5563205	40363
chr19	1812988	2012988	harbor2	chr19	1850169	1850438	LINE/L2	1015	-	134	1850303	37315
chr19	1812988	2012988	harbor2	chr19	1850751	1851356	LINE/L2	1505	-	302	1851053	38065
chr19	10619540	10819540	harbor2	chr19	10620577	10620763	LINE/L2	1164	-	93	10620670	1130
chr19	10619540	10819540	harbor2	chr19	10621382	10621424	LINE/L2	1164	-	21	10621403	1863
chr19	10619540	10819540	harbor2	chr19	10622062	10622534	LINE/L2	1164	-	236	10622298	2758
chr19	49755720	49955720	harbor2	chr19	49768871	49768968	LINE/L2	818	-	48	49768919	13199
chr19	49755720	49955720	harbor2	chr19	49769278	49769881	LINE/L2	1108	-	302	49769580	13860
chr19	49755720	49955720	harbor2	chr19	49770169	49770245	LINE/L2	1108	-	38	49770207	14487
chr19	49755720	49955720	harbor2	chr19	49773515	49774097	LINE/L2	831	-	291	49773806	18086
chr19	12938715	13138715	harbor2	chr19	12965023	12965417	LINE/L2	1003	-	197	12965220	26505
chr19	57145103	57345103	harbor2	chr19	57165822	57166323	LINE/L2	720	-	250	57166072	20969
chr19	57145103	57345103	harbor2	chr19	57166608	57167005	LINE/L2	720	-	198	57166806	21703
chr19	57145103	57345103	harbor2	chr19	57185051	57185107	LINE/L2	641	-	28	57185079	39976
chr19	57145103	57345103	harbor2	chr19	57185423	57185726	LINE/L2	641	-	152	57185575	40472
chr19	5525874	5725874	harbor2	chr19	5532241	5532315	LINE/L2	1670	-	37	5532278	6404
chr19	5525874	5725874	harbor2	chr19	5532618	5532793	LINE/L2	1670	-	88	5532706	6832
chr19	5525874	5725874	harbor2	chr19	5533315	5533637	LINE/L2	1670	-	161	5533476	7602
chr19	5525874	5725874	harbor2	chr19	5562444	5562649	LINE/L2	956	-	102	5562546	36672
chr19	5525874	5725874	harbor2	chr19	5562947	5563464	LINE/L2	956	-	258	5563205	37331
chr19	2670207	2870207	harbor2	chr19	2742648	2742857	LINE/L2	854	-	104	2742752	72545
chr19	2670207	2870207	harbor2	chr19	2742990	2743266	LINE/L2	854	-	138	2743128	72921
chr19	10659895	10859895	harbor2	chr19	10747924	10748387	LINE/L2	822	-	232	10748156	88261
chr19	17167457	17367457	harbor2	chr19	17238218	17238515	LINE/L2	681	-	148	17238366	70909
chr19	49759899	49959899	harbor2	chr19	49768871	49768968	LINE/L2	818	-	48	49768919	9020
chr19	49759899	49959899	harbor2	chr19	49769278	49769881	LINE/L2	1108	-	302	49769580	9681
chr19	49759899	49959899	harbor2	chr19	49770169	49770245	LINE/L2	1108	-	38	49770207	10308
chr19	49759899	49959899	harbor2	chr19	49773515	49774097	LINE/L2	831	-	291	49773806	13907
chr19	12939660	13139660	harbor2	chr19	12965023	12965417	LINE/L2	1003	-	197	12965220	25560
chr19	44902158	45102158	harbor2	chr19	44957816	44958369	LINE/L2	1362	-	276	44958092	55934
chr19	49757500	49957500	harbor2	chr19	49768871	49768968	LINE/L2	818	-	48	49768919	11419
chr19	49757500	49957500	harbor2	chr19	49769278	49769881	LINE/L2	1108	-	302	49769580	12080
chr19	49757500	49957500	harbor2	chr19	49770169	49770245	LINE/L2	1108	-	38	49770207	12707
chr19	49757500	49957500	harbor2	chr19	49773515	49774097	LINE/L2	831	-	291	49773806	16306
chr19	57142619	57342619	harbor2	chr19	57165822	57166323	LINE/L2	720	-	250	57166072	23453
chr19	57142619	57342619	harbor2	chr19	57166608	57167005	LINE/L2	720	-	198	57166806	24187
chr19	57142619	57342619	harbor2	chr19	57185051	57185107	LINE/L2	641	-	28	57185079	42460
chr19	57142619	57342619	harbor2	chr19	57185423	57185726	LINE/L2	641	-	152	57185575	42956
chr19	10736679	10936679	harbor2	chr19	10747924	10748387	LINE/L2	822	-	232	10748156	11477
chr19	10736679	10936679	harbor2	chr19	10788255	10788586	LINE/L2	706	-	166	10788421	51742
chr19	10736679	10936679	harbor2	chr19	10820313	10820865	LINE/L2	782	-	276	10820589	83910
chr19	6325327	6525327	harbor2	chr19	6369010	6369140	LINE/L2	737	-	65	6369075	43748
chr19	6325327	6525327	harbor2	chr19	6369443	6369708	LINE/L2	737	-	132	6369575	44248
chr19	6325327	6525327	harbor2	chr19	6370567	6370802	LINE/L2	692	-	118	6370685	45358
chr19	57140879	57340879	harbor2	chr19	57165822	57166323	LINE/L2	720	-	250	57166072	25193
chr19	57140879	57340879	harbor2	chr19	57166608	57167005	LINE/L2	720	-	198	57166806	25927
chr19	57140879	57340879	harbor2	chr19	57185051	57185107	LINE/L2	641	-	28	57185079	44200
chr19	57140879	57340879	harbor2	chr19	57185423	57185726	LINE/L2	641	-	152	57185575	44696
chr19	49751329	49951329	harbor2	chr19	49768871	49768968	LINE/L2	818	-	48	49768919	17590
chr19	49751329	49951329	harbor2	chr19	49769278	49769881	LINE/L2	1108	-	302	49769580	18251
chr19	49751329	49951329	harbor2	chr19	49770169	49770245	LINE/L2	1108	-	38	49770207	18878
chr19	49751329	49951329	harbor2	chr19	49773515	49774097	LINE/L2	831	-	291	49773806	22477
chr19	10724040	10924040	harbor2	chr19	10747924	10748387	LINE/L2	822	-	232	10748156	24116
chr19	10724040	10924040	harbor2	chr19	10788255	10788586	LINE/L2	706	-	166	10788421	64381
chr19	10724040	10924040	harbor2	chr19	10820313	10820865	LINE/L2	782	-	276	10820589	96549
chr19	49751356	49951356	harbor2	chr19	49768871	49768968	LINE/L2	818	-	48	49768919	17563
chr19	49751356	49951356	harbor2	chr19	49769278	49769881	LINE/L2	1108	-	302	49769580	18224
chr19	49751356	49951356	harbor2	chr19	49770169	49770245	LINE/L2	1108	-	38	49770207	18851
chr19	49751356	49951356	harbor2	chr19	49773515	49774097	LINE/L2	831	-	291	49773806	22450
chr19	50276756	50476756	harbor2	chr19	50277037	50277331	LINE/L2	1152	-	147	50277184	428
chr19	50276756	50476756	harbor2	chr19	50277934	50278043	LINE/L2	1194	-	54	50277988	1232
chr19	50276756	50476756	harbor2	chr19	50307875	50308272	LINE/L2	1150	-	198	50308073	31317
chr19	10736092	10936092	harbor2	chr19	10747924	10748387	LINE/L2	822	-	232	10748156	12064
chr19	10736092	10936092	harbor2	chr19	10788255	10788586	LINE/L2	706	-	166	10788421	52329
chr19	10736092	10936092	harbor2	chr19	10820313	10820865	LINE/L2	782	-	276	10820589	84497
chr19	1763772	1963772	harbor2	chr19	1850169	1850438	LINE/L2	1015	-	134	1850303	86531
chr19	1763772	1963772	harbor2	chr19	1850751	1851356	LINE/L2	1505	-	302	1851053	87281
chr19	49752522	49952522	harbor2	chr19	49768871	49768968	LINE/L2	818	-	48	49768919	16397
chr19	49752522	49952522	harbor2	chr19	49769278	49769881	LINE/L2	1108	-	302	49769580	17058
chr19	49752522	49952522	harbor2	chr19	49770169	49770245	LINE/L2	1108	-	38	49770207	17685
chr19	49752522	49952522	harbor2	chr19	49773515	49774097	LINE/L2	831	-	291	49773806	21284
chr19	50172311	50372311	harbor2	chr19	50173444	50173800	LINE/L2	1038	-	178	50173622	1311
chr19	50172311	50372311	harbor2	chr19	50192610	50193379	LINE/L2	1620	-	384	50192994	20683
chr19	50172311	50372311	harbor2	chr19	50197051	50197066	LINE/L2	1166	-	8	50197059	24748
chr19	50172311	50372311	harbor2	chr19	50197215	50197819	LINE/L2	1166	-	302	50197517	25206
chr19	50172311	50372311	harbor2	chr19	50201916	50202506	LINE/L2	1267	-	295	50202211	29900
chr19	50172311	50372311	harbor2	chr19	50232149	50232310	LINE/L2	856	-	80	50232229	59918
chr19	50172311	50372311	harbor2	chr19	50232623	50232833	LINE/L2	856	-	105	50232728	60417
chr19	50172311	50372311	harbor2	chr19	50247695	50247783	LINE/L2	851	-	44	50247739	75428
chr19	50172311	50372311	harbor2	chr19	50248090	50248429	LINE/L2	851	-	170	50248260	75949
chr19	49292104	49492104	harbor2	chr19	49327554	49328112	LINE/L2	2692	-	279	49327833	35729
chr19	49292104	49492104	harbor2	chr19	49328467	49328629	LINE/L2	2692	-	81	49328548	36444
chr19	49292104	49492104	harbor2	chr19	49329452	49329501	LINE/L2	2692	-	24	49329476	37372
chr19	49292104	49492104	harbor2	chr19	49330127	49330549	LINE/L2	2692	-	211	49330338	38234
chr19	49292104	49492104	harbor2	chr19	49381324	49381886	LINE/L2	720	-	281	49381605	89501
chr19	5522865	5722865	harbor2	chr19	5532241	5532315	LINE/L2	1670	-	37	5532278	9413
chr19	5522865	5722865	harbor2	chr19	5532618	5532793	LINE/L2	1670	-	88	5532706	9841
chr19	5522865	5722865	harbor2	chr19	5533315	5533637	LINE/L2	1670	-	161	5533476	10611
chr19	5522865	5722865	harbor2	chr19	5562444	5562649	LINE/L2	956	-	102	5562546	39681
chr19	5522865	5722865	harbor2	chr19	5562947	5563464	LINE/L2	956	-	258	5563205	40340
chr19	5523143	5723143	harbor2	chr19	5532241	5532315	LINE/L2	1670	-	37	5532278	9135
chr19	5523143	5723143	harbor2	chr19	5532618	5532793	LINE/L2	1670	-	88	5532706	9563
chr19	5523143	5723143	harbor2	chr19	5533315	5533637	LINE/L2	1670	-	161	5533476	10333
chr19	5523143	5723143	harbor2	chr19	5562444	5562649	LINE/L2	956	-	102	5562546	39403
chr19	5523143	5723143	harbor2	chr19	5562947	5563464	LINE/L2	956	-	258	5563205	40062
chr19	10618409	10818409	harbor2	chr19	10620577	10620763	LINE/L2	1164	-	93	10620670	2261
chr19	10618409	10818409	harbor2	chr19	10621382	10621424	LINE/L2	1164	-	21	10621403	2994
chr19	10618409	10818409	harbor2	chr19	10622062	10622534	LINE/L2	1164	-	236	10622298	3889
chr19	5522817	5722817	harbor2	chr19	5532241	5532315	LINE/L2	1670	-	37	5532278	9461
chr19	5522817	5722817	harbor2	chr19	5532618	5532793	LINE/L2	1670	-	88	5532706	9889
chr19	5522817	5722817	harbor2	chr19	5533315	5533637	LINE/L2	1670	-	161	5533476	10659
chr19	5522817	5722817	harbor2	chr19	5562444	5562649	LINE/L2	956	-	102	5562546	39729
chr19	5522817	5722817	harbor2	chr19	5562947	5563464	LINE/L2	956	-	258	5563205	40388
chr19	39408221	39608221	harbor2	chr19	39446252	39446619	LINE/L2	920	-	184	39446436	38215
chr19	39408221	39608221	harbor2	chr19	39465238	39465505	LINE/L2	1040	-	134	39465372	57151
chr19	39408221	39608221	harbor2	chr19	39465726	39465840	LINE/L2	1040	-	57	39465783	57562
chr19	39408221	39608221	harbor2	chr19	39466057	39466359	LINE/L2	1040	-	151	39466208	57987
chr19	39408221	39608221	harbor2	chr19	39471918	39472244	LINE/L2	809	-	163	39472081	63860
chr19	39408221	39608221	harbor2	chr19	39474778	39475105	LINE/L2	830	-	164	39474942	66721
chr19	39408221	39608221	harbor2	chr19	39475407	39475544	LINE/L2	830	-	68	39475475	67254
chr19	35543573	35743573	harbor2	chr19	35555927	35556375	LINE/L2	1340	-	224	35556151	12578
chr19	35543573	35743573	harbor2	chr19	35606859	35607078	LINE/L2	663	-	110	35606969	63396
chr19	35543573	35743573	harbor2	chr19	35630328	35630484	LINE/L2	638	-	78	35630406	86833
chr19	5522852	5722852	harbor2	chr19	5532241	5532315	LINE/L2	1670	-	37	5532278	9426
chr19	5522852	5722852	harbor2	chr19	5532618	5532793	LINE/L2	1670	-	88	5532706	9854
chr19	5522852	5722852	harbor2	chr19	5533315	5533637	LINE/L2	1670	-	161	5533476	10624
chr19	5522852	5722852	harbor2	chr19	5562444	5562649	LINE/L2	956	-	102	5562546	39694
chr19	5522852	5722852	harbor2	chr19	5562947	5563464	LINE/L2	956	-	258	5563205	40353
chr19	10717506	10917506	harbor2	chr19	10747924	10748387	LINE/L2	822	-	232	10748156	30650
chr19	10717506	10917506	harbor2	chr19	10788255	10788586	LINE/L2	706	-	166	10788421	70915
chr19	57180316	57380316	harbor2	chr19	57185051	57185107	LINE/L2	641	-	28	57185079	4763
chr19	57180316	57380316	harbor2	chr19	57185423	57185726	LINE/L2	641	-	152	57185575	5259
chr19	5878158	6078158	harbor2	chr19	5889708	5890271	LINE/L2	668	-	282	5889990	11832
chr19	5878158	6078158	harbor2	chr19	5975513	5975964	LINE/L2	1321	-	226	5975739	97581
chr19	5878158	6078158	harbor2	chr19	5976025	5976348	LINE/L2	854	-	162	5976187	98029
chr19	15092197	15292197	harbor2	chr19	15150328	15150834	LINE/L2	643	-	253	15150581	58384
chr19	15092197	15292197	harbor2	chr19	15175063	15175250	LINE/L2	1042	-	94	15175157	82960
chr19	15092197	15292197	harbor2	chr19	15175554	15175590	LINE/L2	1042	-	18	15175572	83375
chr19	15092197	15292197	harbor2	chr19	15175628	15175918	LINE/L2	1042	-	145	15175773	83576
chr19	10019525	10219525	harbor2	chr19	10067912	10068234	LINE/L2	801	-	161	10068073	48548
chr19	10019525	10219525	harbor2	chr19	10068535	10068545	LINE/L2	801	-	5	10068540	49015
chr19	10019525	10219525	harbor2	chr19	10069349	10069573	LINE/L2	777	-	112	10069461	49936
chr19	10019525	10219525	harbor2	chr19	10069859	10070092	LINE/L2	777	-	116	10069975	50450
chr19	10019525	10219525	harbor2	chr19	10100607	10100840	LINE/L2	743	-	116	10100723	81198
chr19	49769383	49969383	harbor2	chr19	49769278	49769881	LINE/L2	1108	-	302	49769580	197
chr19	49769383	49969383	harbor2	chr19	49770169	49770245	LINE/L2	1108	-	38	49770207	824
chr19	49769383	49969383	harbor2	chr19	49773515	49774097	LINE/L2	831	-	291	49773806	4423
chr19	10619009	10819009	harbor2	chr19	10620577	10620763	LINE/L2	1164	-	93	10620670	1661
chr19	10619009	10819009	harbor2	chr19	10621382	10621424	LINE/L2	1164	-	21	10621403	2394
chr19	10619009	10819009	harbor2	chr19	10622062	10622534	LINE/L2	1164	-	236	10622298	3289
chr19	5522878	5722878	harbor2	chr19	5532241	5532315	LINE/L2	1670	-	37	5532278	9400
chr19	5522878	5722878	harbor2	chr19	5532618	5532793	LINE/L2	1670	-	88	5532706	9828
chr19	5522878	5722878	harbor2	chr19	5533315	5533637	LINE/L2	1670	-	161	5533476	10598
chr19	5522878	5722878	harbor2	chr19	5562444	5562649	LINE/L2	956	-	102	5562546	39668
chr19	5522878	5722878	harbor2	chr19	5562947	5563464	LINE/L2	956	-	258	5563205	40327
chr19	5523688	5723688	harbor2	chr19	5532241	5532315	LINE/L2	1670	-	37	5532278	8590
chr19	5523688	5723688	harbor2	chr19	5532618	5532793	LINE/L2	1670	-	88	5532706	9018
chr19	5523688	5723688	harbor2	chr19	5533315	5533637	LINE/L2	1670	-	161	5533476	9788
chr19	5523688	5723688	harbor2	chr19	5562444	5562649	LINE/L2	956	-	102	5562546	38858
chr19	5523688	5723688	harbor2	chr19	5562947	5563464	LINE/L2	956	-	258	5563205	39517
chr19	49752111	49952111	harbor2	chr19	49768871	49768968	LINE/L2	818	-	48	49768919	16808
chr19	49752111	49952111	harbor2	chr19	49769278	49769881	LINE/L2	1108	-	302	49769580	17469
chr19	49752111	49952111	harbor2	chr19	49770169	49770245	LINE/L2	1108	-	38	49770207	18096
chr19	49752111	49952111	harbor2	chr19	49773515	49774097	LINE/L2	831	-	291	49773806	21695
chr19	3323755	3523755	harbor2	chr19	3344803	3345105	LINE/L2	801	-	151	3344954	21199
chr19	3323755	3523755	harbor2	chr19	3400098	3400193	LINE/L2	1581	-	48	3400146	76391
chr19	3323755	3523755	harbor2	chr19	3400490	3400564	LINE/L2	1581	-	37	3400527	76772
chr19	3323755	3523755	harbor2	chr19	3400872	3401416	LINE/L2	1581	-	272	3401144	77389
chr19	3323755	3523755	harbor2	chr19	3402443	3402930	LINE/L2	1364	-	244	3402687	78932
chr19	3323755	3523755	harbor2	chr19	3406828	3407096	LINE/L2	851	-	134	3406962	83207
chr19	3323755	3523755	harbor2	chr19	3410345	3410697	LINE/L2	999	-	176	3410521	86766
chr19	5523194	5723194	harbor2	chr19	5532241	5532315	LINE/L2	1670	-	37	5532278	9084
chr19	5523194	5723194	harbor2	chr19	5532618	5532793	LINE/L2	1670	-	88	5532706	9512
chr19	5523194	5723194	harbor2	chr19	5533315	5533637	LINE/L2	1670	-	161	5533476	10282
chr19	5523194	5723194	harbor2	chr19	5562444	5562649	LINE/L2	956	-	102	5562546	39352
chr19	5523194	5723194	harbor2	chr19	5562947	5563464	LINE/L2	956	-	258	5563205	40011
chr19	57180327	57380327	harbor2	chr19	57185051	57185107	LINE/L2	641	-	28	57185079	4752
chr19	57180327	57380327	harbor2	chr19	57185423	57185726	LINE/L2	641	-	152	57185575	5248
chr19	42234251	42434251	harbor2	chr19	42275826	42276360	LINE/L2	860	-	267	42276093	41842
chr19	58394774	58594774	harbor2	chr19	58441187	58441695	LINE/L2	692	-	254	58441441	46667
chr19	10619476	10819476	harbor2	chr19	10620577	10620763	LINE/L2	1164	-	93	10620670	1194
chr19	10619476	10819476	harbor2	chr19	10621382	10621424	LINE/L2	1164	-	21	10621403	1927
chr19	10619476	10819476	harbor2	chr19	10622062	10622534	LINE/L2	1164	-	236	10622298	2822
chr19	10735497	10935497	harbor2	chr19	10747924	10748387	LINE/L2	822	-	232	10748156	12659
chr19	10735497	10935497	harbor2	chr19	10788255	10788586	LINE/L2	706	-	166	10788421	52924
chr19	10735497	10935497	harbor2	chr19	10820313	10820865	LINE/L2	782	-	276	10820589	85092
chr19	33077036	33277036	harbor2	chr19	33081373	33081885	LINE/L2	1000	-	256	33081629	4593
chr19	33077036	33277036	harbor2	chr19	33082008	33082274	LINE/L2	1000	-	133	33082141	5105
chr19	33077036	33277036	harbor2	chr19	33172519	33172808	LINE/L2	936	-	144	33172663	95627
chr19	33077036	33277036	harbor2	chr19	33173122	33173217	LINE/L2	936	-	48	33173170	96134
chr19	5523154	5723154	harbor2	chr19	5532241	5532315	LINE/L2	1670	-	37	5532278	9124
chr19	5523154	5723154	harbor2	chr19	5532618	5532793	LINE/L2	1670	-	88	5532706	9552
chr19	5523154	5723154	harbor2	chr19	5533315	5533637	LINE/L2	1670	-	161	5533476	10322
chr19	5523154	5723154	harbor2	chr19	5562444	5562649	LINE/L2	956	-	102	5562546	39392
chr19	5523154	5723154	harbor2	chr19	5562947	5563464	LINE/L2	956	-	258	5563205	40051
chr19	48529835	48729835	harbor2	chr19	48549529	48549881	LINE/L2	781	-	176	48549705	19870
chr19	48529835	48729835	harbor2	chr19	48577731	48577930	LINE/L2	697	-	100	48577831	47996
chr19	48529835	48729835	harbor2	chr19	48588604	48589545	LINE/L2	1415	-	470	48589074	59239
chr19	5522826	5722826	harbor2	chr19	5532241	5532315	LINE/L2	1670	-	37	5532278	9452
chr19	5522826	5722826	harbor2	chr19	5532618	5532793	LINE/L2	1670	-	88	5532706	9880
chr19	5522826	5722826	harbor2	chr19	5533315	5533637	LINE/L2	1670	-	161	5533476	10650
chr19	5522826	5722826	harbor2	chr19	5562444	5562649	LINE/L2	956	-	102	5562546	39720
chr19	5522826	5722826	harbor2	chr19	5562947	5563464	LINE/L2	956	-	258	5563205	40379
chr19	39746502	39946502	harbor2	chr19	39822284	39823213	LINE/L2	1200	-	464	39822748	76246
chr19	39746502	39946502	harbor2	chr19	39839432	39839808	LINE/L2	697	-	188	39839620	93118
chr19	4082590	4282590	harbor2	chr19	4139190	4139212	LINE/L2	716	-	11	4139201	56611
chr19	4082590	4282590	harbor2	chr19	4139518	4140150	LINE/L2	1021	-	316	4139834	57244
chr19	32997991	33197991	harbor2	chr19	32997791	32998075	LINE/L2	755	-	142	32997933	58
chr19	32997991	33197991	harbor2	chr19	33081373	33081885	LINE/L2	1000	-	256	33081629	83638
chr19	32997991	33197991	harbor2	chr19	33082008	33082274	LINE/L2	1000	-	133	33082141	84150
chr19	48648417	48848417	harbor2	chr19	48657973	48658070	LINE/L2	1178	-	48	48658021	9604
chr19	48648417	48848417	harbor2	chr19	48658367	48658609	LINE/L2	1178	-	121	48658488	10071
chr19	48648417	48848417	harbor2	chr19	48658904	48659193	LINE/L2	1178	-	144	48659048	10631
chr19	49752037	49952037	harbor2	chr19	49768871	49768968	LINE/L2	818	-	48	49768919	16882
chr19	49752037	49952037	harbor2	chr19	49769278	49769881	LINE/L2	1108	-	302	49769580	17543
chr19	49752037	49952037	harbor2	chr19	49770169	49770245	LINE/L2	1108	-	38	49770207	18170
chr19	49752037	49952037	harbor2	chr19	49773515	49774097	LINE/L2	831	-	291	49773806	21769
chr19	35168137	35368137	harbor2	chr19	35168166	35168571	LINE/L2	693	-	202	35168368	231
chr19	49752434	49952434	harbor2	chr19	49768871	49768968	LINE/L2	818	-	48	49768919	16485
chr19	49752434	49952434	harbor2	chr19	49769278	49769881	LINE/L2	1108	-	302	49769580	17146
chr19	49752434	49952434	harbor2	chr19	49770169	49770245	LINE/L2	1108	-	38	49770207	17773
chr19	49752434	49952434	harbor2	chr19	49773515	49774097	LINE/L2	831	-	291	49773806	21372
chr19	698632	898632	harbor2	chr19	737491	738101	LINE/L2	715	-	305	737796	39164
chr19	5620309	5820309	harbor2	chr19	5683455	5683609	LINE/L2	800	-	77	5683532	63223
chr19	5620309	5820309	harbor2	chr19	5683923	5683965	LINE/L2	800	-	21	5683944	63635
chr19	5620309	5820309	harbor2	chr19	5684315	5684729	LINE/L2	800	-	207	5684522	64213
chr19	58351584	58551584	harbor2	chr19	58441187	58441695	LINE/L2	692	-	254	58441441	89857
chr19	48529639	48729639	harbor2	chr19	48549529	48549881	LINE/L2	781	-	176	48549705	20066
chr19	48529639	48729639	harbor2	chr19	48577731	48577930	LINE/L2	697	-	100	48577831	48192
chr19	48529639	48729639	harbor2	chr19	48588604	48589545	LINE/L2	1415	-	470	48589074	59435
chr19	58399501	58599501	harbor2	chr19	58441187	58441695	LINE/L2	692	-	254	58441441	41940
chr19	49751281	49951281	harbor2	chr19	49768871	49768968	LINE/L2	818	-	48	49768919	17638
chr19	49751281	49951281	harbor2	chr19	49769278	49769881	LINE/L2	1108	-	302	49769580	18299
chr19	49751281	49951281	harbor2	chr19	49770169	49770245	LINE/L2	1108	-	38	49770207	18926
chr19	49751281	49951281	harbor2	chr19	49773515	49774097	LINE/L2	831	-	291	49773806	22525
chr19	36015441	36215441	harbor2	chr19	36050897	36051655	LINE/L2	1439	-	379	36051276	35835
chr19	36015441	36215441	harbor2	chr19	36060126	36060642	LINE/L2	662	-	258	36060384	44943
chr19	36015441	36215441	harbor2	chr19	36073607	36073948	LINE/L2	808	-	170	36073777	58336
chr19	36015441	36215441	harbor2	chr19	36082078	36082478	LINE/L2	674	-	200	36082278	66837
chr19	36015441	36215441	harbor2	chr19	36089866	36090192	LINE/L2	688	-	163	36090029	74588
chr19	45378520	45578520	harbor2	chr19	45417167	45417622	LINE/L2	1203	-	228	45417395	38875
chr19	45378520	45578520	harbor2	chr19	45424217	45424524	LINE/L2	827	-	154	45424371	45851
chr19	45378520	45578520	harbor2	chr19	45445316	45445885	LINE/L2	1298	-	284	45445600	67080
chr19	45378520	45578520	harbor2	chr19	45446199	45446380	LINE/L2	766	-	90	45446289	67769
chr19	45378520	45578520	harbor2	chr19	45460467	45460833	LINE/L2	1152	-	183	45460650	82130
chr19	45378520	45578520	harbor2	chr19	45476362	45476733	LINE/L2	800	-	186	45476548	98028
chr19	45378520	45578520	harbor2	chr19	45477061	45477508	LINE/L2	718	-	224	45477285	98765
chr19	28840757	29040757	harbor2	chr19	28931670	28932155	LINE/L2	748	-	242	28931912	91155
chr19	12938736	13138736	harbor2	chr19	12965023	12965417	LINE/L2	1003	-	197	12965220	26484
chr19	10735904	10935904	harbor2	chr19	10747924	10748387	LINE/L2	822	-	232	10748156	12252
chr19	10735904	10935904	harbor2	chr19	10788255	10788586	LINE/L2	706	-	166	10788421	52517
chr19	10735904	10935904	harbor2	chr19	10820313	10820865	LINE/L2	782	-	276	10820589	84685
chr19	44976314	45176314	harbor2	chr19	45033000	45033400	LINE/L2	1084	-	200	45033200	56886
chr19	5522874	5722874	harbor2	chr19	5532241	5532315	LINE/L2	1670	-	37	5532278	9404
chr19	5522874	5722874	harbor2	chr19	5532618	5532793	LINE/L2	1670	-	88	5532706	9832
chr19	5522874	5722874	harbor2	chr19	5533315	5533637	LINE/L2	1670	-	161	5533476	10602
chr19	5522874	5722874	harbor2	chr19	5562444	5562649	LINE/L2	956	-	102	5562546	39672
chr19	5522874	5722874	harbor2	chr19	5562947	5563464	LINE/L2	956	-	258	5563205	40331
chr19	49769630	49969630	harbor2	chr19	49769278	49769881	LINE/L2	1108	-	302	49769580	50
chr19	49769630	49969630	harbor2	chr19	49770169	49770245	LINE/L2	1108	-	38	49770207	577
chr19	49769630	49969630	harbor2	chr19	49773515	49774097	LINE/L2	831	-	291	49773806	4176
chr19	39309648	39509648	harbor2	chr19	39348173	39348903	LINE/L2	1072	-	365	39348538	38890
chr19	39309648	39509648	harbor2	chr19	39374875	39375495	LINE/L2	878	-	310	39375185	65537
chr19	39309648	39509648	harbor2	chr19	39400984	39401214	LINE/L2	638	-	115	39401099	91451
chr19	43363366	43563366	harbor2	chr19	43450870	43451004	LINE/L2	850	-	67	43450937	87571
chr19	43363366	43563366	harbor2	chr19	43452339	43452770	LINE/L2	850	-	216	43452555	89189
chr19	47128861	47328861	harbor2	chr19	47132936	47133218	LINE/L2	804	-	141	47133077	4216
chr19	47128861	47328861	harbor2	chr19	47133526	47133850	LINE/L2	804	-	162	47133688	4827
chr19	47128861	47328861	harbor2	chr19	47134161	47134262	LINE/L2	804	-	50	47134211	5350
chr19	13954255	14154255	harbor2	chr19	14050151	14050219	LINE/L2	899	-	34	14050185	95930
chr19	13954255	14154255	harbor2	chr19	14050536	14050718	LINE/L2	899	-	91	14050627	96372
chr19	3288000	3488000	harbor2	chr19	3291596	3291868	LINE/L2	742	-	136	3291732	3732
chr19	3288000	3488000	harbor2	chr19	3316083	3316830	LINE/L2	1267	-	374	3316457	28457
chr19	3288000	3488000	harbor2	chr19	3344803	3345105	LINE/L2	801	-	151	3344954	56954
chr19	5524144	5724144	harbor2	chr19	5532241	5532315	LINE/L2	1670	-	37	5532278	8134
chr19	5524144	5724144	harbor2	chr19	5532618	5532793	LINE/L2	1670	-	88	5532706	8562
chr19	5524144	5724144	harbor2	chr19	5533315	5533637	LINE/L2	1670	-	161	5533476	9332
chr19	5524144	5724144	harbor2	chr19	5562444	5562649	LINE/L2	956	-	102	5562546	38402
chr19	5524144	5724144	harbor2	chr19	5562947	5563464	LINE/L2	956	-	258	5563205	39061
chr19	12951095	13151095	harbor2	chr19	12965023	12965417	LINE/L2	1003	-	197	12965220	14125
chr19	50233658	50433658	harbor2	chr19	50247695	50247783	LINE/L2	851	-	44	50247739	14081
chr19	50233658	50433658	harbor2	chr19	50248090	50248429	LINE/L2	851	-	170	50248260	14602
chr19	50233658	50433658	harbor2	chr19	50277037	50277331	LINE/L2	1152	-	147	50277184	43526
chr19	50233658	50433658	harbor2	chr19	50277934	50278043	LINE/L2	1194	-	54	50277988	44330
chr19	50233658	50433658	harbor2	chr19	50307875	50308272	LINE/L2	1150	-	198	50308073	74415
chr19	45208744	45408744	harbor2	chr19	45218371	45218780	LINE/L2	715	-	204	45218575	9831
chr19	45208744	45408744	harbor2	chr19	45223266	45223340	LINE/L2	967	-	37	45223303	14559
chr19	45208744	45408744	harbor2	chr19	45223642	45223709	LINE/L2	967	-	34	45223676	14932
chr19	45208744	45408744	harbor2	chr19	45224006	45224320	LINE/L2	967	-	157	45224163	15419
chr19	45208744	45408744	harbor2	chr19	45298580	45298803	LINE/L2	875	-	112	45298692	89948
chr19	45208744	45408744	harbor2	chr19	45299091	45299155	LINE/L2	875	-	32	45299123	90379
chr19	45208744	45408744	harbor2	chr19	45299429	45299491	LINE/L2	875	-	31	45299460	90716
chr19	45208744	45408744	harbor2	chr19	45304609	45304853	LINE/L2	634	-	122	45304731	95987
chr19	10041331	10241331	harbor2	chr19	10067912	10068234	LINE/L2	801	-	161	10068073	26742
chr19	10041331	10241331	harbor2	chr19	10068535	10068545	LINE/L2	801	-	5	10068540	27209
chr19	10041331	10241331	harbor2	chr19	10069349	10069573	LINE/L2	777	-	112	10069461	28130
chr19	10041331	10241331	harbor2	chr19	10069859	10070092	LINE/L2	777	-	116	10069975	28644
chr19	10041331	10241331	harbor2	chr19	10100607	10100840	LINE/L2	743	-	116	10100723	59392
chr19	55516374	55716374	harbor2	chr19	55607880	55608312	LINE/L2	1003	-	216	55608096	91722
chr19	48956483	49156483	harbor2	chr19	48956481	48956646	LINE/L2	1026	-	82	48956563	80
chr19	48956483	49156483	harbor2	chr19	48956964	48957254	LINE/L2	1026	-	145	48957109	626
chr19	48956483	49156483	harbor2	chr19	48957575	48957677	LINE/L2	863	-	51	48957626	1143
chr19	48526239	48726239	harbor2	chr19	48549529	48549881	LINE/L2	781	-	176	48549705	23466
chr19	48526239	48726239	harbor2	chr19	48577731	48577930	LINE/L2	697	-	100	48577831	51592
chr19	48526239	48726239	harbor2	chr19	48588604	48589545	LINE/L2	1415	-	470	48589074	62835
chr19	18583553	18783553	harbor2	chr19	18603097	18603439	LINE/L2	679	-	171	18603268	19715
chr19	5522863	5722863	harbor2	chr19	5532241	5532315	LINE/L2	1670	-	37	5532278	9415
chr19	5522863	5722863	harbor2	chr19	5532618	5532793	LINE/L2	1670	-	88	5532706	9843
chr19	5522863	5722863	harbor2	chr19	5533315	5533637	LINE/L2	1670	-	161	5533476	10613
chr19	5522863	5722863	harbor2	chr19	5562444	5562649	LINE/L2	956	-	102	5562546	39683
chr19	5522863	5722863	harbor2	chr19	5562947	5563464	LINE/L2	956	-	258	5563205	40342
chr19	12938726	13138726	harbor2	chr19	12965023	12965417	LINE/L2	1003	-	197	12965220	26494
chr19	5620484	5820484	harbor2	chr19	5683455	5683609	LINE/L2	800	-	77	5683532	63048
chr19	5620484	5820484	harbor2	chr19	5683923	5683965	LINE/L2	800	-	21	5683944	63460
chr19	5620484	5820484	harbor2	chr19	5684315	5684729	LINE/L2	800	-	207	5684522	64038
chr19	10771431	10971431	harbor2	chr19	10788255	10788586	LINE/L2	706	-	166	10788421	16990
chr19	10771431	10971431	harbor2	chr19	10820313	10820865	LINE/L2	782	-	276	10820589	49158
chr19	10771431	10971431	harbor2	chr19	10852509	10852816	LINE/L2	845	-	154	10852663	81232
chr19	10914491	11114491	harbor2	chr19	10991529	10991955	LINE/L2	785	-	213	10991742	77251
chr19	48865977	49065977	harbor2	chr19	48956481	48956646	LINE/L2	1026	-	82	48956563	90586
chr19	48865977	49065977	harbor2	chr19	48956964	48957254	LINE/L2	1026	-	145	48957109	91132
chr19	48865977	49065977	harbor2	chr19	48957575	48957677	LINE/L2	863	-	51	48957626	91649
chr19	10619538	10819538	harbor2	chr19	10620577	10620763	LINE/L2	1164	-	93	10620670	1132
chr19	10619538	10819538	harbor2	chr19	10621382	10621424	LINE/L2	1164	-	21	10621403	1865
chr19	10619538	10819538	harbor2	chr19	10622062	10622534	LINE/L2	1164	-	236	10622298	2760
chr19	10922845	11122845	harbor2	chr19	10991529	10991955	LINE/L2	785	-	213	10991742	68897
chr19	12938728	13138728	harbor2	chr19	12965023	12965417	LINE/L2	1003	-	197	12965220	26492
chr19	33076627	33276627	harbor2	chr19	33081373	33081885	LINE/L2	1000	-	256	33081629	5002
chr19	33076627	33276627	harbor2	chr19	33082008	33082274	LINE/L2	1000	-	133	33082141	5514
chr19	33076627	33276627	harbor2	chr19	33172519	33172808	LINE/L2	936	-	144	33172663	96036
chr19	33076627	33276627	harbor2	chr19	33173122	33173217	LINE/L2	936	-	48	33173170	96543
chr19	5591353	5791353	harbor2	chr19	5683455	5683609	LINE/L2	800	-	77	5683532	92179
chr19	5591353	5791353	harbor2	chr19	5683923	5683965	LINE/L2	800	-	21	5683944	92591
chr19	5591353	5791353	harbor2	chr19	5684315	5684729	LINE/L2	800	-	207	5684522	93169
chr19	18338885	18538885	harbor2	chr19	18401034	18401261	LINE/L2	734	-	114	18401148	62263
chr19	18338885	18538885	harbor2	chr19	18401589	18401714	LINE/L2	734	-	62	18401651	62766
chr19	18338885	18538885	harbor2	chr19	18410897	18410992	LINE/L2	730	-	48	18410945	72060
chr19	18338885	18538885	harbor2	chr19	18411127	18411210	LINE/L2	730	-	42	18411169	72284
chr19	18338885	18538885	harbor2	chr19	18411509	18411691	LINE/L2	730	-	91	18411600	72715
chr19	49752919	49952919	harbor2	chr19	49768871	49768968	LINE/L2	818	-	48	49768919	16000
chr19	49752919	49952919	harbor2	chr19	49769278	49769881	LINE/L2	1108	-	302	49769580	16661
chr19	49752919	49952919	harbor2	chr19	49770169	49770245	LINE/L2	1108	-	38	49770207	17288
chr19	49752919	49952919	harbor2	chr19	49773515	49774097	LINE/L2	831	-	291	49773806	20887
chr19	10659653	10859653	harbor2	chr19	10747924	10748387	LINE/L2	822	-	232	10748156	88503
chr19	40420024	40620024	harbor2	chr19	40424526	40425238	LINE/L2	728	-	356	40424882	4858
chr19	40420024	40620024	harbor2	chr19	40477342	40477844	LINE/L2	670	-	251	40477593	57569
chr19	40420024	40620024	harbor2	chr19	40492053	40492719	LINE/L2	759	-	333	40492386	72362
chr19	40420024	40620024	harbor2	chr19	40512230	40512509	LINE/L2	725	-	140	40512370	92346
chr19	46920765	47120765	harbor2	chr19	46953065	46953453	LINE/L2	1276	-	194	46953259	32494
chr19	43619638	43819638	harbor2	chr19	43654322	43654476	LINE/L2	710	-	77	43654399	34761
chr19	43619638	43819638	harbor2	chr19	43654732	43654906	LINE/L2	710	-	87	43654819	35181
chr19	43619638	43819638	harbor2	chr19	43672110	43672553	LINE/L2	1015	-	222	43672332	52694
chr19	43619638	43819638	harbor2	chr19	43701271	43701659	LINE/L2	766	-	194	43701465	81827
chr19	4082526	4282526	harbor2	chr19	4139190	4139212	LINE/L2	716	-	11	4139201	56675
chr19	4082526	4282526	harbor2	chr19	4139518	4140150	LINE/L2	1021	-	316	4139834	57308
chr19	49752849	49952849	harbor2	chr19	49768871	49768968	LINE/L2	818	-	48	49768919	16070
chr19	49752849	49952849	harbor2	chr19	49769278	49769881	LINE/L2	1108	-	302	49769580	16731
chr19	49752849	49952849	harbor2	chr19	49770169	49770245	LINE/L2	1108	-	38	49770207	17358
chr19	49752849	49952849	harbor2	chr19	49773515	49774097	LINE/L2	831	-	291	49773806	20957
chr19	48529978	48729978	harbor2	chr19	48549529	48549881	LINE/L2	781	-	176	48549705	19727
chr19	48529978	48729978	harbor2	chr19	48577731	48577930	LINE/L2	697	-	100	48577831	47853
chr19	48529978	48729978	harbor2	chr19	48588604	48589545	LINE/L2	1415	-	470	48589074	59096
chr19	11477538	11677538	harbor2	chr19	11543990	11544467	LINE/L2	1291	-	238	11544228	66690
chr19	11477538	11677538	harbor2	chr19	11544801	11544916	LINE/L2	1291	-	58	11544859	67321
chr19	11477538	11677538	harbor2	chr19	11545218	11545672	LINE/L2	1291	-	227	11545445	67907
chr19	11477538	11677538	harbor2	chr19	11545996	11546034	LINE/L2	1291	-	19	11546015	68477
chr19	11477538	11677538	harbor2	chr19	11534206	11534396	LINE/L2	720	-	95	11534301	56763
chr19	45385922	45585922	harbor2	chr19	45417167	45417622	LINE/L2	1203	-	228	45417395	31473
chr19	45385922	45585922	harbor2	chr19	45424217	45424524	LINE/L2	827	-	154	45424371	38449
chr19	45385922	45585922	harbor2	chr19	45445316	45445885	LINE/L2	1298	-	284	45445600	59678
chr19	45385922	45585922	harbor2	chr19	45446199	45446380	LINE/L2	766	-	90	45446289	60367
chr19	45385922	45585922	harbor2	chr19	45460467	45460833	LINE/L2	1152	-	183	45460650	74728
chr19	45385922	45585922	harbor2	chr19	45476362	45476733	LINE/L2	800	-	186	45476548	90626
chr19	45385922	45585922	harbor2	chr19	45477061	45477508	LINE/L2	718	-	224	45477285	91363
chr19	49769438	49969438	harbor2	chr19	49769278	49769881	LINE/L2	1108	-	302	49769580	142
chr19	49769438	49969438	harbor2	chr19	49770169	49770245	LINE/L2	1108	-	38	49770207	769
chr19	49769438	49969438	harbor2	chr19	49773515	49774097	LINE/L2	831	-	291	49773806	4368
chr19	10618715	10818715	harbor2	chr19	10620577	10620763	LINE/L2	1164	-	93	10620670	1955
chr19	10618715	10818715	harbor2	chr19	10621382	10621424	LINE/L2	1164	-	21	10621403	2688
chr19	10618715	10818715	harbor2	chr19	10622062	10622534	LINE/L2	1164	-	236	10622298	3583
chr19	5534518	5734518	harbor2	chr19	5562444	5562649	LINE/L2	956	-	102	5562546	28028
chr19	5534518	5734518	harbor2	chr19	5562947	5563464	LINE/L2	956	-	258	5563205	28687
chr19	10735524	10935524	harbor2	chr19	10747924	10748387	LINE/L2	822	-	232	10748156	12632
chr19	10735524	10935524	harbor2	chr19	10788255	10788586	LINE/L2	706	-	166	10788421	52897
chr19	10735524	10935524	harbor2	chr19	10820313	10820865	LINE/L2	782	-	276	10820589	85065
chr19	45399374	45599374	harbor2	chr19	45417167	45417622	LINE/L2	1203	-	228	45417395	18021
chr19	45399374	45599374	harbor2	chr19	45424217	45424524	LINE/L2	827	-	154	45424371	24997
chr19	45399374	45599374	harbor2	chr19	45445316	45445885	LINE/L2	1298	-	284	45445600	46226
chr19	45399374	45599374	harbor2	chr19	45446199	45446380	LINE/L2	766	-	90	45446289	46915
chr19	45399374	45599374	harbor2	chr19	45460467	45460833	LINE/L2	1152	-	183	45460650	61276
chr19	45399374	45599374	harbor2	chr19	45476362	45476733	LINE/L2	800	-	186	45476548	77174
chr19	45399374	45599374	harbor2	chr19	45477061	45477508	LINE/L2	718	-	224	45477285	77911
chr19	45399374	45599374	harbor2	chr19	45495371	45495840	LINE/L2	1933	-	234	45495605	96231
chr19	10735498	10935498	harbor2	chr19	10747924	10748387	LINE/L2	822	-	232	10748156	12658
chr19	10735498	10935498	harbor2	chr19	10788255	10788586	LINE/L2	706	-	166	10788421	52923
chr19	10735498	10935498	harbor2	chr19	10820313	10820865	LINE/L2	782	-	276	10820589	85091
chr19	10618444	10818444	harbor2	chr19	10620577	10620763	LINE/L2	1164	-	93	10620670	2226
chr19	10618444	10818444	harbor2	chr19	10621382	10621424	LINE/L2	1164	-	21	10621403	2959
chr19	10618444	10818444	harbor2	chr19	10622062	10622534	LINE/L2	1164	-	236	10622298	3854
chr19	697385	897385	harbor2	chr19	737491	738101	LINE/L2	715	-	305	737796	40411
chr19	10736203	10936203	harbor2	chr19	10747924	10748387	LINE/L2	822	-	232	10748156	11953
chr19	10736203	10936203	harbor2	chr19	10788255	10788586	LINE/L2	706	-	166	10788421	52218
chr19	10736203	10936203	harbor2	chr19	10820313	10820865	LINE/L2	782	-	276	10820589	84386
chr19	5522849	5722849	harbor2	chr19	5532241	5532315	LINE/L2	1670	-	37	5532278	9429
chr19	5522849	5722849	harbor2	chr19	5532618	5532793	LINE/L2	1670	-	88	5532706	9857
chr19	5522849	5722849	harbor2	chr19	5533315	5533637	LINE/L2	1670	-	161	5533476	10627
chr19	5522849	5722849	harbor2	chr19	5562444	5562649	LINE/L2	956	-	102	5562546	39697
chr19	5522849	5722849	harbor2	chr19	5562947	5563464	LINE/L2	956	-	258	5563205	40356
chr19	10618446	10818446	harbor2	chr19	10620577	10620763	LINE/L2	1164	-	93	10620670	2224
chr19	10618446	10818446	harbor2	chr19	10621382	10621424	LINE/L2	1164	-	21	10621403	2957
chr19	10618446	10818446	harbor2	chr19	10622062	10622534	LINE/L2	1164	-	236	10622298	3852
chr19	49752530	49952530	harbor2	chr19	49768871	49768968	LINE/L2	818	-	48	49768919	16389
chr19	49752530	49952530	harbor2	chr19	49769278	49769881	LINE/L2	1108	-	302	49769580	17050
chr19	49752530	49952530	harbor2	chr19	49770169	49770245	LINE/L2	1108	-	38	49770207	17677
chr19	49752530	49952530	harbor2	chr19	49773515	49774097	LINE/L2	831	-	291	49773806	21276
chr19	48525085	48725085	harbor2	chr19	48549529	48549881	LINE/L2	781	-	176	48549705	24620
chr19	48525085	48725085	harbor2	chr19	48577731	48577930	LINE/L2	697	-	100	48577831	52746
chr19	48525085	48725085	harbor2	chr19	48588604	48589545	LINE/L2	1415	-	470	48589074	63989
chr20	21818051	22018051	harbor2	chr20	21849274	21849885	LINE/L2	1302	-	306	21849580	31529
chr20	62119278	62319278	harbor2	chr20	62132295	62132790	LINE/L2	989	-	248	62132543	13265
chr20	31622896	31822896	harbor2	chr20	31680664	31681366	LINE/L2	1463	-	351	31681015	58119
chr20	31622896	31822896	harbor2	chr20	31681638	31681711	LINE/L2	1237	-	36	31681674	58778
chr20	31622896	31822896	harbor2	chr20	31701851	31702351	LINE/L2	1086	-	250	31702101	79205
chr20	31622896	31822896	harbor2	chr20	31702963	31703037	LINE/L2	654	-	37	31703000	80104
chr20	31622896	31822896	harbor2	chr20	31710110	31710251	LINE/L2	565	-	70	31710180	87284
chr20	10574519	10774519	harbor2	chr20	10661404	10662098	LINE/L2	686	-	347	10661751	87232
chr20	34725531	34925531	harbor2	chr20	34725681	34726158	LINE/L2	542	-	238	34725919	388
chr20	34725531	34925531	harbor2	chr20	34726173	34726504	LINE/L2	488	-	166	34726339	808
chr20	34725531	34925531	harbor2	chr20	34752375	34752627	LINE/L2	501	-	126	34752501	26970
chr20	34725531	34925531	harbor2	chr20	34774853	34775286	LINE/L2	491	-	216	34775069	49538
chr20	34904860	35104860	harbor2	chr20	34906617	34906701	LINE/L2	542	-	42	34906659	1799
chr20	34904860	35104860	harbor2	chr20	34907005	34907122	LINE/L2	542	-	58	34907063	2203
chr20	34904860	35104860	harbor2	chr20	34918869	34919176	LINE/L2	546	-	154	34919023	14163
chr20	34904860	35104860	harbor2	chr20	34924191	34924688	LINE/L2	1006	-	248	34924439	19579
chr20	34904860	35104860	harbor2	chr20	34924990	34925085	LINE/L2	550	-	48	34925038	20178
chr20	34904860	35104860	harbor2	chr20	34965484	34965944	LINE/L2	511	-	230	34965714	60854
chr20	34904860	35104860	harbor2	chr20	34991220	34991632	LINE/L2	587	-	206	34991426	86566
chr20	35442077	35642077	harbor2	chr20	35444088	35444574	LINE/L2	1115	-	243	35444331	2254
chr20	35442077	35642077	harbor2	chr20	35452805	35452967	LINE/L2	741	-	81	35452886	10809
chr20	35442077	35642077	harbor2	chr20	35453264	35453458	LINE/L2	741	-	97	35453361	11284
chr20	35442077	35642077	harbor2	chr20	35453823	35453936	LINE/L2	484	-	56	35453879	11802
chr20	35442077	35642077	harbor2	chr20	35454104	35454171	LINE/L2	484	-	34	35454138	12061
chr20	35442077	35642077	harbor2	chr20	35457815	35457963	LINE/L2	459	-	74	35457889	15812
chr20	35442077	35642077	harbor2	chr20	35488416	35488441	LINE/L2	471	-	12	35488428	46351
chr20	35442077	35642077	harbor2	chr20	35488764	35488903	LINE/L2	521	-	70	35488834	46757
chr20	35442077	35642077	harbor2	chr20	35489203	35489298	LINE/L2	521	-	48	35489251	47174
chr20	35442077	35642077	harbor2	chr20	35491927	35492178	LINE/L2	950	-	126	35492053	49976
chr20	35442077	35642077	harbor2	chr20	35492505	35492725	LINE/L2	950	-	110	35492615	50538
chr20	35442077	35642077	harbor2	chr20	35494823	35495477	LINE/L2	786	-	327	35495150	53073
chr20	35442077	35642077	harbor2	chr20	35505148	35505370	LINE/L2	475	-	111	35505259	63182
chr20	35442077	35642077	harbor2	chr20	35505672	35505741	LINE/L2	475	-	34	35505706	63629
chr20	50095117	50295117	harbor2	chr20	50097896	50098642	LINE/L2	1208	-	373	50098269	3152
chr20	50095117	50295117	harbor2	chr20	50107717	50108339	LINE/L2	523	-	311	50108028	12911
chr20	50095117	50295117	harbor2	chr20	50113816	50114114	LINE/L2	615	-	149	50113965	18848
chr20	50095117	50295117	harbor2	chr20	50142233	50142451	LINE/L2	929	-	109	50142342	47225
chr20	50095117	50295117	harbor2	chr20	50142751	50143369	LINE/L2	1207	-	309	50143060	47943
chr20	50095117	50295117	harbor2	chr20	50188526	50188834	LINE/L2	612	-	154	50188680	93563
chr20	36898001	37098001	harbor2	chr20	36957101	36957251	LINE/L2	1071	-	75	36957176	59175
chr20	36898001	37098001	harbor2	chr20	36957878	36958158	LINE/L2	1071	-	140	36958018	60017
chr20	24535180	24735180	harbor2	chr20	24578037	24578164	LINE/L2	742	-	64	24578101	42921
chr20	24535180	24735180	harbor2	chr20	24578470	24578758	LINE/L2	742	-	144	24578614	43434
chr20	24535180	24735180	harbor2	chr20	24591407	24591639	LINE/L2	475	-	116	24591523	56343
chr20	4624774	4824774	harbor2	chr20	4670405	4670692	LINE/L2	588	-	144	4670549	45775
chr20	4624774	4824774	harbor2	chr20	4697254	4697935	LINE/L2	905	-	340	4697594	72820
chr20	1023102	1223102	harbor2	chr20	1046917	1047172	LINE/L2	610	-	128	1047045	23943
chr20	1023102	1223102	harbor2	chr20	1047582	1047993	LINE/L2	759	-	206	1047788	24686
chr20	1023102	1223102	harbor2	chr20	1108036	1108170	LINE/L2	694	-	67	1108103	85001
chr20	1023102	1223102	harbor2	chr20	1116641	1116953	LINE/L2	573	-	156	1116797	93695
chr20	1023102	1223102	harbor2	chr20	1116967	1117151	LINE/L2	768	-	92	1117059	93957
chr20	1023102	1223102	harbor2	chr20	1117176	1117328	LINE/L2	534	-	76	1117252	94150
chr20	1023102	1223102	harbor2	chr20	1117644	1117800	LINE/L2	534	-	78	1117722	94620
chr20	9474281	9674281	harbor2	chr20	9495853	9496316	LINE/L2	1107	-	232	9496085	21804
chr20	9474281	9674281	harbor2	chr20	9498091	9498149	LINE/L2	557	-	29	9498120	23839
chr20	9474281	9674281	harbor2	chr20	9498467	9498668	LINE/L2	557	-	100	9498567	24286
chr20	9474281	9674281	harbor2	chr20	9499052	9499075	LINE/L2	557	-	12	9499064	24783
chr20	9474281	9674281	harbor2	chr20	9499082	9500000	LINE/L2	1776	-	459	9499541	25260
chr20	9474281	9674281	harbor2	chr20	9501158	9501385	LINE/L2	486	-	114	9501272	26991
chr20	9474281	9674281	harbor2	chr20	9569330	9569641	LINE/L2	856	-	156	9569486	95205
chr20	9474281	9674281	harbor2	chr20	9567613	9568474	LINE/L2	1220	-	430	9568043	93762
chr20	34725551	34925551	harbor2	chr20	34725681	34726158	LINE/L2	542	-	238	34725919	368
chr20	34725551	34925551	harbor2	chr20	34726173	34726504	LINE/L2	488	-	166	34726339	788
chr20	34725551	34925551	harbor2	chr20	34752375	34752627	LINE/L2	501	-	126	34752501	26950
chr20	34725551	34925551	harbor2	chr20	34774853	34775286	LINE/L2	491	-	216	34775069	49518
chr20	50272702	50472702	harbor2	chr20	50273004	50273682	LINE/L2	860	-	339	50273343	641
chr20	50272702	50472702	harbor2	chr20	50288075	50288230	LINE/L2	503	-	78	50288153	15451
chr20	50272702	50472702	harbor2	chr20	50293885	50294325	LINE/L2	782	-	220	50294105	21403
chr20	50272702	50472702	harbor2	chr20	50303000	50303163	LINE/L2	511	-	82	50303082	30380
chr20	50272702	50472702	harbor2	chr20	50303473	50303582	LINE/L2	511	-	54	50303527	30825
chr20	50272702	50472702	harbor2	chr20	50305983	50306635	LINE/L2	1314	-	326	50306309	33607
chr20	50272702	50472702	harbor2	chr20	50309549	50309980	LINE/L2	888	-	216	50309765	37063
chr20	50272702	50472702	harbor2	chr20	50327820	50328188	LINE/L2	656	-	184	50328004	55302
chr20	50272702	50472702	harbor2	chr20	50328557	50328639	LINE/L2	656	-	41	50328598	55896
chr20	50272702	50472702	harbor2	chr20	50353502	50353984	LINE/L2	699	-	241	50353743	81041
chr20	34904861	35104861	harbor2	chr20	34906617	34906701	LINE/L2	542	-	42	34906659	1798
chr20	34904861	35104861	harbor2	chr20	34907005	34907122	LINE/L2	542	-	58	34907063	2202
chr20	34904861	35104861	harbor2	chr20	34918869	34919176	LINE/L2	546	-	154	34919023	14162
chr20	34904861	35104861	harbor2	chr20	34924191	34924688	LINE/L2	1006	-	248	34924439	19578
chr20	34904861	35104861	harbor2	chr20	34924990	34925085	LINE/L2	550	-	48	34925038	20177
chr20	34904861	35104861	harbor2	chr20	34965484	34965944	LINE/L2	511	-	230	34965714	60853
chr20	34904861	35104861	harbor2	chr20	34991220	34991632	LINE/L2	587	-	206	34991426	86565
chr20	63983670	64183670	harbor2	chr20	64054693	64054833	LINE/L2	585	-	70	64054763	71093
chr20	40600650	40800650	harbor2	chr20	40657185	40657606	LINE/L2	702	-	210	40657395	56745
chr20	40600650	40800650	harbor2	chr20	40677694	40678223	LINE/L2	1252	-	264	40677958	77308
chr20	34776144	34976144	harbor2	chr20	34864008	34864440	LINE/L2	679	-	216	34864224	88080
chr20	34776144	34976144	harbor2	chr20	34864741	34864824	LINE/L2	618	-	42	34864783	88639
chr20	34776144	34976144	harbor2	chr20	34865490	34865568	LINE/L2	618	-	39	34865529	89385
chr20	34776144	34976144	harbor2	chr20	34869541	34869921	LINE/L2	454	-	190	34869731	93587
chr20	34776144	34976144	harbor2	chr20	34865122	34865173	LINE/L2	618	-	26	34865148	89004
chr20	38347847	38547847	harbor2	chr20	38395456	38395672	LINE/L2	736	-	108	38395564	47717
chr20	35362392	35562392	harbor2	chr20	35377506	35377645	LINE/L2	497	-	70	35377576	15184
chr20	35362392	35562392	harbor2	chr20	35420636	35420766	LINE/L2	466	-	65	35420701	58309
chr20	35362392	35562392	harbor2	chr20	35421072	35421222	LINE/L2	466	-	75	35421147	58755
chr20	35362392	35562392	harbor2	chr20	35444088	35444574	LINE/L2	1115	-	243	35444331	81939
chr20	35362392	35562392	harbor2	chr20	35452805	35452967	LINE/L2	741	-	81	35452886	90494
chr20	35362392	35562392	harbor2	chr20	35453264	35453458	LINE/L2	741	-	97	35453361	90969
chr20	35362392	35562392	harbor2	chr20	35453823	35453936	LINE/L2	484	-	56	35453879	91487
chr20	35362392	35562392	harbor2	chr20	35454104	35454171	LINE/L2	484	-	34	35454138	91746
chr20	35362392	35562392	harbor2	chr20	35457815	35457963	LINE/L2	459	-	74	35457889	95497
chr20	34905163	35105163	harbor2	chr20	34906617	34906701	LINE/L2	542	-	42	34906659	1496
chr20	34905163	35105163	harbor2	chr20	34907005	34907122	LINE/L2	542	-	58	34907063	1900
chr20	34905163	35105163	harbor2	chr20	34918869	34919176	LINE/L2	546	-	154	34919023	13860
chr20	34905163	35105163	harbor2	chr20	34924191	34924688	LINE/L2	1006	-	248	34924439	19276
chr20	34905163	35105163	harbor2	chr20	34924990	34925085	LINE/L2	550	-	48	34925038	19875
chr20	34905163	35105163	harbor2	chr20	34965484	34965944	LINE/L2	511	-	230	34965714	60551
chr20	34905163	35105163	harbor2	chr20	34991220	34991632	LINE/L2	587	-	206	34991426	86263
chr20	1020784	1220784	harbor2	chr20	1046917	1047172	LINE/L2	610	-	128	1047045	26261
chr20	1020784	1220784	harbor2	chr20	1047582	1047993	LINE/L2	759	-	206	1047788	27004
chr20	1020784	1220784	harbor2	chr20	1108036	1108170	LINE/L2	694	-	67	1108103	87319
chr20	1020784	1220784	harbor2	chr20	1116641	1116953	LINE/L2	573	-	156	1116797	96013
chr20	1020784	1220784	harbor2	chr20	1116967	1117151	LINE/L2	768	-	92	1117059	96275
chr20	1020784	1220784	harbor2	chr20	1117176	1117328	LINE/L2	534	-	76	1117252	96468
chr20	1020784	1220784	harbor2	chr20	1117644	1117800	LINE/L2	534	-	78	1117722	96938
chr20	9474416	9674416	harbor2	chr20	9495853	9496316	LINE/L2	1107	-	232	9496085	21669
chr20	9474416	9674416	harbor2	chr20	9498091	9498149	LINE/L2	557	-	29	9498120	23704
chr20	9474416	9674416	harbor2	chr20	9498467	9498668	LINE/L2	557	-	100	9498567	24151
chr20	9474416	9674416	harbor2	chr20	9499052	9499075	LINE/L2	557	-	12	9499064	24648
chr20	9474416	9674416	harbor2	chr20	9499082	9500000	LINE/L2	1776	-	459	9499541	25125
chr20	9474416	9674416	harbor2	chr20	9501158	9501385	LINE/L2	486	-	114	9501272	26856
chr20	9474416	9674416	harbor2	chr20	9569330	9569641	LINE/L2	856	-	156	9569486	95070
chr20	9474416	9674416	harbor2	chr20	9567613	9568474	LINE/L2	1220	-	430	9568043	93627
chr20	3370919	3570919	harbor2	chr20	3396363	3396964	LINE/L2	704	-	300	3396663	25744
chr20	3370919	3570919	harbor2	chr20	3397263	3397299	LINE/L2	595	-	18	3397281	26362
chr20	3370919	3570919	harbor2	chr20	3440249	3440402	LINE/L2	554	-	76	3440325	69406
chr20	35138054	35338054	harbor2	chr20	35191337	35192013	LINE/L2	744	-	338	35191675	53621
chr20	35138054	35338054	harbor2	chr20	35193604	35193982	LINE/L2	1348	-	189	35193793	55739
chr20	35138054	35338054	harbor2	chr20	35194206	35194553	LINE/L2	718	-	174	35194380	56326
chr20	35138054	35338054	harbor2	chr20	35209197	35209718	LINE/L2	962	-	260	35209457	71403
chr20	62043222	62243222	harbor2	chr20	62132295	62132790	LINE/L2	989	-	248	62132543	89321
chr20	21866893	22066893	harbor2	chr20	21948633	21948775	LINE/L2	627	-	71	21948704	81811
chr20	21866893	22066893	harbor2	chr20	21949274	21949692	LINE/L2	627	-	209	21949483	82590
chr20	64015438	64215438	harbor2	chr20	64054693	64054833	LINE/L2	585	-	70	64054763	39325
chr20	11791589	11991589	harbor2	chr20	11844558	11845132	LINE/L2	833	-	287	11844845	53256
chr20	11791589	11991589	harbor2	chr20	11865207	11865513	LINE/L2	997	-	153	11865360	73771
chr20	34904857	35104857	harbor2	chr20	34906617	34906701	LINE/L2	542	-	42	34906659	1802
chr20	34904857	35104857	harbor2	chr20	34907005	34907122	LINE/L2	542	-	58	34907063	2206
chr20	34904857	35104857	harbor2	chr20	34918869	34919176	LINE/L2	546	-	154	34919023	14166
chr20	34904857	35104857	harbor2	chr20	34924191	34924688	LINE/L2	1006	-	248	34924439	19582
chr20	34904857	35104857	harbor2	chr20	34924990	34925085	LINE/L2	550	-	48	34925038	20181
chr20	34904857	35104857	harbor2	chr20	34965484	34965944	LINE/L2	511	-	230	34965714	60857
chr20	34904857	35104857	harbor2	chr20	34991220	34991632	LINE/L2	587	-	206	34991426	86569
chr20	21615735	21815735	harbor2	chr20	21629890	21630378	LINE/L2	593	-	244	21630134	14399
chr20	21615735	21815735	harbor2	chr20	21662494	21663985	LINE/L2	2668	-	746	21663240	47505
chr20	21615735	21815735	harbor2	chr20	21664267	21664358	LINE/L2	2668	-	46	21664313	48578
chr20	62707216	62907216	harbor2	chr20	62717741	62718385	LINE/L2	757	-	322	62718063	10847
chr20	62043200	62243200	harbor2	chr20	62132295	62132790	LINE/L2	989	-	248	62132543	89343
chr20	4587587	4787587	harbor2	chr20	4670405	4670692	LINE/L2	588	-	144	4670549	82962
chr21	15065117	15265117	harbor2	chr21	15132765	15133075	LINE/L2	441	-	155	15132920	67803
chr21	29261633	29461633	harbor2	chr21	29310418	29310632	LINE/L2	580	-	107	29310525	48892
chr21	29261633	29461633	harbor2	chr21	29310713	29310942	LINE/L2	458	-	114	29310827	49194
chr21	29261633	29461633	harbor2	chr21	29354060	29354987	LINE/L2	811	-	464	29354524	92891
chr21	46225275	46425275	harbor2	chr21	46230845	46230914	LINE/L2	997	-	34	46230879	5604
chr21	46225275	46425275	harbor2	chr21	46231213	46231677	LINE/L2	997	-	232	46231445	6170
chr21	46225275	46425275	harbor2	chr21	46238777	46240407	LINE/L2	1955	-	815	46239592	14317
chr21	46225275	46425275	harbor2	chr21	46254969	46255499	LINE/L2	472	-	265	46255234	29959
chr21	46225275	46425275	harbor2	chr21	46268318	46268689	LINE/L2	606	-	186	46268504	43229
chr21	43621046	43821046	harbor2	chr21	43662758	43662862	LINE/L2	456	-	52	43662810	41764
chr21	41040652	41240652	harbor2	chr21	41111185	41112062	LINE/L2	765	-	438	41111623	70971
chr21	34275890	34475890	harbor2	chr21	34356134	34356409	LINE/L2	439	-	138	34356272	80382
chr21	14673851	14873851	harbor2	chr21	14766721	14767198	LINE/L2	547	-	238	14766959	93108
chr21	29248676	29448676	harbor2	chr21	29310418	29310632	LINE/L2	580	-	107	29310525	61849
chr21	29248676	29448676	harbor2	chr21	29310713	29310942	LINE/L2	458	-	114	29310827	62151
chr21	41945270	42145270	harbor2	chr21	41999689	41999991	LINE/L2	722	-	151	41999840	54570
chr21	39009375	39209375	harbor2	chr21	39026182	39026625	LINE/L2	539	-	222	39026404	17029
chr21	39009375	39209375	harbor2	chr21	39026909	39027001	LINE/L2	539	-	46	39026955	17580
chr21	39009375	39209375	harbor2	chr21	39099658	39099801	LINE/L2	574	-	72	39099730	90355
chr21	39009375	39209375	harbor2	chr21	39103505	39103658	LINE/L2	613	-	76	39103581	94206
chr21	39009691	39209691	harbor2	chr21	39026182	39026625	LINE/L2	539	-	222	39026404	16713
chr21	39009691	39209691	harbor2	chr21	39026909	39027001	LINE/L2	539	-	46	39026955	17264
chr21	39009691	39209691	harbor2	chr21	39099658	39099801	LINE/L2	574	-	72	39099730	90039
chr21	39009691	39209691	harbor2	chr21	39103505	39103658	LINE/L2	613	-	76	39103581	93890
chr21	39009608	39209608	harbor2	chr21	39026182	39026625	LINE/L2	539	-	222	39026404	16796
chr21	39009608	39209608	harbor2	chr21	39026909	39027001	LINE/L2	539	-	46	39026955	17347
chr21	39009608	39209608	harbor2	chr21	39099658	39099801	LINE/L2	574	-	72	39099730	90122
chr21	39009608	39209608	harbor2	chr21	39103505	39103658	LINE/L2	613	-	76	39103581	93973
chr22	39579346	39779346	harbor2	chr22	39580481	39580618	LINE/L2	396	-	68	39580549	1203
chr22	39579346	39779346	harbor2	chr22	39605499	39605945	LINE/L2	659	-	223	39605722	26376
chr22	39579346	39779346	harbor2	chr22	39633199	39633341	LINE/L2	491	-	71	39633270	53924
chr22	39579346	39779346	harbor2	chr22	39633510	39633729	LINE/L2	420	-	110	39633620	54274
chr22	39579346	39779346	harbor2	chr22	39643833	39644151	LINE/L2	793	-	159	39643992	64646
chr22	44208842	44408842	harbor2	chr22	44275931	44276646	LINE/L2	876	-	358	44276289	67447
chr22	44208842	44408842	harbor2	chr22	44302429	44302741	LINE/L2	520	-	156	44302585	93743
chr22	24070325	24270325	harbor2	chr22	24126155	24126502	LINE/L2	463	-	174	24126329	56004
chr22	24070396	24270396	harbor2	chr22	24126155	24126502	LINE/L2	463	-	174	24126329	55933
chr22	45971904	46171904	harbor2	chr22	46020766	46020883	LINE/L2	471	-	58	46020824	48920
chr22	24069899	24269899	harbor2	chr22	24126155	24126502	LINE/L2	463	-	174	24126329	56430
chr22	37418973	37618973	harbor2	chr22	37428610	37428805	LINE/L2	580	-	98	37428708	9735
chr22	37418973	37618973	harbor2	chr22	37474974	37475197	LINE/L2	586	-	112	37475086	56113
chr22	37418973	37618973	harbor2	chr22	37475514	37475583	LINE/L2	586	-	34	37475548	56575
chr22	37418973	37618973	harbor2	chr22	37504824	37505145	LINE/L2	561	-	160	37504984	86011
chr22	36465130	36665130	harbor2	chr22	36496425	36496892	LINE/L2	833	-	234	36496659	31529
chr22	36465130	36665130	harbor2	chr22	36547193	36547503	LINE/L2	423	-	155	36547348	82218
chr22	24069912	24269912	harbor2	chr22	24126155	24126502	LINE/L2	463	-	174	24126329	56417
chr22	36407158	36607158	harbor2	chr22	36496425	36496892	LINE/L2	833	-	234	36496659	89501
chr22	36919396	37119396	harbor2	chr22	36950831	36952218	LINE/L2	1212	-	694	36951525	32129
chr22	36407144	36607144	harbor2	chr22	36496425	36496892	LINE/L2	833	-	234	36496659	89515
chr22	24069890	24269890	harbor2	chr22	24126155	24126502	LINE/L2	463	-	174	24126329	56439
chr22	46291932	46491932	harbor2	chr22	46318357	46318760	LINE/L2	396	-	202	46318559	26627
chr22	46291932	46491932	harbor2	chr22	46350891	46351220	LINE/L2	393	-	164	46351055	59123
chr22	24069873	24269873	harbor2	chr22	24126155	24126502	LINE/L2	463	-	174	24126329	56456
chr22	24070472	24270472	harbor2	chr22	24126155	24126502	LINE/L2	463	-	174	24126329	55857
chr22	39579321	39779321	harbor2	chr22	39580481	39580618	LINE/L2	396	-	68	39580549	1228
chr22	39579321	39779321	harbor2	chr22	39605499	39605945	LINE/L2	659	-	223	39605722	26401
chr22	39579321	39779321	harbor2	chr22	39633199	39633341	LINE/L2	491	-	71	39633270	53949
chr22	39579321	39779321	harbor2	chr22	39633510	39633729	LINE/L2	420	-	110	39633620	54299
chr22	39579321	39779321	harbor2	chr22	39643833	39644151	LINE/L2	793	-	159	39643992	64671
chr22	24072073	24272073	harbor2	chr22	24126155	24126502	LINE/L2	463	-	174	24126329	54256
chr22	24528324	24728324	harbor2	chr22	24617152	24617977	LINE/L2	741	-	412	24617564	89240
chr22	39579203	39779203	harbor2	chr22	39580481	39580618	LINE/L2	396	-	68	39580549	1346
chr22	39579203	39779203	harbor2	chr22	39605499	39605945	LINE/L2	659	-	223	39605722	26519
chr22	39579203	39779203	harbor2	chr22	39633199	39633341	LINE/L2	491	-	71	39633270	54067
chr22	39579203	39779203	harbor2	chr22	39633510	39633729	LINE/L2	420	-	110	39633620	54417
chr22	39579203	39779203	harbor2	chr22	39643833	39644151	LINE/L2	793	-	159	39643992	64789
chr22	24395407	24595407	harbor2	chr22	24467519	24467729	LINE/L2	534	-	105	24467624	72217
chr22	24395407	24595407	harbor2	chr22	24470443	24470642	LINE/L2	766	-	100	24470543	75136
chr22	24395407	24595407	harbor2	chr22	24470917	24470994	LINE/L2	766	-	38	24470955	75548
chr22	24069893	24269893	harbor2	chr22	24126155	24126502	LINE/L2	463	-	174	24126329	56436
chr22	32100450	32300450	harbor2	chr22	32178415	32179077	LINE/L2	1591	-	331	32178746	78296
chr22	37240349	37440349	harbor2	chr22	37260824	37260955	LINE/L2	454	-	66	37260890	20541
chr22	37240349	37440349	harbor2	chr22	37261028	37261466	LINE/L2	766	-	219	37261247	20898
chr22	37240349	37440349	harbor2	chr22	37282713	37283065	LINE/L2	721	-	176	37282889	42540
chr22	37240349	37440349	harbor2	chr22	37292233	37292572	LINE/L2	562	-	170	37292403	52054
chr22	37240349	37440349	harbor2	chr22	37297865	37298087	LINE/L2	1147	-	111	37297976	57627
chr22	37240349	37440349	harbor2	chr22	37298403	37298591	LINE/L2	1147	-	94	37298497	58148
chr22	37240349	37440349	harbor2	chr22	37301303	37301462	LINE/L2	428	-	80	37301383	61034
chr22	37240349	37440349	harbor2	chr22	37303920	37304333	LINE/L2	469	-	206	37304126	63777
chr22	37240349	37440349	harbor2	chr22	37316414	37316626	LINE/L2	434	-	106	37316520	76171
chr22	24069880	24269880	harbor2	chr22	24126155	24126502	LINE/L2	463	-	174	24126329	56449
chr22	29461784	29661784	harbor2	chr22	29471489	29471871	LINE/L2	477	-	191	29471680	9896
chr22	29461784	29661784	harbor2	chr22	29476390	29476588	LINE/L2	587	-	99	29476489	14705
chr22	44788598	44988598	harbor2	chr22	44823154	44823509	LINE/L2	390	-	178	44823332	34734
chr22	44788598	44988598	harbor2	chr22	44825025	44825120	LINE/L2	401	-	48	44825073	36475
chr22	44788598	44988598	harbor2	chr22	44879806	44880102	LINE/L2	630	-	148	44879954	91356
chr22	23024082	23224082	harbor2	chr22	23038463	23038846	LINE/L2	741	-	192	23038655	14573
chr22	23024082	23224082	harbor2	chr22	23073741	23073940	LINE/L2	411	-	100	23073841	49759
chr22	23024082	23224082	harbor2	chr22	23073987	23074802	LINE/L2	600	-	408	23074395	50313
chr22	23024082	23224082	harbor2	chr22	23079048	23079756	LINE/L2	961	-	354	23079402	55320
chr22	39579207	39779207	harbor2	chr22	39580481	39580618	LINE/L2	396	-	68	39580549	1342
chr22	39579207	39779207	harbor2	chr22	39605499	39605945	LINE/L2	659	-	223	39605722	26515
chr22	39579207	39779207	harbor2	chr22	39633199	39633341	LINE/L2	491	-	71	39633270	54063
chr22	39579207	39779207	harbor2	chr22	39633510	39633729	LINE/L2	420	-	110	39633620	54413
chr22	39579207	39779207	harbor2	chr22	39643833	39644151	LINE/L2	793	-	159	39643992	64785
chr22	24070321	24270321	harbor2	chr22	24126155	24126502	LINE/L2	463	-	174	24126329	56008
chr22	39366725	39566725	harbor2	chr22	39377882	39377997	LINE/L2	413	-	58	39377940	11215
chr22	39366725	39566725	harbor2	chr22	39403944	39404266	LINE/L2	1101	-	161	39404105	37380
chr22	39366725	39566725	harbor2	chr22	39403102	39403638	LINE/L2	1101	-	268	39403370	36645
chr22	24069790	24269790	harbor2	chr22	24126155	24126502	LINE/L2	463	-	174	24126329	56539
chr22	24928712	25128712	harbor2	chr22	24936979	24937648	LINE/L2	1070	-	334	24937313	8601
chr22	24928712	25128712	harbor2	chr22	24944110	24944571	LINE/L2	1631	-	230	24944340	15628
chr22	24928712	25128712	harbor2	chr22	24945203	24945550	LINE/L2	1073	-	174	24945377	16665
chr22	24928712	25128712	harbor2	chr22	24949531	24949866	LINE/L2	527	-	168	24949699	20987
chr22	24928712	25128712	harbor2	chr22	24950884	24951020	LINE/L2	569	-	68	24950952	22240
chr22	24928712	25128712	harbor2	chr22	24972700	24973304	LINE/L2	991	-	302	24973002	44290
chr22	24928712	25128712	harbor2	chr22	25020472	25021065	LINE/L2	508	-	296	25020768	92056
chr22	39369739	39569739	harbor2	chr22	39377882	39377997	LINE/L2	413	-	58	39377940	8201
chr22	39369739	39569739	harbor2	chr22	39403944	39404266	LINE/L2	1101	-	161	39404105	34366
chr22	39369739	39569739	harbor2	chr22	39403102	39403638	LINE/L2	1101	-	268	39403370	33631
chr22	24069829	24269829	harbor2	chr22	24126155	24126502	LINE/L2	463	-	174	24126329	56500
chr22	23421907	23621907	harbor2	chr22	23496301	23496421	LINE/L2	399	-	60	23496361	74454
chr22	23421907	23621907	harbor2	chr22	23510510	23510818	LINE/L2	430	-	154	23510664	88757
chr22	42521734	42721734	harbor2	chr22	42549260	42549697	LINE/L2	528	-	218	42549478	27744
chr22	42521734	42721734	harbor2	chr22	42582239	42582451	LINE/L2	651	-	106	42582345	60611
chr22	24070287	24270287	harbor2	chr22	24126155	24126502	LINE/L2	463	-	174	24126329	56042
chr22	46291944	46491944	harbor2	chr22	46318357	46318760	LINE/L2	396	-	202	46318559	26615
chr22	46291944	46491944	harbor2	chr22	46350891	46351220	LINE/L2	393	-	164	46351055	59111
chr22	41811210	42011210	harbor2	chr22	41819492	41819944	LINE/L2	794	-	226	41819718	8508
chr22	41811210	42011210	harbor2	chr22	41820448	41821319	LINE/L2	3066	-	436	41820884	9674
chr22	41811210	42011210	harbor2	chr22	41821628	41822046	LINE/L2	3066	-	209	41821837	10627
chr22	41811210	42011210	harbor2	chr22	41824003	41824483	LINE/L2	493	-	240	41824243	13033
chr22	41811210	42011210	harbor2	chr22	41824785	41825025	LINE/L2	493	-	120	41824905	13695
chr22	39945490	40145490	harbor2	chr22	40026988	40027279	LINE/L2	415	-	146	40027134	81644
chr22	39945490	40145490	harbor2	chr22	40038050	40038334	LINE/L2	530	-	142	40038192	92702
chr22	37418827	37618827	harbor2	chr22	37428610	37428805	LINE/L2	580	-	98	37428708	9881
chr22	37418827	37618827	harbor2	chr22	37474974	37475197	LINE/L2	586	-	112	37475086	56259
chr22	37418827	37618827	harbor2	chr22	37475514	37475583	LINE/L2	586	-	34	37475548	56721
chr22	37418827	37618827	harbor2	chr22	37504824	37505145	LINE/L2	561	-	160	37504984	86157
chr22	38679511	38879511	harbor2	chr22	38712196	38712522	LINE/L2	397	-	163	38712359	32848
chr22	38679511	38879511	harbor2	chr22	38713820	38714193	LINE/L2	392	-	186	38714006	34495
chr22	38679511	38879511	harbor2	chr22	38714500	38714665	LINE/L2	392	-	82	38714582	35071
chr22	38679511	38879511	harbor2	chr22	38725193	38725602	LINE/L2	413	-	204	38725397	45886
chr22	39414512	39614512	harbor2	chr22	39470031	39470632	LINE/L2	461	-	300	39470331	55819
chr22	24948900	25148900	harbor2	chr22	24949531	24949866	LINE/L2	527	-	168	24949699	799
chr22	24948900	25148900	harbor2	chr22	24950884	24951020	LINE/L2	569	-	68	24950952	2052
chr22	24948900	25148900	harbor2	chr22	24972700	24973304	LINE/L2	991	-	302	24973002	24102
chr22	24948900	25148900	harbor2	chr22	25020472	25021065	LINE/L2	508	-	296	25020768	71868
chr22	24948900	25148900	harbor2	chr22	25048003	25048487	LINE/L2	660	-	242	25048245	99345
chr22	24070996	24270996	harbor2	chr22	24126155	24126502	LINE/L2	463	-	174	24126329	55333
chrX	153388897	153588897	harbor2	chrX	153412377	153412861	LINE/L2	596	-	242	153412619	23722
chrX	24366734	24566734	harbor2	chrX	24372768	24373047	LINE/L2	1012	-	140	24372908	6174
chrX	24366734	24566734	harbor2	chrX	24446583	24447833	LINE/L2	1144	-	625	24447208	80474
chrX	153410219	153610219	harbor2	chrX	153412377	153412861	LINE/L2	596	-	242	153412619	2400
chrX	72046619	72246619	harbor2	chrX	72065884	72066290	LINE/L2	802	-	203	72066087	19468
chrX	72046619	72246619	harbor2	chrX	72096081	72096323	LINE/L2	680	-	121	72096202	49583
chrX	72046619	72246619	harbor2	chrX	72111762	72112322	LINE/L2	1452	-	280	72112042	65423
chrX	72209033	72409033	harbor2	chrX	72234606	72235057	LINE/L2	2463	-	226	72234832	25799
chrX	72209033	72409033	harbor2	chrX	72235875	72236131	LINE/L2	2463	-	128	72236003	26970
chrX	72209033	72409033	harbor2	chrX	72244061	72244494	LINE/L2	1061	-	216	72244277	35244
chrX	72209033	72409033	harbor2	chrX	72256083	72256235	LINE/L2	1424	-	76	72256159	47126
chrX	72209033	72409033	harbor2	chrX	72256658	72257039	LINE/L2	1611	-	190	72256848	47815
chrX	72209033	72409033	harbor2	chrX	72257349	72257661	LINE/L2	1611	-	156	72257505	48472
chrX	72209033	72409033	harbor2	chrX	72263035	72263307	LINE/L2	606	-	136	72263171	54138
chrX	72209033	72409033	harbor2	chrX	72267859	72268235	LINE/L2	1129	-	188	72268047	59014
chrX	72209033	72409033	harbor2	chrX	72280288	72280821	LINE/L2	689	-	266	72280554	71521
chrX	18255217	18455217	harbor2	chrX	18311212	18311780	LINE/L2	2867	-	284	18311496	56279
chrX	18255217	18455217	harbor2	chrX	18312091	18312266	LINE/L2	2867	-	88	18312179	56962
chrX	18255217	18455217	harbor2	chrX	18312614	18312919	LINE/L2	2867	-	152	18312766	57549
chrX	153387298	153587298	harbor2	chrX	153412377	153412861	LINE/L2	596	-	242	153412619	25321
chrX	153370587	153570587	harbor2	chrX	153412377	153412861	LINE/L2	596	-	242	153412619	42032
chrX	72209054	72409054	harbor2	chrX	72234606	72235057	LINE/L2	2463	-	226	72234832	25778
chrX	72209054	72409054	harbor2	chrX	72235875	72236131	LINE/L2	2463	-	128	72236003	26949
chrX	72209054	72409054	harbor2	chrX	72244061	72244494	LINE/L2	1061	-	216	72244277	35223
chrX	72209054	72409054	harbor2	chrX	72256083	72256235	LINE/L2	1424	-	76	72256159	47105
chrX	72209054	72409054	harbor2	chrX	72256658	72257039	LINE/L2	1611	-	190	72256848	47794
chrX	72209054	72409054	harbor2	chrX	72257349	72257661	LINE/L2	1611	-	156	72257505	48451
chrX	72209054	72409054	harbor2	chrX	72263035	72263307	LINE/L2	606	-	136	72263171	54117
chrX	72209054	72409054	harbor2	chrX	72267859	72268235	LINE/L2	1129	-	188	72268047	58993
chrX	72209054	72409054	harbor2	chrX	72280288	72280821	LINE/L2	689	-	266	72280554	71500
chrX	18254719	18454719	harbor2	chrX	18311212	18311780	LINE/L2	2867	-	284	18311496	56777
chrX	18254719	18454719	harbor2	chrX	18312091	18312266	LINE/L2	2867	-	88	18312179	57460
chrX	18254719	18454719	harbor2	chrX	18312614	18312919	LINE/L2	2867	-	152	18312766	58047
chrX	71011961	71211961	harbor2	chrX	71027831	71028531	LINE/L2	1048	-	350	71028181	16220
chrX	40072549	40272549	harbor2	chrX	40120644	40121132	LINE/L2	1099	-	244	40120888	48339
chrX	40072549	40272549	harbor2	chrX	40121480	40121876	LINE/L2	777	-	198	40121678	49129
chrX	153504978	153704978	harbor2	chrX	153578931	153579347	LINE/L2	544	-	208	153579139	74161
