H_chr	H_start	H_end	Harbor	TE_chr	TE_start	TE_end	TE	score	TE_strand	TE_half	TE_middle_pos	TE_dis
chr1	16544779	16744779	harbor2	chr1	16560670	16560870	LTR/ERVL	779	+	100	16560770	15991
chr1	26431527	26631527	harbor2	chr1	26496945	26497334	LTR/ERVL	993	+	194	26497139	65612
chr1	16544783	16744783	harbor2	chr1	16560670	16560870	LTR/ERVL	779	+	100	16560770	15987
chr1	16544748	16744748	harbor2	chr1	16560670	16560870	LTR/ERVL	779	+	100	16560770	16022
chr1	227643530	227843530	harbor2	chr1	227691218	227691462	LTR/ERVL	908	+	122	227691340	47810
chr1	227643530	227843530	harbor2	chr1	227711887	227712200	LTR/ERVL	978	+	156	227712043	68513
chr1	227643530	227843530	harbor2	chr1	227724991	227725700	LTR/ERVL	4317	+	354	227725345	81815
chr1	227643530	227843530	harbor2	chr1	227726734	227727181	LTR/ERVL	2361	+	224	227726958	83428
chr1	178442681	178642681	harbor2	chr1	178499300	178499699	LTR/ERVL	3027	+	200	178499500	56819
chr1	178442681	178642681	harbor2	chr1	178500008	178500076	LTR/ERVL	565	+	34	178500042	57361
chr1	211034356	211234356	harbor2	chr1	211067248	211067560	LTR/ERVL	791	+	156	211067404	33048
chr1	211034356	211234356	harbor2	chr1	211074301	211074595	LTR/ERVL	1044	+	147	211074448	40092
chr1	211034356	211234356	harbor2	chr1	211074600	211074993	LTR/ERVL	1575	+	196	211074796	40440
chr1	211034356	211234356	harbor2	chr1	211093920	211094076	LTR/ERVL	730	+	78	211093998	59642
chr1	211034356	211234356	harbor2	chr1	211094405	211094497	LTR/ERVL	730	+	46	211094451	60095
chr1	211034356	211234356	harbor2	chr1	211115321	211115701	LTR/ERVL	3316	+	190	211115511	81155
chr1	211034356	211234356	harbor2	chr1	211115732	211115794	LTR/ERVL	3316	+	31	211115763	81407
chr1	6348816	6548816	harbor2	chr1	6411051	6411736	LTR/ERVL	1562	+	342	6411393	62577
chr1	727505	927505	harbor2	chr1	741124	741629	LTR/ERVL	3337	+	252	741376	13871
chr1	727505	927505	harbor2	chr1	741937	742006	LTR/ERVL	3337	+	34	741971	14466
chr1	727505	927505	harbor2	chr1	742310	742610	LTR/ERVL	3337	+	150	742460	14955
chr1	727505	927505	harbor2	chr1	752876	753134	LTR/ERVL	3365	+	129	753005	25500
chr1	727505	927505	harbor2	chr1	754046	754345	LTR/ERVL	3365	+	150	754196	26691
chr1	727505	927505	harbor2	chr1	753429	753738	LTR/ERVL	3365	+	154	753583	26078
chr1	87366701	87566701	harbor2	chr1	87425472	87425855	LTR/ERVL	1844	+	192	87425664	58963
chr1	16544774	16744774	harbor2	chr1	16560670	16560870	LTR/ERVL	779	+	100	16560770	15996
chr1	230542426	230742426	harbor2	chr1	230542137	230542560	LTR/ERVL	1292	+	212	230542349	77
chr1	230542426	230742426	harbor2	chr1	230542557	230542596	LTR/ERVL	1153	+	20	230542577	151
chr1	230542426	230742426	harbor2	chr1	230542892	230543180	LTR/ERVL	1153	+	144	230543036	610
chr1	230542426	230742426	harbor2	chr1	230544274	230544881	LTR/ERVL	1687	+	304	230544578	2152
chr1	230542426	230742426	harbor2	chr1	230544969	230545147	LTR/ERVL	728	+	89	230545058	2632
chr1	230542426	230742426	harbor2	chr1	230545176	230545607	LTR/ERVL	695	+	216	230545392	2966
chr1	230542426	230742426	harbor2	chr1	230545606	230545904	LTR/ERVL	902	+	149	230545755	3329
chr1	230542426	230742426	harbor2	chr1	230546068	230546466	LTR/ERVL	793	+	199	230546267	3841
chr1	230542426	230742426	harbor2	chr1	230562140	230562725	LTR/ERVL	3222	+	292	230562432	20006
chr1	230542426	230742426	harbor2	chr1	230629119	230629650	LTR/ERVL	3002	+	266	230629385	86959
chr1	16544791	16744791	harbor2	chr1	16560670	16560870	LTR/ERVL	779	+	100	16560770	15979
chr1	66204207	66404207	harbor2	chr1	66216059	66216154	LTR/ERVL	609	+	48	66216107	11900
chr1	36811933	37011933	harbor2	chr1	36835202	36835644	LTR/ERVL	729	+	221	36835423	23490
chr1	36811933	37011933	harbor2	chr1	36907855	36908264	LTR/ERVL	1081	+	204	36908059	96126
chr1	16544740	16744740	harbor2	chr1	16560670	16560870	LTR/ERVL	779	+	100	16560770	16030
chr1	16546455	16746455	harbor2	chr1	16560670	16560870	LTR/ERVL	779	+	100	16560770	14315
chr1	211034242	211234242	harbor2	chr1	211067248	211067560	LTR/ERVL	791	+	156	211067404	33162
chr1	211034242	211234242	harbor2	chr1	211074301	211074595	LTR/ERVL	1044	+	147	211074448	40206
chr1	211034242	211234242	harbor2	chr1	211074600	211074993	LTR/ERVL	1575	+	196	211074796	40554
chr1	211034242	211234242	harbor2	chr1	211093920	211094076	LTR/ERVL	730	+	78	211093998	59756
chr1	211034242	211234242	harbor2	chr1	211094405	211094497	LTR/ERVL	730	+	46	211094451	60209
chr1	211034242	211234242	harbor2	chr1	211115321	211115701	LTR/ERVL	3316	+	190	211115511	81269
chr1	211034242	211234242	harbor2	chr1	211115732	211115794	LTR/ERVL	3316	+	31	211115763	81521
chr1	16545171	16745171	harbor2	chr1	16560670	16560870	LTR/ERVL	779	+	100	16560770	15599
chr1	119201847	119401847	harbor2	chr1	119254917	119255460	LTR/ERVL	1964	+	272	119255189	53342
chr1	119201847	119401847	harbor2	chr1	119292687	119293153	LTR/ERVL	2936	+	233	119292920	91073
chr1	119201847	119401847	harbor2	chr1	119291612	119291972	LTR/ERVL	712	+	180	119291792	89945
chr1	16544784	16744784	harbor2	chr1	16560670	16560870	LTR/ERVL	779	+	100	16560770	15986
chr1	17289259	17489259	harbor2	chr1	17295845	17296296	LTR/ERVL	1682	+	226	17296071	6812
chr1	17289259	17489259	harbor2	chr1	17296525	17296925	LTR/ERVL	1798	+	200	17296725	7466
chr1	16544808	16744808	harbor2	chr1	16560670	16560870	LTR/ERVL	779	+	100	16560770	15962
chr1	16544785	16744785	harbor2	chr1	16560670	16560870	LTR/ERVL	779	+	100	16560770	15985
chr1	21743220	21943220	harbor2	chr1	21754485	21755157	LTR/ERVL	1153	+	336	21754821	11601
chr1	16555139	16755139	harbor2	chr1	16560670	16560870	LTR/ERVL	779	+	100	16560770	5631
chr1	16544786	16744786	harbor2	chr1	16560670	16560870	LTR/ERVL	779	+	100	16560770	15984
chr1	205330776	205530776	harbor2	chr1	205400557	205400689	LTR/ERVL	725	+	66	205400623	69847
chr1	205330776	205530776	harbor2	chr1	205406860	205407049	LTR/ERVL	3417	+	94	205406954	76178
chr1	205330776	205530776	harbor2	chr1	205407350	205407951	LTR/ERVL	3417	+	300	205407650	76874
chr1	2379773	2579773	harbor2	chr1	2383092	2383334	LTR/ERVL	518	+	121	2383213	3440
chr1	16545169	16745169	harbor2	chr1	16560670	16560870	LTR/ERVL	779	+	100	16560770	15601
chr1	5033151	5233151	harbor2	chr1	5041354	5041726	LTR/ERVL	819	+	186	5041540	8389
chr1	5033151	5233151	harbor2	chr1	5041944	5042187	LTR/ERVL	1811	+	122	5042066	8915
chr1	5033151	5233151	harbor2	chr1	5042558	5042841	LTR/ERVL	1811	+	142	5042700	9549
chr1	5033151	5233151	harbor2	chr1	5082519	5082879	LTR/ERVL	1372	+	180	5082699	49548
chr1	5033151	5233151	harbor2	chr1	5083396	5083616	LTR/ERVL	1372	+	110	5083506	50355
chr1	5033151	5233151	harbor2	chr1	5096301	5097033	LTR/ERVL	3369	+	366	5096667	63516
chr1	16544749	16744749	harbor2	chr1	16560670	16560870	LTR/ERVL	779	+	100	16560770	16021
chr1	99985	299985	harbor2	chr1	140785	141290	LTR/ERVL	3602	+	252	141037	41052
chr1	99985	299985	harbor2	chr1	141598	141667	LTR/ERVL	3602	+	34	141632	41647
chr1	99985	299985	harbor2	chr1	141971	142271	LTR/ERVL	3602	+	150	142121	42136
chr1	99985	299985	harbor2	chr1	152567	152825	LTR/ERVL	3563	+	129	152696	52711
chr1	99985	299985	harbor2	chr1	153120	153429	LTR/ERVL	3563	+	154	153274	53289
chr1	99985	299985	harbor2	chr1	153736	154035	LTR/ERVL	3563	+	150	153886	53901
chr1	39855815	40055815	harbor2	chr1	39908119	39908877	LTR/ERVL	1564	+	379	39908498	52683
chr1	16544788	16744788	harbor2	chr1	16560670	16560870	LTR/ERVL	779	+	100	16560770	15982
chr1	205814048	206014048	harbor2	chr1	205911640	205912045	LTR/ERVL	958	+	202	205911842	97794
chr1	2998349	3198349	harbor2	chr1	3004196	3004406	LTR/ERVL	459	+	105	3004301	5952
chr1	2998349	3198349	harbor2	chr1	3033129	3033510	LTR/ERVL	636	+	190	3033319	34970
chr1	232882890	233082890	harbor2	chr1	232909424	232909622	LTR/ERVL	1225	+	99	232909523	26633
chr1	232882890	233082890	harbor2	chr1	232909617	232909879	LTR/ERVL	1151	+	131	232909748	26858
chr1	232882890	233082890	harbor2	chr1	232911113	232911567	LTR/ERVL	1464	+	227	232911340	28450
chr1	232882890	233082890	harbor2	chr1	232931672	232932654	LTR/ERVL	5933	+	491	232932163	49273
chr1	232882890	233082890	harbor2	chr1	232932655	232933166	LTR/ERVL	2056	+	256	232932911	50021
chr1	232882890	233082890	harbor2	chr1	232933167	232933326	LTR/ERVL	5933	+	80	232933247	50357
chr1	232882890	233082890	harbor2	chr1	232933620	232933732	LTR/ERVL	5933	+	56	232933676	50786
chr1	232882890	233082890	harbor2	chr1	232933724	232934210	LTR/ERVL	1659	+	243	232933967	51077
chr1	232882890	233082890	harbor2	chr1	232934920	232935066	LTR/ERVL	494	+	73	232934993	52103
chr1	232882890	233082890	harbor2	chr1	232935086	232935648	LTR/ERVL	900	+	281	232935367	52477
chr1	232882890	233082890	harbor2	chr1	232936046	232936388	LTR/ERVL	1336	+	171	232936217	53327
chr1	232882890	233082890	harbor2	chr1	232939121	232939221	LTR/ERVL	1957	+	50	232939171	56281
chr1	232882890	233082890	harbor2	chr1	232939521	232939831	LTR/ERVL	1957	+	155	232939676	56786
chr1	232882890	233082890	harbor2	chr1	232952858	232953272	LTR/ERVL	1503	+	207	232953065	70175
chr1	232882890	233082890	harbor2	chr1	232931162	232931508	LTR/ERVL	5933	+	173	232931335	48445
chr1	236847274	237047274	harbor2	chr1	236919302	236919739	LTR/ERVL	3397	+	218	236919520	72246
chr1	119547913	119747913	harbor2	chr1	119558114	119558530	LTR/ERVL	1062	+	208	119558322	10409
chr1	119547913	119747913	harbor2	chr1	119595533	119595944	LTR/ERVL	1173	+	206	119595739	47826
chr1	16545161	16745161	harbor2	chr1	16560670	16560870	LTR/ERVL	779	+	100	16560770	15609
chr1	87228628	87428628	harbor2	chr1	87281726	87282263	LTR/ERVL	1897	+	268	87281994	53366
chr1	16545197	16745197	harbor2	chr1	16560670	16560870	LTR/ERVL	779	+	100	16560770	15573
chr1	11498857	11698857	harbor2	chr1	11552225	11552749	LTR/ERVL	2438	+	262	11552487	53630
chr1	11498857	11698857	harbor2	chr1	11555818	11556334	LTR/ERVL	1920	+	258	11556076	57219
chr1	11498857	11698857	harbor2	chr1	11580502	11580771	LTR/ERVL	794	+	134	11580636	81779
chr1	11498857	11698857	harbor2	chr1	11591409	11591860	LTR/ERVL	2731	+	226	11591635	92778
chr1	16544745	16744745	harbor2	chr1	16560670	16560870	LTR/ERVL	779	+	100	16560770	16025
chr1	92860991	93060991	harbor2	chr1	92860802	92860998	LTR/ERVL	862	+	98	92860900	91
chr1	92860991	93060991	harbor2	chr1	92866549	92866944	LTR/ERVL	1413	+	198	92866747	5756
chr1	92860991	93060991	harbor2	chr1	92870640	92871070	LTR/ERVL	1326	+	215	92870855	9864
chr1	16545147	16745147	harbor2	chr1	16560670	16560870	LTR/ERVL	779	+	100	16560770	15623
chr1	244608951	244808951	harbor2	chr1	244644512	244644942	LTR/ERVL	1120	+	215	244644727	35776
chr1	244608951	244808951	harbor2	chr1	244644953	244645618	LTR/ERVL	1325	+	332	244645285	36334
chr1	244608951	244808951	harbor2	chr1	244647978	244648381	LTR/ERVL	590	+	202	244648180	39229
chr1	244608951	244808951	harbor2	chr1	244665526	244665854	LTR/ERVL	1793	+	164	244665690	56739
chr1	244608951	244808951	harbor2	chr1	244696661	244697204	LTR/ERVL	3037	+	272	244696933	87982
chr1	244608951	244808951	harbor2	chr1	244697207	244697225	LTR/ERVL	10237	+	9	244697216	88265
chr1	244608951	244808951	harbor2	chr1	244697494	244699301	LTR/ERVL	10237	+	904	244698398	89447
chr1	244608951	244808951	harbor2	chr1	244699609	244700085	LTR/ERVL	10237	+	238	244699847	90896
chr1	244608951	244808951	harbor2	chr1	244700086	244700259	LTR/ERVL	731	+	86	244700172	91221
chr1	244608951	244808951	harbor2	chr1	244645678	244646518	LTR/ERVL	2943	+	420	244646098	37147
chr1	16544769	16744769	harbor2	chr1	16560670	16560870	LTR/ERVL	779	+	100	16560770	16001
chr1	16544800	16744800	harbor2	chr1	16560670	16560870	LTR/ERVL	779	+	100	16560770	15970
chr1	39855881	40055881	harbor2	chr1	39908119	39908877	LTR/ERVL	1564	+	379	39908498	52617
chr1	67493952	67693952	harbor2	chr1	67494703	67494864	LTR/ERVL	541	+	80	67494783	831
chr1	67493952	67693952	harbor2	chr1	67495023	67495189	LTR/ERVL	598	+	83	67495106	1154
chr1	67493952	67693952	harbor2	chr1	67522138	67522394	LTR/ERVL	1047	+	128	67522266	28314
chr1	67493952	67693952	harbor2	chr1	67553415	67553730	LTR/ERVL	907	+	158	67553573	59621
chr1	16544895	16744895	harbor2	chr1	16560670	16560870	LTR/ERVL	779	+	100	16560770	15875
chr1	205330799	205530799	harbor2	chr1	205400557	205400689	LTR/ERVL	725	+	66	205400623	69824
chr1	205330799	205530799	harbor2	chr1	205406860	205407049	LTR/ERVL	3417	+	94	205406954	76155
chr1	205330799	205530799	harbor2	chr1	205407350	205407951	LTR/ERVL	3417	+	300	205407650	76851
chr1	16544813	16744813	harbor2	chr1	16560670	16560870	LTR/ERVL	779	+	100	16560770	15957
chr1	74605285	74805285	harbor2	chr1	74624633	74624756	LTR/ERVL	539	+	62	74624695	19410
chr1	74605285	74805285	harbor2	chr1	74625120	74625240	LTR/ERVL	715	+	60	74625180	19895
chr1	74605285	74805285	harbor2	chr1	74637053	74637523	LTR/ERVL	1043	+	235	74637288	32003
chr1	74605285	74805285	harbor2	chr1	74655970	74656426	LTR/ERVL	2459	+	228	74656198	50913
chr1	74605285	74805285	harbor2	chr1	74703921	74704183	LTR/ERVL	1372	+	131	74704052	98767
chr1	2376027	2576027	harbor2	chr1	2383092	2383334	LTR/ERVL	518	+	121	2383213	7186
chr1	16545132	16745132	harbor2	chr1	16560670	16560870	LTR/ERVL	779	+	100	16560770	15638
chr1	43467195	43667195	harbor2	chr1	43475797	43476063	LTR/ERVL	630	+	133	43475930	8735
chr1	43467195	43667195	harbor2	chr1	43512809	43513353	LTR/ERVL	1189	+	272	43513081	45886
chr1	43467195	43667195	harbor2	chr1	43521788	43522217	LTR/ERVL	1254	+	214	43522002	54807
chr1	31479906	31679906	harbor2	chr1	31483347	31484023	LTR/ERVL	598	+	338	31483685	3779
chr1	31479906	31679906	harbor2	chr1	31517845	31518481	LTR/ERVL	5191	+	318	31518163	38257
chr1	31479906	31679906	harbor2	chr1	31518486	31518912	LTR/ERVL	3369	+	213	31518699	38793
chr1	727526	927526	harbor2	chr1	741124	741629	LTR/ERVL	3337	+	252	741376	13850
chr1	727526	927526	harbor2	chr1	741937	742006	LTR/ERVL	3337	+	34	741971	14445
chr1	727526	927526	harbor2	chr1	742310	742610	LTR/ERVL	3337	+	150	742460	14934
chr1	727526	927526	harbor2	chr1	752876	753134	LTR/ERVL	3365	+	129	753005	25479
chr1	727526	927526	harbor2	chr1	754046	754345	LTR/ERVL	3365	+	150	754196	26670
chr1	727526	927526	harbor2	chr1	753429	753738	LTR/ERVL	3365	+	154	753583	26057
chr1	2375920	2575920	harbor2	chr1	2383092	2383334	LTR/ERVL	518	+	121	2383213	7293
chr1	110864043	111064043	harbor2	chr1	110917043	110917419	LTR/ERVL	1788	+	188	110917231	53188
chr1	110864043	111064043	harbor2	chr1	110919150	110919585	LTR/ERVL	3007	+	218	110919368	55325
chr1	110864043	111064043	harbor2	chr1	110925053	110925498	LTR/ERVL	2093	+	222	110925275	61232
chr1	191972112	192172112	harbor2	chr1	191975446	191975746	LTR/ERVL	1392	+	150	191975596	3484
chr1	191972112	192172112	harbor2	chr1	192061633	192062064	LTR/ERVL	1502	+	216	192061849	89737
chr1	61555229	61755229	harbor2	chr1	61609167	61610974	LTR/ERVL	4920	+	904	61610071	54842
chr1	61555229	61755229	harbor2	chr1	61624862	61625411	LTR/ERVL	1205	+	274	61625136	69907
chr1	61555229	61755229	harbor2	chr1	61626690	61627187	LTR/ERVL	1426	+	248	61626938	71709
chr1	61555229	61755229	harbor2	chr1	61632364	61632456	LTR/ERVL	1590	+	46	61632410	77181
chr1	61555229	61755229	harbor2	chr1	61632619	61634362	LTR/ERVL	1757	+	872	61633491	78262
chr1	170517376	170717376	harbor2	chr1	170581119	170581470	LTR/ERVL	859	+	176	170581295	63919
chr1	16838763	17038763	harbor2	chr1	16896667	16896830	LTR/ERVL	508	+	82	16896749	57986
chr1	38904921	39104921	harbor2	chr1	38917795	38918216	LTR/ERVL	2054	+	210	38918005	13084
chr1	38904921	39104921	harbor2	chr1	38961239	38961301	LTR/ERVL	1331	+	31	38961270	56349
chr1	38904921	39104921	harbor2	chr1	38961608	38962042	LTR/ERVL	1331	+	217	38961825	56904
chr1	211730531	211930531	harbor2	chr1	211765783	211766365	LTR/ERVL	2079	+	291	211766074	35543
chr1	211730531	211930531	harbor2	chr1	211766871	211766910	LTR/ERVL	1688	+	20	211766891	36360
chr1	244605752	244805752	harbor2	chr1	244644512	244644942	LTR/ERVL	1120	+	215	244644727	38975
chr1	244605752	244805752	harbor2	chr1	244644953	244645618	LTR/ERVL	1325	+	332	244645285	39533
chr1	244605752	244805752	harbor2	chr1	244647978	244648381	LTR/ERVL	590	+	202	244648180	42428
chr1	244605752	244805752	harbor2	chr1	244665526	244665854	LTR/ERVL	1793	+	164	244665690	59938
chr1	244605752	244805752	harbor2	chr1	244696661	244697204	LTR/ERVL	3037	+	272	244696933	91181
chr1	244605752	244805752	harbor2	chr1	244697207	244697225	LTR/ERVL	10237	+	9	244697216	91464
chr1	244605752	244805752	harbor2	chr1	244697494	244699301	LTR/ERVL	10237	+	904	244698398	92646
chr1	244605752	244805752	harbor2	chr1	244699609	244700085	LTR/ERVL	10237	+	238	244699847	94095
chr1	244605752	244805752	harbor2	chr1	244700086	244700259	LTR/ERVL	731	+	86	244700172	94420
chr1	244605752	244805752	harbor2	chr1	244645678	244646518	LTR/ERVL	2943	+	420	244646098	40346
chr1	76547403	76747403	harbor2	chr1	76588539	76589042	LTR/ERVL	1697	+	252	76588791	41388
chr1	227441438	227641438	harbor2	chr1	227444112	227445179	LTR/ERVL	7121	+	534	227444646	3208
chr1	227441438	227641438	harbor2	chr1	227445180	227445567	LTR/ERVL	1998	+	194	227445374	3936
chr1	227441438	227641438	harbor2	chr1	227445872	227445934	LTR/ERVL	1998	+	31	227445903	4465
chr1	227441438	227641438	harbor2	chr1	227453765	227454144	LTR/ERVL	659	+	190	227453955	12517
chr1	16544742	16744742	harbor2	chr1	16560670	16560870	LTR/ERVL	779	+	100	16560770	16028
chr1	16544837	16744837	harbor2	chr1	16560670	16560870	LTR/ERVL	779	+	100	16560770	15933
chr1	53847584	54047584	harbor2	chr1	53890504	53890997	LTR/ERVL	1036	+	246	53890750	43166
chr1	53847584	54047584	harbor2	chr1	53891310	53891620	LTR/ERVL	508	+	155	53891465	43881
chr1	53847584	54047584	harbor2	chr1	53891764	53892293	LTR/ERVL	1258	+	264	53892028	44444
chr1	53847584	54047584	harbor2	chr1	53912961	53913417	LTR/ERVL	2123	+	228	53913189	65605
chr1	53847584	54047584	harbor2	chr1	53929028	53929505	LTR/ERVL	1177	+	238	53929266	81682
chr1	53856437	54056437	harbor2	chr1	53890504	53890997	LTR/ERVL	1036	+	246	53890750	34313
chr1	53856437	54056437	harbor2	chr1	53891310	53891620	LTR/ERVL	508	+	155	53891465	35028
chr1	53856437	54056437	harbor2	chr1	53891764	53892293	LTR/ERVL	1258	+	264	53892028	35591
chr1	53856437	54056437	harbor2	chr1	53912961	53913417	LTR/ERVL	2123	+	228	53913189	56752
chr1	53856437	54056437	harbor2	chr1	53929028	53929505	LTR/ERVL	1177	+	238	53929266	72829
chr1	16544790	16744790	harbor2	chr1	16560670	16560870	LTR/ERVL	779	+	100	16560770	15980
chr1	182932329	183132329	harbor2	chr1	182990690	182991167	LTR/ERVL	1103	+	238	182990928	58599
chr1	16546417	16746417	harbor2	chr1	16560670	16560870	LTR/ERVL	779	+	100	16560770	14353
chr1	21392241	21592241	harbor2	chr1	21421351	21421551	LTR/ERVL	678	+	100	21421451	29210
chr1	21392241	21592241	harbor2	chr1	21453079	21453372	LTR/ERVL	597	+	146	21453225	60984
chr1	21392241	21592241	harbor2	chr1	21453383	21453605	LTR/ERVL	519	+	111	21453494	61253
chr1	21392241	21592241	harbor2	chr1	21453623	21453988	LTR/ERVL	825	+	182	21453805	61564
chr1	211034229	211234229	harbor2	chr1	211067248	211067560	LTR/ERVL	791	+	156	211067404	33175
chr1	211034229	211234229	harbor2	chr1	211074301	211074595	LTR/ERVL	1044	+	147	211074448	40219
chr1	211034229	211234229	harbor2	chr1	211074600	211074993	LTR/ERVL	1575	+	196	211074796	40567
chr1	211034229	211234229	harbor2	chr1	211093920	211094076	LTR/ERVL	730	+	78	211093998	59769
chr1	211034229	211234229	harbor2	chr1	211094405	211094497	LTR/ERVL	730	+	46	211094451	60222
chr1	211034229	211234229	harbor2	chr1	211115321	211115701	LTR/ERVL	3316	+	190	211115511	81282
chr1	211034229	211234229	harbor2	chr1	211115732	211115794	LTR/ERVL	3316	+	31	211115763	81534
chr1	59715217	59915217	harbor2	chr1	59739870	59740144	LTR/ERVL	705	+	137	59740007	24790
chr1	59715217	59915217	harbor2	chr1	59748678	59749547	LTR/ERVL	3440	+	434	59749112	33895
chr1	59715217	59915217	harbor2	chr1	59808730	59809101	LTR/ERVL	1449	+	186	59808916	93699
chr1	59715217	59915217	harbor2	chr1	59785190	59785330	LTR/ERVL	475	+	70	59785260	70043
chr1	244735652	244935652	harbor2	chr1	244795446	244795714	LTR/ERVL	1165	+	134	244795580	59928
chr1	244763056	244963056	harbor2	chr1	244795446	244795714	LTR/ERVL	1165	+	134	244795580	32524
chr1	16544707	16744707	harbor2	chr1	16560670	16560870	LTR/ERVL	779	+	100	16560770	16063
chr1	227442483	227642483	harbor2	chr1	227444112	227445179	LTR/ERVL	7121	+	534	227444646	2163
chr1	227442483	227642483	harbor2	chr1	227445180	227445567	LTR/ERVL	1998	+	194	227445374	2891
chr1	227442483	227642483	harbor2	chr1	227445872	227445934	LTR/ERVL	1998	+	31	227445903	3420
chr1	227442483	227642483	harbor2	chr1	227453765	227454144	LTR/ERVL	659	+	190	227453955	11472
chr1	25574287	25774287	harbor2	chr1	25589380	25589820	LTR/ERVL	2218	+	220	25589600	15313
chr1	25574287	25774287	harbor2	chr1	25590118	25590184	LTR/ERVL	2218	+	33	25590151	15864
chr1	25574287	25774287	harbor2	chr1	25598359	25598749	LTR/ERVL	1106	+	195	25598554	24267
chr1	25574287	25774287	harbor2	chr1	25613656	25614173	LTR/ERVL	3425	+	258	25613914	39627
chr1	116272865	116472865	harbor2	chr1	116334973	116335299	LTR/ERVL	684	+	163	116335136	62271
chr1	116272865	116472865	harbor2	chr1	116347794	116347952	LTR/ERVL	497	+	79	116347873	75008
chr1	244631205	244831205	harbor2	chr1	244644512	244644942	LTR/ERVL	1120	+	215	244644727	13522
chr1	244631205	244831205	harbor2	chr1	244644953	244645618	LTR/ERVL	1325	+	332	244645285	14080
chr1	244631205	244831205	harbor2	chr1	244647978	244648381	LTR/ERVL	590	+	202	244648180	16975
chr1	244631205	244831205	harbor2	chr1	244665526	244665854	LTR/ERVL	1793	+	164	244665690	34485
chr1	244631205	244831205	harbor2	chr1	244696661	244697204	LTR/ERVL	3037	+	272	244696933	65728
chr1	244631205	244831205	harbor2	chr1	244697207	244697225	LTR/ERVL	10237	+	9	244697216	66011
chr1	244631205	244831205	harbor2	chr1	244697494	244699301	LTR/ERVL	10237	+	904	244698398	67193
chr1	244631205	244831205	harbor2	chr1	244699609	244700085	LTR/ERVL	10237	+	238	244699847	68642
chr1	244631205	244831205	harbor2	chr1	244700086	244700259	LTR/ERVL	731	+	86	244700172	68967
chr1	244631205	244831205	harbor2	chr1	244645678	244646518	LTR/ERVL	2943	+	420	244646098	14893
chr1	244605764	244805764	harbor2	chr1	244644512	244644942	LTR/ERVL	1120	+	215	244644727	38963
chr1	244605764	244805764	harbor2	chr1	244644953	244645618	LTR/ERVL	1325	+	332	244645285	39521
chr1	244605764	244805764	harbor2	chr1	244647978	244648381	LTR/ERVL	590	+	202	244648180	42416
chr1	244605764	244805764	harbor2	chr1	244665526	244665854	LTR/ERVL	1793	+	164	244665690	59926
chr1	244605764	244805764	harbor2	chr1	244696661	244697204	LTR/ERVL	3037	+	272	244696933	91169
chr1	244605764	244805764	harbor2	chr1	244697207	244697225	LTR/ERVL	10237	+	9	244697216	91452
chr1	244605764	244805764	harbor2	chr1	244697494	244699301	LTR/ERVL	10237	+	904	244698398	92634
chr1	244605764	244805764	harbor2	chr1	244699609	244700085	LTR/ERVL	10237	+	238	244699847	94083
chr1	244605764	244805764	harbor2	chr1	244700086	244700259	LTR/ERVL	731	+	86	244700172	94408
chr1	244605764	244805764	harbor2	chr1	244645678	244646518	LTR/ERVL	2943	+	420	244646098	40334
chr1	17020269	17220269	harbor2	chr1	17065877	17066151	LTR/ERVL	815	+	137	17066014	45745
chr1	17020269	17220269	harbor2	chr1	17066461	17066524	LTR/ERVL	815	+	32	17066493	46224
chr1	148210264	148410264	harbor2	chr1	148234810	148234960	LTR/ERVL	445	+	75	148234885	24621
chr1	148210264	148410264	harbor2	chr1	148281965	148282472	LTR/ERVL	2328	+	254	148282219	71955
chr1	31479894	31679894	harbor2	chr1	31483347	31484023	LTR/ERVL	598	+	338	31483685	3791
chr1	31479894	31679894	harbor2	chr1	31517845	31518481	LTR/ERVL	5191	+	318	31518163	38269
chr1	31479894	31679894	harbor2	chr1	31518486	31518912	LTR/ERVL	3369	+	213	31518699	38805
chr1	16545142	16745142	harbor2	chr1	16560670	16560870	LTR/ERVL	779	+	100	16560770	15628
chr1	110113147	110313147	harbor2	chr1	110126077	110126221	LTR/ERVL	565	+	72	110126149	13002
chr1	110113147	110313147	harbor2	chr1	110126245	110126551	LTR/ERVL	831	+	153	110126398	13251
chr1	110113147	110313147	harbor2	chr1	110127735	110128026	LTR/ERVL	1122	+	146	110127881	14734
chr1	110113147	110313147	harbor2	chr1	110149022	110149492	LTR/ERVL	1653	+	235	110149257	36110
chr1	16546458	16746458	harbor2	chr1	16560670	16560870	LTR/ERVL	779	+	100	16560770	14312
chr1	180065529	180265529	harbor2	chr1	180119756	180120116	LTR/ERVL	1456	+	180	180119936	54407
chr1	180065529	180265529	harbor2	chr1	180150951	180151399	LTR/ERVL	942	+	224	180151175	85646
chr1	727539	927539	harbor2	chr1	741124	741629	LTR/ERVL	3337	+	252	741376	13837
chr1	727539	927539	harbor2	chr1	741937	742006	LTR/ERVL	3337	+	34	741971	14432
chr1	727539	927539	harbor2	chr1	742310	742610	LTR/ERVL	3337	+	150	742460	14921
chr1	727539	927539	harbor2	chr1	752876	753134	LTR/ERVL	3365	+	129	753005	25466
chr1	727539	927539	harbor2	chr1	754046	754345	LTR/ERVL	3365	+	150	754196	26657
chr1	727539	927539	harbor2	chr1	753429	753738	LTR/ERVL	3365	+	154	753583	26044
chr1	244609671	244809671	harbor2	chr1	244644512	244644942	LTR/ERVL	1120	+	215	244644727	35056
chr1	244609671	244809671	harbor2	chr1	244644953	244645618	LTR/ERVL	1325	+	332	244645285	35614
chr1	244609671	244809671	harbor2	chr1	244647978	244648381	LTR/ERVL	590	+	202	244648180	38509
chr1	244609671	244809671	harbor2	chr1	244665526	244665854	LTR/ERVL	1793	+	164	244665690	56019
chr1	244609671	244809671	harbor2	chr1	244696661	244697204	LTR/ERVL	3037	+	272	244696933	87262
chr1	244609671	244809671	harbor2	chr1	244697207	244697225	LTR/ERVL	10237	+	9	244697216	87545
chr1	244609671	244809671	harbor2	chr1	244697494	244699301	LTR/ERVL	10237	+	904	244698398	88727
chr1	244609671	244809671	harbor2	chr1	244699609	244700085	LTR/ERVL	10237	+	238	244699847	90176
chr1	244609671	244809671	harbor2	chr1	244700086	244700259	LTR/ERVL	731	+	86	244700172	90501
chr1	244609671	244809671	harbor2	chr1	244645678	244646518	LTR/ERVL	2943	+	420	244646098	36427
chr1	20052576	20252576	harbor2	chr1	20055223	20055839	LTR/ERVL	2101	+	308	20055531	2955
chr1	20052576	20252576	harbor2	chr1	20059578	20059762	LTR/ERVL	516	+	92	20059670	7094
chr1	20052576	20252576	harbor2	chr1	20059879	20059997	LTR/ERVL	481	+	59	20059938	7362
chr1	20052576	20252576	harbor2	chr1	20094082	20094704	LTR/ERVL	1345	+	311	20094393	41817
chr1	20052576	20252576	harbor2	chr1	20094722	20095038	LTR/ERVL	884	+	158	20094880	42304
chr1	20052576	20252576	harbor2	chr1	20095194	20096476	LTR/ERVL	4626	+	641	20095835	43259
chr1	20052576	20252576	harbor2	chr1	20096488	20096749	LTR/ERVL	1079	+	130	20096618	44042
chr1	20052576	20252576	harbor2	chr1	20096756	20097380	LTR/ERVL	1329	+	312	20097068	44492
chr1	223604865	223804865	harbor2	chr1	223671997	223672277	LTR/ERVL	1644	+	140	223672137	67272
chr1	223604865	223804865	harbor2	chr1	223672642	223672817	LTR/ERVL	1644	+	88	223672730	67865
chr1	223604865	223804865	harbor2	chr1	223675826	223675945	LTR/ERVL	2409	+	60	223675886	71021
chr1	223604865	223804865	harbor2	chr1	223676288	223676675	LTR/ERVL	2409	+	194	223676482	71617
chr1	223604865	223804865	harbor2	chr1	223688596	223688857	LTR/ERVL	796	+	130	223688726	83861
chr1	223604865	223804865	harbor2	chr1	223703455	223703792	LTR/ERVL	1450	+	168	223703623	98758
chr1	3845544	4045544	harbor2	chr1	3879943	3880467	LTR/ERVL	1243	+	262	3880205	34661
chr1	3845544	4045544	harbor2	chr1	3932733	3933030	LTR/ERVL	907	+	148	3932881	87337
chr1	3845544	4045544	harbor2	chr1	3931848	3932322	LTR/ERVL	1312	+	237	3932085	86541
chr1	228074079	228274079	harbor2	chr1	228085858	228086233	LTR/ERVL	2085	+	188	228086046	11967
chr1	228074079	228274079	harbor2	chr1	228086543	228087054	LTR/ERVL	2085	+	256	228086799	12720
chr1	228074079	228274079	harbor2	chr1	228104356	228104844	LTR/ERVL	2420	+	244	228104600	30521
chr1	228074079	228274079	harbor2	chr1	228125570	228125724	LTR/ERVL	481	+	77	228125647	51568
chr1	1247817	1447817	harbor2	chr1	1259547	1259908	LTR/ERVL	794	+	180	1259727	11910
chr1	1247817	1447817	harbor2	chr1	1265307	1265513	LTR/ERVL	583	+	103	1265410	17593
chr1	244605740	244805740	harbor2	chr1	244644512	244644942	LTR/ERVL	1120	+	215	244644727	38987
chr1	244605740	244805740	harbor2	chr1	244644953	244645618	LTR/ERVL	1325	+	332	244645285	39545
chr1	244605740	244805740	harbor2	chr1	244647978	244648381	LTR/ERVL	590	+	202	244648180	42440
chr1	244605740	244805740	harbor2	chr1	244665526	244665854	LTR/ERVL	1793	+	164	244665690	59950
chr1	244605740	244805740	harbor2	chr1	244696661	244697204	LTR/ERVL	3037	+	272	244696933	91193
chr1	244605740	244805740	harbor2	chr1	244697207	244697225	LTR/ERVL	10237	+	9	244697216	91476
chr1	244605740	244805740	harbor2	chr1	244697494	244699301	LTR/ERVL	10237	+	904	244698398	92658
chr1	244605740	244805740	harbor2	chr1	244699609	244700085	LTR/ERVL	10237	+	238	244699847	94107
chr1	244605740	244805740	harbor2	chr1	244700086	244700259	LTR/ERVL	731	+	86	244700172	94432
chr1	244605740	244805740	harbor2	chr1	244645678	244646518	LTR/ERVL	2943	+	420	244646098	40358
chr1	230028630	230228630	harbor2	chr1	230032373	230032548	LTR/ERVL	980	+	88	230032461	3831
chr1	230028630	230228630	harbor2	chr1	230048109	230048648	LTR/ERVL	2383	+	270	230048379	19749
chr1	230028630	230228630	harbor2	chr1	230085176	230085618	LTR/ERVL	2649	+	221	230085397	56767
chr1	230028630	230228630	harbor2	chr1	230091825	230092076	LTR/ERVL	695	+	126	230091951	63321
chr1	165727908	165927908	harbor2	chr1	165796037	165796327	LTR/ERVL	1271	+	145	165796182	68274
chr1	165727908	165927908	harbor2	chr1	165815775	165816219	LTR/ERVL	1618	+	222	165815997	88089
chr1	165727908	165927908	harbor2	chr1	165816220	165816588	LTR/ERVL	3334	+	184	165816404	88496
chr1	165727908	165927908	harbor2	chr1	165816886	165817340	LTR/ERVL	3334	+	227	165817113	89205
chr1	165727908	165927908	harbor2	chr1	165817965	165818468	LTR/ERVL	3334	+	252	165818217	90309
chr1	241289600	241489600	harbor2	chr1	241360087	241360672	LTR/ERVL	1529	+	292	241360379	70779
chr1	212332813	212532813	harbor2	chr1	212418912	212419081	LTR/ERVL	861	+	84	212418996	86183
chr1	212332813	212532813	harbor2	chr1	212419391	212419543	LTR/ERVL	861	+	76	212419467	86654
chr1	32108058	32308058	harbor2	chr1	32159568	32159659	LTR/ERVL	498	+	46	32159614	51556
chr1	32108058	32308058	harbor2	chr1	32159627	32159846	LTR/ERVL	801	+	110	32159737	51679
chr1	16544730	16744730	harbor2	chr1	16560670	16560870	LTR/ERVL	779	+	100	16560770	16040
chr1	230743397	230943397	harbor2	chr1	230764090	230764531	LTR/ERVL	2539	+	220	230764310	20913
chr1	89721814	89921814	harbor2	chr1	89728850	89729141	LTR/ERVL	487	+	146	89728996	7182
chr1	89721814	89921814	harbor2	chr1	89730971	89731379	LTR/ERVL	2221	+	204	89731175	9361
chr1	89721814	89921814	harbor2	chr1	89742627	89742764	LTR/ERVL	708	+	68	89742695	20881
chr1	116393750	116593750	harbor2	chr1	116420909	116421307	LTR/ERVL	1505	+	199	116421108	27358
chr1	220688388	220888388	harbor2	chr1	220708196	220708488	LTR/ERVL	2248	+	146	220708342	19954
chr1	220688388	220888388	harbor2	chr1	220708886	220708951	LTR/ERVL	2248	+	32	220708918	20530
chr1	220688388	220888388	harbor2	chr1	220709052	220709615	LTR/ERVL	2279	+	282	220709334	20946
chr1	220688388	220888388	harbor2	chr1	220772902	220773727	LTR/ERVL	3186	+	412	220773314	84926
chr1	235647632	235847632	harbor2	chr1	235669058	235669277	LTR/ERVL	761	+	110	235669168	21536
chr1	235647632	235847632	harbor2	chr1	235669900	235669997	LTR/ERVL	761	+	48	235669948	22316
chr1	235647632	235847632	harbor2	chr1	235675612	235675829	LTR/ERVL	528	+	108	235675720	28088
chr1	235647632	235847632	harbor2	chr1	235708372	235708904	LTR/ERVL	2881	+	266	235708638	61006
chr1	79970074	80170074	harbor2	chr1	79984847	79985278	LTR/ERVL	656	+	216	79985063	14989
chr1	79970074	80170074	harbor2	chr1	80025595	80025983	LTR/ERVL	1944	+	194	80025789	55715
chr1	79970074	80170074	harbor2	chr1	80050218	80050574	LTR/ERVL	2232	+	178	80050396	80322
chr1	79970074	80170074	harbor2	chr1	80050590	80051030	LTR/ERVL	2275	+	220	80050810	80736
chr1	79970074	80170074	harbor2	chr1	80051030	80051208	LTR/ERVL	728	+	89	80051119	81045
chr1	79970074	80170074	harbor2	chr1	80051203	80051394	LTR/ERVL	1220	+	96	80051299	81225
chr1	79970074	80170074	harbor2	chr1	80051394	80051662	LTR/ERVL	1283	+	134	80051528	81454
chr1	79970074	80170074	harbor2	chr1	80052495	80052588	LTR/ERVL	674	+	46	80052541	82467
chr1	79970074	80170074	harbor2	chr1	80054238	80054588	LTR/ERVL	2237	+	175	80054413	84339
chr1	79970074	80170074	harbor2	chr1	80051662	80052493	LTR/ERVL	5191	+	416	80052078	82004
chr1	2380447	2580447	harbor2	chr1	2383092	2383334	LTR/ERVL	518	+	121	2383213	2766
chr1	5894141	6094141	harbor2	chr1	5946549	5946979	LTR/ERVL	1363	+	215	5946764	52623
chr1	5894141	6094141	harbor2	chr1	5983247	5983721	LTR/ERVL	2349	+	237	5983484	89343
chr1	5894141	6094141	harbor2	chr1	5979819	5980351	LTR/ERVL	1406	+	266	5980085	85944
chr1	207932133	208132133	harbor2	chr1	207992024	207992113	LTR/ERVL	1735	+	44	207992068	59935
chr1	207932133	208132133	harbor2	chr1	207992420	207992705	LTR/ERVL	1735	+	142	207992562	60429
chr1	207932133	208132133	harbor2	chr1	208017627	208017985	LTR/ERVL	2264	+	179	208017806	85673
chr1	207932133	208132133	harbor2	chr1	208018038	208018085	LTR/ERVL	2264	+	24	208018062	85929
chr1	1247824	1447824	harbor2	chr1	1259547	1259908	LTR/ERVL	794	+	180	1259727	11903
chr1	1247824	1447824	harbor2	chr1	1265307	1265513	LTR/ERVL	583	+	103	1265410	17586
chr1	211005470	211205470	harbor2	chr1	211067248	211067560	LTR/ERVL	791	+	156	211067404	61934
chr1	211005470	211205470	harbor2	chr1	211074301	211074595	LTR/ERVL	1044	+	147	211074448	68978
chr1	211005470	211205470	harbor2	chr1	211074600	211074993	LTR/ERVL	1575	+	196	211074796	69326
chr1	211005470	211205470	harbor2	chr1	211093920	211094076	LTR/ERVL	730	+	78	211093998	88528
chr1	211005470	211205470	harbor2	chr1	211094405	211094497	LTR/ERVL	730	+	46	211094451	88981
chr1	70202324	70402324	harbor2	chr1	70294355	70294616	LTR/ERVL	1726	+	130	70294485	92161
chr1	70202324	70402324	harbor2	chr1	70294839	70294969	LTR/ERVL	531	+	65	70294904	92580
chr1	16545145	16745145	harbor2	chr1	16560670	16560870	LTR/ERVL	779	+	100	16560770	15625
chr1	26442085	26642085	harbor2	chr1	26496945	26497334	LTR/ERVL	993	+	194	26497139	55054
chr1	16544776	16744776	harbor2	chr1	16560670	16560870	LTR/ERVL	779	+	100	16560770	15994
chr1	42648943	42848943	harbor2	chr1	42719961	42720382	LTR/ERVL	1250	+	210	42720171	71228
chr1	16544734	16744734	harbor2	chr1	16560670	16560870	LTR/ERVL	779	+	100	16560770	16036
chr1	17063875	17263875	harbor2	chr1	17065877	17066151	LTR/ERVL	815	+	137	17066014	2139
chr1	17063875	17263875	harbor2	chr1	17066461	17066524	LTR/ERVL	815	+	32	17066493	2618
chr1	17063875	17263875	harbor2	chr1	17161558	17161766	LTR/ERVL	573	+	104	17161662	97787
chr1	31973331	32173331	harbor2	chr1	32009055	32009614	LTR/ERVL	2916	+	280	32009335	36004
chr1	22374602	22574602	harbor2	chr1	22432036	22432193	LTR/ERVL	618	+	78	22432114	57512
chr1	22374602	22574602	harbor2	chr1	22432266	22432432	LTR/ERVL	448	+	83	22432349	57747
chr1	16545003	16745003	harbor2	chr1	16560670	16560870	LTR/ERVL	779	+	100	16560770	15767
chr1	199637514	199837514	harbor2	chr1	199689104	199689587	LTR/ERVL	1601	+	242	199689346	51832
chr1	199637514	199837514	harbor2	chr1	199718344	199718721	LTR/ERVL	1640	+	188	199718532	81018
chr1	199637514	199837514	harbor2	chr1	199718828	199718981	LTR/ERVL	457	+	76	199718904	81390
chr1	199637514	199837514	harbor2	chr1	199728185	199728351	LTR/ERVL	561	+	83	199728268	90754
chr1	199637514	199837514	harbor2	chr1	199735561	199735759	LTR/ERVL	523	+	99	199735660	98146
chr1	248598635	248798635	harbor2	chr1	248670264	248670680	LTR/ERVL	2316	+	208	248670472	71837
chr1	244608247	244808247	harbor2	chr1	244644512	244644942	LTR/ERVL	1120	+	215	244644727	36480
chr1	244608247	244808247	harbor2	chr1	244644953	244645618	LTR/ERVL	1325	+	332	244645285	37038
chr1	244608247	244808247	harbor2	chr1	244647978	244648381	LTR/ERVL	590	+	202	244648180	39933
chr1	244608247	244808247	harbor2	chr1	244665526	244665854	LTR/ERVL	1793	+	164	244665690	57443
chr1	244608247	244808247	harbor2	chr1	244696661	244697204	LTR/ERVL	3037	+	272	244696933	88686
chr1	244608247	244808247	harbor2	chr1	244697207	244697225	LTR/ERVL	10237	+	9	244697216	88969
chr1	244608247	244808247	harbor2	chr1	244697494	244699301	LTR/ERVL	10237	+	904	244698398	90151
chr1	244608247	244808247	harbor2	chr1	244699609	244700085	LTR/ERVL	10237	+	238	244699847	91600
chr1	244608247	244808247	harbor2	chr1	244700086	244700259	LTR/ERVL	731	+	86	244700172	91925
chr1	244608247	244808247	harbor2	chr1	244645678	244646518	LTR/ERVL	2943	+	420	244646098	37851
chr1	40924280	41124280	harbor2	chr1	40960559	40960815	LTR/ERVL	2236	+	128	40960687	36407
chr1	40924280	41124280	harbor2	chr1	40961126	40961306	LTR/ERVL	2236	+	90	40961216	36936
chr1	40924280	41124280	harbor2	chr1	40961600	40961732	LTR/ERVL	2236	+	66	40961666	37386
chr1	40924280	41124280	harbor2	chr1	40966155	40966664	LTR/ERVL	1998	+	254	40966409	42129
chr1	211034263	211234263	harbor2	chr1	211067248	211067560	LTR/ERVL	791	+	156	211067404	33141
chr1	211034263	211234263	harbor2	chr1	211074301	211074595	LTR/ERVL	1044	+	147	211074448	40185
chr1	211034263	211234263	harbor2	chr1	211074600	211074993	LTR/ERVL	1575	+	196	211074796	40533
chr1	211034263	211234263	harbor2	chr1	211093920	211094076	LTR/ERVL	730	+	78	211093998	59735
chr1	211034263	211234263	harbor2	chr1	211094405	211094497	LTR/ERVL	730	+	46	211094451	60188
chr1	211034263	211234263	harbor2	chr1	211115321	211115701	LTR/ERVL	3316	+	190	211115511	81248
chr1	211034263	211234263	harbor2	chr1	211115732	211115794	LTR/ERVL	3316	+	31	211115763	81500
chr1	234510831	234710831	harbor2	chr1	234541781	234542200	LTR/ERVL	1788	+	210	234541991	31160
chr1	234510831	234710831	harbor2	chr1	234570803	234571225	LTR/ERVL	1550	+	211	234571014	60183
chr1	234510831	234710831	harbor2	chr1	234590398	234590847	LTR/ERVL	2284	+	224	234590622	79791
chr1	211034198	211234198	harbor2	chr1	211067248	211067560	LTR/ERVL	791	+	156	211067404	33206
chr1	211034198	211234198	harbor2	chr1	211074301	211074595	LTR/ERVL	1044	+	147	211074448	40250
chr1	211034198	211234198	harbor2	chr1	211074600	211074993	LTR/ERVL	1575	+	196	211074796	40598
chr1	211034198	211234198	harbor2	chr1	211093920	211094076	LTR/ERVL	730	+	78	211093998	59800
chr1	211034198	211234198	harbor2	chr1	211094405	211094497	LTR/ERVL	730	+	46	211094451	60253
chr1	211034198	211234198	harbor2	chr1	211115321	211115701	LTR/ERVL	3316	+	190	211115511	81313
chr1	211034198	211234198	harbor2	chr1	211115732	211115794	LTR/ERVL	3316	+	31	211115763	81565
chr1	37143776	37343776	harbor2	chr1	37238980	37239462	LTR/ERVL	776	+	241	37239221	95445
chr1	16946370	17146370	harbor2	chr1	16959817	16959944	LTR/ERVL	445	+	64	16959881	13511
chr1	16946370	17146370	harbor2	chr1	17003049	17003267	LTR/ERVL	463	+	109	17003158	56788
chr1	42319822	42519822	harbor2	chr1	42345729	42345991	LTR/ERVL	516	+	131	42345860	26038
chr1	42319822	42519822	harbor2	chr1	42353267	42353684	LTR/ERVL	886	+	208	42353475	33653
chr1	42319822	42519822	harbor2	chr1	42392455	42392676	LTR/ERVL	827	+	110	42392565	72743
chr1	42319822	42519822	harbor2	chr1	42393013	42393251	LTR/ERVL	889	+	119	42393132	73310
chr1	17216061	17416061	harbor2	chr1	17295845	17296296	LTR/ERVL	1682	+	226	17296071	80010
chr1	17216061	17416061	harbor2	chr1	17296525	17296925	LTR/ERVL	1798	+	200	17296725	80664
chr1	6367837	6567837	harbor2	chr1	6411051	6411736	LTR/ERVL	1562	+	342	6411393	43556
chr1	223143141	223343141	harbor2	chr1	223163437	223163566	LTR/ERVL	546	+	64	223163501	20360
chr1	223143141	223343141	harbor2	chr1	223175024	223175634	LTR/ERVL	1510	+	305	223175329	32188
chr1	226308052	226508052	harbor2	chr1	226325545	226325719	LTR/ERVL	552	+	87	226325632	17580
chr1	226308052	226508052	harbor2	chr1	226326806	226327041	LTR/ERVL	1166	+	118	226326924	18872
chr1	226308052	226508052	harbor2	chr1	226328134	226328182	LTR/ERVL	1166	+	24	226328158	20106
chr1	226308052	226508052	harbor2	chr1	226328495	226328619	LTR/ERVL	1166	+	62	226328557	20505
chr1	54787204	54987204	harbor2	chr1	54845389	54845735	LTR/ERVL	1516	+	173	54845562	58358
chr1	54787204	54987204	harbor2	chr1	54847309	54847813	LTR/ERVL	2410	+	252	54847561	60357
chr1	54787204	54987204	harbor2	chr1	54848145	54848205	LTR/ERVL	1903	+	30	54848175	60971
chr1	54787204	54987204	harbor2	chr1	54858128	54858425	LTR/ERVL	834	+	148	54858276	71072
chr1	54388402	54588402	harbor2	chr1	54422274	54422446	LTR/ERVL	526	+	86	54422360	33958
chr1	54388402	54588402	harbor2	chr1	54422447	54422870	LTR/ERVL	1221	+	212	54422659	34257
chr1	54388402	54588402	harbor2	chr1	54423584	54423817	LTR/ERVL	972	+	116	54423700	35298
chr1	54388402	54588402	harbor2	chr1	54424424	54424629	LTR/ERVL	972	+	102	54424526	36124
chr1	54388402	54588402	harbor2	chr1	54453067	54453211	LTR/ERVL	502	+	72	54453139	64737
chr1	54388402	54588402	harbor2	chr1	54453240	54453494	LTR/ERVL	965	+	127	54453367	64965
chr1	54388402	54588402	harbor2	chr1	54457200	54457441	LTR/ERVL	945	+	120	54457320	68918
chr1	54388402	54588402	harbor2	chr1	54459215	54459368	LTR/ERVL	669	+	76	54459291	70889
chr1	235227639	235427639	harbor2	chr1	235279590	235280110	LTR/ERVL	2148	+	260	235279850	52211
chr2	197400198	197600198	harbor2	chr2	197445367	197445595	LTR/ERVL	658	+	114	197445481	45283
chr2	197400198	197600198	harbor2	chr2	197445598	197446148	LTR/ERVL	2751	+	275	197445873	45675
chr2	218223278	218423278	harbor2	chr2	218303899	218304152	LTR/ERVL	718	+	126	218304025	80747
chr2	218223278	218423278	harbor2	chr2	218304444	218304632	LTR/ERVL	718	+	94	218304538	81260
chr2	86976766	87176766	harbor2	chr2	87056265	87056391	LTR/ERVL	1226	+	63	87056328	79562
chr2	86976766	87176766	harbor2	chr2	87056733	87056850	LTR/ERVL	1226	+	58	87056791	80025
chr2	86976766	87176766	harbor2	chr2	87057058	87057218	LTR/ERVL	862	+	80	87057138	80372
chr2	54998188	55198188	harbor2	chr2	55037329	55037706	LTR/ERVL	1475	+	188	55037517	39329
chr2	54998188	55198188	harbor2	chr2	55083788	55084282	LTR/ERVL	2460	+	247	55084035	85847
chr2	54998188	55198188	harbor2	chr2	55084450	55084798	LTR/ERVL	1380	+	174	55084624	86436
chr2	54998188	55198188	harbor2	chr2	55085089	55085143	LTR/ERVL	1282	+	27	55085116	86928
chr2	63488841	63688841	harbor2	chr2	63527085	63527224	LTR/ERVL	508	+	70	63527155	38314
chr2	63488841	63688841	harbor2	chr2	63530439	63530715	LTR/ERVL	978	+	138	63530577	41736
chr2	1057942	1257942	harbor2	chr2	1061339	1061804	LTR/ERVL	1373	+	232	1061571	3629
chr2	1057942	1257942	harbor2	chr2	1146908	1147219	LTR/ERVL	2373	+	156	1147064	89122
chr2	1057942	1257942	harbor2	chr2	1147220	1147666	LTR/ERVL	3554	+	223	1147443	89501
chr2	190775521	190975521	harbor2	chr2	190789445	190789917	LTR/ERVL	1108	+	236	190789681	14160
chr2	190775521	190975521	harbor2	chr2	190813096	190813532	LTR/ERVL	654	+	218	190813314	37793
chr2	190775521	190975521	harbor2	chr2	190825208	190825945	LTR/ERVL	2431	+	368	190825576	50055
chr2	190775521	190975521	harbor2	chr2	190842238	190842687	LTR/ERVL	1489	+	224	190842462	66941
chr2	190775521	190975521	harbor2	chr2	190842960	190843285	LTR/ERVL	2990	+	162	190843122	67601
chr2	190775521	190975521	harbor2	chr2	190843603	190844240	LTR/ERVL	2990	+	318	190843921	68400
chr2	190775521	190975521	harbor2	chr2	190844240	190844528	LTR/ERVL	997	+	144	190844384	68863
chr2	86976313	87176313	harbor2	chr2	87056265	87056391	LTR/ERVL	1226	+	63	87056328	80015
chr2	86976313	87176313	harbor2	chr2	87056733	87056850	LTR/ERVL	1226	+	58	87056791	80478
chr2	86976313	87176313	harbor2	chr2	87057058	87057218	LTR/ERVL	862	+	80	87057138	80825
chr2	175980096	176180096	harbor2	chr2	176019125	176019514	LTR/ERVL	1001	+	194	176019319	39223
chr2	42069367	42269367	harbor2	chr2	42092222	42092519	LTR/ERVL	1205	+	148	42092370	23003
chr2	42069367	42269367	harbor2	chr2	42092593	42092764	LTR/ERVL	936	+	86	42092679	23312
chr2	84762238	84962238	harbor2	chr2	84768930	84769369	LTR/ERVL	1033	+	220	84769150	6912
chr2	219384377	219584377	harbor2	chr2	219390955	219391314	LTR/ERVL	1248	+	180	219391135	6758
chr2	85502797	85702797	harbor2	chr2	85513464	85513895	LTR/ERVL	767	+	216	85513680	10883
chr2	31963580	32163580	harbor2	chr2	32050757	32050850	LTR/ERVL	2163	+	46	32050803	87223
chr2	31963580	32163580	harbor2	chr2	32051170	32051189	LTR/ERVL	2163	+	10	32051180	87600
chr2	31963580	32163580	harbor2	chr2	32051448	32051496	LTR/ERVL	2163	+	24	32051472	87892
chr2	31963580	32163580	harbor2	chr2	32051809	32052142	LTR/ERVL	2163	+	166	32051975	88395
chr2	53764282	53964282	harbor2	chr2	53846882	53847234	LTR/ERVL	441	+	176	53847058	82776
chr2	53764282	53964282	harbor2	chr2	53847504	53847622	LTR/ERVL	441	+	59	53847563	83281
chr2	53764282	53964282	harbor2	chr2	53848009	53848436	LTR/ERVL	840	+	214	53848223	83941
chr2	227428022	227628022	harbor2	chr2	227513261	227513716	LTR/ERVL	716	+	228	227513489	85467
chr2	46198785	46398785	harbor2	chr2	46291764	46292092	LTR/ERVL	527	+	164	46291928	93143
chr2	111956551	112156551	harbor2	chr2	111991925	111992055	LTR/ERVL	513	+	65	111991990	35439
chr2	111956551	112156551	harbor2	chr2	111992036	111992470	LTR/ERVL	3043	+	217	111992253	35702
chr2	111956551	112156551	harbor2	chr2	111992781	111993158	LTR/ERVL	3043	+	188	111992969	36418
chr2	111956551	112156551	harbor2	chr2	112047473	112047825	LTR/ERVL	1336	+	176	112047649	91098
chr2	111956551	112156551	harbor2	chr2	112048212	112048303	LTR/ERVL	1336	+	46	112048258	91707
chr2	46207640	46407640	harbor2	chr2	46291764	46292092	LTR/ERVL	527	+	164	46291928	84288
chr2	46200025	46400025	harbor2	chr2	46291764	46292092	LTR/ERVL	527	+	164	46291928	91903
chr2	86976783	87176783	harbor2	chr2	87056265	87056391	LTR/ERVL	1226	+	63	87056328	79545
chr2	86976783	87176783	harbor2	chr2	87056733	87056850	LTR/ERVL	1226	+	58	87056791	80008
chr2	86976783	87176783	harbor2	chr2	87057058	87057218	LTR/ERVL	862	+	80	87057138	80355
chr2	26613172	26813172	harbor2	chr2	26648438	26648848	LTR/ERVL	476	+	205	26648643	35471
chr2	26613172	26813172	harbor2	chr2	26649153	26649175	LTR/ERVL	476	+	11	26649164	35992
chr2	26613172	26813172	harbor2	chr2	26666856	26667174	LTR/ERVL	1180	+	159	26667015	53843
chr2	26613172	26813172	harbor2	chr2	26667251	26667484	LTR/ERVL	479	+	116	26667367	54195
chr2	142651021	142851021	harbor2	chr2	142726449	142726921	LTR/ERVL	710	+	236	142726685	75664
chr2	142651021	142851021	harbor2	chr2	142740953	142741040	LTR/ERVL	1945	+	44	142740997	89976
chr2	142651021	142851021	harbor2	chr2	142741574	142742020	LTR/ERVL	1945	+	223	142741797	90776
chr2	142651021	142851021	harbor2	chr2	142745226	142745535	LTR/ERVL	477	+	154	142745380	94359
chr2	47707524	47907524	harbor2	chr2	47711099	47711200	LTR/ERVL	498	+	50	47711149	3625
chr2	47707524	47907524	harbor2	chr2	47709930	47710215	LTR/ERVL	1677	+	142	47710072	2548
chr2	10822431	11022431	harbor2	chr2	10823712	10824129	LTR/ERVL	1285	+	208	10823920	1489
chr2	10822431	11022431	harbor2	chr2	10824149	10824325	LTR/ERVL	648	+	88	10824237	1806
chr2	10822431	11022431	harbor2	chr2	10824856	10825243	LTR/ERVL	3316	+	194	10825050	2619
chr2	10822431	11022431	harbor2	chr2	10825306	10825356	LTR/ERVL	3316	+	25	10825331	2900
chr2	10822431	11022431	harbor2	chr2	10851915	10852796	LTR/ERVL	3524	+	440	10852355	29924
chr2	10822431	11022431	harbor2	chr2	10890662	10890989	LTR/ERVL	484	+	164	10890826	68395
chr2	10822431	11022431	harbor2	chr2	10909106	10909630	LTR/ERVL	1836	+	262	10909368	86937
chr2	70771713	70971713	harbor2	chr2	70771784	70772105	LTR/ERVL	1228	+	160	70771944	231
chr2	70771713	70971713	harbor2	chr2	70774042	70774346	LTR/ERVL	721	+	152	70774194	2481
chr2	70771713	70971713	harbor2	chr2	70821185	70821726	LTR/ERVL	1873	+	270	70821455	49742
chr2	70771713	70971713	harbor2	chr2	70822059	70822288	LTR/ERVL	1873	+	114	70822173	50460
chr2	70771713	70971713	harbor2	chr2	70850061	70850324	LTR/ERVL	512	+	132	70850193	78480
chr2	159611903	159811903	harbor2	chr2	159687170	159687969	LTR/ERVL	2623	+	400	159687570	75667
chr2	159611903	159811903	harbor2	chr2	159706741	159707109	LTR/ERVL	1899	+	184	159706925	95022
chr2	10277847	10477847	harbor2	chr2	10328352	10328803	LTR/ERVL	2475	+	226	10328578	50731
chr2	30047316	30247316	harbor2	chr2	30053020	30053442	LTR/ERVL	1366	+	211	30053231	5915
chr2	30047316	30247316	harbor2	chr2	30078646	30078879	LTR/ERVL	2072	+	116	30078762	31446
chr2	30047316	30247316	harbor2	chr2	30079172	30079589	LTR/ERVL	2072	+	208	30079380	32064
chr2	30047316	30247316	harbor2	chr2	30087030	30087261	LTR/ERVL	574	+	116	30087146	39830
chr2	30047316	30247316	harbor2	chr2	30087417	30087611	LTR/ERVL	961	+	97	30087514	40198
chr2	30047316	30247316	harbor2	chr2	30095983	30096025	LTR/ERVL	1755	+	21	30096004	48688
chr2	30047316	30247316	harbor2	chr2	30096339	30096896	LTR/ERVL	1755	+	278	30096617	49301
chr2	30047316	30247316	harbor2	chr2	30112625	30113166	LTR/ERVL	2512	+	270	30112895	65579
chr2	30047316	30247316	harbor2	chr2	30121020	30121456	LTR/ERVL	970	+	218	30121238	73922
chr2	30047316	30247316	harbor2	chr2	30129650	30129954	LTR/ERVL	723	+	152	30129802	82486
chr2	72971434	73171434	harbor2	chr2	72994297	72994549	LTR/ERVL	456	+	126	72994423	22989
chr2	72046331	72246331	harbor2	chr2	72074203	72074507	LTR/ERVL	695	+	152	72074355	28024
chr2	67112244	67312244	harbor2	chr2	67186835	67187129	LTR/ERVL	899	+	147	67186982	74738
chr2	85502768	85702768	harbor2	chr2	85513464	85513895	LTR/ERVL	767	+	216	85513680	10912
chr2	229671325	229871325	harbor2	chr2	229673783	229674269	LTR/ERVL	1223	+	243	229674026	2701
chr2	218223273	218423273	harbor2	chr2	218303899	218304152	LTR/ERVL	718	+	126	218304025	80752
chr2	218223273	218423273	harbor2	chr2	218304444	218304632	LTR/ERVL	718	+	94	218304538	81265
chr2	237592294	237792294	harbor2	chr2	237602391	237602641	LTR/ERVL	1242	+	125	237602516	10222
chr2	237592294	237792294	harbor2	chr2	237602647	237603178	LTR/ERVL	2879	+	266	237602913	10619
chr2	237592294	237792294	harbor2	chr2	237632247	237632450	LTR/ERVL	450	+	102	237632349	40055
chr2	231834767	232034767	harbor2	chr2	231850549	231850913	LTR/ERVL	2754	+	182	231850731	15964
chr2	231834767	232034767	harbor2	chr2	231890950	231891551	LTR/ERVL	3856	+	300	231891250	56483
chr2	231834767	232034767	harbor2	chr2	231849877	231850383	LTR/ERVL	2754	+	253	231850130	15363
chr2	152043289	152243289	harbor2	chr2	152053002	152053522	LTR/ERVL	3142	+	260	152053262	9973
chr2	152043289	152243289	harbor2	chr2	152053825	152054085	LTR/ERVL	3142	+	130	152053955	10666
chr2	152043289	152243289	harbor2	chr2	152054390	152054447	LTR/ERVL	3142	+	28	152054418	11129
chr2	152043289	152243289	harbor2	chr2	152066083	152066299	LTR/ERVL	616	+	108	152066191	22902
chr2	152043289	152243289	harbor2	chr2	152067173	152067357	LTR/ERVL	1250	+	92	152067265	23976
chr2	152043289	152243289	harbor2	chr2	152067511	152067651	LTR/ERVL	1250	+	70	152067581	24292
chr2	152043289	152243289	harbor2	chr2	152069014	152069303	LTR/ERVL	1073	+	144	152069158	25869
chr2	152043289	152243289	harbor2	chr2	152091665	152091836	LTR/ERVL	735	+	86	152091751	48462
chr2	85511640	85711640	harbor2	chr2	85513464	85513895	LTR/ERVL	767	+	216	85513680	2040
chr2	56095019	56295019	harbor2	chr2	56169031	56169532	LTR/ERVL	1790	+	250	56169281	74262
chr2	46199989	46399989	harbor2	chr2	46291764	46292092	LTR/ERVL	527	+	164	46291928	91939
chr2	46199056	46399056	harbor2	chr2	46291764	46292092	LTR/ERVL	527	+	164	46291928	92872
chr2	46199733	46399733	harbor2	chr2	46291764	46292092	LTR/ERVL	527	+	164	46291928	92195
chr2	72972031	73172031	harbor2	chr2	72994297	72994549	LTR/ERVL	456	+	126	72994423	22392
chr2	143543446	143743446	harbor2	chr2	143627715	143627825	LTR/ERVL	827	+	55	143627770	84324
chr2	143543446	143743446	harbor2	chr2	143628410	143628815	LTR/ERVL	827	+	202	143628612	85166
chr2	156337938	156537938	harbor2	chr2	156345566	156345762	LTR/ERVL	799	+	98	156345664	7726
chr2	156337938	156537938	harbor2	chr2	156345775	156346002	LTR/ERVL	762	+	114	156345889	7951
chr2	170412424	170612424	harbor2	chr2	170475801	170476052	LTR/ERVL	2204	+	126	170475927	63503
chr2	170412424	170612424	harbor2	chr2	170476858	170477078	LTR/ERVL	2204	+	110	170476968	64544
chr2	170412424	170612424	harbor2	chr2	170480103	170480316	LTR/ERVL	1217	+	106	170480209	67785
chr2	170412424	170612424	harbor2	chr2	170480322	170480874	LTR/ERVL	3098	+	276	170480598	68174
chr2	1511396	1711396	harbor2	chr2	1544499	1545024	LTR/ERVL	1868	+	262	1544761	33365
chr2	1511396	1711396	harbor2	chr2	1575467	1575751	LTR/ERVL	803	+	142	1575609	64213
chr2	66333348	66533348	harbor2	chr2	66345834	66346161	LTR/ERVL	995	+	164	66345998	12650
chr2	66333348	66533348	harbor2	chr2	66399252	66399573	LTR/ERVL	1972	+	160	66399412	66064
chr2	66333348	66533348	harbor2	chr2	66399702	66399847	LTR/ERVL	794	+	72	66399774	66426
chr2	72866749	73066749	harbor2	chr2	72965842	72966313	LTR/ERVL	1902	+	236	72966078	99329
chr2	112819372	113019372	harbor2	chr2	112864735	112865462	LTR/ERVL	2033	+	364	112865099	45727
chr2	70838422	71038422	harbor2	chr2	70850061	70850324	LTR/ERVL	512	+	132	70850193	11771
chr2	64300586	64500586	harbor2	chr2	64341654	64341993	LTR/ERVL	1026	+	170	64341824	41238
chr2	64300586	64500586	harbor2	chr2	64342414	64342551	LTR/ERVL	1026	+	68	64342482	41896
chr2	64300586	64500586	harbor2	chr2	64343699	64343831	LTR/ERVL	480	+	66	64343765	43179
chr2	64300586	64500586	harbor2	chr2	64345085	64345603	LTR/ERVL	1026	+	259	64345344	44758
chr2	64300586	64500586	harbor2	chr2	64361350	64361789	LTR/ERVL	1112	+	220	64361570	60984
chr2	204961872	205161872	harbor2	chr2	204985361	204985819	LTR/ERVL	550	+	229	204985590	23718
chr2	204961872	205161872	harbor2	chr2	204986127	204986176	LTR/ERVL	550	+	24	204986151	24279
chr2	204961872	205161872	harbor2	chr2	205042254	205042697	LTR/ERVL	767	+	222	205042476	80604
chr2	96386357	96586357	harbor2	chr2	96464208	96464480	LTR/ERVL	767	+	136	96464344	77987
chr2	175980104	176180104	harbor2	chr2	176019125	176019514	LTR/ERVL	1001	+	194	176019319	39215
chr2	91620961	91820961	harbor2	chr2	91667529	91667609	LTR/ERVL	486	+	40	91667569	46608
chr2	239595748	239795748	harbor2	chr2	239612269	239612714	LTR/ERVL	1193	+	222	239612491	16743
chr2	239595748	239795748	harbor2	chr2	239670356	239670553	LTR/ERVL	539	+	98	239670454	74706
chr2	239595748	239795748	harbor2	chr2	239670631	239670787	LTR/ERVL	624	+	78	239670709	74961
chr2	119126672	119326672	harbor2	chr2	119177292	119177536	LTR/ERVL	530	+	122	119177414	50742
chr2	119126672	119326672	harbor2	chr2	119190438	119190710	LTR/ERVL	521	+	136	119190574	63902
chr2	119126672	119326672	harbor2	chr2	119209211	119209379	LTR/ERVL	556	+	84	119209295	82623
chr2	222208340	222408340	harbor2	chr2	222223448	222223721	LTR/ERVL	881	+	136	222223584	15244
chr2	71358556	71558556	harbor2	chr2	71444089	71444433	LTR/ERVL	2146	+	172	71444261	85705
chr2	71358556	71558556	harbor2	chr2	71445594	71446102	LTR/ERVL	2146	+	254	71445848	87292
chr2	208143888	208343888	harbor2	chr2	208149502	208149788	LTR/ERVL	723	+	143	208149645	5757
chr2	208143888	208343888	harbor2	chr2	208187698	208188085	LTR/ERVL	1296	+	194	208187892	44004
chr2	208143888	208343888	harbor2	chr2	208188128	208188171	LTR/ERVL	856	+	22	208188150	44262
chr2	86006203	86206203	harbor2	chr2	86042480	86042685	LTR/ERVL	467	+	102	86042582	36379
chr2	86006203	86206203	harbor2	chr2	86101282	86101583	LTR/ERVL	476	+	150	86101432	95229
chr2	42070444	42270444	harbor2	chr2	42092222	42092519	LTR/ERVL	1205	+	148	42092370	21926
chr2	42070444	42270444	harbor2	chr2	42092593	42092764	LTR/ERVL	936	+	86	42092679	22235
chr2	164732161	164932161	harbor2	chr2	164791728	164791937	LTR/ERVL	495	+	104	164791832	59671
chr2	72971529	73171529	harbor2	chr2	72994297	72994549	LTR/ERVL	456	+	126	72994423	22894
chr2	27396611	27596611	harbor2	chr2	27415916	27415996	LTR/ERVL	917	+	40	27415956	19345
chr2	27396611	27596611	harbor2	chr2	27416294	27416514	LTR/ERVL	917	+	110	27416404	19793
chr2	27396611	27596611	harbor2	chr2	27416809	27416819	LTR/ERVL	917	+	5	27416814	20203
chr2	27396611	27596611	harbor2	chr2	27417095	27417246	LTR/ERVL	917	+	76	27417171	20560
chr2	27396611	27596611	harbor2	chr2	27452008	27452474	LTR/ERVL	2430	+	233	27452241	55630
chr2	192560007	192760007	harbor2	chr2	192591950	192592449	LTR/ERVL	1783	+	250	192592200	32193
chr2	192560007	192760007	harbor2	chr2	192594708	192595174	LTR/ERVL	1246	+	233	192594941	34934
chr2	44068663	44268663	harbor2	chr2	44090390	44090836	LTR/ERVL	1157	+	223	44090613	21950
chr2	64956793	65156793	harbor2	chr2	64956610	64956928	LTR/ERVL	1702	+	159	64956769	24
chr2	64956793	65156793	harbor2	chr2	64961123	64961913	LTR/ERVL	2772	+	395	64961518	4725
chr2	64956793	65156793	harbor2	chr2	64979161	64979579	LTR/ERVL	1396	+	209	64979370	22577
chr2	64956793	65156793	harbor2	chr2	64979716	64979750	LTR/ERVL	1396	+	17	64979733	22940
chr2	64956793	65156793	harbor2	chr2	65053217	65053895	LTR/ERVL	1338	+	339	65053556	96763
chr2	96403077	96603077	harbor2	chr2	96464208	96464480	LTR/ERVL	767	+	136	96464344	61267
chr2	130102755	130302755	harbor2	chr2	130196817	130197206	LTR/ERVL	1116	+	194	130197011	94256
chr2	112055853	112255853	harbor2	chr2	112132466	112133022	LTR/ERVL	1500	+	278	112132744	76891
chr2	112055853	112255853	harbor2	chr2	112152494	112152903	LTR/ERVL	1612	+	204	112152698	96845
chr2	217378357	217578357	harbor2	chr2	217401087	217401472	LTR/ERVL	573	+	192	217401279	22922
chr2	217378357	217578357	harbor2	chr2	217475884	217476364	LTR/ERVL	1204	+	240	217476124	97767
chr2	112780949	112980949	harbor2	chr2	112864735	112865462	LTR/ERVL	2033	+	364	112865099	84150
chr2	124410890	124610890	harbor2	chr2	124420502	124420902	LTR/ERVL	1171	+	200	124420702	9812
chr2	124410890	124610890	harbor2	chr2	124459170	124459466	LTR/ERVL	1457	+	148	124459318	48428
chr2	124410890	124610890	harbor2	chr2	124459781	124460008	LTR/ERVL	1457	+	114	124459895	49005
chr2	113790804	113990804	harbor2	chr2	113795177	113795566	LTR/ERVL	869	+	194	113795371	4567
chr2	113790804	113990804	harbor2	chr2	113796808	113797237	LTR/ERVL	1823	+	214	113797022	6218
chr2	113790804	113990804	harbor2	chr2	113818360	113818768	LTR/ERVL	1869	+	204	113818564	27760
chr2	113790804	113990804	harbor2	chr2	113818767	113818892	LTR/ERVL	658	+	62	113818829	28025
chr2	113790804	113990804	harbor2	chr2	113825358	113825696	LTR/ERVL	476	+	169	113825527	34723
chr2	113790804	113990804	harbor2	chr2	113839915	113839930	LTR/ERVL	1359	+	8	113839923	49119
chr2	113790804	113990804	harbor2	chr2	113839980	113840218	LTR/ERVL	1359	+	119	113840099	49295
chr2	113790804	113990804	harbor2	chr2	113840224	113840765	LTR/ERVL	2938	+	270	113840494	49690
chr3	127490209	127690209	harbor2	chr3	127527079	127527488	LTR/ERVL	1203	+	204	127527283	37074
chr3	127490209	127690209	harbor2	chr3	127540128	127540464	LTR/ERVL	1450	+	168	127540296	50087
chr3	108082734	108282734	harbor2	chr3	108156881	108157677	LTR/ERVL	2666	+	398	108157279	74545
chr3	108422389	108622389	harbor2	chr3	108453275	108453876	LTR/ERVL	1025	+	300	108453575	31186
chr3	108422389	108622389	harbor2	chr3	108466446	108466939	LTR/ERVL	2262	+	246	108466692	44303
chr3	49074515	49274515	harbor2	chr3	49170199	49170644	LTR/ERVL	1232	+	222	49170421	95906
chr3	157169493	157369493	harbor2	chr3	157180788	157181087	LTR/ERVL	947	+	150	157180938	11445
chr3	157169493	157369493	harbor2	chr3	157223272	157223610	LTR/ERVL	1827	+	169	157223441	53948
chr3	157169493	157369493	harbor2	chr3	157263928	157264502	LTR/ERVL	2739	+	287	157264215	94722
chr3	113036307	113236307	harbor2	chr3	113036266	113036327	LTR/ERVL	716	+	30	113036296	11
chr3	113036307	113236307	harbor2	chr3	113036892	113037824	LTR/ERVL	2446	+	466	113037358	1051
chr3	113036307	113236307	harbor2	chr3	113073093	113073241	LTR/ERVL	491	+	74	113073167	36860
chr3	113036307	113236307	harbor2	chr3	113073376	113073592	LTR/ERVL	520	+	108	113073484	37177
chr3	113036307	113236307	harbor2	chr3	113076676	113077279	LTR/ERVL	1515	+	302	113076978	40671
chr3	49071598	49271598	harbor2	chr3	49170199	49170644	LTR/ERVL	1232	+	222	49170421	98823
chr3	157395984	157595984	harbor2	chr3	157427755	157428173	LTR/ERVL	1814	+	209	157427964	31980
chr3	157395984	157595984	harbor2	chr3	157475517	157477024	LTR/ERVL	1324	+	754	157476271	80287
chr3	157395984	157595984	harbor2	chr3	157477515	157477561	LTR/ERVL	845	+	23	157477538	81554
chr3	157395984	157595984	harbor2	chr3	157477555	157477766	LTR/ERVL	852	+	106	157477661	81677
chr3	157395984	157595984	harbor2	chr3	157478003	157478417	LTR/ERVL	1316	+	207	157478210	82226
chr3	49072873	49272873	harbor2	chr3	49170199	49170644	LTR/ERVL	1232	+	222	49170421	97548
chr3	115844385	116044385	harbor2	chr3	115845449	115845833	LTR/ERVL	464	+	192	115845641	1256
chr3	115844385	116044385	harbor2	chr3	115881819	115882270	LTR/ERVL	851	+	226	115882045	37660
chr3	50033140	50233140	harbor2	chr3	50082258	50082570	LTR/ERVL	1742	+	156	50082414	49274
chr3	50033140	50233140	harbor2	chr3	50083052	50083151	LTR/ERVL	581	+	50	50083102	49962
chr3	50033140	50233140	harbor2	chr3	50129291	50129651	LTR/ERVL	2565	+	180	50129471	96331
chr3	50033140	50233140	harbor2	chr3	50129951	50129978	LTR/ERVL	2565	+	14	50129965	96825
chr3	50033140	50233140	harbor2	chr3	50130292	50130349	LTR/ERVL	2565	+	28	50130320	97180
chr3	50447939	50647939	harbor2	chr3	50451979	50452366	LTR/ERVL	1264	+	194	50452173	4234
chr3	50447939	50647939	harbor2	chr3	50452749	50452999	LTR/ERVL	490	+	125	50452874	4935
chr3	49078708	49278708	harbor2	chr3	49170199	49170644	LTR/ERVL	1232	+	222	49170421	91713
chr3	49829882	50029882	harbor2	chr3	49888864	49889239	LTR/ERVL	1179	+	188	49889052	59170
chr3	108221011	108421011	harbor2	chr3	108305873	108306301	LTR/ERVL	967	+	214	108306087	85076
chr3	108221011	108421011	harbor2	chr3	108311889	108312367	LTR/ERVL	776	+	239	108312128	91117
chr3	108221011	108421011	harbor2	chr3	108312409	108312841	LTR/ERVL	1357	+	216	108312625	91614
chr3	108221011	108421011	harbor2	chr3	108319274	108319525	LTR/ERVL	869	+	126	108319400	98389
chr3	188076829	188276829	harbor2	chr3	188078594	188078783	LTR/ERVL	434	+	94	188078688	1859
chr3	188076829	188276829	harbor2	chr3	188101184	188101523	LTR/ERVL	588	+	170	188101354	24525
chr3	146094434	146294434	harbor2	chr3	146114582	146114672	LTR/ERVL	405	+	45	146114627	20193
chr3	146094434	146294434	harbor2	chr3	146130817	146131383	LTR/ERVL	2876	+	283	146131100	36666
chr3	146094434	146294434	harbor2	chr3	146146604	146146921	LTR/ERVL	904	+	158	146146762	52328
chr3	146094434	146294434	harbor2	chr3	146185949	146186319	LTR/ERVL	589	+	185	146186134	91700
chr3	151244079	151444079	harbor2	chr3	151296307	151296730	LTR/ERVL	1343	+	212	151296519	52440
chr3	161134786	161334786	harbor2	chr3	161156643	161157131	LTR/ERVL	2055	+	244	161156887	22101
chr3	161134786	161334786	harbor2	chr3	161172082	161172410	LTR/ERVL	1841	+	164	161172246	37460
chr3	161134786	161334786	harbor2	chr3	161215104	161215438	LTR/ERVL	990	+	167	161215271	80485
chr3	161134786	161334786	harbor2	chr3	161217541	161217913	LTR/ERVL	1588	+	186	161217727	82941
chr3	138397969	138597969	harbor2	chr3	138424814	138425205	LTR/ERVL	2189	+	196	138425010	27041
chr3	138397969	138597969	harbor2	chr3	138425754	138425846	LTR/ERVL	2189	+	46	138425800	27831
chr3	138397969	138597969	harbor2	chr3	138479438	138479583	LTR/ERVL	446	+	72	138479510	81541
chr3	196509496	196709496	harbor2	chr3	196517147	196517573	LTR/ERVL	983	+	213	196517360	7864
chr3	196509496	196709496	harbor2	chr3	196603769	196603993	LTR/ERVL	2310	+	112	196603881	94385
chr3	196509496	196709496	harbor2	chr3	196604286	196604489	LTR/ERVL	2310	+	102	196604388	94892
chr3	43899808	44099808	harbor2	chr3	43908438	43908861	LTR/ERVL	1124	+	212	43908650	8842
chr3	43899808	44099808	harbor2	chr3	43917384	43917879	LTR/ERVL	604	+	248	43917632	17824
chr3	43899808	44099808	harbor2	chr3	43951223	43951670	LTR/ERVL	864	+	224	43951447	51639
chr3	43899808	44099808	harbor2	chr3	43962761	43963102	LTR/ERVL	1073	+	170	43962931	63123
chr3	43899808	44099808	harbor2	chr3	43963362	43963516	LTR/ERVL	1073	+	77	43963439	63631
chr3	43899808	44099808	harbor2	chr3	43965554	43965664	LTR/ERVL	506	+	55	43965609	65801
chr3	43899808	44099808	harbor2	chr3	43967431	43967778	LTR/ERVL	1509	+	174	43967605	67797
chr3	47682285	47882285	harbor2	chr3	47752416	47752504	LTR/ERVL	857	+	44	47752460	70175
chr3	47682285	47882285	harbor2	chr3	47752778	47753034	LTR/ERVL	857	+	128	47752906	70621
chr3	49072483	49272483	harbor2	chr3	49170199	49170644	LTR/ERVL	1232	+	222	49170421	97938
chr3	126604196	126804196	harbor2	chr3	126691822	126692590	LTR/ERVL	1337	+	384	126692206	88010
chr3	125918450	126118450	harbor2	chr3	125921029	125921386	LTR/ERVL	515	+	178	125921207	2757
chr3	125918450	126118450	harbor2	chr3	125984069	125984217	LTR/ERVL	567	+	74	125984143	65693
chr3	125918450	126118450	harbor2	chr3	125984240	125984513	LTR/ERVL	833	+	136	125984376	65926
chr3	125918450	126118450	harbor2	chr3	125984594	125984840	LTR/ERVL	833	+	123	125984717	66267
chr3	125918450	126118450	harbor2	chr3	126005489	126005729	LTR/ERVL	1030	+	120	126005609	87159
chr3	49829895	50029895	harbor2	chr3	49888864	49889239	LTR/ERVL	1179	+	188	49889052	59157
chr3	43899990	44099990	harbor2	chr3	43908438	43908861	LTR/ERVL	1124	+	212	43908650	8660
chr3	43899990	44099990	harbor2	chr3	43917384	43917879	LTR/ERVL	604	+	248	43917632	17642
chr3	43899990	44099990	harbor2	chr3	43951223	43951670	LTR/ERVL	864	+	224	43951447	51457
chr3	43899990	44099990	harbor2	chr3	43962761	43963102	LTR/ERVL	1073	+	170	43962931	62941
chr3	43899990	44099990	harbor2	chr3	43963362	43963516	LTR/ERVL	1073	+	77	43963439	63449
chr3	43899990	44099990	harbor2	chr3	43965554	43965664	LTR/ERVL	506	+	55	43965609	65619
chr3	43899990	44099990	harbor2	chr3	43967431	43967778	LTR/ERVL	1509	+	174	43967605	67615
chr3	184086379	184286379	harbor2	chr3	184112171	184112275	LTR/ERVL	687	+	52	184112223	25844
chr3	123360102	123560102	harbor2	chr3	123405936	123406484	LTR/ERVL	3253	+	274	123406210	46108
chr3	123360102	123560102	harbor2	chr3	123418197	123418336	LTR/ERVL	2919	+	70	123418267	58165
chr3	123360102	123560102	harbor2	chr3	123418770	123419145	LTR/ERVL	2919	+	188	123418958	58856
chr3	197553469	197753469	harbor2	chr3	197559523	197559597	LTR/ERVL	466	+	37	197559560	6091
chr3	197553469	197753469	harbor2	chr3	197573828	197574313	LTR/ERVL	3889	+	242	197574070	20601
chr3	197553469	197753469	harbor2	chr3	197574763	197574937	LTR/ERVL	3889	+	87	197574850	21381
chr3	197553469	197753469	harbor2	chr3	197575662	197575911	LTR/ERVL	1363	+	124	197575786	22317
chr3	197553469	197753469	harbor2	chr3	197576476	197576533	LTR/ERVL	1363	+	28	197576504	23035
chr3	197553469	197753469	harbor2	chr3	197576589	197576637	LTR/ERVL	1363	+	24	197576613	23144
chr3	197553469	197753469	harbor2	chr3	197593631	197594079	LTR/ERVL	2678	+	224	197593855	40386
chr3	197553469	197753469	harbor2	chr3	197558176	197558561	LTR/ERVL	938	+	192	197558368	4899
chr3	186683597	186883597	harbor2	chr3	186747711	186747820	LTR/ERVL	444	+	54	186747765	64168
chr3	186683597	186883597	harbor2	chr3	186747838	186748111	LTR/ERVL	1214	+	136	186747974	64377
chr3	184086435	184286435	harbor2	chr3	184112171	184112275	LTR/ERVL	687	+	52	184112223	25788
chr3	196967075	197167075	harbor2	chr3	196991651	196992059	LTR/ERVL	994	+	204	196991855	24780
chr3	23714640	23914640	harbor2	chr3	23729611	23729960	LTR/ERVL	745	+	174	23729785	15145
chr3	23714640	23914640	harbor2	chr3	23775239	23775651	LTR/ERVL	1395	+	206	23775445	60805
chr3	39007400	39207400	harbor2	chr3	39007257	39007497	LTR/ERVL	1199	+	120	39007377	23
chr3	39007400	39207400	harbor2	chr3	39007516	39008116	LTR/ERVL	2172	+	300	39007816	416
chr3	39007400	39207400	harbor2	chr3	39020466	39020747	LTR/ERVL	528	+	140	39020606	13206
chr3	128635373	128835373	harbor2	chr3	128688520	128688745	LTR/ERVL	865	+	112	128688632	53259
chr3	128635373	128835373	harbor2	chr3	128689076	128689327	LTR/ERVL	1326	+	126	128689202	53829
chr3	128635373	128835373	harbor2	chr3	128719774	128720287	LTR/ERVL	922	+	256	128720030	84657
chr3	49072168	49272168	harbor2	chr3	49170199	49170644	LTR/ERVL	1232	+	222	49170421	98253
chr3	185965616	186165616	harbor2	chr3	186033467	186033651	LTR/ERVL	473	+	92	186033559	67943
chr3	185965616	186165616	harbor2	chr3	186033663	186033786	LTR/ERVL	428	+	62	186033725	68109
chr3	185965616	186165616	harbor2	chr3	186043831	186043928	LTR/ERVL	418	+	48	186043879	78263
chr3	126430170	126630170	harbor2	chr3	126456231	126456729	LTR/ERVL	1803	+	249	126456480	26310
chr3	126430170	126630170	harbor2	chr3	126518903	126519822	LTR/ERVL	3657	+	460	126519363	89193
chr3	50127523	50327523	harbor2	chr3	50129291	50129651	LTR/ERVL	2565	+	180	50129471	1948
chr3	50127523	50327523	harbor2	chr3	50129951	50129978	LTR/ERVL	2565	+	14	50129965	2442
chr3	50127523	50327523	harbor2	chr3	50130292	50130349	LTR/ERVL	2565	+	28	50130320	2797
chr3	123351261	123551261	harbor2	chr3	123405936	123406484	LTR/ERVL	3253	+	274	123406210	54949
chr3	123351261	123551261	harbor2	chr3	123418197	123418336	LTR/ERVL	2919	+	70	123418267	67006
chr3	123351261	123551261	harbor2	chr3	123418770	123419145	LTR/ERVL	2919	+	188	123418958	67697
chr3	138336888	138536888	harbor2	chr3	138339350	138339522	LTR/ERVL	628	+	86	138339436	2548
chr3	138336888	138536888	harbor2	chr3	138341428	138341708	LTR/ERVL	921	+	140	138341568	4680
chr3	138336888	138536888	harbor2	chr3	138424814	138425205	LTR/ERVL	2189	+	196	138425010	88122
chr3	138336888	138536888	harbor2	chr3	138425754	138425846	LTR/ERVL	2189	+	46	138425800	88912
chr3	127581228	127781228	harbor2	chr3	127593439	127594637	LTR/ERVL	1782	+	599	127594038	12810
chr3	179843714	180043714	harbor2	chr3	179843979	179844157	LTR/ERVL	561	+	89	179844068	354
chr3	179843714	180043714	harbor2	chr3	179846501	179846980	LTR/ERVL	2215	+	240	179846741	3027
chr3	192260032	192460032	harbor2	chr3	192328182	192328747	LTR/ERVL	2038	+	282	192328464	68432
chr3	185529283	185729283	harbor2	chr3	185539792	185540226	LTR/ERVL	1566	+	217	185540009	10726
chr3	123781375	123981375	harbor2	chr3	123819132	123819573	LTR/ERVL	1755	+	220	123819352	37977
chr3	112250274	112450274	harbor2	chr3	112279225	112279419	LTR/ERVL	784	+	97	112279322	29048
chr3	112250274	112450274	harbor2	chr3	112279633	112279947	LTR/ERVL	1160	+	157	112279790	29516
chr3	128745391	128945391	harbor2	chr3	128760021	128760429	LTR/ERVL	908	+	204	128760225	14834
chr3	49137838	49337838	harbor2	chr3	49170199	49170644	LTR/ERVL	1232	+	222	49170421	32583
chr3	49137838	49337838	harbor2	chr3	49188467	49188678	LTR/ERVL	460	+	106	49188573	50735
chr3	150314573	150514573	harbor2	chr3	150323911	150324349	LTR/ERVL	1201	+	219	150324130	9557
chr3	122418615	122618615	harbor2	chr3	122464988	122465217	LTR/ERVL	1170	+	114	122465102	46487
chr3	122418615	122618615	harbor2	chr3	122465583	122465615	LTR/ERVL	1170	+	16	122465599	46984
chr3	122418615	122618615	harbor2	chr3	122465791	122465996	LTR/ERVL	1020	+	102	122465893	47278
chr3	138088132	138288132	harbor2	chr3	138098836	138098863	LTR/ERVL	749	+	14	138098850	10718
chr3	138088132	138288132	harbor2	chr3	138099145	138099204	LTR/ERVL	749	+	30	138099175	11043
chr3	138088132	138288132	harbor2	chr3	138099423	138099527	LTR/ERVL	749	+	52	138099475	11343
chr3	138088132	138288132	harbor2	chr3	138099943	138099980	LTR/ERVL	749	+	18	138099961	11829
chr3	138088132	138288132	harbor2	chr3	138100091	138100716	LTR/ERVL	3050	+	312	138100403	12271
chr3	138088132	138288132	harbor2	chr3	138138926	138139494	LTR/ERVL	3186	+	284	138139210	51078
chr3	138088132	138288132	harbor2	chr3	138179995	138180189	LTR/ERVL	594	+	97	138180092	91960
chr3	138088132	138288132	harbor2	chr3	138185182	138185629	LTR/ERVL	960	+	224	138185406	97274
chr3	51841955	52041955	harbor2	chr3	51868926	51869005	LTR/ERVL	1983	+	40	51868966	27011
chr3	51841955	52041955	harbor2	chr3	51869373	51869701	LTR/ERVL	1983	+	164	51869537	27582
chr3	119612088	119812088	harbor2	chr3	119611994	119612303	LTR/ERVL	640	+	154	119612148	60
chr3	197860204	198060204	harbor2	chr3	197906039	197906279	LTR/ERVL	837	+	120	197906159	45955
chr3	197860204	198060204	harbor2	chr3	197926549	197926950	LTR/ERVL	1139	+	200	197926749	66545
chr3	197860204	198060204	harbor2	chr3	197947704	197947878	LTR/ERVL	595	+	87	197947791	87587
chr3	49072760	49272760	harbor2	chr3	49170199	49170644	LTR/ERVL	1232	+	222	49170421	97661
chr3	47725663	47925663	harbor2	chr3	47752416	47752504	LTR/ERVL	857	+	44	47752460	26797
chr3	47725663	47925663	harbor2	chr3	47752778	47753034	LTR/ERVL	857	+	128	47752906	27243
chr3	197860166	198060166	harbor2	chr3	197906039	197906279	LTR/ERVL	837	+	120	197906159	45993
chr3	197860166	198060166	harbor2	chr3	197926549	197926950	LTR/ERVL	1139	+	200	197926749	66583
chr3	197860166	198060166	harbor2	chr3	197947704	197947878	LTR/ERVL	595	+	87	197947791	87625
chr3	50517057	50717057	harbor2	chr3	50594632	50594866	LTR/ERVL	951	+	117	50594749	77692
chr3	50517057	50717057	harbor2	chr3	50595692	50595772	LTR/ERVL	951	+	40	50595732	78675
chr3	30593678	30793678	harbor2	chr3	30639241	30639528	LTR/ERVL	1586	+	144	30639385	45707
chr3	30593678	30793678	harbor2	chr3	30647054	30647453	LTR/ERVL	914	+	200	30647254	53576
chr3	63339864	63539864	harbor2	chr3	63432011	63432289	LTR/ERVL	781	+	139	63432150	92286
chr3	53396060	53596060	harbor2	chr3	53411097	53411437	LTR/ERVL	1077	+	170	53411267	15207
chr3	53396060	53596060	harbor2	chr3	53411621	53411789	LTR/ERVL	583	+	84	53411705	15645
chr3	197860186	198060186	harbor2	chr3	197906039	197906279	LTR/ERVL	837	+	120	197906159	45973
chr3	197860186	198060186	harbor2	chr3	197926549	197926950	LTR/ERVL	1139	+	200	197926749	66563
chr3	197860186	198060186	harbor2	chr3	197947704	197947878	LTR/ERVL	595	+	87	197947791	87605
chr3	102709889	102909889	harbor2	chr3	102735696	102736046	LTR/ERVL	2429	+	175	102735871	25982
chr3	102709889	102909889	harbor2	chr3	102736054	102737655	LTR/ERVL	8668	+	800	102736854	26965
chr3	102709889	102909889	harbor2	chr3	102737741	102738584	LTR/ERVL	5627	+	422	102738163	28274
chr3	102709889	102909889	harbor2	chr3	102738584	102741853	LTR/ERVL	20836	+	1634	102740218	30329
chr3	102709889	102909889	harbor2	chr3	102741859	102742206	LTR/ERVL	2345	+	174	102742033	32144
chr3	102709889	102909889	harbor2	chr3	102773536	102773885	LTR/ERVL	1359	+	174	102773710	63821
chr3	48541350	48741350	harbor2	chr3	48546560	48547122	LTR/ERVL	2950	+	281	48546841	5491
chr3	50442364	50642364	harbor2	chr3	50451979	50452366	LTR/ERVL	1264	+	194	50452173	9809
chr3	50442364	50642364	harbor2	chr3	50452749	50452999	LTR/ERVL	490	+	125	50452874	10510
chr3	157035633	157235633	harbor2	chr3	157125938	157126371	LTR/ERVL	874	+	216	157126154	90521
chr3	157035633	157235633	harbor2	chr3	157126380	157126520	LTR/ERVL	466	+	70	157126450	90817
chr3	49073508	49273508	harbor2	chr3	49170199	49170644	LTR/ERVL	1232	+	222	49170421	96913
chr3	123544853	123744853	harbor2	chr3	123553476	123553916	LTR/ERVL	1098	+	220	123553696	8843
chr3	123544853	123744853	harbor2	chr3	123573545	123573755	LTR/ERVL	665	+	105	123573650	28797
chr3	123544853	123744853	harbor2	chr3	123600940	123601490	LTR/ERVL	2132	+	275	123601215	56362
chr3	123544853	123744853	harbor2	chr3	123602293	123602600	LTR/ERVL	2105	+	154	123602447	57594
chr3	123544853	123744853	harbor2	chr3	123608666	123608971	LTR/ERVL	878	+	152	123608818	63965
chr3	46800653	47000653	harbor2	chr3	46816558	46817200	LTR/ERVL	1947	+	321	46816879	16226
chr3	46800653	47000653	harbor2	chr3	46827947	46828376	LTR/ERVL	2404	+	214	46828161	27508
chr3	46800653	47000653	harbor2	chr3	46854846	46855131	LTR/ERVL	575	+	142	46854988	54335
chr3	157569498	157769498	harbor2	chr3	157579061	157579227	LTR/ERVL	1162	+	83	157579144	9646
chr3	157569498	157769498	harbor2	chr3	157588010	157588227	LTR/ERVL	1493	+	108	157588118	18620
chr3	157569498	157769498	harbor2	chr3	157667269	157667762	LTR/ERVL	1798	+	246	157667515	98017
chr3	157569498	157769498	harbor2	chr3	157668505	157668706	LTR/ERVL	787	+	100	157668605	99107
chr3	157569498	157769498	harbor2	chr3	157668735	157669066	LTR/ERVL	787	+	166	157668901	99403
chr3	172010482	172210482	harbor2	chr3	172012541	172012822	LTR/ERVL	1015	+	140	172012681	2199
chr3	172010482	172210482	harbor2	chr3	172021123	172021928	LTR/ERVL	4275	+	402	172021525	11043
chr3	172010482	172210482	harbor2	chr3	172014901	172015660	LTR/ERVL	3418	+	380	172015281	4799
chr3	122886039	123086039	harbor2	chr3	122952882	122953086	LTR/ERVL	721	+	102	122952984	66945
chr3	122886039	123086039	harbor2	chr3	122967405	122967804	LTR/ERVL	1024	+	200	122967605	81566
chr3	74983907	75183907	harbor2	chr3	75078577	75079015	LTR/ERVL	1251	+	219	75078796	94889
chr3	12828058	13028058	harbor2	chr3	12885369	12885864	LTR/ERVL	1280	+	248	12885617	57559
chr3	126257004	126457004	harbor2	chr3	126282414	126282429	LTR/ERVL	4118	+	8	126282422	25418
chr3	126257004	126457004	harbor2	chr3	126282477	126283289	LTR/ERVL	4118	+	406	126282883	25879
chr3	138337091	138537091	harbor2	chr3	138339350	138339522	LTR/ERVL	628	+	86	138339436	2345
chr3	138337091	138537091	harbor2	chr3	138341428	138341708	LTR/ERVL	921	+	140	138341568	4477
chr3	138337091	138537091	harbor2	chr3	138424814	138425205	LTR/ERVL	2189	+	196	138425010	87919
chr3	138337091	138537091	harbor2	chr3	138425754	138425846	LTR/ERVL	2189	+	46	138425800	88709
chr3	127675921	127875921	harbor2	chr3	127731427	127731510	LTR/ERVL	444	+	42	127731469	55548
chr3	127675921	127875921	harbor2	chr3	127731534	127731908	LTR/ERVL	1260	+	187	127731721	55800
chr3	127675921	127875921	harbor2	chr3	127756224	127756667	LTR/ERVL	1867	+	222	127756446	80525
chr3	189960849	190160849	harbor2	chr3	189980682	189980847	LTR/ERVL	459	+	82	189980764	19915
chr3	189960849	190160849	harbor2	chr3	189980817	189981509	LTR/ERVL	2106	+	346	189981163	20314
chr3	189960849	190160849	harbor2	chr3	190045569	190045839	LTR/ERVL	999	+	135	190045704	84855
chr3	189960849	190160849	harbor2	chr3	190046141	190046287	LTR/ERVL	999	+	73	190046214	85365
chr4	145103423	145303423	harbor2	chr4	145197222	145197764	LTR/ERVL	589	+	271	145197493	94070
chr4	145103423	145303423	harbor2	chr4	145199028	145199546	LTR/ERVL	875	+	259	145199287	95864
chr4	2363035	2563035	harbor2	chr4	2363239	2363809	LTR/ERVL	1713	+	285	2363524	489
chr4	911390	1111390	harbor2	chr4	981650	981816	LTR/ERVL	2422	+	83	981733	70343
chr4	911390	1111390	harbor2	chr4	982119	982755	LTR/ERVL	2422	+	318	982437	71047
chr4	25762832	25962832	harbor2	chr4	25803505	25804037	LTR/ERVL	2077	+	266	25803771	40939
chr4	911356	1111356	harbor2	chr4	981650	981816	LTR/ERVL	2422	+	83	981733	70377
chr4	911356	1111356	harbor2	chr4	982119	982755	LTR/ERVL	2422	+	318	982437	71081
chr4	911393	1111393	harbor2	chr4	981650	981816	LTR/ERVL	2422	+	83	981733	70340
chr4	911393	1111393	harbor2	chr4	982119	982755	LTR/ERVL	2422	+	318	982437	71044
chr4	730253	930253	harbor2	chr4	798985	799580	LTR/ERVL	3564	+	298	799283	69030
chr4	730253	930253	harbor2	chr4	799884	800261	LTR/ERVL	3564	+	188	800072	69819
chr4	730253	930253	harbor2	chr4	814030	814219	LTR/ERVL	2957	+	94	814124	83871
chr4	730253	930253	harbor2	chr4	814513	814987	LTR/ERVL	2957	+	237	814750	84497
chr4	1421350	1621350	harbor2	chr4	1447015	1447329	LTR/ERVL	847	+	157	1447172	25822
chr4	89737944	89937944	harbor2	chr4	89771599	89771883	LTR/ERVL	787	+	142	89771741	33797
chr4	89737944	89937944	harbor2	chr4	89797096	89797530	LTR/ERVL	1009	+	217	89797313	59369
chr4	89737944	89937944	harbor2	chr4	89800947	89801393	LTR/ERVL	822	+	223	89801170	63226
chr4	89737944	89937944	harbor2	chr4	89800662	89800747	LTR/ERVL	822	+	42	89800704	62760
chr4	159002941	159202941	harbor2	chr4	159036245	159036583	LTR/ERVL	583	+	169	159036414	33473
chr4	159002941	159202941	harbor2	chr4	159023102	159023496	LTR/ERVL	1492	+	197	159023299	20358
chr4	159026392	159226392	harbor2	chr4	159036245	159036583	LTR/ERVL	583	+	169	159036414	10022
chr4	139551799	139751799	harbor2	chr4	139642379	139642593	LTR/ERVL	1016	+	107	139642486	90687
chr4	1771258	1971258	harbor2	chr4	1839574	1839778	LTR/ERVL	929	+	102	1839676	68418
chr4	1771258	1971258	harbor2	chr4	1839779	1840020	LTR/ERVL	1915	+	120	1839899	68641
chr4	1771258	1971258	harbor2	chr4	1840076	1840095	LTR/ERVL	1915	+	10	1840086	68828
chr4	1771258	1971258	harbor2	chr4	1840692	1840974	LTR/ERVL	1915	+	141	1840833	69575
chr4	3264984	3464984	harbor2	chr4	3282882	3283053	LTR/ERVL	592	+	86	3282968	17984
chr4	3264984	3464984	harbor2	chr4	3283059	3283243	LTR/ERVL	512	+	92	3283151	18167
chr4	3264984	3464984	harbor2	chr4	3284750	3285147	LTR/ERVL	1474	+	198	3284948	19964
chr4	3264984	3464984	harbor2	chr4	3291195	3291346	LTR/ERVL	517	+	76	3291271	26287
chr4	3264984	3464984	harbor2	chr4	3291647	3291944	LTR/ERVL	517	+	148	3291795	26811
chr4	3264984	3464984	harbor2	chr4	3314808	3315328	LTR/ERVL	2242	+	260	3315068	50084
chr4	3264984	3464984	harbor2	chr4	3321589	3321896	LTR/ERVL	650	+	154	3321743	56759
chr4	128444275	128644275	harbor2	chr4	128465150	128465625	LTR/ERVL	3155	+	238	128465388	21113
chr4	128444275	128644275	harbor2	chr4	128465664	128465714	LTR/ERVL	3155	+	25	128465689	21414
chr4	128444275	128644275	harbor2	chr4	128510150	128510680	LTR/ERVL	2362	+	265	128510415	66140
chr4	128444275	128644275	harbor2	chr4	128510986	128511030	LTR/ERVL	2362	+	22	128511008	66733
chr4	128444275	128644275	harbor2	chr4	128512876	128513307	LTR/ERVL	1392	+	216	128513092	68817
chr4	145198204	145398204	harbor2	chr4	145199028	145199546	LTR/ERVL	875	+	259	145199287	1083
chr4	145198204	145398204	harbor2	chr4	145250221	145250727	LTR/ERVL	1492	+	253	145250474	52270
chr4	145198204	145398204	harbor2	chr4	145271056	145271621	LTR/ERVL	1640	+	282	145271338	73134
chr4	159002962	159202962	harbor2	chr4	159036245	159036583	LTR/ERVL	583	+	169	159036414	33452
chr4	159002962	159202962	harbor2	chr4	159023102	159023496	LTR/ERVL	1492	+	197	159023299	20337
chr4	16642723	16842723	harbor2	chr4	16720102	16720527	LTR/ERVL	1296	+	212	16720314	77591
chr4	120195584	120395584	harbor2	chr4	120195866	120196448	LTR/ERVL	1885	+	291	120196157	573
chr4	120195584	120395584	harbor2	chr4	120202348	120202582	LTR/ERVL	913	+	117	120202465	6881
chr4	120195584	120395584	harbor2	chr4	120219569	120220035	LTR/ERVL	2766	+	233	120219802	24218
chr4	120195584	120395584	harbor2	chr4	120229055	120229352	LTR/ERVL	1350	+	148	120229203	33619
chr4	120195584	120395584	harbor2	chr4	120287158	120288243	LTR/ERVL	1419	+	542	120287700	92116
chr4	120195584	120395584	harbor2	chr4	120288683	120289178	LTR/ERVL	1047	+	248	120288931	93347
chr4	151521646	151721646	harbor2	chr4	151545931	151546498	LTR/ERVL	2694	+	284	151546215	24569
chr4	911391	1111391	harbor2	chr4	981650	981816	LTR/ERVL	2422	+	83	981733	70342
chr4	911391	1111391	harbor2	chr4	982119	982755	LTR/ERVL	2422	+	318	982437	71046
chr4	128712057	128912057	harbor2	chr4	128775703	128775934	LTR/ERVL	664	+	116	128775819	63762
chr4	76114019	76314019	harbor2	chr4	76156011	76156530	LTR/ERVL	1223	+	260	76156271	42252
chr4	76114019	76314019	harbor2	chr4	76176563	76177032	LTR/ERVL	2396	+	234	76176797	62778
chr4	3054676	3254676	harbor2	chr4	3063890	3064047	LTR/ERVL	660	+	78	3063968	9292
chr4	120823308	121023308	harbor2	chr4	120834201	120834217	LTR/ERVL	1937	+	8	120834209	10901
chr4	120823308	121023308	harbor2	chr4	120834583	120834988	LTR/ERVL	1937	+	202	120834785	11477
chr4	120823308	121023308	harbor2	chr4	120852247	120852648	LTR/ERVL	1606	+	200	120852447	29139
chr4	120823308	121023308	harbor2	chr4	120862543	120862876	LTR/ERVL	2314	+	166	120862709	39401
chr4	120823308	121023308	harbor2	chr4	120863177	120863191	LTR/ERVL	2314	+	7	120863184	39876
chr4	120823308	121023308	harbor2	chr4	120863227	120863460	LTR/ERVL	2314	+	116	120863343	40035
chr4	120823308	121023308	harbor2	chr4	120905319	120905744	LTR/ERVL	1522	+	212	120905531	82223
chr4	3418040	3618040	harbor2	chr4	3453754	3453895	LTR/ERVL	678	+	70	3453824	35784
chr4	3418040	3618040	harbor2	chr4	3453908	3454348	LTR/ERVL	3153	+	220	3454128	36088
chr4	3418040	3618040	harbor2	chr4	3454349	3456213	LTR/ERVL	38802	+	932	3455281	37241
chr4	3418040	3618040	harbor2	chr4	3458732	3460384	LTR/ERVL	38802	+	826	3459558	41518
chr4	3418040	3618040	harbor2	chr4	3456524	3458303	LTR/ERVL	38802	+	890	3457414	39374
chr4	8768364	8968364	harbor2	chr4	8835980	8836352	LTR/ERVL	678	+	186	8836166	67802
chr4	8768364	8968364	harbor2	chr4	8854460	8854749	LTR/ERVL	918	+	144	8854604	86240
chr4	120832418	121032418	harbor2	chr4	120834201	120834217	LTR/ERVL	1937	+	8	120834209	1791
chr4	120832418	121032418	harbor2	chr4	120834583	120834988	LTR/ERVL	1937	+	202	120834785	2367
chr4	120832418	121032418	harbor2	chr4	120852247	120852648	LTR/ERVL	1606	+	200	120852447	20029
chr4	120832418	121032418	harbor2	chr4	120862543	120862876	LTR/ERVL	2314	+	166	120862709	30291
chr4	120832418	121032418	harbor2	chr4	120863177	120863191	LTR/ERVL	2314	+	7	120863184	30766
chr4	120832418	121032418	harbor2	chr4	120863227	120863460	LTR/ERVL	2314	+	116	120863343	30925
chr4	120832418	121032418	harbor2	chr4	120905319	120905744	LTR/ERVL	1522	+	212	120905531	73113
chr4	163375906	163575906	harbor2	chr4	163435011	163435451	LTR/ERVL	1346	+	220	163435231	59325
chr4	163375906	163575906	harbor2	chr4	163467082	163467267	LTR/ERVL	607	+	92	163467174	91268
chr4	70803213	71003213	harbor2	chr4	70873099	70873491	LTR/ERVL	645	+	196	70873295	70082
chr4	138772104	138972104	harbor2	chr4	138779047	138779171	LTR/ERVL	629	+	62	138779109	7005
chr4	138772104	138972104	harbor2	chr4	138779263	138779670	LTR/ERVL	1167	+	204	138779467	7363
chr4	1421525	1621525	harbor2	chr4	1447015	1447329	LTR/ERVL	847	+	157	1447172	25647
chr4	86953456	87153456	harbor2	chr4	87019221	87020057	LTR/ERVL	4510	+	418	87019639	66183
chr4	139195860	139395860	harbor2	chr4	139219830	139220112	LTR/ERVL	1137	+	141	139219971	24111
chr4	120823157	121023157	harbor2	chr4	120834201	120834217	LTR/ERVL	1937	+	8	120834209	11052
chr4	120823157	121023157	harbor2	chr4	120834583	120834988	LTR/ERVL	1937	+	202	120834785	11628
chr4	120823157	121023157	harbor2	chr4	120852247	120852648	LTR/ERVL	1606	+	200	120852447	29290
chr4	120823157	121023157	harbor2	chr4	120862543	120862876	LTR/ERVL	2314	+	166	120862709	39552
chr4	120823157	121023157	harbor2	chr4	120863177	120863191	LTR/ERVL	2314	+	7	120863184	40027
chr4	120823157	121023157	harbor2	chr4	120863227	120863460	LTR/ERVL	2314	+	116	120863343	40186
chr4	120823157	121023157	harbor2	chr4	120905319	120905744	LTR/ERVL	1522	+	212	120905531	82374
chr4	1511255	1711255	harbor2	chr4	1590283	1590680	LTR/ERVL	1740	+	198	1590481	79226
chr4	55753709	55953709	harbor2	chr4	55790176	55790603	LTR/ERVL	1875	+	214	55790390	36681
chr4	55753709	55953709	harbor2	chr4	55804025	55804704	LTR/ERVL	1997	+	340	55804365	50656
chr4	55753709	55953709	harbor2	chr4	55851382	55851827	LTR/ERVL	543	+	222	55851604	97895
chr4	55753709	55953709	harbor2	chr4	55851988	55852466	LTR/ERVL	1465	+	239	55852227	98518
chr4	1068019	1268019	harbor2	chr4	1080305	1081157	LTR/ERVL	2296	+	426	1080731	12712
chr4	1068019	1268019	harbor2	chr4	1134868	1135048	LTR/ERVL	603	+	90	1134958	66939
chr4	1358624	1558624	harbor2	chr4	1447015	1447329	LTR/ERVL	847	+	157	1447172	88548
chr5	26453659	26653659	harbor2	chr5	26467893	26468177	LTR/ERVL	1204	+	142	26468035	14376
chr5	26453659	26653659	harbor2	chr5	26468480	26468680	LTR/ERVL	696	+	100	26468580	14921
chr5	26453659	26653659	harbor2	chr5	26474206	26474491	LTR/ERVL	773	+	142	26474348	20689
chr5	26453659	26653659	harbor2	chr5	26537035	26537304	LTR/ERVL	607	+	134	26537169	83510
chr5	26453659	26653659	harbor2	chr5	26538682	26539082	LTR/ERVL	541	+	200	26538882	85223
chr5	26453659	26653659	harbor2	chr5	26541238	26541615	LTR/ERVL	771	+	188	26541426	87767
chr5	26453659	26653659	harbor2	chr5	26544422	26544913	LTR/ERVL	1146	+	246	26544668	91009
chr5	26453659	26653659	harbor2	chr5	26545750	26545999	LTR/ERVL	602	+	124	26545874	92215
chr5	26453659	26653659	harbor2	chr5	26546096	26546393	LTR/ERVL	627	+	148	26546244	92585
chr5	9115075	9315075	harbor2	chr5	9127263	9127649	LTR/ERVL	1946	+	193	9127456	12381
chr5	9115075	9315075	harbor2	chr5	9148380	9148712	LTR/ERVL	1097	+	166	9148546	33471
chr5	9115075	9315075	harbor2	chr5	9149019	9149169	LTR/ERVL	1097	+	75	9149094	34019
chr5	10532476	10732476	harbor2	chr5	10581574	10581961	LTR/ERVL	2594	+	194	10581768	49292
chr5	10532476	10732476	harbor2	chr5	10589189	10589389	LTR/ERVL	531	+	100	10589289	56813
chr5	150964836	151164836	harbor2	chr5	151000078	151000460	LTR/ERVL	959	+	191	151000269	35433
chr5	150964836	151164836	harbor2	chr5	151014808	151015352	LTR/ERVL	2646	+	272	151015080	50244
chr5	150964836	151164836	harbor2	chr5	151016043	151016486	LTR/ERVL	1932	+	222	151016265	51429
chr5	52700037	52900037	harbor2	chr5	52702003	52702540	LTR/ERVL	2082	+	268	52702271	2234
chr5	52700037	52900037	harbor2	chr5	52714551	52714759	LTR/ERVL	621	+	104	52714655	14618
chr5	139561183	139761183	harbor2	chr5	139575092	139575306	LTR/ERVL	570	+	107	139575199	14016
chr5	62303875	62503875	harbor2	chr5	62342371	62342757	LTR/ERVL	1491	+	193	62342564	38689
chr5	62303875	62503875	harbor2	chr5	62343052	62343165	LTR/ERVL	1144	+	56	62343108	39233
chr5	139561198	139761198	harbor2	chr5	139575092	139575306	LTR/ERVL	570	+	107	139575199	14001
chr5	175342628	175542628	harbor2	chr5	175363480	175363740	LTR/ERVL	1272	+	130	175363610	20982
chr5	175342628	175542628	harbor2	chr5	175363748	175363993	LTR/ERVL	1504	+	122	175363870	21242
chr5	175342628	175542628	harbor2	chr5	175363994	175364398	LTR/ERVL	2634	+	202	175364196	21568
chr5	175342628	175542628	harbor2	chr5	175364400	175364722	LTR/ERVL	1278	+	161	175364561	21933
chr5	73397400	73597400	harbor2	chr5	73395554	73397440	LTR/ERVL	9098	+	943	73396497	903
chr5	73397400	73597400	harbor2	chr5	73397441	73398002	LTR/ERVL	1348	+	280	73397721	321
chr5	73397400	73597400	harbor2	chr5	73426255	73426780	LTR/ERVL	2886	+	262	73426517	29117
chr5	73397400	73597400	harbor2	chr5	73494707	73495150	LTR/ERVL	2356	+	222	73494929	97529
chr5	73397400	73597400	harbor2	chr5	73495383	73495513	LTR/ERVL	2356	+	65	73495448	98048
chr5	37742412	37942412	harbor2	chr5	37793305	37793724	LTR/ERVL	3102	+	210	37793515	51103
chr5	37742412	37942412	harbor2	chr5	37793725	37795107	LTR/ERVL	33293	+	691	37794416	52004
chr5	37742412	37942412	harbor2	chr5	37795417	37798236	LTR/ERVL	33293	+	1410	37796827	54415
chr5	33908472	34108472	harbor2	chr5	33961658	33962147	LTR/ERVL	1729	+	244	33961902	53430
chr5	33908472	34108472	harbor2	chr5	33970416	33970523	LTR/ERVL	442	+	54	33970470	61998
chr5	33908472	34108472	harbor2	chr5	33986535	33986963	LTR/ERVL	780	+	214	33986749	78277
chr5	73351463	73551463	harbor2	chr5	73395554	73397440	LTR/ERVL	9098	+	943	73396497	45034
chr5	73351463	73551463	harbor2	chr5	73397441	73398002	LTR/ERVL	1348	+	280	73397721	46258
chr5	73351463	73551463	harbor2	chr5	73426255	73426780	LTR/ERVL	2886	+	262	73426517	75054
chr5	135435248	135635248	harbor2	chr5	135442746	135443256	LTR/ERVL	1000	+	255	135443001	7753
chr5	135833577	136033577	harbor2	chr5	135924622	135925210	LTR/ERVL	2020	+	294	135924916	91339
chr5	10454733	10654733	harbor2	chr5	10466167	10466427	LTR/ERVL	485	+	130	10466297	11564
chr5	10454733	10654733	harbor2	chr5	10475052	10475470	LTR/ERVL	1905	+	209	10475261	20528
chr5	10454733	10654733	harbor2	chr5	10507548	10508145	LTR/ERVL	3491	+	298	10507846	53113
chr5	10454733	10654733	harbor2	chr5	10513702	10514075	LTR/ERVL	585	+	186	10513888	59155
chr5	73351456	73551456	harbor2	chr5	73395554	73397440	LTR/ERVL	9098	+	943	73396497	45041
chr5	73351456	73551456	harbor2	chr5	73397441	73398002	LTR/ERVL	1348	+	280	73397721	46265
chr5	73351456	73551456	harbor2	chr5	73426255	73426780	LTR/ERVL	2886	+	262	73426517	75061
chr5	52848700	53048700	harbor2	chr5	52857795	52858013	LTR/ERVL	661	+	109	52857904	9204
chr5	73351468	73551468	harbor2	chr5	73395554	73397440	LTR/ERVL	9098	+	943	73396497	45029
chr5	73351468	73551468	harbor2	chr5	73397441	73398002	LTR/ERVL	1348	+	280	73397721	46253
chr5	73351468	73551468	harbor2	chr5	73426255	73426780	LTR/ERVL	2886	+	262	73426517	75049
chr5	16450508	16650508	harbor2	chr5	16526788	16527175	LTR/ERVL	1207	+	194	16526982	76474
chr5	177922457	178122457	harbor2	chr5	177987514	177987785	LTR/ERVL	1375	+	136	177987650	65193
chr5	177922457	178122457	harbor2	chr5	177988097	177988195	LTR/ERVL	1375	+	49	177988146	65689
chr5	177922457	178122457	harbor2	chr5	178015193	178015979	LTR/ERVL	3481	+	393	178015586	93129
chr5	73351472	73551472	harbor2	chr5	73395554	73397440	LTR/ERVL	9098	+	943	73396497	45025
chr5	73351472	73551472	harbor2	chr5	73397441	73398002	LTR/ERVL	1348	+	280	73397721	46249
chr5	73351472	73551472	harbor2	chr5	73426255	73426780	LTR/ERVL	2886	+	262	73426517	75045
chr5	90417637	90617637	harbor2	chr5	90462058	90462241	LTR/ERVL	733	+	92	90462150	44513
chr5	181061884	181261884	harbor2	chr5	181081170	181081393	LTR/ERVL	1267	+	112	181081282	19398
chr5	181061884	181261884	harbor2	chr5	181081635	181081839	LTR/ERVL	1089	+	102	181081737	19853
chr5	181061884	181261884	harbor2	chr5	181120456	181120578	LTR/ERVL	452	+	61	181120517	58633
chr5	181061884	181261884	harbor2	chr5	181120881	181121078	LTR/ERVL	452	+	98	181120979	59095
chr5	181061884	181261884	harbor2	chr5	181121098	181121571	LTR/ERVL	1516	+	236	181121334	59450
chr5	181061884	181261884	harbor2	chr5	181122591	181122650	LTR/ERVL	424	+	30	181122621	60737
chr5	181061884	181261884	harbor2	chr5	181122896	181122970	LTR/ERVL	424	+	37	181122933	61049
chr5	181061884	181261884	harbor2	chr5	181140795	181141314	LTR/ERVL	1884	+	260	181141055	79171
chr5	38973892	39173892	harbor2	chr5	39048247	39048749	LTR/ERVL	2350	+	251	39048498	74606
chr5	52700057	52900057	harbor2	chr5	52702003	52702540	LTR/ERVL	2082	+	268	52702271	2214
chr5	52700057	52900057	harbor2	chr5	52714551	52714759	LTR/ERVL	621	+	104	52714655	14598
chr5	10661141	10861141	harbor2	chr5	10672684	10673047	LTR/ERVL	1828	+	182	10672866	11725
chr5	10661141	10861141	harbor2	chr5	10716384	10716832	LTR/ERVL	3087	+	224	10716608	55467
chr5	10661141	10861141	harbor2	chr5	10716833	10717681	LTR/ERVL	6539	+	424	10717257	56116
chr5	10661141	10861141	harbor2	chr5	10717681	10720094	LTR/ERVL	18730	+	1206	10718887	57746
chr5	10661141	10861141	harbor2	chr5	10720334	10722105	LTR/ERVL	13357	+	886	10721220	60079
chr5	10661141	10861141	harbor2	chr5	10722106	10722498	LTR/ERVL	2866	+	196	10722302	61161
chr5	10661141	10861141	harbor2	chr5	10747636	10747809	LTR/ERVL	448	+	86	10747722	86581
chr5	135111374	135311374	harbor2	chr5	135159638	135160026	LTR/ERVL	1117	+	194	135159832	48458
chr5	135111374	135311374	harbor2	chr5	135162119	135162219	LTR/ERVL	482	+	50	135162169	50795
chr5	73397918	73597918	harbor2	chr5	73397441	73398002	LTR/ERVL	1348	+	280	73397721	197
chr5	73397918	73597918	harbor2	chr5	73426255	73426780	LTR/ERVL	2886	+	262	73426517	28599
chr5	73397918	73597918	harbor2	chr5	73494707	73495150	LTR/ERVL	2356	+	222	73494929	97011
chr5	73397918	73597918	harbor2	chr5	73495383	73495513	LTR/ERVL	2356	+	65	73495448	97530
chr5	9114713	9314713	harbor2	chr5	9127263	9127649	LTR/ERVL	1946	+	193	9127456	12743
chr5	9114713	9314713	harbor2	chr5	9148380	9148712	LTR/ERVL	1097	+	166	9148546	33833
chr5	9114713	9314713	harbor2	chr5	9149019	9149169	LTR/ERVL	1097	+	75	9149094	34381
chr5	132104549	132304549	harbor2	chr5	132190262	132190427	LTR/ERVL	498	+	82	132190344	85795
chr5	132104549	132304549	harbor2	chr5	132202871	132203347	LTR/ERVL	2804	+	238	132203109	98560
chr5	150968283	151168283	harbor2	chr5	151000078	151000460	LTR/ERVL	959	+	191	151000269	31986
chr5	150968283	151168283	harbor2	chr5	151014808	151015352	LTR/ERVL	2646	+	272	151015080	46797
chr5	150968283	151168283	harbor2	chr5	151016043	151016486	LTR/ERVL	1932	+	222	151016265	47982
chr5	12213087	12413087	harbor2	chr5	12265604	12265749	LTR/ERVL	857	+	72	12265676	52589
chr5	12213087	12413087	harbor2	chr5	12273888	12274632	LTR/ERVL	2319	+	372	12274260	61173
chr5	12213087	12413087	harbor2	chr5	12274830	12275147	LTR/ERVL	728	+	158	12274988	61901
chr5	12213087	12413087	harbor2	chr5	12298224	12298541	LTR/ERVL	475	+	158	12298382	85295
chr5	135980732	136180732	harbor2	chr5	135986067	135986327	LTR/ERVL	1059	+	130	135986197	5465
chr5	73353308	73553308	harbor2	chr5	73395554	73397440	LTR/ERVL	9098	+	943	73396497	43189
chr5	73353308	73553308	harbor2	chr5	73397441	73398002	LTR/ERVL	1348	+	280	73397721	44413
chr5	73353308	73553308	harbor2	chr5	73426255	73426780	LTR/ERVL	2886	+	262	73426517	73209
chr5	9115133	9315133	harbor2	chr5	9127263	9127649	LTR/ERVL	1946	+	193	9127456	12323
chr5	9115133	9315133	harbor2	chr5	9148380	9148712	LTR/ERVL	1097	+	166	9148546	33413
chr5	9115133	9315133	harbor2	chr5	9149019	9149169	LTR/ERVL	1097	+	75	9149094	33961
chr5	52700041	52900041	harbor2	chr5	52702003	52702540	LTR/ERVL	2082	+	268	52702271	2230
chr5	52700041	52900041	harbor2	chr5	52714551	52714759	LTR/ERVL	621	+	104	52714655	14614
chr5	10184413	10384413	harbor2	chr5	10191041	10191152	LTR/ERVL	440	+	56	10191097	6684
chr5	10184413	10384413	harbor2	chr5	10196808	10197381	LTR/ERVL	2154	+	286	10197094	12681
chr5	10184413	10384413	harbor2	chr5	10278182	10279043	LTR/ERVL	4610	+	430	10278612	94199
chr5	9114912	9314912	harbor2	chr5	9127263	9127649	LTR/ERVL	1946	+	193	9127456	12544
chr5	9114912	9314912	harbor2	chr5	9148380	9148712	LTR/ERVL	1097	+	166	9148546	33634
chr5	9114912	9314912	harbor2	chr5	9149019	9149169	LTR/ERVL	1097	+	75	9149094	34182
chr5	171288566	171488566	harbor2	chr5	171332101	171332362	LTR/ERVL	600	+	130	171332231	43665
chr5	171288566	171488566	harbor2	chr5	171332543	171332683	LTR/ERVL	602	+	70	171332613	44047
chr5	171288566	171488566	harbor2	chr5	171356741	171357110	LTR/ERVL	668	+	184	171356925	68359
chr5	171288566	171488566	harbor2	chr5	171357682	171358489	LTR/ERVL	1349	+	404	171358086	69520
chr5	171288566	171488566	harbor2	chr5	171378068	171378196	LTR/ERVL	433	+	64	171378132	89566
chr5	171288566	171488566	harbor2	chr5	171379200	171379339	LTR/ERVL	547	+	70	171379270	90704
chr5	93480280	93680280	harbor2	chr5	93491469	93492030	LTR/ERVL	2839	+	280	93491749	11469
chr5	93480280	93680280	harbor2	chr5	93503494	93503987	LTR/ERVL	2798	+	246	93503740	23460
chr5	93480280	93680280	harbor2	chr5	93511062	93511453	LTR/ERVL	1805	+	196	93511258	30978
chr5	93480280	93680280	harbor2	chr5	93546784	93547230	LTR/ERVL	2232	+	223	93547007	66727
chr5	73354658	73554658	harbor2	chr5	73395554	73397440	LTR/ERVL	9098	+	943	73396497	41839
chr5	73354658	73554658	harbor2	chr5	73397441	73398002	LTR/ERVL	1348	+	280	73397721	43063
chr5	73354658	73554658	harbor2	chr5	73426255	73426780	LTR/ERVL	2886	+	262	73426517	71859
chr5	9114251	9314251	harbor2	chr5	9127263	9127649	LTR/ERVL	1946	+	193	9127456	13205
chr5	9114251	9314251	harbor2	chr5	9148380	9148712	LTR/ERVL	1097	+	166	9148546	34295
chr5	9114251	9314251	harbor2	chr5	9149019	9149169	LTR/ERVL	1097	+	75	9149094	34843
chr5	130296604	130496604	harbor2	chr5	130299867	130301538	LTR/ERVL	3525	+	836	130300703	4099
chr5	130296604	130496604	harbor2	chr5	130354716	130355260	LTR/ERVL	973	+	272	130354988	58384
chr5	130296604	130496604	harbor2	chr5	130355285	130355533	LTR/ERVL	482	+	124	130355409	58805
chr5	130296604	130496604	harbor2	chr5	130356225	130356333	LTR/ERVL	496	+	54	130356279	59675
chr5	130296604	130496604	harbor2	chr5	130356340	130356698	LTR/ERVL	617	+	179	130356519	59915
chr5	130296604	130496604	harbor2	chr5	130356774	130357115	LTR/ERVL	685	+	170	130356944	60340
chr5	130296604	130496604	harbor2	chr5	130357117	130357288	LTR/ERVL	478	+	86	130357203	60599
chr5	130296604	130496604	harbor2	chr5	130357344	130357402	LTR/ERVL	1586	+	29	130357373	60769
chr5	130296604	130496604	harbor2	chr5	130357642	130357986	LTR/ERVL	1586	+	172	130357814	61210
chr5	130296604	130496604	harbor2	chr5	130368063	130368650	LTR/ERVL	1535	+	294	130368357	71753
chr5	9114268	9314268	harbor2	chr5	9127263	9127649	LTR/ERVL	1946	+	193	9127456	13188
chr5	9114268	9314268	harbor2	chr5	9148380	9148712	LTR/ERVL	1097	+	166	9148546	34278
chr5	9114268	9314268	harbor2	chr5	9149019	9149169	LTR/ERVL	1097	+	75	9149094	34826
chr5	153994567	154194567	harbor2	chr5	154081655	154082107	LTR/ERVL	1801	+	226	154081881	87314
chr5	153994567	154194567	harbor2	chr5	154088385	154088725	LTR/ERVL	856	+	170	154088555	93988
chr5	78345454	78545454	harbor2	chr5	78347111	78347413	LTR/ERVL	678	+	151	78347262	1808
chr5	78345454	78545454	harbor2	chr5	78389860	78390040	LTR/ERVL	1464	+	90	78389950	44496
chr5	78345454	78545454	harbor2	chr5	78390076	78390237	LTR/ERVL	1464	+	80	78390156	44702
chr5	171287658	171487658	harbor2	chr5	171332101	171332362	LTR/ERVL	600	+	130	171332231	44573
chr5	171287658	171487658	harbor2	chr5	171332543	171332683	LTR/ERVL	602	+	70	171332613	44955
chr5	171287658	171487658	harbor2	chr5	171356741	171357110	LTR/ERVL	668	+	184	171356925	69267
chr5	171287658	171487658	harbor2	chr5	171357682	171358489	LTR/ERVL	1349	+	404	171358086	70428
chr5	171287658	171487658	harbor2	chr5	171378068	171378196	LTR/ERVL	433	+	64	171378132	90474
chr5	171287658	171487658	harbor2	chr5	171379200	171379339	LTR/ERVL	547	+	70	171379270	91612
chr5	73351454	73551454	harbor2	chr5	73395554	73397440	LTR/ERVL	9098	+	943	73396497	45043
chr5	73351454	73551454	harbor2	chr5	73397441	73398002	LTR/ERVL	1348	+	280	73397721	46267
chr5	73351454	73551454	harbor2	chr5	73426255	73426780	LTR/ERVL	2886	+	262	73426517	75063
chr5	171288550	171488550	harbor2	chr5	171332101	171332362	LTR/ERVL	600	+	130	171332231	43681
chr5	171288550	171488550	harbor2	chr5	171332543	171332683	LTR/ERVL	602	+	70	171332613	44063
chr5	171288550	171488550	harbor2	chr5	171356741	171357110	LTR/ERVL	668	+	184	171356925	68375
chr5	171288550	171488550	harbor2	chr5	171357682	171358489	LTR/ERVL	1349	+	404	171358086	69536
chr5	171288550	171488550	harbor2	chr5	171378068	171378196	LTR/ERVL	433	+	64	171378132	89582
chr5	171288550	171488550	harbor2	chr5	171379200	171379339	LTR/ERVL	547	+	70	171379270	90720
chr5	181070052	181270052	harbor2	chr5	181081170	181081393	LTR/ERVL	1267	+	112	181081282	11230
chr5	181070052	181270052	harbor2	chr5	181081635	181081839	LTR/ERVL	1089	+	102	181081737	11685
chr5	181070052	181270052	harbor2	chr5	181120456	181120578	LTR/ERVL	452	+	61	181120517	50465
chr5	181070052	181270052	harbor2	chr5	181120881	181121078	LTR/ERVL	452	+	98	181120979	50927
chr5	181070052	181270052	harbor2	chr5	181121098	181121571	LTR/ERVL	1516	+	236	181121334	51282
chr5	181070052	181270052	harbor2	chr5	181122591	181122650	LTR/ERVL	424	+	30	181122621	52569
chr5	181070052	181270052	harbor2	chr5	181122896	181122970	LTR/ERVL	424	+	37	181122933	52881
chr5	181070052	181270052	harbor2	chr5	181140795	181141314	LTR/ERVL	1884	+	260	181141055	71003
chr5	11986337	12186337	harbor2	chr5	12014549	12014766	LTR/ERVL	589	+	108	12014657	28320
chr5	11986337	12186337	harbor2	chr5	12070840	12071390	LTR/ERVL	2634	+	275	12071115	84778
chr5	93480288	93680288	harbor2	chr5	93491469	93492030	LTR/ERVL	2839	+	280	93491749	11461
chr5	93480288	93680288	harbor2	chr5	93503494	93503987	LTR/ERVL	2798	+	246	93503740	23452
chr5	93480288	93680288	harbor2	chr5	93511062	93511453	LTR/ERVL	1805	+	196	93511258	30970
chr5	93480288	93680288	harbor2	chr5	93546784	93547230	LTR/ERVL	2232	+	223	93547007	66719
chr5	62303878	62503878	harbor2	chr5	62342371	62342757	LTR/ERVL	1491	+	193	62342564	38686
chr5	62303878	62503878	harbor2	chr5	62343052	62343165	LTR/ERVL	1144	+	56	62343108	39230
chr5	164861844	165061844	harbor2	chr5	164864084	164864470	LTR/ERVL	1807	+	193	164864277	2433
chr5	164861844	165061844	harbor2	chr5	164894629	164894835	LTR/ERVL	687	+	103	164894732	32888
chr5	6526022	6726022	harbor2	chr5	6526153	6526482	LTR/ERVL	1490	+	164	6526317	295
chr5	6526022	6726022	harbor2	chr5	6526545	6526669	LTR/ERVL	483	+	62	6526607	585
chr5	6526022	6726022	harbor2	chr5	6537900	6538183	LTR/ERVL	1613	+	142	6538042	12020
chr5	6526022	6726022	harbor2	chr5	6557371	6557817	LTR/ERVL	817	+	223	6557594	31572
chr5	6526022	6726022	harbor2	chr5	6572513	6572798	LTR/ERVL	560	+	142	6572655	46633
chr5	6526022	6726022	harbor2	chr5	6591912	6592235	LTR/ERVL	751	+	162	6592074	66052
chr5	6526022	6726022	harbor2	chr5	6595445	6595958	LTR/ERVL	2363	+	256	6595701	69679
chr5	6526022	6726022	harbor2	chr5	6613689	6613801	LTR/ERVL	461	+	56	6613745	87723
chr5	6526022	6726022	harbor2	chr5	6569609	6570026	LTR/ERVL	3100	+	208	6569817	43795
chr5	150967168	151167168	harbor2	chr5	151000078	151000460	LTR/ERVL	959	+	191	151000269	33101
chr5	150967168	151167168	harbor2	chr5	151014808	151015352	LTR/ERVL	2646	+	272	151015080	47912
chr5	150967168	151167168	harbor2	chr5	151016043	151016486	LTR/ERVL	1932	+	222	151016265	49097
chr5	10661088	10861088	harbor2	chr5	10672684	10673047	LTR/ERVL	1828	+	182	10672866	11778
chr5	10661088	10861088	harbor2	chr5	10716384	10716832	LTR/ERVL	3087	+	224	10716608	55520
chr5	10661088	10861088	harbor2	chr5	10716833	10717681	LTR/ERVL	6539	+	424	10717257	56169
chr5	10661088	10861088	harbor2	chr5	10717681	10720094	LTR/ERVL	18730	+	1206	10718887	57799
chr5	10661088	10861088	harbor2	chr5	10720334	10722105	LTR/ERVL	13357	+	886	10721220	60132
chr5	10661088	10861088	harbor2	chr5	10722106	10722498	LTR/ERVL	2866	+	196	10722302	61214
chr5	10661088	10861088	harbor2	chr5	10747636	10747809	LTR/ERVL	448	+	86	10747722	86634
chr5	170686109	170886109	harbor2	chr5	170739473	170739615	LTR/ERVL	877	+	71	170739544	53435
chr5	170686109	170886109	harbor2	chr5	170740038	170740246	LTR/ERVL	877	+	104	170740142	54033
chr5	170686109	170886109	harbor2	chr5	170742362	170742704	LTR/ERVL	1954	+	171	170742533	56424
chr5	170686109	170886109	harbor2	chr5	170743010	170743049	LTR/ERVL	1954	+	20	170743030	56921
chr5	170686109	170886109	harbor2	chr5	170743096	170743136	LTR/ERVL	1954	+	20	170743116	57007
chr5	170686109	170886109	harbor2	chr5	170753670	170753958	LTR/ERVL	1269	+	144	170753814	67705
chr5	2004592	2204592	harbor2	chr5	2010372	2010658	LTR/ERVL	970	+	143	2010515	5923
chr5	2004592	2204592	harbor2	chr5	2010804	2010957	LTR/ERVL	625	+	76	2010880	6288
chr5	2004592	2204592	harbor2	chr5	2012700	2012947	LTR/ERVL	448	+	124	2012824	8232
chr5	2004592	2204592	harbor2	chr5	2045445	2045818	LTR/ERVL	635	+	186	2045631	41039
chr5	132110718	132310718	harbor2	chr5	132190262	132190427	LTR/ERVL	498	+	82	132190344	79626
chr5	132110718	132310718	harbor2	chr5	132202871	132203347	LTR/ERVL	2804	+	238	132203109	92391
chr5	151640401	151840401	harbor2	chr5	151654475	151654884	LTR/ERVL	1494	+	204	151654679	14278
chr5	151640401	151840401	harbor2	chr5	151670104	151670652	LTR/ERVL	3112	+	274	151670378	29977
chr5	151640401	151840401	harbor2	chr5	151703036	151703482	LTR/ERVL	1293	+	223	151703259	62858
chr5	73351410	73551410	harbor2	chr5	73395554	73397440	LTR/ERVL	9098	+	943	73396497	45087
chr5	73351410	73551410	harbor2	chr5	73397441	73398002	LTR/ERVL	1348	+	280	73397721	46311
chr5	73351410	73551410	harbor2	chr5	73426255	73426780	LTR/ERVL	2886	+	262	73426517	75107
chr5	143870685	144070685	harbor2	chr5	143880297	143880606	LTR/ERVL	733	+	154	143880451	9766
chr5	143870685	144070685	harbor2	chr5	143959938	143960326	LTR/ERVL	1059	+	194	143960132	89447
chr5	135980728	136180728	harbor2	chr5	135986067	135986327	LTR/ERVL	1059	+	130	135986197	5469
chr5	135359105	135559105	harbor2	chr5	135424518	135425079	LTR/ERVL	785	+	280	135424798	65693
chr5	135359105	135559105	harbor2	chr5	135428715	135429016	LTR/ERVL	549	+	150	135428865	69760
chr5	135359105	135559105	harbor2	chr5	135429037	135429166	LTR/ERVL	482	+	64	135429101	69996
chr5	135359105	135559105	harbor2	chr5	135442746	135443256	LTR/ERVL	1000	+	255	135443001	83896
chr5	93492549	93692549	harbor2	chr5	93503494	93503987	LTR/ERVL	2798	+	246	93503740	11191
chr5	93492549	93692549	harbor2	chr5	93511062	93511453	LTR/ERVL	1805	+	196	93511258	18709
chr5	93492549	93692549	harbor2	chr5	93546784	93547230	LTR/ERVL	2232	+	223	93547007	54458
chr5	9114687	9314687	harbor2	chr5	9127263	9127649	LTR/ERVL	1946	+	193	9127456	12769
chr5	9114687	9314687	harbor2	chr5	9148380	9148712	LTR/ERVL	1097	+	166	9148546	33859
chr5	9114687	9314687	harbor2	chr5	9149019	9149169	LTR/ERVL	1097	+	75	9149094	34407
chr5	179720825	179920825	harbor2	chr5	179782044	179782397	LTR/ERVL	859	+	176	179782220	61395
chr5	139561187	139761187	harbor2	chr5	139575092	139575306	LTR/ERVL	570	+	107	139575199	14012
chr5	32176705	32376705	harbor2	chr5	32203334	32203433	LTR/ERVL	3762	+	50	32203384	26679
chr5	32176705	32376705	harbor2	chr5	32203735	32204502	LTR/ERVL	3762	+	384	32204119	27414
chr5	32176705	32376705	harbor2	chr5	32221220	32221518	LTR/ERVL	1018	+	149	32221369	44664
chr5	19259135	19459135	harbor2	chr5	19270219	19270759	LTR/ERVL	2711	+	270	19270489	11354
chr5	107321099	107521099	harbor2	chr5	107354740	107354929	LTR/ERVL	430	+	94	107354834	33735
chr6	139488408	139688408	harbor2	chr6	139497021	139497518	LTR/ERVL	1332	+	248	139497269	8861
chr6	139488408	139688408	harbor2	chr6	139506456	139506713	LTR/ERVL	789	+	128	139506584	18176
chr6	105490329	105690329	harbor2	chr6	105540416	105540465	LTR/ERVL	2608	+	24	105540440	50111
chr6	105490329	105690329	harbor2	chr6	105540776	105541275	LTR/ERVL	2608	+	250	105541026	50697
chr6	105490329	105690329	harbor2	chr6	105541276	105541727	LTR/ERVL	1384	+	226	105541502	51173
chr6	139785813	139985813	harbor2	chr6	139840490	139840666	LTR/ERVL	840	+	88	139840578	54765
chr6	139785813	139985813	harbor2	chr6	139840751	139840763	LTR/ERVL	840	+	6	139840757	54944
chr6	139785813	139985813	harbor2	chr6	139840844	139840878	LTR/ERVL	840	+	17	139840861	55048
chr6	139275435	139475435	harbor2	chr6	139285693	139285793	LTR/ERVL	726	+	50	139285743	10308
chr6	139275435	139475435	harbor2	chr6	139287058	139287389	LTR/ERVL	2163	+	166	139287224	11789
chr6	127168513	127368513	harbor2	chr6	127223432	127223897	LTR/ERVL	966	+	232	127223664	55151
chr6	127168513	127368513	harbor2	chr6	127239428	127239578	LTR/ERVL	846	+	75	127239503	70990
chr6	127168513	127368513	harbor2	chr6	127249110	127249446	LTR/ERVL	665	+	168	127249278	80765
chr6	127168513	127368513	harbor2	chr6	127249471	127249637	LTR/ERVL	747	+	83	127249554	81041
chr6	111987608	112187608	harbor2	chr6	112036477	112036769	LTR/ERVL	752	+	146	112036623	49015
chr6	166899020	167099020	harbor2	chr6	166991408	166991908	LTR/ERVL	2583	+	250	166991658	92638
chr6	139275444	139475444	harbor2	chr6	139285693	139285793	LTR/ERVL	726	+	50	139285743	10299
chr6	139275444	139475444	harbor2	chr6	139287058	139287389	LTR/ERVL	2163	+	166	139287224	11780
chr6	124863601	125063601	harbor2	chr6	124917781	124918185	LTR/ERVL	1706	+	202	124917983	54382
chr6	11912036	12112036	harbor2	chr6	11946565	11946973	LTR/ERVL	1697	+	204	11946769	34733
chr6	11912036	12112036	harbor2	chr6	11963606	11964123	LTR/ERVL	2885	+	258	11963864	51828
chr6	7639383	7839383	harbor2	chr6	7674100	7674671	LTR/ERVL	1086	+	286	7674386	35003
chr6	7639383	7839383	harbor2	chr6	7677028	7677379	LTR/ERVL	2317	+	176	7677204	37821
chr6	7639383	7839383	harbor2	chr6	7677510	7677549	LTR/ERVL	2317	+	20	7677530	38147
chr6	7639383	7839383	harbor2	chr6	7738378	7738618	LTR/ERVL	544	+	120	7738498	99115
chr6	105895039	106095039	harbor2	chr6	105907961	105908290	LTR/ERVL	951	+	164	105908125	13086
chr6	105895039	106095039	harbor2	chr6	105929865	105930205	LTR/ERVL	746	+	170	105930035	34996
chr6	105895039	106095039	harbor2	chr6	105964240	105964760	LTR/ERVL	1303	+	260	105964500	69461
chr6	105895039	106095039	harbor2	chr6	105972930	105973372	LTR/ERVL	1868	+	221	105973151	78112
chr6	107974811	108174811	harbor2	chr6	107998392	107998580	LTR/ERVL	1504	+	94	107998486	23675
chr6	107974811	108174811	harbor2	chr6	107998873	107999375	LTR/ERVL	1504	+	251	107999124	24313
chr6	107974811	108174811	harbor2	chr6	108033423	108033786	LTR/ERVL	1681	+	182	108033605	58794
chr6	139275454	139475454	harbor2	chr6	139285693	139285793	LTR/ERVL	726	+	50	139285743	10289
chr6	139275454	139475454	harbor2	chr6	139287058	139287389	LTR/ERVL	2163	+	166	139287224	11770
chr6	35370706	35570706	harbor2	chr6	35432314	35432726	LTR/ERVL	1221	+	206	35432520	61814
chr6	45551785	45751785	harbor2	chr6	45621072	45621915	LTR/ERVL	4750	+	422	45621494	69709
chr6	110291208	110491208	harbor2	chr6	110388953	110389443	LTR/ERVL	2987	+	245	110389198	97990
chr6	107974809	108174809	harbor2	chr6	107998392	107998580	LTR/ERVL	1504	+	94	107998486	23677
chr6	107974809	108174809	harbor2	chr6	107998873	107999375	LTR/ERVL	1504	+	251	107999124	24315
chr6	107974809	108174809	harbor2	chr6	108033423	108033786	LTR/ERVL	1681	+	182	108033605	58796
chr6	139275412	139475412	harbor2	chr6	139285693	139285793	LTR/ERVL	726	+	50	139285743	10331
chr6	139275412	139475412	harbor2	chr6	139287058	139287389	LTR/ERVL	2163	+	166	139287224	11812
chr6	36494234	36694234	harbor2	chr6	36586605	36586742	LTR/ERVL	542	+	68	36586673	92439
chr6	77363827	77563827	harbor2	chr6	77363736	77363902	LTR/ERVL	532	+	83	77363819	8
chr6	77363827	77563827	harbor2	chr6	77364124	77364500	LTR/ERVL	565	+	188	77364312	485
chr6	77363827	77563827	harbor2	chr6	77364510	77365171	LTR/ERVL	1689	+	330	77364840	1013
chr6	77363827	77563827	harbor2	chr6	77373959	77374381	LTR/ERVL	1296	+	211	77374170	10343
chr6	77363827	77563827	harbor2	chr6	77428294	77428695	LTR/ERVL	1305	+	200	77428494	64667
chr6	77363827	77563827	harbor2	chr6	77440327	77440686	LTR/ERVL	1403	+	180	77440507	76680
chr6	139275376	139475376	harbor2	chr6	139285693	139285793	LTR/ERVL	726	+	50	139285743	10367
chr6	139275376	139475376	harbor2	chr6	139287058	139287389	LTR/ERVL	2163	+	166	139287224	11848
chr6	30786661	30986661	harbor2	chr6	30810701	30811222	LTR/ERVL	2188	+	260	30810961	24300
chr6	30786661	30986661	harbor2	chr6	30820210	30820620	LTR/ERVL	1011	+	205	30820415	33754
chr6	30786661	30986661	harbor2	chr6	30832625	30833083	LTR/ERVL	1396	+	229	30832854	46193
chr6	30786661	30986661	harbor2	chr6	30833447	30833491	LTR/ERVL	1089	+	22	30833469	46808
chr6	30786661	30986661	harbor2	chr6	30873343	30873529	LTR/ERVL	608	+	93	30873436	86775
chr6	10422491	10622491	harbor2	chr6	10451060	10451872	LTR/ERVL	4437	+	406	10451466	28975
chr6	10422491	10622491	harbor2	chr6	10469877	10470174	LTR/ERVL	561	+	148	10470025	47534
chr6	10422491	10622491	harbor2	chr6	10475018	10475747	LTR/ERVL	2386	+	364	10475382	52891
chr6	10422491	10622491	harbor2	chr6	10476219	10477348	LTR/ERVL	1726	+	564	10476783	54292
chr6	10422491	10622491	harbor2	chr6	10477445	10477506	LTR/ERVL	963	+	30	10477475	54984
chr6	10422491	10622491	harbor2	chr6	10477801	10478178	LTR/ERVL	963	+	188	10477989	55498
chr6	10422491	10622491	harbor2	chr6	10486070	10486316	LTR/ERVL	1284	+	123	10486193	63702
chr6	139346565	139546565	harbor2	chr6	139437722	139438129	LTR/ERVL	1238	+	204	139437926	91361
chr6	139346565	139546565	harbor2	chr6	139438439	139438668	LTR/ERVL	1238	+	114	139438553	91988
chr6	139275442	139475442	harbor2	chr6	139285693	139285793	LTR/ERVL	726	+	50	139285743	10301
chr6	139275442	139475442	harbor2	chr6	139287058	139287389	LTR/ERVL	2163	+	166	139287224	11782
chr6	81653509	81853509	harbor2	chr6	81668894	81669164	LTR/ERVL	723	+	135	81669029	15520
chr6	81653509	81853509	harbor2	chr6	81669473	81669578	LTR/ERVL	723	+	52	81669525	16016
chr6	81653509	81853509	harbor2	chr6	81689812	81690409	LTR/ERVL	1297	+	298	81690110	36601
chr6	81653509	81853509	harbor2	chr6	81691927	81691997	LTR/ERVL	531	+	35	81691962	38453
chr6	81653509	81853509	harbor2	chr6	81692293	81692770	LTR/ERVL	531	+	238	81692531	39022
chr6	81653509	81853509	harbor2	chr6	81735846	81736343	LTR/ERVL	1405	+	248	81736094	82585
chr6	147108187	147308187	harbor2	chr6	147165420	147165865	LTR/ERVL	1974	+	222	147165642	57455
chr6	36343651	36543651	harbor2	chr6	36344458	36344674	LTR/ERVL	1622	+	108	36344566	915
chr6	36343651	36543651	harbor2	chr6	36350571	36350770	LTR/ERVL	523	+	100	36350671	7020
chr6	109952856	110152856	harbor2	chr6	109983098	109983169	LTR/ERVL	461	+	36	109983134	30278
chr6	109952856	110152856	harbor2	chr6	109983170	109983425	LTR/ERVL	582	+	128	109983298	30442
chr6	109952856	110152856	harbor2	chr6	110021443	110021613	LTR/ERVL	1163	+	85	110021528	68672
chr6	109952856	110152856	harbor2	chr6	110031161	110031404	LTR/ERVL	1162	+	122	110031283	78427
chr6	109952856	110152856	harbor2	chr6	110047954	110048340	LTR/ERVL	2909	+	193	110048147	95291
chr6	109952856	110152856	harbor2	chr6	110048457	110048656	LTR/ERVL	570	+	100	110048557	95701
chr6	109952856	110152856	harbor2	chr6	110050005	110050366	LTR/ERVL	681	+	180	110050185	97329
chr6	109952856	110152856	harbor2	chr6	110050391	110050560	LTR/ERVL	584	+	84	110050475	97619
chr6	109952856	110152856	harbor2	chr6	110051334	110051747	LTR/ERVL	1740	+	206	110051540	98684
chr6	109952856	110152856	harbor2	chr6	110051795	110051875	LTR/ERVL	1740	+	40	110051835	98979
chr6	88863719	89063719	harbor2	chr6	88897639	88898157	LTR/ERVL	2227	+	259	88897898	34179
chr6	88863719	89063719	harbor2	chr6	88916773	88917192	LTR/ERVL	2316	+	210	88916983	53264
chr6	88863719	89063719	harbor2	chr6	88960929	88961416	LTR/ERVL	3021	+	244	88961173	97454
chr6	52185236	52385236	harbor2	chr6	52194886	52194941	LTR/ERVL	2515	+	28	52194914	9678
chr6	52185236	52385236	harbor2	chr6	52195310	52195486	LTR/ERVL	2515	+	88	52195398	10162
chr6	52185236	52385236	harbor2	chr6	52195532	52195793	LTR/ERVL	2515	+	130	52195662	10426
chr6	52185236	52385236	harbor2	chr6	52237730	52238129	LTR/ERVL	2375	+	200	52237930	52694
chr6	100675847	100875847	harbor2	chr6	100695719	100695987	LTR/ERVL	915	+	134	100695853	20006
chr6	100675847	100875847	harbor2	chr6	100721105	100721666	LTR/ERVL	1339	+	280	100721385	45538
chr6	100675847	100875847	harbor2	chr6	100744874	100745011	LTR/ERVL	468	+	68	100744942	69095
chr6	169863936	170063936	harbor2	chr6	169953458	169954304	LTR/ERVL	3116	+	423	169953881	89945
chr6	169863936	170063936	harbor2	chr6	169954339	169954998	LTR/ERVL	3405	+	330	169954669	90733
chr6	29088020	29288020	harbor2	chr6	29146218	29146734	LTR/ERVL	907	+	258	29146476	58456
chr6	42879393	43079393	harbor2	chr6	42904089	42904398	LTR/ERVL	1403	+	154	42904243	24850
chr6	42879393	43079393	harbor2	chr6	42905005	42905447	LTR/ERVL	1403	+	221	42905226	25833
chr6	42879393	43079393	harbor2	chr6	42907134	42907383	LTR/ERVL	537	+	124	42907258	27865
chr6	42879393	43079393	harbor2	chr6	42907426	42908133	LTR/ERVL	1344	+	354	42907780	28387
chr6	42879393	43079393	harbor2	chr6	42908163	42908768	LTR/ERVL	2137	+	302	42908465	29072
chr6	147106075	147306075	harbor2	chr6	147165420	147165865	LTR/ERVL	1974	+	222	147165642	59567
chr6	106179953	106379953	harbor2	chr6	106241539	106241982	LTR/ERVL	1286	+	222	106241761	61808
chr6	106179953	106379953	harbor2	chr6	106251180	106251484	LTR/ERVL	848	+	152	106251332	71379
chr6	8009439	8209439	harbor2	chr6	8042354	8042523	LTR/ERVL	2433	+	84	8042438	32999
chr6	8009439	8209439	harbor2	chr6	8042753	8043158	LTR/ERVL	2433	+	202	8042955	33516
chr6	8009439	8209439	harbor2	chr6	8065086	8065636	LTR/ERVL	1012	+	275	8065361	55922
chr6	8009439	8209439	harbor2	chr6	8106932	8107282	LTR/ERVL	2088	+	175	8107107	97668
chr6	8009439	8209439	harbor2	chr6	8107642	8107754	LTR/ERVL	2088	+	56	8107698	98259
chr6	105468439	105668439	harbor2	chr6	105540416	105540465	LTR/ERVL	2608	+	24	105540440	72001
chr6	105468439	105668439	harbor2	chr6	105540776	105541275	LTR/ERVL	2608	+	250	105541026	72587
chr6	105468439	105668439	harbor2	chr6	105541276	105541727	LTR/ERVL	1384	+	226	105541502	73063
chr6	52477046	52677046	harbor2	chr6	52492547	52492624	LTR/ERVL	2418	+	38	52492585	15539
chr6	52477046	52677046	harbor2	chr6	52492917	52493390	LTR/ERVL	2418	+	236	52493153	16107
chr6	52477046	52677046	harbor2	chr6	52550144	52550455	LTR/ERVL	586	+	156	52550300	73254
chr6	139275446	139475446	harbor2	chr6	139285693	139285793	LTR/ERVL	726	+	50	139285743	10297
chr6	139275446	139475446	harbor2	chr6	139287058	139287389	LTR/ERVL	2163	+	166	139287224	11778
chr6	30369767	30569767	harbor2	chr6	30402231	30402587	LTR/ERVL	1427	+	178	30402409	32642
chr6	30369767	30569767	harbor2	chr6	30402943	30403264	LTR/ERVL	4799	+	160	30403103	33336
chr6	30369767	30569767	harbor2	chr6	30404040	30404937	LTR/ERVL	4799	+	448	30404488	34721
chr6	127174273	127374273	harbor2	chr6	127223432	127223897	LTR/ERVL	966	+	232	127223664	49391
chr6	127174273	127374273	harbor2	chr6	127239428	127239578	LTR/ERVL	846	+	75	127239503	65230
chr6	127174273	127374273	harbor2	chr6	127249110	127249446	LTR/ERVL	665	+	168	127249278	75005
chr6	127174273	127374273	harbor2	chr6	127249471	127249637	LTR/ERVL	747	+	83	127249554	75281
chr6	139275443	139475443	harbor2	chr6	139285693	139285793	LTR/ERVL	726	+	50	139285743	10300
chr6	139275443	139475443	harbor2	chr6	139287058	139287389	LTR/ERVL	2163	+	166	139287224	11781
chr6	127169913	127369913	harbor2	chr6	127223432	127223897	LTR/ERVL	966	+	232	127223664	53751
chr6	127169913	127369913	harbor2	chr6	127239428	127239578	LTR/ERVL	846	+	75	127239503	69590
chr6	127169913	127369913	harbor2	chr6	127249110	127249446	LTR/ERVL	665	+	168	127249278	79365
chr6	127169913	127369913	harbor2	chr6	127249471	127249637	LTR/ERVL	747	+	83	127249554	79641
chr6	33522645	33722645	harbor2	chr6	33523993	33524415	LTR/ERVL	2402	+	211	33524204	1559
chr6	33522645	33722645	harbor2	chr6	33525211	33525377	LTR/ERVL	959	+	83	33525294	2649
chr6	33522645	33722645	harbor2	chr6	33526177	33526412	LTR/ERVL	994	+	118	33526295	3650
chr6	33522645	33722645	harbor2	chr6	33602003	33602233	LTR/ERVL	559	+	115	33602118	79473
chr6	33522645	33722645	harbor2	chr6	33611986	33612362	LTR/ERVL	1333	+	188	33612174	89529
chr6	33522645	33722645	harbor2	chr6	33612658	33612729	LTR/ERVL	1333	+	36	33612694	90049
chr6	139275379	139475379	harbor2	chr6	139285693	139285793	LTR/ERVL	726	+	50	139285743	10364
chr6	139275379	139475379	harbor2	chr6	139287058	139287389	LTR/ERVL	2163	+	166	139287224	11845
chr6	155200738	155400738	harbor2	chr6	155280229	155280628	LTR/ERVL	735	+	200	155280429	79691
chr6	155200738	155400738	harbor2	chr6	155291009	155291336	LTR/ERVL	1462	+	164	155291173	90435
chr6	139275438	139475438	harbor2	chr6	139285693	139285793	LTR/ERVL	726	+	50	139285743	10305
chr6	139275438	139475438	harbor2	chr6	139287058	139287389	LTR/ERVL	2163	+	166	139287224	11786
chr6	79848077	80048077	harbor2	chr6	79859626	79860016	LTR/ERVL	2128	+	195	79859821	11744
chr6	79848077	80048077	harbor2	chr6	79864474	79865032	LTR/ERVL	1773	+	279	79864753	16676
chr6	79848077	80048077	harbor2	chr6	79902620	79903103	LTR/ERVL	722	+	242	79902862	54785
chr6	165561195	165761195	harbor2	chr6	165583523	165584083	LTR/ERVL	2974	+	280	165583803	22608
chr6	165561195	165761195	harbor2	chr6	165584093	165584655	LTR/ERVL	1022	+	281	165584374	23179
chr6	165561195	165761195	harbor2	chr6	165584662	165585303	LTR/ERVL	2663	+	320	165584982	23787
chr6	165561195	165761195	harbor2	chr6	165585304	165585503	LTR/ERVL	625	+	100	165585404	24209
chr6	165561195	165761195	harbor2	chr6	165621869	165622203	LTR/ERVL	1766	+	167	165622036	60841
chr6	165561195	165761195	harbor2	chr6	165645004	165645188	LTR/ERVL	504	+	92	165645096	83901
chr6	150800551	151000551	harbor2	chr6	150857630	150858046	LTR/ERVL	2938	+	208	150857838	57287
chr6	41174459	41374459	harbor2	chr6	41193257	41193599	LTR/ERVL	714	+	171	41193428	18969
chr6	41174459	41374459	harbor2	chr6	41254417	41254864	LTR/ERVL	2007	+	224	41254641	80182
chr6	139493790	139693790	harbor2	chr6	139497021	139497518	LTR/ERVL	1332	+	248	139497269	3479
chr6	139493790	139693790	harbor2	chr6	139506456	139506713	LTR/ERVL	789	+	128	139506584	12794
chr6	45542589	45742589	harbor2	chr6	45621072	45621915	LTR/ERVL	4750	+	422	45621494	78905
chr6	139434279	139634279	harbor2	chr6	139437722	139438129	LTR/ERVL	1238	+	204	139437926	3647
chr6	139434279	139634279	harbor2	chr6	139438439	139438668	LTR/ERVL	1238	+	114	139438553	4274
chr6	139434279	139634279	harbor2	chr6	139486184	139486518	LTR/ERVL	685	+	167	139486351	52072
chr6	139434279	139634279	harbor2	chr6	139497021	139497518	LTR/ERVL	1332	+	248	139497269	62990
chr6	139434279	139634279	harbor2	chr6	139506456	139506713	LTR/ERVL	789	+	128	139506584	72305
chr6	46592267	46792267	harbor2	chr6	46599980	46600085	LTR/ERVL	618	+	52	46600032	7765
chr6	46592267	46792267	harbor2	chr6	46600452	46601167	LTR/ERVL	3037	+	358	46600810	8543
chr6	46592267	46792267	harbor2	chr6	46618792	46619130	LTR/ERVL	990	+	169	46618961	26694
chr6	46592267	46792267	harbor2	chr6	46623152	46623697	LTR/ERVL	944	+	272	46623424	31157
chr6	43393418	43593418	harbor2	chr6	43393685	43393797	LTR/ERVL	580	+	56	43393741	323
chr6	43393418	43593418	harbor2	chr6	43393796	43393919	LTR/ERVL	627	+	62	43393858	440
chr6	146816562	147016562	harbor2	chr6	146854796	146855346	LTR/ERVL	2060	+	275	146855071	38509
chr6	45542590	45742590	harbor2	chr6	45621072	45621915	LTR/ERVL	4750	+	422	45621494	78904
chr6	166512532	166712532	harbor2	chr6	166519863	166520568	LTR/ERVL	1870	+	352	166520215	7683
chr6	166512532	166712532	harbor2	chr6	166530155	166530651	LTR/ERVL	2053	+	248	166530403	17871
chr6	166512532	166712532	harbor2	chr6	166596246	166596804	LTR/ERVL	1986	+	279	166596525	83993
chr6	166512532	166712532	harbor2	chr6	166602944	166603377	LTR/ERVL	680	+	216	166603160	90628
chr6	44034328	44234328	harbor2	chr6	44052538	44052761	LTR/ERVL	1324	+	112	44052650	18322
chr6	44034328	44234328	harbor2	chr6	44052799	44053147	LTR/ERVL	1324	+	174	44052973	18645
chr6	7907023	8107023	harbor2	chr6	7960907	7961151	LTR/ERVL	3246	+	122	7961029	54006
chr6	7907023	8107023	harbor2	chr6	7961464	7961818	LTR/ERVL	3246	+	177	7961641	54618
chr6	7907023	8107023	harbor2	chr6	7962134	7962207	LTR/ERVL	3246	+	36	7962170	55147
chr6	7907023	8107023	harbor2	chr6	7970074	7970567	LTR/ERVL	1669	+	246	7970320	63297
chr6	148245637	148445637	harbor2	chr6	148282050	148282382	LTR/ERVL	784	+	166	148282216	36579
chr6	148245637	148445637	harbor2	chr6	148282680	148282748	LTR/ERVL	784	+	34	148282714	37077
chr6	127216519	127416519	harbor2	chr6	127223432	127223897	LTR/ERVL	966	+	232	127223664	7145
chr6	127216519	127416519	harbor2	chr6	127239428	127239578	LTR/ERVL	846	+	75	127239503	22984
chr6	127216519	127416519	harbor2	chr6	127249110	127249446	LTR/ERVL	665	+	168	127249278	32759
chr6	127216519	127416519	harbor2	chr6	127249471	127249637	LTR/ERVL	747	+	83	127249554	33035
chr6	52300000	52500000	harbor2	chr6	52320403	52320601	LTR/ERVL	515	+	99	52320502	20502
chr6	52300000	52500000	harbor2	chr6	52320905	52320981	LTR/ERVL	515	+	38	52320943	20943
chr6	52300000	52500000	harbor2	chr6	52331738	52331882	LTR/ERVL	677	+	72	52331810	31810
chr6	52300000	52500000	harbor2	chr6	52331999	52332195	LTR/ERVL	708	+	98	52332097	32097
chr6	7875319	8075319	harbor2	chr6	7960907	7961151	LTR/ERVL	3246	+	122	7961029	85710
chr6	7875319	8075319	harbor2	chr6	7961464	7961818	LTR/ERVL	3246	+	177	7961641	86322
chr6	7875319	8075319	harbor2	chr6	7962134	7962207	LTR/ERVL	3246	+	36	7962170	86851
chr6	7875319	8075319	harbor2	chr6	7970074	7970567	LTR/ERVL	1669	+	246	7970320	95001
chr6	169863958	170063958	harbor2	chr6	169953458	169954304	LTR/ERVL	3116	+	423	169953881	89923
chr6	169863958	170063958	harbor2	chr6	169954339	169954998	LTR/ERVL	3405	+	330	169954669	90711
chr6	166856299	167056299	harbor2	chr6	166868614	166869023	LTR/ERVL	2917	+	204	166868818	12519
chr6	166856299	167056299	harbor2	chr6	166869194	166869248	LTR/ERVL	462	+	27	166869221	12922
chr6	166856299	167056299	harbor2	chr6	166883969	166884659	LTR/ERVL	1987	+	345	166884314	28015
chr6	325158	525158	harbor2	chr6	384318	384716	LTR/ERVL	604	+	199	384517	59359
chr6	325158	525158	harbor2	chr6	385554	385945	LTR/ERVL	898	+	196	385750	60592
chr6	56921793	57121793	harbor2	chr6	56979835	56980170	LTR/ERVL	1930	+	168	56980003	58210
chr6	56921793	57121793	harbor2	chr6	56980481	56980590	LTR/ERVL	1930	+	54	56980535	58742
chr6	151352799	151552799	harbor2	chr6	151441268	151442109	LTR/ERVL	3325	+	420	151441688	88889
chr6	105895040	106095040	harbor2	chr6	105907961	105908290	LTR/ERVL	951	+	164	105908125	13085
chr6	105895040	106095040	harbor2	chr6	105929865	105930205	LTR/ERVL	746	+	170	105930035	34995
chr6	105895040	106095040	harbor2	chr6	105964240	105964760	LTR/ERVL	1303	+	260	105964500	69460
chr6	105895040	106095040	harbor2	chr6	105972930	105973372	LTR/ERVL	1868	+	221	105973151	78111
chr6	127167589	127367589	harbor2	chr6	127223432	127223897	LTR/ERVL	966	+	232	127223664	56075
chr6	127167589	127367589	harbor2	chr6	127239428	127239578	LTR/ERVL	846	+	75	127239503	71914
chr6	127167589	127367589	harbor2	chr6	127249110	127249446	LTR/ERVL	665	+	168	127249278	81689
chr6	127167589	127367589	harbor2	chr6	127249471	127249637	LTR/ERVL	747	+	83	127249554	81965
chr6	45541581	45741581	harbor2	chr6	45621072	45621915	LTR/ERVL	4750	+	422	45621494	79913
chr6	99249452	99449452	harbor2	chr6	99295369	99295695	LTR/ERVL	1355	+	163	99295532	46080
chr6	75250277	75450277	harbor2	chr6	75268212	75268937	LTR/ERVL	1276	+	362	75268574	18297
chr6	75250277	75450277	harbor2	chr6	75275755	75276623	LTR/ERVL	4125	+	434	75276189	25912
chr6	75250277	75450277	harbor2	chr6	75291326	75291744	LTR/ERVL	666	+	209	75291535	41258
chr6	27416505	27616505	harbor2	chr6	27435701	27435944	LTR/ERVL	647	+	122	27435823	19318
chr6	27416505	27616505	harbor2	chr6	27461123	27461449	LTR/ERVL	503	+	163	27461286	44781
chr6	27416505	27616505	harbor2	chr6	27491903	27492166	LTR/ERVL	1697	+	132	27492035	75530
chr6	27416505	27616505	harbor2	chr6	27492790	27493135	LTR/ERVL	1327	+	172	27492962	76457
chr6	27416505	27616505	harbor2	chr6	27493205	27493436	LTR/ERVL	593	+	116	27493321	76816
chr6	27416505	27616505	harbor2	chr6	27498116	27498540	LTR/ERVL	1414	+	212	27498328	81823
chr6	27416505	27616505	harbor2	chr6	27492316	27492531	LTR/ERVL	550	+	108	27492424	75919
chr6	107857740	108057740	harbor2	chr6	107866061	107866496	LTR/ERVL	1310	+	218	107866279	8539
chr6	35356242	35556242	harbor2	chr6	35432314	35432726	LTR/ERVL	1221	+	206	35432520	76278
chr6	71233331	71433331	harbor2	chr6	71259846	71260182	LTR/ERVL	1165	+	168	71260014	26683
chr6	13613032	13813032	harbor2	chr6	13678416	13678795	LTR/ERVL	1320	+	190	13678606	65574
chr6	52571777	52771777	harbor2	chr6	52651037	52651454	LTR/ERVL	1920	+	208	52651245	79468
chr6	128006768	128206768	harbor2	chr6	128057263	128057814	LTR/ERVL	2728	+	276	128057539	50771
chr6	139275401	139475401	harbor2	chr6	139285693	139285793	LTR/ERVL	726	+	50	139285743	10342
chr6	139275401	139475401	harbor2	chr6	139287058	139287389	LTR/ERVL	2163	+	166	139287224	11823
chr6	139275439	139475439	harbor2	chr6	139285693	139285793	LTR/ERVL	726	+	50	139285743	10304
chr6	139275439	139475439	harbor2	chr6	139287058	139287389	LTR/ERVL	2163	+	166	139287224	11785
chr6	41092580	41292580	harbor2	chr6	41155189	41155303	LTR/ERVL	547	+	57	41155246	62666
chr6	41092580	41292580	harbor2	chr6	41155333	41155375	LTR/ERVL	814	+	21	41155354	62774
chr6	41092580	41292580	harbor2	chr6	41155407	41155576	LTR/ERVL	814	+	84	41155491	62911
chr6	41092580	41292580	harbor2	chr6	41170742	41171195	LTR/ERVL	992	+	226	41170968	78388
chr6	32875092	33075092	harbor2	chr6	32883858	32884205	LTR/ERVL	676	+	174	32884032	8940
chr6	32875092	33075092	harbor2	chr6	32931225	32931649	LTR/ERVL	576	+	212	32931437	56345
chr6	32875092	33075092	harbor2	chr6	32939107	32939521	LTR/ERVL	1468	+	207	32939314	64222
chr6	32875092	33075092	harbor2	chr6	32939748	32940128	LTR/ERVL	1376	+	190	32939938	64846
chr6	159071496	159271496	harbor2	chr6	159148521	159149037	LTR/ERVL	3181	+	258	159148779	77283
chr6	73362326	73562326	harbor2	chr6	73421611	73422177	LTR/ERVL	2126	+	283	73421894	59568
chr6	63473882	63673882	harbor2	chr6	63525227	63525875	LTR/ERVL	1564	+	324	63525551	51669
chr6	146813024	147013024	harbor2	chr6	146854796	146855346	LTR/ERVL	2060	+	275	146855071	42047
chr6	145745469	145945469	harbor2	chr6	145750401	145750948	LTR/ERVL	2151	+	274	145750675	5206
chr6	145745469	145945469	harbor2	chr6	145753977	145754387	LTR/ERVL	1025	+	205	145754182	8713
chr6	145745469	145945469	harbor2	chr6	145754869	145755273	LTR/ERVL	544	+	202	145755071	9602
chr6	145745469	145945469	harbor2	chr6	145755756	145756014	LTR/ERVL	670	+	129	145755885	10416
chr6	145745469	145945469	harbor2	chr6	145756036	145756579	LTR/ERVL	1270	+	272	145756308	10839
chr6	145745469	145945469	harbor2	chr6	145756586	145756793	LTR/ERVL	588	+	104	145756690	11221
chr6	145745469	145945469	harbor2	chr6	145757110	145757149	LTR/ERVL	588	+	20	145757130	11661
chr6	145745469	145945469	harbor2	chr6	145787342	145788474	LTR/ERVL	6917	+	566	145787908	42439
chr6	145745469	145945469	harbor2	chr6	145788543	145789228	LTR/ERVL	3211	+	342	145788885	43416
chr6	145745469	145945469	harbor2	chr6	145839678	145840054	LTR/ERVL	2279	+	188	145839866	94397
chr6	145745469	145945469	harbor2	chr6	145784612	145785981	LTR/ERVL	8020	+	684	145785296	39827
chr6	27416592	27616592	harbor2	chr6	27435701	27435944	LTR/ERVL	647	+	122	27435823	19231
chr6	27416592	27616592	harbor2	chr6	27461123	27461449	LTR/ERVL	503	+	163	27461286	44694
chr6	27416592	27616592	harbor2	chr6	27491903	27492166	LTR/ERVL	1697	+	132	27492035	75443
chr6	27416592	27616592	harbor2	chr6	27492790	27493135	LTR/ERVL	1327	+	172	27492962	76370
chr6	27416592	27616592	harbor2	chr6	27493205	27493436	LTR/ERVL	593	+	116	27493321	76729
chr6	27416592	27616592	harbor2	chr6	27498116	27498540	LTR/ERVL	1414	+	212	27498328	81736
chr6	27416592	27616592	harbor2	chr6	27492316	27492531	LTR/ERVL	550	+	108	27492424	75832
chr6	32753450	32953450	harbor2	chr6	32811165	32811646	LTR/ERVL	3139	+	240	32811405	57955
chr6	32753450	32953450	harbor2	chr6	32816470	32816595	LTR/ERVL	625	+	62	32816532	63082
chr6	159410489	159610489	harbor2	chr6	159411197	159411812	LTR/ERVL	978	+	308	159411505	1016
chr6	159410489	159610489	harbor2	chr6	159425130	159425574	LTR/ERVL	1244	+	222	159425352	14863
chr6	159410489	159610489	harbor2	chr6	159435514	159436011	LTR/ERVL	2166	+	248	159435762	25273
chr6	159410489	159610489	harbor2	chr6	159466935	159467216	LTR/ERVL	1173	+	140	159467075	56586
chr6	32053002	32253002	harbor2	chr6	32123744	32123888	LTR/ERVL	543	+	72	32123816	70814
chr6	169864558	170064558	harbor2	chr6	169953458	169954304	LTR/ERVL	3116	+	423	169953881	89323
chr6	169864558	170064558	harbor2	chr6	169954339	169954998	LTR/ERVL	3405	+	330	169954669	90111
chr6	52185444	52385444	harbor2	chr6	52194886	52194941	LTR/ERVL	2515	+	28	52194914	9470
chr6	52185444	52385444	harbor2	chr6	52195310	52195486	LTR/ERVL	2515	+	88	52195398	9954
chr6	52185444	52385444	harbor2	chr6	52195532	52195793	LTR/ERVL	2515	+	130	52195662	10218
chr6	52185444	52385444	harbor2	chr6	52237730	52238129	LTR/ERVL	2375	+	200	52237930	52486
chr7	50206270	50406270	harbor2	chr7	50290068	50290313	LTR/ERVL	1021	+	122	50290190	83920
chr7	130568331	130768331	harbor2	chr7	130661259	130661508	LTR/ERVL	494	+	124	130661383	93052
chr7	130568331	130768331	harbor2	chr7	130661514	130662373	LTR/ERVL	3697	+	430	130661944	93613
chr7	130568331	130768331	harbor2	chr7	130662374	130662736	LTR/ERVL	968	+	181	130662555	94224
chr7	28540595	28740595	harbor2	chr7	28556657	28557160	LTR/ERVL	891	+	252	28556909	16314
chr7	1252797	1452797	harbor2	chr7	1278687	1278802	LTR/ERVL	458	+	58	1278745	25948
chr7	1252797	1452797	harbor2	chr7	1310453	1310474	LTR/ERVL	730	+	10	1310463	57666
chr7	1252797	1452797	harbor2	chr7	1310764	1311288	LTR/ERVL	730	+	262	1311026	58229
chr7	39733301	39933301	harbor2	chr7	39780788	39780872	LTR/ERVL	429	+	42	39780830	47529
chr7	39733301	39933301	harbor2	chr7	39781175	39781212	LTR/ERVL	429	+	18	39781193	47892
chr7	39733301	39933301	harbor2	chr7	39781500	39781562	LTR/ERVL	429	+	31	39781531	48230
chr7	39733301	39933301	harbor2	chr7	39790896	39791048	LTR/ERVL	741	+	76	39790972	57671
chr7	39733301	39933301	harbor2	chr7	39825736	39825771	LTR/ERVL	2737	+	18	39825754	92453
chr7	39733301	39933301	harbor2	chr7	39826205	39826949	LTR/ERVL	2737	+	372	39826577	93276
chr7	128310411	128510411	harbor2	chr7	128386407	128386928	LTR/ERVL	2235	+	260	128386667	76256
chr7	149614656	149814656	harbor2	chr7	149645564	149645586	LTR/ERVL	2209	+	11	149645575	30919
chr7	149614656	149814656	harbor2	chr7	149645881	149646225	LTR/ERVL	2209	+	172	149646053	31397
chr7	149614656	149814656	harbor2	chr7	149646258	149646306	LTR/ERVL	2209	+	24	149646282	31626
chr7	110297759	110497759	harbor2	chr7	110313712	110314192	LTR/ERVL	2258	+	240	110313952	16193
chr7	110297759	110497759	harbor2	chr7	110338513	110338770	LTR/ERVL	809	+	128	110338641	40882
chr7	110297759	110497759	harbor2	chr7	110338810	110338845	LTR/ERVL	809	+	18	110338828	41069
chr7	110297759	110497759	harbor2	chr7	110377622	110377942	LTR/ERVL	1279	+	160	110377782	80023
chr7	140915057	141115057	harbor2	chr7	140937326	140937728	LTR/ERVL	1663	+	201	140937527	22470
chr7	140915057	141115057	harbor2	chr7	140938085	140938433	LTR/ERVL	1663	+	174	140938259	23202
chr7	140915057	141115057	harbor2	chr7	140938727	140938764	LTR/ERVL	1663	+	18	140938745	23688
chr7	140915057	141115057	harbor2	chr7	140938765	140939220	LTR/ERVL	2583	+	228	140938993	23936
chr7	140915057	141115057	harbor2	chr7	140939301	140939883	LTR/ERVL	12709	+	291	140939592	24535
chr7	140915057	141115057	harbor2	chr7	140940241	140941829	LTR/ERVL	12709	+	794	140941035	25978
chr7	140915057	141115057	harbor2	chr7	140941830	140941905	LTR/ERVL	410	+	38	140941868	26811
chr7	140915057	141115057	harbor2	chr7	140941906	140942076	LTR/ERVL	662	+	85	140941991	26934
chr7	50206568	50406568	harbor2	chr7	50290068	50290313	LTR/ERVL	1021	+	122	50290190	83622
chr7	44969996	45169996	harbor2	chr7	44981640	44981896	LTR/ERVL	787	+	128	44981768	11772
chr7	62197525	62397525	harbor2	chr7	62287652	62287975	LTR/ERVL	1136	+	162	62287814	90289
chr7	47569714	47769714	harbor2	chr7	47585495	47585898	LTR/ERVL	2387	+	202	47585697	15983
chr7	47569714	47769714	harbor2	chr7	47586199	47586279	LTR/ERVL	2387	+	40	47586239	16525
chr7	156586157	156786157	harbor2	chr7	156613046	156613580	LTR/ERVL	1483	+	267	156613313	27156
chr7	156586157	156786157	harbor2	chr7	156662395	156662527	LTR/ERVL	840	+	66	156662461	76304
chr7	156586157	156786157	harbor2	chr7	156684272	156684626	LTR/ERVL	408	+	177	156684449	98292
chr7	47250554	47450554	harbor2	chr7	47255484	47256356	LTR/ERVL	4698	+	436	47255920	5366
chr7	50265125	50465125	harbor2	chr7	50290068	50290313	LTR/ERVL	1021	+	122	50290190	25065
chr7	28180867	28380867	harbor2	chr7	28223509	28224323	LTR/ERVL	2294	+	407	28223916	43049
chr7	28180867	28380867	harbor2	chr7	28252945	28253336	LTR/ERVL	1437	+	196	28253141	72274
chr7	47228593	47428593	harbor2	chr7	47255484	47256356	LTR/ERVL	4698	+	436	47255920	27327
chr7	123650345	123850345	harbor2	chr7	123697669	123698225	LTR/ERVL	2687	+	278	123697947	47602
chr7	28372783	28572783	harbor2	chr7	28447934	28448365	LTR/ERVL	3607	+	216	28448150	75367
chr7	155252074	155452074	harbor2	chr7	155266577	155267033	LTR/ERVL	853	+	228	155266805	14731
chr7	155252074	155452074	harbor2	chr7	155286322	155286768	LTR/ERVL	3554	+	223	155286545	34471
chr7	155252074	155452074	harbor2	chr7	155336301	155336709	LTR/ERVL	1315	+	204	155336505	84431
chr7	156338633	156538633	harbor2	chr7	156432572	156432725	LTR/ERVL	738	+	76	156432648	94015
chr7	113020567	113220567	harbor2	chr7	113045691	113045935	LTR/ERVL	993	+	122	113045813	25246
chr7	157885917	158085917	harbor2	chr7	157952557	157952764	LTR/ERVL	891	+	104	157952661	66744
chr7	123649503	123849503	harbor2	chr7	123697669	123698225	LTR/ERVL	2687	+	278	123697947	48444
chr7	44696599	44896599	harbor2	chr7	44725307	44725387	LTR/ERVL	2137	+	40	44725347	28748
chr7	44696599	44896599	harbor2	chr7	44725656	44725673	LTR/ERVL	2137	+	8	44725664	29065
chr7	44696599	44896599	harbor2	chr7	44725950	44726265	LTR/ERVL	2137	+	158	44726108	29509
chr7	44696599	44896599	harbor2	chr7	44726864	44726896	LTR/ERVL	2137	+	16	44726880	30281
chr7	44696599	44896599	harbor2	chr7	44727195	44727384	LTR/ERVL	2137	+	94	44727289	30690
chr7	44696599	44896599	harbor2	chr7	44743827	44744194	LTR/ERVL	1958	+	184	44744011	47412
chr7	123649133	123849133	harbor2	chr7	123697669	123698225	LTR/ERVL	2687	+	278	123697947	48814
chr7	155249504	155449504	harbor2	chr7	155266577	155267033	LTR/ERVL	853	+	228	155266805	17301
chr7	155249504	155449504	harbor2	chr7	155286322	155286768	LTR/ERVL	3554	+	223	155286545	37041
chr7	155249504	155449504	harbor2	chr7	155336301	155336709	LTR/ERVL	1315	+	204	155336505	87001
chr7	50212359	50412359	harbor2	chr7	50290068	50290313	LTR/ERVL	1021	+	122	50290190	77831
chr7	47228840	47428840	harbor2	chr7	47255484	47256356	LTR/ERVL	4698	+	436	47255920	27080
chr7	80035782	80235782	harbor2	chr7	80079684	80079910	LTR/ERVL	806	+	113	80079797	44015
chr7	80035782	80235782	harbor2	chr7	80128947	80129419	LTR/ERVL	1602	+	236	80129183	93401
chr7	80035782	80235782	harbor2	chr7	80117365	80117896	LTR/ERVL	2425	+	266	80117631	81849
chr7	117804099	118004099	harbor2	chr7	117832587	117832737	LTR/ERVL	1715	+	75	117832662	28563
chr7	117804099	118004099	harbor2	chr7	117833055	117833449	LTR/ERVL	1708	+	197	117833252	29153
chr7	47237791	47437791	harbor2	chr7	47255484	47256356	LTR/ERVL	4698	+	436	47255920	18129
chr7	127247874	127447874	harbor2	chr7	127308578	127308708	LTR/ERVL	421	+	65	127308643	60769
chr7	35945695	36145695	harbor2	chr7	36035161	36035536	LTR/ERVL	875	+	188	36035349	89654
chr7	47228278	47428278	harbor2	chr7	47255484	47256356	LTR/ERVL	4698	+	436	47255920	27642
chr7	123652099	123852099	harbor2	chr7	123697669	123698225	LTR/ERVL	2687	+	278	123697947	45848
chr7	151659928	151859928	harbor2	chr7	151666914	151667336	LTR/ERVL	2027	+	211	151667125	7197
chr7	151659928	151859928	harbor2	chr7	151668471	151668877	LTR/ERVL	1103	+	203	151668674	8746
chr7	151659928	151859928	harbor2	chr7	151698311	151698371	LTR/ERVL	433	+	30	151698341	38413
chr7	151659928	151859928	harbor2	chr7	151698770	151698837	LTR/ERVL	433	+	34	151698804	38876
chr7	151659928	151859928	harbor2	chr7	151723898	151724310	LTR/ERVL	2360	+	206	151724104	64176
chr7	151659928	151859928	harbor2	chr7	151740122	151740559	LTR/ERVL	771	+	218	151740340	80412
chr7	151659928	151859928	harbor2	chr7	151756590	151756901	LTR/ERVL	504	+	156	151756746	96818
chr7	123649299	123849299	harbor2	chr7	123697669	123698225	LTR/ERVL	2687	+	278	123697947	48648
chr7	102333445	102533445	harbor2	chr7	102344059	102344281	LTR/ERVL	657	+	111	102344170	10725
chr7	144955897	145155897	harbor2	chr7	144975742	144976432	LTR/ERVL	1720	+	345	144976087	20190
chr7	144955897	145155897	harbor2	chr7	144976425	144977674	LTR/ERVL	3508	+	624	144977049	21152
chr7	28180872	28380872	harbor2	chr7	28223509	28224323	LTR/ERVL	2294	+	407	28223916	43044
chr7	28180872	28380872	harbor2	chr7	28252945	28253336	LTR/ERVL	1437	+	196	28253141	72269
chr7	66457694	66657694	harbor2	chr7	66463289	66463362	LTR/ERVL	1081	+	36	66463325	5631
chr7	66457694	66657694	harbor2	chr7	66463658	66463833	LTR/ERVL	1081	+	88	66463746	6052
chr7	66457694	66657694	harbor2	chr7	66463841	66464364	LTR/ERVL	2739	+	262	66464103	6409
chr7	66457694	66657694	harbor2	chr7	66465305	66465576	LTR/ERVL	1228	+	136	66465441	7747
chr7	66457694	66657694	harbor2	chr7	66465970	66466277	LTR/ERVL	1228	+	154	66466124	8430
chr7	155581114	155781114	harbor2	chr7	155653367	155653639	LTR/ERVL	768	+	136	155653503	72389
chr7	155581114	155781114	harbor2	chr7	155653634	155653993	LTR/ERVL	1136	+	180	155653814	72700
chr7	25329225	25529225	harbor2	chr7	25365362	25365630	LTR/ERVL	693	+	134	25365496	36271
chr7	25329225	25529225	harbor2	chr7	25365645	25365843	LTR/ERVL	643	+	99	25365744	36519
chr7	25329225	25529225	harbor2	chr7	25377904	25378133	LTR/ERVL	940	+	114	25378018	48793
chr7	25329225	25529225	harbor2	chr7	25378202	25378319	LTR/ERVL	940	+	58	25378260	49035
chr7	33803527	34003527	harbor2	chr7	33871737	33872114	LTR/ERVL	631	+	188	33871925	68398
chr7	33803527	34003527	harbor2	chr7	33872321	33872749	LTR/ERVL	2182	+	214	33872535	69008
chr7	33803527	34003527	harbor2	chr7	33878214	33878349	LTR/ERVL	451	+	68	33878282	74755
chr7	33803527	34003527	harbor2	chr7	33878860	33879436	LTR/ERVL	1794	+	288	33879148	75621
chr7	33803527	34003527	harbor2	chr7	33880275	33880744	LTR/ERVL	1543	+	234	33880509	76982
chr7	122786808	122986808	harbor2	chr7	122806903	122807379	LTR/ERVL	1244	+	238	122807141	20333
chr7	122786808	122986808	harbor2	chr7	122807373	122807565	LTR/ERVL	882	+	96	122807469	20661
chr7	122786808	122986808	harbor2	chr7	122853099	122853386	LTR/ERVL	534	+	144	122853243	66435
chr7	122786808	122986808	harbor2	chr7	122853370	122853640	LTR/ERVL	798	+	135	122853505	66697
chr7	122786808	122986808	harbor2	chr7	122862246	122862645	LTR/ERVL	506	+	200	122862446	75638
chr7	52055428	52255428	harbor2	chr7	52071117	52071604	LTR/ERVL	1859	+	244	52071361	15933
chr7	52055428	52255428	harbor2	chr7	52074910	52075340	LTR/ERVL	1522	+	215	52075125	19697
chr7	52055428	52255428	harbor2	chr7	52109434	52109801	LTR/ERVL	839	+	184	52109618	54190
chr7	52055428	52255428	harbor2	chr7	52117928	52118048	LTR/ERVL	422	+	60	52117988	62560
chr7	52055428	52255428	harbor2	chr7	52135825	52136648	LTR/ERVL	3221	+	412	52136237	80809
chr7	52055428	52255428	harbor2	chr7	52143786	52144812	LTR/ERVL	5428	+	513	52144299	88871
chr7	52055428	52255428	harbor2	chr7	52144809	52145260	LTR/ERVL	2236	+	226	52145035	89607
chr7	52055428	52255428	harbor2	chr7	52145266	52145642	LTR/ERVL	1195	+	188	52145454	90026
chr7	47228307	47428307	harbor2	chr7	47255484	47256356	LTR/ERVL	4698	+	436	47255920	27613
chr7	1199588	1399588	harbor2	chr7	1278687	1278802	LTR/ERVL	458	+	58	1278745	79157
chr7	50204468	50404468	harbor2	chr7	50290068	50290313	LTR/ERVL	1021	+	122	50290190	85722
chr7	75462	275462	harbor2	chr7	118269	118940	LTR/ERVL	2342	+	336	118605	43143
chr7	75462	275462	harbor2	chr7	135243	135392	LTR/ERVL	616	+	74	135317	59855
chr7	75462	275462	harbor2	chr7	135490	135768	LTR/ERVL	826	+	139	135629	60167
chr7	108470639	108670639	harbor2	chr7	108538301	108538639	LTR/ERVL	2218	+	169	108538470	67831
chr7	108470639	108670639	harbor2	chr7	108538651	108538918	LTR/ERVL	8584	+	134	108538785	68146
chr7	108470639	108670639	harbor2	chr7	108538962	108539880	LTR/ERVL	8584	+	459	108539421	68782
chr7	108470639	108670639	harbor2	chr7	108539883	108540233	LTR/ERVL	2630	+	175	108540058	69419
chr7	108470639	108670639	harbor2	chr7	108540274	108540367	LTR/ERVL	2630	+	46	108540320	69681
chr7	82696059	82896059	harbor2	chr7	82719110	82719515	LTR/ERVL	1932	+	202	82719312	23253
chr7	82696059	82896059	harbor2	chr7	82733620	82734062	LTR/ERVL	26695	+	221	82733841	37782
chr7	82696059	82896059	harbor2	chr7	82734210	82738364	LTR/ERVL	26695	+	2077	82736287	40228
chr7	82696059	82896059	harbor2	chr7	82738497	82738573	LTR/ERVL	26695	+	38	82738535	42476
chr7	82696059	82896059	harbor2	chr7	82738882	82739115	LTR/ERVL	26695	+	116	82738998	42939
chr7	82696059	82896059	harbor2	chr7	82742216	82742647	LTR/ERVL	1101	+	216	82742432	46373
chr7	82696059	82896059	harbor2	chr7	82743879	82744337	LTR/ERVL	1164	+	229	82744108	48049
chr7	82696059	82896059	harbor2	chr7	82744748	82744930	LTR/ERVL	8156	+	91	82744839	48780
chr7	82696059	82896059	harbor2	chr7	82744986	82748076	LTR/ERVL	8156	+	1545	82746531	50472
chr7	82696059	82896059	harbor2	chr7	82773739	82774217	LTR/ERVL	1133	+	239	82773978	77919
chr7	82696059	82896059	harbor2	chr7	82781552	82781805	LTR/ERVL	1554	+	126	82781678	85619
chr7	82696059	82896059	harbor2	chr7	82781811	82782347	LTR/ERVL	2824	+	268	82782079	86020
chr7	82696059	82896059	harbor2	chr7	82739116	82739704	LTR/ERVL	2381	+	294	82739410	43351
chr7	124001724	124201724	harbor2	chr7	124019633	124020800	LTR/ERVL	6493	+	584	124020217	18493
chr7	124001724	124201724	harbor2	chr7	124020954	124021091	LTR/ERVL	12517	+	68	124021022	19298
chr7	124001724	124201724	harbor2	chr7	124021123	124023158	LTR/ERVL	12517	+	1018	124022141	20417
chr7	123649513	123849513	harbor2	chr7	123697669	123698225	LTR/ERVL	2687	+	278	123697947	48434
chr7	47569738	47769738	harbor2	chr7	47585495	47585898	LTR/ERVL	2387	+	202	47585697	15959
chr7	47569738	47769738	harbor2	chr7	47586199	47586279	LTR/ERVL	2387	+	40	47586239	16501
chr7	47228323	47428323	harbor2	chr7	47255484	47256356	LTR/ERVL	4698	+	436	47255920	27597
chr7	123649217	123849217	harbor2	chr7	123697669	123698225	LTR/ERVL	2687	+	278	123697947	48730
chr7	155197380	155397380	harbor2	chr7	155201760	155202181	LTR/ERVL	1158	+	210	155201970	4590
chr7	155197380	155397380	harbor2	chr7	155226956	155227111	LTR/ERVL	471	+	78	155227034	29654
chr7	155197380	155397380	harbor2	chr7	155266577	155267033	LTR/ERVL	853	+	228	155266805	69425
chr7	155197380	155397380	harbor2	chr7	155286322	155286768	LTR/ERVL	3554	+	223	155286545	89165
chr7	32629540	32829540	harbor2	chr7	32669163	32669692	LTR/ERVL	1738	+	264	32669427	39887
chr7	32629540	32829540	harbor2	chr7	32677452	32677853	LTR/ERVL	1131	+	200	32677652	48112
chr7	28134889	28334889	harbor2	chr7	28223509	28224323	LTR/ERVL	2294	+	407	28223916	89027
chr7	141412330	141612330	harbor2	chr7	141501471	141501844	LTR/ERVL	2252	+	186	141501657	89327
chr7	30979520	31179520	harbor2	chr7	30984811	30985212	LTR/ERVL	1679	+	200	30985011	5491
chr7	30979520	31179520	harbor2	chr7	30985255	30985309	LTR/ERVL	1679	+	27	30985282	5762
chr7	30979520	31179520	harbor2	chr7	31003656	31004115	LTR/ERVL	1676	+	230	31003886	24366
chr7	252668	452668	harbor2	chr7	346028	346466	LTR/ERVL	1140	+	219	346247	93579
chr7	157237066	157437066	harbor2	chr7	157311043	157311086	LTR/ERVL	453	+	22	157311065	73999
chr7	157237066	157437066	harbor2	chr7	157311372	157311456	LTR/ERVL	453	+	42	157311414	74348
chr7	157237066	157437066	harbor2	chr7	157313066	157313301	LTR/ERVL	1390	+	118	157313184	76118
chr7	44696579	44896579	harbor2	chr7	44725307	44725387	LTR/ERVL	2137	+	40	44725347	28768
chr7	44696579	44896579	harbor2	chr7	44725656	44725673	LTR/ERVL	2137	+	8	44725664	29085
chr7	44696579	44896579	harbor2	chr7	44725950	44726265	LTR/ERVL	2137	+	158	44726108	29529
chr7	44696579	44896579	harbor2	chr7	44726864	44726896	LTR/ERVL	2137	+	16	44726880	30301
chr7	44696579	44896579	harbor2	chr7	44727195	44727384	LTR/ERVL	2137	+	94	44727289	30710
chr7	44696579	44896579	harbor2	chr7	44743827	44744194	LTR/ERVL	1958	+	184	44744011	47432
chr7	122791479	122991479	harbor2	chr7	122806903	122807379	LTR/ERVL	1244	+	238	122807141	15662
chr7	122791479	122991479	harbor2	chr7	122807373	122807565	LTR/ERVL	882	+	96	122807469	15990
chr7	122791479	122991479	harbor2	chr7	122853099	122853386	LTR/ERVL	534	+	144	122853243	61764
chr7	122791479	122991479	harbor2	chr7	122853370	122853640	LTR/ERVL	798	+	135	122853505	62026
chr7	122791479	122991479	harbor2	chr7	122862246	122862645	LTR/ERVL	506	+	200	122862446	70967
chr7	90112558	90312558	harbor2	chr7	90130790	90130966	LTR/ERVL	583	+	88	90130878	18320
chr7	123649203	123849203	harbor2	chr7	123697669	123698225	LTR/ERVL	2687	+	278	123697947	48744
chr7	130248133	130448133	harbor2	chr7	130326321	130326746	LTR/ERVL	1179	+	212	130326533	78400
chr7	130248133	130448133	harbor2	chr7	130333200	130333397	LTR/ERVL	764	+	98	130333298	85165
chr7	130248133	130448133	harbor2	chr7	130340665	130341082	LTR/ERVL	2000	+	208	130340873	92740
chr7	47246812	47446812	harbor2	chr7	47255484	47256356	LTR/ERVL	4698	+	436	47255920	9108
chr7	123649200	123849200	harbor2	chr7	123697669	123698225	LTR/ERVL	2687	+	278	123697947	48747
chr7	2685113	2885113	harbor2	chr7	2694045	2694461	LTR/ERVL	1096	+	208	2694253	9140
chr7	2685113	2885113	harbor2	chr7	2775936	2776035	LTR/ERVL	503	+	50	2775986	90873
chr7	2685113	2885113	harbor2	chr7	2776237	2776803	LTR/ERVL	4249	+	283	2776520	91407
chr7	2685113	2885113	harbor2	chr7	2776966	2777375	LTR/ERVL	4249	+	204	2777170	92057
chr7	126687671	126887671	harbor2	chr7	126688797	126689300	LTR/ERVL	962	+	252	126689049	1378
chr7	126687671	126887671	harbor2	chr7	126702329	126702864	LTR/ERVL	709	+	268	126702597	14926
chr7	126687671	126887671	harbor2	chr7	126735842	126736172	LTR/ERVL	1225	+	165	126736007	48336
chr7	50204831	50404831	harbor2	chr7	50290068	50290313	LTR/ERVL	1021	+	122	50290190	85359
chr8	142532499	142732499	harbor2	chr8	142554851	142555631	LTR/ERVL	3303	+	390	142555241	22742
chr8	142532499	142732499	harbor2	chr8	142564749	142565392	LTR/ERVL	619	+	322	142565071	32572
chr8	23428835	23628835	harbor2	chr8	23476479	23477036	LTR/ERVL	1571	+	278	23476757	47922
chr8	23428830	23628830	harbor2	chr8	23476479	23477036	LTR/ERVL	1571	+	278	23476757	47927
chr8	23428848	23628848	harbor2	chr8	23476479	23477036	LTR/ERVL	1571	+	278	23476757	47909
chr8	23428832	23628832	harbor2	chr8	23476479	23477036	LTR/ERVL	1571	+	278	23476757	47925
chr8	29983316	30183316	harbor2	chr8	29983604	29984157	LTR/ERVL	1965	+	276	29983880	564
chr8	29983316	30183316	harbor2	chr8	30005503	30006054	LTR/ERVL	1207	+	276	30005779	22463
chr8	29983316	30183316	harbor2	chr8	30007218	30007318	LTR/ERVL	1207	+	50	30007268	23952
chr8	29983316	30183316	harbor2	chr8	30056873	30057055	LTR/ERVL	779	+	91	30056964	73648
chr8	29983316	30183316	harbor2	chr8	30075384	30075655	LTR/ERVL	440	+	136	30075520	92204
chr8	23430921	23630921	harbor2	chr8	23476479	23477036	LTR/ERVL	1571	+	278	23476757	45836
chr8	85146187	85346187	harbor2	chr8	85204277	85204370	LTR/ERVL	1147	+	46	85204323	58136
chr8	85146187	85346187	harbor2	chr8	85204703	85204903	LTR/ERVL	1147	+	100	85204803	58616
chr8	85146187	85346187	harbor2	chr8	85205201	85205240	LTR/ERVL	1147	+	20	85205221	59034
chr8	85146187	85346187	harbor2	chr8	85205583	85205761	LTR/ERVL	1147	+	89	85205672	59485
chr8	85146187	85346187	harbor2	chr8	85215277	85216062	LTR/ERVL	3668	+	392	85215669	69482
chr8	85146187	85346187	harbor2	chr8	85234886	85235378	LTR/ERVL	2214	+	246	85235132	88945
chr8	23430734	23630734	harbor2	chr8	23476479	23477036	LTR/ERVL	1571	+	278	23476757	46023
chr8	104366653	104566653	harbor2	chr8	104392107	104392518	LTR/ERVL	1133	+	206	104392313	25660
chr8	104366653	104566653	harbor2	chr8	104406402	104406760	LTR/ERVL	1153	+	179	104406581	39928
chr8	23429310	23629310	harbor2	chr8	23476479	23477036	LTR/ERVL	1571	+	278	23476757	47447
chr8	23428822	23628822	harbor2	chr8	23476479	23477036	LTR/ERVL	1571	+	278	23476757	47935
chr8	90970532	91170532	harbor2	chr8	91007641	91008180	LTR/ERVL	2810	+	270	91007911	37379
chr8	90970532	91170532	harbor2	chr8	91026021	91026701	LTR/ERVL	2046	+	340	91026361	55829
chr8	90970532	91170532	harbor2	chr8	91026905	91028303	LTR/ERVL	2931	+	699	91027604	57072
chr8	90970532	91170532	harbor2	chr8	91028324	91028799	LTR/ERVL	963	+	238	91028562	58030
chr8	90970532	91170532	harbor2	chr8	91034388	91034825	LTR/ERVL	669	+	218	91034606	64074
chr8	90970532	91170532	harbor2	chr8	91065575	91065663	LTR/ERVL	455	+	44	91065619	95087
chr8	23428834	23628834	harbor2	chr8	23476479	23477036	LTR/ERVL	1571	+	278	23476757	47923
chr8	23430616	23630616	harbor2	chr8	23476479	23477036	LTR/ERVL	1571	+	278	23476757	46141
chr8	23428887	23628887	harbor2	chr8	23476479	23477036	LTR/ERVL	1571	+	278	23476757	47870
chr8	23428847	23628847	harbor2	chr8	23476479	23477036	LTR/ERVL	1571	+	278	23476757	47910
chr8	129916351	130116351	harbor2	chr8	129932201	129932716	LTR/ERVL	2007	+	258	129932459	16108
chr8	129916351	130116351	harbor2	chr8	129933021	129933594	LTR/ERVL	1521	+	286	129933307	16956
chr8	129916351	130116351	harbor2	chr8	129933923	129934018	LTR/ERVL	1521	+	48	129933971	17620
chr8	129916351	130116351	harbor2	chr8	129934018	129934402	LTR/ERVL	1246	+	192	129934210	17859
chr8	23429171	23629171	harbor2	chr8	23476479	23477036	LTR/ERVL	1571	+	278	23476757	47586
chr8	23428810	23628810	harbor2	chr8	23476479	23477036	LTR/ERVL	1571	+	278	23476757	47947
chr8	23428878	23628878	harbor2	chr8	23476479	23477036	LTR/ERVL	1571	+	278	23476757	47879
chr8	96337693	96537693	harbor2	chr8	96408436	96408850	LTR/ERVL	1267	+	207	96408643	70950
chr8	142525412	142725412	harbor2	chr8	142554851	142555631	LTR/ERVL	3303	+	390	142555241	29829
chr8	142525412	142725412	harbor2	chr8	142564749	142565392	LTR/ERVL	619	+	322	142565071	39659
chr8	23430801	23630801	harbor2	chr8	23476479	23477036	LTR/ERVL	1571	+	278	23476757	45956
chr8	23428837	23628837	harbor2	chr8	23476479	23477036	LTR/ERVL	1571	+	278	23476757	47920
chr8	23428831	23628831	harbor2	chr8	23476479	23477036	LTR/ERVL	1571	+	278	23476757	47926
chr8	23430721	23630721	harbor2	chr8	23476479	23477036	LTR/ERVL	1571	+	278	23476757	46036
chr8	23123866	23323866	harbor2	chr8	23165997	23166297	LTR/ERVL	2768	+	150	23166147	42281
chr8	23123866	23323866	harbor2	chr8	23167737	23168604	LTR/ERVL	6621	+	434	23168171	44305
chr8	23123866	23323866	harbor2	chr8	23168883	23169135	LTR/ERVL	6621	+	126	23169009	45143
chr8	23123866	23323866	harbor2	chr8	23169551	23169953	LTR/ERVL	6621	+	201	23169752	45886
chr8	23123866	23323866	harbor2	chr8	23170256	23170311	LTR/ERVL	6621	+	28	23170284	46418
chr8	23123866	23323866	harbor2	chr8	23170501	23170843	LTR/ERVL	1497	+	171	23170672	46806
chr8	23123866	23323866	harbor2	chr8	23171154	23171416	LTR/ERVL	1497	+	131	23171285	47419
chr8	23123866	23323866	harbor2	chr8	23172417	23172523	LTR/ERVL	569	+	53	23172470	48604
chr8	23123866	23323866	harbor2	chr8	23172817	23172899	LTR/ERVL	569	+	41	23172858	48992
chr8	23123866	23323866	harbor2	chr8	23166586	23166990	LTR/ERVL	2768	+	202	23166788	42922
chr8	23428811	23628811	harbor2	chr8	23476479	23477036	LTR/ERVL	1571	+	278	23476757	47946
chr8	108431293	108631293	harbor2	chr8	108435891	108436363	LTR/ERVL	1605	+	236	108436127	4834
chr8	142524861	142724861	harbor2	chr8	142554851	142555631	LTR/ERVL	3303	+	390	142555241	30380
chr8	142524861	142724861	harbor2	chr8	142564749	142565392	LTR/ERVL	619	+	322	142565071	40210
chr8	66086821	66286821	harbor2	chr8	66109128	66109383	LTR/ERVL	1033	+	128	66109256	22435
chr8	66086821	66286821	harbor2	chr8	66120288	66121010	LTR/ERVL	1774	+	361	66120649	33828
chr8	23428838	23628838	harbor2	chr8	23476479	23477036	LTR/ERVL	1571	+	278	23476757	47919
chr8	23429250	23629250	harbor2	chr8	23476479	23477036	LTR/ERVL	1571	+	278	23476757	47507
chr8	23428888	23628888	harbor2	chr8	23476479	23477036	LTR/ERVL	1571	+	278	23476757	47869
chr8	60554292	60754292	harbor2	chr8	60560933	60561296	LTR/ERVL	923	+	182	60561115	6823
chr8	142524868	142724868	harbor2	chr8	142554851	142555631	LTR/ERVL	3303	+	390	142555241	30373
chr8	142524868	142724868	harbor2	chr8	142564749	142565392	LTR/ERVL	619	+	322	142565071	40203
chr8	23428787	23628787	harbor2	chr8	23476479	23477036	LTR/ERVL	1571	+	278	23476757	47970
chr8	23428812	23628812	harbor2	chr8	23476479	23477036	LTR/ERVL	1571	+	278	23476757	47945
chr8	10626848	10826848	harbor2	chr8	10638755	10638862	LTR/ERVL	1230	+	54	10638809	11961
chr8	10626848	10826848	harbor2	chr8	10639172	10639382	LTR/ERVL	1230	+	105	10639277	12429
chr8	10626848	10826848	harbor2	chr8	10639674	10639803	LTR/ERVL	1230	+	64	10639738	12890
chr8	10626848	10826848	harbor2	chr8	10646932	10647280	LTR/ERVL	516	+	174	10647106	20258
chr8	10626848	10826848	harbor2	chr8	10706765	10707077	LTR/ERVL	753	+	156	10706921	80073
chr8	10626848	10826848	harbor2	chr8	10707529	10707769	LTR/ERVL	711	+	120	10707649	80801
chr8	23428873	23628873	harbor2	chr8	23476479	23477036	LTR/ERVL	1571	+	278	23476757	47884
chr8	29996669	30196669	harbor2	chr8	30005503	30006054	LTR/ERVL	1207	+	276	30005779	9110
chr8	29996669	30196669	harbor2	chr8	30007218	30007318	LTR/ERVL	1207	+	50	30007268	10599
chr8	29996669	30196669	harbor2	chr8	30056873	30057055	LTR/ERVL	779	+	91	30056964	60295
chr8	29996669	30196669	harbor2	chr8	30075384	30075655	LTR/ERVL	440	+	136	30075520	78851
chr8	23430877	23630877	harbor2	chr8	23476479	23477036	LTR/ERVL	1571	+	278	23476757	45880
chr8	124796970	124996970	harbor2	chr8	124801575	124801682	LTR/ERVL	468	+	54	124801629	4659
chr8	124796970	124996970	harbor2	chr8	124808043	124808301	LTR/ERVL	705	+	129	124808172	11202
chr8	124796970	124996970	harbor2	chr8	124841658	124842052	LTR/ERVL	996	+	197	124841855	44885
chr8	23440530	23640530	harbor2	chr8	23476479	23477036	LTR/ERVL	1571	+	278	23476757	36227
chr8	23429402	23629402	harbor2	chr8	23476479	23477036	LTR/ERVL	1571	+	278	23476757	47355
chr8	129914983	130114983	harbor2	chr8	129932201	129932716	LTR/ERVL	2007	+	258	129932459	17476
chr8	129914983	130114983	harbor2	chr8	129933021	129933594	LTR/ERVL	1521	+	286	129933307	18324
chr8	129914983	130114983	harbor2	chr8	129933923	129934018	LTR/ERVL	1521	+	48	129933971	18988
chr8	129914983	130114983	harbor2	chr8	129934018	129934402	LTR/ERVL	1246	+	192	129934210	19227
chr8	142531182	142731182	harbor2	chr8	142554851	142555631	LTR/ERVL	3303	+	390	142555241	24059
chr8	142531182	142731182	harbor2	chr8	142564749	142565392	LTR/ERVL	619	+	322	142565071	33889
chr8	142674582	142874582	harbor2	chr8	142761500	142762292	LTR/ERVL	3591	+	396	142761896	87314
chr8	142525400	142725400	harbor2	chr8	142554851	142555631	LTR/ERVL	3303	+	390	142555241	29841
chr8	142525400	142725400	harbor2	chr8	142564749	142565392	LTR/ERVL	619	+	322	142565071	39671
chr8	81621343	81821343	harbor2	chr8	81707084	81707540	LTR/ERVL	1024	+	228	81707312	85969
chr8	81621343	81821343	harbor2	chr8	81716280	81716483	LTR/ERVL	573	+	102	81716382	95039
chr8	142524867	142724867	harbor2	chr8	142554851	142555631	LTR/ERVL	3303	+	390	142555241	30374
chr8	142524867	142724867	harbor2	chr8	142564749	142565392	LTR/ERVL	619	+	322	142565071	40204
chr8	23428886	23628886	harbor2	chr8	23476479	23477036	LTR/ERVL	1571	+	278	23476757	47871
chr8	124982576	125182576	harbor2	chr8	124987055	124987624	LTR/ERVL	2972	+	284	124987339	4763
chr8	124982576	125182576	harbor2	chr8	124987618	124991707	LTR/ERVL	24492	+	2044	124989662	7086
chr8	124982576	125182576	harbor2	chr8	124991708	124992252	LTR/ERVL	2230	+	272	124991980	9404
chr8	124982576	125182576	harbor2	chr8	125068135	125068643	LTR/ERVL	2547	+	254	125068389	85813
chr8	90971180	91171180	harbor2	chr8	91007641	91008180	LTR/ERVL	2810	+	270	91007911	36731
chr8	90971180	91171180	harbor2	chr8	91026021	91026701	LTR/ERVL	2046	+	340	91026361	55181
chr8	90971180	91171180	harbor2	chr8	91026905	91028303	LTR/ERVL	2931	+	699	91027604	56424
chr8	90971180	91171180	harbor2	chr8	91028324	91028799	LTR/ERVL	963	+	238	91028562	57382
chr8	90971180	91171180	harbor2	chr8	91034388	91034825	LTR/ERVL	669	+	218	91034606	63426
chr8	90971180	91171180	harbor2	chr8	91065575	91065663	LTR/ERVL	455	+	44	91065619	94439
chr8	85146249	85346249	harbor2	chr8	85204277	85204370	LTR/ERVL	1147	+	46	85204323	58074
chr8	85146249	85346249	harbor2	chr8	85204703	85204903	LTR/ERVL	1147	+	100	85204803	58554
chr8	85146249	85346249	harbor2	chr8	85205201	85205240	LTR/ERVL	1147	+	20	85205221	58972
chr8	85146249	85346249	harbor2	chr8	85205583	85205761	LTR/ERVL	1147	+	89	85205672	59423
chr8	85146249	85346249	harbor2	chr8	85215277	85216062	LTR/ERVL	3668	+	392	85215669	69420
chr8	85146249	85346249	harbor2	chr8	85234886	85235378	LTR/ERVL	2214	+	246	85235132	88883
chr8	85145757	85345757	harbor2	chr8	85204277	85204370	LTR/ERVL	1147	+	46	85204323	58566
chr8	85145757	85345757	harbor2	chr8	85204703	85204903	LTR/ERVL	1147	+	100	85204803	59046
chr8	85145757	85345757	harbor2	chr8	85205201	85205240	LTR/ERVL	1147	+	20	85205221	59464
chr8	85145757	85345757	harbor2	chr8	85205583	85205761	LTR/ERVL	1147	+	89	85205672	59915
chr8	85145757	85345757	harbor2	chr8	85215277	85216062	LTR/ERVL	3668	+	392	85215669	69912
chr8	85145757	85345757	harbor2	chr8	85234886	85235378	LTR/ERVL	2214	+	246	85235132	89375
chr8	142524847	142724847	harbor2	chr8	142554851	142555631	LTR/ERVL	3303	+	390	142555241	30394
chr8	142524847	142724847	harbor2	chr8	142564749	142565392	LTR/ERVL	619	+	322	142565071	40224
chr8	54199923	54399923	harbor2	chr8	54271744	54272054	LTR/ERVL	1003	+	155	54271899	71976
chr8	78098264	78298264	harbor2	chr8	78155679	78156085	LTR/ERVL	2981	+	203	78155882	57618
chr8	78098264	78298264	harbor2	chr8	78156110	78159313	LTR/ERVL	23621	+	1602	78157712	59448
chr8	78098264	78298264	harbor2	chr8	78159312	78160341	LTR/ERVL	8011	+	514	78159826	61562
chr8	78098264	78298264	harbor2	chr8	78161676	78162506	LTR/ERVL	5896	+	415	78162091	63827
chr8	78098264	78298264	harbor2	chr8	78162507	78162899	LTR/ERVL	2909	+	196	78162703	64439
chr8	23429413	23629413	harbor2	chr8	23476479	23477036	LTR/ERVL	1571	+	278	23476757	47344
chr8	23428927	23628927	harbor2	chr8	23476479	23477036	LTR/ERVL	1571	+	278	23476757	47830
chr8	129916407	130116407	harbor2	chr8	129932201	129932716	LTR/ERVL	2007	+	258	129932459	16052
chr8	129916407	130116407	harbor2	chr8	129933021	129933594	LTR/ERVL	1521	+	286	129933307	16900
chr8	129916407	130116407	harbor2	chr8	129933923	129934018	LTR/ERVL	1521	+	48	129933971	17564
chr8	129916407	130116407	harbor2	chr8	129934018	129934402	LTR/ERVL	1246	+	192	129934210	17803
chr8	134491303	134691303	harbor2	chr8	134503475	134503909	LTR/ERVL	2137	+	217	134503692	12389
chr8	134491303	134691303	harbor2	chr8	134503960	134503994	LTR/ERVL	2137	+	17	134503977	12674
chr8	134491303	134691303	harbor2	chr8	134563794	134563958	LTR/ERVL	1022	+	82	134563876	72573
chr8	134491303	134691303	harbor2	chr8	134564218	134564541	LTR/ERVL	1557	+	162	134564380	73077
chr8	29983254	30183254	harbor2	chr8	29983604	29984157	LTR/ERVL	1965	+	276	29983880	626
chr8	29983254	30183254	harbor2	chr8	30005503	30006054	LTR/ERVL	1207	+	276	30005779	22525
chr8	29983254	30183254	harbor2	chr8	30007218	30007318	LTR/ERVL	1207	+	50	30007268	24014
chr8	29983254	30183254	harbor2	chr8	30056873	30057055	LTR/ERVL	779	+	91	30056964	73710
chr8	29983254	30183254	harbor2	chr8	30075384	30075655	LTR/ERVL	440	+	136	30075520	92266
chr8	23428893	23628893	harbor2	chr8	23476479	23477036	LTR/ERVL	1571	+	278	23476757	47864
chr8	81789753	81989753	harbor2	chr8	81883702	81884114	LTR/ERVL	1229	+	206	81883908	94155
chr8	23428926	23628926	harbor2	chr8	23476479	23477036	LTR/ERVL	1571	+	278	23476757	47831
chr8	142525343	142725343	harbor2	chr8	142554851	142555631	LTR/ERVL	3303	+	390	142555241	29898
chr8	142525343	142725343	harbor2	chr8	142564749	142565392	LTR/ERVL	619	+	322	142565071	39728
chr8	29983321	30183321	harbor2	chr8	29983604	29984157	LTR/ERVL	1965	+	276	29983880	559
chr8	29983321	30183321	harbor2	chr8	30005503	30006054	LTR/ERVL	1207	+	276	30005779	22458
chr8	29983321	30183321	harbor2	chr8	30007218	30007318	LTR/ERVL	1207	+	50	30007268	23947
chr8	29983321	30183321	harbor2	chr8	30056873	30057055	LTR/ERVL	779	+	91	30056964	73643
chr8	29983321	30183321	harbor2	chr8	30075384	30075655	LTR/ERVL	440	+	136	30075520	92199
chr8	102557133	102757133	harbor2	chr8	102644172	102644667	LTR/ERVL	2016	+	248	102644420	87287
chr8	143978595	144178595	harbor2	chr8	144075920	144076411	LTR/ERVL	1706	+	246	144076166	97571
chr8	142528666	142728666	harbor2	chr8	142554851	142555631	LTR/ERVL	3303	+	390	142555241	26575
chr8	142528666	142728666	harbor2	chr8	142564749	142565392	LTR/ERVL	619	+	322	142565071	36405
chr8	144801613	145001613	harbor2	chr8	144809392	144809769	LTR/ERVL	1806	+	188	144809580	7967
chr8	144801613	145001613	harbor2	chr8	144810066	144810119	LTR/ERVL	1806	+	26	144810092	8479
chr8	144801613	145001613	harbor2	chr8	144824167	144824249	LTR/ERVL	1223	+	41	144824208	22595
chr8	144801613	145001613	harbor2	chr8	144824539	144824956	LTR/ERVL	1223	+	208	144824747	23134
chr8	144801613	145001613	harbor2	chr8	144846103	144846312	LTR/ERVL	437	+	104	144846207	44594
chr8	144801613	145001613	harbor2	chr8	144855427	144855837	LTR/ERVL	2325	+	205	144855632	54019
chr8	144801613	145001613	harbor2	chr8	144856853	144857653	LTR/ERVL	905	+	400	144857253	55640
chr8	144801613	145001613	harbor2	chr8	144857810	144857993	LTR/ERVL	598	+	92	144857902	56289
chr8	144801613	145001613	harbor2	chr8	144857998	144858292	LTR/ERVL	502	+	147	144858145	56532
chr8	144801613	145001613	harbor2	chr8	144868593	144868834	LTR/ERVL	1565	+	120	144868713	67100
chr8	144801613	145001613	harbor2	chr8	144868835	144869179	LTR/ERVL	2703	+	172	144869007	67394
chr8	144801613	145001613	harbor2	chr8	144870584	144871050	LTR/ERVL	3558	+	233	144870817	69204
chr8	144801613	145001613	harbor2	chr8	144873795	144873861	LTR/ERVL	2178	+	33	144873828	72215
chr8	144801613	145001613	harbor2	chr8	144874158	144874428	LTR/ERVL	2178	+	135	144874293	72680
chr8	144801613	145001613	harbor2	chr8	144874429	144874710	LTR/ERVL	2003	+	140	144874569	72956
chr8	143150227	143350227	harbor2	chr8	143165743	143165996	LTR/ERVL	789	+	126	143165869	15642
chr8	143150227	143350227	harbor2	chr8	143193481	143193894	LTR/ERVL	1855	+	206	143193687	43460
chr8	143150227	143350227	harbor2	chr8	143196487	143196561	LTR/ERVL	546	+	37	143196524	46297
chr8	143150227	143350227	harbor2	chr8	143196560	143196761	LTR/ERVL	1462	+	100	143196660	46433
chr8	143150227	143350227	harbor2	chr8	143196827	143196865	LTR/ERVL	1462	+	19	143196846	46619
chr8	143150227	143350227	harbor2	chr8	143195432	143196486	LTR/ERVL	7686	+	527	143195959	45732
chr8	144048018	144248018	harbor2	chr8	144075920	144076411	LTR/ERVL	1706	+	246	144076166	28148
chr8	144048018	144248018	harbor2	chr8	144129816	144130026	LTR/ERVL	568	+	105	144129921	81903
chr8	23431204	23631204	harbor2	chr8	23476479	23477036	LTR/ERVL	1571	+	278	23476757	45553
chr8	41512963	41712963	harbor2	chr8	41517524	41517945	LTR/ERVL	1022	+	210	41517734	4771
chr8	41512963	41712963	harbor2	chr8	41557804	41558189	LTR/ERVL	2905	+	192	41557996	45033
chr8	41512963	41712963	harbor2	chr8	41606044	41606459	LTR/ERVL	1765	+	208	41606252	93289
chr8	23428900	23628900	harbor2	chr8	23476479	23477036	LTR/ERVL	1571	+	278	23476757	47857
chr8	41241751	41441751	harbor2	chr8	41273734	41274241	LTR/ERVL	1704	+	254	41273988	32237
chr8	94973524	95173524	harbor2	chr8	94977551	94977795	LTR/ERVL	757	+	122	94977673	4149
chr8	94973524	95173524	harbor2	chr8	94978733	94979077	LTR/ERVL	3693	+	172	94978905	5381
chr8	94973524	95173524	harbor2	chr8	95021718	95022039	LTR/ERVL	1005	+	160	95021878	48354
chr8	94973524	95173524	harbor2	chr8	95064578	95065400	LTR/ERVL	3907	+	411	95064989	91465
chr8	94973524	95173524	harbor2	chr8	94977876	94978433	LTR/ERVL	3693	+	278	94978154	4630
chr8	23429267	23629267	harbor2	chr8	23476479	23477036	LTR/ERVL	1571	+	278	23476757	47490
chr8	66406890	66606890	harbor2	chr8	66482976	66483405	LTR/ERVL	949	+	214	66483190	76300
chr8	23428736	23628736	harbor2	chr8	23476479	23477036	LTR/ERVL	1571	+	278	23476757	48021
chr8	143825669	144025669	harbor2	chr8	143842234	143842366	LTR/ERVL	609	+	66	143842300	16631
chr8	143825669	144025669	harbor2	chr8	143842573	143842974	LTR/ERVL	1575	+	200	143842773	17104
chr8	143825669	144025669	harbor2	chr8	143875703	143876180	LTR/ERVL	611	+	238	143875941	50272
chr8	143825669	144025669	harbor2	chr8	143911511	143911989	LTR/ERVL	587	+	239	143911750	86081
chr8	143825669	144025669	harbor2	chr8	143912139	143912418	LTR/ERVL	529	+	140	143912279	86610
chr8	143825669	144025669	harbor2	chr8	143913824	143914030	LTR/ERVL	479	+	103	143913927	88258
chr9	4692868	4892868	harbor2	chr9	4719472	4719754	LTR/ERVL	1402	+	141	4719613	26745
chr9	4692868	4892868	harbor2	chr9	4767974	4768533	LTR/ERVL	2710	+	280	4768254	75386
chr9	4692868	4892868	harbor2	chr9	4768560	4768598	LTR/ERVL	623	+	19	4768579	75711
chr9	4692868	4892868	harbor2	chr9	4776096	4776156	LTR/ERVL	1756	+	30	4776126	83258
chr9	4692868	4892868	harbor2	chr9	4776449	4776750	LTR/ERVL	1756	+	150	4776599	83731
chr9	136670195	136870195	harbor2	chr9	136705861	136706339	LTR/ERVL	3741	+	239	136706100	35905
chr9	136670195	136870195	harbor2	chr9	136706959	136707635	LTR/ERVL	3741	+	338	136707297	37102
chr9	136670195	136870195	harbor2	chr9	136707946	136708531	LTR/ERVL	3741	+	292	136708238	38043
chr9	4770890	4970890	harbor2	chr9	4776096	4776156	LTR/ERVL	1756	+	30	4776126	5236
chr9	4770890	4970890	harbor2	chr9	4776449	4776750	LTR/ERVL	1756	+	150	4776599	5709
chr9	4692825	4892825	harbor2	chr9	4719472	4719754	LTR/ERVL	1402	+	141	4719613	26788
chr9	4692825	4892825	harbor2	chr9	4767974	4768533	LTR/ERVL	2710	+	280	4768254	75429
chr9	4692825	4892825	harbor2	chr9	4768560	4768598	LTR/ERVL	623	+	19	4768579	75754
chr9	4692825	4892825	harbor2	chr9	4776096	4776156	LTR/ERVL	1756	+	30	4776126	83301
chr9	4692825	4892825	harbor2	chr9	4776449	4776750	LTR/ERVL	1756	+	150	4776599	83774
chr9	4884805	5084805	harbor2	chr9	4971442	4971760	LTR/ERVL	1353	+	159	4971601	86796
chr9	4884805	5084805	harbor2	chr9	4972365	4972544	LTR/ERVL	1353	+	90	4972455	87650
chr9	4692782	4892782	harbor2	chr9	4719472	4719754	LTR/ERVL	1402	+	141	4719613	26831
chr9	4692782	4892782	harbor2	chr9	4767974	4768533	LTR/ERVL	2710	+	280	4768254	75472
chr9	4692782	4892782	harbor2	chr9	4768560	4768598	LTR/ERVL	623	+	19	4768579	75797
chr9	4692782	4892782	harbor2	chr9	4776096	4776156	LTR/ERVL	1756	+	30	4776126	83344
chr9	4692782	4892782	harbor2	chr9	4776449	4776750	LTR/ERVL	1756	+	150	4776599	83817
chr9	4884804	5084804	harbor2	chr9	4971442	4971760	LTR/ERVL	1353	+	159	4971601	86797
chr9	4884804	5084804	harbor2	chr9	4972365	4972544	LTR/ERVL	1353	+	90	4972455	87651
chr9	4698243	4898243	harbor2	chr9	4719472	4719754	LTR/ERVL	1402	+	141	4719613	21370
chr9	4698243	4898243	harbor2	chr9	4767974	4768533	LTR/ERVL	2710	+	280	4768254	70011
chr9	4698243	4898243	harbor2	chr9	4768560	4768598	LTR/ERVL	623	+	19	4768579	70336
chr9	4698243	4898243	harbor2	chr9	4776096	4776156	LTR/ERVL	1756	+	30	4776126	77883
chr9	4698243	4898243	harbor2	chr9	4776449	4776750	LTR/ERVL	1756	+	150	4776599	78356
chr9	16305865	16505865	harbor2	chr9	16334245	16334561	LTR/ERVL	878	+	158	16334403	28538
chr9	16305865	16505865	harbor2	chr9	16341832	16342051	LTR/ERVL	546	+	110	16341942	36077
chr9	16305865	16505865	harbor2	chr9	16386960	16387287	LTR/ERVL	1202	+	164	16387124	81259
chr9	4692809	4892809	harbor2	chr9	4719472	4719754	LTR/ERVL	1402	+	141	4719613	26804
chr9	4692809	4892809	harbor2	chr9	4767974	4768533	LTR/ERVL	2710	+	280	4768254	75445
chr9	4692809	4892809	harbor2	chr9	4768560	4768598	LTR/ERVL	623	+	19	4768579	75770
chr9	4692809	4892809	harbor2	chr9	4776096	4776156	LTR/ERVL	1756	+	30	4776126	83317
chr9	4692809	4892809	harbor2	chr9	4776449	4776750	LTR/ERVL	1756	+	150	4776599	83790
chr9	4692811	4892811	harbor2	chr9	4719472	4719754	LTR/ERVL	1402	+	141	4719613	26802
chr9	4692811	4892811	harbor2	chr9	4767974	4768533	LTR/ERVL	2710	+	280	4768254	75443
chr9	4692811	4892811	harbor2	chr9	4768560	4768598	LTR/ERVL	623	+	19	4768579	75768
chr9	4692811	4892811	harbor2	chr9	4776096	4776156	LTR/ERVL	1756	+	30	4776126	83315
chr9	4692811	4892811	harbor2	chr9	4776449	4776750	LTR/ERVL	1756	+	150	4776599	83788
chr9	4884747	5084747	harbor2	chr9	4971442	4971760	LTR/ERVL	1353	+	159	4971601	86854
chr9	4884747	5084747	harbor2	chr9	4972365	4972544	LTR/ERVL	1353	+	90	4972455	87708
chr9	4884773	5084773	harbor2	chr9	4971442	4971760	LTR/ERVL	1353	+	159	4971601	86828
chr9	4884773	5084773	harbor2	chr9	4972365	4972544	LTR/ERVL	1353	+	90	4972455	87682
chr9	4884793	5084793	harbor2	chr9	4971442	4971760	LTR/ERVL	1353	+	159	4971601	86808
chr9	4884793	5084793	harbor2	chr9	4972365	4972544	LTR/ERVL	1353	+	90	4972455	87662
chr9	100253009	100453009	harbor2	chr9	100337990	100338608	LTR/ERVL	1426	+	309	100338299	85290
chr9	100253009	100453009	harbor2	chr9	100338900	100338937	LTR/ERVL	1426	+	18	100338918	85909
chr9	4884841	5084841	harbor2	chr9	4971442	4971760	LTR/ERVL	1353	+	159	4971601	86760
chr9	4884841	5084841	harbor2	chr9	4972365	4972544	LTR/ERVL	1353	+	90	4972455	87614
chr9	4884813	5084813	harbor2	chr9	4971442	4971760	LTR/ERVL	1353	+	159	4971601	86788
chr9	4884813	5084813	harbor2	chr9	4972365	4972544	LTR/ERVL	1353	+	90	4972455	87642
chr9	4884788	5084788	harbor2	chr9	4971442	4971760	LTR/ERVL	1353	+	159	4971601	86813
chr9	4884788	5084788	harbor2	chr9	4972365	4972544	LTR/ERVL	1353	+	90	4972455	87667
chr9	4884790	5084790	harbor2	chr9	4971442	4971760	LTR/ERVL	1353	+	159	4971601	86811
chr9	4884790	5084790	harbor2	chr9	4972365	4972544	LTR/ERVL	1353	+	90	4972455	87665
chr9	34146713	34346713	harbor2	chr9	34152257	34152548	LTR/ERVL	567	+	146	34152403	5690
chr9	34146713	34346713	harbor2	chr9	34153357	34153854	LTR/ERVL	2107	+	248	34153605	6892
chr9	34146713	34346713	harbor2	chr9	34171781	34172004	LTR/ERVL	788	+	112	34171893	25180
chr9	4692881	4892881	harbor2	chr9	4719472	4719754	LTR/ERVL	1402	+	141	4719613	26732
chr9	4692881	4892881	harbor2	chr9	4767974	4768533	LTR/ERVL	2710	+	280	4768254	75373
chr9	4692881	4892881	harbor2	chr9	4768560	4768598	LTR/ERVL	623	+	19	4768579	75698
chr9	4692881	4892881	harbor2	chr9	4776096	4776156	LTR/ERVL	1756	+	30	4776126	83245
chr9	4692881	4892881	harbor2	chr9	4776449	4776750	LTR/ERVL	1756	+	150	4776599	83718
chr9	4884785	5084785	harbor2	chr9	4971442	4971760	LTR/ERVL	1353	+	159	4971601	86816
chr9	4884785	5084785	harbor2	chr9	4972365	4972544	LTR/ERVL	1353	+	90	4972455	87670
chr9	134036108	134236108	harbor2	chr9	134111144	134111681	LTR/ERVL	1985	+	268	134111412	75304
chr9	4885814	5085814	harbor2	chr9	4971442	4971760	LTR/ERVL	1353	+	159	4971601	85787
chr9	4885814	5085814	harbor2	chr9	4972365	4972544	LTR/ERVL	1353	+	90	4972455	86641
chr9	134036094	134236094	harbor2	chr9	134111144	134111681	LTR/ERVL	1985	+	268	134111412	75318
chr9	68662242	68862242	harbor2	chr9	68663292	68665299	LTR/ERVL	3516	+	1004	68664296	2054
chr9	68662242	68862242	harbor2	chr9	68667709	68668071	LTR/ERVL	1092	+	181	68667890	5648
chr9	68662242	68862242	harbor2	chr9	68671043	68671520	LTR/ERVL	1601	+	238	68671281	9039
chr9	4692776	4892776	harbor2	chr9	4719472	4719754	LTR/ERVL	1402	+	141	4719613	26837
chr9	4692776	4892776	harbor2	chr9	4767974	4768533	LTR/ERVL	2710	+	280	4768254	75478
chr9	4692776	4892776	harbor2	chr9	4768560	4768598	LTR/ERVL	623	+	19	4768579	75803
chr9	4692776	4892776	harbor2	chr9	4776096	4776156	LTR/ERVL	1756	+	30	4776126	83350
chr9	4692776	4892776	harbor2	chr9	4776449	4776750	LTR/ERVL	1756	+	150	4776599	83823
chr9	4886412	5086412	harbor2	chr9	4971442	4971760	LTR/ERVL	1353	+	159	4971601	85189
chr9	4886412	5086412	harbor2	chr9	4972365	4972544	LTR/ERVL	1353	+	90	4972455	86043
chr9	4884783	5084783	harbor2	chr9	4971442	4971760	LTR/ERVL	1353	+	159	4971601	86818
chr9	4884783	5084783	harbor2	chr9	4972365	4972544	LTR/ERVL	1353	+	90	4972455	87672
chr9	32688006	32888006	harbor2	chr9	32728277	32728838	LTR/ERVL	3230	+	280	32728557	40551
chr9	32688006	32888006	harbor2	chr9	32776179	32776613	LTR/ERVL	1495	+	217	32776396	88390
chr9	4884822	5084822	harbor2	chr9	4971442	4971760	LTR/ERVL	1353	+	159	4971601	86779
chr9	4884822	5084822	harbor2	chr9	4972365	4972544	LTR/ERVL	1353	+	90	4972455	87633
chr9	4692771	4892771	harbor2	chr9	4719472	4719754	LTR/ERVL	1402	+	141	4719613	26842
chr9	4692771	4892771	harbor2	chr9	4767974	4768533	LTR/ERVL	2710	+	280	4768254	75483
chr9	4692771	4892771	harbor2	chr9	4768560	4768598	LTR/ERVL	623	+	19	4768579	75808
chr9	4692771	4892771	harbor2	chr9	4776096	4776156	LTR/ERVL	1756	+	30	4776126	83355
chr9	4692771	4892771	harbor2	chr9	4776449	4776750	LTR/ERVL	1756	+	150	4776599	83828
chr9	4886118	5086118	harbor2	chr9	4971442	4971760	LTR/ERVL	1353	+	159	4971601	85483
chr9	4886118	5086118	harbor2	chr9	4972365	4972544	LTR/ERVL	1353	+	90	4972455	86337
chr9	4693367	4893367	harbor2	chr9	4719472	4719754	LTR/ERVL	1402	+	141	4719613	26246
chr9	4693367	4893367	harbor2	chr9	4767974	4768533	LTR/ERVL	2710	+	280	4768254	74887
chr9	4693367	4893367	harbor2	chr9	4768560	4768598	LTR/ERVL	623	+	19	4768579	75212
chr9	4693367	4893367	harbor2	chr9	4776096	4776156	LTR/ERVL	1756	+	30	4776126	82759
chr9	4693367	4893367	harbor2	chr9	4776449	4776750	LTR/ERVL	1756	+	150	4776599	83232
chr9	91845860	92045860	harbor2	chr9	91893105	91893215	LTR/ERVL	739	+	55	91893160	47300
chr9	91845860	92045860	harbor2	chr9	91893457	91893657	LTR/ERVL	739	+	100	91893557	47697
chr9	91845860	92045860	harbor2	chr9	91927549	91927559	LTR/ERVL	1451	+	5	91927554	81694
chr9	91845860	92045860	harbor2	chr9	91927864	91928391	LTR/ERVL	1451	+	264	91928128	82268
chr9	68605578	68805578	harbor2	chr9	68606573	68607099	LTR/ERVL	2580	+	263	68606836	1258
chr9	68605578	68805578	harbor2	chr9	68634248	68634706	LTR/ERVL	1390	+	229	68634477	28899
chr9	68605578	68805578	harbor2	chr9	68661999	68662160	LTR/ERVL	673	+	80	68662079	56501
chr9	68605578	68805578	harbor2	chr9	68663292	68665299	LTR/ERVL	3516	+	1004	68664296	58718
chr9	68605578	68805578	harbor2	chr9	68667709	68668071	LTR/ERVL	1092	+	181	68667890	62312
chr9	68605578	68805578	harbor2	chr9	68671043	68671520	LTR/ERVL	1601	+	238	68671281	65703
chr9	4884810	5084810	harbor2	chr9	4971442	4971760	LTR/ERVL	1353	+	159	4971601	86791
chr9	4884810	5084810	harbor2	chr9	4972365	4972544	LTR/ERVL	1353	+	90	4972455	87645
chr9	4884787	5084787	harbor2	chr9	4971442	4971760	LTR/ERVL	1353	+	159	4971601	86814
chr9	4884787	5084787	harbor2	chr9	4972365	4972544	LTR/ERVL	1353	+	90	4972455	87668
chr9	95415629	95615629	harbor2	chr9	95430638	95430831	LTR/ERVL	551	+	96	95430734	15105
chr9	95415629	95615629	harbor2	chr9	95430868	95431012	LTR/ERVL	591	+	72	95430940	15311
chr9	95415629	95615629	harbor2	chr9	95434424	95434622	LTR/ERVL	672	+	99	95434523	18894
chr9	35836326	36036326	harbor2	chr9	35868147	35868560	LTR/ERVL	2774	+	206	35868353	32027
chr9	4884811	5084811	harbor2	chr9	4971442	4971760	LTR/ERVL	1353	+	159	4971601	86790
chr9	4884811	5084811	harbor2	chr9	4972365	4972544	LTR/ERVL	1353	+	90	4972455	87644
chr9	4884812	5084812	harbor2	chr9	4971442	4971760	LTR/ERVL	1353	+	159	4971601	86789
chr9	4884812	5084812	harbor2	chr9	4972365	4972544	LTR/ERVL	1353	+	90	4972455	87643
chr9	133063996	133263996	harbor2	chr9	133156878	133157011	LTR/ERVL	611	+	66	133156944	92948
chr9	133063996	133263996	harbor2	chr9	133157311	133157462	LTR/ERVL	611	+	76	133157387	93391
chr9	4884741	5084741	harbor2	chr9	4971442	4971760	LTR/ERVL	1353	+	159	4971601	86860
chr9	4884741	5084741	harbor2	chr9	4972365	4972544	LTR/ERVL	1353	+	90	4972455	87714
chr9	133063986	133263986	harbor2	chr9	133156878	133157011	LTR/ERVL	611	+	66	133156944	92958
chr9	133063986	133263986	harbor2	chr9	133157311	133157462	LTR/ERVL	611	+	76	133157387	93401
chr9	115857318	116057318	harbor2	chr9	115916294	115916709	LTR/ERVL	1340	+	208	115916502	59184
chr9	4884717	5084717	harbor2	chr9	4971442	4971760	LTR/ERVL	1353	+	159	4971601	86884
chr9	4884717	5084717	harbor2	chr9	4972365	4972544	LTR/ERVL	1353	+	90	4972455	87738
chr9	4886228	5086228	harbor2	chr9	4971442	4971760	LTR/ERVL	1353	+	159	4971601	85373
chr9	4886228	5086228	harbor2	chr9	4972365	4972544	LTR/ERVL	1353	+	90	4972455	86227
chr9	4884728	5084728	harbor2	chr9	4971442	4971760	LTR/ERVL	1353	+	159	4971601	86873
chr9	4884728	5084728	harbor2	chr9	4972365	4972544	LTR/ERVL	1353	+	90	4972455	87727
chr9	4692837	4892837	harbor2	chr9	4719472	4719754	LTR/ERVL	1402	+	141	4719613	26776
chr9	4692837	4892837	harbor2	chr9	4767974	4768533	LTR/ERVL	2710	+	280	4768254	75417
chr9	4692837	4892837	harbor2	chr9	4768560	4768598	LTR/ERVL	623	+	19	4768579	75742
chr9	4692837	4892837	harbor2	chr9	4776096	4776156	LTR/ERVL	1756	+	30	4776126	83289
chr9	4692837	4892837	harbor2	chr9	4776449	4776750	LTR/ERVL	1756	+	150	4776599	83762
chr9	4885225	5085225	harbor2	chr9	4971442	4971760	LTR/ERVL	1353	+	159	4971601	86376
chr9	4885225	5085225	harbor2	chr9	4972365	4972544	LTR/ERVL	1353	+	90	4972455	87230
chr9	4698150	4898150	harbor2	chr9	4719472	4719754	LTR/ERVL	1402	+	141	4719613	21463
chr9	4698150	4898150	harbor2	chr9	4767974	4768533	LTR/ERVL	2710	+	280	4768254	70104
chr9	4698150	4898150	harbor2	chr9	4768560	4768598	LTR/ERVL	623	+	19	4768579	70429
chr9	4698150	4898150	harbor2	chr9	4776096	4776156	LTR/ERVL	1756	+	30	4776126	77976
chr9	4698150	4898150	harbor2	chr9	4776449	4776750	LTR/ERVL	1756	+	150	4776599	78449
chr9	4692907	4892907	harbor2	chr9	4719472	4719754	LTR/ERVL	1402	+	141	4719613	26706
chr9	4692907	4892907	harbor2	chr9	4767974	4768533	LTR/ERVL	2710	+	280	4768254	75347
chr9	4692907	4892907	harbor2	chr9	4768560	4768598	LTR/ERVL	623	+	19	4768579	75672
chr9	4692907	4892907	harbor2	chr9	4776096	4776156	LTR/ERVL	1756	+	30	4776126	83219
chr9	4692907	4892907	harbor2	chr9	4776449	4776750	LTR/ERVL	1756	+	150	4776599	83692
chr9	4692711	4892711	harbor2	chr9	4719472	4719754	LTR/ERVL	1402	+	141	4719613	26902
chr9	4692711	4892711	harbor2	chr9	4767974	4768533	LTR/ERVL	2710	+	280	4768254	75543
chr9	4692711	4892711	harbor2	chr9	4768560	4768598	LTR/ERVL	623	+	19	4768579	75868
chr9	4692711	4892711	harbor2	chr9	4776096	4776156	LTR/ERVL	1756	+	30	4776126	83415
chr9	4692711	4892711	harbor2	chr9	4776449	4776750	LTR/ERVL	1756	+	150	4776599	83888
chr9	4884786	5084786	harbor2	chr9	4971442	4971760	LTR/ERVL	1353	+	159	4971601	86815
chr9	4884786	5084786	harbor2	chr9	4972365	4972544	LTR/ERVL	1353	+	90	4972455	87669
chr9	4884857	5084857	harbor2	chr9	4971442	4971760	LTR/ERVL	1353	+	159	4971601	86744
chr9	4884857	5084857	harbor2	chr9	4972365	4972544	LTR/ERVL	1353	+	90	4972455	87598
chr9	1	129256	harbor2	chr9	57588	57794	LTR/ERVL	891	+	103	57691	57690
chr9	1	129256	harbor2	chr9	58216	58448	LTR/ERVL	1535	+	116	58332	58331
chr9	4692877	4892877	harbor2	chr9	4719472	4719754	LTR/ERVL	1402	+	141	4719613	26736
chr9	4692877	4892877	harbor2	chr9	4767974	4768533	LTR/ERVL	2710	+	280	4768254	75377
chr9	4692877	4892877	harbor2	chr9	4768560	4768598	LTR/ERVL	623	+	19	4768579	75702
chr9	4692877	4892877	harbor2	chr9	4776096	4776156	LTR/ERVL	1756	+	30	4776126	83249
chr9	4692877	4892877	harbor2	chr9	4776449	4776750	LTR/ERVL	1756	+	150	4776599	83722
chr9	4884757	5084757	harbor2	chr9	4971442	4971760	LTR/ERVL	1353	+	159	4971601	86844
chr9	4884757	5084757	harbor2	chr9	4972365	4972544	LTR/ERVL	1353	+	90	4972455	87698
chr9	133064003	133264003	harbor2	chr9	133156878	133157011	LTR/ERVL	611	+	66	133156944	92941
chr9	133064003	133264003	harbor2	chr9	133157311	133157462	LTR/ERVL	611	+	76	133157387	93384
chr9	137327951	137527951	harbor2	chr9	137332900	137333444	LTR/ERVL	2368	+	272	137333172	5221
chr9	4693388	4893388	harbor2	chr9	4719472	4719754	LTR/ERVL	1402	+	141	4719613	26225
chr9	4693388	4893388	harbor2	chr9	4767974	4768533	LTR/ERVL	2710	+	280	4768254	74866
chr9	4693388	4893388	harbor2	chr9	4768560	4768598	LTR/ERVL	623	+	19	4768579	75191
chr9	4693388	4893388	harbor2	chr9	4776096	4776156	LTR/ERVL	1756	+	30	4776126	82738
chr9	4693388	4893388	harbor2	chr9	4776449	4776750	LTR/ERVL	1756	+	150	4776599	83211
chr9	4692814	4892814	harbor2	chr9	4719472	4719754	LTR/ERVL	1402	+	141	4719613	26799
chr9	4692814	4892814	harbor2	chr9	4767974	4768533	LTR/ERVL	2710	+	280	4768254	75440
chr9	4692814	4892814	harbor2	chr9	4768560	4768598	LTR/ERVL	623	+	19	4768579	75765
chr9	4692814	4892814	harbor2	chr9	4776096	4776156	LTR/ERVL	1756	+	30	4776126	83312
chr9	4692814	4892814	harbor2	chr9	4776449	4776750	LTR/ERVL	1756	+	150	4776599	83785
chr9	4886219	5086219	harbor2	chr9	4971442	4971760	LTR/ERVL	1353	+	159	4971601	85382
chr9	4886219	5086219	harbor2	chr9	4972365	4972544	LTR/ERVL	1353	+	90	4972455	86236
chr9	4692878	4892878	harbor2	chr9	4719472	4719754	LTR/ERVL	1402	+	141	4719613	26735
chr9	4692878	4892878	harbor2	chr9	4767974	4768533	LTR/ERVL	2710	+	280	4768254	75376
chr9	4692878	4892878	harbor2	chr9	4768560	4768598	LTR/ERVL	623	+	19	4768579	75701
chr9	4692878	4892878	harbor2	chr9	4776096	4776156	LTR/ERVL	1756	+	30	4776126	83248
chr9	4692878	4892878	harbor2	chr9	4776449	4776750	LTR/ERVL	1756	+	150	4776599	83721
chr9	4884862	5084862	harbor2	chr9	4971442	4971760	LTR/ERVL	1353	+	159	4971601	86739
chr9	4884862	5084862	harbor2	chr9	4972365	4972544	LTR/ERVL	1353	+	90	4972455	87593
chr9	4768126	4968126	harbor2	chr9	4767974	4768533	LTR/ERVL	2710	+	280	4768254	128
chr9	4768126	4968126	harbor2	chr9	4768560	4768598	LTR/ERVL	623	+	19	4768579	453
chr9	4768126	4968126	harbor2	chr9	4776096	4776156	LTR/ERVL	1756	+	30	4776126	8000
chr9	4768126	4968126	harbor2	chr9	4776449	4776750	LTR/ERVL	1756	+	150	4776599	8473
chr9	134238720	134438720	harbor2	chr9	134245758	134246174	LTR/ERVL	651	+	208	134245966	7246
chr9	134238720	134438720	harbor2	chr9	134298873	134299385	LTR/ERVL	2822	+	256	134299129	60409
chr9	4692777	4892777	harbor2	chr9	4719472	4719754	LTR/ERVL	1402	+	141	4719613	26836
chr9	4692777	4892777	harbor2	chr9	4767974	4768533	LTR/ERVL	2710	+	280	4768254	75477
chr9	4692777	4892777	harbor2	chr9	4768560	4768598	LTR/ERVL	623	+	19	4768579	75802
chr9	4692777	4892777	harbor2	chr9	4776096	4776156	LTR/ERVL	1756	+	30	4776126	83349
chr9	4692777	4892777	harbor2	chr9	4776449	4776750	LTR/ERVL	1756	+	150	4776599	83822
chr9	4885989	5085989	harbor2	chr9	4971442	4971760	LTR/ERVL	1353	+	159	4971601	85612
chr9	4885989	5085989	harbor2	chr9	4972365	4972544	LTR/ERVL	1353	+	90	4972455	86466
chr9	4692867	4892867	harbor2	chr9	4719472	4719754	LTR/ERVL	1402	+	141	4719613	26746
chr9	4692867	4892867	harbor2	chr9	4767974	4768533	LTR/ERVL	2710	+	280	4768254	75387
chr9	4692867	4892867	harbor2	chr9	4768560	4768598	LTR/ERVL	623	+	19	4768579	75712
chr9	4692867	4892867	harbor2	chr9	4776096	4776156	LTR/ERVL	1756	+	30	4776126	83259
chr9	4692867	4892867	harbor2	chr9	4776449	4776750	LTR/ERVL	1756	+	150	4776599	83732
chr9	4692785	4892785	harbor2	chr9	4719472	4719754	LTR/ERVL	1402	+	141	4719613	26828
chr9	4692785	4892785	harbor2	chr9	4767974	4768533	LTR/ERVL	2710	+	280	4768254	75469
chr9	4692785	4892785	harbor2	chr9	4768560	4768598	LTR/ERVL	623	+	19	4768579	75794
chr9	4692785	4892785	harbor2	chr9	4776096	4776156	LTR/ERVL	1756	+	30	4776126	83341
chr9	4692785	4892785	harbor2	chr9	4776449	4776750	LTR/ERVL	1756	+	150	4776599	83814
chr9	132707943	132907943	harbor2	chr9	132727552	132728042	LTR/ERVL	2122	+	245	132727797	19854
chr9	132707943	132907943	harbor2	chr9	132776784	132776966	LTR/ERVL	594	+	91	132776875	68932
chr9	132707943	132907943	harbor2	chr9	132795000	132795481	LTR/ERVL	1533	+	240	132795240	87297
chr9	137215057	137415057	harbor2	chr9	137249416	137249649	LTR/ERVL	867	+	116	137249532	34475
chr9	137215057	137415057	harbor2	chr9	137249657	137250192	LTR/ERVL	1825	+	268	137249925	34868
chr9	137214578	137414578	harbor2	chr9	137249416	137249649	LTR/ERVL	867	+	116	137249532	34954
chr9	137214578	137414578	harbor2	chr9	137249657	137250192	LTR/ERVL	1825	+	268	137249925	35347
chr9	4884744	5084744	harbor2	chr9	4971442	4971760	LTR/ERVL	1353	+	159	4971601	86857
chr9	4884744	5084744	harbor2	chr9	4972365	4972544	LTR/ERVL	1353	+	90	4972455	87711
chr9	89263404	89463404	harbor2	chr9	89286886	89287630	LTR/ERVL	1781	+	372	89287258	23854
chr9	93152471	93352471	harbor2	chr9	93154383	93154523	LTR/ERVL	508	+	70	93154453	1982
chr9	137214986	137414986	harbor2	chr9	137249416	137249649	LTR/ERVL	867	+	116	137249532	34546
chr9	137214986	137414986	harbor2	chr9	137249657	137250192	LTR/ERVL	1825	+	268	137249925	34939
chr9	134036117	134236117	harbor2	chr9	134111144	134111681	LTR/ERVL	1985	+	268	134111412	75295
chr9	134581107	134781107	harbor2	chr9	134591103	134591633	LTR/ERVL	2328	+	265	134591368	10261
chr9	134581107	134781107	harbor2	chr9	134595533	134595713	LTR/ERVL	563	+	90	134595623	14516
chr9	134581107	134781107	harbor2	chr9	134631242	134631789	LTR/ERVL	1864	+	274	134631516	50409
chr9	134581107	134781107	harbor2	chr9	134647908	134648288	LTR/ERVL	3094	+	190	134648098	66991
chr9	134581107	134781107	harbor2	chr9	134648321	134648377	LTR/ERVL	3094	+	28	134648349	67242
chr9	97885753	98085753	harbor2	chr9	97965278	97965512	LTR/ERVL	769	+	117	97965395	79642
chr9	4698109	4898109	harbor2	chr9	4719472	4719754	LTR/ERVL	1402	+	141	4719613	21504
chr9	4698109	4898109	harbor2	chr9	4767974	4768533	LTR/ERVL	2710	+	280	4768254	70145
chr9	4698109	4898109	harbor2	chr9	4768560	4768598	LTR/ERVL	623	+	19	4768579	70470
chr9	4698109	4898109	harbor2	chr9	4776096	4776156	LTR/ERVL	1756	+	30	4776126	78017
chr9	4698109	4898109	harbor2	chr9	4776449	4776750	LTR/ERVL	1756	+	150	4776599	78490
chr9	4885834	5085834	harbor2	chr9	4971442	4971760	LTR/ERVL	1353	+	159	4971601	85767
chr9	4885834	5085834	harbor2	chr9	4972365	4972544	LTR/ERVL	1353	+	90	4972455	86621
chr9	4698056	4898056	harbor2	chr9	4719472	4719754	LTR/ERVL	1402	+	141	4719613	21557
chr9	4698056	4898056	harbor2	chr9	4767974	4768533	LTR/ERVL	2710	+	280	4768254	70198
chr9	4698056	4898056	harbor2	chr9	4768560	4768598	LTR/ERVL	623	+	19	4768579	70523
chr9	4698056	4898056	harbor2	chr9	4776096	4776156	LTR/ERVL	1756	+	30	4776126	78070
chr9	4698056	4898056	harbor2	chr9	4776449	4776750	LTR/ERVL	1756	+	150	4776599	78543
chr9	94066300	94266300	harbor2	chr9	94106208	94106673	LTR/ERVL	1523	+	232	94106440	40140
chr9	68655476	68855476	harbor2	chr9	68661999	68662160	LTR/ERVL	673	+	80	68662079	6603
chr9	68655476	68855476	harbor2	chr9	68663292	68665299	LTR/ERVL	3516	+	1004	68664296	8820
chr9	68655476	68855476	harbor2	chr9	68667709	68668071	LTR/ERVL	1092	+	181	68667890	12414
chr9	68655476	68855476	harbor2	chr9	68671043	68671520	LTR/ERVL	1601	+	238	68671281	15805
chr9	4884821	5084821	harbor2	chr9	4971442	4971760	LTR/ERVL	1353	+	159	4971601	86780
chr9	4884821	5084821	harbor2	chr9	4972365	4972544	LTR/ERVL	1353	+	90	4972455	87634
chr9	4693327	4893327	harbor2	chr9	4719472	4719754	LTR/ERVL	1402	+	141	4719613	26286
chr9	4693327	4893327	harbor2	chr9	4767974	4768533	LTR/ERVL	2710	+	280	4768254	74927
chr9	4693327	4893327	harbor2	chr9	4768560	4768598	LTR/ERVL	623	+	19	4768579	75252
chr9	4693327	4893327	harbor2	chr9	4776096	4776156	LTR/ERVL	1756	+	30	4776126	82799
chr9	4693327	4893327	harbor2	chr9	4776449	4776750	LTR/ERVL	1756	+	150	4776599	83272
chr9	137221156	137421156	harbor2	chr9	137249416	137249649	LTR/ERVL	867	+	116	137249532	28376
chr9	137221156	137421156	harbor2	chr9	137249657	137250192	LTR/ERVL	1825	+	268	137249925	28769
chr9	137215890	137415890	harbor2	chr9	137249416	137249649	LTR/ERVL	867	+	116	137249532	33642
chr9	137215890	137415890	harbor2	chr9	137249657	137250192	LTR/ERVL	1825	+	268	137249925	34035
chr9	112387609	112587609	harbor2	chr9	112474175	112474321	LTR/ERVL	2525	+	73	112474248	86639
chr9	112387609	112587609	harbor2	chr9	112474401	112474977	LTR/ERVL	2525	+	288	112474689	87080
chr9	112387609	112587609	harbor2	chr9	112483117	112483243	LTR/ERVL	1393	+	63	112483180	95571
chr9	112387609	112587609	harbor2	chr9	112483549	112483647	LTR/ERVL	1393	+	49	112483598	95989
chr9	112387609	112587609	harbor2	chr9	112483945	112484074	LTR/ERVL	1393	+	64	112484009	96400
chr9	4884854	5084854	harbor2	chr9	4971442	4971760	LTR/ERVL	1353	+	159	4971601	86747
chr9	4884854	5084854	harbor2	chr9	4972365	4972544	LTR/ERVL	1353	+	90	4972455	87601
chr9	4884876	5084876	harbor2	chr9	4971442	4971760	LTR/ERVL	1353	+	159	4971601	86725
chr9	4884876	5084876	harbor2	chr9	4972365	4972544	LTR/ERVL	1353	+	90	4972455	87579
chr9	4884809	5084809	harbor2	chr9	4971442	4971760	LTR/ERVL	1353	+	159	4971601	86792
chr9	4884809	5084809	harbor2	chr9	4972365	4972544	LTR/ERVL	1353	+	90	4972455	87646
chr9	125647137	125847137	harbor2	chr9	125731279	125731440	LTR/ERVL	1151	+	80	125731359	84222
chr9	125647137	125847137	harbor2	chr9	125730751	125730968	LTR/ERVL	1151	+	108	125730859	83722
chr9	4886126	5086126	harbor2	chr9	4971442	4971760	LTR/ERVL	1353	+	159	4971601	85475
chr9	4886126	5086126	harbor2	chr9	4972365	4972544	LTR/ERVL	1353	+	90	4972455	86329
chr9	133063985	133263985	harbor2	chr9	133156878	133157011	LTR/ERVL	611	+	66	133156944	92959
chr9	133063985	133263985	harbor2	chr9	133157311	133157462	LTR/ERVL	611	+	76	133157387	93402
chr9	88952836	89152836	harbor2	chr9	89008685	89008957	LTR/ERVL	926	+	136	89008821	55985
chr9	6658753	6858753	harbor2	chr9	6706759	6706836	LTR/ERVL	2171	+	38	6706797	48044
chr9	6658753	6858753	harbor2	chr9	6707124	6707147	LTR/ERVL	2171	+	12	6707136	48383
chr9	6658753	6858753	harbor2	chr9	6707454	6707771	LTR/ERVL	2171	+	158	6707612	48859
chr9	6658753	6858753	harbor2	chr9	6723717	6723818	LTR/ERVL	485	+	50	6723767	65014
chr9	6658753	6858753	harbor2	chr9	6724130	6724498	LTR/ERVL	586	+	184	6724314	65561
chr9	6658753	6858753	harbor2	chr9	6728092	6728247	LTR/ERVL	796	+	78	6728170	69417
chr9	6658753	6858753	harbor2	chr9	6729561	6729827	LTR/ERVL	2146	+	133	6729694	70941
chr9	6658753	6858753	harbor2	chr9	6730130	6730282	LTR/ERVL	2146	+	76	6730206	71453
chr9	6658753	6858753	harbor2	chr9	6733191	6733601	LTR/ERVL	2911	+	205	6733396	74643
chr9	6658753	6858753	harbor2	chr9	6734151	6734287	LTR/ERVL	2911	+	68	6734219	75466
chr9	6658753	6858753	harbor2	chr9	6735169	6735390	LTR/ERVL	737	+	110	6735279	76526
chr9	6658753	6858753	harbor2	chr9	6700799	6701276	LTR/ERVL	1276	+	238	6701037	42284
chr9	137205986	137405986	harbor2	chr9	137249416	137249649	LTR/ERVL	867	+	116	137249532	43546
chr9	137205986	137405986	harbor2	chr9	137249657	137250192	LTR/ERVL	1825	+	268	137249925	43939
chr9	89263414	89463414	harbor2	chr9	89286886	89287630	LTR/ERVL	1781	+	372	89287258	23844
chr9	4692732	4892732	harbor2	chr9	4719472	4719754	LTR/ERVL	1402	+	141	4719613	26881
chr9	4692732	4892732	harbor2	chr9	4767974	4768533	LTR/ERVL	2710	+	280	4768254	75522
chr9	4692732	4892732	harbor2	chr9	4768560	4768598	LTR/ERVL	623	+	19	4768579	75847
chr9	4692732	4892732	harbor2	chr9	4776096	4776156	LTR/ERVL	1756	+	30	4776126	83394
chr9	4692732	4892732	harbor2	chr9	4776449	4776750	LTR/ERVL	1756	+	150	4776599	83867
chr9	4885722	5085722	harbor2	chr9	4971442	4971760	LTR/ERVL	1353	+	159	4971601	85879
chr9	4885722	5085722	harbor2	chr9	4972365	4972544	LTR/ERVL	1353	+	90	4972455	86733
chr9	4729056	4929056	harbor2	chr9	4767974	4768533	LTR/ERVL	2710	+	280	4768254	39198
chr9	4729056	4929056	harbor2	chr9	4768560	4768598	LTR/ERVL	623	+	19	4768579	39523
chr9	4729056	4929056	harbor2	chr9	4776096	4776156	LTR/ERVL	1756	+	30	4776126	47070
chr9	4729056	4929056	harbor2	chr9	4776449	4776750	LTR/ERVL	1756	+	150	4776599	47543
chr9	4692766	4892766	harbor2	chr9	4719472	4719754	LTR/ERVL	1402	+	141	4719613	26847
chr9	4692766	4892766	harbor2	chr9	4767974	4768533	LTR/ERVL	2710	+	280	4768254	75488
chr9	4692766	4892766	harbor2	chr9	4768560	4768598	LTR/ERVL	623	+	19	4768579	75813
chr9	4692766	4892766	harbor2	chr9	4776096	4776156	LTR/ERVL	1756	+	30	4776126	83360
chr9	4692766	4892766	harbor2	chr9	4776449	4776750	LTR/ERVL	1756	+	150	4776599	83833
chr9	4885228	5085228	harbor2	chr9	4971442	4971760	LTR/ERVL	1353	+	159	4971601	86373
chr9	4885228	5085228	harbor2	chr9	4972365	4972544	LTR/ERVL	1353	+	90	4972455	87227
chr9	4889537	5089537	harbor2	chr9	4971442	4971760	LTR/ERVL	1353	+	159	4971601	82064
chr9	4889537	5089537	harbor2	chr9	4972365	4972544	LTR/ERVL	1353	+	90	4972455	82918
chr9	134036890	134236890	harbor2	chr9	134111144	134111681	LTR/ERVL	1985	+	268	134111412	74522
chr9	4885594	5085594	harbor2	chr9	4971442	4971760	LTR/ERVL	1353	+	159	4971601	86007
chr9	4885594	5085594	harbor2	chr9	4972365	4972544	LTR/ERVL	1353	+	90	4972455	86861
chr9	4692826	4892826	harbor2	chr9	4719472	4719754	LTR/ERVL	1402	+	141	4719613	26787
chr9	4692826	4892826	harbor2	chr9	4767974	4768533	LTR/ERVL	2710	+	280	4768254	75428
chr9	4692826	4892826	harbor2	chr9	4768560	4768598	LTR/ERVL	623	+	19	4768579	75753
chr9	4692826	4892826	harbor2	chr9	4776096	4776156	LTR/ERVL	1756	+	30	4776126	83300
chr9	4692826	4892826	harbor2	chr9	4776449	4776750	LTR/ERVL	1756	+	150	4776599	83773
chr9	137220723	137420723	harbor2	chr9	137249416	137249649	LTR/ERVL	867	+	116	137249532	28809
chr9	137220723	137420723	harbor2	chr9	137249657	137250192	LTR/ERVL	1825	+	268	137249925	29202
chr9	137214559	137414559	harbor2	chr9	137249416	137249649	LTR/ERVL	867	+	116	137249532	34973
chr9	137214559	137414559	harbor2	chr9	137249657	137250192	LTR/ERVL	1825	+	268	137249925	35366
chr9	128003758	128203758	harbor2	chr9	128040205	128040322	LTR/ERVL	860	+	58	128040263	36505
chr9	128003758	128203758	harbor2	chr9	128040609	128040625	LTR/ERVL	860	+	8	128040617	36859
chr9	128003758	128203758	harbor2	chr9	128041138	128041197	LTR/ERVL	860	+	30	128041168	37410
chr9	128003758	128203758	harbor2	chr9	128041197	128041713	LTR/ERVL	2930	+	258	128041455	37697
chr9	128003758	128203758	harbor2	chr9	128056204	128056491	LTR/ERVL	1184	+	144	128056348	52590
chr9	128003758	128203758	harbor2	chr9	128056987	128057287	LTR/ERVL	1072	+	150	128057137	53379
chr9	136558034	136758034	harbor2	chr9	136590693	136591804	LTR/ERVL	899	+	556	136591249	33215
chr9	137217873	137417873	harbor2	chr9	137249416	137249649	LTR/ERVL	867	+	116	137249532	31659
chr9	137217873	137417873	harbor2	chr9	137249657	137250192	LTR/ERVL	1825	+	268	137249925	32052
chr9	4884814	5084814	harbor2	chr9	4971442	4971760	LTR/ERVL	1353	+	159	4971601	86787
chr9	4884814	5084814	harbor2	chr9	4972365	4972544	LTR/ERVL	1353	+	90	4972455	87641
chr9	79474112	79674112	harbor2	chr9	79535421	79535886	LTR/ERVL	1983	+	232	79535653	61541
chr9	79474112	79674112	harbor2	chr9	79553267	79553721	LTR/ERVL	2669	+	227	79553494	79382
chr9	137214917	137414917	harbor2	chr9	137249416	137249649	LTR/ERVL	867	+	116	137249532	34615
chr9	137214917	137414917	harbor2	chr9	137249657	137250192	LTR/ERVL	1825	+	268	137249925	35008
chr9	4692728	4892728	harbor2	chr9	4719472	4719754	LTR/ERVL	1402	+	141	4719613	26885
chr9	4692728	4892728	harbor2	chr9	4767974	4768533	LTR/ERVL	2710	+	280	4768254	75526
chr9	4692728	4892728	harbor2	chr9	4768560	4768598	LTR/ERVL	623	+	19	4768579	75851
chr9	4692728	4892728	harbor2	chr9	4776096	4776156	LTR/ERVL	1756	+	30	4776126	83398
chr9	4692728	4892728	harbor2	chr9	4776449	4776750	LTR/ERVL	1756	+	150	4776599	83871
chr9	137215027	137415027	harbor2	chr9	137249416	137249649	LTR/ERVL	867	+	116	137249532	34505
chr9	137215027	137415027	harbor2	chr9	137249657	137250192	LTR/ERVL	1825	+	268	137249925	34898
chr9	134036110	134236110	harbor2	chr9	134111144	134111681	LTR/ERVL	1985	+	268	134111412	75302
chr9	137180157	137380157	harbor2	chr9	137249416	137249649	LTR/ERVL	867	+	116	137249532	69375
chr9	137180157	137380157	harbor2	chr9	137249657	137250192	LTR/ERVL	1825	+	268	137249925	69768
chr9	84422130	84622130	harbor2	chr9	84449489	84449780	LTR/ERVL	2186	+	146	84449635	27505
chr9	84422130	84622130	harbor2	chr9	84450078	84450320	LTR/ERVL	2186	+	121	84450199	28069
chr9	84422130	84622130	harbor2	chr9	84451098	84451348	LTR/ERVL	2186	+	125	84451223	29093
chr9	84422130	84622130	harbor2	chr9	84473480	84474076	LTR/ERVL	2859	+	298	84473778	51648
chr9	84422130	84622130	harbor2	chr9	84505752	84505899	LTR/ERVL	749	+	74	84505826	83696
chr9	84422130	84622130	harbor2	chr9	84506323	84506484	LTR/ERVL	749	+	80	84506403	84273
chr9	4692827	4892827	harbor2	chr9	4719472	4719754	LTR/ERVL	1402	+	141	4719613	26786
chr9	4692827	4892827	harbor2	chr9	4767974	4768533	LTR/ERVL	2710	+	280	4768254	75427
chr9	4692827	4892827	harbor2	chr9	4768560	4768598	LTR/ERVL	623	+	19	4768579	75752
chr9	4692827	4892827	harbor2	chr9	4776096	4776156	LTR/ERVL	1756	+	30	4776126	83299
chr9	4692827	4892827	harbor2	chr9	4776449	4776750	LTR/ERVL	1756	+	150	4776599	83772
chr9	137177840	137377840	harbor2	chr9	137249416	137249649	LTR/ERVL	867	+	116	137249532	71692
chr9	137177840	137377840	harbor2	chr9	137249657	137250192	LTR/ERVL	1825	+	268	137249925	72085
chr9	97885525	98085525	harbor2	chr9	97965278	97965512	LTR/ERVL	769	+	117	97965395	79870
chr9	4692863	4892863	harbor2	chr9	4719472	4719754	LTR/ERVL	1402	+	141	4719613	26750
chr9	4692863	4892863	harbor2	chr9	4767974	4768533	LTR/ERVL	2710	+	280	4768254	75391
chr9	4692863	4892863	harbor2	chr9	4768560	4768598	LTR/ERVL	623	+	19	4768579	75716
chr9	4692863	4892863	harbor2	chr9	4776096	4776156	LTR/ERVL	1756	+	30	4776126	83263
chr9	4692863	4892863	harbor2	chr9	4776449	4776750	LTR/ERVL	1756	+	150	4776599	83736
chr9	93086535	93286535	harbor2	chr9	93154383	93154523	LTR/ERVL	508	+	70	93154453	67918
chr9	4890034	5090034	harbor2	chr9	4971442	4971760	LTR/ERVL	1353	+	159	4971601	81567
chr9	4890034	5090034	harbor2	chr9	4972365	4972544	LTR/ERVL	1353	+	90	4972455	82421
chr9	137215896	137415896	harbor2	chr9	137249416	137249649	LTR/ERVL	867	+	116	137249532	33636
chr9	137215896	137415896	harbor2	chr9	137249657	137250192	LTR/ERVL	1825	+	268	137249925	34029
chr9	4693547	4893547	harbor2	chr9	4719472	4719754	LTR/ERVL	1402	+	141	4719613	26066
chr9	4693547	4893547	harbor2	chr9	4767974	4768533	LTR/ERVL	2710	+	280	4768254	74707
chr9	4693547	4893547	harbor2	chr9	4768560	4768598	LTR/ERVL	623	+	19	4768579	75032
chr9	4693547	4893547	harbor2	chr9	4776096	4776156	LTR/ERVL	1756	+	30	4776126	82579
chr9	4693547	4893547	harbor2	chr9	4776449	4776750	LTR/ERVL	1756	+	150	4776599	83052
chr9	109520305	109720305	harbor2	chr9	109560418	109560993	LTR/ERVL	673	+	288	109560706	40401
chr9	109520305	109720305	harbor2	chr9	109575221	109575493	LTR/ERVL	958	+	136	109575357	55052
chr9	109520305	109720305	harbor2	chr9	109600126	109600557	LTR/ERVL	1288	+	216	109600342	80037
chr9	109520305	109720305	harbor2	chr9	109601153	109601197	LTR/ERVL	2722	+	22	109601175	80870
chr9	109520305	109720305	harbor2	chr9	109601310	109601918	LTR/ERVL	2722	+	304	109601614	81309
chr9	109520305	109720305	harbor2	chr9	109602208	109602348	LTR/ERVL	2722	+	70	109602278	81973
chr9	109520305	109720305	harbor2	chr9	109615755	109616302	LTR/ERVL	2221	+	274	109616029	95724
chr9	112387187	112587187	harbor2	chr9	112474175	112474321	LTR/ERVL	2525	+	73	112474248	87061
chr9	112387187	112587187	harbor2	chr9	112474401	112474977	LTR/ERVL	2525	+	288	112474689	87502
chr9	112387187	112587187	harbor2	chr9	112483117	112483243	LTR/ERVL	1393	+	63	112483180	95993
chr9	112387187	112587187	harbor2	chr9	112483549	112483647	LTR/ERVL	1393	+	49	112483598	96411
chr9	112387187	112587187	harbor2	chr9	112483945	112484074	LTR/ERVL	1393	+	64	112484009	96822
chr9	4693361	4893361	harbor2	chr9	4719472	4719754	LTR/ERVL	1402	+	141	4719613	26252
chr9	4693361	4893361	harbor2	chr9	4767974	4768533	LTR/ERVL	2710	+	280	4768254	74893
chr9	4693361	4893361	harbor2	chr9	4768560	4768598	LTR/ERVL	623	+	19	4768579	75218
chr9	4693361	4893361	harbor2	chr9	4776096	4776156	LTR/ERVL	1756	+	30	4776126	82765
chr9	4693361	4893361	harbor2	chr9	4776449	4776750	LTR/ERVL	1756	+	150	4776599	83238
chr9	112420689	112620689	harbor2	chr9	112474175	112474321	LTR/ERVL	2525	+	73	112474248	53559
chr9	112420689	112620689	harbor2	chr9	112474401	112474977	LTR/ERVL	2525	+	288	112474689	54000
chr9	112420689	112620689	harbor2	chr9	112483117	112483243	LTR/ERVL	1393	+	63	112483180	62491
chr9	112420689	112620689	harbor2	chr9	112483549	112483647	LTR/ERVL	1393	+	49	112483598	62909
chr9	112420689	112620689	harbor2	chr9	112483945	112484074	LTR/ERVL	1393	+	64	112484009	63320
chr9	4692842	4892842	harbor2	chr9	4719472	4719754	LTR/ERVL	1402	+	141	4719613	26771
chr9	4692842	4892842	harbor2	chr9	4767974	4768533	LTR/ERVL	2710	+	280	4768254	75412
chr9	4692842	4892842	harbor2	chr9	4768560	4768598	LTR/ERVL	623	+	19	4768579	75737
chr9	4692842	4892842	harbor2	chr9	4776096	4776156	LTR/ERVL	1756	+	30	4776126	83284
chr9	4692842	4892842	harbor2	chr9	4776449	4776750	LTR/ERVL	1756	+	150	4776599	83757
chr9	112389364	112589364	harbor2	chr9	112474175	112474321	LTR/ERVL	2525	+	73	112474248	84884
chr9	112389364	112589364	harbor2	chr9	112474401	112474977	LTR/ERVL	2525	+	288	112474689	85325
chr9	112389364	112589364	harbor2	chr9	112483117	112483243	LTR/ERVL	1393	+	63	112483180	93816
chr9	112389364	112589364	harbor2	chr9	112483549	112483647	LTR/ERVL	1393	+	49	112483598	94234
chr9	112389364	112589364	harbor2	chr9	112483945	112484074	LTR/ERVL	1393	+	64	112484009	94645
chr9	4884868	5084868	harbor2	chr9	4971442	4971760	LTR/ERVL	1353	+	159	4971601	86733
chr9	4884868	5084868	harbor2	chr9	4972365	4972544	LTR/ERVL	1353	+	90	4972455	87587
chr9	34156759	34356759	harbor2	chr9	34171781	34172004	LTR/ERVL	788	+	112	34171893	15134
chr9	6658524	6858524	harbor2	chr9	6706759	6706836	LTR/ERVL	2171	+	38	6706797	48273
chr9	6658524	6858524	harbor2	chr9	6707124	6707147	LTR/ERVL	2171	+	12	6707136	48612
chr9	6658524	6858524	harbor2	chr9	6707454	6707771	LTR/ERVL	2171	+	158	6707612	49088
chr9	6658524	6858524	harbor2	chr9	6723717	6723818	LTR/ERVL	485	+	50	6723767	65243
chr9	6658524	6858524	harbor2	chr9	6724130	6724498	LTR/ERVL	586	+	184	6724314	65790
chr9	6658524	6858524	harbor2	chr9	6728092	6728247	LTR/ERVL	796	+	78	6728170	69646
chr9	6658524	6858524	harbor2	chr9	6729561	6729827	LTR/ERVL	2146	+	133	6729694	71170
chr9	6658524	6858524	harbor2	chr9	6730130	6730282	LTR/ERVL	2146	+	76	6730206	71682
chr9	6658524	6858524	harbor2	chr9	6733191	6733601	LTR/ERVL	2911	+	205	6733396	74872
chr9	6658524	6858524	harbor2	chr9	6734151	6734287	LTR/ERVL	2911	+	68	6734219	75695
chr9	6658524	6858524	harbor2	chr9	6735169	6735390	LTR/ERVL	737	+	110	6735279	76755
chr9	6658524	6858524	harbor2	chr9	6700799	6701276	LTR/ERVL	1276	+	238	6701037	42513
chr9	22257300	22457300	harbor2	chr9	22268377	22268655	LTR/ERVL	495	+	139	22268516	11216
chr9	22257300	22457300	harbor2	chr9	22287261	22287828	LTR/ERVL	487	+	284	22287545	30245
chr9	22257300	22457300	harbor2	chr9	22321644	22322051	LTR/ERVL	1169	+	204	22321848	64548
chr9	22257300	22457300	harbor2	chr9	22322053	22322563	LTR/ERVL	2118	+	255	22322308	65008
chr9	22257300	22457300	harbor2	chr9	22323122	22323283	LTR/ERVL	570	+	80	22323202	65902
chr9	135951490	136151490	harbor2	chr9	135964526	135964734	LTR/ERVL	538	+	104	135964630	13140
chr9	135951490	136151490	harbor2	chr9	135976221	135976978	LTR/ERVL	2707	+	378	135976599	25109
chr9	4692856	4892856	harbor2	chr9	4719472	4719754	LTR/ERVL	1402	+	141	4719613	26757
chr9	4692856	4892856	harbor2	chr9	4767974	4768533	LTR/ERVL	2710	+	280	4768254	75398
chr9	4692856	4892856	harbor2	chr9	4768560	4768598	LTR/ERVL	623	+	19	4768579	75723
chr9	4692856	4892856	harbor2	chr9	4776096	4776156	LTR/ERVL	1756	+	30	4776126	83270
chr9	4692856	4892856	harbor2	chr9	4776449	4776750	LTR/ERVL	1756	+	150	4776599	83743
chr9	4692823	4892823	harbor2	chr9	4719472	4719754	LTR/ERVL	1402	+	141	4719613	26790
chr9	4692823	4892823	harbor2	chr9	4767974	4768533	LTR/ERVL	2710	+	280	4768254	75431
chr9	4692823	4892823	harbor2	chr9	4768560	4768598	LTR/ERVL	623	+	19	4768579	75756
chr9	4692823	4892823	harbor2	chr9	4776096	4776156	LTR/ERVL	1756	+	30	4776126	83303
chr9	4692823	4892823	harbor2	chr9	4776449	4776750	LTR/ERVL	1756	+	150	4776599	83776
chr9	4884895	5084895	harbor2	chr9	4971442	4971760	LTR/ERVL	1353	+	159	4971601	86706
chr9	4884895	5084895	harbor2	chr9	4972365	4972544	LTR/ERVL	1353	+	90	4972455	87560
chr9	128003757	128203757	harbor2	chr9	128040205	128040322	LTR/ERVL	860	+	58	128040263	36506
chr9	128003757	128203757	harbor2	chr9	128040609	128040625	LTR/ERVL	860	+	8	128040617	36860
chr9	128003757	128203757	harbor2	chr9	128041138	128041197	LTR/ERVL	860	+	30	128041168	37411
chr9	128003757	128203757	harbor2	chr9	128041197	128041713	LTR/ERVL	2930	+	258	128041455	37698
chr9	128003757	128203757	harbor2	chr9	128056204	128056491	LTR/ERVL	1184	+	144	128056348	52591
chr9	128003757	128203757	harbor2	chr9	128056987	128057287	LTR/ERVL	1072	+	150	128057137	53380
chr9	65482190	65682190	harbor2	chr9	65495012	65495555	LTR/ERVL	2644	+	272	65495284	13094
chr9	65482190	65682190	harbor2	chr9	65505414	65505501	LTR/ERVL	4155	+	44	65505458	23268
chr9	65482190	65682190	harbor2	chr9	65505809	65506540	LTR/ERVL	4155	+	366	65506175	23985
chr9	65482190	65682190	harbor2	chr9	65522733	65523252	LTR/ERVL	1914	+	260	65522993	40803
chr9	65482190	65682190	harbor2	chr9	65536724	65537071	LTR/ERVL	1231	+	174	65536898	54708
chr9	137215352	137415352	harbor2	chr9	137249416	137249649	LTR/ERVL	867	+	116	137249532	34180
chr9	137215352	137415352	harbor2	chr9	137249657	137250192	LTR/ERVL	1825	+	268	137249925	34573
chr9	4885406	5085406	harbor2	chr9	4971442	4971760	LTR/ERVL	1353	+	159	4971601	86195
chr9	4885406	5085406	harbor2	chr9	4972365	4972544	LTR/ERVL	1353	+	90	4972455	87049
chr9	113809675	114009675	harbor2	chr9	113822454	113822934	LTR/ERVL	2226	+	240	113822694	13019
chr9	113809675	114009675	harbor2	chr9	113854089	113854581	LTR/ERVL	1643	+	246	113854335	44660
chr9	133063982	133263982	harbor2	chr9	133156878	133157011	LTR/ERVL	611	+	66	133156944	92962
chr9	133063982	133263982	harbor2	chr9	133157311	133157462	LTR/ERVL	611	+	76	133157387	93405
chr9	97885737	98085737	harbor2	chr9	97965278	97965512	LTR/ERVL	769	+	117	97965395	79658
chr9	133936073	134136073	harbor2	chr9	134005309	134005829	LTR/ERVL	803	+	260	134005569	69496
chr9	133936073	134136073	harbor2	chr9	134010148	134010798	LTR/ERVL	1139	+	325	134010473	74400
chr9	133936073	134136073	harbor2	chr9	134015217	134015458	LTR/ERVL	851	+	120	134015337	79264
chr9	4693426	4893426	harbor2	chr9	4719472	4719754	LTR/ERVL	1402	+	141	4719613	26187
chr9	4693426	4893426	harbor2	chr9	4767974	4768533	LTR/ERVL	2710	+	280	4768254	74828
chr9	4693426	4893426	harbor2	chr9	4768560	4768598	LTR/ERVL	623	+	19	4768579	75153
chr9	4693426	4893426	harbor2	chr9	4776096	4776156	LTR/ERVL	1756	+	30	4776126	82700
chr9	4693426	4893426	harbor2	chr9	4776449	4776750	LTR/ERVL	1756	+	150	4776599	83173
chr9	4692886	4892886	harbor2	chr9	4719472	4719754	LTR/ERVL	1402	+	141	4719613	26727
chr9	4692886	4892886	harbor2	chr9	4767974	4768533	LTR/ERVL	2710	+	280	4768254	75368
chr9	4692886	4892886	harbor2	chr9	4768560	4768598	LTR/ERVL	623	+	19	4768579	75693
chr9	4692886	4892886	harbor2	chr9	4776096	4776156	LTR/ERVL	1756	+	30	4776126	83240
chr9	4692886	4892886	harbor2	chr9	4776449	4776750	LTR/ERVL	1756	+	150	4776599	83713
chr9	83804284	84004284	harbor2	chr9	83843916	83844347	LTR/ERVL	2599	+	216	83844132	39848
chr9	83804284	84004284	harbor2	chr9	83844376	83844415	LTR/ERVL	2599	+	20	83844396	40112
chr9	83804284	84004284	harbor2	chr9	83844416	83844772	LTR/ERVL	2889	+	178	83844594	40310
chr9	83804284	84004284	harbor2	chr9	83844763	83847560	LTR/ERVL	22653	+	1398	83846161	41877
chr9	83804284	84004284	harbor2	chr9	83847561	83847951	LTR/ERVL	2765	+	195	83847756	43472
chr9	83804284	84004284	harbor2	chr9	83894355	83894889	LTR/ERVL	2592	+	267	83894622	90338
chr9	4885226	5085226	harbor2	chr9	4971442	4971760	LTR/ERVL	1353	+	159	4971601	86375
chr9	4885226	5085226	harbor2	chr9	4972365	4972544	LTR/ERVL	1353	+	90	4972455	87229
chr9	4693750	4893750	harbor2	chr9	4719472	4719754	LTR/ERVL	1402	+	141	4719613	25863
chr9	4693750	4893750	harbor2	chr9	4767974	4768533	LTR/ERVL	2710	+	280	4768254	74504
chr9	4693750	4893750	harbor2	chr9	4768560	4768598	LTR/ERVL	623	+	19	4768579	74829
chr9	4693750	4893750	harbor2	chr9	4776096	4776156	LTR/ERVL	1756	+	30	4776126	82376
chr9	4693750	4893750	harbor2	chr9	4776449	4776750	LTR/ERVL	1756	+	150	4776599	82849
chr9	4694585	4894585	harbor2	chr9	4719472	4719754	LTR/ERVL	1402	+	141	4719613	25028
chr9	4694585	4894585	harbor2	chr9	4767974	4768533	LTR/ERVL	2710	+	280	4768254	73669
chr9	4694585	4894585	harbor2	chr9	4768560	4768598	LTR/ERVL	623	+	19	4768579	73994
chr9	4694585	4894585	harbor2	chr9	4776096	4776156	LTR/ERVL	1756	+	30	4776126	81541
chr9	4694585	4894585	harbor2	chr9	4776449	4776750	LTR/ERVL	1756	+	150	4776599	82014
chr10	102141575	102341575	harbor2	chr10	102207252	102207551	LTR/ERVL	1170	+	150	102207402	65827
chr10	102141575	102341575	harbor2	chr10	102207863	102208054	LTR/ERVL	1170	+	96	102207959	66384
chr10	131311970	131511970	harbor2	chr10	131378281	131378594	LTR/ERVL	878	+	156	131378437	66467
chr10	131311970	131511970	harbor2	chr10	131400841	131401289	LTR/ERVL	1866	+	224	131401065	89095
chr10	78867019	79067019	harbor2	chr10	78874011	78874558	LTR/ERVL	2181	+	274	78874285	7266
chr10	78867019	79067019	harbor2	chr10	78877076	78877820	LTR/ERVL	1342	+	372	78877448	10429
chr10	78867019	79067019	harbor2	chr10	78945719	78946148	LTR/ERVL	1017	+	214	78945933	78914
chr10	132611286	132811286	harbor2	chr10	132672117	132672275	LTR/ERVL	974	+	79	132672196	60910
chr10	581042	781042	harbor2	chr10	596946	597395	LTR/ERVL	667	+	224	597170	16128
chr10	127453941	127653941	harbor2	chr10	127455363	127455705	LTR/ERVL	1910	+	171	127455534	1593
chr10	127453941	127653941	harbor2	chr10	127472982	127473587	LTR/ERVL	1770	+	302	127473284	19343
chr10	127453941	127653941	harbor2	chr10	127486207	127486509	LTR/ERVL	474	+	151	127486358	32417
chr10	75435110	75635110	harbor2	chr10	75533061	75533796	LTR/ERVL	1685	+	368	75533429	98319
chr10	14854190	15054190	harbor2	chr10	14953060	14953257	LTR/ERVL	500	+	98	14953158	98968
chr10	14854190	15054190	harbor2	chr10	14953282	14953680	LTR/ERVL	656	+	199	14953481	99291
chr10	14854190	15054190	harbor2	chr10	14941945	14942419	LTR/ERVL	931	+	237	14942182	87992
chr10	37994305	38194305	harbor2	chr10	37994729	37994835	LTR/ERVL	562	+	53	37994782	477
chr10	37994305	38194305	harbor2	chr10	38002471	38002782	LTR/ERVL	754	+	156	38002627	8322
chr10	37994305	38194305	harbor2	chr10	38007387	38007855	LTR/ERVL	1946	+	234	38007621	13316
chr10	37994305	38194305	harbor2	chr10	38060194	38060682	LTR/ERVL	1815	+	244	38060438	66133
chr10	14778679	14978679	harbor2	chr10	14833194	14833598	LTR/ERVL	1299	+	202	14833396	54717
chr10	69780869	69980869	harbor2	chr10	69787806	69788175	LTR/ERVL	747	+	184	69787990	7121
chr10	122468309	122668309	harbor2	chr10	122525279	122525738	LTR/ERVL	2207	+	230	122525509	57200
chr10	123058794	123258794	harbor2	chr10	123119091	123119550	LTR/ERVL	844	+	230	123119321	60527
chr10	97402344	97602344	harbor2	chr10	97416525	97416845	LTR/ERVL	734	+	160	97416685	14341
chr10	97402344	97602344	harbor2	chr10	97418119	97418131	LTR/ERVL	734	+	6	97418125	15781
chr10	23091420	23291420	harbor2	chr10	23106449	23106906	LTR/ERVL	1088	+	228	23106677	15257
chr10	23091420	23291420	harbor2	chr10	23128559	23128793	LTR/ERVL	478	+	117	23128676	37256
chr10	116171415	116371415	harbor2	chr10	116185417	116185797	LTR/ERVL	901	+	190	116185607	14192
chr10	75114221	75314221	harbor2	chr10	75206219	75206389	LTR/ERVL	1753	+	85	75206304	92083
chr10	75114221	75314221	harbor2	chr10	75207534	75207864	LTR/ERVL	1753	+	165	75207699	93478
chr10	132235041	132435041	harbor2	chr10	132236606	132236781	LTR/ERVL	693	+	88	132236694	1653
chr10	14778642	14978642	harbor2	chr10	14833194	14833598	LTR/ERVL	1299	+	202	14833396	54754
chr10	45280422	45480422	harbor2	chr10	45336528	45336967	LTR/ERVL	3378	+	220	45336748	56326
chr10	45280422	45480422	harbor2	chr10	45336971	45338269	LTR/ERVL	32828	+	649	45337620	57198
chr10	45280422	45480422	harbor2	chr10	45338385	45341477	LTR/ERVL	32828	+	1546	45339931	59509
chr10	45280422	45480422	harbor2	chr10	45354971	45355142	LTR/ERVL	870	+	86	45355057	74635
chr10	102141599	102341599	harbor2	chr10	102207252	102207551	LTR/ERVL	1170	+	150	102207402	65803
chr10	102141599	102341599	harbor2	chr10	102207863	102208054	LTR/ERVL	1170	+	96	102207959	66360
chr10	102145388	102345388	harbor2	chr10	102207252	102207551	LTR/ERVL	1170	+	150	102207402	62014
chr10	102145388	102345388	harbor2	chr10	102207863	102208054	LTR/ERVL	1170	+	96	102207959	62571
chr10	102141601	102341601	harbor2	chr10	102207252	102207551	LTR/ERVL	1170	+	150	102207402	65801
chr10	102141601	102341601	harbor2	chr10	102207863	102208054	LTR/ERVL	1170	+	96	102207959	66358
chr10	14778676	14978676	harbor2	chr10	14833194	14833598	LTR/ERVL	1299	+	202	14833396	54720
chr10	17824143	18024143	harbor2	chr10	17916860	17916912	LTR/ERVL	437	+	26	17916886	92743
chr10	10133183	10333183	harbor2	chr10	10144949	10145298	LTR/ERVL	747	+	174	10145123	11940
chr10	10133183	10333183	harbor2	chr10	10186862	10187095	LTR/ERVL	496	+	116	10186978	53795
chr10	117192768	117392768	harbor2	chr10	117194187	117194373	LTR/ERVL	2317	+	93	117194280	1512
chr10	117192768	117392768	harbor2	chr10	117213250	117213608	LTR/ERVL	1320	+	179	117213429	20661
chr10	117192768	117392768	harbor2	chr10	117194747	117195134	LTR/ERVL	2317	+	194	117194941	2173
chr10	62705914	62905914	harbor2	chr10	62725059	62725606	LTR/ERVL	788	+	274	62725333	19419
chr10	2968256	3168256	harbor2	chr10	3018602	3018902	LTR/ERVL	1029	+	150	3018752	50496
chr10	2968256	3168256	harbor2	chr10	3019154	3019307	LTR/ERVL	2037	+	76	3019230	50974
chr10	2968256	3168256	harbor2	chr10	3019587	3019871	LTR/ERVL	2037	+	142	3019729	51473
chr10	2968256	3168256	harbor2	chr10	3019943	3020366	LTR/ERVL	512	+	212	3020155	51899
chr10	2968256	3168256	harbor2	chr10	3020658	3020902	LTR/ERVL	459	+	122	3020780	52524
chr10	89246928	89446928	harbor2	chr10	89270016	89271779	LTR/ERVL	6419	+	882	89270898	23970
chr10	89246928	89446928	harbor2	chr10	89274256	89274702	LTR/ERVL	831	+	223	89274479	27551
chr10	89246928	89446928	harbor2	chr10	89275040	89275666	LTR/ERVL	2523	+	313	89275353	28425
chr10	131310675	131510675	harbor2	chr10	131378281	131378594	LTR/ERVL	878	+	156	131378437	67762
chr10	131310675	131510675	harbor2	chr10	131400841	131401289	LTR/ERVL	1866	+	224	131401065	90390
chr10	106074072	106274072	harbor2	chr10	106086508	106086907	LTR/ERVL	849	+	200	106086708	12636
chr10	106074072	106274072	harbor2	chr10	106100854	106101123	LTR/ERVL	537	+	134	106100988	26916
chr10	106074072	106274072	harbor2	chr10	106101850	106102043	LTR/ERVL	471	+	96	106101946	27874
chr10	106074072	106274072	harbor2	chr10	106102265	106102431	LTR/ERVL	434	+	83	106102348	28276
chr10	106074072	106274072	harbor2	chr10	106105425	106105664	LTR/ERVL	425	+	120	106105545	31473
chr10	106074072	106274072	harbor2	chr10	106106344	106106655	LTR/ERVL	691	+	156	106106500	32428
chr10	106074072	106274072	harbor2	chr10	106107197	106107561	LTR/ERVL	691	+	182	106107379	33307
chr10	106074072	106274072	harbor2	chr10	106109134	106109366	LTR/ERVL	863	+	116	106109250	35178
chr10	95990339	96190339	harbor2	chr10	96002070	96002363	LTR/ERVL	553	+	146	96002216	11877
chr10	95990339	96190339	harbor2	chr10	96010291	96010402	LTR/ERVL	526	+	56	96010347	20008
chr10	95990339	96190339	harbor2	chr10	96077721	96077929	LTR/ERVL	647	+	104	96077825	87486
chr10	113237565	113437565	harbor2	chr10	113292988	113293409	LTR/ERVL	1422	+	210	113293198	55633
chr10	113237565	113437565	harbor2	chr10	113319966	113320190	LTR/ERVL	913	+	112	113320078	82513
chr10	97418040	97618040	harbor2	chr10	97418119	97418131	LTR/ERVL	734	+	6	97418125	85
chr10	97399405	97599405	harbor2	chr10	97416525	97416845	LTR/ERVL	734	+	160	97416685	17280
chr10	97399405	97599405	harbor2	chr10	97418119	97418131	LTR/ERVL	734	+	6	97418125	18720
chr10	132233360	132433360	harbor2	chr10	132236606	132236781	LTR/ERVL	693	+	88	132236694	3334
chr10	13341913	13541913	harbor2	chr10	13433340	13433730	LTR/ERVL	3121	+	195	13433535	91622
chr10	92352968	92552968	harbor2	chr10	92373335	92373426	LTR/ERVL	3087	+	46	92373381	20413
chr10	92352968	92552968	harbor2	chr10	92372696	92373074	LTR/ERVL	3087	+	189	92372885	19917
chr10	97398820	97598820	harbor2	chr10	97416525	97416845	LTR/ERVL	734	+	160	97416685	17865
chr10	97398820	97598820	harbor2	chr10	97418119	97418131	LTR/ERVL	734	+	6	97418125	19305
chr10	46182886	46382886	harbor2	chr10	46206935	46207209	LTR/ERVL	1533	+	137	46207072	24186
chr10	46182886	46382886	harbor2	chr10	46222719	46222949	LTR/ERVL	1070	+	115	46222834	39948
chr10	46182886	46382886	harbor2	chr10	46280885	46281162	LTR/ERVL	444	+	138	46281023	98137
chr10	43505466	43705466	harbor2	chr10	43506142	43506231	LTR/ERVL	1856	+	44	43506186	720
chr10	43505466	43705466	harbor2	chr10	43506532	43506867	LTR/ERVL	1856	+	168	43506700	1234
chr10	43505466	43705466	harbor2	chr10	43507837	43508293	LTR/ERVL	1975	+	228	43508065	2599
chr10	43505466	43705466	harbor2	chr10	43508301	43508526	LTR/ERVL	1994	+	112	43508413	2947
chr10	43505466	43705466	harbor2	chr10	43508868	43508924	LTR/ERVL	1994	+	28	43508896	3430
chr10	43505466	43705466	harbor2	chr10	43509210	43509420	LTR/ERVL	1994	+	105	43509315	3849
chr10	43505466	43705466	harbor2	chr10	43516880	43518522	LTR/ERVL	8892	+	821	43517701	12235
chr10	132020269	132220269	harbor2	chr10	132029247	132029440	LTR/ERVL	485	+	96	132029343	9074
chr10	132020269	132220269	harbor2	chr10	132031937	132032287	LTR/ERVL	3957	+	175	132032112	11843
chr10	132020269	132220269	harbor2	chr10	132032593	132032956	LTR/ERVL	3957	+	182	132032775	12506
chr10	132020269	132220269	harbor2	chr10	132033252	132034188	LTR/ERVL	3957	+	468	132033720	13451
chr10	132020269	132220269	harbor2	chr10	132034553	132034739	LTR/ERVL	3957	+	93	132034646	14377
chr10	132020269	132220269	harbor2	chr10	132034867	132035149	LTR/ERVL	3957	+	141	132035008	14739
chr10	132020269	132220269	harbor2	chr10	132035489	132035971	LTR/ERVL	937	+	241	132035730	15461
chr10	75308135	75508135	harbor2	chr10	75366632	75367021	LTR/ERVL	1328	+	194	75366826	58691
chr10	75308135	75508135	harbor2	chr10	75373092	75373456	LTR/ERVL	870	+	182	75373274	65139
chr10	22337523	22537523	harbor2	chr10	22422045	22422318	LTR/ERVL	891	+	136	22422181	84658
chr10	22337523	22537523	harbor2	chr10	22422513	22423020	LTR/ERVL	1081	+	254	22422767	85244
chr10	22337523	22537523	harbor2	chr10	22423056	22423267	LTR/ERVL	1365	+	106	22423162	85639
chr10	22337523	22537523	harbor2	chr10	22423572	22424185	LTR/ERVL	1490	+	306	22423878	86355
chr10	22337523	22537523	harbor2	chr10	22424157	22425533	LTR/ERVL	1914	+	688	22424845	87322
chr10	46916741	47116741	harbor2	chr10	46962805	46963318	LTR/ERVL	669	+	256	46963061	46320
chr10	46916741	47116741	harbor2	chr10	46976966	46977379	LTR/ERVL	2309	+	206	46977172	60431
chr10	46916741	47116741	harbor2	chr10	46977386	46982057	LTR/ERVL	23985	+	2336	46979722	62981
chr10	132233977	132433977	harbor2	chr10	132236606	132236781	LTR/ERVL	693	+	88	132236694	2717
chr10	5312490	5512490	harbor2	chr10	5407068	5407441	LTR/ERVL	1425	+	186	5407254	94764
chr10	47240671	47440671	harbor2	chr10	47260935	47261519	LTR/ERVL	3035	+	292	47261227	20556
chr10	47240671	47440671	harbor2	chr10	47271574	47272078	LTR/ERVL	2811	+	252	47271826	31155
chr10	47240671	47440671	harbor2	chr10	47334608	47334936	LTR/ERVL	548	+	164	47334772	94101
chr10	47240671	47440671	harbor2	chr10	47337297	47337712	LTR/ERVL	1934	+	208	47337505	96834
chr10	75111455	75311455	harbor2	chr10	75206219	75206389	LTR/ERVL	1753	+	85	75206304	94849
chr10	75111455	75311455	harbor2	chr10	75207534	75207864	LTR/ERVL	1753	+	165	75207699	96244
chr10	131310707	131510707	harbor2	chr10	131378281	131378594	LTR/ERVL	878	+	156	131378437	67730
chr10	131310707	131510707	harbor2	chr10	131400841	131401289	LTR/ERVL	1866	+	224	131401065	90358
chr10	78867018	79067018	harbor2	chr10	78874011	78874558	LTR/ERVL	2181	+	274	78874285	7267
chr10	78867018	79067018	harbor2	chr10	78877076	78877820	LTR/ERVL	1342	+	372	78877448	10430
chr10	78867018	79067018	harbor2	chr10	78945719	78946148	LTR/ERVL	1017	+	214	78945933	78915
chr10	77307204	77507204	harbor2	chr10	77375652	77376015	LTR/ERVL	703	+	182	77375834	68630
chr10	132358619	132558619	harbor2	chr10	132381015	132381551	LTR/ERVL	1864	+	268	132381283	22664
chr10	132358619	132558619	harbor2	chr10	132434354	132434769	LTR/ERVL	1315	+	208	132434562	75943
chr10	75111531	75311531	harbor2	chr10	75206219	75206389	LTR/ERVL	1753	+	85	75206304	94773
chr10	75111531	75311531	harbor2	chr10	75207534	75207864	LTR/ERVL	1753	+	165	75207699	96168
chr10	62713157	62913157	harbor2	chr10	62725059	62725606	LTR/ERVL	788	+	274	62725333	12176
chr10	132988004	133188004	harbor2	chr10	133026723	133026871	LTR/ERVL	658	+	74	133026797	38793
chr10	132988004	133188004	harbor2	chr10	133026932	133027103	LTR/ERVL	501	+	86	133027018	39014
chr10	132988004	133188004	harbor2	chr10	133027429	133027609	LTR/ERVL	435	+	90	133027519	39515
chr10	29348352	29548352	harbor2	chr10	29436000	29436600	LTR/ERVL	1481	+	300	29436300	87948
chr10	29348352	29548352	harbor2	chr10	29439900	29440305	LTR/ERVL	1415	+	202	29440102	91750
chr10	29348352	29548352	harbor2	chr10	29447577	29447897	LTR/ERVL	1013	+	160	29447737	99385
chr10	97675345	97875345	harbor2	chr10	97695971	97696448	LTR/ERVL	2828	+	238	97696209	20864
chr10	97675345	97875345	harbor2	chr10	97696759	97696829	LTR/ERVL	2828	+	35	97696794	21449
chr10	97675345	97875345	harbor2	chr10	97697148	97697358	LTR/ERVL	2828	+	105	97697253	21908
chr10	97675345	97875345	harbor2	chr10	97698904	97699051	LTR/ERVL	765	+	74	97698978	23633
chr10	97675345	97875345	harbor2	chr10	97699352	97699483	LTR/ERVL	765	+	66	97699418	24073
chr10	97675345	97875345	harbor2	chr10	97701473	97701683	LTR/ERVL	863	+	105	97701578	26233
chr10	97675345	97875345	harbor2	chr10	97701955	97702438	LTR/ERVL	1884	+	242	97702197	26852
chr10	97675345	97875345	harbor2	chr10	97705447	97705640	LTR/ERVL	1183	+	96	97705543	30198
chr10	14782829	14982829	harbor2	chr10	14833194	14833598	LTR/ERVL	1299	+	202	14833396	50567
chr10	35932	235932	harbor2	chr10	68041	68146	LTR/ERVL	691	+	52	68093	32161
chr10	97399404	97599404	harbor2	chr10	97416525	97416845	LTR/ERVL	734	+	160	97416685	17281
chr10	97399404	97599404	harbor2	chr10	97418119	97418131	LTR/ERVL	734	+	6	97418125	18721
chr10	79279921	79479921	harbor2	chr10	79319465	79319902	LTR/ERVL	996	+	218	79319683	39762
chr10	79279921	79479921	harbor2	chr10	79320020	79320454	LTR/ERVL	595	+	217	79320237	40316
chr10	79279921	79479921	harbor2	chr10	79320462	79321531	LTR/ERVL	3234	+	534	79320996	41075
chr10	79279921	79479921	harbor2	chr10	79321633	79322018	LTR/ERVL	970	+	192	79321825	41904
chr10	79279921	79479921	harbor2	chr10	79336763	79337052	LTR/ERVL	876	+	144	79336907	56986
chr10	79279921	79479921	harbor2	chr10	79341954	79342297	LTR/ERVL	869	+	172	79342126	62205
chr10	79279921	79479921	harbor2	chr10	79358580	79358604	LTR/ERVL	2420	+	12	79358592	78671
chr10	79279921	79479921	harbor2	chr10	79358898	79359361	LTR/ERVL	2420	+	232	79359130	79209
chr10	110775618	110975618	harbor2	chr10	110779038	110779798	LTR/ERVL	3995	+	380	110779418	3800
chr10	51860313	52060313	harbor2	chr10	51876611	51877053	LTR/ERVL	1473	+	221	51876832	16519
chr10	51860313	52060313	harbor2	chr10	51882899	51883444	LTR/ERVL	2409	+	272	51883171	22858
chr10	89205746	89405746	harbor2	chr10	89270016	89271779	LTR/ERVL	6419	+	882	89270898	65152
chr10	89205746	89405746	harbor2	chr10	89274256	89274702	LTR/ERVL	831	+	223	89274479	68733
chr10	89205746	89405746	harbor2	chr10	89275040	89275666	LTR/ERVL	2523	+	313	89275353	69607
chr10	46182816	46382816	harbor2	chr10	46206935	46207209	LTR/ERVL	1533	+	137	46207072	24256
chr10	46182816	46382816	harbor2	chr10	46222719	46222949	LTR/ERVL	1070	+	115	46222834	40018
chr10	46182816	46382816	harbor2	chr10	46280885	46281162	LTR/ERVL	444	+	138	46281023	98207
chr10	14778690	14978690	harbor2	chr10	14833194	14833598	LTR/ERVL	1299	+	202	14833396	54706
chr10	48094820	48294820	harbor2	chr10	48098835	48099352	LTR/ERVL	1972	+	258	48099093	4273
chr10	48094820	48294820	harbor2	chr10	48099421	48099563	LTR/ERVL	479	+	71	48099492	4672
chr10	48094820	48294820	harbor2	chr10	48099564	48099717	LTR/ERVL	672	+	76	48099640	4820
chr10	48094820	48294820	harbor2	chr10	48124696	48125209	LTR/ERVL	1423	+	256	48124952	30132
chr10	48094820	48294820	harbor2	chr10	48131305	48131584	LTR/ERVL	1535	+	140	48131445	36625
chr10	48094820	48294820	harbor2	chr10	48146847	48147191	LTR/ERVL	1292	+	172	48147019	52199
chr10	48094820	48294820	harbor2	chr10	48167391	48167665	LTR/ERVL	674	+	137	48167528	72708
chr10	48094820	48294820	harbor2	chr10	48167680	48168124	LTR/ERVL	2026	+	222	48167902	73082
chr10	48094820	48294820	harbor2	chr10	48174212	48174416	LTR/ERVL	517	+	102	48174314	79494
chr10	48094820	48294820	harbor2	chr10	48190159	48190412	LTR/ERVL	570	+	126	48190285	95465
chr10	48094820	48294820	harbor2	chr10	48190438	48190605	LTR/ERVL	438	+	84	48190522	95702
chr10	47240692	47440692	harbor2	chr10	47260935	47261519	LTR/ERVL	3035	+	292	47261227	20535
chr10	47240692	47440692	harbor2	chr10	47271574	47272078	LTR/ERVL	2811	+	252	47271826	31134
chr10	47240692	47440692	harbor2	chr10	47334608	47334936	LTR/ERVL	548	+	164	47334772	94080
chr10	47240692	47440692	harbor2	chr10	47337297	47337712	LTR/ERVL	1934	+	208	47337505	96813
chr10	69473042	69673042	harbor2	chr10	69521020	69521223	LTR/ERVL	1460	+	102	69521122	48080
chr10	69473042	69673042	harbor2	chr10	69521628	69521940	LTR/ERVL	1672	+	156	69521784	48742
chr10	69473042	69673042	harbor2	chr10	69549158	69549593	LTR/ERVL	2026	+	218	69549376	76334
chr10	69473042	69673042	harbor2	chr10	69550797	69551207	LTR/ERVL	720	+	205	69551002	77960
chr10	69473042	69673042	harbor2	chr10	69533685	69534013	LTR/ERVL	1885	+	164	69533849	60807
chr11	133733675	133933675	harbor2	chr11	133736526	133736978	LTR/ERVL	1637	+	226	133736752	3077
chr11	133733675	133933675	harbor2	chr11	133779805	133780133	LTR/ERVL	552	+	164	133779969	46294
chr11	133733675	133933675	harbor2	chr11	133802102	133802203	LTR/ERVL	426	+	50	133802152	68477
chr11	122404333	122604333	harbor2	chr11	122475953	122476080	LTR/ERVL	499	+	64	122476017	71684
chr11	122404333	122604333	harbor2	chr11	122486855	122487356	LTR/ERVL	577	+	250	122487105	82772
chr11	5191705	5391705	harbor2	chr11	5238617	5239149	LTR/ERVL	570	+	266	5238883	47178
chr11	5134523	5334523	harbor2	chr11	5147269	5147661	LTR/ERVL	1627	+	196	5147465	12942
chr11	5127958	5327958	harbor2	chr11	5147269	5147661	LTR/ERVL	1627	+	196	5147465	19507
chr11	5169679	5369679	harbor2	chr11	5238617	5239149	LTR/ERVL	570	+	266	5238883	69204
chr11	5127422	5327422	harbor2	chr11	5147269	5147661	LTR/ERVL	1627	+	196	5147465	20043
chr11	5134276	5334276	harbor2	chr11	5147269	5147661	LTR/ERVL	1627	+	196	5147465	13189
chr11	5188729	5388729	harbor2	chr11	5238617	5239149	LTR/ERVL	570	+	266	5238883	50154
chr11	5181733	5381733	harbor2	chr11	5238617	5239149	LTR/ERVL	570	+	266	5238883	57150
chr11	108021538	108221538	harbor2	chr11	108041018	108041268	LTR/ERVL	805	+	125	108041143	19605
chr11	5127208	5327208	harbor2	chr11	5147269	5147661	LTR/ERVL	1627	+	196	5147465	20257
chr11	5128910	5328910	harbor2	chr11	5147269	5147661	LTR/ERVL	1627	+	196	5147465	18555
chr11	120028317	120228317	harbor2	chr11	120091571	120092002	LTR/ERVL	1500	+	216	120091787	63470
chr11	108021539	108221539	harbor2	chr11	108041018	108041268	LTR/ERVL	805	+	125	108041143	19604
chr11	5133667	5333667	harbor2	chr11	5147269	5147661	LTR/ERVL	1627	+	196	5147465	13798
chr11	6381515	6581515	harbor2	chr11	6384117	6384333	LTR/ERVL	957	+	108	6384225	2710
chr11	6381515	6581515	harbor2	chr11	6426518	6427003	LTR/ERVL	459	+	242	6426760	45245
chr11	5127183	5327183	harbor2	chr11	5147269	5147661	LTR/ERVL	1627	+	196	5147465	20282
chr11	5135332	5335332	harbor2	chr11	5147269	5147661	LTR/ERVL	1627	+	196	5147465	12133
chr11	5226377	5426377	harbor2	chr11	5238617	5239149	LTR/ERVL	570	+	266	5238883	12506
chr11	5134532	5334532	harbor2	chr11	5147269	5147661	LTR/ERVL	1627	+	196	5147465	12933
chr11	113775363	113975363	harbor2	chr11	113847830	113849952	LTR/ERVL	8539	+	1061	113848891	73528
chr11	46138377	46338377	harbor2	chr11	46176715	46177138	LTR/ERVL	1759	+	212	46176927	38550
chr11	46138377	46338377	harbor2	chr11	46177160	46177717	LTR/ERVL	1438	+	278	46177438	39061
chr11	46138377	46338377	harbor2	chr11	46178083	46178239	LTR/ERVL	618	+	78	46178161	39784
chr11	46138377	46338377	harbor2	chr11	46178266	46178457	LTR/ERVL	939	+	96	46178362	39985
chr11	46138377	46338377	harbor2	chr11	46178463	46178606	LTR/ERVL	532	+	72	46178535	40158
chr11	119842499	120042499	harbor2	chr11	119886020	119886516	LTR/ERVL	1077	+	248	119886268	43769
chr11	119842499	120042499	harbor2	chr11	119891738	119892133	LTR/ERVL	981	+	198	119891936	49437
chr11	119842499	120042499	harbor2	chr11	119904635	119905076	LTR/ERVL	1190	+	220	119904855	62356
chr11	5127072	5327072	harbor2	chr11	5147269	5147661	LTR/ERVL	1627	+	196	5147465	20393
chr11	108021885	108221885	harbor2	chr11	108041018	108041268	LTR/ERVL	805	+	125	108041143	19258
chr11	5127114	5327114	harbor2	chr11	5147269	5147661	LTR/ERVL	1627	+	196	5147465	20351
chr11	5129662	5329662	harbor2	chr11	5147269	5147661	LTR/ERVL	1627	+	196	5147465	17803
chr11	5191376	5391376	harbor2	chr11	5238617	5239149	LTR/ERVL	570	+	266	5238883	47507
chr11	5134537	5334537	harbor2	chr11	5147269	5147661	LTR/ERVL	1627	+	196	5147465	12928
chr11	5127991	5327991	harbor2	chr11	5147269	5147661	LTR/ERVL	1627	+	196	5147465	19474
chr11	6290207	6490207	harbor2	chr11	6365726	6365919	LTR/ERVL	518	+	96	6365822	75615
chr11	6290207	6490207	harbor2	chr11	6371663	6371831	LTR/ERVL	715	+	84	6371747	81540
chr11	6290207	6490207	harbor2	chr11	6380213	6381235	LTR/ERVL	2806	+	511	6380724	90517
chr11	6290207	6490207	harbor2	chr11	6384117	6384333	LTR/ERVL	957	+	108	6384225	94018
chr11	5140669	5340669	harbor2	chr11	5147269	5147661	LTR/ERVL	1627	+	196	5147465	6796
chr11	5140669	5340669	harbor2	chr11	5238617	5239149	LTR/ERVL	570	+	266	5238883	98214
chr11	5127134	5327134	harbor2	chr11	5147269	5147661	LTR/ERVL	1627	+	196	5147465	20331
chr11	5140326	5340326	harbor2	chr11	5147269	5147661	LTR/ERVL	1627	+	196	5147465	7139
chr11	5140326	5340326	harbor2	chr11	5238617	5239149	LTR/ERVL	570	+	266	5238883	98557
chr11	108021571	108221571	harbor2	chr11	108041018	108041268	LTR/ERVL	805	+	125	108041143	19572
chr11	5127140	5327140	harbor2	chr11	5147269	5147661	LTR/ERVL	1627	+	196	5147465	20325
chr11	34108576	34308576	harbor2	chr11	34177366	34177630	LTR/ERVL	781	+	132	34177498	68922
chr11	34108576	34308576	harbor2	chr11	34177888	34178116	LTR/ERVL	671	+	114	34178002	69426
chr11	108021540	108221540	harbor2	chr11	108041018	108041268	LTR/ERVL	805	+	125	108041143	19603
chr11	5140241	5340241	harbor2	chr11	5147269	5147661	LTR/ERVL	1627	+	196	5147465	7224
chr11	5140241	5340241	harbor2	chr11	5238617	5239149	LTR/ERVL	570	+	266	5238883	98642
chr11	5127590	5327590	harbor2	chr11	5147269	5147661	LTR/ERVL	1627	+	196	5147465	19875
chr11	5127122	5327122	harbor2	chr11	5147269	5147661	LTR/ERVL	1627	+	196	5147465	20343
chr11	5128021	5328021	harbor2	chr11	5147269	5147661	LTR/ERVL	1627	+	196	5147465	19444
chr11	5200121	5400121	harbor2	chr11	5238617	5239149	LTR/ERVL	570	+	266	5238883	38762
chr11	5780143	5980143	harbor2	chr11	5872290	5872924	LTR/ERVL	2740	+	317	5872607	92464
chr11	86572054	86772054	harbor2	chr11	86623017	86623521	LTR/ERVL	2924	+	252	86623269	51215
chr11	86572054	86772054	harbor2	chr11	86626106	86626617	LTR/ERVL	1228	+	256	86626362	54308
chr11	86572054	86772054	harbor2	chr11	86626806	86626940	LTR/ERVL	1005	+	67	86626873	54819
chr11	5127137	5327137	harbor2	chr11	5147269	5147661	LTR/ERVL	1627	+	196	5147465	20328
chr11	43476525	43676525	harbor2	chr11	43505405	43505513	LTR/ERVL	768	+	54	43505459	28934
chr11	43476525	43676525	harbor2	chr11	43505940	43506182	LTR/ERVL	768	+	121	43506061	29536
chr11	43476525	43676525	harbor2	chr11	43524498	43524887	LTR/ERVL	793	+	194	43524692	48167
chr11	43476525	43676525	harbor2	chr11	43527366	43527498	LTR/ERVL	467	+	66	43527432	50907
chr11	43476525	43676525	harbor2	chr11	43527580	43528056	LTR/ERVL	1254	+	238	43527818	51293
chr11	43476525	43676525	harbor2	chr11	43528295	43528497	LTR/ERVL	664	+	101	43528396	51871
chr11	43476525	43676525	harbor2	chr11	43528750	43529032	LTR/ERVL	1248	+	141	43528891	52366
chr11	108021566	108221566	harbor2	chr11	108041018	108041268	LTR/ERVL	805	+	125	108041143	19577
chr11	5127198	5327198	harbor2	chr11	5147269	5147661	LTR/ERVL	1627	+	196	5147465	20267
chr11	5191220	5391220	harbor2	chr11	5238617	5239149	LTR/ERVL	570	+	266	5238883	47663
chr11	5127169	5327169	harbor2	chr11	5147269	5147661	LTR/ERVL	1627	+	196	5147465	20296
chr11	108021911	108221911	harbor2	chr11	108041018	108041268	LTR/ERVL	805	+	125	108041143	19232
chr11	76597013	76797013	harbor2	chr11	76644567	76645358	LTR/ERVL	3866	+	396	76644963	47950
chr11	5130296	5330296	harbor2	chr11	5147269	5147661	LTR/ERVL	1627	+	196	5147465	17169
chr11	65758415	65958415	harbor2	chr11	65764462	65765178	LTR/ERVL	3272	+	358	65764820	6405
chr11	65758415	65958415	harbor2	chr11	65771400	65771659	LTR/ERVL	741	+	130	65771530	13115
chr11	65758415	65958415	harbor2	chr11	65775372	65775785	LTR/ERVL	487	+	206	65775578	17163
chr11	5127119	5327119	harbor2	chr11	5147269	5147661	LTR/ERVL	1627	+	196	5147465	20346
chr11	5374833	5574833	harbor2	chr11	5447295	5447555	LTR/ERVL	538	+	130	5447425	72592
chr11	5374833	5574833	harbor2	chr11	5447556	5448235	LTR/ERVL	1328	+	340	5447896	73063
chr11	5374833	5574833	harbor2	chr11	5448236	5448275	LTR/ERVL	532	+	20	5448256	73423
chr11	70734520	70934520	harbor2	chr11	70757331	70757817	LTR/ERVL	1256	+	243	70757574	23054
chr11	70734520	70934520	harbor2	chr11	70790339	70790759	LTR/ERVL	1996	+	210	70790549	56029
chr11	5127221	5327221	harbor2	chr11	5147269	5147661	LTR/ERVL	1627	+	196	5147465	20244
chr11	5191472	5391472	harbor2	chr11	5238617	5239149	LTR/ERVL	570	+	266	5238883	47411
chr11	5243759	5443759	harbor2	chr11	5336108	5336591	LTR/ERVL	2440	+	242	5336350	92591
chr11	5128073	5328073	harbor2	chr11	5147269	5147661	LTR/ERVL	1627	+	196	5147465	19392
chr11	10402307	10602307	harbor2	chr11	10440433	10440633	LTR/ERVL	524	+	100	10440533	38226
chr11	5127064	5327064	harbor2	chr11	5147269	5147661	LTR/ERVL	1627	+	196	5147465	20401
chr11	34816682	35016682	harbor2	chr11	34846637	34847034	LTR/ERVL	1466	+	198	34846835	30153
chr11	34816682	35016682	harbor2	chr11	34847037	34848671	LTR/ERVL	4468	+	817	34847854	31172
chr11	34816682	35016682	harbor2	chr11	34849041	34850231	LTR/ERVL	4468	+	595	34849636	32954
chr11	34816682	35016682	harbor2	chr11	34850237	34850312	LTR/ERVL	413	+	38	34850275	33593
chr11	34816682	35016682	harbor2	chr11	34872114	34872941	LTR/ERVL	4469	+	414	34872528	55846
chr11	34816682	35016682	harbor2	chr11	34912452	34912884	LTR/ERVL	3276	+	216	34912668	95986
chr11	5127952	5327952	harbor2	chr11	5147269	5147661	LTR/ERVL	1627	+	196	5147465	19513
chr11	5134168	5334168	harbor2	chr11	5147269	5147661	LTR/ERVL	1627	+	196	5147465	13297
chr11	5127561	5327561	harbor2	chr11	5147269	5147661	LTR/ERVL	1627	+	196	5147465	19904
chr11	5132031	5332031	harbor2	chr11	5147269	5147661	LTR/ERVL	1627	+	196	5147465	15434
chr11	5270087	5470087	harbor2	chr11	5336108	5336591	LTR/ERVL	2440	+	242	5336350	66263
chr11	5126997	5326997	harbor2	chr11	5147269	5147661	LTR/ERVL	1627	+	196	5147465	20468
chr11	88444581	88644581	harbor2	chr11	88470897	88471281	LTR/ERVL	2004	+	192	88471089	26508
chr11	88444581	88644581	harbor2	chr11	88495049	88495269	LTR/ERVL	565	+	110	88495159	50578
chr11	5140184	5340184	harbor2	chr11	5147269	5147661	LTR/ERVL	1627	+	196	5147465	7281
chr11	5140184	5340184	harbor2	chr11	5238617	5239149	LTR/ERVL	570	+	266	5238883	98699
chr11	76580946	76780946	harbor2	chr11	76644567	76645358	LTR/ERVL	3866	+	396	76644963	64017
chr11	108021537	108221537	harbor2	chr11	108041018	108041268	LTR/ERVL	805	+	125	108041143	19606
chr11	133742979	133942979	harbor2	chr11	133779805	133780133	LTR/ERVL	552	+	164	133779969	36990
chr11	133742979	133942979	harbor2	chr11	133802102	133802203	LTR/ERVL	426	+	50	133802152	59173
chr11	5127155	5327155	harbor2	chr11	5147269	5147661	LTR/ERVL	1627	+	196	5147465	20310
chr11	5127211	5327211	harbor2	chr11	5147269	5147661	LTR/ERVL	1627	+	196	5147465	20254
chr11	5134551	5334551	harbor2	chr11	5147269	5147661	LTR/ERVL	1627	+	196	5147465	12914
chr11	5127112	5327112	harbor2	chr11	5147269	5147661	LTR/ERVL	1627	+	196	5147465	20353
chr11	5132933	5332933	harbor2	chr11	5147269	5147661	LTR/ERVL	1627	+	196	5147465	14532
chr11	5137985	5337985	harbor2	chr11	5147269	5147661	LTR/ERVL	1627	+	196	5147465	9480
chr11	5134538	5334538	harbor2	chr11	5147269	5147661	LTR/ERVL	1627	+	196	5147465	12927
chr11	5179921	5379921	harbor2	chr11	5238617	5239149	LTR/ERVL	570	+	266	5238883	58962
chr11	5196062	5396062	harbor2	chr11	5238617	5239149	LTR/ERVL	570	+	266	5238883	42821
chr11	5133805	5333805	harbor2	chr11	5147269	5147661	LTR/ERVL	1627	+	196	5147465	13660
chr11	108022093	108222093	harbor2	chr11	108041018	108041268	LTR/ERVL	805	+	125	108041143	19050
chr11	5127124	5327124	harbor2	chr11	5147269	5147661	LTR/ERVL	1627	+	196	5147465	20341
chr11	86705704	86905704	harbor2	chr11	86752236	86753114	LTR/ERVL	2544	+	439	86752675	46971
chr11	86705704	86905704	harbor2	chr11	86792066	86792537	LTR/ERVL	830	+	236	86792302	86598
chr11	5130452	5330452	harbor2	chr11	5147269	5147661	LTR/ERVL	1627	+	196	5147465	17013
chr11	5254966	5454966	harbor2	chr11	5336108	5336591	LTR/ERVL	2440	+	242	5336350	81384
chr11	117887292	118087292	harbor2	chr11	117984458	117984780	LTR/ERVL	1593	+	161	117984619	97327
chr11	5127171	5327171	harbor2	chr11	5147269	5147661	LTR/ERVL	1627	+	196	5147465	20294
chr11	69540237	69740237	harbor2	chr11	69601712	69602120	LTR/ERVL	480	+	204	69601916	61679
chr11	5133958	5333958	harbor2	chr11	5147269	5147661	LTR/ERVL	1627	+	196	5147465	13507
chr11	5134924	5334924	harbor2	chr11	5147269	5147661	LTR/ERVL	1627	+	196	5147465	12541
chr11	124775046	124975046	harbor2	chr11	124829157	124829319	LTR/ERVL	550	+	81	124829238	54192
chr11	124775046	124975046	harbor2	chr11	124831169	124831595	LTR/ERVL	1246	+	213	124831382	56336
chr11	124775046	124975046	harbor2	chr11	124831596	124831894	LTR/ERVL	893	+	149	124831745	56699
chr11	6512688	6712688	harbor2	chr11	6515483	6515723	LTR/ERVL	588	+	120	6515603	2915
chr11	6512688	6712688	harbor2	chr11	6527915	6528042	LTR/ERVL	434	+	64	6527979	15291
chr11	6512688	6712688	harbor2	chr11	6554997	6555199	LTR/ERVL	1918	+	101	6555098	42410
chr11	6512688	6712688	harbor2	chr11	6555247	6555401	LTR/ERVL	1918	+	77	6555324	42636
chr11	6512688	6712688	harbor2	chr11	6555402	6555596	LTR/ERVL	1448	+	97	6555499	42811
chr11	6512688	6712688	harbor2	chr11	6593478	6593800	LTR/ERVL	698	+	161	6593639	80951
chr11	6206570	6406570	harbor2	chr11	6228929	6229085	LTR/ERVL	627	+	78	6229007	22437
chr11	71032716	71232716	harbor2	chr11	71086545	71086709	LTR/ERVL	658	+	82	71086627	53911
chr11	71032716	71232716	harbor2	chr11	71088060	71088366	LTR/ERVL	1169	+	153	71088213	55497
chr11	71032716	71232716	harbor2	chr11	71117364	71118081	LTR/ERVL	1782	+	358	71117722	85006
chr11	46138378	46338378	harbor2	chr11	46176715	46177138	LTR/ERVL	1759	+	212	46176927	38549
chr11	46138378	46338378	harbor2	chr11	46177160	46177717	LTR/ERVL	1438	+	278	46177438	39060
chr11	46138378	46338378	harbor2	chr11	46178083	46178239	LTR/ERVL	618	+	78	46178161	39783
chr11	46138378	46338378	harbor2	chr11	46178266	46178457	LTR/ERVL	939	+	96	46178362	39984
chr11	46138378	46338378	harbor2	chr11	46178463	46178606	LTR/ERVL	532	+	72	46178535	40157
chr11	6519523	6719523	harbor2	chr11	6527915	6528042	LTR/ERVL	434	+	64	6527979	8456
chr11	6519523	6719523	harbor2	chr11	6554997	6555199	LTR/ERVL	1918	+	101	6555098	35575
chr11	6519523	6719523	harbor2	chr11	6555247	6555401	LTR/ERVL	1918	+	77	6555324	35801
chr11	6519523	6719523	harbor2	chr11	6555402	6555596	LTR/ERVL	1448	+	97	6555499	35976
chr11	6519523	6719523	harbor2	chr11	6593478	6593800	LTR/ERVL	698	+	161	6593639	74116
chr11	5134209	5334209	harbor2	chr11	5147269	5147661	LTR/ERVL	1627	+	196	5147465	13256
chr11	108022644	108222644	harbor2	chr11	108041018	108041268	LTR/ERVL	805	+	125	108041143	18499
chr11	76580961	76780961	harbor2	chr11	76644567	76645358	LTR/ERVL	3866	+	396	76644963	64002
chr11	76580925	76780925	harbor2	chr11	76644567	76645358	LTR/ERVL	3866	+	396	76644963	64038
chr11	108122770	108322770	harbor2	chr11	108123948	108124255	LTR/ERVL	781	+	154	108124102	1332
chr11	108122770	108322770	harbor2	chr11	108219025	108219250	LTR/ERVL	802	+	112	108219137	96367
chr11	108122770	108322770	harbor2	chr11	108219318	108219509	LTR/ERVL	570	+	96	108219414	96644
chr11	76580957	76780957	harbor2	chr11	76644567	76645358	LTR/ERVL	3866	+	396	76644963	64006
chr11	5128067	5328067	harbor2	chr11	5147269	5147661	LTR/ERVL	1627	+	196	5147465	19398
chr11	113925194	114125194	harbor2	chr11	113941574	113942013	LTR/ERVL	856	+	220	113941794	16600
chr11	113925194	114125194	harbor2	chr11	114001328	114001773	LTR/ERVL	1832	+	222	114001550	76356
chr11	113925194	114125194	harbor2	chr11	114016494	114016585	LTR/ERVL	2656	+	46	114016540	91346
chr11	113925194	114125194	harbor2	chr11	114016866	114017323	LTR/ERVL	2656	+	228	114017094	91900
chr11	113925194	114125194	harbor2	chr11	114017983	114018106	LTR/ERVL	469	+	62	114018045	92851
chr11	113925194	114125194	harbor2	chr11	114019133	114019346	LTR/ERVL	521	+	106	114019239	94045
chr11	5280970	5480970	harbor2	chr11	5336108	5336591	LTR/ERVL	2440	+	242	5336350	55380
chr11	75668641	75868641	harbor2	chr11	75711156	75712681	LTR/ERVL	5509	+	762	75711918	43277
chr11	75668641	75868641	harbor2	chr11	75712663	75712828	LTR/ERVL	880	+	82	75712745	44104
chr11	75668641	75868641	harbor2	chr11	75712836	75712988	LTR/ERVL	671	+	76	75712912	44271
chr11	75668641	75868641	harbor2	chr11	75712977	75713343	LTR/ERVL	554	+	183	75713160	44519
chr11	75668641	75868641	harbor2	chr11	75713724	75714405	LTR/ERVL	2659	+	340	75714064	45423
chr11	75668641	75868641	harbor2	chr11	75744602	75745036	LTR/ERVL	914	+	217	75744819	76178
chr11	75668641	75868641	harbor2	chr11	75763453	75763708	LTR/ERVL	635	+	128	75763581	94940
chr11	6202662	6402662	harbor2	chr11	6228929	6229085	LTR/ERVL	627	+	78	6229007	26345
chr11	108022180	108222180	harbor2	chr11	108041018	108041268	LTR/ERVL	805	+	125	108041143	18963
chr11	120017923	120217923	harbor2	chr11	120091571	120092002	LTR/ERVL	1500	+	216	120091787	73864
chr11	5212919	5412919	harbor2	chr11	5238617	5239149	LTR/ERVL	570	+	266	5238883	25964
chr11	5128829	5328829	harbor2	chr11	5147269	5147661	LTR/ERVL	1627	+	196	5147465	18636
chr11	5135349	5335349	harbor2	chr11	5147269	5147661	LTR/ERVL	1627	+	196	5147465	12116
chr11	93068304	93268304	harbor2	chr11	93084147	93084395	LTR/ERVL	706	+	124	93084271	15967
chr11	6215101	6415101	harbor2	chr11	6228929	6229085	LTR/ERVL	627	+	78	6229007	13906
chr11	5140732	5340732	harbor2	chr11	5147269	5147661	LTR/ERVL	1627	+	196	5147465	6733
chr11	5140732	5340732	harbor2	chr11	5238617	5239149	LTR/ERVL	570	+	266	5238883	98151
chr11	5127158	5327158	harbor2	chr11	5147269	5147661	LTR/ERVL	1627	+	196	5147465	20307
chr11	71257652	71457652	harbor2	chr11	71264403	71264904	LTR/ERVL	2457	+	250	71264653	7001
chr11	71257652	71457652	harbor2	chr11	71264936	71264986	LTR/ERVL	2457	+	25	71264961	7309
chr11	71257652	71457652	harbor2	chr11	71284399	71284669	LTR/ERVL	984	+	135	71284534	26882
chr11	84730966	84930966	harbor2	chr11	84761379	84761907	LTR/ERVL	2087	+	264	84761643	30677
chr11	84730966	84930966	harbor2	chr11	84778662	84779275	LTR/ERVL	1626	+	306	84778968	48002
chr11	86038927	86238927	harbor2	chr11	86087269	86087847	LTR/ERVL	1416	+	289	86087558	48631
chr11	86038927	86238927	harbor2	chr11	86088000	86088211	LTR/ERVL	849	+	106	86088106	49179
chr11	86038927	86238927	harbor2	chr11	86122366	86122741	LTR/ERVL	1419	+	188	86122554	83627
chr11	71765031	71965031	harbor2	chr11	71791971	71792300	LTR/ERVL	631	+	164	71792135	27104
chr11	70734899	70934899	harbor2	chr11	70757331	70757817	LTR/ERVL	1256	+	243	70757574	22675
chr11	70734899	70934899	harbor2	chr11	70790339	70790759	LTR/ERVL	1996	+	210	70790549	55650
chr11	22729649	22929649	harbor2	chr11	22823369	22823740	LTR/ERVL	1833	+	186	22823555	93906
chr11	22729649	22929649	harbor2	chr11	22824039	22824117	LTR/ERVL	1833	+	39	22824078	94429
chr11	5134455	5334455	harbor2	chr11	5147269	5147661	LTR/ERVL	1627	+	196	5147465	13010
chr11	75668758	75868758	harbor2	chr11	75711156	75712681	LTR/ERVL	5509	+	762	75711918	43160
chr11	75668758	75868758	harbor2	chr11	75712663	75712828	LTR/ERVL	880	+	82	75712745	43987
chr11	75668758	75868758	harbor2	chr11	75712836	75712988	LTR/ERVL	671	+	76	75712912	44154
chr11	75668758	75868758	harbor2	chr11	75712977	75713343	LTR/ERVL	554	+	183	75713160	44402
chr11	75668758	75868758	harbor2	chr11	75713724	75714405	LTR/ERVL	2659	+	340	75714064	45306
chr11	75668758	75868758	harbor2	chr11	75744602	75745036	LTR/ERVL	914	+	217	75744819	76061
chr11	75668758	75868758	harbor2	chr11	75763453	75763708	LTR/ERVL	635	+	128	75763581	94823
chr11	5127199	5327199	harbor2	chr11	5147269	5147661	LTR/ERVL	1627	+	196	5147465	20266
chr11	73052995	73252995	harbor2	chr11	73054284	73054568	LTR/ERVL	994	+	142	73054426	1431
chr11	73052995	73252995	harbor2	chr11	73092809	73093462	LTR/ERVL	2474	+	326	73093135	40140
chr11	5127156	5327156	harbor2	chr11	5147269	5147661	LTR/ERVL	1627	+	196	5147465	20309
chr11	69541435	69741435	harbor2	chr11	69601712	69602120	LTR/ERVL	480	+	204	69601916	60481
chr11	76603574	76803574	harbor2	chr11	76644567	76645358	LTR/ERVL	3866	+	396	76644963	41389
chr11	5127093	5327093	harbor2	chr11	5147269	5147661	LTR/ERVL	1627	+	196	5147465	20372
chr11	33157293	33357293	harbor2	chr11	33198256	33198619	LTR/ERVL	1149	+	182	33198438	41145
chr11	33157293	33357293	harbor2	chr11	33202751	33202978	LTR/ERVL	832	+	114	33202865	45572
chr11	33157293	33357293	harbor2	chr11	33202984	33203034	LTR/ERVL	664	+	25	33203009	45716
chr11	33157293	33357293	harbor2	chr11	33203321	33203516	LTR/ERVL	698	+	98	33203419	46126
chr11	33157293	33357293	harbor2	chr11	33205925	33206384	LTR/ERVL	1516	+	230	33206155	48862
chr11	5134058	5334058	harbor2	chr11	5147269	5147661	LTR/ERVL	1627	+	196	5147465	13407
chr11	69540515	69740515	harbor2	chr11	69601712	69602120	LTR/ERVL	480	+	204	69601916	61401
chr11	5127178	5327178	harbor2	chr11	5147269	5147661	LTR/ERVL	1627	+	196	5147465	20287
chr11	72618653	72818653	harbor2	chr11	72663887	72664332	LTR/ERVL	646	+	222	72664109	45456
chr11	688408	888408	harbor2	chr11	751877	752068	LTR/ERVL	3149	+	96	751973	63565
chr11	688408	888408	harbor2	chr11	752380	753087	LTR/ERVL	3149	+	354	752734	64326
chr11	5200536	5400536	harbor2	chr11	5238617	5239149	LTR/ERVL	570	+	266	5238883	38347
chr11	47367046	47567046	harbor2	chr11	47430539	47431006	LTR/ERVL	2133	+	234	47430773	63727
chr11	5134999	5334999	harbor2	chr11	5147269	5147661	LTR/ERVL	1627	+	196	5147465	12466
chr11	69543489	69743489	harbor2	chr11	69601712	69602120	LTR/ERVL	480	+	204	69601916	58427
chr11	5127964	5327964	harbor2	chr11	5147269	5147661	LTR/ERVL	1627	+	196	5147465	19501
chr11	69575463	69775463	harbor2	chr11	69601712	69602120	LTR/ERVL	480	+	204	69601916	26453
chr11	76581002	76781002	harbor2	chr11	76644567	76645358	LTR/ERVL	3866	+	396	76644963	63961
chr11	6512668	6712668	harbor2	chr11	6515483	6515723	LTR/ERVL	588	+	120	6515603	2935
chr11	6512668	6712668	harbor2	chr11	6527915	6528042	LTR/ERVL	434	+	64	6527979	15311
chr11	6512668	6712668	harbor2	chr11	6554997	6555199	LTR/ERVL	1918	+	101	6555098	42430
chr11	6512668	6712668	harbor2	chr11	6555247	6555401	LTR/ERVL	1918	+	77	6555324	42656
chr11	6512668	6712668	harbor2	chr11	6555402	6555596	LTR/ERVL	1448	+	97	6555499	42831
chr11	6512668	6712668	harbor2	chr11	6593478	6593800	LTR/ERVL	698	+	161	6593639	80971
chr11	5134513	5334513	harbor2	chr11	5147269	5147661	LTR/ERVL	1627	+	196	5147465	12952
chr11	6204994	6404994	harbor2	chr11	6228929	6229085	LTR/ERVL	627	+	78	6229007	24013
chr11	113775362	113975362	harbor2	chr11	113847830	113849952	LTR/ERVL	8539	+	1061	113848891	73529
chr11	104477395	104677395	harbor2	chr11	104477634	104478139	LTR/ERVL	2009	+	252	104477886	491
chr11	104477395	104677395	harbor2	chr11	104517575	104517972	LTR/ERVL	1047	+	198	104517773	40378
chr11	104477395	104677395	harbor2	chr11	104529437	104529841	LTR/ERVL	1249	+	202	104529639	52244
chr11	104477395	104677395	harbor2	chr11	104530231	104530770	LTR/ERVL	2598	+	270	104530501	53106
chr11	104477395	104677395	harbor2	chr11	104531172	104531410	LTR/ERVL	456	+	119	104531291	53896
chr11	104477395	104677395	harbor2	chr11	104531933	104532130	LTR/ERVL	461	+	98	104532031	54636
chr11	104477395	104677395	harbor2	chr11	104529916	104530187	LTR/ERVL	567	+	136	104530052	52657
chr11	6201292	6401292	harbor2	chr11	6228929	6229085	LTR/ERVL	627	+	78	6229007	27715
chr11	5134524	5334524	harbor2	chr11	5147269	5147661	LTR/ERVL	1627	+	196	5147465	12941
chr11	5127128	5327128	harbor2	chr11	5147269	5147661	LTR/ERVL	1627	+	196	5147465	20337
chr11	5140128	5340128	harbor2	chr11	5147269	5147661	LTR/ERVL	1627	+	196	5147465	7337
chr11	5140128	5340128	harbor2	chr11	5238617	5239149	LTR/ERVL	570	+	266	5238883	98755
chr11	76580962	76780962	harbor2	chr11	76644567	76645358	LTR/ERVL	3866	+	396	76644963	64001
chr11	104242642	104442642	harbor2	chr11	104308851	104309298	LTR/ERVL	3455	+	224	104309075	66433
chr11	5185577	5385577	harbor2	chr11	5238617	5239149	LTR/ERVL	570	+	266	5238883	53306
chr11	69540279	69740279	harbor2	chr11	69601712	69602120	LTR/ERVL	480	+	204	69601916	61637
chr11	134971985	135171985	harbor2	chr11	134984439	134984752	LTR/ERVL	949	+	156	134984595	12610
chr11	134971985	135171985	harbor2	chr11	135057418	135057666	LTR/ERVL	1015	+	124	135057542	85557
chr11	134971985	135171985	harbor2	chr11	135060259	135060685	LTR/ERVL	2512	+	213	135060472	88487
chr11	134971985	135171985	harbor2	chr11	135069501	135069857	LTR/ERVL	1789	+	178	135069679	97694
chr11	5216139	5416139	harbor2	chr11	5238617	5239149	LTR/ERVL	570	+	266	5238883	22744
chr11	76580938	76780938	harbor2	chr11	76644567	76645358	LTR/ERVL	3866	+	396	76644963	64025
chr11	5130257	5330257	harbor2	chr11	5147269	5147661	LTR/ERVL	1627	+	196	5147465	17208
chr11	5212918	5412918	harbor2	chr11	5238617	5239149	LTR/ERVL	570	+	266	5238883	25965
chr11	33594688	33794688	harbor2	chr11	33614161	33614476	LTR/ERVL	1221	+	158	33614319	19631
chr11	33594688	33794688	harbor2	chr11	33614481	33614531	LTR/ERVL	710	+	25	33614506	19818
chr11	33594688	33794688	harbor2	chr11	33614911	33614992	LTR/ERVL	710	+	40	33614951	20263
chr11	33594688	33794688	harbor2	chr11	33614993	33615189	LTR/ERVL	768	+	98	33615091	20403
chr11	33594688	33794688	harbor2	chr11	33693084	33693282	LTR/ERVL	453	+	99	33693183	98495
chr11	33594688	33794688	harbor2	chr11	33693614	33693680	LTR/ERVL	453	+	33	33693647	98959
chr11	5128029	5328029	harbor2	chr11	5147269	5147661	LTR/ERVL	1627	+	196	5147465	19436
chr11	5134085	5334085	harbor2	chr11	5147269	5147661	LTR/ERVL	1627	+	196	5147465	13380
chr11	76597028	76797028	harbor2	chr11	76644567	76645358	LTR/ERVL	3866	+	396	76644963	47935
chr11	64753229	64953229	harbor2	chr11	64822081	64822172	LTR/ERVL	496	+	46	64822127	68898
chr11	64753229	64953229	harbor2	chr11	64822598	64822755	LTR/ERVL	496	+	78	64822676	69447
chr11	5133710	5333710	harbor2	chr11	5147269	5147661	LTR/ERVL	1627	+	196	5147465	13755
chr11	3206827	3406827	harbor2	chr11	3234992	3235204	LTR/ERVL	477	+	106	3235098	28271
chr11	65289218	65489218	harbor2	chr11	65359541	65360206	LTR/ERVL	1440	+	332	65359873	70655
chr11	64348940	64548940	harbor2	chr11	64397783	64398525	LTR/ERVL	3207	+	371	64398154	49214
chr11	64348940	64548940	harbor2	chr11	64398895	64399098	LTR/ERVL	3207	+	102	64398997	50057
chr11	64348940	64548940	harbor2	chr11	64399334	64399598	LTR/ERVL	874	+	132	64399466	50526
chr11	64348940	64548940	harbor2	chr11	64399914	64399988	LTR/ERVL	874	+	37	64399951	51011
chr11	64348940	64548940	harbor2	chr11	64400513	64400807	LTR/ERVL	4906	+	147	64400660	51720
chr11	64348940	64548940	harbor2	chr11	64401022	64402091	LTR/ERVL	4906	+	534	64401556	52616
chr11	64348940	64548940	harbor2	chr11	64402402	64402510	LTR/ERVL	4906	+	54	64402456	53516
chr11	64348940	64548940	harbor2	chr11	64402699	64402762	LTR/ERVL	448	+	32	64402731	53791
chr11	64348940	64548940	harbor2	chr11	64403166	64403305	LTR/ERVL	448	+	70	64403236	54296
chr11	64348940	64548940	harbor2	chr11	64403308	64403465	LTR/ERVL	1128	+	78	64403386	54446
chr11	64348940	64548940	harbor2	chr11	64403848	64404278	LTR/ERVL	1128	+	215	64404063	55123
chr11	64348940	64548940	harbor2	chr11	64406577	64406966	LTR/ERVL	1939	+	194	64406771	57831
chr11	86702251	86902251	harbor2	chr11	86752236	86753114	LTR/ERVL	2544	+	439	86752675	50424
chr11	86702251	86902251	harbor2	chr11	86792066	86792537	LTR/ERVL	830	+	236	86792302	90051
chr11	69539137	69739137	harbor2	chr11	69601712	69602120	LTR/ERVL	480	+	204	69601916	62779
chr11	69540570	69740570	harbor2	chr11	69601712	69602120	LTR/ERVL	480	+	204	69601916	61346
chr11	5129604	5329604	harbor2	chr11	5147269	5147661	LTR/ERVL	1627	+	196	5147465	17861
chr11	46820071	47020071	harbor2	chr11	46840613	46840986	LTR/ERVL	2480	+	186	46840799	20728
chr11	46820071	47020071	harbor2	chr11	46841283	46841435	LTR/ERVL	2480	+	76	46841359	21288
chr11	46820071	47020071	harbor2	chr11	46841453	46841718	LTR/ERVL	3173	+	132	46841585	21514
chr11	46820071	47020071	harbor2	chr11	46842019	46842319	LTR/ERVL	3173	+	150	46842169	22098
chr11	46820071	47020071	harbor2	chr11	46843128	46843366	LTR/ERVL	1155	+	119	46843247	23176
chr11	46820071	47020071	harbor2	chr11	46843754	46843895	LTR/ERVL	527	+	70	46843824	23753
chr11	46820071	47020071	harbor2	chr11	46844317	46844414	LTR/ERVL	453	+	48	46844365	24294
chr11	19614222	19814222	harbor2	chr11	19639038	19639214	LTR/ERVL	1033	+	88	19639126	24904
chr11	682049	882049	harbor2	chr11	751877	752068	LTR/ERVL	3149	+	96	751973	69924
chr11	682049	882049	harbor2	chr11	752380	753087	LTR/ERVL	3149	+	354	752734	70685
chr11	5138019	5338019	harbor2	chr11	5147269	5147661	LTR/ERVL	1627	+	196	5147465	9446
chr11	2300595	2500595	harbor2	chr11	2324940	2326034	LTR/ERVL	7101	+	547	2325487	24892
chr11	2300595	2500595	harbor2	chr11	2343947	2344067	LTR/ERVL	1775	+	60	2344007	43412
chr11	2300595	2500595	harbor2	chr11	2344446	2345045	LTR/ERVL	1775	+	300	2344746	44151
chr11	2300595	2500595	harbor2	chr11	2345085	2345312	LTR/ERVL	1130	+	114	2345199	44604
chr11	2300595	2500595	harbor2	chr11	2345723	2345883	LTR/ERVL	618	+	80	2345803	45208
chr11	2300595	2500595	harbor2	chr11	2346091	2346398	LTR/ERVL	1046	+	154	2346245	45650
chr11	2300595	2500595	harbor2	chr11	2346520	2346612	LTR/ERVL	1322	+	46	2346566	45971
chr11	2300595	2500595	harbor2	chr11	2346647	2347430	LTR/ERVL	1322	+	392	2347039	46444
chr11	2300595	2500595	harbor2	chr11	2347975	2348058	LTR/ERVL	548	+	42	2348017	47422
chr11	2300595	2500595	harbor2	chr11	2354004	2354433	LTR/ERVL	1635	+	214	2354218	53623
chr11	2300595	2500595	harbor2	chr11	2354736	2354784	LTR/ERVL	1635	+	24	2354760	54165
chr11	2300595	2500595	harbor2	chr11	2354788	2356082	LTR/ERVL	24559	+	647	2355435	54840
chr11	2300595	2500595	harbor2	chr11	2356608	2358562	LTR/ERVL	24559	+	977	2357585	56990
chr11	2300595	2500595	harbor2	chr11	2361019	2361595	LTR/ERVL	24559	+	288	2361307	60712
chr11	2300595	2500595	harbor2	chr11	2361596	2362091	LTR/ERVL	2350	+	248	2361844	61249
chr11	2300595	2500595	harbor2	chr11	2362518	2362928	LTR/ERVL	840	+	205	2362723	62128
chr11	2300595	2500595	harbor2	chr11	2326399	2326799	LTR/ERVL	7101	+	200	2326599	26004
chr11	2300595	2500595	harbor2	chr11	2358852	2360707	LTR/ERVL	24559	+	928	2359780	59185
chr11	5128903	5328903	harbor2	chr11	5147269	5147661	LTR/ERVL	1627	+	196	5147465	18562
chr11	5216274	5416274	harbor2	chr11	5238617	5239149	LTR/ERVL	570	+	266	5238883	22609
chr11	5280964	5480964	harbor2	chr11	5336108	5336591	LTR/ERVL	2440	+	242	5336350	55386
chr11	86937893	87137893	harbor2	chr11	86961834	86962064	LTR/ERVL	1081	+	115	86961949	24056
chr11	86937893	87137893	harbor2	chr11	86962071	86962519	LTR/ERVL	1648	+	224	86962295	24402
chr11	86937893	87137893	harbor2	chr11	86974415	86974944	LTR/ERVL	2935	+	264	86974679	36786
chr12	56388130	56588130	harbor2	chr12	56398527	56400360	LTR/ERVL	28923	+	916	56399443	11313
chr12	56388130	56588130	harbor2	chr12	56401326	56404751	LTR/ERVL	28923	+	1712	56403038	14908
chr12	56388130	56588130	harbor2	chr12	56404752	56405145	LTR/ERVL	2908	+	196	56404948	16818
chr12	56388130	56588130	harbor2	chr12	56414467	56414779	LTR/ERVL	678	+	156	56414623	26493
chr12	123153661	123353661	harbor2	chr12	123173301	123174184	LTR/ERVL	3803	+	442	123173743	20082
chr12	10113589	10313589	harbor2	chr12	10174027	10174048	LTR/ERVL	955	+	10	10174037	60448
chr12	10113589	10313589	harbor2	chr12	10183840	10184602	LTR/ERVL	3897	+	381	10184221	70632
chr12	10113589	10313589	harbor2	chr12	10174362	10174732	LTR/ERVL	955	+	185	10174547	60958
chr12	49481241	49681241	harbor2	chr12	49482211	49482680	LTR/ERVL	855	+	234	49482445	1204
chr12	2941177	3141177	harbor2	chr12	2988205	2988230	LTR/ERVL	3323	+	12	2988217	47040
chr12	2941177	3141177	harbor2	chr12	2988529	2989164	LTR/ERVL	3323	+	318	2988847	47670
chr12	56104486	56304486	harbor2	chr12	56149787	56150197	LTR/ERVL	1777	+	205	56149992	45506
chr12	50183574	50383574	harbor2	chr12	50186385	50186842	LTR/ERVL	2757	+	228	50186613	3039
chr12	130739294	130939294	harbor2	chr12	130763098	130763189	LTR/ERVL	2653	+	46	130763144	23850
chr12	130739294	130939294	harbor2	chr12	130763490	130764073	LTR/ERVL	2653	+	292	130763782	24488
chr12	130739294	130939294	harbor2	chr12	130804308	130804733	LTR/ERVL	2165	+	212	130804520	65226
chr12	130064326	130264326	harbor2	chr12	130106570	130107092	LTR/ERVL	2204	+	261	130106831	42505
chr12	130064326	130264326	harbor2	chr12	130112268	130112595	LTR/ERVL	2276	+	164	130112432	48106
chr12	130064326	130264326	harbor2	chr12	130112960	130113160	LTR/ERVL	2276	+	100	130113060	48734
chr12	130064326	130264326	harbor2	chr12	130131747	130132220	LTR/ERVL	855	+	236	130131983	67657
chr12	54117976	54317976	harbor2	chr12	54178769	54179313	LTR/ERVL	1599	+	272	54179041	61065
chr12	52212987	52412987	harbor2	chr12	52222090	52222659	LTR/ERVL	1851	+	284	52222374	9387
chr12	52212987	52412987	harbor2	chr12	52222959	52223033	LTR/ERVL	1808	+	37	52222996	10009
chr12	6981048	7181048	harbor2	chr12	7023788	7024483	LTR/ERVL	4148	+	348	7024136	43088
chr12	6981048	7181048	harbor2	chr12	7027452	7027564	LTR/ERVL	1379	+	56	7027508	46460
chr12	6981048	7181048	harbor2	chr12	7027920	7028075	LTR/ERVL	1379	+	78	7027998	46950
chr12	6981048	7181048	harbor2	chr12	7028121	7028147	LTR/ERVL	3580	+	13	7028134	47086
chr12	6981048	7181048	harbor2	chr12	7029275	7029300	LTR/ERVL	3580	+	12	7029287	48239
chr12	6981048	7181048	harbor2	chr12	7029677	7029909	LTR/ERVL	2692	+	116	7029793	48745
chr12	6981048	7181048	harbor2	chr12	7030210	7030241	LTR/ERVL	2692	+	16	7030226	49178
chr12	6981048	7181048	harbor2	chr12	7031842	7032041	LTR/ERVL	2692	+	100	7031942	50894
chr12	6981048	7181048	harbor2	chr12	7034169	7035773	LTR/ERVL	11783	+	802	7034971	53923
chr12	6981048	7181048	harbor2	chr12	7035840	7036181	LTR/ERVL	11783	+	170	7036010	54962
chr12	6981048	7181048	harbor2	chr12	7036182	7036511	LTR/ERVL	1476	+	164	7036346	55298
chr12	6981048	7181048	harbor2	chr12	7028442	7028949	LTR/ERVL	3580	+	254	7028696	47648
chr12	114565308	114765308	harbor2	chr12	114578064	114578603	LTR/ERVL	2582	+	270	114578334	13026
chr12	114565308	114765308	harbor2	chr12	114602151	114602481	LTR/ERVL	1274	+	165	114602316	37008
chr12	114565308	114765308	harbor2	chr12	114609121	114609562	LTR/ERVL	3449	+	220	114609341	44033
chr12	54817529	55017529	harbor2	chr12	54849905	54850159	LTR/ERVL	710	+	127	54850032	32503
chr12	11087032	11287032	harbor2	chr12	11087471	11088058	LTR/ERVL	1586	+	294	11087765	733
chr12	11087032	11287032	harbor2	chr12	11088345	11088945	LTR/ERVL	1586	+	300	11088645	1613
chr12	11087032	11287032	harbor2	chr12	11089101	11089617	LTR/ERVL	1546	+	258	11089359	2327
chr12	11087032	11287032	harbor2	chr12	11129286	11129868	LTR/ERVL	1573	+	291	11129577	42545
chr12	11087032	11287032	harbor2	chr12	11130155	11130617	LTR/ERVL	1573	+	231	11130386	43354
chr12	11087032	11287032	harbor2	chr12	11130926	11131441	LTR/ERVL	1527	+	258	11131184	44152
chr12	11087032	11287032	harbor2	chr12	11152956	11153917	LTR/ERVL	3068	+	480	11153436	66404
chr12	11087032	11287032	harbor2	chr12	11164070	11164524	LTR/ERVL	2098	+	227	11164297	77265
chr12	96299869	96499869	harbor2	chr12	96337828	96338449	LTR/ERVL	2433	+	310	96338138	38269
chr12	123358547	123558547	harbor2	chr12	123449149	123449562	LTR/ERVL	844	+	206	123449355	90808
chr12	66144148	66344148	harbor2	chr12	66177432	66177787	LTR/ERVL	1002	+	178	66177610	33462
chr12	65456928	65656928	harbor2	chr12	65511962	65512425	LTR/ERVL	1054	+	232	65512194	55266
chr13	94616682	94816682	harbor2	chr13	94630805	94631325	LTR/ERVL	1510	+	260	94631065	14383
chr13	94616682	94816682	harbor2	chr13	94632655	94633305	LTR/ERVL	1572	+	325	94632980	16298
chr13	94616682	94816682	harbor2	chr13	94686806	94687030	LTR/ERVL	1398	+	112	94686918	70236
chr13	37193965	37393965	harbor2	chr13	37246832	37247255	LTR/ERVL	1463	+	212	37247044	53079
chr13	37193965	37393965	harbor2	chr13	37271078	37271634	LTR/ERVL	2537	+	278	37271356	77391
chr13	37193965	37393965	harbor2	chr13	37274367	37274508	LTR/ERVL	431	+	70	37274437	80472
chr13	37193965	37393965	harbor2	chr13	37275968	37278020	LTR/ERVL	5379	+	1026	37276994	83029
chr13	37193965	37393965	harbor2	chr13	37284732	37284887	LTR/ERVL	561	+	78	37284810	90845
chr13	37193965	37393965	harbor2	chr13	37289453	37289860	LTR/ERVL	830	+	204	37289657	95692
chr13	109467216	109667216	harbor2	chr13	109467201	109467618	LTR/ERVL	978	+	208	109467409	193
chr13	20320596	20520596	harbor2	chr13	20320754	20321016	LTR/ERVL	502	+	131	20320885	289
chr13	20320596	20520596	harbor2	chr13	20322602	20322752	LTR/ERVL	602	+	75	20322677	2081
chr13	27730189	27930189	harbor2	chr13	27778934	27779075	LTR/ERVL	902	+	70	27779004	48815
chr13	27730189	27930189	harbor2	chr13	27779527	27779707	LTR/ERVL	902	+	90	27779617	49428
chr13	20315103	20515103	harbor2	chr13	20317636	20318690	LTR/ERVL	6536	+	527	20318163	3060
chr13	20315103	20515103	harbor2	chr13	20318691	20319230	LTR/ERVL	3102	+	270	20318961	3858
chr13	20315103	20515103	harbor2	chr13	20319231	20319602	LTR/ERVL	1435	+	186	20319417	4314
chr13	20315103	20515103	harbor2	chr13	20320754	20321016	LTR/ERVL	502	+	131	20320885	5782
chr13	20315103	20515103	harbor2	chr13	20322602	20322752	LTR/ERVL	602	+	75	20322677	7574
chr13	50025816	50225816	harbor2	chr13	50115164	50115408	LTR/ERVL	813	+	122	50115286	89470
chr13	50025816	50225816	harbor2	chr13	50115466	50115714	LTR/ERVL	574	+	124	50115590	89774
chr13	110254735	110454735	harbor2	chr13	110285488	110285923	LTR/ERVL	1206	+	218	110285706	30971
chr13	100785242	100985242	harbor2	chr13	100803629	100803709	LTR/ERVL	2300	+	40	100803669	18427
chr13	100785242	100985242	harbor2	chr13	100804565	100805004	LTR/ERVL	2300	+	220	100804785	19543
chr13	100785242	100985242	harbor2	chr13	100882396	100882840	LTR/ERVL	3345	+	222	100882618	97376
chr13	100848871	101048871	harbor2	chr13	100882396	100882840	LTR/ERVL	3345	+	222	100882618	33747
chr13	100848871	101048871	harbor2	chr13	100925929	100926237	LTR/ERVL	744	+	154	100926083	77212
chr13	100848871	101048871	harbor2	chr13	100926705	100927000	LTR/ERVL	1207	+	148	100926853	77982
chr13	100848871	101048871	harbor2	chr13	100931552	100932340	LTR/ERVL	3220	+	394	100931946	83075
chr13	95000339	95200339	harbor2	chr13	95014304	95014681	LTR/ERVL	969	+	188	95014492	14153
chr13	110779820	110979820	harbor2	chr13	110814684	110815046	LTR/ERVL	1189	+	181	110814865	35045
chr13	110779820	110979820	harbor2	chr13	110859065	110859222	LTR/ERVL	439	+	78	110859143	79323
chr13	58429168	58629168	harbor2	chr13	58478773	58479143	LTR/ERVL	1810	+	185	58478958	49790
chr13	58429168	58629168	harbor2	chr13	58479170	58479215	LTR/ERVL	1810	+	22	58479192	50024
chr13	27730181	27930181	harbor2	chr13	27778934	27779075	LTR/ERVL	902	+	70	27779004	48823
chr13	27730181	27930181	harbor2	chr13	27779527	27779707	LTR/ERVL	902	+	90	27779617	49436
chr13	28720903	28920903	harbor2	chr13	28804889	28805248	LTR/ERVL	1071	+	180	28805069	84166
chr13	28720903	28920903	harbor2	chr13	28805450	28805688	LTR/ERVL	443	+	119	28805569	84666
chr13	28720903	28920903	harbor2	chr13	28806739	28806910	LTR/ERVL	497	+	86	28806825	85922
chr13	28720903	28920903	harbor2	chr13	28806892	28807078	LTR/ERVL	732	+	93	28806985	86082
chr13	28720903	28920903	harbor2	chr13	28807424	28807621	LTR/ERVL	811	+	98	28807522	86619
chr13	28720903	28920903	harbor2	chr13	28814305	28814505	LTR/ERVL	563	+	100	28814405	93502
chr13	28720903	28920903	harbor2	chr13	28815547	28815801	LTR/ERVL	761	+	127	28815674	94771
chr13	28720903	28920903	harbor2	chr13	28816107	28816179	LTR/ERVL	761	+	36	28816143	95240
chr13	110254770	110454770	harbor2	chr13	110285488	110285923	LTR/ERVL	1206	+	218	110285706	30936
chr13	23074893	23274893	harbor2	chr13	23111630	23112324	LTR/ERVL	2398	+	347	23111977	37084
chr13	23074893	23274893	harbor2	chr13	23136497	23136948	LTR/ERVL	457	+	226	23136723	61830
chr13	51842701	52042701	harbor2	chr13	51892422	51892685	LTR/ERVL	447	+	132	51892554	49853
chr13	51842701	52042701	harbor2	chr13	51892747	51892962	LTR/ERVL	591	+	108	51892855	50154
chr13	51842701	52042701	harbor2	chr13	51907260	51907813	LTR/ERVL	2708	+	276	51907536	64835
chr13	22891244	23091244	harbor2	chr13	22956525	22957080	LTR/ERVL	1724	+	278	22956803	65559
chr13	22891244	23091244	harbor2	chr13	22957806	22957895	LTR/ERVL	446	+	44	22957850	66606
chr13	100665338	100865338	harbor2	chr13	100738303	100738680	LTR/ERVL	767	+	188	100738491	73153
chr13	72960932	73160932	harbor2	chr13	73036845	73037029	LTR/ERVL	592	+	92	73036937	76005
chr13	112675199	112875199	harbor2	chr13	112684156	112684583	LTR/ERVL	2365	+	214	112684370	9171
chr13	112675199	112875199	harbor2	chr13	112772964	112773201	LTR/ERVL	799	+	118	112773082	97883
chr13	112675199	112875199	harbor2	chr13	112773229	112773299	LTR/ERVL	799	+	35	112773264	98065
chr13	50026936	50226936	harbor2	chr13	50115164	50115408	LTR/ERVL	813	+	122	50115286	88350
chr13	50026936	50226936	harbor2	chr13	50115466	50115714	LTR/ERVL	574	+	124	50115590	88654
chr14	103242844	103442844	harbor2	chr14	103260095	103260635	LTR/ERVL	2035	+	270	103260365	17521
chr14	103242844	103442844	harbor2	chr14	103260665	103261052	LTR/ERVL	2743	+	194	103260859	18015
chr14	103242844	103442844	harbor2	chr14	103261053	103261239	LTR/ERVL	734	+	93	103261146	18302
chr14	103242844	103442844	harbor2	chr14	103312130	103312301	LTR/ERVL	486	+	86	103312216	69372
chr14	90283171	90483171	harbor2	chr14	90340655	90341063	LTR/ERVL	865	+	204	90340859	57688
chr14	90283171	90483171	harbor2	chr14	90341356	90341476	LTR/ERVL	865	+	60	90341416	58245
chr14	64418631	64618631	harbor2	chr14	64479431	64479950	LTR/ERVL	2351	+	260	64479691	61060
chr14	99583954	99783954	harbor2	chr14	99643632	99644081	LTR/ERVL	1139	+	224	99643856	59902
chr14	100185464	100385464	harbor2	chr14	100206120	100206922	LTR/ERVL	2313	+	401	100206521	21057
chr14	75328321	75528321	harbor2	chr14	75344361	75344843	LTR/ERVL	2261	+	241	75344602	16281
chr14	75328321	75528321	harbor2	chr14	75345881	75346312	LTR/ERVL	2049	+	216	75346097	17776
chr14	75328321	75528321	harbor2	chr14	75369589	75370008	LTR/ERVL	1366	+	210	75369799	41478
chr14	75328321	75528321	harbor2	chr14	75370049	75370247	LTR/ERVL	802	+	99	75370148	41827
chr14	75328321	75528321	harbor2	chr14	75370263	75370616	LTR/ERVL	1119	+	176	75370439	42118
chr14	75328321	75528321	harbor2	chr14	75374557	75375034	LTR/ERVL	2698	+	238	75374795	46474
chr14	100198905	100398905	harbor2	chr14	100206120	100206922	LTR/ERVL	2313	+	401	100206521	7616
chr14	92647880	92847880	harbor2	chr14	92653160	92653578	LTR/ERVL	984	+	209	92653369	5489
chr14	92647880	92847880	harbor2	chr14	92693823	92694339	LTR/ERVL	1685	+	258	92694081	46201
chr14	92647880	92847880	harbor2	chr14	92702633	92703040	LTR/ERVL	2069	+	204	92702837	54957
chr14	90283153	90483153	harbor2	chr14	90340655	90341063	LTR/ERVL	865	+	204	90340859	57706
chr14	90283153	90483153	harbor2	chr14	90341356	90341476	LTR/ERVL	865	+	60	90341416	58263
chr14	90283474	90483474	harbor2	chr14	90340655	90341063	LTR/ERVL	865	+	204	90340859	57385
chr14	90283474	90483474	harbor2	chr14	90341356	90341476	LTR/ERVL	865	+	60	90341416	57942
chr14	101610279	101810279	harbor2	chr14	101687842	101688267	LTR/ERVL	1054	+	212	101688054	77775
chr14	101610279	101810279	harbor2	chr14	101701719	101702132	LTR/ERVL	1929	+	206	101701925	91646
chr14	101610279	101810279	harbor2	chr14	101702171	101702194	LTR/ERVL	1102	+	12	101702183	91904
chr14	67500241	67700241	harbor2	chr14	67530451	67530755	LTR/ERVL	893	+	152	67530603	30362
chr14	54389016	54589016	harbor2	chr14	54395308	54395767	LTR/ERVL	1487	+	230	54395538	6522
chr14	75330460	75530460	harbor2	chr14	75344361	75344843	LTR/ERVL	2261	+	241	75344602	14142
chr14	75330460	75530460	harbor2	chr14	75345881	75346312	LTR/ERVL	2049	+	216	75346097	15637
chr14	75330460	75530460	harbor2	chr14	75369589	75370008	LTR/ERVL	1366	+	210	75369799	39339
chr14	75330460	75530460	harbor2	chr14	75370049	75370247	LTR/ERVL	802	+	99	75370148	39688
chr14	75330460	75530460	harbor2	chr14	75370263	75370616	LTR/ERVL	1119	+	176	75370439	39979
chr14	75330460	75530460	harbor2	chr14	75374557	75375034	LTR/ERVL	2698	+	238	75374795	44335
chr14	51889569	52089569	harbor2	chr14	51956131	51956575	LTR/ERVL	1669	+	222	51956353	66784
chr14	51889569	52089569	harbor2	chr14	51974526	51974849	LTR/ERVL	776	+	162	51974688	85119
chr14	104203027	104403027	harbor2	chr14	104294525	104294946	LTR/ERVL	740	+	210	104294735	91708
chr14	93232282	93432282	harbor2	chr14	93273359	93273918	LTR/ERVL	626	+	280	93273639	41357
chr14	93232282	93432282	harbor2	chr14	93274328	93274766	LTR/ERVL	1343	+	219	93274547	42265
chr14	93232282	93432282	harbor2	chr14	93312467	93312955	LTR/ERVL	2434	+	244	93312711	80429
chr14	93232282	93432282	harbor2	chr14	93317623	93318138	LTR/ERVL	2599	+	258	93317881	85599
chr14	90960739	91160739	harbor2	chr14	90986593	90986991	LTR/ERVL	1172	+	199	90986792	26053
chr14	90960739	91160739	harbor2	chr14	91016687	91018315	LTR/ERVL	10301	+	814	91017501	56762
chr14	90960739	91160739	harbor2	chr14	91018316	91018904	LTR/ERVL	2293	+	294	91018610	57871
chr14	90960739	91160739	harbor2	chr14	91018905	91019171	LTR/ERVL	10301	+	133	91019038	58299
chr14	90960739	91160739	harbor2	chr14	91019172	91019592	LTR/ERVL	1448	+	210	91019382	58643
chr14	23420834	23620834	harbor2	chr14	23456685	23456957	LTR/ERVL	3361	+	136	23456821	35987
chr14	23420834	23620834	harbor2	chr14	23457679	23458309	LTR/ERVL	3361	+	315	23457994	37160
chr14	75329481	75529481	harbor2	chr14	75344361	75344843	LTR/ERVL	2261	+	241	75344602	15121
chr14	75329481	75529481	harbor2	chr14	75345881	75346312	LTR/ERVL	2049	+	216	75346097	16616
chr14	75329481	75529481	harbor2	chr14	75369589	75370008	LTR/ERVL	1366	+	210	75369799	40318
chr14	75329481	75529481	harbor2	chr14	75370049	75370247	LTR/ERVL	802	+	99	75370148	40667
chr14	75329481	75529481	harbor2	chr14	75370263	75370616	LTR/ERVL	1119	+	176	75370439	40958
chr14	75329481	75529481	harbor2	chr14	75374557	75375034	LTR/ERVL	2698	+	238	75374795	45314
chr14	105106012	105306012	harbor2	chr14	105124374	105124689	LTR/ERVL	522	+	158	105124532	18520
chr14	105106012	105306012	harbor2	chr14	105129954	105130159	LTR/ERVL	4627	+	102	105130056	24044
chr14	105106012	105306012	harbor2	chr14	105130472	105130786	LTR/ERVL	4627	+	157	105130629	24617
chr14	105106012	105306012	harbor2	chr14	105131090	105131880	LTR/ERVL	4627	+	395	105131485	25473
chr14	75329814	75529814	harbor2	chr14	75344361	75344843	LTR/ERVL	2261	+	241	75344602	14788
chr14	75329814	75529814	harbor2	chr14	75345881	75346312	LTR/ERVL	2049	+	216	75346097	16283
chr14	75329814	75529814	harbor2	chr14	75369589	75370008	LTR/ERVL	1366	+	210	75369799	39985
chr14	75329814	75529814	harbor2	chr14	75370049	75370247	LTR/ERVL	802	+	99	75370148	40334
chr14	75329814	75529814	harbor2	chr14	75370263	75370616	LTR/ERVL	1119	+	176	75370439	40625
chr14	75329814	75529814	harbor2	chr14	75374557	75375034	LTR/ERVL	2698	+	238	75374795	44981
chr14	104404069	104604069	harbor2	chr14	104495848	104496408	LTR/ERVL	1620	+	280	104496128	92059
chr14	104404069	104604069	harbor2	chr14	104496785	104497225	LTR/ERVL	886	+	220	104497005	92936
chr14	104017421	104217421	harbor2	chr14	104043839	104044308	LTR/ERVL	1964	+	234	104044073	26652
chr14	104017421	104217421	harbor2	chr14	104068870	104069388	LTR/ERVL	2606	+	259	104069129	51708
chr14	104017421	104217421	harbor2	chr14	104078003	104078184	LTR/ERVL	699	+	90	104078093	60672
chr14	67500259	67700259	harbor2	chr14	67530451	67530755	LTR/ERVL	893	+	152	67530603	30344
chr14	73545011	73745011	harbor2	chr14	73609103	73609631	LTR/ERVL	5350	+	264	73609367	64356
chr14	73545011	73745011	harbor2	chr14	73609939	73610290	LTR/ERVL	5350	+	176	73610115	65104
chr14	73545011	73745011	harbor2	chr14	73610591	73610697	LTR/ERVL	5350	+	53	73610644	65633
chr14	73545011	73745011	harbor2	chr14	73610704	73611149	LTR/ERVL	2638	+	222	73610926	65915
chr14	104623763	104823763	harbor2	chr14	104662325	104662713	LTR/ERVL	1267	+	194	104662519	38756
chr14	90283167	90483167	harbor2	chr14	90340655	90341063	LTR/ERVL	865	+	204	90340859	57692
chr14	90283167	90483167	harbor2	chr14	90341356	90341476	LTR/ERVL	865	+	60	90341416	58249
chr14	100185450	100385450	harbor2	chr14	100206120	100206922	LTR/ERVL	2313	+	401	100206521	21071
chr14	105872245	106072245	harbor2	chr14	105965186	105966563	LTR/ERVL	10879	+	688	105965874	93629
chr14	105872245	106072245	harbor2	chr14	105966564	105966980	LTR/ERVL	3226	+	208	105966772	94527
chr14	90283475	90483475	harbor2	chr14	90340655	90341063	LTR/ERVL	865	+	204	90340859	57384
chr14	90283475	90483475	harbor2	chr14	90341356	90341476	LTR/ERVL	865	+	60	90341416	57941
chr14	55029365	55229365	harbor2	chr14	55081514	55081697	LTR/ERVL	728	+	92	55081606	52241
chr14	55029365	55229365	harbor2	chr14	55085390	55085659	LTR/ERVL	679	+	134	55085524	56159
chr14	55029365	55229365	harbor2	chr14	55085952	55085991	LTR/ERVL	679	+	20	55085972	56607
chr14	55029365	55229365	harbor2	chr14	55109946	55110212	LTR/ERVL	2095	+	133	55110079	80714
chr14	55029365	55229365	harbor2	chr14	55110518	55110614	LTR/ERVL	2095	+	48	55110566	81201
chr14	55029365	55229365	harbor2	chr14	55110750	55110830	LTR/ERVL	2095	+	40	55110790	81425
chr14	55029365	55229365	harbor2	chr14	55110946	55111255	LTR/ERVL	1036	+	154	55111100	81735
chr14	55029365	55229365	harbor2	chr14	55111540	55111662	LTR/ERVL	2595	+	61	55111601	82236
chr14	55029365	55229365	harbor2	chr14	55111933	55112261	LTR/ERVL	2595	+	164	55112097	82732
chr14	92958098	93158098	harbor2	chr14	92975502	92975805	LTR/ERVL	1188	+	152	92975654	17556
chr14	92958098	93158098	harbor2	chr14	92976163	92976245	LTR/ERVL	1188	+	41	92976204	18106
chr14	92958098	93158098	harbor2	chr14	93018026	93018470	LTR/ERVL	598	+	222	93018248	60150
chr14	75330552	75530552	harbor2	chr14	75344361	75344843	LTR/ERVL	2261	+	241	75344602	14050
chr14	75330552	75530552	harbor2	chr14	75345881	75346312	LTR/ERVL	2049	+	216	75346097	15545
chr14	75330552	75530552	harbor2	chr14	75369589	75370008	LTR/ERVL	1366	+	210	75369799	39247
chr14	75330552	75530552	harbor2	chr14	75370049	75370247	LTR/ERVL	802	+	99	75370148	39596
chr14	75330552	75530552	harbor2	chr14	75370263	75370616	LTR/ERVL	1119	+	176	75370439	39887
chr14	75330552	75530552	harbor2	chr14	75374557	75375034	LTR/ERVL	2698	+	238	75374795	44243
chr14	75328337	75528337	harbor2	chr14	75344361	75344843	LTR/ERVL	2261	+	241	75344602	16265
chr14	75328337	75528337	harbor2	chr14	75345881	75346312	LTR/ERVL	2049	+	216	75346097	17760
chr14	75328337	75528337	harbor2	chr14	75369589	75370008	LTR/ERVL	1366	+	210	75369799	41462
chr14	75328337	75528337	harbor2	chr14	75370049	75370247	LTR/ERVL	802	+	99	75370148	41811
chr14	75328337	75528337	harbor2	chr14	75370263	75370616	LTR/ERVL	1119	+	176	75370439	42102
chr14	75328337	75528337	harbor2	chr14	75374557	75375034	LTR/ERVL	2698	+	238	75374795	46458
chr14	73358260	73558260	harbor2	chr14	73400468	73401216	LTR/ERVL	4300	+	374	73400842	42582
chr14	104654376	104854376	harbor2	chr14	104662325	104662713	LTR/ERVL	1267	+	194	104662519	8143
chr14	104654376	104854376	harbor2	chr14	104748812	104749690	LTR/ERVL	3664	+	439	104749251	94875
chr14	104019012	104219012	harbor2	chr14	104043839	104044308	LTR/ERVL	1964	+	234	104044073	25061
chr14	104019012	104219012	harbor2	chr14	104068870	104069388	LTR/ERVL	2606	+	259	104069129	50117
chr14	104019012	104219012	harbor2	chr14	104078003	104078184	LTR/ERVL	699	+	90	104078093	59081
chr14	100582274	100782274	harbor2	chr14	100607634	100608022	LTR/ERVL	971	+	194	100607828	25554
chr14	100582274	100782274	harbor2	chr14	100616680	100617256	LTR/ERVL	1421	+	288	100616968	34694
chr14	100582274	100782274	harbor2	chr14	100624119	100624571	LTR/ERVL	1104	+	226	100624345	42071
chr14	100582274	100782274	harbor2	chr14	100629659	100630121	LTR/ERVL	1970	+	231	100629890	47616
chr14	20369338	20569338	harbor2	chr14	20394794	20395023	LTR/ERVL	584	+	114	20394908	25570
chr14	75329541	75529541	harbor2	chr14	75344361	75344843	LTR/ERVL	2261	+	241	75344602	15061
chr14	75329541	75529541	harbor2	chr14	75345881	75346312	LTR/ERVL	2049	+	216	75346097	16556
chr14	75329541	75529541	harbor2	chr14	75369589	75370008	LTR/ERVL	1366	+	210	75369799	40258
chr14	75329541	75529541	harbor2	chr14	75370049	75370247	LTR/ERVL	802	+	99	75370148	40607
chr14	75329541	75529541	harbor2	chr14	75370263	75370616	LTR/ERVL	1119	+	176	75370439	40898
chr14	75329541	75529541	harbor2	chr14	75374557	75375034	LTR/ERVL	2698	+	238	75374795	45254
chr14	95542807	95742807	harbor2	chr14	95554676	95554872	LTR/ERVL	1789	+	98	95554774	11967
chr14	95542807	95742807	harbor2	chr14	95555148	95555507	LTR/ERVL	1789	+	180	95555328	12521
chr14	95542807	95742807	harbor2	chr14	95573877	95574362	LTR/ERVL	1456	+	242	95574119	31312
chr14	95542807	95742807	harbor2	chr14	95616657	95617128	LTR/ERVL	2767	+	236	95616893	74086
chr14	99637683	99837683	harbor2	chr14	99643632	99644081	LTR/ERVL	1139	+	224	99643856	6173
chr14	96745593	96945593	harbor2	chr14	96827196	96827383	LTR/ERVL	607	+	94	96827290	81697
chr14	96745593	96945593	harbor2	chr14	96827603	96827802	LTR/ERVL	471	+	100	96827703	82110
chr14	78725637	78925637	harbor2	chr14	78788334	78788807	LTR/ERVL	651	+	236	78788570	62933
chr14	104256665	104456665	harbor2	chr14	104294525	104294946	LTR/ERVL	740	+	210	104294735	38070
chr14	91232557	91432557	harbor2	chr14	91257474	91257894	LTR/ERVL	1034	+	210	91257684	25127
chr14	91232557	91432557	harbor2	chr14	91268100	91268400	LTR/ERVL	2102	+	150	91268250	35693
chr14	91232557	91432557	harbor2	chr14	91269139	91269218	LTR/ERVL	555	+	40	91269179	36622
chr14	91232557	91432557	harbor2	chr14	91320055	91320764	LTR/ERVL	2904	+	354	91320409	87852
chr15	31401692	31601692	harbor2	chr15	31426679	31427226	LTR/ERVL	2947	+	274	31426953	25261
chr15	31401692	31601692	harbor2	chr15	31462747	31463031	LTR/ERVL	2574	+	142	31462889	61197
chr15	31401692	31601692	harbor2	chr15	31463341	31463854	LTR/ERVL	2574	+	256	31463597	61905
chr15	31401692	31601692	harbor2	chr15	31467539	31468126	LTR/ERVL	1864	+	294	31467833	66141
chr15	31401692	31601692	harbor2	chr15	31468425	31468704	LTR/ERVL	1864	+	140	31468565	66873
chr15	31401692	31601692	harbor2	chr15	31469753	31470005	LTR/ERVL	1864	+	126	31469879	68187
chr15	31401692	31601692	harbor2	chr15	31470010	31470663	LTR/ERVL	1055	+	326	31470336	68644
chr15	31401692	31601692	harbor2	chr15	31471405	31472856	LTR/ERVL	3238	+	726	31472131	70439
chr15	31401692	31601692	harbor2	chr15	31473145	31473457	LTR/ERVL	553	+	156	31473301	71609
chr15	29170226	29370226	harbor2	chr15	29188112	29188245	LTR/ERVL	3440	+	66	29188178	17952
chr15	29170226	29370226	harbor2	chr15	29188616	29189372	LTR/ERVL	3440	+	378	29188994	18768
chr15	29170226	29370226	harbor2	chr15	29193151	29193692	LTR/ERVL	2923	+	270	29193421	23195
chr15	29170226	29370226	harbor2	chr15	29209994	29210364	LTR/ERVL	1931	+	185	29210179	39953
chr15	29170226	29370226	harbor2	chr15	29210707	29210866	LTR/ERVL	1931	+	80	29210787	40561
chr15	29170226	29370226	harbor2	chr15	29215185	29215568	LTR/ERVL	3199	+	192	29215377	45151
chr15	29170226	29370226	harbor2	chr15	29215598	29215637	LTR/ERVL	3199	+	20	29215618	45392
chr15	29170226	29370226	harbor2	chr15	29262159	29263033	LTR/ERVL	5139	+	437	29262596	92370
chr15	50324378	50524378	harbor2	chr15	50388354	50388548	LTR/ERVL	1056	+	97	50388451	64073
chr15	50324378	50524378	harbor2	chr15	50388553	50389509	LTR/ERVL	13488	+	478	50389031	64653
chr15	50324378	50524378	harbor2	chr15	50389834	50390115	LTR/ERVL	13488	+	140	50389974	65596
chr15	50324378	50524378	harbor2	chr15	50390435	50391559	LTR/ERVL	13488	+	562	50390997	66619
chr15	50324378	50524378	harbor2	chr15	50391565	50391819	LTR/ERVL	1151	+	127	50391692	67314
chr15	50324378	50524378	harbor2	chr15	50392067	50392241	LTR/ERVL	1093	+	87	50392154	67776
chr15	50324378	50524378	harbor2	chr15	50415912	50416104	LTR/ERVL	479	+	96	50416008	91630
chr15	33938898	34138898	harbor2	chr15	33999026	33999248	LTR/ERVL	605	+	111	33999137	60239
chr15	75354520	75554520	harbor2	chr15	75379854	75380375	LTR/ERVL	2904	+	260	75380114	25594
chr15	35992850	36192850	harbor2	chr15	36007811	36008356	LTR/ERVL	3124	+	272	36008083	15233
chr15	35992850	36192850	harbor2	chr15	36062553	36062988	LTR/ERVL	1523	+	218	36062771	69921
chr15	101862140	102062140	harbor2	chr15	101948690	101949583	LTR/ERVL	756	+	446	101949136	86996
chr15	101861388	102061388	harbor2	chr15	101948690	101949583	LTR/ERVL	756	+	446	101949136	87748
chr15	39901338	40101338	harbor2	chr15	39924394	39924939	LTR/ERVL	3101	+	272	39924666	23328
chr15	79797266	79997266	harbor2	chr15	79804459	79804736	LTR/ERVL	866	+	138	79804597	7331
chr15	79797266	79997266	harbor2	chr15	79821616	79822026	LTR/ERVL	3407	+	205	79821821	24555
chr15	79797266	79997266	harbor2	chr15	79822206	79822682	LTR/ERVL	3407	+	238	79822444	25178
chr15	79797266	79997266	harbor2	chr15	79868461	79868861	LTR/ERVL	1413	+	200	79868661	71395
chr15	79797266	79997266	harbor2	chr15	79822688	79823244	LTR/ERVL	1907	+	278	79822966	25700
chr15	75248486	75448486	harbor2	chr15	75314899	75315870	LTR/ERVL	1509	+	486	75315385	66899
chr15	75248486	75448486	harbor2	chr15	75316169	75316770	LTR/ERVL	1509	+	300	75316469	67983
chr15	45242182	45442182	harbor2	chr15	45282542	45282959	LTR/ERVL	498	+	208	45282750	40568
chr15	45242182	45442182	harbor2	chr15	45285671	45286355	LTR/ERVL	700	+	342	45286013	43831
chr15	45242182	45442182	harbor2	chr15	45286471	45286823	LTR/ERVL	1058	+	176	45286647	44465
chr15	45242182	45442182	harbor2	chr15	45287103	45287148	LTR/ERVL	1058	+	22	45287125	44943
chr15	45242182	45442182	harbor2	chr15	45287184	45287372	LTR/ERVL	978	+	94	45287278	45096
chr15	45242182	45442182	harbor2	chr15	45287598	45287857	LTR/ERVL	978	+	130	45287728	45546
chr15	53985076	54185076	harbor2	chr15	54029757	54030235	LTR/ERVL	956	+	239	54029996	44920
chr15	69999345	70199345	harbor2	chr15	70003072	70003184	LTR/ERVL	430	+	56	70003128	3783
chr15	101861522	102061522	harbor2	chr15	101948690	101949583	LTR/ERVL	756	+	446	101949136	87614
chr15	40121372	40321372	harbor2	chr15	40149436	40149885	LTR/ERVL	858	+	224	40149660	28288
chr15	69999529	70199529	harbor2	chr15	70003072	70003184	LTR/ERVL	430	+	56	70003128	3599
chr15	63409518	63609518	harbor2	chr15	63419809	63420185	LTR/ERVL	915	+	188	63419997	10479
chr15	63409518	63609518	harbor2	chr15	63420639	63420736	LTR/ERVL	915	+	48	63420687	11169
chr15	63409518	63609518	harbor2	chr15	63427678	63428091	LTR/ERVL	1226	+	206	63427884	18366
chr15	63409518	63609518	harbor2	chr15	63460442	63460629	LTR/ERVL	484	+	94	63460536	51018
chr15	63409518	63609518	harbor2	chr15	63460690	63460806	LTR/ERVL	415	+	58	63460748	51230
chr15	100502491	100702491	harbor2	chr15	100512169	100512345	LTR/ERVL	864	+	88	100512257	9766
chr15	100502491	100702491	harbor2	chr15	100512367	100512678	LTR/ERVL	1194	+	156	100512523	10032
chr15	45303426	45503426	harbor2	chr15	45344538	45344780	LTR/ERVL	2150	+	121	45344659	41233
chr15	45303426	45503426	harbor2	chr15	45345099	45345266	LTR/ERVL	2150	+	84	45345183	41757
chr15	45303426	45503426	harbor2	chr15	45345310	45345422	LTR/ERVL	2150	+	56	45345366	41940
chr15	45303426	45503426	harbor2	chr15	45397084	45398013	LTR/ERVL	4102	+	464	45397548	94122
chr15	98322213	98522213	harbor2	chr15	98324641	98324959	LTR/ERVL	1314	+	159	98324800	2587
chr15	98322213	98522213	harbor2	chr15	98325313	98325705	LTR/ERVL	1314	+	196	98325509	3296
chr15	98322213	98522213	harbor2	chr15	98349551	98349758	LTR/ERVL	897	+	104	98349655	27442
chr15	98322213	98522213	harbor2	chr15	98360016	98360448	LTR/ERVL	1009	+	216	98360232	38019
chr15	98322213	98522213	harbor2	chr15	98363449	98363889	LTR/ERVL	727	+	220	98363669	41456
chr15	98322213	98522213	harbor2	chr15	98416953	98417391	LTR/ERVL	1391	+	219	98417172	94959
chr15	69719502	69919502	harbor2	chr15	69785013	69785240	LTR/ERVL	636	+	114	69785127	65625
chr15	64256308	64456308	harbor2	chr15	64324216	64324765	LTR/ERVL	1847	+	274	64324490	68182
chr15	101861640	102061640	harbor2	chr15	101948690	101949583	LTR/ERVL	756	+	446	101949136	87496
chr15	26348871	26548871	harbor2	chr15	26402541	26403119	LTR/ERVL	963	+	289	26402830	53959
chr15	51149547	51349547	harbor2	chr15	51180499	51180990	LTR/ERVL	2092	+	246	51180745	31198
chr15	98032466	98232466	harbor2	chr15	98045786	98045933	LTR/ERVL	564	+	74	98045860	13394
chr15	98032466	98232466	harbor2	chr15	98045957	98046660	LTR/ERVL	1109	+	352	98046309	13843
chr15	98032466	98232466	harbor2	chr15	98048423	98048760	LTR/ERVL	1505	+	168	98048591	16125
chr15	98032466	98232466	harbor2	chr15	98048882	98049022	LTR/ERVL	965	+	70	98048952	16486
chr15	98032466	98232466	harbor2	chr15	98129133	98129470	LTR/ERVL	1792	+	168	98129301	96835
chr15	98032466	98232466	harbor2	chr15	98131195	98131561	LTR/ERVL	1117	+	183	98131378	98912
chr15	28554377	28754377	harbor2	chr15	28597560	28597957	LTR/ERVL	836	+	198	28597758	43381
chr15	28554377	28754377	harbor2	chr15	28617325	28617480	LTR/ERVL	716	+	78	28617403	63026
chr15	101861538	102061538	harbor2	chr15	101948690	101949583	LTR/ERVL	756	+	446	101949136	87598
chr15	74947191	75147191	harbor2	chr15	74965309	74965719	LTR/ERVL	434	+	205	74965514	18323
chr15	74947191	75147191	harbor2	chr15	74979643	74980018	LTR/ERVL	1737	+	188	74979831	32640
chr15	74947191	75147191	harbor2	chr15	74991948	74992195	LTR/ERVL	778	+	124	74992072	44881
chr15	74962964	75162964	harbor2	chr15	74965309	74965719	LTR/ERVL	434	+	205	74965514	2550
chr15	74962964	75162964	harbor2	chr15	74979643	74980018	LTR/ERVL	1737	+	188	74979831	16867
chr15	74962964	75162964	harbor2	chr15	74991948	74992195	LTR/ERVL	778	+	124	74992072	29108
chr15	80115684	80315684	harbor2	chr15	80193204	80193510	LTR/ERVL	894	+	153	80193357	77673
chr15	80115684	80315684	harbor2	chr15	80193697	80194022	LTR/ERVL	1309	+	162	80193859	78175
chr15	80115684	80315684	harbor2	chr15	80194254	80194911	LTR/ERVL	2039	+	328	80194582	78898
chr15	80115684	80315684	harbor2	chr15	80194917	80195413	LTR/ERVL	1659	+	248	80195165	79481
chr15	80115684	80315684	harbor2	chr15	80195837	80196091	LTR/ERVL	799	+	127	80195964	80280
chr15	80115684	80315684	harbor2	chr15	80196738	80197051	LTR/ERVL	1454	+	156	80196894	81210
chr15	80115684	80315684	harbor2	chr15	80197365	80197496	LTR/ERVL	1454	+	66	80197431	81747
chr15	80115684	80315684	harbor2	chr15	80211832	80212320	LTR/ERVL	1742	+	244	80212076	96392
chr15	52686651	52886651	harbor2	chr15	52725082	52725277	LTR/ERVL	1426	+	98	52725180	38529
chr15	52686651	52886651	harbor2	chr15	52725789	52726021	LTR/ERVL	1426	+	116	52725905	39254
chr15	52686651	52886651	harbor2	chr15	52760891	52761354	LTR/ERVL	705	+	232	52761123	74472
chr15	101861562	102061562	harbor2	chr15	101948690	101949583	LTR/ERVL	756	+	446	101949136	87574
chr15	101862064	102062064	harbor2	chr15	101948690	101949583	LTR/ERVL	756	+	446	101949136	87072
chr15	29169897	29369897	harbor2	chr15	29188112	29188245	LTR/ERVL	3440	+	66	29188178	18281
chr15	29169897	29369897	harbor2	chr15	29188616	29189372	LTR/ERVL	3440	+	378	29188994	19097
chr15	29169897	29369897	harbor2	chr15	29193151	29193692	LTR/ERVL	2923	+	270	29193421	23524
chr15	29169897	29369897	harbor2	chr15	29209994	29210364	LTR/ERVL	1931	+	185	29210179	40282
chr15	29169897	29369897	harbor2	chr15	29210707	29210866	LTR/ERVL	1931	+	80	29210787	40890
chr15	29169897	29369897	harbor2	chr15	29215185	29215568	LTR/ERVL	3199	+	192	29215377	45480
chr15	29169897	29369897	harbor2	chr15	29215598	29215637	LTR/ERVL	3199	+	20	29215618	45721
chr15	29169897	29369897	harbor2	chr15	29262159	29263033	LTR/ERVL	5139	+	437	29262596	92699
chr15	34426686	34626686	harbor2	chr15	34463512	34463941	LTR/ERVL	2900	+	214	34463726	37040
chr15	34426686	34626686	harbor2	chr15	34476095	34476472	LTR/ERVL	892	+	188	34476283	49597
chr15	66727859	66927859	harbor2	chr15	66790919	66791337	LTR/ERVL	1586	+	209	66791128	63269
chr15	66727859	66927859	harbor2	chr15	66791339	66791429	LTR/ERVL	464	+	45	66791384	63525
chr15	66727859	66927859	harbor2	chr15	66791736	66792209	LTR/ERVL	1528	+	236	66791972	64113
chr15	66727859	66927859	harbor2	chr15	66792282	66792395	LTR/ERVL	2520	+	56	66792338	64479
chr15	66727859	66927859	harbor2	chr15	66792694	66793061	LTR/ERVL	2520	+	184	66792878	65019
chr15	66727859	66927859	harbor2	chr15	66793461	66793659	LTR/ERVL	2520	+	99	66793560	65701
chr15	66727859	66927859	harbor2	chr15	66793952	66794315	LTR/ERVL	2520	+	182	66794134	66275
chr15	66727859	66927859	harbor2	chr15	66794433	66794659	LTR/ERVL	1018	+	113	66794546	66687
chr15	66727859	66927859	harbor2	chr15	66794687	66794980	LTR/ERVL	1347	+	146	66794833	66974
chr15	66727859	66927859	harbor2	chr15	66795264	66795376	LTR/ERVL	1347	+	56	66795320	67461
chr15	66727859	66927859	harbor2	chr15	66795529	66795741	LTR/ERVL	764	+	106	66795635	67776
chr16	700508	900508	harbor2	chr16	735073	735423	LTR/ERVL	814	+	175	735248	34740
chr16	700508	900508	harbor2	chr16	735416	735901	LTR/ERVL	1401	+	242	735658	35150
chr16	700508	900508	harbor2	chr16	760974	761306	LTR/ERVL	802	+	166	761140	60632
chr16	700537	900537	harbor2	chr16	735073	735423	LTR/ERVL	814	+	175	735248	34711
chr16	700537	900537	harbor2	chr16	735416	735901	LTR/ERVL	1401	+	242	735658	35121
chr16	700537	900537	harbor2	chr16	760974	761306	LTR/ERVL	802	+	166	761140	60603
chr16	1279091	1479091	harbor2	chr16	1297517	1297646	LTR/ERVL	614	+	64	1297581	18490
chr16	66222808	66422808	harbor2	chr16	66253500	66253995	LTR/ERVL	2122	+	248	66253748	30940
chr16	66222808	66422808	harbor2	chr16	66273162	66273705	LTR/ERVL	1847	+	272	66273434	50626
chr16	700507	900507	harbor2	chr16	735073	735423	LTR/ERVL	814	+	175	735248	34741
chr16	700507	900507	harbor2	chr16	735416	735901	LTR/ERVL	1401	+	242	735658	35151
chr16	700507	900507	harbor2	chr16	760974	761306	LTR/ERVL	802	+	166	761140	60633
chr16	846589	1046589	harbor2	chr16	906244	906669	LTR/ERVL	2499	+	212	906456	59867
chr16	2438113	2638113	harbor2	chr16	2485088	2485852	LTR/ERVL	1790	+	382	2485470	47357
chr16	79433396	79633396	harbor2	chr16	79514654	79514906	LTR/ERVL	562	+	126	79514780	81384
chr16	870904	1070904	harbor2	chr16	906244	906669	LTR/ERVL	2499	+	212	906456	35552
chr16	88709995	88909995	harbor2	chr16	88755245	88755691	LTR/ERVL	1437	+	223	88755468	45473
chr16	88709995	88909995	harbor2	chr16	88766100	88766425	LTR/ERVL	681	+	162	88766262	56267
chr16	1892435	2092435	harbor2	chr16	1904421	1904676	LTR/ERVL	696	+	128	1904549	12114
chr16	1892435	2092435	harbor2	chr16	1936811	1937145	LTR/ERVL	1374	+	167	1936978	44543
chr16	88685860	88885860	harbor2	chr16	88755245	88755691	LTR/ERVL	1437	+	223	88755468	69608
chr16	88685860	88885860	harbor2	chr16	88766100	88766425	LTR/ERVL	681	+	162	88766262	80402
chr16	89759708	89959708	harbor2	chr16	89804287	89804524	LTR/ERVL	1419	+	118	89804405	44697
chr16	77583873	77783873	harbor2	chr16	77604805	77605084	LTR/ERVL	685	+	140	77604945	21072
chr16	77583873	77783873	harbor2	chr16	77641864	77642135	LTR/ERVL	583	+	136	77642000	58127
chr16	77583873	77783873	harbor2	chr16	77671822	77671896	LTR/ERVL	578	+	37	77671859	87986
chr16	77583873	77783873	harbor2	chr16	77671952	77672443	LTR/ERVL	1593	+	246	77672198	88325
chr16	1892462	2092462	harbor2	chr16	1904421	1904676	LTR/ERVL	696	+	128	1904549	12087
chr16	1892462	2092462	harbor2	chr16	1936811	1937145	LTR/ERVL	1374	+	167	1936978	44516
chr16	4084047	4284047	harbor2	chr16	4134690	4134935	LTR/ERVL	1839	+	122	4134812	50765
chr16	4084047	4284047	harbor2	chr16	4135246	4135336	LTR/ERVL	1839	+	45	4135291	51244
chr16	4084047	4284047	harbor2	chr16	4180175	4180381	LTR/ERVL	552	+	103	4180278	96231
chr16	2865108	3065108	harbor2	chr16	2942645	2942720	LTR/ERVL	1819	+	38	2942683	77575
chr16	2865108	3065108	harbor2	chr16	2943001	2943487	LTR/ERVL	1819	+	243	2943244	78136
chr16	700530	900530	harbor2	chr16	735073	735423	LTR/ERVL	814	+	175	735248	34718
chr16	700530	900530	harbor2	chr16	735416	735901	LTR/ERVL	1401	+	242	735658	35128
chr16	700530	900530	harbor2	chr16	760974	761306	LTR/ERVL	802	+	166	761140	60610
chr16	700526	900526	harbor2	chr16	735073	735423	LTR/ERVL	814	+	175	735248	34722
chr16	700526	900526	harbor2	chr16	735416	735901	LTR/ERVL	1401	+	242	735658	35132
chr16	700526	900526	harbor2	chr16	760974	761306	LTR/ERVL	802	+	166	761140	60614
chr16	870844	1070844	harbor2	chr16	906244	906669	LTR/ERVL	2499	+	212	906456	35612
chr16	31042548	31242548	harbor2	chr16	31100362	31100712	LTR/ERVL	2556	+	175	31100537	57989
chr16	31042548	31242548	harbor2	chr16	31101019	31101264	LTR/ERVL	2556	+	122	31101141	58593
chr16	1864895	2064895	harbor2	chr16	1904421	1904676	LTR/ERVL	696	+	128	1904549	39654
chr16	1864895	2064895	harbor2	chr16	1936811	1937145	LTR/ERVL	1374	+	167	1936978	72083
chr16	1892270	2092270	harbor2	chr16	1904421	1904676	LTR/ERVL	696	+	128	1904549	12279
chr16	1892270	2092270	harbor2	chr16	1936811	1937145	LTR/ERVL	1374	+	167	1936978	44708
chr16	31042549	31242549	harbor2	chr16	31100362	31100712	LTR/ERVL	2556	+	175	31100537	57988
chr16	31042549	31242549	harbor2	chr16	31101019	31101264	LTR/ERVL	2556	+	122	31101141	58592
chr16	56536473	56736473	harbor2	chr16	56569217	56569578	LTR/ERVL	1174	+	180	56569397	32924
chr16	704549	904549	harbor2	chr16	735073	735423	LTR/ERVL	814	+	175	735248	30699
chr16	704549	904549	harbor2	chr16	735416	735901	LTR/ERVL	1401	+	242	735658	31109
chr16	704549	904549	harbor2	chr16	760974	761306	LTR/ERVL	802	+	166	761140	56591
chr16	1279028	1479028	harbor2	chr16	1297517	1297646	LTR/ERVL	614	+	64	1297581	18553
chr16	46873069	47073069	harbor2	chr16	46873330	46873664	LTR/ERVL	1170	+	167	46873497	428
chr16	27963957	28163957	harbor2	chr16	27984292	27984461	LTR/ERVL	703	+	84	27984376	20419
chr16	27963957	28163957	harbor2	chr16	27991981	27992214	LTR/ERVL	2403	+	116	27992097	28140
chr16	27963957	28163957	harbor2	chr16	27992509	27992695	LTR/ERVL	2403	+	93	27992602	28645
chr16	27963957	28163957	harbor2	chr16	28007939	28008076	LTR/ERVL	1002	+	68	28008007	44050
chr16	27963957	28163957	harbor2	chr16	28008379	28008474	LTR/ERVL	1002	+	48	28008427	44470
chr16	27963957	28163957	harbor2	chr16	27983844	27984289	LTR/ERVL	2374	+	222	27984066	20109
chr16	55108159	55308159	harbor2	chr16	55114281	55114446	LTR/ERVL	578	+	82	55114363	6204
chr16	55108159	55308159	harbor2	chr16	55115899	55116183	LTR/ERVL	941	+	142	55116041	7882
chr16	55108159	55308159	harbor2	chr16	55143032	55143365	LTR/ERVL	884	+	166	55143198	35039
chr16	55108159	55308159	harbor2	chr16	55147891	55148152	LTR/ERVL	968	+	130	55148021	39862
chr16	55108159	55308159	harbor2	chr16	55152869	55153355	LTR/ERVL	2067	+	243	55153112	44953
chr16	55108159	55308159	harbor2	chr16	55170239	55170553	LTR/ERVL	1849	+	157	55170396	62237
chr16	55108159	55308159	harbor2	chr16	55114583	55115866	LTR/ERVL	2543	+	642	55115225	7066
chr16	47361963	47561963	harbor2	chr16	47378937	47379349	LTR/ERVL	1613	+	206	47379143	17180
chr16	47361963	47561963	harbor2	chr16	47379357	47379405	LTR/ERVL	1670	+	24	47379381	17418
chr16	47361963	47561963	harbor2	chr16	47379705	47380694	LTR/ERVL	1670	+	494	47380199	18236
chr16	47361963	47561963	harbor2	chr16	47380664	47380776	LTR/ERVL	553	+	56	47380720	18757
chr16	47361963	47561963	harbor2	chr16	47387382	47387707	LTR/ERVL	1435	+	162	47387544	25581
chr16	870935	1070935	harbor2	chr16	906244	906669	LTR/ERVL	2499	+	212	906456	35521
chr16	701128	901128	harbor2	chr16	735073	735423	LTR/ERVL	814	+	175	735248	34120
chr16	701128	901128	harbor2	chr16	735416	735901	LTR/ERVL	1401	+	242	735658	34530
chr16	701128	901128	harbor2	chr16	760974	761306	LTR/ERVL	802	+	166	761140	60012
chr16	870909	1070909	harbor2	chr16	906244	906669	LTR/ERVL	2499	+	212	906456	35547
chr16	88757148	88957148	harbor2	chr16	88766100	88766425	LTR/ERVL	681	+	162	88766262	9114
chr16	700524	900524	harbor2	chr16	735073	735423	LTR/ERVL	814	+	175	735248	34724
chr16	700524	900524	harbor2	chr16	735416	735901	LTR/ERVL	1401	+	242	735658	35134
chr16	700524	900524	harbor2	chr16	760974	761306	LTR/ERVL	802	+	166	761140	60616
chr16	3625684	3825684	harbor2	chr16	3639544	3639722	LTR/ERVL	531	+	89	3639633	13949
chr16	704878	904878	harbor2	chr16	735073	735423	LTR/ERVL	814	+	175	735248	30370
chr16	704878	904878	harbor2	chr16	735416	735901	LTR/ERVL	1401	+	242	735658	30780
chr16	704878	904878	harbor2	chr16	760974	761306	LTR/ERVL	802	+	166	761140	56262
chr16	66222798	66422798	harbor2	chr16	66253500	66253995	LTR/ERVL	2122	+	248	66253748	30950
chr16	66222798	66422798	harbor2	chr16	66273162	66273705	LTR/ERVL	1847	+	272	66273434	50636
chr16	989175	1189175	harbor2	chr16	1067475	1067768	LTR/ERVL	1121	+	146	1067621	78446
chr16	989175	1189175	harbor2	chr16	1067860	1068025	LTR/ERVL	588	+	82	1067942	78767
chr16	2870096	3070096	harbor2	chr16	2942645	2942720	LTR/ERVL	1819	+	38	2942683	72587
chr16	2870096	3070096	harbor2	chr16	2943001	2943487	LTR/ERVL	1819	+	243	2943244	73148
chr16	58762872	58962872	harbor2	chr16	58812971	58813184	LTR/ERVL	662	+	106	58813077	50205
chr16	58762872	58962872	harbor2	chr16	58813481	58813704	LTR/ERVL	662	+	112	58813593	50721
chr16	47561803	47761803	harbor2	chr16	47630637	47631175	LTR/ERVL	2715	+	269	47630906	69103
chr16	1002283	1202283	harbor2	chr16	1067475	1067768	LTR/ERVL	1121	+	146	1067621	65338
chr16	1002283	1202283	harbor2	chr16	1067860	1068025	LTR/ERVL	588	+	82	1067942	65659
chr16	70885369	71085369	harbor2	chr16	70940622	70940956	LTR/ERVL	576	+	167	70940789	55420
chr16	70885369	71085369	harbor2	chr16	70966029	70966274	LTR/ERVL	892	+	122	70966151	80782
chr16	70885369	71085369	harbor2	chr16	70971077	70971303	LTR/ERVL	662	+	113	70971190	85821
chr16	47360975	47560975	harbor2	chr16	47378937	47379349	LTR/ERVL	1613	+	206	47379143	18168
chr16	47360975	47560975	harbor2	chr16	47379357	47379405	LTR/ERVL	1670	+	24	47379381	18406
chr16	47360975	47560975	harbor2	chr16	47379705	47380694	LTR/ERVL	1670	+	494	47380199	19224
chr16	47360975	47560975	harbor2	chr16	47380664	47380776	LTR/ERVL	553	+	56	47380720	19745
chr16	47360975	47560975	harbor2	chr16	47387382	47387707	LTR/ERVL	1435	+	162	47387544	26569
chr16	703103	903103	harbor2	chr16	735073	735423	LTR/ERVL	814	+	175	735248	32145
chr16	703103	903103	harbor2	chr16	735416	735901	LTR/ERVL	1401	+	242	735658	32555
chr16	703103	903103	harbor2	chr16	760974	761306	LTR/ERVL	802	+	166	761140	58037
chr16	30255065	30455065	harbor2	chr16	30310607	30310709	LTR/ERVL	2102	+	51	30310658	55593
chr16	30255065	30455065	harbor2	chr16	30310969	30311437	LTR/ERVL	2102	+	234	30311203	56138
chr16	30255065	30455065	harbor2	chr16	30311734	30311816	LTR/ERVL	2102	+	41	30311775	56710
chr16	979992	1179992	harbor2	chr16	1067475	1067768	LTR/ERVL	1121	+	146	1067621	87629
chr16	979992	1179992	harbor2	chr16	1067860	1068025	LTR/ERVL	588	+	82	1067942	87950
chr16	31042592	31242592	harbor2	chr16	31100362	31100712	LTR/ERVL	2556	+	175	31100537	57945
chr16	31042592	31242592	harbor2	chr16	31101019	31101264	LTR/ERVL	2556	+	122	31101141	58549
chr16	30599106	30799106	harbor2	chr16	30680306	30680546	LTR/ERVL	1208	+	120	30680426	81320
chr16	79501524	79701524	harbor2	chr16	79514654	79514906	LTR/ERVL	562	+	126	79514780	13256
chr16	79501524	79701524	harbor2	chr16	79555116	79555312	LTR/ERVL	708	+	98	79555214	53690
chr16	31202309	31402309	harbor2	chr16	31255650	31255752	LTR/ERVL	590	+	51	31255701	53392
chr16	4747400	4947400	harbor2	chr16	4759487	4759716	LTR/ERVL	719	+	114	4759601	12201
chr16	47361826	47561826	harbor2	chr16	47378937	47379349	LTR/ERVL	1613	+	206	47379143	17317
chr16	47361826	47561826	harbor2	chr16	47379357	47379405	LTR/ERVL	1670	+	24	47379381	17555
chr16	47361826	47561826	harbor2	chr16	47379705	47380694	LTR/ERVL	1670	+	494	47380199	18373
chr16	47361826	47561826	harbor2	chr16	47380664	47380776	LTR/ERVL	553	+	56	47380720	18894
chr16	47361826	47561826	harbor2	chr16	47387382	47387707	LTR/ERVL	1435	+	162	47387544	25718
chr16	871674	1071674	harbor2	chr16	906244	906669	LTR/ERVL	2499	+	212	906456	34782
chr16	871554	1071554	harbor2	chr16	906244	906669	LTR/ERVL	2499	+	212	906456	34902
chr16	1872873	2072873	harbor2	chr16	1904421	1904676	LTR/ERVL	696	+	128	1904549	31676
chr16	1872873	2072873	harbor2	chr16	1936811	1937145	LTR/ERVL	1374	+	167	1936978	64105
chr16	89596335	89796335	harbor2	chr16	89676934	89677316	LTR/ERVL	1321	+	191	89677125	80790
chr16	89596335	89796335	harbor2	chr16	89677627	89677660	LTR/ERVL	1321	+	16	89677643	81308
chr16	700511	900511	harbor2	chr16	735073	735423	LTR/ERVL	814	+	175	735248	34737
chr16	700511	900511	harbor2	chr16	735416	735901	LTR/ERVL	1401	+	242	735658	35147
chr16	700511	900511	harbor2	chr16	760974	761306	LTR/ERVL	802	+	166	761140	60629
chr16	824869	1024869	harbor2	chr16	906244	906669	LTR/ERVL	2499	+	212	906456	81587
chr16	30599603	30799603	harbor2	chr16	30680306	30680546	LTR/ERVL	1208	+	120	30680426	80823
chr16	4998398	5198398	harbor2	chr16	5022687	5023045	LTR/ERVL	1348	+	179	5022866	24468
chr16	4998398	5198398	harbor2	chr16	5046966	5047372	LTR/ERVL	726	+	203	5047169	48771
chr16	28503963	28703963	harbor2	chr16	28557364	28557867	LTR/ERVL	2622	+	252	28557616	53653
chr16	28503963	28703963	harbor2	chr16	28574909	28575224	LTR/ERVL	1600	+	158	28575067	71104
chr16	4085358	4285358	harbor2	chr16	4134690	4134935	LTR/ERVL	1839	+	122	4134812	49454
chr16	4085358	4285358	harbor2	chr16	4135246	4135336	LTR/ERVL	1839	+	45	4135291	49933
chr16	4085358	4285358	harbor2	chr16	4180175	4180381	LTR/ERVL	552	+	103	4180278	94920
chr16	88757121	88957121	harbor2	chr16	88766100	88766425	LTR/ERVL	681	+	162	88766262	9141
chr16	31042572	31242572	harbor2	chr16	31100362	31100712	LTR/ERVL	2556	+	175	31100537	57965
chr16	31042572	31242572	harbor2	chr16	31101019	31101264	LTR/ERVL	2556	+	122	31101141	58569
chr16	982324	1182324	harbor2	chr16	1067475	1067768	LTR/ERVL	1121	+	146	1067621	85297
chr16	982324	1182324	harbor2	chr16	1067860	1068025	LTR/ERVL	588	+	82	1067942	85618
chr16	75241699	75441699	harbor2	chr16	75307992	75308437	LTR/ERVL	1442	+	222	75308214	66515
chr16	49244544	49444544	harbor2	chr16	49327118	49327436	LTR/ERVL	1057	+	159	49327277	82733
chr16	89238136	89438136	harbor2	chr16	89324438	89324964	LTR/ERVL	2195	+	263	89324701	86565
chr16	2869233	3069233	harbor2	chr16	2942645	2942720	LTR/ERVL	1819	+	38	2942683	73450
chr16	2869233	3069233	harbor2	chr16	2943001	2943487	LTR/ERVL	1819	+	243	2943244	74011
chr16	4163779	4363779	harbor2	chr16	4180175	4180381	LTR/ERVL	552	+	103	4180278	16499
chr16	89595449	89795449	harbor2	chr16	89676934	89677316	LTR/ERVL	1321	+	191	89677125	81676
chr16	89595449	89795449	harbor2	chr16	89677627	89677660	LTR/ERVL	1321	+	16	89677643	82194
chr16	82568055	82768055	harbor2	chr16	82586406	82586857	LTR/ERVL	3421	+	226	82586632	18577
chr16	87750387	87950387	harbor2	chr16	87799466	87800115	LTR/ERVL	2692	+	324	87799790	49403
chr16	2912065	3112065	harbor2	chr16	2942645	2942720	LTR/ERVL	1819	+	38	2942683	30618
chr16	2912065	3112065	harbor2	chr16	2943001	2943487	LTR/ERVL	1819	+	243	2943244	31179
chr17	28783714	28983714	harbor2	chr17	28804112	28804337	LTR/ERVL	1039	+	112	28804224	20510
chr17	79819279	80019279	harbor2	chr17	79888747	79889305	LTR/ERVL	2149	+	279	79889026	69747
chr17	76675676	76875676	harbor2	chr17	76690872	76691732	LTR/ERVL	2986	+	430	76691302	15626
chr17	78893046	79093046	harbor2	chr17	78904630	78904861	LTR/ERVL	1959	+	116	78904746	11700
chr17	78893046	79093046	harbor2	chr17	78905159	78905428	LTR/ERVL	1959	+	134	78905293	12247
chr17	55168160	55368160	harbor2	chr17	55176609	55177198	LTR/ERVL	2345	+	294	55176903	8743
chr17	38927260	39127260	harbor2	chr17	39014134	39014172	LTR/ERVL	838	+	19	39014153	86893
chr17	38927260	39127260	harbor2	chr17	39014880	39014984	LTR/ERVL	838	+	52	39014932	87672
chr17	38927260	39127260	harbor2	chr17	39015052	39015075	LTR/ERVL	3290	+	12	39015064	87804
chr17	38927260	39127260	harbor2	chr17	39015377	39015505	LTR/ERVL	3290	+	64	39015441	88181
chr17	38927260	39127260	harbor2	chr17	39016553	39016935	LTR/ERVL	3290	+	191	39016744	89484
chr17	7480912	7680912	harbor2	chr17	7568039	7568315	LTR/ERVL	2661	+	138	7568177	87265
chr17	7480912	7680912	harbor2	chr17	7568605	7569103	LTR/ERVL	2661	+	249	7568854	87942
chr17	7479425	7679425	harbor2	chr17	7568039	7568315	LTR/ERVL	2661	+	138	7568177	88752
chr17	7479425	7679425	harbor2	chr17	7568605	7569103	LTR/ERVL	2661	+	249	7568854	89429
chr17	76638002	76838002	harbor2	chr17	76690872	76691732	LTR/ERVL	2986	+	430	76691302	53300
chr17	76637950	76837950	harbor2	chr17	76690872	76691732	LTR/ERVL	2986	+	430	76691302	53352
chr17	76638185	76838185	harbor2	chr17	76690872	76691732	LTR/ERVL	2986	+	430	76691302	53117
chr17	7474337	7674337	harbor2	chr17	7568039	7568315	LTR/ERVL	2661	+	138	7568177	93840
chr17	7474337	7674337	harbor2	chr17	7568605	7569103	LTR/ERVL	2661	+	249	7568854	94517
chr17	65970416	66170416	harbor2	chr17	66051616	66051838	LTR/ERVL	633	+	111	66051727	81311
chr17	68058283	68258283	harbor2	chr17	68068518	68069005	LTR/ERVL	2363	+	244	68068762	10479
chr17	43301647	43501647	harbor2	chr17	43304458	43304875	LTR/ERVL	953	+	208	43304666	3019
chr17	43301647	43501647	harbor2	chr17	43356532	43357143	LTR/ERVL	3096	+	306	43356838	55191
chr17	43301647	43501647	harbor2	chr17	43363466	43363767	LTR/ERVL	782	+	150	43363616	61969
chr17	39764391	39964391	harbor2	chr17	39820634	39821323	LTR/ERVL	1526	+	344	39820978	56587
chr17	39764391	39964391	harbor2	chr17	39821328	39822245	LTR/ERVL	4640	+	458	39821786	57395
chr17	39764391	39964391	harbor2	chr17	39825204	39825234	LTR/ERVL	4640	+	15	39825219	60828
chr17	39764391	39964391	harbor2	chr17	39825621	39826046	LTR/ERVL	7795	+	212	39825833	61442
chr17	39764391	39964391	harbor2	chr17	39826342	39826993	LTR/ERVL	7795	+	326	39826668	62277
chr17	39764391	39964391	harbor2	chr17	39827608	39828496	LTR/ERVL	7795	+	444	39828052	63661
chr17	39764391	39964391	harbor2	chr17	39828502	39828716	LTR/ERVL	634	+	107	39828609	64218
chr17	76638046	76838046	harbor2	chr17	76690872	76691732	LTR/ERVL	2986	+	430	76691302	53256
chr17	76956448	77156448	harbor2	chr17	76963949	76964408	LTR/ERVL	1179	+	230	76964179	7731
chr17	76956448	77156448	harbor2	chr17	76964723	76964855	LTR/ERVL	1179	+	66	76964789	8341
chr17	76956448	77156448	harbor2	chr17	76979217	76979454	LTR/ERVL	982	+	118	76979335	22887
chr17	76956448	77156448	harbor2	chr17	76998981	76999405	LTR/ERVL	1270	+	212	76999193	42745
chr17	76956448	77156448	harbor2	chr17	76999721	76999944	LTR/ERVL	1270	+	112	76999833	43385
chr17	76956448	77156448	harbor2	chr17	77017284	77017632	LTR/ERVL	2605	+	174	77017458	61010
chr17	76956448	77156448	harbor2	chr17	77017939	77018353	LTR/ERVL	2605	+	207	77018146	61698
chr17	76956448	77156448	harbor2	chr17	77018703	77018796	LTR/ERVL	2605	+	46	77018749	62301
chr17	7474332	7674332	harbor2	chr17	7568039	7568315	LTR/ERVL	2661	+	138	7568177	93845
chr17	7474332	7674332	harbor2	chr17	7568605	7569103	LTR/ERVL	2661	+	249	7568854	94522
chr17	79819290	80019290	harbor2	chr17	79888747	79889305	LTR/ERVL	2149	+	279	79889026	69736
chr17	73833382	74033382	harbor2	chr17	73845683	73846147	LTR/ERVL	2416	+	232	73845915	12533
chr17	73833382	74033382	harbor2	chr17	73846200	73846262	LTR/ERVL	2416	+	31	73846231	12849
chr17	73833382	74033382	harbor2	chr17	73886988	73887563	LTR/ERVL	2902	+	288	73887276	53894
chr17	7481389	7681389	harbor2	chr17	7568039	7568315	LTR/ERVL	2661	+	138	7568177	86788
chr17	7481389	7681389	harbor2	chr17	7568605	7569103	LTR/ERVL	2661	+	249	7568854	87465
chr17	7474612	7674612	harbor2	chr17	7568039	7568315	LTR/ERVL	2661	+	138	7568177	93565
chr17	7474612	7674612	harbor2	chr17	7568605	7569103	LTR/ERVL	2661	+	249	7568854	94242
chr17	82598301	82798301	harbor2	chr17	82641344	82641613	LTR/ERVL	3146	+	134	82641478	43177
chr17	82598301	82798301	harbor2	chr17	82641896	82642150	LTR/ERVL	3146	+	127	82642023	43722
chr17	82598301	82798301	harbor2	chr17	82642465	82642825	LTR/ERVL	3146	+	180	82642645	44344
chr17	79826880	80026880	harbor2	chr17	79888747	79889305	LTR/ERVL	2149	+	279	79889026	62146
chr17	73131478	73331478	harbor2	chr17	73188186	73188347	LTR/ERVL	715	+	80	73188266	56788
chr17	73131478	73331478	harbor2	chr17	73188622	73188670	LTR/ERVL	715	+	24	73188646	57168
chr17	73131478	73331478	harbor2	chr17	73188973	73189211	LTR/ERVL	715	+	119	73189092	57614
chr17	76298198	76498198	harbor2	chr17	76365934	76366451	LTR/ERVL	928	+	258	76366192	67994
chr17	50409150	50609150	harbor2	chr17	50505904	50506106	LTR/ERVL	728	+	101	50506005	96855
chr17	76637928	76837928	harbor2	chr17	76690872	76691732	LTR/ERVL	2986	+	430	76691302	53374
chr17	17395750	17595750	harbor2	chr17	17417877	17418549	LTR/ERVL	3383	+	336	17418213	22463
chr17	7482394	7682394	harbor2	chr17	7568039	7568315	LTR/ERVL	2661	+	138	7568177	85783
chr17	7482394	7682394	harbor2	chr17	7568605	7569103	LTR/ERVL	2661	+	249	7568854	86460
chr17	30611433	30811433	harbor2	chr17	30677573	30677954	LTR/ERVL	869	+	190	30677763	66330
chr17	7492702	7692702	harbor2	chr17	7568039	7568315	LTR/ERVL	2661	+	138	7568177	75475
chr17	7492702	7692702	harbor2	chr17	7568605	7569103	LTR/ERVL	2661	+	249	7568854	76152
chr17	7494677	7694677	harbor2	chr17	7568039	7568315	LTR/ERVL	2661	+	138	7568177	73500
chr17	7494677	7694677	harbor2	chr17	7568605	7569103	LTR/ERVL	2661	+	249	7568854	74177
chr17	7947124	8147124	harbor2	chr17	7967955	7968079	LTR/ERVL	660	+	62	7968017	20893
chr17	7947124	8147124	harbor2	chr17	7982795	7983042	LTR/ERVL	1480	+	124	7982919	35795
chr17	7947124	8147124	harbor2	chr17	7983375	7983507	LTR/ERVL	1480	+	66	7983441	36317
chr17	7947124	8147124	harbor2	chr17	7984482	7984717	LTR/ERVL	3430	+	118	7984600	37476
chr17	7947124	8147124	harbor2	chr17	7985013	7985780	LTR/ERVL	3430	+	384	7985397	38273
chr17	7947124	8147124	harbor2	chr17	7986471	7986639	LTR/ERVL	689	+	84	7986555	39431
chr17	76953100	77153100	harbor2	chr17	76963949	76964408	LTR/ERVL	1179	+	230	76964179	11079
chr17	76953100	77153100	harbor2	chr17	76964723	76964855	LTR/ERVL	1179	+	66	76964789	11689
chr17	76953100	77153100	harbor2	chr17	76979217	76979454	LTR/ERVL	982	+	118	76979335	26235
chr17	76953100	77153100	harbor2	chr17	76998981	76999405	LTR/ERVL	1270	+	212	76999193	46093
chr17	76953100	77153100	harbor2	chr17	76999721	76999944	LTR/ERVL	1270	+	112	76999833	46733
chr17	76953100	77153100	harbor2	chr17	77017284	77017632	LTR/ERVL	2605	+	174	77017458	64358
chr17	76953100	77153100	harbor2	chr17	77017939	77018353	LTR/ERVL	2605	+	207	77018146	65046
chr17	76953100	77153100	harbor2	chr17	77018703	77018796	LTR/ERVL	2605	+	46	77018749	65649
chr17	30610131	30810131	harbor2	chr17	30677573	30677954	LTR/ERVL	869	+	190	30677763	67632
chr17	82200980	82400980	harbor2	chr17	82206496	82206807	LTR/ERVL	2013	+	156	82206652	5672
chr17	82200980	82400980	harbor2	chr17	82207809	82208047	LTR/ERVL	2013	+	119	82207928	6948
chr17	76284349	76484349	harbor2	chr17	76365934	76366451	LTR/ERVL	928	+	258	76366192	81843
chr17	34602208	34802208	harbor2	chr17	34679400	34679976	LTR/ERVL	1980	+	288	34679688	77480
chr17	34602208	34802208	harbor2	chr17	34680718	34680938	LTR/ERVL	802	+	110	34680828	78620
chr17	78477331	78677331	harbor2	chr17	78531871	78532394	LTR/ERVL	2425	+	262	78532133	54802
chr17	78477331	78677331	harbor2	chr17	78533643	78533688	LTR/ERVL	965	+	22	78533665	56334
chr17	78477331	78677331	harbor2	chr17	78533986	78534231	LTR/ERVL	965	+	122	78534108	56777
chr17	78477331	78677331	harbor2	chr17	78555655	78556131	LTR/ERVL	1734	+	238	78555893	78562
chr17	13555165	13755165	harbor2	chr17	13630268	13630656	LTR/ERVL	1788	+	194	13630462	75297
chr17	13555165	13755165	harbor2	chr17	13630991	13631090	LTR/ERVL	1788	+	50	13631041	75876
chr17	58298595	58498595	harbor2	chr17	58298812	58299101	LTR/ERVL	1808	+	144	58298956	361
chr17	36094893	36294893	harbor2	chr17	36111494	36111743	LTR/ERVL	1697	+	124	36111618	16725
chr17	36094893	36294893	harbor2	chr17	36111840	36113213	LTR/ERVL	6974	+	686	36112526	17633
chr17	36094893	36294893	harbor2	chr17	36113212	36115348	LTR/ERVL	17706	+	1068	36114280	19387
chr17	36094893	36294893	harbor2	chr17	36115346	36115864	LTR/ERVL	3915	+	259	36115605	20712
chr17	36094893	36294893	harbor2	chr17	36115865	36116246	LTR/ERVL	3004	+	190	36116055	21162
chr17	36094893	36294893	harbor2	chr17	36116305	36116344	LTR/ERVL	3004	+	20	36116325	21432
chr17	36094893	36294893	harbor2	chr17	36131939	36132358	LTR/ERVL	920	+	210	36132149	37256
chr17	36094893	36294893	harbor2	chr17	36132408	36132906	LTR/ERVL	1057	+	249	36132657	37764
chr17	36094893	36294893	harbor2	chr17	36144057	36144653	LTR/ERVL	1718	+	298	36144355	49462
chr17	36094893	36294893	harbor2	chr17	36145132	36145702	LTR/ERVL	2787	+	285	36145417	50524
chr17	36094893	36294893	harbor2	chr17	36143059	36143416	LTR/ERVL	931	+	178	36143237	48344
chr17	79831273	80031273	harbor2	chr17	79888747	79889305	LTR/ERVL	2149	+	279	79889026	57753
chr17	78740813	78940813	harbor2	chr17	78785839	78786221	LTR/ERVL	2172	+	191	78786030	45217
chr17	78740813	78940813	harbor2	chr17	78786515	78786864	LTR/ERVL	2172	+	174	78786689	45876
chr17	45709559	45909559	harbor2	chr17	45729823	45730222	LTR/ERVL	1258	+	200	45730023	20464
chr17	45709559	45909559	harbor2	chr17	45766219	45766427	LTR/ERVL	688	+	104	45766323	56764
chr17	81859888	82059888	harbor2	chr17	81944421	81944983	LTR/ERVL	1723	+	281	81944702	84814
chr17	81859888	82059888	harbor2	chr17	81945888	81945999	LTR/ERVL	944	+	56	81945944	86056
chr17	81859888	82059888	harbor2	chr17	81947212	81947354	LTR/ERVL	944	+	71	81947283	87395
chr17	7472461	7672461	harbor2	chr17	7568039	7568315	LTR/ERVL	2661	+	138	7568177	95716
chr17	7472461	7672461	harbor2	chr17	7568605	7569103	LTR/ERVL	2661	+	249	7568854	96393
chr17	74936805	75136805	harbor2	chr17	74985176	74985679	LTR/ERVL	1368	+	252	74985428	48623
chr17	57769118	57969118	harbor2	chr17	57802266	57802715	LTR/ERVL	1313	+	224	57802490	33372
chr17	57769118	57969118	harbor2	chr17	57817339	57817660	LTR/ERVL	1059	+	160	57817499	48381
chr17	57769118	57969118	harbor2	chr17	57818024	57818390	LTR/ERVL	842	+	183	57818207	49089
chr17	57769118	57969118	harbor2	chr17	57818386	57818753	LTR/ERVL	1156	+	184	57818570	49452
chr17	57769118	57969118	harbor2	chr17	57818849	57819235	LTR/ERVL	1224	+	193	57819042	49924
chr17	76637275	76837275	harbor2	chr17	76690872	76691732	LTR/ERVL	2986	+	430	76691302	54027
chr17	6919402	7119402	harbor2	chr17	6964461	6964688	LTR/ERVL	2403	+	114	6964575	45173
chr17	6919402	7119402	harbor2	chr17	6964967	6965223	LTR/ERVL	2403	+	128	6965095	45693
chr17	76638049	76838049	harbor2	chr17	76690872	76691732	LTR/ERVL	2986	+	430	76691302	53253
chr17	76284381	76484381	harbor2	chr17	76365934	76366451	LTR/ERVL	928	+	258	76366192	81811
chr17	988320	1188320	harbor2	chr17	1058948	1059482	LTR/ERVL	1125	+	267	1059215	70895
chr17	7479862	7679862	harbor2	chr17	7568039	7568315	LTR/ERVL	2661	+	138	7568177	88315
chr17	7479862	7679862	harbor2	chr17	7568605	7569103	LTR/ERVL	2661	+	249	7568854	88992
chr17	55321022	55521022	harbor2	chr17	55327749	55328206	LTR/ERVL	2762	+	228	55327977	6955
chr17	77860765	78060765	harbor2	chr17	77867281	77867806	LTR/ERVL	2829	+	262	77867543	6778
chr17	77860765	78060765	harbor2	chr17	77941055	77941434	LTR/ERVL	1175	+	190	77941245	80480
chr17	77860765	78060765	harbor2	chr17	77941729	77941746	LTR/ERVL	1175	+	8	77941737	80972
chr17	76638956	76838956	harbor2	chr17	76690872	76691732	LTR/ERVL	2986	+	430	76691302	52346
chr17	79831926	80031926	harbor2	chr17	79888747	79889305	LTR/ERVL	2149	+	279	79889026	57100
chr17	40317891	40517891	harbor2	chr17	40372997	40373425	LTR/ERVL	3469	+	214	40373211	55320
chr17	48809655	49009655	harbor2	chr17	48883156	48883375	LTR/ERVL	733	+	110	48883266	73611
chr17	48795295	48995295	harbor2	chr17	48883156	48883375	LTR/ERVL	733	+	110	48883266	87971
chr17	30996295	31196295	harbor2	chr17	30999443	30999979	LTR/ERVL	2575	+	268	30999711	3416
chr17	30996295	31196295	harbor2	chr17	31075123	31075553	LTR/ERVL	1115	+	215	31075338	79043
chr17	28788005	28988005	harbor2	chr17	28804112	28804337	LTR/ERVL	1039	+	112	28804224	16219
chr17	7152164	7352164	harbor2	chr17	7160754	7161235	LTR/ERVL	1728	+	240	7160994	8830
chr17	7152164	7352164	harbor2	chr17	7164990	7165410	LTR/ERVL	1201	+	210	7165200	13036
chr17	1008518	1208518	harbor2	chr17	1058948	1059482	LTR/ERVL	1125	+	267	1059215	50697
chr17	43300682	43500682	harbor2	chr17	43304458	43304875	LTR/ERVL	953	+	208	43304666	3984
chr17	43300682	43500682	harbor2	chr17	43356532	43357143	LTR/ERVL	3096	+	306	43356838	56156
chr17	43300682	43500682	harbor2	chr17	43363466	43363767	LTR/ERVL	782	+	150	43363616	62934
chr17	76638206	76838206	harbor2	chr17	76690872	76691732	LTR/ERVL	2986	+	430	76691302	53096
chr17	15162566	15362566	harbor2	chr17	15184873	15184938	LTR/ERVL	640	+	32	15184905	22339
chr17	15162566	15362566	harbor2	chr17	15185469	15185649	LTR/ERVL	640	+	90	15185559	22993
chr17	9859791	10059791	harbor2	chr17	9900252	9900688	LTR/ERVL	1062	+	218	9900470	40679
chr18	26207400	26407400	harbor2	chr18	26210262	26210691	LTR/ERVL	2476	+	214	26210476	3076
chr18	26207400	26407400	harbor2	chr18	26210728	26210776	LTR/ERVL	2476	+	24	26210752	3352
chr18	26207400	26407400	harbor2	chr18	26212511	26212656	LTR/ERVL	604	+	72	26212583	5183
chr18	37466538	37666538	harbor2	chr18	37474783	37475253	LTR/ERVL	1680	+	235	37475018	8480
chr18	26128429	26328429	harbor2	chr18	26128164	26128552	LTR/ERVL	3226	+	194	26128358	71
chr18	26128429	26328429	harbor2	chr18	26128647	26128681	LTR/ERVL	3226	+	17	26128664	235
chr18	26128429	26328429	harbor2	chr18	26210262	26210691	LTR/ERVL	2476	+	214	26210476	82047
chr18	26128429	26328429	harbor2	chr18	26210728	26210776	LTR/ERVL	2476	+	24	26210752	82323
chr18	26128429	26328429	harbor2	chr18	26212511	26212656	LTR/ERVL	604	+	72	26212583	84154
chr18	50173629	50373629	harbor2	chr18	50173868	50174170	LTR/ERVL	1562	+	151	50174019	390
chr18	50173629	50373629	harbor2	chr18	50200664	50201094	LTR/ERVL	3218	+	215	50200879	27250
chr18	50173629	50373629	harbor2	chr18	50204613	50205321	LTR/ERVL	1863	+	354	50204967	31338
chr18	50173629	50373629	harbor2	chr18	50219060	50219364	LTR/ERVL	898	+	152	50219212	45583
chr18	50173629	50373629	harbor2	chr18	50230108	50230780	LTR/ERVL	2444	+	336	50230444	56815
chr18	50173629	50373629	harbor2	chr18	50240995	50241331	LTR/ERVL	1392	+	168	50241163	67534
chr18	50173629	50373629	harbor2	chr18	50269323	50269978	LTR/ERVL	3714	+	328	50269651	96022
chr18	26127503	26327503	harbor2	chr18	26128164	26128552	LTR/ERVL	3226	+	194	26128358	855
chr18	26127503	26327503	harbor2	chr18	26128647	26128681	LTR/ERVL	3226	+	17	26128664	1161
chr18	26127503	26327503	harbor2	chr18	26210262	26210691	LTR/ERVL	2476	+	214	26210476	82973
chr18	26127503	26327503	harbor2	chr18	26210728	26210776	LTR/ERVL	2476	+	24	26210752	83249
chr18	26127503	26327503	harbor2	chr18	26212511	26212656	LTR/ERVL	604	+	72	26212583	85080
chr18	31999202	32199202	harbor2	chr18	32081713	32081799	LTR/ERVL	564	+	43	32081756	82554
chr18	31999202	32199202	harbor2	chr18	32087088	32087213	LTR/ERVL	768	+	62	32087150	87948
chr18	31999202	32199202	harbor2	chr18	32087266	32087640	LTR/ERVL	2244	+	187	32087453	88251
chr18	31999202	32199202	harbor2	chr18	32087650	32088072	LTR/ERVL	1892	+	211	32087861	88659
chr18	26128488	26328488	harbor2	chr18	26128164	26128552	LTR/ERVL	3226	+	194	26128358	130
chr18	26128488	26328488	harbor2	chr18	26128647	26128681	LTR/ERVL	3226	+	17	26128664	176
chr18	26128488	26328488	harbor2	chr18	26210262	26210691	LTR/ERVL	2476	+	214	26210476	81988
chr18	26128488	26328488	harbor2	chr18	26210728	26210776	LTR/ERVL	2476	+	24	26210752	82264
chr18	26128488	26328488	harbor2	chr18	26212511	26212656	LTR/ERVL	604	+	72	26212583	84095
chr18	42427605	42627605	harbor2	chr18	42526847	42527039	LTR/ERVL	569	+	96	42526943	99338
chr18	76054282	76254282	harbor2	chr18	76112280	76112685	LTR/ERVL	1596	+	202	76112482	58200
chr18	76054282	76254282	harbor2	chr18	76112729	76112768	LTR/ERVL	1596	+	20	76112749	58467
chr18	74357679	74557679	harbor2	chr18	74392196	74392541	LTR/ERVL	1251	+	172	74392368	34689
chr18	74357679	74557679	harbor2	chr18	74395368	74395438	LTR/ERVL	448	+	35	74395403	37724
chr18	74357679	74557679	harbor2	chr18	74420352	74420900	LTR/ERVL	2150	+	274	74420626	62947
chr18	74357679	74557679	harbor2	chr18	74430294	74430700	LTR/ERVL	2405	+	203	74430497	72818
chr18	74357679	74557679	harbor2	chr18	74431307	74431346	LTR/ERVL	2405	+	20	74431327	73648
chr18	26126452	26326452	harbor2	chr18	26128164	26128552	LTR/ERVL	3226	+	194	26128358	1906
chr18	26126452	26326452	harbor2	chr18	26128647	26128681	LTR/ERVL	3226	+	17	26128664	2212
chr18	26126452	26326452	harbor2	chr18	26210262	26210691	LTR/ERVL	2476	+	214	26210476	84024
chr18	26126452	26326452	harbor2	chr18	26210728	26210776	LTR/ERVL	2476	+	24	26210752	84300
chr18	26126452	26326452	harbor2	chr18	26212511	26212656	LTR/ERVL	604	+	72	26212583	86131
chr18	75398513	75598513	harbor2	chr18	75403613	75403779	LTR/ERVL	677	+	83	75403696	5183
chr18	26126438	26326438	harbor2	chr18	26128164	26128552	LTR/ERVL	3226	+	194	26128358	1920
chr18	26126438	26326438	harbor2	chr18	26128647	26128681	LTR/ERVL	3226	+	17	26128664	2226
chr18	26126438	26326438	harbor2	chr18	26210262	26210691	LTR/ERVL	2476	+	214	26210476	84038
chr18	26126438	26326438	harbor2	chr18	26210728	26210776	LTR/ERVL	2476	+	24	26210752	84314
chr18	26126438	26326438	harbor2	chr18	26212511	26212656	LTR/ERVL	604	+	72	26212583	86145
chr18	54891836	55091836	harbor2	chr18	54940343	54940838	LTR/ERVL	843	+	248	54940591	48755
chr18	37468263	37668263	harbor2	chr18	37474783	37475253	LTR/ERVL	1680	+	235	37475018	6755
chr18	62458039	62658039	harbor2	chr18	62491016	62491558	LTR/ERVL	2066	+	271	62491287	33248
chr18	75108369	75308369	harbor2	chr18	75123144	75123562	LTR/ERVL	597	+	209	75123353	14984
chr18	75108369	75308369	harbor2	chr18	75135636	75135846	LTR/ERVL	833	+	105	75135741	27372
chr18	75108369	75308369	harbor2	chr18	75136097	75136235	LTR/ERVL	484	+	69	75136166	27797
chr18	75108369	75308369	harbor2	chr18	75136540	75136562	LTR/ERVL	484	+	11	75136551	28182
chr18	75108369	75308369	harbor2	chr18	75136597	75136625	LTR/ERVL	484	+	14	75136611	28242
chr18	75108369	75308369	harbor2	chr18	75176480	75176954	LTR/ERVL	2032	+	237	75176717	68348
chr18	26127296	26327296	harbor2	chr18	26128164	26128552	LTR/ERVL	3226	+	194	26128358	1062
chr18	26127296	26327296	harbor2	chr18	26128647	26128681	LTR/ERVL	3226	+	17	26128664	1368
chr18	26127296	26327296	harbor2	chr18	26210262	26210691	LTR/ERVL	2476	+	214	26210476	83180
chr18	26127296	26327296	harbor2	chr18	26210728	26210776	LTR/ERVL	2476	+	24	26210752	83456
chr18	26127296	26327296	harbor2	chr18	26212511	26212656	LTR/ERVL	604	+	72	26212583	85287
chr18	57499758	57699758	harbor2	chr18	57502474	57502923	LTR/ERVL	771	+	224	57502698	2940
chr18	57499758	57699758	harbor2	chr18	57526439	57527019	LTR/ERVL	2086	+	290	57526729	26971
chr18	57521968	57721968	harbor2	chr18	57526439	57527019	LTR/ERVL	2086	+	290	57526729	4761
chr18	57521968	57721968	harbor2	chr18	57608724	57609270	LTR/ERVL	1914	+	273	57608997	87029
chr18	59170166	59370166	harbor2	chr18	59212065	59212161	LTR/ERVL	1922	+	48	59212113	41947
chr18	59170166	59370166	harbor2	chr18	59211659	59212008	LTR/ERVL	1922	+	174	59211833	41667
chr18	11589562	11789562	harbor2	chr18	11677907	11678305	LTR/ERVL	896	+	199	11678106	88544
chr18	26127357	26327357	harbor2	chr18	26128164	26128552	LTR/ERVL	3226	+	194	26128358	1001
chr18	26127357	26327357	harbor2	chr18	26128647	26128681	LTR/ERVL	3226	+	17	26128664	1307
chr18	26127357	26327357	harbor2	chr18	26210262	26210691	LTR/ERVL	2476	+	214	26210476	83119
chr18	26127357	26327357	harbor2	chr18	26210728	26210776	LTR/ERVL	2476	+	24	26210752	83395
chr18	26127357	26327357	harbor2	chr18	26212511	26212656	LTR/ERVL	604	+	72	26212583	85226
chr18	46638380	46838380	harbor2	chr18	46692708	46693200	LTR/ERVL	1664	+	246	46692954	54574
chr18	46638380	46838380	harbor2	chr18	46706633	46706748	LTR/ERVL	697	+	58	46706691	68311
chr18	46638380	46838380	harbor2	chr18	46706856	46707039	LTR/ERVL	508	+	92	46706948	68568
chr18	46638380	46838380	harbor2	chr18	46708412	46708910	LTR/ERVL	2318	+	249	46708661	70281
chr18	46638380	46838380	harbor2	chr18	46734864	46735388	LTR/ERVL	2553	+	262	46735126	96746
chr18	12557366	12757366	harbor2	chr18	12603324	12603574	LTR/ERVL	3679	+	125	12603449	46083
chr18	12557366	12757366	harbor2	chr18	12603873	12604434	LTR/ERVL	3679	+	280	12604153	46787
chr18	26126393	26326393	harbor2	chr18	26128164	26128552	LTR/ERVL	3226	+	194	26128358	1965
chr18	26126393	26326393	harbor2	chr18	26128647	26128681	LTR/ERVL	3226	+	17	26128664	2271
chr18	26126393	26326393	harbor2	chr18	26210262	26210691	LTR/ERVL	2476	+	214	26210476	84083
chr18	26126393	26326393	harbor2	chr18	26210728	26210776	LTR/ERVL	2476	+	24	26210752	84359
chr18	26126393	26326393	harbor2	chr18	26212511	26212656	LTR/ERVL	604	+	72	26212583	86190
chr18	12208746	12408746	harbor2	chr18	12281922	12282061	LTR/ERVL	2916	+	70	12281992	73246
chr18	12208746	12408746	harbor2	chr18	12282355	12283069	LTR/ERVL	2916	+	357	12282712	73966
chr18	12208746	12408746	harbor2	chr18	12283107	12283438	LTR/ERVL	1373	+	166	12283273	74527
chr18	75103932	75303932	harbor2	chr18	75123144	75123562	LTR/ERVL	597	+	209	75123353	19421
chr18	75103932	75303932	harbor2	chr18	75135636	75135846	LTR/ERVL	833	+	105	75135741	31809
chr18	75103932	75303932	harbor2	chr18	75136097	75136235	LTR/ERVL	484	+	69	75136166	32234
chr18	75103932	75303932	harbor2	chr18	75136540	75136562	LTR/ERVL	484	+	11	75136551	32619
chr18	75103932	75303932	harbor2	chr18	75136597	75136625	LTR/ERVL	484	+	14	75136611	32679
chr18	75103932	75303932	harbor2	chr18	75176480	75176954	LTR/ERVL	2032	+	237	75176717	72785
chr18	50093420	50293420	harbor2	chr18	50127682	50128188	LTR/ERVL	2560	+	253	50127935	34515
chr18	50093420	50293420	harbor2	chr18	50173868	50174170	LTR/ERVL	1562	+	151	50174019	80599
chr18	59166135	59366135	harbor2	chr18	59212065	59212161	LTR/ERVL	1922	+	48	59212113	45978
chr18	59166135	59366135	harbor2	chr18	59211659	59212008	LTR/ERVL	1922	+	174	59211833	45698
chr18	77230159	77430159	harbor2	chr18	77309706	77310231	LTR/ERVL	2318	+	262	77309968	79809
chr18	65651681	65851681	harbor2	chr18	65651859	65652216	LTR/ERVL	1816	+	178	65652037	356
chr18	65651681	65851681	harbor2	chr18	65652249	65652307	LTR/ERVL	727	+	29	65652278	597
chr19	19676560	19876560	harbor2	chr19	19760002	19760027	LTR/ERVL	1863	+	12	19760014	83454
chr19	19676560	19876560	harbor2	chr19	19760320	19760792	LTR/ERVL	1863	+	236	19760556	83996
chr19	19676560	19876560	harbor2	chr19	19761109	19761520	LTR/ERVL	4637	+	206	19761315	84755
chr19	19676560	19876560	harbor2	chr19	19761837	19761960	LTR/ERVL	4637	+	62	19761899	85339
chr19	19676560	19876560	harbor2	chr19	19762256	19762865	LTR/ERVL	4637	+	304	19762560	86000
chr19	19676560	19876560	harbor2	chr19	19763222	19763463	LTR/ERVL	3870	+	120	19763342	86782
chr19	19676560	19876560	harbor2	chr19	19764169	19764818	LTR/ERVL	3870	+	324	19764493	87933
chr19	19676555	19876555	harbor2	chr19	19760002	19760027	LTR/ERVL	1863	+	12	19760014	83459
chr19	19676555	19876555	harbor2	chr19	19760320	19760792	LTR/ERVL	1863	+	236	19760556	84001
chr19	19676555	19876555	harbor2	chr19	19761109	19761520	LTR/ERVL	4637	+	206	19761315	84760
chr19	19676555	19876555	harbor2	chr19	19761837	19761960	LTR/ERVL	4637	+	62	19761899	85344
chr19	19676555	19876555	harbor2	chr19	19762256	19762865	LTR/ERVL	4637	+	304	19762560	86005
chr19	19676555	19876555	harbor2	chr19	19763222	19763463	LTR/ERVL	3870	+	120	19763342	86787
chr19	19676555	19876555	harbor2	chr19	19764169	19764818	LTR/ERVL	3870	+	324	19764493	87938
chr19	19676581	19876581	harbor2	chr19	19760002	19760027	LTR/ERVL	1863	+	12	19760014	83433
chr19	19676581	19876581	harbor2	chr19	19760320	19760792	LTR/ERVL	1863	+	236	19760556	83975
chr19	19676581	19876581	harbor2	chr19	19761109	19761520	LTR/ERVL	4637	+	206	19761315	84734
chr19	19676581	19876581	harbor2	chr19	19761837	19761960	LTR/ERVL	4637	+	62	19761899	85318
chr19	19676581	19876581	harbor2	chr19	19762256	19762865	LTR/ERVL	4637	+	304	19762560	85979
chr19	19676581	19876581	harbor2	chr19	19763222	19763463	LTR/ERVL	3870	+	120	19763342	86761
chr19	19676581	19876581	harbor2	chr19	19764169	19764818	LTR/ERVL	3870	+	324	19764493	87912
chr19	19676554	19876554	harbor2	chr19	19760002	19760027	LTR/ERVL	1863	+	12	19760014	83460
chr19	19676554	19876554	harbor2	chr19	19760320	19760792	LTR/ERVL	1863	+	236	19760556	84002
chr19	19676554	19876554	harbor2	chr19	19761109	19761520	LTR/ERVL	4637	+	206	19761315	84761
chr19	19676554	19876554	harbor2	chr19	19761837	19761960	LTR/ERVL	4637	+	62	19761899	85345
chr19	19676554	19876554	harbor2	chr19	19762256	19762865	LTR/ERVL	4637	+	304	19762560	86006
chr19	19676554	19876554	harbor2	chr19	19763222	19763463	LTR/ERVL	3870	+	120	19763342	86788
chr19	19676554	19876554	harbor2	chr19	19764169	19764818	LTR/ERVL	3870	+	324	19764493	87939
chr19	56041213	56241213	harbor2	chr19	56071522	56071948	LTR/ERVL	1621	+	213	56071735	30522
chr19	19676548	19876548	harbor2	chr19	19760002	19760027	LTR/ERVL	1863	+	12	19760014	83466
chr19	19676548	19876548	harbor2	chr19	19760320	19760792	LTR/ERVL	1863	+	236	19760556	84008
chr19	19676548	19876548	harbor2	chr19	19761109	19761520	LTR/ERVL	4637	+	206	19761315	84767
chr19	19676548	19876548	harbor2	chr19	19761837	19761960	LTR/ERVL	4637	+	62	19761899	85351
chr19	19676548	19876548	harbor2	chr19	19762256	19762865	LTR/ERVL	4637	+	304	19762560	86012
chr19	19676548	19876548	harbor2	chr19	19763222	19763463	LTR/ERVL	3870	+	120	19763342	86794
chr19	19676548	19876548	harbor2	chr19	19764169	19764818	LTR/ERVL	3870	+	324	19764493	87945
chr19	2065435	2265435	harbor2	chr19	2124097	2124407	LTR/ERVL	729	+	155	2124252	58817
chr19	2065435	2265435	harbor2	chr19	2154586	2154897	LTR/ERVL	815	+	156	2154742	89307
chr19	19676570	19876570	harbor2	chr19	19760002	19760027	LTR/ERVL	1863	+	12	19760014	83444
chr19	19676570	19876570	harbor2	chr19	19760320	19760792	LTR/ERVL	1863	+	236	19760556	83986
chr19	19676570	19876570	harbor2	chr19	19761109	19761520	LTR/ERVL	4637	+	206	19761315	84745
chr19	19676570	19876570	harbor2	chr19	19761837	19761960	LTR/ERVL	4637	+	62	19761899	85329
chr19	19676570	19876570	harbor2	chr19	19762256	19762865	LTR/ERVL	4637	+	304	19762560	85990
chr19	19676570	19876570	harbor2	chr19	19763222	19763463	LTR/ERVL	3870	+	120	19763342	86772
chr19	19676570	19876570	harbor2	chr19	19764169	19764818	LTR/ERVL	3870	+	324	19764493	87923
chr19	35168136	35368136	harbor2	chr19	35173816	35174053	LTR/ERVL	776	+	118	35173934	5798
chr19	35168136	35368136	harbor2	chr19	35179191	35179552	LTR/ERVL	2206	+	180	35179371	11235
chr19	35168136	35368136	harbor2	chr19	35179864	35180103	LTR/ERVL	2206	+	120	35179984	11848
chr19	35168136	35368136	harbor2	chr19	35180160	35180210	LTR/ERVL	4651	+	25	35180185	12049
chr19	35168136	35368136	harbor2	chr19	35180521	35181581	LTR/ERVL	4651	+	530	35181051	12915
chr19	35168136	35368136	harbor2	chr19	35181919	35182123	LTR/ERVL	952	+	102	35182021	13885
chr19	35168136	35368136	harbor2	chr19	35185038	35185218	LTR/ERVL	855	+	90	35185128	16992
chr19	35168136	35368136	harbor2	chr19	35196745	35196781	LTR/ERVL	3679	+	18	35196763	28627
chr19	35168136	35368136	harbor2	chr19	35197446	35198141	LTR/ERVL	3679	+	348	35197794	29658
chr19	35168136	35368136	harbor2	chr19	35198332	35198426	LTR/ERVL	1416	+	47	35198379	30243
chr19	35168136	35368136	harbor2	chr19	35198739	35199045	LTR/ERVL	1416	+	153	35198892	30756
chr19	2710739	2910739	harbor2	chr19	2733975	2734322	LTR/ERVL	1498	+	174	2734149	23410
chr19	2710739	2910739	harbor2	chr19	2737707	2737870	LTR/ERVL	1095	+	82	2737789	27050
chr19	2710739	2910739	harbor2	chr19	2761932	2762235	LTR/ERVL	1060	+	152	2762084	51345
chr19	2710739	2910739	harbor2	chr19	2763312	2763580	LTR/ERVL	715	+	134	2763446	52707
chr19	2356840	2556840	harbor2	chr19	2440848	2441326	LTR/ERVL	940	+	239	2441087	84247
chr19	10619380	10819380	harbor2	chr19	10646676	10646776	LTR/ERVL	1468	+	50	10646726	27346
chr19	10619380	10819380	harbor2	chr19	10647048	10647454	LTR/ERVL	1468	+	203	10647251	27871
chr19	19676521	19876521	harbor2	chr19	19760002	19760027	LTR/ERVL	1863	+	12	19760014	83493
chr19	19676521	19876521	harbor2	chr19	19760320	19760792	LTR/ERVL	1863	+	236	19760556	84035
chr19	19676521	19876521	harbor2	chr19	19761109	19761520	LTR/ERVL	4637	+	206	19761315	84794
chr19	19676521	19876521	harbor2	chr19	19761837	19761960	LTR/ERVL	4637	+	62	19761899	85378
chr19	19676521	19876521	harbor2	chr19	19762256	19762865	LTR/ERVL	4637	+	304	19762560	86039
chr19	19676521	19876521	harbor2	chr19	19763222	19763463	LTR/ERVL	3870	+	120	19763342	86821
chr19	19676521	19876521	harbor2	chr19	19764169	19764818	LTR/ERVL	3870	+	324	19764493	87972
chr19	15232942	15432942	harbor2	chr19	15293967	15294091	LTR/ERVL	625	+	62	15294029	61087
chr19	43994297	44194297	harbor2	chr19	44017410	44017713	LTR/ERVL	751	+	152	44017562	23265
chr19	43994297	44194297	harbor2	chr19	44018024	44018044	LTR/ERVL	751	+	10	44018034	23737
chr19	43994297	44194297	harbor2	chr19	44018405	44018943	LTR/ERVL	2506	+	269	44018674	24377
chr19	43994297	44194297	harbor2	chr19	44019073	44019341	LTR/ERVL	2506	+	134	44019207	24910
chr19	43994297	44194297	harbor2	chr19	44035606	44035780	LTR/ERVL	1532	+	87	44035693	41396
chr19	43994297	44194297	harbor2	chr19	44036074	44036459	LTR/ERVL	1532	+	192	44036266	41969
chr19	43994297	44194297	harbor2	chr19	44036544	44036764	LTR/ERVL	1532	+	110	44036654	42357
chr19	56021023	56221023	harbor2	chr19	56071522	56071948	LTR/ERVL	1621	+	213	56071735	50712
chr19	19676568	19876568	harbor2	chr19	19760002	19760027	LTR/ERVL	1863	+	12	19760014	83446
chr19	19676568	19876568	harbor2	chr19	19760320	19760792	LTR/ERVL	1863	+	236	19760556	83988
chr19	19676568	19876568	harbor2	chr19	19761109	19761520	LTR/ERVL	4637	+	206	19761315	84747
chr19	19676568	19876568	harbor2	chr19	19761837	19761960	LTR/ERVL	4637	+	62	19761899	85331
chr19	19676568	19876568	harbor2	chr19	19762256	19762865	LTR/ERVL	4637	+	304	19762560	85992
chr19	19676568	19876568	harbor2	chr19	19763222	19763463	LTR/ERVL	3870	+	120	19763342	86774
chr19	19676568	19876568	harbor2	chr19	19764169	19764818	LTR/ERVL	3870	+	324	19764493	87925
chr19	19676595	19876595	harbor2	chr19	19760002	19760027	LTR/ERVL	1863	+	12	19760014	83419
chr19	19676595	19876595	harbor2	chr19	19760320	19760792	LTR/ERVL	1863	+	236	19760556	83961
chr19	19676595	19876595	harbor2	chr19	19761109	19761520	LTR/ERVL	4637	+	206	19761315	84720
chr19	19676595	19876595	harbor2	chr19	19761837	19761960	LTR/ERVL	4637	+	62	19761899	85304
chr19	19676595	19876595	harbor2	chr19	19762256	19762865	LTR/ERVL	4637	+	304	19762560	85965
chr19	19676595	19876595	harbor2	chr19	19763222	19763463	LTR/ERVL	3870	+	120	19763342	86747
chr19	19676595	19876595	harbor2	chr19	19764169	19764818	LTR/ERVL	3870	+	324	19764493	87898
chr19	41923608	42123608	harbor2	chr19	41955919	41956506	LTR/ERVL	1603	+	294	41956213	32605
chr19	41923608	42123608	harbor2	chr19	42000883	42001196	LTR/ERVL	1490	+	156	42001039	77431
chr19	49824648	50024648	harbor2	chr19	49913244	49913788	LTR/ERVL	1224	+	272	49913516	88868
chr19	19676599	19876599	harbor2	chr19	19760002	19760027	LTR/ERVL	1863	+	12	19760014	83415
chr19	19676599	19876599	harbor2	chr19	19760320	19760792	LTR/ERVL	1863	+	236	19760556	83957
chr19	19676599	19876599	harbor2	chr19	19761109	19761520	LTR/ERVL	4637	+	206	19761315	84716
chr19	19676599	19876599	harbor2	chr19	19761837	19761960	LTR/ERVL	4637	+	62	19761899	85300
chr19	19676599	19876599	harbor2	chr19	19762256	19762865	LTR/ERVL	4637	+	304	19762560	85961
chr19	19676599	19876599	harbor2	chr19	19763222	19763463	LTR/ERVL	3870	+	120	19763342	86743
chr19	19676599	19876599	harbor2	chr19	19764169	19764818	LTR/ERVL	3870	+	324	19764493	87894
chr19	51864995	52064995	harbor2	chr19	51895831	51896153	LTR/ERVL	1533	+	161	51895992	30997
chr19	51864995	52064995	harbor2	chr19	51911828	51911872	LTR/ERVL	1245	+	22	51911850	46855
chr19	51864995	52064995	harbor2	chr19	51912172	51912529	LTR/ERVL	1245	+	178	51912350	47355
chr19	51864995	52064995	harbor2	chr19	51923222	51923693	LTR/ERVL	2084	+	236	51923458	58463
chr19	51864995	52064995	harbor2	chr19	51936431	51936494	LTR/ERVL	2977	+	32	51936463	71468
chr19	51864995	52064995	harbor2	chr19	51936785	51937462	LTR/ERVL	2977	+	338	51937123	72128
chr19	1961578	2161578	harbor2	chr19	2001514	2001743	LTR/ERVL	803	+	114	2001628	40050
chr19	1961578	2161578	harbor2	chr19	2002039	2002069	LTR/ERVL	803	+	15	2002054	40476
chr19	1961578	2161578	harbor2	chr19	2002361	2002592	LTR/ERVL	803	+	116	2002477	40899
chr19	1961578	2161578	harbor2	chr19	2002905	2003009	LTR/ERVL	803	+	52	2002957	41379
chr19	39766858	39966858	harbor2	chr19	39770440	39770606	LTR/ERVL	1138	+	83	39770523	3665
chr19	39766858	39966858	harbor2	chr19	39771716	39771985	LTR/ERVL	1138	+	134	39771850	4992
chr19	39766858	39966858	harbor2	chr19	39865723	39866073	LTR/ERVL	1660	+	175	39865898	99040
chr19	10619513	10819513	harbor2	chr19	10646676	10646776	LTR/ERVL	1468	+	50	10646726	27213
chr19	10619513	10819513	harbor2	chr19	10647048	10647454	LTR/ERVL	1468	+	203	10647251	27738
chr19	54349613	54549613	harbor2	chr19	54402951	54403368	LTR/ERVL	1394	+	208	54403159	53546
chr19	54349613	54549613	harbor2	chr19	54444710	54445187	LTR/ERVL	1539	+	238	54444948	95335
chr19	10618444	10818444	harbor2	chr19	10646676	10646776	LTR/ERVL	1468	+	50	10646726	28282
chr19	10618444	10818444	harbor2	chr19	10647048	10647454	LTR/ERVL	1468	+	203	10647251	28807
chr19	58357531	58557531	harbor2	chr19	58365703	58366062	LTR/ERVL	884	+	180	58365883	8352
chr19	190996	390996	harbor2	chr19	206165	206670	LTR/ERVL	3544	+	252	206417	15421
chr19	190996	390996	harbor2	chr19	206978	207047	LTR/ERVL	3544	+	34	207012	16016
chr19	190996	390996	harbor2	chr19	207351	207651	LTR/ERVL	3544	+	150	207501	16505
chr19	190996	390996	harbor2	chr19	217941	218198	LTR/ERVL	3577	+	128	218069	27073
chr19	190996	390996	harbor2	chr19	218494	218803	LTR/ERVL	3577	+	154	218648	27652
chr19	190996	390996	harbor2	chr19	219110	219409	LTR/ERVL	3577	+	150	219260	28264
chr19	31990162	32190162	harbor2	chr19	31990481	31990902	LTR/ERVL	669	+	210	31990691	529
chr19	29842433	30042433	harbor2	chr19	29849873	29850172	LTR/ERVL	1726	+	150	29850023	7590
chr19	29842433	30042433	harbor2	chr19	29850611	29850763	LTR/ERVL	913	+	76	29850687	8254
chr19	55205663	55405663	harbor2	chr19	55222952	55223410	LTR/ERVL	2758	+	229	55223181	17518
chr19	55205663	55405663	harbor2	chr19	55213666	55214150	LTR/ERVL	1078	+	242	55213908	8245
chr19	32286588	32486588	harbor2	chr19	32288794	32289325	LTR/ERVL	2764	+	266	32289060	2472
chr19	10618443	10818443	harbor2	chr19	10646676	10646776	LTR/ERVL	1468	+	50	10646726	28283
chr19	10618443	10818443	harbor2	chr19	10647048	10647454	LTR/ERVL	1468	+	203	10647251	28808
chr19	2391198	2591198	harbor2	chr19	2440848	2441326	LTR/ERVL	940	+	239	2441087	49889
chr19	19676587	19876587	harbor2	chr19	19760002	19760027	LTR/ERVL	1863	+	12	19760014	83427
chr19	19676587	19876587	harbor2	chr19	19760320	19760792	LTR/ERVL	1863	+	236	19760556	83969
chr19	19676587	19876587	harbor2	chr19	19761109	19761520	LTR/ERVL	4637	+	206	19761315	84728
chr19	19676587	19876587	harbor2	chr19	19761837	19761960	LTR/ERVL	4637	+	62	19761899	85312
chr19	19676587	19876587	harbor2	chr19	19762256	19762865	LTR/ERVL	4637	+	304	19762560	85973
chr19	19676587	19876587	harbor2	chr19	19763222	19763463	LTR/ERVL	3870	+	120	19763342	86755
chr19	19676587	19876587	harbor2	chr19	19764169	19764818	LTR/ERVL	3870	+	324	19764493	87906
chr19	30444888	30644888	harbor2	chr19	30472827	30472909	LTR/ERVL	2012	+	41	30472868	27980
chr19	30444888	30644888	harbor2	chr19	30473238	30473598	LTR/ERVL	2012	+	180	30473418	28530
chr19	48640267	48840267	harbor2	chr19	48712221	48712408	LTR/ERVL	783	+	94	48712315	72048
chr19	48640267	48840267	harbor2	chr19	48712732	48712807	LTR/ERVL	783	+	38	48712770	72503
chr19	48640267	48840267	harbor2	chr19	48709558	48709855	LTR/ERVL	798	+	148	48709706	69439
chr19	32578169	32778169	harbor2	chr19	32623166	32623548	LTR/ERVL	2372	+	191	32623357	45188
chr19	32578169	32778169	harbor2	chr19	32623851	32624042	LTR/ERVL	2372	+	96	32623947	45778
chr19	49830317	50030317	harbor2	chr19	49913244	49913788	LTR/ERVL	1224	+	272	49913516	83199
chr19	33324387	33524387	harbor2	chr19	33336984	33337254	LTR/ERVL	686	+	135	33337119	12732
chr19	19952302	20152302	harbor2	chr19	19957701	19958100	LTR/ERVL	3355	+	200	19957901	5599
chr19	19952302	20152302	harbor2	chr19	19958164	19958689	LTR/ERVL	4031	+	262	19958426	6124
chr19	19952302	20152302	harbor2	chr19	19959694	19959789	LTR/ERVL	4031	+	48	19959742	7440
chr19	19952302	20152302	harbor2	chr19	19959790	19961467	LTR/ERVL	12830	+	838	19960628	8326
chr19	19952302	20152302	harbor2	chr19	19962598	19962713	LTR/ERVL	793	+	58	19962656	10354
chr19	19952302	20152302	harbor2	chr19	19962700	19964290	LTR/ERVL	11117	+	795	19963495	11193
chr19	19952302	20152302	harbor2	chr19	19964291	19964935	LTR/ERVL	3797	+	322	19964613	12311
chr19	317994	517994	harbor2	chr19	348520	348786	LTR/ERVL	735	+	133	348653	30659
chr19	35168150	35368150	harbor2	chr19	35173816	35174053	LTR/ERVL	776	+	118	35173934	5784
chr19	35168150	35368150	harbor2	chr19	35179191	35179552	LTR/ERVL	2206	+	180	35179371	11221
chr19	35168150	35368150	harbor2	chr19	35179864	35180103	LTR/ERVL	2206	+	120	35179984	11834
chr19	35168150	35368150	harbor2	chr19	35180160	35180210	LTR/ERVL	4651	+	25	35180185	12035
chr19	35168150	35368150	harbor2	chr19	35180521	35181581	LTR/ERVL	4651	+	530	35181051	12901
chr19	35168150	35368150	harbor2	chr19	35181919	35182123	LTR/ERVL	952	+	102	35182021	13871
chr19	35168150	35368150	harbor2	chr19	35185038	35185218	LTR/ERVL	855	+	90	35185128	16978
chr19	35168150	35368150	harbor2	chr19	35196745	35196781	LTR/ERVL	3679	+	18	35196763	28613
chr19	35168150	35368150	harbor2	chr19	35197446	35198141	LTR/ERVL	3679	+	348	35197794	29644
chr19	35168150	35368150	harbor2	chr19	35198332	35198426	LTR/ERVL	1416	+	47	35198379	30229
chr19	35168150	35368150	harbor2	chr19	35198739	35199045	LTR/ERVL	1416	+	153	35198892	30742
chr19	9870651	10070651	harbor2	chr19	9885447	9885816	LTR/ERVL	701	+	184	9885631	14980
chr19	9870651	10070651	harbor2	chr19	9886115	9886165	LTR/ERVL	701	+	25	9886140	15489
chr19	9870651	10070651	harbor2	chr19	9917378	9917786	LTR/ERVL	1216	+	204	9917582	46931
chr19	9870651	10070651	harbor2	chr19	9939565	9939991	LTR/ERVL	915	+	213	9939778	69127
chr19	9870651	10070651	harbor2	chr19	9940633	9940742	LTR/ERVL	915	+	54	9940687	70036
chr19	9870651	10070651	harbor2	chr19	9942069	9942404	LTR/ERVL	881	+	168	9942237	71586
chr19	9870651	10070651	harbor2	chr19	9962989	9963205	LTR/ERVL	858	+	108	9963097	92446
chr19	19676557	19876557	harbor2	chr19	19760002	19760027	LTR/ERVL	1863	+	12	19760014	83457
chr19	19676557	19876557	harbor2	chr19	19760320	19760792	LTR/ERVL	1863	+	236	19760556	83999
chr19	19676557	19876557	harbor2	chr19	19761109	19761520	LTR/ERVL	4637	+	206	19761315	84758
chr19	19676557	19876557	harbor2	chr19	19761837	19761960	LTR/ERVL	4637	+	62	19761899	85342
chr19	19676557	19876557	harbor2	chr19	19762256	19762865	LTR/ERVL	4637	+	304	19762560	86003
chr19	19676557	19876557	harbor2	chr19	19763222	19763463	LTR/ERVL	3870	+	120	19763342	86785
chr19	19676557	19876557	harbor2	chr19	19764169	19764818	LTR/ERVL	3870	+	324	19764493	87936
chr19	19676582	19876582	harbor2	chr19	19760002	19760027	LTR/ERVL	1863	+	12	19760014	83432
chr19	19676582	19876582	harbor2	chr19	19760320	19760792	LTR/ERVL	1863	+	236	19760556	83974
chr19	19676582	19876582	harbor2	chr19	19761109	19761520	LTR/ERVL	4637	+	206	19761315	84733
chr19	19676582	19876582	harbor2	chr19	19761837	19761960	LTR/ERVL	4637	+	62	19761899	85317
chr19	19676582	19876582	harbor2	chr19	19762256	19762865	LTR/ERVL	4637	+	304	19762560	85978
chr19	19676582	19876582	harbor2	chr19	19763222	19763463	LTR/ERVL	3870	+	120	19763342	86760
chr19	19676582	19876582	harbor2	chr19	19764169	19764818	LTR/ERVL	3870	+	324	19764493	87911
chr19	19676565	19876565	harbor2	chr19	19760002	19760027	LTR/ERVL	1863	+	12	19760014	83449
chr19	19676565	19876565	harbor2	chr19	19760320	19760792	LTR/ERVL	1863	+	236	19760556	83991
chr19	19676565	19876565	harbor2	chr19	19761109	19761520	LTR/ERVL	4637	+	206	19761315	84750
chr19	19676565	19876565	harbor2	chr19	19761837	19761960	LTR/ERVL	4637	+	62	19761899	85334
chr19	19676565	19876565	harbor2	chr19	19762256	19762865	LTR/ERVL	4637	+	304	19762560	85995
chr19	19676565	19876565	harbor2	chr19	19763222	19763463	LTR/ERVL	3870	+	120	19763342	86777
chr19	19676565	19876565	harbor2	chr19	19764169	19764818	LTR/ERVL	3870	+	324	19764493	87928
chr19	208948	408948	harbor2	chr19	217941	218198	LTR/ERVL	3577	+	128	218069	9121
chr19	208948	408948	harbor2	chr19	218494	218803	LTR/ERVL	3577	+	154	218648	9700
chr19	208948	408948	harbor2	chr19	219110	219409	LTR/ERVL	3577	+	150	219260	10312
chr19	10618459	10818459	harbor2	chr19	10646676	10646776	LTR/ERVL	1468	+	50	10646726	28267
chr19	10618459	10818459	harbor2	chr19	10647048	10647454	LTR/ERVL	1468	+	203	10647251	28792
chr19	15882495	16082495	harbor2	chr19	15891044	15891481	LTR/ERVL	1367	+	218	15891262	8767
chr19	15882495	16082495	harbor2	chr19	15895680	15895762	LTR/ERVL	616	+	41	15895721	13226
chr19	15882495	16082495	harbor2	chr19	15903994	15904444	LTR/ERVL	3465	+	225	15904219	21724
chr19	15882495	16082495	harbor2	chr19	15923137	15923238	LTR/ERVL	937	+	50	15923187	40692
chr19	15882495	16082495	harbor2	chr19	15923286	15923638	LTR/ERVL	937	+	176	15923462	40967
chr19	15882495	16082495	harbor2	chr19	15925771	15925882	LTR/ERVL	1225	+	56	15925827	43332
chr19	15882495	16082495	harbor2	chr19	15926179	15926436	LTR/ERVL	1225	+	128	15926307	43812
chr19	15882495	16082495	harbor2	chr19	15929631	15930146	LTR/ERVL	1400	+	258	15929889	47394
chr19	15882495	16082495	harbor2	chr19	15973954	15973988	LTR/ERVL	2938	+	17	15973971	91476
chr19	15882495	16082495	harbor2	chr19	15975247	15975323	LTR/ERVL	2938	+	38	15975285	92790
chr19	15882495	16082495	harbor2	chr19	15974288	15974871	LTR/ERVL	2938	+	292	15974580	92085
chr19	49713961	49913961	harbor2	chr19	49717516	49717903	LTR/ERVL	1134	+	194	49717710	3749
chr19	49713961	49913961	harbor2	chr19	49718210	49718287	LTR/ERVL	1134	+	38	49718248	4287
chr19	49713961	49913961	harbor2	chr19	49718583	49718671	LTR/ERVL	1134	+	44	49718627	4666
chr19	49713961	49913961	harbor2	chr19	49730381	49730545	LTR/ERVL	636	+	82	49730463	16502
chr19	45026245	45226245	harbor2	chr19	45031424	45031555	LTR/ERVL	698	+	66	45031490	5245
chr19	10619429	10819429	harbor2	chr19	10646676	10646776	LTR/ERVL	1468	+	50	10646726	27297
chr19	10619429	10819429	harbor2	chr19	10647048	10647454	LTR/ERVL	1468	+	203	10647251	27822
chr19	55988018	56188018	harbor2	chr19	56071522	56071948	LTR/ERVL	1621	+	213	56071735	83717
chr19	51744047	51944047	harbor2	chr19	51760506	51760833	LTR/ERVL	1733	+	164	51760670	16623
chr19	51744047	51944047	harbor2	chr19	51780527	51781861	LTR/ERVL	6817	+	667	51781194	37147
chr19	51744047	51944047	harbor2	chr19	51782241	51782426	LTR/ERVL	938	+	92	51782333	38286
chr19	51744047	51944047	harbor2	chr19	51782427	51782818	LTR/ERVL	1243	+	196	51782623	38576
chr19	51744047	51944047	harbor2	chr19	51793657	51794408	LTR/ERVL	1789	+	376	51794033	49986
chr19	51744047	51944047	harbor2	chr19	51801312	51801498	LTR/ERVL	3102	+	93	51801405	57358
chr19	51744047	51944047	harbor2	chr19	51801754	51802250	LTR/ERVL	3102	+	248	51802002	57955
chr19	51744047	51944047	harbor2	chr19	51804123	51804241	LTR/ERVL	782	+	59	51804182	60135
chr19	51744047	51944047	harbor2	chr19	51804436	51804695	LTR/ERVL	1582	+	130	51804566	60519
chr19	51744047	51944047	harbor2	chr19	51811941	51812767	LTR/ERVL	3430	+	413	51812354	68307
chr19	51744047	51944047	harbor2	chr19	51816091	51816245	LTR/ERVL	2053	+	77	51816168	72121
chr19	51744047	51944047	harbor2	chr19	51816548	51816918	LTR/ERVL	2053	+	185	51816733	72686
chr19	19676571	19876571	harbor2	chr19	19760002	19760027	LTR/ERVL	1863	+	12	19760014	83443
chr19	19676571	19876571	harbor2	chr19	19760320	19760792	LTR/ERVL	1863	+	236	19760556	83985
chr19	19676571	19876571	harbor2	chr19	19761109	19761520	LTR/ERVL	4637	+	206	19761315	84744
chr19	19676571	19876571	harbor2	chr19	19761837	19761960	LTR/ERVL	4637	+	62	19761899	85328
chr19	19676571	19876571	harbor2	chr19	19762256	19762865	LTR/ERVL	4637	+	304	19762560	85989
chr19	19676571	19876571	harbor2	chr19	19763222	19763463	LTR/ERVL	3870	+	120	19763342	86771
chr19	19676571	19876571	harbor2	chr19	19764169	19764818	LTR/ERVL	3870	+	324	19764493	87922
chr19	2130274	2330274	harbor2	chr19	2154586	2154897	LTR/ERVL	815	+	156	2154742	24468
chr19	10618433	10818433	harbor2	chr19	10646676	10646776	LTR/ERVL	1468	+	50	10646726	28293
chr19	10618433	10818433	harbor2	chr19	10647048	10647454	LTR/ERVL	1468	+	203	10647251	28818
chr19	1961573	2161573	harbor2	chr19	2001514	2001743	LTR/ERVL	803	+	114	2001628	40055
chr19	1961573	2161573	harbor2	chr19	2002039	2002069	LTR/ERVL	803	+	15	2002054	40481
chr19	1961573	2161573	harbor2	chr19	2002361	2002592	LTR/ERVL	803	+	116	2002477	40904
chr19	1961573	2161573	harbor2	chr19	2002905	2003009	LTR/ERVL	803	+	52	2002957	41384
chr19	19952301	20152301	harbor2	chr19	19957701	19958100	LTR/ERVL	3355	+	200	19957901	5600
chr19	19952301	20152301	harbor2	chr19	19958164	19958689	LTR/ERVL	4031	+	262	19958426	6125
chr19	19952301	20152301	harbor2	chr19	19959694	19959789	LTR/ERVL	4031	+	48	19959742	7441
chr19	19952301	20152301	harbor2	chr19	19959790	19961467	LTR/ERVL	12830	+	838	19960628	8327
chr19	19952301	20152301	harbor2	chr19	19962598	19962713	LTR/ERVL	793	+	58	19962656	10355
chr19	19952301	20152301	harbor2	chr19	19962700	19964290	LTR/ERVL	11117	+	795	19963495	11194
chr19	19952301	20152301	harbor2	chr19	19964291	19964935	LTR/ERVL	3797	+	322	19964613	12312
chr19	50332354	50532354	harbor2	chr19	50339150	50339407	LTR/ERVL	1346	+	128	50339278	6924
chr19	50332354	50532354	harbor2	chr19	50339692	50339826	LTR/ERVL	1346	+	67	50339759	7405
chr19	43994355	44194355	harbor2	chr19	44017410	44017713	LTR/ERVL	751	+	152	44017562	23207
chr19	43994355	44194355	harbor2	chr19	44018024	44018044	LTR/ERVL	751	+	10	44018034	23679
chr19	43994355	44194355	harbor2	chr19	44018405	44018943	LTR/ERVL	2506	+	269	44018674	24319
chr19	43994355	44194355	harbor2	chr19	44019073	44019341	LTR/ERVL	2506	+	134	44019207	24852
chr19	43994355	44194355	harbor2	chr19	44035606	44035780	LTR/ERVL	1532	+	87	44035693	41338
chr19	43994355	44194355	harbor2	chr19	44036074	44036459	LTR/ERVL	1532	+	192	44036266	41911
chr19	43994355	44194355	harbor2	chr19	44036544	44036764	LTR/ERVL	1532	+	110	44036654	42299
chr19	48344616	48544616	harbor2	chr19	48355663	48356106	LTR/ERVL	2501	+	222	48355885	11269
chr19	51196549	51396549	harbor2	chr19	51257531	51258278	LTR/ERVL	3121	+	374	51257905	61356
chr19	51196549	51396549	harbor2	chr19	51258284	51258680	LTR/ERVL	1434	+	198	51258482	61933
chr19	51196549	51396549	harbor2	chr19	51258732	51259118	LTR/ERVL	1387	+	193	51258925	62376
chr19	51196549	51396549	harbor2	chr19	51259238	51260130	LTR/ERVL	2315	+	446	51259684	63135
chr19	1961617	2161617	harbor2	chr19	2001514	2001743	LTR/ERVL	803	+	114	2001628	40011
chr19	1961617	2161617	harbor2	chr19	2002039	2002069	LTR/ERVL	803	+	15	2002054	40437
chr19	1961617	2161617	harbor2	chr19	2002361	2002592	LTR/ERVL	803	+	116	2002477	40860
chr19	1961617	2161617	harbor2	chr19	2002905	2003009	LTR/ERVL	803	+	52	2002957	41340
chr19	15279599	15479599	harbor2	chr19	15293967	15294091	LTR/ERVL	625	+	62	15294029	14430
chr19	54059667	54259667	harbor2	chr19	54079372	54079571	LTR/ERVL	788	+	100	54079472	19805
chr19	19676545	19876545	harbor2	chr19	19760002	19760027	LTR/ERVL	1863	+	12	19760014	83469
chr19	19676545	19876545	harbor2	chr19	19760320	19760792	LTR/ERVL	1863	+	236	19760556	84011
chr19	19676545	19876545	harbor2	chr19	19761109	19761520	LTR/ERVL	4637	+	206	19761315	84770
chr19	19676545	19876545	harbor2	chr19	19761837	19761960	LTR/ERVL	4637	+	62	19761899	85354
chr19	19676545	19876545	harbor2	chr19	19762256	19762865	LTR/ERVL	4637	+	304	19762560	86015
chr19	19676545	19876545	harbor2	chr19	19763222	19763463	LTR/ERVL	3870	+	120	19763342	86797
chr19	19676545	19876545	harbor2	chr19	19764169	19764818	LTR/ERVL	3870	+	324	19764493	87948
chr19	2146353	2346353	harbor2	chr19	2154586	2154897	LTR/ERVL	815	+	156	2154742	8389
chr19	46994624	47194624	harbor2	chr19	47074477	47074922	LTR/ERVL	1658	+	222	47074699	80075
chr19	19676558	19876558	harbor2	chr19	19760002	19760027	LTR/ERVL	1863	+	12	19760014	83456
chr19	19676558	19876558	harbor2	chr19	19760320	19760792	LTR/ERVL	1863	+	236	19760556	83998
chr19	19676558	19876558	harbor2	chr19	19761109	19761520	LTR/ERVL	4637	+	206	19761315	84757
chr19	19676558	19876558	harbor2	chr19	19761837	19761960	LTR/ERVL	4637	+	62	19761899	85341
chr19	19676558	19876558	harbor2	chr19	19762256	19762865	LTR/ERVL	4637	+	304	19762560	86002
chr19	19676558	19876558	harbor2	chr19	19763222	19763463	LTR/ERVL	3870	+	120	19763342	86784
chr19	19676558	19876558	harbor2	chr19	19764169	19764818	LTR/ERVL	3870	+	324	19764493	87935
chr19	47008504	47208504	harbor2	chr19	47074477	47074922	LTR/ERVL	1658	+	222	47074699	66195
chr19	19676585	19876585	harbor2	chr19	19760002	19760027	LTR/ERVL	1863	+	12	19760014	83429
chr19	19676585	19876585	harbor2	chr19	19760320	19760792	LTR/ERVL	1863	+	236	19760556	83971
chr19	19676585	19876585	harbor2	chr19	19761109	19761520	LTR/ERVL	4637	+	206	19761315	84730
chr19	19676585	19876585	harbor2	chr19	19761837	19761960	LTR/ERVL	4637	+	62	19761899	85314
chr19	19676585	19876585	harbor2	chr19	19762256	19762865	LTR/ERVL	4637	+	304	19762560	85975
chr19	19676585	19876585	harbor2	chr19	19763222	19763463	LTR/ERVL	3870	+	120	19763342	86757
chr19	19676585	19876585	harbor2	chr19	19764169	19764818	LTR/ERVL	3870	+	324	19764493	87908
chr19	54476346	54676346	harbor2	chr19	54568509	54571051	LTR/ERVL	11870	+	1271	54569780	93434
chr19	35168139	35368139	harbor2	chr19	35173816	35174053	LTR/ERVL	776	+	118	35173934	5795
chr19	35168139	35368139	harbor2	chr19	35179191	35179552	LTR/ERVL	2206	+	180	35179371	11232
chr19	35168139	35368139	harbor2	chr19	35179864	35180103	LTR/ERVL	2206	+	120	35179984	11845
chr19	35168139	35368139	harbor2	chr19	35180160	35180210	LTR/ERVL	4651	+	25	35180185	12046
chr19	35168139	35368139	harbor2	chr19	35180521	35181581	LTR/ERVL	4651	+	530	35181051	12912
chr19	35168139	35368139	harbor2	chr19	35181919	35182123	LTR/ERVL	952	+	102	35182021	13882
chr19	35168139	35368139	harbor2	chr19	35185038	35185218	LTR/ERVL	855	+	90	35185128	16989
chr19	35168139	35368139	harbor2	chr19	35196745	35196781	LTR/ERVL	3679	+	18	35196763	28624
chr19	35168139	35368139	harbor2	chr19	35197446	35198141	LTR/ERVL	3679	+	348	35197794	29655
chr19	35168139	35368139	harbor2	chr19	35198332	35198426	LTR/ERVL	1416	+	47	35198379	30240
chr19	35168139	35368139	harbor2	chr19	35198739	35199045	LTR/ERVL	1416	+	153	35198892	30753
chr19	19676575	19876575	harbor2	chr19	19760002	19760027	LTR/ERVL	1863	+	12	19760014	83439
chr19	19676575	19876575	harbor2	chr19	19760320	19760792	LTR/ERVL	1863	+	236	19760556	83981
chr19	19676575	19876575	harbor2	chr19	19761109	19761520	LTR/ERVL	4637	+	206	19761315	84740
chr19	19676575	19876575	harbor2	chr19	19761837	19761960	LTR/ERVL	4637	+	62	19761899	85324
chr19	19676575	19876575	harbor2	chr19	19762256	19762865	LTR/ERVL	4637	+	304	19762560	85985
chr19	19676575	19876575	harbor2	chr19	19763222	19763463	LTR/ERVL	3870	+	120	19763342	86767
chr19	19676575	19876575	harbor2	chr19	19764169	19764818	LTR/ERVL	3870	+	324	19764493	87918
chr19	46368192	46568192	harbor2	chr19	46367824	46368510	LTR/ERVL	3977	+	343	46368167	25
chr19	46368192	46568192	harbor2	chr19	46368921	46369044	LTR/ERVL	760	+	62	46368983	791
chr19	46368192	46568192	harbor2	chr19	46431918	46432184	LTR/ERVL	717	+	133	46432051	63859
chr19	46368192	46568192	harbor2	chr19	46432493	46432610	LTR/ERVL	717	+	58	46432551	64359
chr19	18755479	18955479	harbor2	chr19	18820948	18821368	LTR/ERVL	1401	+	210	18821158	65679
chr19	19952380	20152380	harbor2	chr19	19957701	19958100	LTR/ERVL	3355	+	200	19957901	5521
chr19	19952380	20152380	harbor2	chr19	19958164	19958689	LTR/ERVL	4031	+	262	19958426	6046
chr19	19952380	20152380	harbor2	chr19	19959694	19959789	LTR/ERVL	4031	+	48	19959742	7362
chr19	19952380	20152380	harbor2	chr19	19959790	19961467	LTR/ERVL	12830	+	838	19960628	8248
chr19	19952380	20152380	harbor2	chr19	19962598	19962713	LTR/ERVL	793	+	58	19962656	10276
chr19	19952380	20152380	harbor2	chr19	19962700	19964290	LTR/ERVL	11117	+	795	19963495	11115
chr19	19952380	20152380	harbor2	chr19	19964291	19964935	LTR/ERVL	3797	+	322	19964613	12233
chr19	18780209	18980209	harbor2	chr19	18820948	18821368	LTR/ERVL	1401	+	210	18821158	40949
chr19	2486357	2686357	harbor2	chr19	2519607	2519837	LTR/ERVL	1409	+	115	2519722	33365
chr19	56041194	56241194	harbor2	chr19	56071522	56071948	LTR/ERVL	1621	+	213	56071735	30541
chr19	14334318	14534318	harbor2	chr19	14339836	14340105	LTR/ERVL	1149	+	134	14339970	5652
chr19	14334318	14534318	harbor2	chr19	14345474	14345733	LTR/ERVL	788	+	130	14345604	11286
chr19	19676551	19876551	harbor2	chr19	19760002	19760027	LTR/ERVL	1863	+	12	19760014	83463
chr19	19676551	19876551	harbor2	chr19	19760320	19760792	LTR/ERVL	1863	+	236	19760556	84005
chr19	19676551	19876551	harbor2	chr19	19761109	19761520	LTR/ERVL	4637	+	206	19761315	84764
chr19	19676551	19876551	harbor2	chr19	19761837	19761960	LTR/ERVL	4637	+	62	19761899	85348
chr19	19676551	19876551	harbor2	chr19	19762256	19762865	LTR/ERVL	4637	+	304	19762560	86009
chr19	19676551	19876551	harbor2	chr19	19763222	19763463	LTR/ERVL	3870	+	120	19763342	86791
chr19	19676551	19876551	harbor2	chr19	19764169	19764818	LTR/ERVL	3870	+	324	19764493	87942
chr19	19676588	19876588	harbor2	chr19	19760002	19760027	LTR/ERVL	1863	+	12	19760014	83426
chr19	19676588	19876588	harbor2	chr19	19760320	19760792	LTR/ERVL	1863	+	236	19760556	83968
chr19	19676588	19876588	harbor2	chr19	19761109	19761520	LTR/ERVL	4637	+	206	19761315	84727
chr19	19676588	19876588	harbor2	chr19	19761837	19761960	LTR/ERVL	4637	+	62	19761899	85311
chr19	19676588	19876588	harbor2	chr19	19762256	19762865	LTR/ERVL	4637	+	304	19762560	85972
chr19	19676588	19876588	harbor2	chr19	19763222	19763463	LTR/ERVL	3870	+	120	19763342	86754
chr19	19676588	19876588	harbor2	chr19	19764169	19764818	LTR/ERVL	3870	+	324	19764493	87905
chr20	63357465	63557465	harbor2	chr20	63450733	63450859	LTR/ERVL	515	+	63	63450796	93331
chr20	63357465	63557465	harbor2	chr20	63451166	63451248	LTR/ERVL	515	+	41	63451207	93742
chr20	63357465	63557465	harbor2	chr20	63451296	63451570	LTR/ERVL	912	+	137	63451433	93968
chr20	35354845	35554845	harbor2	chr20	35394268	35394643	LTR/ERVL	1194	+	188	35394456	39611
chr20	35355061	35555061	harbor2	chr20	35394268	35394643	LTR/ERVL	1194	+	188	35394456	39395
chr20	5095940	5295940	harbor2	chr20	5124689	5124881	LTR/ERVL	574	+	96	5124785	28845
chr20	5095940	5295940	harbor2	chr20	5140957	5141929	LTR/ERVL	2630	+	486	5141443	45503
chr20	35354894	35554894	harbor2	chr20	35394268	35394643	LTR/ERVL	1194	+	188	35394456	39562
chr20	44866890	45066890	harbor2	chr20	44870970	44871103	LTR/ERVL	503	+	66	44871036	4146
chr20	62349814	62549814	harbor2	chr20	62440106	62440458	LTR/ERVL	788	+	176	62440282	90468
chr20	63471957	63671957	harbor2	chr20	63504284	63504390	LTR/ERVL	468	+	53	63504337	32380
chr20	63647950	63847950	harbor2	chr20	63663061	63663280	LTR/ERVL	653	+	110	63663171	15221
chr20	63647950	63847950	harbor2	chr20	63705753	63706203	LTR/ERVL	1583	+	225	63705978	58028
chr20	1021218	1221218	harbor2	chr20	1109101	1109488	LTR/ERVL	756	+	194	1109295	88077
chr20	1021218	1221218	harbor2	chr20	1109865	1110271	LTR/ERVL	861	+	203	1110068	88850
chr20	1021218	1221218	harbor2	chr20	1114185	1114427	LTR/ERVL	987	+	121	1114306	93088
chr20	3718565	3918565	harbor2	chr20	3722104	3722206	LTR/ERVL	467	+	51	3722155	3590
chr20	63474251	63674251	harbor2	chr20	63504284	63504390	LTR/ERVL	468	+	53	63504337	30086
chr20	4627380	4827380	harbor2	chr20	4635913	4636276	LTR/ERVL	639	+	182	4636095	8715
chr20	4627380	4827380	harbor2	chr20	4653972	4654431	LTR/ERVL	1785	+	230	4654202	26822
chr20	4627380	4827380	harbor2	chr20	4654600	4654811	LTR/ERVL	1117	+	106	4654706	27326
chr20	4627380	4827380	harbor2	chr20	4708059	4708519	LTR/ERVL	1683	+	230	4708289	80909
chr20	63472813	63672813	harbor2	chr20	63504284	63504390	LTR/ERVL	468	+	53	63504337	31524
chr20	33390084	33590084	harbor2	chr20	33405082	33405515	LTR/ERVL	1893	+	216	33405298	15214
chr20	63365828	63565828	harbor2	chr20	63450733	63450859	LTR/ERVL	515	+	63	63450796	84968
chr20	63365828	63565828	harbor2	chr20	63451166	63451248	LTR/ERVL	515	+	41	63451207	85379
chr20	63365828	63565828	harbor2	chr20	63451296	63451570	LTR/ERVL	912	+	137	63451433	85605
chr20	63442771	63642771	harbor2	chr20	63450733	63450859	LTR/ERVL	515	+	63	63450796	8025
chr20	63442771	63642771	harbor2	chr20	63451166	63451248	LTR/ERVL	515	+	41	63451207	8436
chr20	63442771	63642771	harbor2	chr20	63451296	63451570	LTR/ERVL	912	+	137	63451433	8662
chr20	63442771	63642771	harbor2	chr20	63504284	63504390	LTR/ERVL	468	+	53	63504337	61566
chr20	50269774	50469774	harbor2	chr20	50275930	50276139	LTR/ERVL	618	+	104	50276034	6260
chr20	50269774	50469774	harbor2	chr20	50302406	50302917	LTR/ERVL	1427	+	256	50302662	32888
chr20	59419626	59619626	harbor2	chr20	59439319	59440194	LTR/ERVL	1906	+	438	59439757	20131
chr20	63567788	63767788	harbor2	chr20	63579242	63579829	LTR/ERVL	2199	+	294	63579536	11748
chr20	63567788	63767788	harbor2	chr20	63633757	63634116	LTR/ERVL	1072	+	180	63633937	66149
chr20	63567788	63767788	harbor2	chr20	63663061	63663280	LTR/ERVL	653	+	110	63663171	95383
chr20	4811509	5011509	harbor2	chr20	4903878	4904557	LTR/ERVL	2041	+	340	4904218	92709
chr20	48277508	48477508	harbor2	chr20	48332192	48332349	LTR/ERVL	538	+	78	48332270	54762
chr20	5908030	6108030	harbor2	chr20	5929878	5929924	LTR/ERVL	1135	+	23	5929901	21871
chr20	5908030	6108030	harbor2	chr20	5930406	5930666	LTR/ERVL	1135	+	130	5930536	22506
chr20	5908030	6108030	harbor2	chr20	5939877	5940313	LTR/ERVL	1521	+	218	5940095	32065
chr20	5908030	6108030	harbor2	chr20	5998199	5998460	LTR/ERVL	1045	+	130	5998329	90299
chr20	5908030	6108030	harbor2	chr20	5998502	5998720	LTR/ERVL	784	+	109	5998611	90581
chr20	50413348	50613348	harbor2	chr20	50431312	50431750	LTR/ERVL	1632	+	219	50431531	18183
chr20	50413348	50613348	harbor2	chr20	50482541	50482952	LTR/ERVL	2472	+	206	50482747	69399
chr20	21820205	22020205	harbor2	chr20	21821816	21822116	LTR/ERVL	738	+	150	21821966	1761
chr20	21820205	22020205	harbor2	chr20	21840250	21840531	LTR/ERVL	588	+	140	21840390	20185
chr20	21820205	22020205	harbor2	chr20	21896294	21896586	LTR/ERVL	862	+	146	21896440	76235
chr20	21820205	22020205	harbor2	chr20	21904768	21905019	LTR/ERVL	597	+	126	21904894	84689
chr20	21820205	22020205	harbor2	chr20	21909481	21909820	LTR/ERVL	1093	+	170	21909651	89446
chr20	62159612	62359612	harbor2	chr20	62223038	62224270	LTR/ERVL	1343	+	616	62223654	64042
chr20	61604459	61804459	harbor2	chr20	61614047	61614731	LTR/ERVL	917	+	342	61614389	9930
chr20	63591101	63791101	harbor2	chr20	63633757	63634116	LTR/ERVL	1072	+	180	63633937	42836
chr20	63591101	63791101	harbor2	chr20	63663061	63663280	LTR/ERVL	653	+	110	63663171	72070
chr20	50272882	50472882	harbor2	chr20	50275930	50276139	LTR/ERVL	618	+	104	50276034	3152
chr20	50272882	50472882	harbor2	chr20	50302406	50302917	LTR/ERVL	1427	+	256	50302662	29780
chr20	63472919	63672919	harbor2	chr20	63504284	63504390	LTR/ERVL	468	+	53	63504337	31418
chr20	4071981	4271981	harbor2	chr20	4076742	4077165	LTR/ERVL	2876	+	212	4076954	4973
chr20	4071981	4271981	harbor2	chr20	4093152	4093665	LTR/ERVL	2964	+	256	4093408	21427
chr20	4071981	4271981	harbor2	chr20	4107139	4107303	LTR/ERVL	600	+	82	4107221	35240
chr20	4071981	4271981	harbor2	chr20	4110830	4111279	LTR/ERVL	1105	+	224	4111054	39073
chr20	4071981	4271981	harbor2	chr20	4140978	4141214	LTR/ERVL	658	+	118	4141096	69115
chr20	4071981	4271981	harbor2	chr20	4143748	4144171	LTR/ERVL	1344	+	212	4143960	71979
chr20	4071981	4271981	harbor2	chr20	4144549	4144804	LTR/ERVL	1779	+	128	4144677	72696
chr20	4071981	4271981	harbor2	chr20	4145115	4145241	LTR/ERVL	1779	+	63	4145178	73197
chr20	59110854	59310854	harbor2	chr20	59186096	59186281	LTR/ERVL	819	+	92	59186188	75334
chr20	5092121	5292121	harbor2	chr20	5124689	5124881	LTR/ERVL	574	+	96	5124785	32664
chr20	5092121	5292121	harbor2	chr20	5140957	5141929	LTR/ERVL	2630	+	486	5141443	49322
chr20	63471523	63671523	harbor2	chr20	63504284	63504390	LTR/ERVL	468	+	53	63504337	32814
chr20	62138481	62338481	harbor2	chr20	62223038	62224270	LTR/ERVL	1343	+	616	62223654	85173
chr20	63366366	63566366	harbor2	chr20	63450733	63450859	LTR/ERVL	515	+	63	63450796	84430
chr20	63366366	63566366	harbor2	chr20	63451166	63451248	LTR/ERVL	515	+	41	63451207	84841
chr20	63366366	63566366	harbor2	chr20	63451296	63451570	LTR/ERVL	912	+	137	63451433	85067
chr20	62030147	62230147	harbor2	chr20	62072970	62073517	LTR/ERVL	1969	+	274	62073244	43097
chr20	62030147	62230147	harbor2	chr20	62073537	62074083	LTR/ERVL	4047	+	273	62073810	43663
chr20	62030147	62230147	harbor2	chr20	62083599	62083905	LTR/ERVL	967	+	153	62083752	53605
chr20	62030147	62230147	harbor2	chr20	62113011	62113165	LTR/ERVL	496	+	77	62113088	82941
chr20	62030147	62230147	harbor2	chr20	62113996	62114043	LTR/ERVL	528	+	24	62114020	83873
chr20	62030147	62230147	harbor2	chr20	62114964	62115343	LTR/ERVL	528	+	190	62115154	85007
chr20	38707041	38907041	harbor2	chr20	38733716	38733954	LTR/ERVL	506	+	119	38733835	26794
chr20	1021009	1221009	harbor2	chr20	1109101	1109488	LTR/ERVL	756	+	194	1109295	88286
chr20	1021009	1221009	harbor2	chr20	1109865	1110271	LTR/ERVL	861	+	203	1110068	89059
chr20	1021009	1221009	harbor2	chr20	1114185	1114427	LTR/ERVL	987	+	121	1114306	93297
chr20	34993730	35193730	harbor2	chr20	35040171	35040598	LTR/ERVL	2038	+	214	35040385	46655
chr20	62027610	62227610	harbor2	chr20	62072970	62073517	LTR/ERVL	1969	+	274	62073244	45634
chr20	62027610	62227610	harbor2	chr20	62073537	62074083	LTR/ERVL	4047	+	273	62073810	46200
chr20	62027610	62227610	harbor2	chr20	62083599	62083905	LTR/ERVL	967	+	153	62083752	56142
chr20	62027610	62227610	harbor2	chr20	62113011	62113165	LTR/ERVL	496	+	77	62113088	85478
chr20	62027610	62227610	harbor2	chr20	62113996	62114043	LTR/ERVL	528	+	24	62114020	86410
chr20	62027610	62227610	harbor2	chr20	62114964	62115343	LTR/ERVL	528	+	190	62115154	87544
chr20	50272735	50472735	harbor2	chr20	50275930	50276139	LTR/ERVL	618	+	104	50276034	3299
chr20	50272735	50472735	harbor2	chr20	50302406	50302917	LTR/ERVL	1427	+	256	50302662	29927
chr21	29233865	29433865	harbor2	chr21	29284765	29285221	LTR/ERVL	1130	+	228	29284993	51128
chr21	44624082	44824082	harbor2	chr21	44652727	44652874	LTR/ERVL	723	+	74	44652801	28719
chr21	44624082	44824082	harbor2	chr21	44720858	44721216	LTR/ERVL	2181	+	179	44721037	96955
chr21	44624082	44824082	harbor2	chr21	44678869	44679282	LTR/ERVL	2560	+	206	44679075	54993
chr21	14338484	14538484	harbor2	chr21	14377531	14378072	LTR/ERVL	1988	+	270	14377801	39317
chr21	33073262	33273262	harbor2	chr21	33146477	33146880	LTR/ERVL	1119	+	202	33146679	73417
chr21	14484895	14684895	harbor2	chr21	14513938	14514334	LTR/ERVL	1230	+	198	14514136	29241
chr21	29199648	29399648	harbor2	chr21	29284765	29285221	LTR/ERVL	1130	+	228	29284993	85345
chr21	29486560	29686560	harbor2	chr21	29512822	29513376	LTR/ERVL	1843	+	277	29513099	26539
chr21	29486560	29686560	harbor2	chr21	29525557	29525719	LTR/ERVL	598	+	81	29525638	39078
chr21	29486560	29686560	harbor2	chr21	29528426	29528622	LTR/ERVL	598	+	98	29528524	41964
chr21	29486560	29686560	harbor2	chr21	29569843	29570222	LTR/ERVL	1009	+	190	29570033	83473
chr21	29486560	29686560	harbor2	chr21	29570517	29570597	LTR/ERVL	1009	+	40	29570557	83997
chr21	29486560	29686560	harbor2	chr21	29585373	29585592	LTR/ERVL	848	+	110	29585483	98923
chr21	39044046	39244046	harbor2	chr21	39058286	39058388	LTR/ERVL	669	+	51	39058337	14291
chr21	39044046	39244046	harbor2	chr21	39116344	39116743	LTR/ERVL	2079	+	200	39116544	72498
chr21	5028556	5228556	harbor2	chr21	5122101	5122298	LTR/ERVL	658	+	98	5122199	93643
chr21	5028556	5228556	harbor2	chr21	5122305	5122609	LTR/ERVL	1084	+	152	5122457	93901
chr21	14344309	14544309	harbor2	chr21	14377531	14378072	LTR/ERVL	1988	+	270	14377801	33492
chr21	15191535	15391535	harbor2	chr21	15231926	15232149	LTR/ERVL	507	+	112	15232038	40503
chr21	15191535	15391535	harbor2	chr21	15249583	15250170	LTR/ERVL	715	+	294	15249877	58342
chr21	15191535	15391535	harbor2	chr21	15288289	15288747	LTR/ERVL	2128	+	229	15288518	96983
chr21	14338970	14538970	harbor2	chr21	14377531	14378072	LTR/ERVL	1988	+	270	14377801	38831
chr21	29219635	29419635	harbor2	chr21	29284765	29285221	LTR/ERVL	1130	+	228	29284993	65358
chr21	46358911	46558911	harbor2	chr21	46450898	46451173	LTR/ERVL	789	+	138	46451036	92125
chr21	46358911	46558911	harbor2	chr21	46451459	46451621	LTR/ERVL	789	+	81	46451540	92629
chr21	14337764	14537764	harbor2	chr21	14377531	14378072	LTR/ERVL	1988	+	270	14377801	40037
chr21	39010819	39210819	harbor2	chr21	39043229	39043261	LTR/ERVL	1446	+	16	39043245	32426
chr21	39010819	39210819	harbor2	chr21	39058286	39058388	LTR/ERVL	669	+	51	39058337	47518
chr21	39010819	39210819	harbor2	chr21	39042772	39043183	LTR/ERVL	1446	+	206	39042978	32159
chr21	44717549	44917549	harbor2	chr21	44720858	44721216	LTR/ERVL	2181	+	179	44721037	3488
chr21	44717549	44917549	harbor2	chr21	44767842	44768336	LTR/ERVL	1280	+	247	44768089	50540
chr21	14339047	14539047	harbor2	chr21	14377531	14378072	LTR/ERVL	1988	+	270	14377801	38754
chr21	42276934	42476934	harbor2	chr21	42356549	42356618	LTR/ERVL	2008	+	34	42356583	79649
chr21	42276934	42476934	harbor2	chr21	42356619	42357127	LTR/ERVL	2687	+	254	42356873	79939
chr21	42276934	42476934	harbor2	chr21	42357128	42357529	LTR/ERVL	2008	+	200	42357328	80394
chr21	42154556	42354556	harbor2	chr21	42155679	42155872	LTR/ERVL	726	+	96	42155775	1219
chr21	46358915	46558915	harbor2	chr21	46450898	46451173	LTR/ERVL	789	+	138	46451036	92121
chr21	46358915	46558915	harbor2	chr21	46451459	46451621	LTR/ERVL	789	+	81	46451540	92625
chr21	29200088	29400088	harbor2	chr21	29284765	29285221	LTR/ERVL	1130	+	228	29284993	84905
chr21	39009540	39209540	harbor2	chr21	39043229	39043261	LTR/ERVL	1446	+	16	39043245	33705
chr21	39009540	39209540	harbor2	chr21	39058286	39058388	LTR/ERVL	669	+	51	39058337	48797
chr21	39009540	39209540	harbor2	chr21	39042772	39043183	LTR/ERVL	1446	+	206	39042978	33438
chr21	36057503	36257503	harbor2	chr21	36095730	36095909	LTR/ERVL	507	+	90	36095820	38317
chr21	46537399	46737399	harbor2	chr21	46607219	46607590	LTR/ERVL	992	+	186	46607405	70006
chr21	46537399	46737399	harbor2	chr21	46607826	46608051	LTR/ERVL	2078	+	112	46607938	70539
chr21	46537399	46737399	harbor2	chr21	46608603	46609198	LTR/ERVL	2078	+	298	46608901	71502
chr21	46537399	46737399	harbor2	chr21	46609230	46610032	LTR/ERVL	2801	+	401	46609631	72232
chr21	46537399	46737399	harbor2	chr21	46610033	46610311	LTR/ERVL	851	+	139	46610172	72773
chr21	46537399	46737399	harbor2	chr21	46610872	46611133	LTR/ERVL	1142	+	130	46611002	73603
chr21	46537399	46737399	harbor2	chr21	46628756	46629114	LTR/ERVL	610	+	179	46628935	91536
chr21	14337790	14537790	harbor2	chr21	14377531	14378072	LTR/ERVL	1988	+	270	14377801	40011
chr21	42468253	42668253	harbor2	chr21	42490627	42491388	LTR/ERVL	2067	+	380	42491007	22754
chr21	42468253	42668253	harbor2	chr21	42524753	42525562	LTR/ERVL	2916	+	404	42525157	56904
chr21	46083095	46283095	harbor2	chr21	46159249	46159813	LTR/ERVL	1138	+	282	46159531	76436
chr21	14338290	14538290	harbor2	chr21	14377531	14378072	LTR/ERVL	1988	+	270	14377801	39511
chr21	46225203	46425203	harbor2	chr21	46320538	46320992	LTR/ERVL	1353	+	227	46320765	95562
chr22	42989451	43189451	harbor2	chr22	43030272	43030719	LTR/ERVL	1679	+	224	43030496	41045
chr22	42989451	43189451	harbor2	chr22	43060196	43060467	LTR/ERVL	498	+	136	43060332	70881
chr22	50581425	50781425	harbor2	chr22	50583743	50584084	LTR/ERVL	1197	+	170	50583913	2488
chr22	50581425	50781425	harbor2	chr22	50584690	50585464	LTR/ERVL	1197	+	387	50585077	3652
chr22	50581425	50781425	harbor2	chr22	50585508	50586147	LTR/ERVL	1078	+	320	50585828	4403
chr22	50581425	50781425	harbor2	chr22	50586209	50586470	LTR/ERVL	664	+	130	50586339	4914
chr22	50581425	50781425	harbor2	chr22	50586558	50587782	LTR/ERVL	1501	+	612	50587170	5745
chr22	50581425	50781425	harbor2	chr22	50656555	50656811	LTR/ERVL	793	+	128	50656683	75258
chr22	50581425	50781425	harbor2	chr22	50657097	50657223	LTR/ERVL	793	+	63	50657160	75735
chr22	50581425	50781425	harbor2	chr22	50657809	50658054	LTR/ERVL	492	+	122	50657931	76506
chr22	22590069	22790069	harbor2	chr22	22620913	22621361	LTR/ERVL	2665	+	224	22621137	31068
chr22	42989456	43189456	harbor2	chr22	43030272	43030719	LTR/ERVL	1679	+	224	43030496	41040
chr22	42989456	43189456	harbor2	chr22	43060196	43060467	LTR/ERVL	498	+	136	43060332	70876
chr22	42989457	43189457	harbor2	chr22	43030272	43030719	LTR/ERVL	1679	+	224	43030496	41039
chr22	42989457	43189457	harbor2	chr22	43060196	43060467	LTR/ERVL	498	+	136	43060332	70875
chr22	43477459	43677459	harbor2	chr22	43512918	43513446	LTR/ERVL	947	+	264	43513182	35723
chr22	50061646	50261646	harbor2	chr22	50078809	50078968	LTR/ERVL	665	+	80	50078889	17243
chr22	42989737	43189737	harbor2	chr22	43030272	43030719	LTR/ERVL	1679	+	224	43030496	40759
chr22	42989737	43189737	harbor2	chr22	43060196	43060467	LTR/ERVL	498	+	136	43060332	70595
chr22	32078363	32278363	harbor2	chr22	32115707	32116277	LTR/ERVL	1921	+	285	32115992	37629
chr22	32078363	32278363	harbor2	chr22	32116610	32116894	LTR/ERVL	1607	+	142	32116752	38389
chr22	44398337	44598337	harbor2	chr22	44434480	44435300	LTR/ERVL	4641	+	410	44434890	36553
chr22	23023478	23223478	harbor2	chr22	23026084	23026412	LTR/ERVL	5220	+	164	23026248	2770
chr22	23023478	23223478	harbor2	chr22	23027289	23027892	LTR/ERVL	5220	+	302	23027591	4113
chr22	23023478	23223478	harbor2	chr22	23029349	23029819	LTR/ERVL	5220	+	235	23029584	6106
chr22	49692745	49892745	harbor2	chr22	49726916	49727122	LTR/ERVL	565	+	103	49727019	34274
chr22	49692745	49892745	harbor2	chr22	49725347	49725618	LTR/ERVL	720	+	136	49725483	32738
chr22	49664584	49864584	harbor2	chr22	49726916	49727122	LTR/ERVL	565	+	103	49727019	62435
chr22	49664584	49864584	harbor2	chr22	49725347	49725618	LTR/ERVL	720	+	136	49725483	60899
chr22	42989453	43189453	harbor2	chr22	43030272	43030719	LTR/ERVL	1679	+	224	43030496	41043
chr22	42989453	43189453	harbor2	chr22	43060196	43060467	LTR/ERVL	498	+	136	43060332	70879
chr22	23023459	23223459	harbor2	chr22	23026084	23026412	LTR/ERVL	5220	+	164	23026248	2789
chr22	23023459	23223459	harbor2	chr22	23027289	23027892	LTR/ERVL	5220	+	302	23027591	4132
chr22	23023459	23223459	harbor2	chr22	23029349	23029819	LTR/ERVL	5220	+	235	23029584	6125
chr22	36186701	36386701	harbor2	chr22	36187778	36188078	LTR/ERVL	840	+	150	36187928	1227
chr22	36186701	36386701	harbor2	chr22	36192608	36192816	LTR/ERVL	522	+	104	36192712	6011
chr22	36186701	36386701	harbor2	chr22	36193375	36193650	LTR/ERVL	1188	+	138	36193513	6812
chr22	36186701	36386701	harbor2	chr22	36220385	36220973	LTR/ERVL	2157	+	294	36220679	33978
chr22	36186701	36386701	harbor2	chr22	36223722	36224154	LTR/ERVL	453	+	216	36223938	37237
chr22	36186701	36386701	harbor2	chr22	36224603	36224855	LTR/ERVL	545	+	126	36224729	38028
chr22	36186701	36386701	harbor2	chr22	36228665	36228966	LTR/ERVL	646	+	150	36228815	42114
chr22	36186701	36386701	harbor2	chr22	36229433	36229719	LTR/ERVL	1234	+	143	36229576	42875
chr22	36186701	36386701	harbor2	chr22	36248161	36248356	LTR/ERVL	543	+	98	36248259	61558
chr22	36186701	36386701	harbor2	chr22	36248385	36248801	LTR/ERVL	1139	+	208	36248593	61892
chr22	36186701	36386701	harbor2	chr22	36267213	36267606	LTR/ERVL	2406	+	196	36267409	80708
chr22	42989431	43189431	harbor2	chr22	43030272	43030719	LTR/ERVL	1679	+	224	43030496	41065
chr22	42989431	43189431	harbor2	chr22	43060196	43060467	LTR/ERVL	498	+	136	43060332	70901
chr22	30998853	31198853	harbor2	chr22	31049103	31049451	LTR/ERVL	1050	+	174	31049277	50424
chr22	42989458	43189458	harbor2	chr22	43030272	43030719	LTR/ERVL	1679	+	224	43030496	41038
chr22	42989458	43189458	harbor2	chr22	43060196	43060467	LTR/ERVL	498	+	136	43060332	70874
chr22	23668508	23868508	harbor2	chr22	23755895	23756010	LTR/ERVL	1530	+	58	23755953	87445
chr22	23668508	23868508	harbor2	chr22	23756308	23756320	LTR/ERVL	1530	+	6	23756314	87806
chr22	23668508	23868508	harbor2	chr22	23756928	23757251	LTR/ERVL	1530	+	162	23757090	88582
chr22	23668508	23868508	harbor2	chr22	23757587	23757620	LTR/ERVL	1530	+	16	23757603	89095
chr22	49199648	49399648	harbor2	chr22	49239818	49239980	LTR/ERVL	646	+	81	49239899	40251
chr22	49199648	49399648	harbor2	chr22	49254027	49254415	LTR/ERVL	1001	+	194	49254221	54573
chr22	23024071	23224071	harbor2	chr22	23026084	23026412	LTR/ERVL	5220	+	164	23026248	2177
chr22	23024071	23224071	harbor2	chr22	23027289	23027892	LTR/ERVL	5220	+	302	23027591	3520
chr22	23024071	23224071	harbor2	chr22	23029349	23029819	LTR/ERVL	5220	+	235	23029584	5513
chr22	43480672	43680672	harbor2	chr22	43512918	43513446	LTR/ERVL	947	+	264	43513182	32510
chr22	36919222	37119222	harbor2	chr22	36981653	36981754	LTR/ERVL	579	+	50	36981703	62481
chr22	36919222	37119222	harbor2	chr22	36982088	36982223	LTR/ERVL	579	+	68	36982156	62934
chr22	36919213	37119213	harbor2	chr22	36981653	36981754	LTR/ERVL	579	+	50	36981703	62490
chr22	36919213	37119213	harbor2	chr22	36982088	36982223	LTR/ERVL	579	+	68	36982156	62943
chr22	42989450	43189450	harbor2	chr22	43030272	43030719	LTR/ERVL	1679	+	224	43030496	41046
chr22	42989450	43189450	harbor2	chr22	43060196	43060467	LTR/ERVL	498	+	136	43060332	70882
chr22	36186697	36386697	harbor2	chr22	36187778	36188078	LTR/ERVL	840	+	150	36187928	1231
chr22	36186697	36386697	harbor2	chr22	36192608	36192816	LTR/ERVL	522	+	104	36192712	6015
chr22	36186697	36386697	harbor2	chr22	36193375	36193650	LTR/ERVL	1188	+	138	36193513	6816
chr22	36186697	36386697	harbor2	chr22	36220385	36220973	LTR/ERVL	2157	+	294	36220679	33982
chr22	36186697	36386697	harbor2	chr22	36223722	36224154	LTR/ERVL	453	+	216	36223938	37241
chr22	36186697	36386697	harbor2	chr22	36224603	36224855	LTR/ERVL	545	+	126	36224729	38032
chr22	36186697	36386697	harbor2	chr22	36228665	36228966	LTR/ERVL	646	+	150	36228815	42118
chr22	36186697	36386697	harbor2	chr22	36229433	36229719	LTR/ERVL	1234	+	143	36229576	42879
chr22	36186697	36386697	harbor2	chr22	36248161	36248356	LTR/ERVL	543	+	98	36248259	61562
chr22	36186697	36386697	harbor2	chr22	36248385	36248801	LTR/ERVL	1139	+	208	36248593	61896
chr22	36186697	36386697	harbor2	chr22	36267213	36267606	LTR/ERVL	2406	+	196	36267409	80712
chr22	46387837	46587837	harbor2	chr22	46442191	46442577	LTR/ERVL	586	+	193	46442384	54547
chr22	36186696	36386696	harbor2	chr22	36187778	36188078	LTR/ERVL	840	+	150	36187928	1232
chr22	36186696	36386696	harbor2	chr22	36192608	36192816	LTR/ERVL	522	+	104	36192712	6016
chr22	36186696	36386696	harbor2	chr22	36193375	36193650	LTR/ERVL	1188	+	138	36193513	6817
chr22	36186696	36386696	harbor2	chr22	36220385	36220973	LTR/ERVL	2157	+	294	36220679	33983
chr22	36186696	36386696	harbor2	chr22	36223722	36224154	LTR/ERVL	453	+	216	36223938	37242
chr22	36186696	36386696	harbor2	chr22	36224603	36224855	LTR/ERVL	545	+	126	36224729	38033
chr22	36186696	36386696	harbor2	chr22	36228665	36228966	LTR/ERVL	646	+	150	36228815	42119
chr22	36186696	36386696	harbor2	chr22	36229433	36229719	LTR/ERVL	1234	+	143	36229576	42880
chr22	36186696	36386696	harbor2	chr22	36248161	36248356	LTR/ERVL	543	+	98	36248259	61563
chr22	36186696	36386696	harbor2	chr22	36248385	36248801	LTR/ERVL	1139	+	208	36248593	61897
chr22	36186696	36386696	harbor2	chr22	36267213	36267606	LTR/ERVL	2406	+	196	36267409	80713
chr22	36186702	36386702	harbor2	chr22	36187778	36188078	LTR/ERVL	840	+	150	36187928	1226
chr22	36186702	36386702	harbor2	chr22	36192608	36192816	LTR/ERVL	522	+	104	36192712	6010
chr22	36186702	36386702	harbor2	chr22	36193375	36193650	LTR/ERVL	1188	+	138	36193513	6811
chr22	36186702	36386702	harbor2	chr22	36220385	36220973	LTR/ERVL	2157	+	294	36220679	33977
chr22	36186702	36386702	harbor2	chr22	36223722	36224154	LTR/ERVL	453	+	216	36223938	37236
chr22	36186702	36386702	harbor2	chr22	36224603	36224855	LTR/ERVL	545	+	126	36224729	38027
chr22	36186702	36386702	harbor2	chr22	36228665	36228966	LTR/ERVL	646	+	150	36228815	42113
chr22	36186702	36386702	harbor2	chr22	36229433	36229719	LTR/ERVL	1234	+	143	36229576	42874
chr22	36186702	36386702	harbor2	chr22	36248161	36248356	LTR/ERVL	543	+	98	36248259	61557
chr22	36186702	36386702	harbor2	chr22	36248385	36248801	LTR/ERVL	1139	+	208	36248593	61891
chr22	36186702	36386702	harbor2	chr22	36267213	36267606	LTR/ERVL	2406	+	196	36267409	80707
chr22	36186690	36386690	harbor2	chr22	36187778	36188078	LTR/ERVL	840	+	150	36187928	1238
chr22	36186690	36386690	harbor2	chr22	36192608	36192816	LTR/ERVL	522	+	104	36192712	6022
chr22	36186690	36386690	harbor2	chr22	36193375	36193650	LTR/ERVL	1188	+	138	36193513	6823
chr22	36186690	36386690	harbor2	chr22	36220385	36220973	LTR/ERVL	2157	+	294	36220679	33989
chr22	36186690	36386690	harbor2	chr22	36223722	36224154	LTR/ERVL	453	+	216	36223938	37248
chr22	36186690	36386690	harbor2	chr22	36224603	36224855	LTR/ERVL	545	+	126	36224729	38039
chr22	36186690	36386690	harbor2	chr22	36228665	36228966	LTR/ERVL	646	+	150	36228815	42125
chr22	36186690	36386690	harbor2	chr22	36229433	36229719	LTR/ERVL	1234	+	143	36229576	42886
chr22	36186690	36386690	harbor2	chr22	36248161	36248356	LTR/ERVL	543	+	98	36248259	61569
chr22	36186690	36386690	harbor2	chr22	36248385	36248801	LTR/ERVL	1139	+	208	36248593	61903
chr22	36186690	36386690	harbor2	chr22	36267213	36267606	LTR/ERVL	2406	+	196	36267409	80719
chrX	49762718	49962718	harbor2	chrX	49784848	49785067	LTR/ERVL	991	+	110	49784958	22240
chrX	49762718	49962718	harbor2	chrX	49785041	49785579	LTR/ERVL	2152	+	269	49785310	22592
chrX	109965478	110165478	harbor2	chrX	109967912	109968323	LTR/ERVL	1739	+	206	109968118	2640
chrX	49066465	49266465	harbor2	chrX	49139062	49139364	LTR/ERVL	2025	+	151	49139213	72748
chrX	49066465	49266465	harbor2	chrX	49139454	49139562	LTR/ERVL	573	+	54	49139508	73043
chrX	41234593	41434593	harbor2	chrX	41264448	41264653	LTR/ERVL	3387	+	102	41264550	29957
chrX	41234593	41434593	harbor2	chrX	41264943	41265286	LTR/ERVL	3387	+	172	41265115	30522
chrX	41234593	41434593	harbor2	chrX	41298354	41298801	LTR/ERVL	994	+	224	41298578	63985
chrX	41234593	41434593	harbor2	chrX	41300792	41301192	LTR/ERVL	1717	+	200	41300992	66399
chrX	41234593	41434593	harbor2	chrX	41302333	41302710	LTR/ERVL	732	+	188	41302521	67928
chrX	48805353	49005353	harbor2	chrX	48863941	48864111	LTR/ERVL	780	+	85	48864026	58673
chrX	20396267	20596267	harbor2	chrX	20397548	20397934	LTR/ERVL	1868	+	193	20397741	1474
chrX	20396267	20596267	harbor2	chrX	20400744	20401545	LTR/ERVL	2985	+	400	20401144	4877
chrX	20396267	20596267	harbor2	chrX	20406153	20406622	LTR/ERVL	1087	+	234	20406387	10120
chrX	20396267	20596267	harbor2	chrX	20440173	20440523	LTR/ERVL	1021	+	175	20440348	44081
chrX	20396267	20596267	harbor2	chrX	20478192	20478655	LTR/ERVL	717	+	232	20478424	82157
chrX	20396267	20596267	harbor2	chrX	20490322	20490504	LTR/ERVL	716	+	91	20490413	94146
chrX	20396267	20596267	harbor2	chrX	20491251	20491396	LTR/ERVL	757	+	72	20491323	95056
chrX	20396267	20596267	harbor2	chrX	20397968	20398182	LTR/ERVL	1868	+	107	20398075	1808
chrX	20396267	20596267	harbor2	chrX	20463597	20463883	LTR/ERVL	691	+	143	20463740	67473
chrX	16520297	16720297	harbor2	chrX	16558089	16558321	LTR/ERVL	709	+	116	16558205	37908
chrX	16520297	16720297	harbor2	chrX	16604971	16605439	LTR/ERVL	2166	+	234	16605205	84908
chrX	16520297	16720297	harbor2	chrX	16605743	16605825	LTR/ERVL	2166	+	41	16605784	85487
