H_chr	H_start	H_end	Harbor	TE_chr	TE_start	TE_end	TE	score	TE_strand	TE_half	TE_middle_pos	TE_dis
chr1	16545136	16745136	harbor1	chr1	16560670	16560870	LTR/ERVL	779	+	100	16560770	15634
chr1	16543138	16743138	harbor1	chr1	16560670	16560870	LTR/ERVL	779	+	100	16560770	17632
chr1	3525011	3725011	harbor1	chr1	3587046	3587733	LTR/ERVL	3477	+	344	3587390	62379
chr1	3525011	3725011	harbor1	chr1	3623418	3623573	LTR/ERVL	517	+	78	3623496	98485
chr1	63219176	63419176	harbor1	chr1	63237660	63237843	LTR/ERVL	938	+	92	63237752	18576
chr1	63219176	63419176	harbor1	chr1	63237926	63238043	LTR/ERVL	932	+	58	63237984	18808
chr1	63219176	63419176	harbor1	chr1	63238367	63238429	LTR/ERVL	932	+	31	63238398	19222
chr1	21742123	21942123	harbor1	chr1	21754485	21755157	LTR/ERVL	1153	+	336	21754821	12698
chr1	16542741	16742741	harbor1	chr1	16560670	16560870	LTR/ERVL	779	+	100	16560770	18029
chr1	16544784	16744784	harbor1	chr1	16560670	16560870	LTR/ERVL	779	+	100	16560770	15986
chr1	15942113	16142113	harbor1	chr1	15982176	15982247	LTR/ERVL	597	+	36	15982212	40099
chr1	15942113	16142113	harbor1	chr1	15982540	15982680	LTR/ERVL	597	+	70	15982610	40497
chr1	15942113	16142113	harbor1	chr1	15982682	15983526	LTR/ERVL	1169	+	422	15983104	40991
chr1	15942113	16142113	harbor1	chr1	16038550	16038766	LTR/ERVL	691	+	108	16038658	96545
chr1	15942113	16142113	harbor1	chr1	16039077	16039305	LTR/ERVL	691	+	114	16039191	97078
chr1	2375365	2575365	harbor1	chr1	2383092	2383334	LTR/ERVL	518	+	121	2383213	7848
chr1	89721500	89921500	harbor1	chr1	89728850	89729141	LTR/ERVL	487	+	146	89728996	7496
chr1	89721500	89921500	harbor1	chr1	89730971	89731379	LTR/ERVL	2221	+	204	89731175	9675
chr1	89721500	89921500	harbor1	chr1	89742627	89742764	LTR/ERVL	708	+	68	89742695	21195
chr1	16544947	16744947	harbor1	chr1	16560670	16560870	LTR/ERVL	779	+	100	16560770	15823
chr1	16526616	16726616	harbor1	chr1	16560670	16560870	LTR/ERVL	779	+	100	16560770	34154
chr1	16544872	16744872	harbor1	chr1	16560670	16560870	LTR/ERVL	779	+	100	16560770	15898
chr1	16544810	16744810	harbor1	chr1	16560670	16560870	LTR/ERVL	779	+	100	16560770	15960
chr1	16544790	16744790	harbor1	chr1	16560670	16560870	LTR/ERVL	779	+	100	16560770	15980
chr1	227441496	227641496	harbor1	chr1	227444112	227445179	LTR/ERVL	7121	+	534	227444646	3150
chr1	227441496	227641496	harbor1	chr1	227445180	227445567	LTR/ERVL	1998	+	194	227445374	3878
chr1	227441496	227641496	harbor1	chr1	227445872	227445934	LTR/ERVL	1998	+	31	227445903	4407
chr1	227441496	227641496	harbor1	chr1	227453765	227454144	LTR/ERVL	659	+	190	227453955	12459
chr1	16526581	16726581	harbor1	chr1	16560670	16560870	LTR/ERVL	779	+	100	16560770	34189
chr1	77131620	77331620	harbor1	chr1	77182626	77182703	LTR/ERVL	603	+	38	77182664	51044
chr1	77131620	77331620	harbor1	chr1	77188857	77189318	LTR/ERVL	42361	+	230	77189087	57467
chr1	77131620	77331620	harbor1	chr1	77189319	77189694	LTR/ERVL	2778	+	188	77189507	57887
chr1	77131620	77331620	harbor1	chr1	77189750	77189846	LTR/ERVL	2778	+	48	77189798	58178
chr1	77131620	77331620	harbor1	chr1	77182764	77187777	LTR/ERVL	42361	+	2506	77185270	53650
chr1	16544755	16744755	harbor1	chr1	16560670	16560870	LTR/ERVL	779	+	100	16560770	16015
chr1	16544809	16744809	harbor1	chr1	16560670	16560870	LTR/ERVL	779	+	100	16560770	15961
chr1	53846279	54046279	harbor1	chr1	53890504	53890997	LTR/ERVL	1036	+	246	53890750	44471
chr1	53846279	54046279	harbor1	chr1	53891310	53891620	LTR/ERVL	508	+	155	53891465	45186
chr1	53846279	54046279	harbor1	chr1	53891764	53892293	LTR/ERVL	1258	+	264	53892028	45749
chr1	53846279	54046279	harbor1	chr1	53912961	53913417	LTR/ERVL	2123	+	228	53913189	66910
chr1	53846279	54046279	harbor1	chr1	53929028	53929505	LTR/ERVL	1177	+	238	53929266	82987
chr1	26400749	26600749	harbor1	chr1	26496945	26497334	LTR/ERVL	993	+	194	26497139	96390
chr1	16538570	16738570	harbor1	chr1	16560670	16560870	LTR/ERVL	779	+	100	16560770	22200
chr1	16543109	16743109	harbor1	chr1	16560670	16560870	LTR/ERVL	779	+	100	16560770	17661
chr1	244605525	244805525	harbor1	chr1	244644512	244644942	LTR/ERVL	1120	+	215	244644727	39202
chr1	244605525	244805525	harbor1	chr1	244644953	244645618	LTR/ERVL	1325	+	332	244645285	39760
chr1	244605525	244805525	harbor1	chr1	244647978	244648381	LTR/ERVL	590	+	202	244648180	42655
chr1	244605525	244805525	harbor1	chr1	244665526	244665854	LTR/ERVL	1793	+	164	244665690	60165
chr1	244605525	244805525	harbor1	chr1	244696661	244697204	LTR/ERVL	3037	+	272	244696933	91408
chr1	244605525	244805525	harbor1	chr1	244697207	244697225	LTR/ERVL	10237	+	9	244697216	91691
chr1	244605525	244805525	harbor1	chr1	244697494	244699301	LTR/ERVL	10237	+	904	244698398	92873
chr1	244605525	244805525	harbor1	chr1	244699609	244700085	LTR/ERVL	10237	+	238	244699847	94322
chr1	244605525	244805525	harbor1	chr1	244700086	244700259	LTR/ERVL	731	+	86	244700172	94647
chr1	244605525	244805525	harbor1	chr1	244645678	244646518	LTR/ERVL	2943	+	420	244646098	40573
chr1	4738326	4938326	harbor1	chr1	4762231	4762751	LTR/ERVL	1506	+	260	4762491	24165
chr1	4738326	4938326	harbor1	chr1	4763477	4763710	LTR/ERVL	1231	+	116	4763593	25267
chr1	4738326	4938326	harbor1	chr1	4763941	4764223	LTR/ERVL	1062	+	141	4764082	25756
chr1	4738326	4938326	harbor1	chr1	4800884	4801176	LTR/ERVL	468	+	146	4801030	62704
chr1	4738326	4938326	harbor1	chr1	4817228	4817770	LTR/ERVL	1972	+	271	4817499	79173
chr1	5561024	5761024	harbor1	chr1	5587413	5587800	LTR/ERVL	682	+	194	5587607	26583
chr1	5561024	5761024	harbor1	chr1	5647223	5647756	LTR/ERVL	1854	+	266	5647489	86465
chr1	5561024	5761024	harbor1	chr1	5586900	5587031	LTR/ERVL	682	+	66	5586966	25942
chr1	6134956	6334956	harbor1	chr1	6200566	6201073	LTR/ERVL	743	+	254	6200820	65864
chr1	227441495	227641495	harbor1	chr1	227444112	227445179	LTR/ERVL	7121	+	534	227444646	3151
chr1	227441495	227641495	harbor1	chr1	227445180	227445567	LTR/ERVL	1998	+	194	227445374	3879
chr1	227441495	227641495	harbor1	chr1	227445872	227445934	LTR/ERVL	1998	+	31	227445903	4408
chr1	227441495	227641495	harbor1	chr1	227453765	227454144	LTR/ERVL	659	+	190	227453955	12460
chr1	11520750	11720750	harbor1	chr1	11552225	11552749	LTR/ERVL	2438	+	262	11552487	31737
chr1	11520750	11720750	harbor1	chr1	11555818	11556334	LTR/ERVL	1920	+	258	11556076	35326
chr1	11520750	11720750	harbor1	chr1	11580502	11580771	LTR/ERVL	794	+	134	11580636	59886
chr1	11520750	11720750	harbor1	chr1	11583833	11584086	LTR/ERVL	430	+	126	11583959	63209
chr1	11520750	11720750	harbor1	chr1	11591409	11591860	LTR/ERVL	2731	+	226	11591635	70885
chr1	11520750	11720750	harbor1	chr1	11619256	11619714	LTR/ERVL	2338	+	229	11619485	98735
chr1	11520750	11720750	harbor1	chr1	11620023	11620080	LTR/ERVL	2338	+	28	11620051	99301
chr1	16544792	16744792	harbor1	chr1	16560670	16560870	LTR/ERVL	779	+	100	16560770	15978
chr1	16544920	16744920	harbor1	chr1	16560670	16560870	LTR/ERVL	779	+	100	16560770	15850
chr1	53846229	54046229	harbor1	chr1	53890504	53890997	LTR/ERVL	1036	+	246	53890750	44521
chr1	53846229	54046229	harbor1	chr1	53891310	53891620	LTR/ERVL	508	+	155	53891465	45236
chr1	53846229	54046229	harbor1	chr1	53891764	53892293	LTR/ERVL	1258	+	264	53892028	45799
chr1	53846229	54046229	harbor1	chr1	53912961	53913417	LTR/ERVL	2123	+	228	53913189	66960
chr1	53846229	54046229	harbor1	chr1	53929028	53929505	LTR/ERVL	1177	+	238	53929266	83037
chr1	211033805	211233805	harbor1	chr1	211067248	211067560	LTR/ERVL	791	+	156	211067404	33599
chr1	211033805	211233805	harbor1	chr1	211074301	211074595	LTR/ERVL	1044	+	147	211074448	40643
chr1	211033805	211233805	harbor1	chr1	211074600	211074993	LTR/ERVL	1575	+	196	211074796	40991
chr1	211033805	211233805	harbor1	chr1	211093920	211094076	LTR/ERVL	730	+	78	211093998	60193
chr1	211033805	211233805	harbor1	chr1	211094405	211094497	LTR/ERVL	730	+	46	211094451	60646
chr1	211033805	211233805	harbor1	chr1	211115321	211115701	LTR/ERVL	3316	+	190	211115511	81706
chr1	211033805	211233805	harbor1	chr1	211115732	211115794	LTR/ERVL	3316	+	31	211115763	81958
chr1	2375348	2575348	harbor1	chr1	2383092	2383334	LTR/ERVL	518	+	121	2383213	7865
chr1	2028839	2228839	harbor1	chr1	2040701	2040800	LTR/ERVL	475	+	50	2040751	11912
chr1	16503985	16703985	harbor1	chr1	16560670	16560870	LTR/ERVL	779	+	100	16560770	56785
chr1	155463419	155663419	harbor1	chr1	155471229	155471930	LTR/ERVL	1741	+	350	155471579	8160
chr1	16538366	16738366	harbor1	chr1	16560670	16560870	LTR/ERVL	779	+	100	16560770	22404
chr1	16544780	16744780	harbor1	chr1	16560670	16560870	LTR/ERVL	779	+	100	16560770	15990
chr1	7122266	7322266	harbor1	chr1	7127783	7128361	LTR/ERVL	2475	+	289	7128072	5806
chr1	2375257	2575257	harbor1	chr1	2383092	2383334	LTR/ERVL	518	+	121	2383213	7956
chr1	16544851	16744851	harbor1	chr1	16560670	16560870	LTR/ERVL	779	+	100	16560770	15919
chr1	16544789	16744789	harbor1	chr1	16560670	16560870	LTR/ERVL	779	+	100	16560770	15981
chr1	16544721	16744721	harbor1	chr1	16560670	16560870	LTR/ERVL	779	+	100	16560770	16049
chr1	16544890	16744890	harbor1	chr1	16560670	16560870	LTR/ERVL	779	+	100	16560770	15880
chr1	16545018	16745018	harbor1	chr1	16560670	16560870	LTR/ERVL	779	+	100	16560770	15752
chr1	2987716	3187716	harbor1	chr1	3004196	3004406	LTR/ERVL	459	+	105	3004301	16585
chr1	2987716	3187716	harbor1	chr1	3033129	3033510	LTR/ERVL	636	+	190	3033319	45603
chr1	16544940	16744940	harbor1	chr1	16560670	16560870	LTR/ERVL	779	+	100	16560770	15830
chr1	16520804	16720804	harbor1	chr1	16560670	16560870	LTR/ERVL	779	+	100	16560770	39966
chr1	2374246	2574246	harbor1	chr1	2383092	2383334	LTR/ERVL	518	+	121	2383213	8967
chr1	211032764	211232764	harbor1	chr1	211067248	211067560	LTR/ERVL	791	+	156	211067404	34640
chr1	211032764	211232764	harbor1	chr1	211074301	211074595	LTR/ERVL	1044	+	147	211074448	41684
chr1	211032764	211232764	harbor1	chr1	211074600	211074993	LTR/ERVL	1575	+	196	211074796	42032
chr1	211032764	211232764	harbor1	chr1	211093920	211094076	LTR/ERVL	730	+	78	211093998	61234
chr1	211032764	211232764	harbor1	chr1	211094405	211094497	LTR/ERVL	730	+	46	211094451	61687
chr1	211032764	211232764	harbor1	chr1	211115321	211115701	LTR/ERVL	3316	+	190	211115511	82747
chr1	211032764	211232764	harbor1	chr1	211115732	211115794	LTR/ERVL	3316	+	31	211115763	82999
chr1	227441477	227641477	harbor1	chr1	227444112	227445179	LTR/ERVL	7121	+	534	227444646	3169
chr1	227441477	227641477	harbor1	chr1	227445180	227445567	LTR/ERVL	1998	+	194	227445374	3897
chr1	227441477	227641477	harbor1	chr1	227445872	227445934	LTR/ERVL	1998	+	31	227445903	4426
chr1	227441477	227641477	harbor1	chr1	227453765	227454144	LTR/ERVL	659	+	190	227453955	12478
chr1	3524787	3724787	harbor1	chr1	3587046	3587733	LTR/ERVL	3477	+	344	3587390	62603
chr1	3524787	3724787	harbor1	chr1	3623418	3623573	LTR/ERVL	517	+	78	3623496	98709
chr1	16544926	16744926	harbor1	chr1	16560670	16560870	LTR/ERVL	779	+	100	16560770	15844
chr1	89425139	89625139	harbor1	chr1	89425199	89425766	LTR/ERVL	2044	+	284	89425483	344
chr1	89425139	89625139	harbor1	chr1	89487704	89488124	LTR/ERVL	2686	+	210	89487914	62775
chr1	89425139	89625139	harbor1	chr1	89488368	89488617	LTR/ERVL	1357	+	124	89488492	63353
chr1	89425139	89625139	harbor1	chr1	89498365	89498554	LTR/ERVL	873	+	94	89498459	73320
chr1	153558888	153758888	harbor1	chr1	153653057	153653456	LTR/ERVL	1818	+	200	153653257	94369
chr1	153558888	153758888	harbor1	chr1	153654046	153654299	LTR/ERVL	1818	+	126	153654172	95284
chr1	1300182	1500182	harbor1	chr1	1357233	1357526	LTR/ERVL	1029	+	146	1357379	57197
chr1	1300182	1500182	harbor1	chr1	1357817	1357890	LTR/ERVL	1029	+	36	1357853	57671
chr1	145842666	146042666	harbor1	chr1	145887837	145888532	LTR/ERVL	3996	+	348	145888185	45519
chr1	16504141	16704141	harbor1	chr1	16560670	16560870	LTR/ERVL	779	+	100	16560770	56629
chr1	16545003	16745003	harbor1	chr1	16560670	16560870	LTR/ERVL	779	+	100	16560770	15767
chr1	16542821	16742821	harbor1	chr1	16560670	16560870	LTR/ERVL	779	+	100	16560770	17949
chr1	202827305	203027305	harbor1	chr1	202909741	202910003	LTR/ERVL	710	+	131	202909872	82567
chr1	204585523	204785523	harbor1	chr1	204596576	204596725	LTR/ERVL	483	+	74	204596650	11127
chr1	204585523	204785523	harbor1	chr1	204596855	204597643	LTR/ERVL	2255	+	394	204597249	11726
chr1	205330822	205530822	harbor1	chr1	205400557	205400689	LTR/ERVL	725	+	66	205400623	69801
chr1	205330822	205530822	harbor1	chr1	205406860	205407049	LTR/ERVL	3417	+	94	205406954	76132
chr1	205330822	205530822	harbor1	chr1	205407350	205407951	LTR/ERVL	3417	+	300	205407650	76828
chr1	16544898	16744898	harbor1	chr1	16560670	16560870	LTR/ERVL	779	+	100	16560770	15872
chr1	117480253	117680253	harbor1	chr1	117555713	117556175	LTR/ERVL	1851	+	231	117555944	75691
chr1	16504004	16704004	harbor1	chr1	16560670	16560870	LTR/ERVL	779	+	100	16560770	56766
chr1	16545023	16745023	harbor1	chr1	16560670	16560870	LTR/ERVL	779	+	100	16560770	15747
chr1	2375321	2575321	harbor1	chr1	2383092	2383334	LTR/ERVL	518	+	121	2383213	7892
chr1	16267485	16467485	harbor1	chr1	16342599	16342682	LTR/ERVL	514	+	42	16342641	75156
chr1	16267485	16467485	harbor1	chr1	16343111	16343232	LTR/ERVL	514	+	60	16343171	75686
chr1	53189636	53389636	harbor1	chr1	53262933	53263107	LTR/ERVL	557	+	87	53263020	73384
chr1	16544545	16744545	harbor1	chr1	16560670	16560870	LTR/ERVL	779	+	100	16560770	16225
chr1	36753751	36953751	harbor1	chr1	36774229	36774438	LTR/ERVL	477	+	104	36774333	20582
chr1	36753751	36953751	harbor1	chr1	36789511	36789946	LTR/ERVL	1477	+	218	36789729	35978
chr1	36753751	36953751	harbor1	chr1	36794665	36795085	LTR/ERVL	555	+	210	36794875	41124
chr1	36753751	36953751	harbor1	chr1	36835202	36835644	LTR/ERVL	729	+	221	36835423	81672
chr1	2375299	2575299	harbor1	chr1	2383092	2383334	LTR/ERVL	518	+	121	2383213	7914
chr1	94137807	94337807	harbor1	chr1	94199398	94199875	LTR/ERVL	1883	+	238	94199636	61829
chr1	16543056	16743056	harbor1	chr1	16560670	16560870	LTR/ERVL	779	+	100	16560770	17714
chr1	229331834	229531834	harbor1	chr1	229332143	229332495	LTR/ERVL	2114	+	176	229332319	485
chr1	229331834	229531834	harbor1	chr1	229361653	229361807	LTR/ERVL	741	+	77	229361730	29896
chr1	229331834	229531834	harbor1	chr1	229396594	229397128	LTR/ERVL	2104	+	267	229396861	65027
chr1	211033758	211233758	harbor1	chr1	211067248	211067560	LTR/ERVL	791	+	156	211067404	33646
chr1	211033758	211233758	harbor1	chr1	211074301	211074595	LTR/ERVL	1044	+	147	211074448	40690
chr1	211033758	211233758	harbor1	chr1	211074600	211074993	LTR/ERVL	1575	+	196	211074796	41038
chr1	211033758	211233758	harbor1	chr1	211093920	211094076	LTR/ERVL	730	+	78	211093998	60240
chr1	211033758	211233758	harbor1	chr1	211094405	211094497	LTR/ERVL	730	+	46	211094451	60693
chr1	211033758	211233758	harbor1	chr1	211115321	211115701	LTR/ERVL	3316	+	190	211115511	81753
chr1	211033758	211233758	harbor1	chr1	211115732	211115794	LTR/ERVL	3316	+	31	211115763	82005
chr1	185216973	185416973	harbor1	chr1	185279982	185280011	LTR/ERVL	1545	+	14	185279996	63023
chr1	185216973	185416973	harbor1	chr1	185280379	185280716	LTR/ERVL	1545	+	168	185280547	63574
chr1	185216973	185416973	harbor1	chr1	185282385	185282847	LTR/ERVL	1510	+	231	185282616	65643
chr1	185216973	185416973	harbor1	chr1	185284908	185285421	LTR/ERVL	1140	+	256	185285164	68191
chr1	7267274	7467274	harbor1	chr1	7337322	7337498	LTR/ERVL	995	+	88	7337410	70136
chr1	7267274	7467274	harbor1	chr1	7337699	7337980	LTR/ERVL	1406	+	140	7337839	70565
chr1	39855337	40055337	harbor1	chr1	39908119	39908877	LTR/ERVL	1564	+	379	39908498	53161
chr1	2375268	2575268	harbor1	chr1	2383092	2383334	LTR/ERVL	518	+	121	2383213	7945
chr1	16517974	16717974	harbor1	chr1	16560670	16560870	LTR/ERVL	779	+	100	16560770	42796
chr1	43447553	43647553	harbor1	chr1	43465255	43465474	LTR/ERVL	601	+	110	43465365	17812
chr1	43447553	43647553	harbor1	chr1	43465486	43465620	LTR/ERVL	485	+	67	43465553	18000
chr1	43447553	43647553	harbor1	chr1	43475797	43476063	LTR/ERVL	630	+	133	43475930	28377
chr1	43447553	43647553	harbor1	chr1	43512809	43513353	LTR/ERVL	1189	+	272	43513081	65528
chr1	43447553	43647553	harbor1	chr1	43521788	43522217	LTR/ERVL	1254	+	214	43522002	74449
chr1	16490133	16690133	harbor1	chr1	16560670	16560870	LTR/ERVL	779	+	100	16560770	70637
chr1	2375370	2575370	harbor1	chr1	2383092	2383334	LTR/ERVL	518	+	121	2383213	7843
chr1	92384641	92584641	harbor1	chr1	92465885	92466159	LTR/ERVL	1472	+	137	92466022	81381
chr1	6350574	6550574	harbor1	chr1	6411051	6411736	LTR/ERVL	1562	+	342	6411393	60819
chr1	722912	922912	harbor1	chr1	741124	741629	LTR/ERVL	3337	+	252	741376	18464
chr1	722912	922912	harbor1	chr1	741937	742006	LTR/ERVL	3337	+	34	741971	19059
chr1	722912	922912	harbor1	chr1	742310	742610	LTR/ERVL	3337	+	150	742460	19548
chr1	722912	922912	harbor1	chr1	752876	753134	LTR/ERVL	3365	+	129	753005	30093
chr1	722912	922912	harbor1	chr1	754046	754345	LTR/ERVL	3365	+	150	754196	31284
chr1	722912	922912	harbor1	chr1	753429	753738	LTR/ERVL	3365	+	154	753583	30671
chr1	116052112	116252112	harbor1	chr1	116070407	116070459	LTR/ERVL	693	+	26	116070433	18321
chr1	116052112	116252112	harbor1	chr1	116070732	116070958	LTR/ERVL	693	+	113	116070845	18733
chr1	116052112	116252112	harbor1	chr1	116147893	116148310	LTR/ERVL	1384	+	208	116148101	95989
chr1	92386045	92586045	harbor1	chr1	92465885	92466159	LTR/ERVL	1472	+	137	92466022	79977
chr1	160897940	161097940	harbor1	chr1	160934190	160934403	LTR/ERVL	739	+	106	160934296	36356
chr1	160897940	161097940	harbor1	chr1	160951408	160951550	LTR/ERVL	677	+	71	160951479	53539
chr1	160897940	161097940	harbor1	chr1	160951708	160952210	LTR/ERVL	1692	+	251	160951959	54019
chr1	160897940	161097940	harbor1	chr1	160952253	160952393	LTR/ERVL	696	+	70	160952323	54383
chr1	153245885	153445885	harbor1	chr1	153274129	153274175	LTR/ERVL	583	+	23	153274152	28267
chr1	153245885	153445885	harbor1	chr1	153274312	153274371	LTR/ERVL	583	+	30	153274342	28457
chr1	194321308	194521308	harbor1	chr1	194399371	194399466	LTR/ERVL	448	+	48	194399419	78111
chr1	11520749	11720749	harbor1	chr1	11552225	11552749	LTR/ERVL	2438	+	262	11552487	31738
chr1	11520749	11720749	harbor1	chr1	11555818	11556334	LTR/ERVL	1920	+	258	11556076	35327
chr1	11520749	11720749	harbor1	chr1	11580502	11580771	LTR/ERVL	794	+	134	11580636	59887
chr1	11520749	11720749	harbor1	chr1	11583833	11584086	LTR/ERVL	430	+	126	11583959	63210
chr1	11520749	11720749	harbor1	chr1	11591409	11591860	LTR/ERVL	2731	+	226	11591635	70886
chr1	11520749	11720749	harbor1	chr1	11619256	11619714	LTR/ERVL	2338	+	229	11619485	98736
chr1	11520749	11720749	harbor1	chr1	11620023	11620080	LTR/ERVL	2338	+	28	11620051	99302
chr1	211033691	211233691	harbor1	chr1	211067248	211067560	LTR/ERVL	791	+	156	211067404	33713
chr1	211033691	211233691	harbor1	chr1	211074301	211074595	LTR/ERVL	1044	+	147	211074448	40757
chr1	211033691	211233691	harbor1	chr1	211074600	211074993	LTR/ERVL	1575	+	196	211074796	41105
chr1	211033691	211233691	harbor1	chr1	211093920	211094076	LTR/ERVL	730	+	78	211093998	60307
chr1	211033691	211233691	harbor1	chr1	211094405	211094497	LTR/ERVL	730	+	46	211094451	60760
chr1	211033691	211233691	harbor1	chr1	211115321	211115701	LTR/ERVL	3316	+	190	211115511	81820
chr1	211033691	211233691	harbor1	chr1	211115732	211115794	LTR/ERVL	3316	+	31	211115763	82072
chr1	2375300	2575300	harbor1	chr1	2383092	2383334	LTR/ERVL	518	+	121	2383213	7913
chr1	6567487	6767487	harbor1	chr1	6570452	6570671	LTR/ERVL	777	+	110	6570562	3075
chr1	29351447	29551447	harbor1	chr1	29398478	29398782	LTR/ERVL	905	+	152	29398630	47183
chr1	29351447	29551447	harbor1	chr1	29398949	29399032	LTR/ERVL	905	+	42	29398991	47544
chr1	29351447	29551447	harbor1	chr1	29405644	29406960	LTR/ERVL	3609	+	658	29406302	54855
chr1	29351447	29551447	harbor1	chr1	29447514	29448018	LTR/ERVL	2149	+	252	29447766	96319
chr1	16544832	16744832	harbor1	chr1	16560670	16560870	LTR/ERVL	779	+	100	16560770	15938
chr1	20561106	20761106	harbor1	chr1	20629872	20630130	LTR/ERVL	734	+	129	20630001	68895
chr1	20561106	20761106	harbor1	chr1	20632078	20632128	LTR/ERVL	1356	+	25	20632103	70997
chr1	20561106	20761106	harbor1	chr1	20632433	20632714	LTR/ERVL	1356	+	140	20632573	71467
chr1	211730554	211930554	harbor1	chr1	211765783	211766365	LTR/ERVL	2079	+	291	211766074	35520
chr1	211730554	211930554	harbor1	chr1	211766871	211766910	LTR/ERVL	1688	+	20	211766891	36337
chr1	152203804	152403804	harbor1	chr1	152236620	152236962	LTR/ERVL	1813	+	171	152236791	32987
chr1	209543647	209743647	harbor1	chr1	209567952	209568385	LTR/ERVL	3141	+	216	209568168	24521
chr1	53846295	54046295	harbor1	chr1	53890504	53890997	LTR/ERVL	1036	+	246	53890750	44455
chr1	53846295	54046295	harbor1	chr1	53891310	53891620	LTR/ERVL	508	+	155	53891465	45170
chr1	53846295	54046295	harbor1	chr1	53891764	53892293	LTR/ERVL	1258	+	264	53892028	45733
chr1	53846295	54046295	harbor1	chr1	53912961	53913417	LTR/ERVL	2123	+	228	53913189	66894
chr1	53846295	54046295	harbor1	chr1	53929028	53929505	LTR/ERVL	1177	+	238	53929266	82971
chr1	2375288	2575288	harbor1	chr1	2383092	2383334	LTR/ERVL	518	+	121	2383213	7925
chr1	25516603	25716603	harbor1	chr1	25589380	25589820	LTR/ERVL	2218	+	220	25589600	72997
chr1	25516603	25716603	harbor1	chr1	25590118	25590184	LTR/ERVL	2218	+	33	25590151	73548
chr1	25516603	25716603	harbor1	chr1	25598359	25598749	LTR/ERVL	1106	+	195	25598554	81951
chr1	25516603	25716603	harbor1	chr1	25613656	25614173	LTR/ERVL	3425	+	258	25613914	97311
chr1	44307706	44507706	harbor1	chr1	44370793	44372016	LTR/ERVL	4907	+	612	44371405	63699
chr1	44307706	44507706	harbor1	chr1	44372962	44373642	LTR/ERVL	2435	+	340	44373302	65596
chr1	44307706	44507706	harbor1	chr1	44374012	44374424	LTR/ERVL	1759	+	206	44374218	66512
chr1	110021160	110221160	harbor1	chr1	110111287	110111466	LTR/ERVL	1044	+	90	110111377	90217
chr1	110021160	110221160	harbor1	chr1	110111774	110112007	LTR/ERVL	868	+	116	110111890	90730
chr1	41562092	41762092	harbor1	chr1	41595589	41596007	LTR/ERVL	3297	+	209	41595798	33706
chr1	41562092	41762092	harbor1	chr1	41609814	41610227	LTR/ERVL	2033	+	206	41610020	47928
chr1	2375272	2575272	harbor1	chr1	2383092	2383334	LTR/ERVL	518	+	121	2383213	7941
chr1	53846285	54046285	harbor1	chr1	53890504	53890997	LTR/ERVL	1036	+	246	53890750	44465
chr1	53846285	54046285	harbor1	chr1	53891310	53891620	LTR/ERVL	508	+	155	53891465	45180
chr1	53846285	54046285	harbor1	chr1	53891764	53892293	LTR/ERVL	1258	+	264	53892028	45743
chr1	53846285	54046285	harbor1	chr1	53912961	53913417	LTR/ERVL	2123	+	228	53913189	66904
chr1	53846285	54046285	harbor1	chr1	53929028	53929505	LTR/ERVL	1177	+	238	53929266	82981
chr1	16531613	16731613	harbor1	chr1	16560670	16560870	LTR/ERVL	779	+	100	16560770	29157
chr1	678890	878890	harbor1	chr1	741124	741629	LTR/ERVL	3337	+	252	741376	62486
chr1	678890	878890	harbor1	chr1	741937	742006	LTR/ERVL	3337	+	34	741971	63081
chr1	678890	878890	harbor1	chr1	742310	742610	LTR/ERVL	3337	+	150	742460	63570
chr1	678890	878890	harbor1	chr1	752876	753134	LTR/ERVL	3365	+	129	753005	74115
chr1	678890	878890	harbor1	chr1	754046	754345	LTR/ERVL	3365	+	150	754196	75306
chr1	678890	878890	harbor1	chr1	753429	753738	LTR/ERVL	3365	+	154	753583	74693
chr1	2375302	2575302	harbor1	chr1	2383092	2383334	LTR/ERVL	518	+	121	2383213	7911
chr1	16542818	16742818	harbor1	chr1	16560670	16560870	LTR/ERVL	779	+	100	16560770	17952
chr1	16543037	16743037	harbor1	chr1	16560670	16560870	LTR/ERVL	779	+	100	16560770	17733
chr1	2375187	2575187	harbor1	chr1	2383092	2383334	LTR/ERVL	518	+	121	2383213	8026
chr1	53312624	53512624	harbor1	chr1	53363460	53363652	LTR/ERVL	525	+	96	53363556	50932
chr1	85965115	86165115	harbor1	chr1	85967833	85968262	LTR/ERVL	3137	+	214	85968047	2932
chr1	85965115	86165115	harbor1	chr1	85998565	85999030	LTR/ERVL	1235	+	232	85998797	33682
chr1	85965115	86165115	harbor1	chr1	85999036	85999343	LTR/ERVL	1115	+	154	85999190	34075
chr1	85965115	86165115	harbor1	chr1	86002209	86005168	LTR/ERVL	9735	+	1480	86003689	38574
chr1	31913327	32113327	harbor1	chr1	31970846	31971245	LTR/ERVL	634	+	200	31971046	57719
chr1	31913327	32113327	harbor1	chr1	32009055	32009614	LTR/ERVL	2916	+	280	32009335	96008
chr1	16344104	16544104	harbor1	chr1	16401970	16402244	LTR/ERVL	643	+	137	16402107	58003
chr1	16344104	16544104	harbor1	chr1	16416294	16416395	LTR/ERVL	2514	+	50	16416344	72240
chr1	16344104	16544104	harbor1	chr1	16416699	16417079	LTR/ERVL	2514	+	190	16416889	72785
chr1	16544840	16744840	harbor1	chr1	16560670	16560870	LTR/ERVL	779	+	100	16560770	15930
chr1	211033713	211233713	harbor1	chr1	211067248	211067560	LTR/ERVL	791	+	156	211067404	33691
chr1	211033713	211233713	harbor1	chr1	211074301	211074595	LTR/ERVL	1044	+	147	211074448	40735
chr1	211033713	211233713	harbor1	chr1	211074600	211074993	LTR/ERVL	1575	+	196	211074796	41083
chr1	211033713	211233713	harbor1	chr1	211093920	211094076	LTR/ERVL	730	+	78	211093998	60285
chr1	211033713	211233713	harbor1	chr1	211094405	211094497	LTR/ERVL	730	+	46	211094451	60738
chr1	211033713	211233713	harbor1	chr1	211115321	211115701	LTR/ERVL	3316	+	190	211115511	81798
chr1	211033713	211233713	harbor1	chr1	211115732	211115794	LTR/ERVL	3316	+	31	211115763	82050
chr1	5847916	6047916	harbor1	chr1	5946549	5946979	LTR/ERVL	1363	+	215	5946764	98848
chr1	207902897	208102897	harbor1	chr1	207992024	207992113	LTR/ERVL	1735	+	44	207992068	89171
chr1	207902897	208102897	harbor1	chr1	207992420	207992705	LTR/ERVL	1735	+	142	207992562	89665
chr1	211033788	211233788	harbor1	chr1	211067248	211067560	LTR/ERVL	791	+	156	211067404	33616
chr1	211033788	211233788	harbor1	chr1	211074301	211074595	LTR/ERVL	1044	+	147	211074448	40660
chr1	211033788	211233788	harbor1	chr1	211074600	211074993	LTR/ERVL	1575	+	196	211074796	41008
chr1	211033788	211233788	harbor1	chr1	211093920	211094076	LTR/ERVL	730	+	78	211093998	60210
chr1	211033788	211233788	harbor1	chr1	211094405	211094497	LTR/ERVL	730	+	46	211094451	60663
chr1	211033788	211233788	harbor1	chr1	211115321	211115701	LTR/ERVL	3316	+	190	211115511	81723
chr1	211033788	211233788	harbor1	chr1	211115732	211115794	LTR/ERVL	3316	+	31	211115763	81975
chr1	2308936	2508936	harbor1	chr1	2383092	2383334	LTR/ERVL	518	+	121	2383213	74277
chr1	16544915	16744915	harbor1	chr1	16560670	16560870	LTR/ERVL	779	+	100	16560770	15855
chr1	210684182	210884182	harbor1	chr1	210695790	210696487	LTR/ERVL	562	+	348	210696138	11956
chr1	210684182	210884182	harbor1	chr1	210720407	210720892	LTR/ERVL	1221	+	242	210720649	36467
chr1	210684182	210884182	harbor1	chr1	210743808	210744296	LTR/ERVL	1447	+	244	210744052	59870
chr1	244605824	244805824	harbor1	chr1	244644512	244644942	LTR/ERVL	1120	+	215	244644727	38903
chr1	244605824	244805824	harbor1	chr1	244644953	244645618	LTR/ERVL	1325	+	332	244645285	39461
chr1	244605824	244805824	harbor1	chr1	244647978	244648381	LTR/ERVL	590	+	202	244648180	42356
chr1	244605824	244805824	harbor1	chr1	244665526	244665854	LTR/ERVL	1793	+	164	244665690	59866
chr1	244605824	244805824	harbor1	chr1	244696661	244697204	LTR/ERVL	3037	+	272	244696933	91109
chr1	244605824	244805824	harbor1	chr1	244697207	244697225	LTR/ERVL	10237	+	9	244697216	91392
chr1	244605824	244805824	harbor1	chr1	244697494	244699301	LTR/ERVL	10237	+	904	244698398	92574
chr1	244605824	244805824	harbor1	chr1	244699609	244700085	LTR/ERVL	10237	+	238	244699847	94023
chr1	244605824	244805824	harbor1	chr1	244700086	244700259	LTR/ERVL	731	+	86	244700172	94348
chr1	244605824	244805824	harbor1	chr1	244645678	244646518	LTR/ERVL	2943	+	420	244646098	40274
chr1	205330828	205530828	harbor1	chr1	205400557	205400689	LTR/ERVL	725	+	66	205400623	69795
chr1	205330828	205530828	harbor1	chr1	205406860	205407049	LTR/ERVL	3417	+	94	205406954	76126
chr1	205330828	205530828	harbor1	chr1	205407350	205407951	LTR/ERVL	3417	+	300	205407650	76822
chr1	16544904	16744904	harbor1	chr1	16560670	16560870	LTR/ERVL	779	+	100	16560770	15866
chr1	145919577	146119577	harbor1	chr1	145948683	145949147	LTR/ERVL	1849	+	232	145948915	29338
chr1	16544923	16744923	harbor1	chr1	16560670	16560870	LTR/ERVL	779	+	100	16560770	15847
chr1	226785705	226985705	harbor1	chr1	226806645	226806795	LTR/ERVL	480	+	75	226806720	21015
chr1	226785705	226985705	harbor1	chr1	226857038	226857800	LTR/ERVL	2846	+	381	226857419	71714
chr1	226785705	226985705	harbor1	chr1	226865740	226865884	LTR/ERVL	445	+	72	226865812	80107
chr1	226785705	226985705	harbor1	chr1	226865874	226866015	LTR/ERVL	745	+	70	226865944	80239
chr1	202013163	202213163	harbor1	chr1	202039680	202039831	LTR/ERVL	850	+	76	202039756	26593
chr1	202013163	202213163	harbor1	chr1	202067216	202067613	LTR/ERVL	1166	+	198	202067414	54251
chr1	202013163	202213163	harbor1	chr1	202067616	202067969	LTR/ERVL	976	+	176	202067792	54629
chr1	202013163	202213163	harbor1	chr1	202068489	202068890	LTR/ERVL	1059	+	200	202068689	55526
chr1	202013163	202213163	harbor1	chr1	202069064	202069250	LTR/ERVL	1519	+	93	202069157	55994
chr1	202013163	202213163	harbor1	chr1	202069551	202070018	LTR/ERVL	1519	+	234	202069785	56622
chr1	16544980	16744980	harbor1	chr1	16560670	16560870	LTR/ERVL	779	+	100	16560770	15790
chr1	16544958	16744958	harbor1	chr1	16560670	16560870	LTR/ERVL	779	+	100	16560770	15812
chr1	46294443	46494443	harbor1	chr1	46364354	46364394	LTR/ERVL	1824	+	20	46364374	69931
chr1	46294443	46494443	harbor1	chr1	46364698	46365076	LTR/ERVL	1824	+	189	46364887	70444
chr1	185628149	185828149	harbor1	chr1	185707226	185707362	LTR/ERVL	864	+	68	185707294	79145
chr1	2375387	2575387	harbor1	chr1	2383092	2383334	LTR/ERVL	518	+	121	2383213	7826
chr1	2375251	2575251	harbor1	chr1	2383092	2383334	LTR/ERVL	518	+	121	2383213	7962
chr1	6351852	6551852	harbor1	chr1	6411051	6411736	LTR/ERVL	1562	+	342	6411393	59541
chr1	31972901	32172901	harbor1	chr1	32009055	32009614	LTR/ERVL	2916	+	280	32009335	36434
chr1	53312611	53512611	harbor1	chr1	53363460	53363652	LTR/ERVL	525	+	96	53363556	50945
chr1	25516631	25716631	harbor1	chr1	25589380	25589820	LTR/ERVL	2218	+	220	25589600	72969
chr1	25516631	25716631	harbor1	chr1	25590118	25590184	LTR/ERVL	2218	+	33	25590151	73520
chr1	25516631	25716631	harbor1	chr1	25598359	25598749	LTR/ERVL	1106	+	195	25598554	81923
chr1	25516631	25716631	harbor1	chr1	25613656	25614173	LTR/ERVL	3425	+	258	25613914	97283
chr1	16544749	16744749	harbor1	chr1	16560670	16560870	LTR/ERVL	779	+	100	16560770	16021
chr1	230539098	230739098	harbor1	chr1	230539427	230541165	LTR/ERVL	1853	+	869	230540296	1198
chr1	230539098	230739098	harbor1	chr1	230541931	230542128	LTR/ERVL	455	+	98	230542029	2931
chr1	230539098	230739098	harbor1	chr1	230542137	230542560	LTR/ERVL	1292	+	212	230542349	3251
chr1	230539098	230739098	harbor1	chr1	230542557	230542596	LTR/ERVL	1153	+	20	230542577	3479
chr1	230539098	230739098	harbor1	chr1	230542892	230543180	LTR/ERVL	1153	+	144	230543036	3938
chr1	230539098	230739098	harbor1	chr1	230544274	230544881	LTR/ERVL	1687	+	304	230544578	5480
chr1	230539098	230739098	harbor1	chr1	230544969	230545147	LTR/ERVL	728	+	89	230545058	5960
chr1	230539098	230739098	harbor1	chr1	230545176	230545607	LTR/ERVL	695	+	216	230545392	6294
chr1	230539098	230739098	harbor1	chr1	230545606	230545904	LTR/ERVL	902	+	149	230545755	6657
chr1	230539098	230739098	harbor1	chr1	230546068	230546466	LTR/ERVL	793	+	199	230546267	7169
chr1	230539098	230739098	harbor1	chr1	230562140	230562725	LTR/ERVL	3222	+	292	230562432	23334
chr1	230539098	230739098	harbor1	chr1	230629119	230629650	LTR/ERVL	3002	+	266	230629385	90287
chr1	230539098	230739098	harbor1	chr1	230539216	230539419	LTR/ERVL	487	+	102	230539318	220
chr2	196936108	197136108	harbor1	chr2	197030520	197030792	LTR/ERVL	954	+	136	197030656	94548
chr2	53462886	53662886	harbor1	chr2	53466040	53466171	LTR/ERVL	863	+	66	53466106	3220
chr2	53462886	53662886	harbor1	chr2	53466381	53466877	LTR/ERVL	1829	+	248	53466629	3743
chr2	53462886	53662886	harbor1	chr2	53477609	53477966	LTR/ERVL	668	+	178	53477787	14901
chr2	53462886	53662886	harbor1	chr2	53484651	53485211	LTR/ERVL	2763	+	280	53484931	22045
chr2	72038963	72238963	harbor1	chr2	72074203	72074507	LTR/ERVL	695	+	152	72074355	35392
chr2	69543779	69743779	harbor1	chr2	69611029	69611640	LTR/ERVL	1623	+	306	69611335	67556
chr2	69543779	69743779	harbor1	chr2	69613240	69614100	LTR/ERVL	4202	+	430	69613670	69891
chr2	85502408	85702408	harbor1	chr2	85513464	85513895	LTR/ERVL	767	+	216	85513680	11272
chr2	70771787	70971787	harbor1	chr2	70771784	70772105	LTR/ERVL	1228	+	160	70771944	157
chr2	70771787	70971787	harbor1	chr2	70774042	70774346	LTR/ERVL	721	+	152	70774194	2407
chr2	70771787	70971787	harbor1	chr2	70821185	70821726	LTR/ERVL	1873	+	270	70821455	49668
chr2	70771787	70971787	harbor1	chr2	70822059	70822288	LTR/ERVL	1873	+	114	70822173	50386
chr2	70771787	70971787	harbor1	chr2	70850061	70850324	LTR/ERVL	512	+	132	70850193	78406
chr2	3604000	3804000	harbor1	chr2	3645909	3646440	LTR/ERVL	1501	+	266	3646175	42175
chr2	158867991	159067991	harbor1	chr2	158912795	158913019	LTR/ERVL	2143	+	112	158912907	44916
chr2	158867991	159067991	harbor1	chr2	158913308	158913571	LTR/ERVL	2143	+	132	158913440	45449
chr2	158867991	159067991	harbor1	chr2	158955915	158956409	LTR/ERVL	961	+	247	158956162	88171
chr2	6817111	7017111	harbor1	chr2	6868954	6869356	LTR/ERVL	650	+	201	6869155	52044
chr2	2616616	2816616	harbor1	chr2	2676664	2679228	LTR/ERVL	19298	+	1282	2677946	61330
chr2	2616616	2816616	harbor1	chr2	2679230	2679681	LTR/ERVL	2776	+	226	2679456	62840
chr2	2616616	2816616	harbor1	chr2	2696149	2696320	LTR/ERVL	642	+	86	2696235	79619
chr2	69543869	69743869	harbor1	chr2	69611029	69611640	LTR/ERVL	1623	+	306	69611335	67466
chr2	69543869	69743869	harbor1	chr2	69613240	69614100	LTR/ERVL	4202	+	430	69613670	69801
chr2	34909049	35109049	harbor1	chr2	34964811	34965988	LTR/ERVL	2048	+	588	34965399	56350
chr2	34909049	35109049	harbor1	chr2	34966154	34966459	LTR/ERVL	892	+	152	34966306	57257
chr2	232385663	232585663	harbor1	chr2	232393184	232393249	LTR/ERVL	1404	+	32	232393216	7553
chr2	232385663	232585663	harbor1	chr2	232393681	232394107	LTR/ERVL	1404	+	213	232393894	8231
chr2	86463906	86663906	harbor1	chr2	86558981	86559501	LTR/ERVL	2571	+	260	86559241	95335
chr2	46198450	46398450	harbor1	chr2	46291764	46292092	LTR/ERVL	527	+	164	46291928	93478
chr2	42069545	42269545	harbor1	chr2	42092222	42092519	LTR/ERVL	1205	+	148	42092370	22825
chr2	42069545	42269545	harbor1	chr2	42092593	42092764	LTR/ERVL	936	+	86	42092679	23134
chr2	127928490	128128490	harbor1	chr2	127956074	127956468	LTR/ERVL	2615	+	197	127956271	27781
chr2	127928490	128128490	harbor1	chr2	127956716	127956953	LTR/ERVL	2615	+	118	127956834	28344
chr2	127928490	128128490	harbor1	chr2	127981348	127981388	LTR/ERVL	1158	+	20	127981368	52878
chr2	127928490	128128490	harbor1	chr2	127981764	127982008	LTR/ERVL	871	+	122	127981886	53396
chr2	87424870	87624870	harbor1	chr2	87481711	87481902	LTR/ERVL	1774	+	96	87481807	56937
chr2	87424870	87624870	harbor1	chr2	87482214	87482405	LTR/ERVL	1774	+	96	87482310	57440
chr2	87424870	87624870	harbor1	chr2	87482486	87482526	LTR/ERVL	1774	+	20	87482506	57636
chr2	87424870	87624870	harbor1	chr2	87516536	87517272	LTR/ERVL	3892	+	368	87516904	92034
chr2	69381601	69581601	harbor1	chr2	69398395	69398857	LTR/ERVL	1891	+	231	69398626	17025
chr2	110569500	110769500	harbor1	chr2	110615742	110616405	LTR/ERVL	1711	+	332	110616074	46574
chr2	86976350	87176350	harbor1	chr2	87056265	87056391	LTR/ERVL	1226	+	63	87056328	79978
chr2	86976350	87176350	harbor1	chr2	87056733	87056850	LTR/ERVL	1226	+	58	87056791	80441
chr2	86976350	87176350	harbor1	chr2	87057058	87057218	LTR/ERVL	862	+	80	87057138	80788
chr2	63488511	63688511	harbor1	chr2	63527085	63527224	LTR/ERVL	508	+	70	63527155	38644
chr2	63488511	63688511	harbor1	chr2	63530439	63530715	LTR/ERVL	978	+	138	63530577	42066
chr2	37132026	37332026	harbor1	chr2	37159149	37159501	LTR/ERVL	465	+	176	37159325	27299
chr2	37132026	37332026	harbor1	chr2	37160112	37160407	LTR/ERVL	651	+	148	37160260	28234
chr2	37132026	37332026	harbor1	chr2	37206023	37206120	LTR/ERVL	554	+	48	37206071	74045
chr2	56085054	56285054	harbor1	chr2	56169031	56169532	LTR/ERVL	1790	+	250	56169281	84227
chr2	219343396	219543396	harbor1	chr2	219345124	219345683	LTR/ERVL	860	+	280	219345404	2008
chr2	219343396	219543396	harbor1	chr2	219390955	219391314	LTR/ERVL	1248	+	180	219391135	47739
chr2	232389018	232589018	harbor1	chr2	232393184	232393249	LTR/ERVL	1404	+	32	232393216	4198
chr2	232389018	232589018	harbor1	chr2	232393681	232394107	LTR/ERVL	1404	+	213	232393894	4876
chr2	240592012	240792012	harbor1	chr2	240650947	240651654	LTR/ERVL	2949	+	354	240651301	59289
chr2	240592012	240792012	harbor1	chr2	240651681	240651994	LTR/ERVL	1302	+	156	240651837	59825
chr2	240592012	240792012	harbor1	chr2	240653373	240653703	LTR/ERVL	1079	+	165	240653538	61526
chr2	240592012	240792012	harbor1	chr2	240654791	240654974	LTR/ERVL	4342	+	92	240654883	62871
chr2	240592012	240792012	harbor1	chr2	240655334	240656024	LTR/ERVL	4342	+	345	240655679	63667
chr2	240592012	240792012	harbor1	chr2	240656322	240657248	LTR/ERVL	4342	+	463	240656785	64773
chr2	240592012	240792012	harbor1	chr2	240662603	240663048	LTR/ERVL	2153	+	222	240662825	70813
chr2	240592012	240792012	harbor1	chr2	240663348	240663453	LTR/ERVL	2153	+	52	240663400	71388
chr2	240592012	240792012	harbor1	chr2	240687020	240687386	LTR/ERVL	856	+	183	240687203	95191
chr2	56085032	56285032	harbor1	chr2	56169031	56169532	LTR/ERVL	1790	+	250	56169281	84249
chr2	56085009	56285009	harbor1	chr2	56169031	56169532	LTR/ERVL	1790	+	250	56169281	84272
chr2	70771209	70971209	harbor1	chr2	70771784	70772105	LTR/ERVL	1228	+	160	70771944	735
chr2	70771209	70971209	harbor1	chr2	70774042	70774346	LTR/ERVL	721	+	152	70774194	2985
chr2	70771209	70971209	harbor1	chr2	70821185	70821726	LTR/ERVL	1873	+	270	70821455	50246
chr2	70771209	70971209	harbor1	chr2	70822059	70822288	LTR/ERVL	1873	+	114	70822173	50964
chr2	70771209	70971209	harbor1	chr2	70850061	70850324	LTR/ERVL	512	+	132	70850193	78984
chr2	85502856	85702856	harbor1	chr2	85513464	85513895	LTR/ERVL	767	+	216	85513680	10824
chr2	162739522	162939522	harbor1	chr2	162782821	162783229	LTR/ERVL	1306	+	204	162783025	43503
chr2	162739522	162939522	harbor1	chr2	162783245	162783350	LTR/ERVL	448	+	52	162783297	43775
chr2	26144160	26344160	harbor1	chr2	26219492	26221988	LTR/ERVL	13441	+	1248	26220740	76580
chr2	26144160	26344160	harbor1	chr2	26222381	26222644	LTR/ERVL	4980	+	132	26222513	78353
chr2	26144160	26344160	harbor1	chr2	26222663	26223513	LTR/ERVL	4455	+	425	26223088	78928
chr2	26144160	26344160	harbor1	chr2	26223520	26223740	LTR/ERVL	2318	+	110	26223630	79470
chr2	26144160	26344160	harbor1	chr2	26224047	26224376	LTR/ERVL	2318	+	164	26224211	80051
chr2	26144160	26344160	harbor1	chr2	26224415	26224762	LTR/ERVL	1522	+	174	26224589	80429
chr2	26144160	26344160	harbor1	chr2	26224779	26224879	LTR/ERVL	507	+	50	26224829	80669
chr2	26154867	26354867	harbor1	chr2	26219492	26221988	LTR/ERVL	13441	+	1248	26220740	65873
chr2	26154867	26354867	harbor1	chr2	26222381	26222644	LTR/ERVL	4980	+	132	26222513	67646
chr2	26154867	26354867	harbor1	chr2	26222663	26223513	LTR/ERVL	4455	+	425	26223088	68221
chr2	26154867	26354867	harbor1	chr2	26223520	26223740	LTR/ERVL	2318	+	110	26223630	68763
chr2	26154867	26354867	harbor1	chr2	26224047	26224376	LTR/ERVL	2318	+	164	26224211	69344
chr2	26154867	26354867	harbor1	chr2	26224415	26224762	LTR/ERVL	1522	+	174	26224589	69722
chr2	26154867	26354867	harbor1	chr2	26224779	26224879	LTR/ERVL	507	+	50	26224829	69962
chr2	74270990	74470990	harbor1	chr2	74319516	74319652	LTR/ERVL	878	+	68	74319584	48594
chr2	74270990	74470990	harbor1	chr2	74319659	74319924	LTR/ERVL	1386	+	132	74319791	48801
chr2	74270990	74470990	harbor1	chr2	74331789	74332159	LTR/ERVL	523	+	185	74331974	60984
chr2	74270990	74470990	harbor1	chr2	74358084	74358339	LTR/ERVL	532	+	128	74358212	87222
chr2	46198509	46398509	harbor1	chr2	46291764	46292092	LTR/ERVL	527	+	164	46291928	93419
chr2	1483290	1683290	harbor1	chr2	1544499	1545024	LTR/ERVL	1868	+	262	1544761	61471
chr2	1483290	1683290	harbor1	chr2	1575467	1575751	LTR/ERVL	803	+	142	1575609	92319
chr2	53760159	53960159	harbor1	chr2	53761402	53761792	LTR/ERVL	1747	+	195	53761597	1438
chr2	53760159	53960159	harbor1	chr2	53848009	53848436	LTR/ERVL	840	+	214	53848223	88064
chr2	70771799	70971799	harbor1	chr2	70771784	70772105	LTR/ERVL	1228	+	160	70771944	145
chr2	70771799	70971799	harbor1	chr2	70774042	70774346	LTR/ERVL	721	+	152	70774194	2395
chr2	70771799	70971799	harbor1	chr2	70821185	70821726	LTR/ERVL	1873	+	270	70821455	49656
chr2	70771799	70971799	harbor1	chr2	70822059	70822288	LTR/ERVL	1873	+	114	70822173	50374
chr2	70771799	70971799	harbor1	chr2	70850061	70850324	LTR/ERVL	512	+	132	70850193	78394
chr2	240345243	240545243	harbor1	chr2	240418779	240419401	LTR/ERVL	1548	+	311	240419090	73847
chr2	61788838	61988838	harbor1	chr2	61846579	61846871	LTR/ERVL	1195	+	146	61846725	57887
chr2	61788838	61988838	harbor1	chr2	61862980	61863168	LTR/ERVL	536	+	94	61863074	74236
chr2	61788838	61988838	harbor1	chr2	61863375	61863441	LTR/ERVL	5329	+	33	61863408	74570
chr2	61788838	61988838	harbor1	chr2	61863723	61864768	LTR/ERVL	5329	+	522	61864245	75407
chr2	61788838	61988838	harbor1	chr2	61865071	61865106	LTR/ERVL	4824	+	18	61865089	76251
chr2	61788838	61988838	harbor1	chr2	61865118	61865287	LTR/ERVL	851	+	84	61865202	76364
chr2	111924427	112124427	harbor1	chr2	111991925	111992055	LTR/ERVL	513	+	65	111991990	67563
chr2	111924427	112124427	harbor1	chr2	111992036	111992470	LTR/ERVL	3043	+	217	111992253	67826
chr2	111924427	112124427	harbor1	chr2	111992781	111993158	LTR/ERVL	3043	+	188	111992969	68542
chr2	70557451	70757451	harbor1	chr2	70566560	70567089	LTR/ERVL	2234	+	264	70566824	9373
chr2	70557451	70757451	harbor1	chr2	70632093	70632422	LTR/ERVL	701	+	164	70632257	74806
chr2	217613937	217813937	harbor1	chr2	217623426	217623546	LTR/ERVL	544	+	60	217623486	9549
chr2	217613937	217813937	harbor1	chr2	217623547	217623918	LTR/ERVL	1886	+	186	217623733	9796
chr2	217613937	217813937	harbor1	chr2	217623956	217623995	LTR/ERVL	1886	+	20	217623976	10039
chr2	217613937	217813937	harbor1	chr2	217623996	217624048	LTR/ERVL	544	+	26	217624022	10085
chr2	217613937	217813937	harbor1	chr2	217629642	217629979	LTR/ERVL	672	+	168	217629810	15873
chr2	217613937	217813937	harbor1	chr2	217636294	217636497	LTR/ERVL	742	+	102	217636396	22459
chr2	217613937	217813937	harbor1	chr2	217636609	217636747	LTR/ERVL	742	+	69	217636678	22741
chr2	217613937	217813937	harbor1	chr2	217650806	217651158	LTR/ERVL	1055	+	176	217650982	37045
chr2	217613937	217813937	harbor1	chr2	217657300	217657722	LTR/ERVL	814	+	211	217657511	43574
chr2	217613937	217813937	harbor1	chr2	217662856	217663180	LTR/ERVL	1302	+	162	217663018	49081
chr2	217613937	217813937	harbor1	chr2	217689150	217689448	LTR/ERVL	1264	+	149	217689299	75362
chr2	127928563	128128563	harbor1	chr2	127956074	127956468	LTR/ERVL	2615	+	197	127956271	27708
chr2	127928563	128128563	harbor1	chr2	127956716	127956953	LTR/ERVL	2615	+	118	127956834	28271
chr2	127928563	128128563	harbor1	chr2	127981348	127981388	LTR/ERVL	1158	+	20	127981368	52805
chr2	127928563	128128563	harbor1	chr2	127981764	127982008	LTR/ERVL	871	+	122	127981886	53323
chr2	111955758	112155758	harbor1	chr2	111991925	111992055	LTR/ERVL	513	+	65	111991990	36232
chr2	111955758	112155758	harbor1	chr2	111992036	111992470	LTR/ERVL	3043	+	217	111992253	36495
chr2	111955758	112155758	harbor1	chr2	111992781	111993158	LTR/ERVL	3043	+	188	111992969	37211
chr2	111955758	112155758	harbor1	chr2	112047473	112047825	LTR/ERVL	1336	+	176	112047649	91891
chr2	111955758	112155758	harbor1	chr2	112048212	112048303	LTR/ERVL	1336	+	46	112048258	92500
chr2	32257033	32457033	harbor1	chr2	32320168	32320288	LTR/ERVL	1743	+	60	32320228	63195
chr2	32257033	32457033	harbor1	chr2	32320598	32320937	LTR/ERVL	1743	+	170	32320768	63735
chr2	32257033	32457033	harbor1	chr2	32321862	32322103	LTR/ERVL	1494	+	120	32321982	64949
chr2	32257033	32457033	harbor1	chr2	32340430	32340524	LTR/ERVL	512	+	47	32340477	83444
chr2	219384924	219584924	harbor1	chr2	219390955	219391314	LTR/ERVL	1248	+	180	219391135	6211
chr2	42000972	42200972	harbor1	chr2	42092222	42092519	LTR/ERVL	1205	+	148	42092370	91398
chr2	42000972	42200972	harbor1	chr2	42092593	42092764	LTR/ERVL	936	+	86	42092679	91707
chr2	42069414	42269414	harbor1	chr2	42092222	42092519	LTR/ERVL	1205	+	148	42092370	22956
chr2	42069414	42269414	harbor1	chr2	42092593	42092764	LTR/ERVL	936	+	86	42092679	23265
chr2	111023174	111223174	harbor1	chr2	111090807	111091346	LTR/ERVL	713	+	270	111091077	67903
chr2	134566253	134766253	harbor1	chr2	134582359	134582570	LTR/ERVL	1157	+	106	134582465	16212
chr2	134566253	134766253	harbor1	chr2	134625522	134625812	LTR/ERVL	563	+	145	134625667	59414
chr2	134566253	134766253	harbor1	chr2	134628281	134628881	LTR/ERVL	2457	+	300	134628581	62328
chr2	158868018	159068018	harbor1	chr2	158912795	158913019	LTR/ERVL	2143	+	112	158912907	44889
chr2	158868018	159068018	harbor1	chr2	158913308	158913571	LTR/ERVL	2143	+	132	158913440	45422
chr2	158868018	159068018	harbor1	chr2	158955915	158956409	LTR/ERVL	961	+	247	158956162	88144
chr2	96174902	96374902	harbor1	chr2	96187424	96187675	LTR/ERVL	1488	+	126	96187550	12648
chr2	96174902	96374902	harbor1	chr2	96188575	96188601	LTR/ERVL	1488	+	13	96188588	13686
chr2	96174902	96374902	harbor1	chr2	96188924	96188948	LTR/ERVL	1488	+	12	96188936	14034
chr2	96174902	96374902	harbor1	chr2	96189249	96189420	LTR/ERVL	1488	+	86	96189335	14433
chr2	96174902	96374902	harbor1	chr2	96225095	96225361	LTR/ERVL	854	+	133	96225228	50326
chr2	96174902	96374902	harbor1	chr2	96233989	96234253	LTR/ERVL	1101	+	132	96234121	59219
chr2	96174902	96374902	harbor1	chr2	96234375	96234563	LTR/ERVL	627	+	94	96234469	59567
chr2	96174902	96374902	harbor1	chr2	96235418	96235444	LTR/ERVL	4963	+	13	96235431	60529
chr2	96174902	96374902	harbor1	chr2	96235742	96238331	LTR/ERVL	4963	+	1294	96237036	62134
chr2	96174902	96374902	harbor1	chr2	96238343	96238537	LTR/ERVL	768	+	97	96238440	63538
chr2	96174902	96374902	harbor1	chr2	96241345	96241546	LTR/ERVL	458	+	100	96241445	66543
chr2	96174902	96374902	harbor1	chr2	96245582	96246075	LTR/ERVL	2147	+	246	96245828	70926
chr2	96174902	96374902	harbor1	chr2	96239359	96239799	LTR/ERVL	1078	+	220	96239579	64677
chr2	72971175	73171175	harbor1	chr2	72994297	72994549	LTR/ERVL	456	+	126	72994423	23248
chr2	61276617	61476617	harbor1	chr2	61287881	61288014	LTR/ERVL	501	+	66	61287947	11330
chr2	61276617	61476617	harbor1	chr2	61288111	61288415	LTR/ERVL	475	+	152	61288263	11646
chr2	218223831	218423831	harbor1	chr2	218303899	218304152	LTR/ERVL	718	+	126	218304025	80194
chr2	218223831	218423831	harbor1	chr2	218304444	218304632	LTR/ERVL	718	+	94	218304538	80707
chr2	96108492	96308492	harbor1	chr2	96187424	96187675	LTR/ERVL	1488	+	126	96187550	79058
chr2	96108492	96308492	harbor1	chr2	96188575	96188601	LTR/ERVL	1488	+	13	96188588	80096
chr2	96108492	96308492	harbor1	chr2	96188924	96188948	LTR/ERVL	1488	+	12	96188936	80444
chr2	96108492	96308492	harbor1	chr2	96189249	96189420	LTR/ERVL	1488	+	86	96189335	80843
chr2	111955737	112155737	harbor1	chr2	111991925	111992055	LTR/ERVL	513	+	65	111991990	36253
chr2	111955737	112155737	harbor1	chr2	111992036	111992470	LTR/ERVL	3043	+	217	111992253	36516
chr2	111955737	112155737	harbor1	chr2	111992781	111993158	LTR/ERVL	3043	+	188	111992969	37232
chr2	111955737	112155737	harbor1	chr2	112047473	112047825	LTR/ERVL	1336	+	176	112047649	91912
chr2	111955737	112155737	harbor1	chr2	112048212	112048303	LTR/ERVL	1336	+	46	112048258	92521
chr2	72043426	72243426	harbor1	chr2	72074203	72074507	LTR/ERVL	695	+	152	72074355	30929
chr3	50017175	50217175	harbor1	chr3	50082258	50082570	LTR/ERVL	1742	+	156	50082414	65239
chr3	50017175	50217175	harbor1	chr3	50083052	50083151	LTR/ERVL	581	+	50	50083102	65927
chr3	46799606	46999606	harbor1	chr3	46816558	46817200	LTR/ERVL	1947	+	321	46816879	17273
chr3	46799606	46999606	harbor1	chr3	46827947	46828376	LTR/ERVL	2404	+	214	46828161	28555
chr3	46799606	46999606	harbor1	chr3	46854846	46855131	LTR/ERVL	575	+	142	46854988	55382
chr3	53988061	54188061	harbor1	chr3	54061894	54062357	LTR/ERVL	1243	+	232	54062126	74065
chr3	53988061	54188061	harbor1	chr3	54063045	54063314	LTR/ERVL	461	+	134	54063179	75118
chr3	127490205	127690205	harbor1	chr3	127527079	127527488	LTR/ERVL	1203	+	204	127527283	37078
chr3	127490205	127690205	harbor1	chr3	127540128	127540464	LTR/ERVL	1450	+	168	127540296	50091
chr3	140272103	140472103	harbor1	chr3	140274925	140275277	LTR/ERVL	1184	+	176	140275101	2998
chr3	140272103	140472103	harbor1	chr3	140275571	140275642	LTR/ERVL	1184	+	36	140275607	3504
chr3	140272103	140472103	harbor1	chr3	140330200	140330650	LTR/ERVL	1093	+	225	140330425	58322
chr3	140272103	140472103	harbor1	chr3	140334834	140335165	LTR/ERVL	789	+	166	140335000	62897
chr3	140272103	140472103	harbor1	chr3	140353945	140354448	LTR/ERVL	856	+	252	140354197	82094
chr3	140272103	140472103	harbor1	chr3	140368237	140368542	LTR/ERVL	571	+	152	140368389	96286
chr3	49071632	49271632	harbor1	chr3	49170199	49170644	LTR/ERVL	1232	+	222	49170421	98789
chr3	197859562	198059562	harbor1	chr3	197906039	197906279	LTR/ERVL	837	+	120	197906159	46597
chr3	197859562	198059562	harbor1	chr3	197926549	197926950	LTR/ERVL	1139	+	200	197926749	67187
chr3	197859562	198059562	harbor1	chr3	197947704	197947878	LTR/ERVL	595	+	87	197947791	88229
chr3	7485739	7685739	harbor1	chr3	7551061	7551559	LTR/ERVL	1470	+	249	7551310	65571
chr3	43898752	44098752	harbor1	chr3	43908438	43908861	LTR/ERVL	1124	+	212	43908650	9898
chr3	43898752	44098752	harbor1	chr3	43917384	43917879	LTR/ERVL	604	+	248	43917632	18880
chr3	43898752	44098752	harbor1	chr3	43951223	43951670	LTR/ERVL	864	+	224	43951447	52695
chr3	43898752	44098752	harbor1	chr3	43962761	43963102	LTR/ERVL	1073	+	170	43962931	64179
chr3	43898752	44098752	harbor1	chr3	43963362	43963516	LTR/ERVL	1073	+	77	43963439	64687
chr3	43898752	44098752	harbor1	chr3	43965554	43965664	LTR/ERVL	506	+	55	43965609	66857
chr3	43898752	44098752	harbor1	chr3	43967431	43967778	LTR/ERVL	1509	+	174	43967605	68853
chr3	126256980	126456980	harbor1	chr3	126282414	126282429	LTR/ERVL	4118	+	8	126282422	25442
chr3	126256980	126456980	harbor1	chr3	126282477	126283289	LTR/ERVL	4118	+	406	126282883	25903
chr3	184086431	184286431	harbor1	chr3	184112171	184112275	LTR/ERVL	687	+	52	184112223	25792
chr3	184086603	184286603	harbor1	chr3	184112171	184112275	LTR/ERVL	687	+	52	184112223	25620
chr3	49829599	50029599	harbor1	chr3	49888864	49889239	LTR/ERVL	1179	+	188	49889052	59453
chr3	127572813	127772813	harbor1	chr3	127593439	127594637	LTR/ERVL	1782	+	599	127594038	21225
chr3	183820276	184020276	harbor1	chr3	183888789	183888928	LTR/ERVL	1310	+	70	183888859	68583
chr3	183820276	184020276	harbor1	chr3	183889221	183889249	LTR/ERVL	1310	+	14	183889235	68959
chr3	183820276	184020276	harbor1	chr3	183889535	183889809	LTR/ERVL	1310	+	137	183889672	69396
chr3	183820276	184020276	harbor1	chr3	183890219	183890288	LTR/ERVL	795	+	34	183890253	69977
chr3	183820276	184020276	harbor1	chr3	183890885	183891065	LTR/ERVL	795	+	90	183890975	70699
chr3	126257099	126457099	harbor1	chr3	126282414	126282429	LTR/ERVL	4118	+	8	126282422	25323
chr3	126257099	126457099	harbor1	chr3	126282477	126283289	LTR/ERVL	4118	+	406	126282883	25784
chr3	23710865	23910865	harbor1	chr3	23729611	23729960	LTR/ERVL	745	+	174	23729785	18920
chr3	23710865	23910865	harbor1	chr3	23775239	23775651	LTR/ERVL	1395	+	206	23775445	64580
chr3	129021178	129221178	harbor1	chr3	129065773	129066179	LTR/ERVL	2018	+	203	129065976	44798
chr3	129021178	129221178	harbor1	chr3	129101852	129102178	LTR/ERVL	545	+	163	129102015	80837
chr3	184216377	184416377	harbor1	chr3	184225023	184225216	LTR/ERVL	726	+	96	184225119	8742
chr3	184216377	184416377	harbor1	chr3	184225247	184225284	LTR/ERVL	726	+	18	184225265	8888
chr3	52830611	53030611	harbor1	chr3	52873655	52874000	LTR/ERVL	584	+	172	52873827	43216
chr3	52830611	53030611	harbor1	chr3	52914820	52915245	LTR/ERVL	1317	+	212	52915032	84421
chr3	52830611	53030611	harbor1	chr3	52854077	52854951	LTR/ERVL	3688	+	437	52854514	23903
chr3	123544722	123744722	harbor1	chr3	123553476	123553916	LTR/ERVL	1098	+	220	123553696	8974
chr3	123544722	123744722	harbor1	chr3	123573545	123573755	LTR/ERVL	665	+	105	123573650	28928
chr3	123544722	123744722	harbor1	chr3	123600940	123601490	LTR/ERVL	2132	+	275	123601215	56493
chr3	123544722	123744722	harbor1	chr3	123602293	123602600	LTR/ERVL	2105	+	154	123602447	57725
chr3	123544722	123744722	harbor1	chr3	123608666	123608971	LTR/ERVL	878	+	152	123608818	64096
chr3	49071612	49271612	harbor1	chr3	49170199	49170644	LTR/ERVL	1232	+	222	49170421	98809
chr3	50401005	50601005	harbor1	chr3	50451979	50452366	LTR/ERVL	1264	+	194	50452173	51168
chr3	50401005	50601005	harbor1	chr3	50452749	50452999	LTR/ERVL	490	+	125	50452874	51869
chr3	123544636	123744636	harbor1	chr3	123553476	123553916	LTR/ERVL	1098	+	220	123553696	9060
chr3	123544636	123744636	harbor1	chr3	123573545	123573755	LTR/ERVL	665	+	105	123573650	29014
chr3	123544636	123744636	harbor1	chr3	123600940	123601490	LTR/ERVL	2132	+	275	123601215	56579
chr3	123544636	123744636	harbor1	chr3	123602293	123602600	LTR/ERVL	2105	+	154	123602447	57811
chr3	123544636	123744636	harbor1	chr3	123608666	123608971	LTR/ERVL	878	+	152	123608818	64182
chr3	156575295	156775295	harbor1	chr3	156604509	156605011	LTR/ERVL	2630	+	251	156604760	29465
chr3	156575295	156775295	harbor1	chr3	156620366	156620695	LTR/ERVL	2283	+	164	156620530	45235
chr3	156575295	156775295	harbor1	chr3	156620710	156620991	LTR/ERVL	1802	+	140	156620850	45555
chr3	156575295	156775295	harbor1	chr3	156620989	156626236	LTR/ERVL	34252	+	2624	156623613	48318
chr3	156575295	156775295	harbor1	chr3	156626238	156626577	LTR/ERVL	2449	+	170	156626408	51113
chr3	126928935	127128935	harbor1	chr3	127009990	127010215	LTR/ERVL	940	+	112	127010102	81167
chr3	126928935	127128935	harbor1	chr3	127010215	127010431	LTR/ERVL	752	+	108	127010323	81388
chr3	193971532	194171532	harbor1	chr3	193992508	193992748	LTR/ERVL	763	+	120	193992628	21096
chr3	193971532	194171532	harbor1	chr3	194007715	194008246	LTR/ERVL	2349	+	266	194007981	36449
chr3	193971532	194171532	harbor1	chr3	194044962	194045399	LTR/ERVL	1035	+	218	194045180	73648
chr3	47681953	47881953	harbor1	chr3	47752416	47752504	LTR/ERVL	857	+	44	47752460	70507
chr3	47681953	47881953	harbor1	chr3	47752778	47753034	LTR/ERVL	857	+	128	47752906	70953
chr3	50093141	50293141	harbor1	chr3	50129291	50129651	LTR/ERVL	2565	+	180	50129471	36330
chr3	50093141	50293141	harbor1	chr3	50129951	50129978	LTR/ERVL	2565	+	14	50129965	36824
chr3	50093141	50293141	harbor1	chr3	50130292	50130349	LTR/ERVL	2565	+	28	50130320	37179
chr3	127490203	127690203	harbor1	chr3	127527079	127527488	LTR/ERVL	1203	+	204	127527283	37080
chr3	127490203	127690203	harbor1	chr3	127540128	127540464	LTR/ERVL	1450	+	168	127540296	50093
chr3	64289146	64489146	harbor1	chr3	64304424	64305005	LTR/ERVL	2382	+	290	64304714	15568
chr3	64289146	64489146	harbor1	chr3	64305177	64305434	LTR/ERVL	2382	+	128	64305305	16159
chr3	64289146	64489146	harbor1	chr3	64315886	64316779	LTR/ERVL	4615	+	446	64316332	27186
chr3	64289146	64489146	harbor1	chr3	64328102	64328527	LTR/ERVL	2149	+	212	64328314	39168
chr3	64289146	64489146	harbor1	chr3	64358573	64359002	LTR/ERVL	1788	+	214	64358787	69641
chr3	161005344	161205344	harbor1	chr3	161095356	161095941	LTR/ERVL	2218	+	292	161095648	90304
chr3	197859739	198059739	harbor1	chr3	197906039	197906279	LTR/ERVL	837	+	120	197906159	46420
chr3	197859739	198059739	harbor1	chr3	197926549	197926950	LTR/ERVL	1139	+	200	197926749	67010
chr3	197859739	198059739	harbor1	chr3	197947704	197947878	LTR/ERVL	595	+	87	197947791	88052
chr3	12867501	13067501	harbor1	chr3	12885369	12885864	LTR/ERVL	1280	+	248	12885617	18116
chr3	49770828	49970828	harbor1	chr3	49772392	49772409	LTR/ERVL	437	+	8	49772400	1572
chr3	49770828	49970828	harbor1	chr3	49772703	49772766	LTR/ERVL	437	+	32	49772735	1907
chr3	134227277	134427277	harbor1	chr3	134323871	134324215	LTR/ERVL	864	+	172	134324043	96766
chr3	51859972	52059972	harbor1	chr3	51868926	51869005	LTR/ERVL	1983	+	40	51868966	8994
chr3	51859972	52059972	harbor1	chr3	51869373	51869701	LTR/ERVL	1983	+	164	51869537	9565
chr3	49730589	49930589	harbor1	chr3	49772392	49772409	LTR/ERVL	437	+	8	49772400	41811
chr3	49730589	49930589	harbor1	chr3	49772703	49772766	LTR/ERVL	437	+	32	49772735	42146
chr3	23710941	23910941	harbor1	chr3	23729611	23729960	LTR/ERVL	745	+	174	23729785	18844
chr3	23710941	23910941	harbor1	chr3	23775239	23775651	LTR/ERVL	1395	+	206	23775445	64504
chr3	49829614	50029614	harbor1	chr3	49888864	49889239	LTR/ERVL	1179	+	188	49889052	59438
chr3	123544621	123744621	harbor1	chr3	123553476	123553916	LTR/ERVL	1098	+	220	123553696	9075
chr3	123544621	123744621	harbor1	chr3	123573545	123573755	LTR/ERVL	665	+	105	123573650	29029
chr3	123544621	123744621	harbor1	chr3	123600940	123601490	LTR/ERVL	2132	+	275	123601215	56594
chr3	123544621	123744621	harbor1	chr3	123602293	123602600	LTR/ERVL	2105	+	154	123602447	57826
chr3	123544621	123744621	harbor1	chr3	123608666	123608971	LTR/ERVL	878	+	152	123608818	64197
chr3	49071664	49271664	harbor1	chr3	49170199	49170644	LTR/ERVL	1232	+	222	49170421	98757
chr3	138334644	138534644	harbor1	chr3	138334856	138335364	LTR/ERVL	2026	+	254	138335110	466
chr3	138334644	138534644	harbor1	chr3	138339350	138339522	LTR/ERVL	628	+	86	138339436	4792
chr3	138334644	138534644	harbor1	chr3	138341428	138341708	LTR/ERVL	921	+	140	138341568	6924
chr3	138334644	138534644	harbor1	chr3	138424814	138425205	LTR/ERVL	2189	+	196	138425010	90366
chr3	138334644	138534644	harbor1	chr3	138425754	138425846	LTR/ERVL	2189	+	46	138425800	91156
chr3	129021082	129221082	harbor1	chr3	129065773	129066179	LTR/ERVL	2018	+	203	129065976	44894
chr3	129021082	129221082	harbor1	chr3	129101852	129102178	LTR/ERVL	545	+	163	129102015	80933
chr3	124955501	125155501	harbor1	chr3	125003458	125003685	LTR/ERVL	989	+	114	125003572	48071
chr3	124955501	125155501	harbor1	chr3	125003699	125004041	LTR/ERVL	1506	+	171	125003870	48369
chr3	23710436	23910436	harbor1	chr3	23729611	23729960	LTR/ERVL	745	+	174	23729785	19349
chr3	23710436	23910436	harbor1	chr3	23775239	23775651	LTR/ERVL	1395	+	206	23775445	65009
chr3	184085733	184285733	harbor1	chr3	184112171	184112275	LTR/ERVL	687	+	52	184112223	26490
chr3	129875059	130075059	harbor1	chr3	129925192	129925550	LTR/ERVL	1111	+	179	129925371	50312
chr3	129021083	129221083	harbor1	chr3	129065773	129066179	LTR/ERVL	2018	+	203	129065976	44893
chr3	129021083	129221083	harbor1	chr3	129101852	129102178	LTR/ERVL	545	+	163	129102015	80932
chr3	127489843	127689843	harbor1	chr3	127527079	127527488	LTR/ERVL	1203	+	204	127527283	37440
chr3	127489843	127689843	harbor1	chr3	127540128	127540464	LTR/ERVL	1450	+	168	127540296	50453
chr3	123349837	123549837	harbor1	chr3	123405936	123406484	LTR/ERVL	3253	+	274	123406210	56373
chr3	123349837	123549837	harbor1	chr3	123418197	123418336	LTR/ERVL	2919	+	70	123418267	68430
chr3	123349837	123549837	harbor1	chr3	123418770	123419145	LTR/ERVL	2919	+	188	123418958	69121
chr3	49071660	49271660	harbor1	chr3	49170199	49170644	LTR/ERVL	1232	+	222	49170421	98761
chr3	195796157	195996157	harbor1	chr3	195815496	195815784	LTR/ERVL	584	+	144	195815640	19483
chr3	195796157	195996157	harbor1	chr3	195849608	195849777	LTR/ERVL	596	+	84	195849692	53535
chr3	127560407	127760407	harbor1	chr3	127593439	127594637	LTR/ERVL	1782	+	599	127594038	33631
chr3	49071688	49271688	harbor1	chr3	49170199	49170644	LTR/ERVL	1232	+	222	49170421	98733
chr3	49071644	49271644	harbor1	chr3	49170199	49170644	LTR/ERVL	1232	+	222	49170421	98777
chr4	582955	782955	harbor1	chr4	617717	618131	LTR/ERVL	1714	+	207	617924	34969
chr4	38767776	38967776	harbor1	chr4	38770302	38770728	LTR/ERVL	2992	+	213	38770515	2739
chr4	38767776	38967776	harbor1	chr4	38802710	38803297	LTR/ERVL	3120	+	294	38803004	35228
chr4	38767776	38967776	harbor1	chr4	38811806	38811999	LTR/ERVL	1307	+	96	38811902	44126
chr4	98039583	98239583	harbor1	chr4	98072743	98072881	LTR/ERVL	679	+	69	98072812	33229
chr4	98039583	98239583	harbor1	chr4	98111636	98112137	LTR/ERVL	3129	+	250	98111886	72303
chr4	98039583	98239583	harbor1	chr4	98112504	98112543	LTR/ERVL	3129	+	20	98112524	72941
chr4	102218940	102418940	harbor1	chr4	102257765	102258048	LTR/ERVL	990	+	142	102257907	38967
chr4	102218940	102418940	harbor1	chr4	102271200	102271959	LTR/ERVL	996	+	380	102271580	52640
chr4	102218940	102418940	harbor1	chr4	102279161	102279711	LTR/ERVL	1067	+	275	102279436	60496
chr4	102218940	102418940	harbor1	chr4	102279916	102280314	LTR/ERVL	651	+	199	102280115	61175
chr4	551186	751186	harbor1	chr4	557230	557623	LTR/ERVL	2676	+	196	557426	6240
chr4	551186	751186	harbor1	chr4	617717	618131	LTR/ERVL	1714	+	207	617924	66738
chr4	3569607	3769607	harbor1	chr4	3584411	3584750	LTR/ERVL	1458	+	170	3584581	14974
chr4	3569607	3769607	harbor1	chr4	3585036	3585058	LTR/ERVL	1458	+	11	3585047	15440
chr4	38573151	38773151	harbor1	chr4	38603262	38603346	LTR/ERVL	1464	+	42	38603304	30153
chr4	38573151	38773151	harbor1	chr4	38603669	38604070	LTR/ERVL	1464	+	200	38603869	30718
chr4	55288238	55488238	harbor1	chr4	55289749	55290091	LTR/ERVL	1591	+	171	55289920	1682
chr4	55288238	55488238	harbor1	chr4	55385774	55386120	LTR/ERVL	1706	+	173	55385947	97709
chr4	910896	1110896	harbor1	chr4	981650	981816	LTR/ERVL	2422	+	83	981733	70837
chr4	910896	1110896	harbor1	chr4	982119	982755	LTR/ERVL	2422	+	318	982437	71541
chr4	120822742	121022742	harbor1	chr4	120834201	120834217	LTR/ERVL	1937	+	8	120834209	11467
chr4	120822742	121022742	harbor1	chr4	120834583	120834988	LTR/ERVL	1937	+	202	120834785	12043
chr4	120822742	121022742	harbor1	chr4	120852247	120852648	LTR/ERVL	1606	+	200	120852447	29705
chr4	120822742	121022742	harbor1	chr4	120862543	120862876	LTR/ERVL	2314	+	166	120862709	39967
chr4	120822742	121022742	harbor1	chr4	120863177	120863191	LTR/ERVL	2314	+	7	120863184	40442
chr4	120822742	121022742	harbor1	chr4	120863227	120863460	LTR/ERVL	2314	+	116	120863343	40601
chr4	120822742	121022742	harbor1	chr4	120905319	120905744	LTR/ERVL	1522	+	212	120905531	82789
chr4	2361876	2561876	harbor1	chr4	2363239	2363809	LTR/ERVL	1713	+	285	2363524	1648
chr4	189957450	190157450	harbor1	chr4	190008700	190009279	LTR/ERVL	3724	+	290	190008990	51540
chr4	120821303	121021303	harbor1	chr4	120834201	120834217	LTR/ERVL	1937	+	8	120834209	12906
chr4	120821303	121021303	harbor1	chr4	120834583	120834988	LTR/ERVL	1937	+	202	120834785	13482
chr4	120821303	121021303	harbor1	chr4	120852247	120852648	LTR/ERVL	1606	+	200	120852447	31144
chr4	120821303	121021303	harbor1	chr4	120862543	120862876	LTR/ERVL	2314	+	166	120862709	41406
chr4	120821303	121021303	harbor1	chr4	120863177	120863191	LTR/ERVL	2314	+	7	120863184	41881
chr4	120821303	121021303	harbor1	chr4	120863227	120863460	LTR/ERVL	2314	+	116	120863343	42040
chr4	120821303	121021303	harbor1	chr4	120905319	120905744	LTR/ERVL	1522	+	212	120905531	84228
chr4	120822671	121022671	harbor1	chr4	120834201	120834217	LTR/ERVL	1937	+	8	120834209	11538
chr4	120822671	121022671	harbor1	chr4	120834583	120834988	LTR/ERVL	1937	+	202	120834785	12114
chr4	120822671	121022671	harbor1	chr4	120852247	120852648	LTR/ERVL	1606	+	200	120852447	29776
chr4	120822671	121022671	harbor1	chr4	120862543	120862876	LTR/ERVL	2314	+	166	120862709	40038
chr4	120822671	121022671	harbor1	chr4	120863177	120863191	LTR/ERVL	2314	+	7	120863184	40513
chr4	120822671	121022671	harbor1	chr4	120863227	120863460	LTR/ERVL	2314	+	116	120863343	40672
chr4	120822671	121022671	harbor1	chr4	120905319	120905744	LTR/ERVL	1522	+	212	120905531	82860
chr4	2317159	2517159	harbor1	chr4	2335069	2335527	LTR/ERVL	1238	+	229	2335298	18139
chr4	2317159	2517159	harbor1	chr4	2350489	2351307	LTR/ERVL	3173	+	409	2350898	33739
chr4	2317159	2517159	harbor1	chr4	2363239	2363809	LTR/ERVL	1713	+	285	2363524	46365
chr4	11269110	11469110	harbor1	chr4	11274814	11275249	LTR/ERVL	782	+	218	11275032	5922
chr4	910971	1110971	harbor1	chr4	981650	981816	LTR/ERVL	2422	+	83	981733	70762
chr4	910971	1110971	harbor1	chr4	982119	982755	LTR/ERVL	2422	+	318	982437	71466
chr4	102919713	103119713	harbor1	chr4	102933095	102933418	LTR/ERVL	785	+	162	102933257	13544
chr4	102919713	103119713	harbor1	chr4	102955960	102956315	LTR/ERVL	1807	+	178	102956138	36425
chr4	98160943	98360943	harbor1	chr4	98167291	98168079	LTR/ERVL	3961	+	394	98167685	6742
chr4	98160943	98360943	harbor1	chr4	98175127	98175562	LTR/ERVL	3464	+	218	98175345	14402
chr4	98160943	98360943	harbor1	chr4	98201843	98202039	LTR/ERVL	618	+	98	98201941	40998
chr4	98160943	98360943	harbor1	chr4	98224716	98225169	LTR/ERVL	2624	+	226	98224942	63999
chr4	98160943	98360943	harbor1	chr4	98250743	98250994	LTR/ERVL	531	+	126	98250869	89926
chr4	187835400	188035400	harbor1	chr4	187850843	187851055	LTR/ERVL	823	+	106	187850949	15549
chr4	187835400	188035400	harbor1	chr4	187883176	187883570	LTR/ERVL	1164	+	197	187883373	47973
chr4	2363070	2563070	harbor1	chr4	2363239	2363809	LTR/ERVL	1713	+	285	2363524	454
chr4	2151076	2351076	harbor1	chr4	2166446	2166994	LTR/ERVL	2642	+	274	2166720	15644
chr4	2151076	2351076	harbor1	chr4	2220065	2220759	LTR/ERVL	1413	+	347	2220412	69336
chr4	2363106	2563106	harbor1	chr4	2363239	2363809	LTR/ERVL	1713	+	285	2363524	418
chr4	15581887	15781887	harbor1	chr4	15677257	15678023	LTR/ERVL	2078	+	383	15677640	95753
chr4	3569499	3769499	harbor1	chr4	3584411	3584750	LTR/ERVL	1458	+	170	3584581	15082
chr4	3569499	3769499	harbor1	chr4	3585036	3585058	LTR/ERVL	1458	+	11	3585047	15548
chr4	69927953	70127953	harbor1	chr4	69984028	69984200	LTR/ERVL	959	+	86	69984114	56161
chr4	69927953	70127953	harbor1	chr4	69984341	69984550	LTR/ERVL	608	+	104	69984445	56492
chr4	120822652	121022652	harbor1	chr4	120834201	120834217	LTR/ERVL	1937	+	8	120834209	11557
chr4	120822652	121022652	harbor1	chr4	120834583	120834988	LTR/ERVL	1937	+	202	120834785	12133
chr4	120822652	121022652	harbor1	chr4	120852247	120852648	LTR/ERVL	1606	+	200	120852447	29795
chr4	120822652	121022652	harbor1	chr4	120862543	120862876	LTR/ERVL	2314	+	166	120862709	40057
chr4	120822652	121022652	harbor1	chr4	120863177	120863191	LTR/ERVL	2314	+	7	120863184	40532
chr4	120822652	121022652	harbor1	chr4	120863227	120863460	LTR/ERVL	2314	+	116	120863343	40691
chr4	120822652	121022652	harbor1	chr4	120905319	120905744	LTR/ERVL	1522	+	212	120905531	82879
chr4	1349026	1549026	harbor1	chr4	1447015	1447329	LTR/ERVL	847	+	157	1447172	98146
chr4	2656061	2856061	harbor1	chr4	2737628	2738039	LTR/ERVL	3215	+	206	2737834	81773
chr4	2656061	2856061	harbor1	chr4	2738042	2739874	LTR/ERVL	17885	+	916	2738958	82897
chr4	2656061	2856061	harbor1	chr4	2740175	2740627	LTR/ERVL	17885	+	226	2740401	84340
chr4	2656061	2856061	harbor1	chr4	2740929	2741098	LTR/ERVL	17885	+	84	2741013	84952
chr4	2656061	2856061	harbor1	chr4	2741101	2741531	LTR/ERVL	3383	+	215	2741316	85255
chr4	910985	1110985	harbor1	chr4	981650	981816	LTR/ERVL	2422	+	83	981733	70748
chr4	910985	1110985	harbor1	chr4	982119	982755	LTR/ERVL	2422	+	318	982437	71452
chr4	910965	1110965	harbor1	chr4	981650	981816	LTR/ERVL	2422	+	83	981733	70768
chr4	910965	1110965	harbor1	chr4	982119	982755	LTR/ERVL	2422	+	318	982437	71472
chr4	86404939	86604939	harbor1	chr4	86432933	86433173	LTR/ERVL	582	+	120	86433053	28114
chr4	86404939	86604939	harbor1	chr4	86433230	86433506	LTR/ERVL	713	+	138	86433368	28429
chr4	86404939	86604939	harbor1	chr4	86498269	86498399	LTR/ERVL	482	+	65	86498334	93395
chr4	103098519	103298519	harbor1	chr4	103098425	103098868	LTR/ERVL	1461	+	222	103098647	128
chr4	103098519	103298519	harbor1	chr4	103101908	103102332	LTR/ERVL	2085	+	212	103102120	3601
chr4	103098519	103298519	harbor1	chr4	103102837	103102961	LTR/ERVL	5133	+	62	103102899	4380
chr4	103098519	103298519	harbor1	chr4	103103205	103103346	LTR/ERVL	5133	+	70	103103275	4756
chr4	103098519	103298519	harbor1	chr4	103103642	103104007	LTR/ERVL	5133	+	182	103103824	5305
chr4	103098519	103298519	harbor1	chr4	103104306	103104683	LTR/ERVL	5133	+	188	103104494	5975
chr4	1756089	1956089	harbor1	chr4	1839574	1839778	LTR/ERVL	929	+	102	1839676	83587
chr4	1756089	1956089	harbor1	chr4	1839779	1840020	LTR/ERVL	1915	+	120	1839899	83810
chr4	1756089	1956089	harbor1	chr4	1840076	1840095	LTR/ERVL	1915	+	10	1840086	83997
chr4	1756089	1956089	harbor1	chr4	1840692	1840974	LTR/ERVL	1915	+	141	1840833	84744
chr4	550827	750827	harbor1	chr4	557230	557623	LTR/ERVL	2676	+	196	557426	6599
chr4	550827	750827	harbor1	chr4	617717	618131	LTR/ERVL	1714	+	207	617924	67097
chr4	8230062	8430062	harbor1	chr4	8248457	8248614	LTR/ERVL	1218	+	78	8248535	18473
chr4	8230062	8430062	harbor1	chr4	8257778	8257988	LTR/ERVL	912	+	105	8257883	27821
chr4	8230062	8430062	harbor1	chr4	8258339	8258555	LTR/ERVL	912	+	108	8258447	28385
chr4	8230062	8430062	harbor1	chr4	8325693	8325882	LTR/ERVL	591	+	94	8325787	95725
chr4	8230062	8430062	harbor1	chr4	8322754	8323192	LTR/ERVL	2098	+	219	8322973	92911
chr4	910306	1110306	harbor1	chr4	981650	981816	LTR/ERVL	2422	+	83	981733	71427
chr4	910306	1110306	harbor1	chr4	982119	982755	LTR/ERVL	2422	+	318	982437	72131
chr4	98145495	98345495	harbor1	chr4	98167291	98168079	LTR/ERVL	3961	+	394	98167685	22190
chr4	98145495	98345495	harbor1	chr4	98175127	98175562	LTR/ERVL	3464	+	218	98175345	29850
chr4	98145495	98345495	harbor1	chr4	98201843	98202039	LTR/ERVL	618	+	98	98201941	56446
chr4	98145495	98345495	harbor1	chr4	98224716	98225169	LTR/ERVL	2624	+	226	98224942	79447
chr4	67487456	67687456	harbor1	chr4	67511473	67512001	LTR/ERVL	2554	+	264	67511737	24281
chr4	67487456	67687456	harbor1	chr4	67531374	67531851	LTR/ERVL	1805	+	238	67531612	44156
chr4	76846562	77046562	harbor1	chr4	76864060	76864381	LTR/ERVL	748	+	160	76864220	17658
chr4	76846562	77046562	harbor1	chr4	76878648	76879200	LTR/ERVL	2169	+	276	76878924	32362
chr4	76846562	77046562	harbor1	chr4	76885264	76885446	LTR/ERVL	750	+	91	76885355	38793
chr4	76846562	77046562	harbor1	chr4	76924185	76924981	LTR/ERVL	2367	+	398	76924583	78021
chr4	76846562	77046562	harbor1	chr4	76927084	76927389	LTR/ERVL	795	+	152	76927236	80674
chr4	76846562	77046562	harbor1	chr4	76932984	76933368	LTR/ERVL	1062	+	192	76933176	86614
chr4	2314181	2514181	harbor1	chr4	2335069	2335527	LTR/ERVL	1238	+	229	2335298	21117
chr4	2314181	2514181	harbor1	chr4	2350489	2351307	LTR/ERVL	3173	+	409	2350898	36717
chr4	2314181	2514181	harbor1	chr4	2363239	2363809	LTR/ERVL	1713	+	285	2363524	49343
chr4	189957491	190157491	harbor1	chr4	190008700	190009279	LTR/ERVL	3724	+	290	190008990	51499
chr4	55295888	55495888	harbor1	chr4	55385774	55386120	LTR/ERVL	1706	+	173	55385947	90059
chr4	189956178	190156178	harbor1	chr4	190008700	190009279	LTR/ERVL	3724	+	290	190008990	52812
chr5	113414289	113614289	harbor1	chr5	113428311	113428681	LTR/ERVL	1214	+	185	113428496	14207
chr5	113414289	113614289	harbor1	chr5	113431554	113431637	LTR/ERVL	488	+	42	113431596	17307
chr5	159190926	159390926	harbor1	chr5	159254795	159255042	LTR/ERVL	2005	+	124	159254919	63993
chr5	159190926	159390926	harbor1	chr5	159255418	159255704	LTR/ERVL	2005	+	143	159255561	64635
chr5	73350908	73550908	harbor1	chr5	73395554	73397440	LTR/ERVL	9098	+	943	73396497	45589
chr5	73350908	73550908	harbor1	chr5	73397441	73398002	LTR/ERVL	1348	+	280	73397721	46813
chr5	73350908	73550908	harbor1	chr5	73426255	73426780	LTR/ERVL	2886	+	262	73426517	75609
chr5	135435228	135635228	harbor1	chr5	135442746	135443256	LTR/ERVL	1000	+	255	135443001	7773
chr5	10337580	10537580	harbor1	chr5	10338272	10338725	LTR/ERVL	3085	+	226	10338498	918
chr5	150964868	151164868	harbor1	chr5	151000078	151000460	LTR/ERVL	959	+	191	151000269	35401
chr5	150964868	151164868	harbor1	chr5	151014808	151015352	LTR/ERVL	2646	+	272	151015080	50212
chr5	150964868	151164868	harbor1	chr5	151016043	151016486	LTR/ERVL	1932	+	222	151016265	51397
chr5	73350879	73550879	harbor1	chr5	73395554	73397440	LTR/ERVL	9098	+	943	73396497	45618
chr5	73350879	73550879	harbor1	chr5	73397441	73398002	LTR/ERVL	1348	+	280	73397721	46842
chr5	73350879	73550879	harbor1	chr5	73426255	73426780	LTR/ERVL	2886	+	262	73426517	75638
chr5	10337987	10537987	harbor1	chr5	10338272	10338725	LTR/ERVL	3085	+	226	10338498	511
chr5	73351482	73551482	harbor1	chr5	73395554	73397440	LTR/ERVL	9098	+	943	73396497	45015
chr5	73351482	73551482	harbor1	chr5	73397441	73398002	LTR/ERVL	1348	+	280	73397721	46239
chr5	73351482	73551482	harbor1	chr5	73426255	73426780	LTR/ERVL	2886	+	262	73426517	75035
chr5	6723084	6923084	harbor1	chr5	6783820	6784320	LTR/ERVL	2282	+	250	6784070	60986
chr5	6533035	6733035	harbor1	chr5	6537900	6538183	LTR/ERVL	1613	+	142	6538042	5007
chr5	6533035	6733035	harbor1	chr5	6557371	6557817	LTR/ERVL	817	+	223	6557594	24559
chr5	6533035	6733035	harbor1	chr5	6572513	6572798	LTR/ERVL	560	+	142	6572655	39620
chr5	6533035	6733035	harbor1	chr5	6591912	6592235	LTR/ERVL	751	+	162	6592074	59039
chr5	6533035	6733035	harbor1	chr5	6595445	6595958	LTR/ERVL	2363	+	256	6595701	62666
chr5	6533035	6733035	harbor1	chr5	6613689	6613801	LTR/ERVL	461	+	56	6613745	80710
chr5	6533035	6733035	harbor1	chr5	6569609	6570026	LTR/ERVL	3100	+	208	6569817	36782
chr5	52688052	52888052	harbor1	chr5	52702003	52702540	LTR/ERVL	2082	+	268	52702271	14219
chr5	52688052	52888052	harbor1	chr5	52714551	52714759	LTR/ERVL	621	+	104	52714655	26603
chr5	135919218	136119218	harbor1	chr5	135924622	135925210	LTR/ERVL	2020	+	294	135924916	5698
chr5	135919218	136119218	harbor1	chr5	135986067	135986327	LTR/ERVL	1059	+	130	135986197	66979
chr5	73351497	73551497	harbor1	chr5	73395554	73397440	LTR/ERVL	9098	+	943	73396497	45000
chr5	73351497	73551497	harbor1	chr5	73397441	73398002	LTR/ERVL	1348	+	280	73397721	46224
chr5	73351497	73551497	harbor1	chr5	73426255	73426780	LTR/ERVL	2886	+	262	73426517	75020
chr5	133502807	133702807	harbor1	chr5	133539868	133540242	LTR/ERVL	1752	+	187	133540055	37248
chr5	133502807	133702807	harbor1	chr5	133547921	133548401	LTR/ERVL	1289	+	240	133548161	45354
chr5	73351070	73551070	harbor1	chr5	73395554	73397440	LTR/ERVL	9098	+	943	73396497	45427
chr5	73351070	73551070	harbor1	chr5	73397441	73398002	LTR/ERVL	1348	+	280	73397721	46651
chr5	73351070	73551070	harbor1	chr5	73426255	73426780	LTR/ERVL	2886	+	262	73426517	75447
chr5	133905039	134105039	harbor1	chr5	133909956	133910354	LTR/ERVL	1892	+	199	133910155	5116
chr5	133905039	134105039	harbor1	chr5	133932730	133933224	LTR/ERVL	2602	+	247	133932977	27938
chr5	133905039	134105039	harbor1	chr5	133983644	133983702	LTR/ERVL	434	+	29	133983673	78634
chr5	133905039	134105039	harbor1	chr5	133984964	133985256	LTR/ERVL	1893	+	146	133985110	80071
chr5	133905039	134105039	harbor1	chr5	133999419	133999688	LTR/ERVL	1046	+	134	133999553	94514
chr5	82647609	82847609	harbor1	chr5	82705316	82705510	LTR/ERVL	1276	+	97	82705413	57804
chr5	82647609	82847609	harbor1	chr5	82729134	82729350	LTR/ERVL	430	+	108	82729242	81633
chr5	82647609	82847609	harbor1	chr5	82740064	82740459	LTR/ERVL	848	+	198	82740262	92653
chr5	82647609	82847609	harbor1	chr5	82740457	82740936	LTR/ERVL	919	+	240	82740697	93088
chr5	132193610	132393610	harbor1	chr5	132202871	132203347	LTR/ERVL	2804	+	238	132203109	9499
chr5	132193610	132393610	harbor1	chr5	132223209	132223263	LTR/ERVL	530	+	27	132223236	29626
chr5	132193610	132393610	harbor1	chr5	132223556	132223675	LTR/ERVL	530	+	60	132223616	30006
chr5	132193610	132393610	harbor1	chr5	132232148	132232634	LTR/ERVL	2915	+	243	132232391	38781
chr5	132193610	132393610	harbor1	chr5	132239030	132239200	LTR/ERVL	709	+	85	132239115	45505
chr5	132193610	132393610	harbor1	chr5	132288494	132288639	LTR/ERVL	702	+	72	132288566	94956
chr5	132193610	132393610	harbor1	chr5	132288665	132289072	LTR/ERVL	611	+	204	132288869	95259
chr5	132193610	132393610	harbor1	chr5	132289119	132289427	LTR/ERVL	516	+	154	132289273	95663
chr5	132193610	132393610	harbor1	chr5	132289440	132289528	LTR/ERVL	1464	+	44	132289484	95874
chr5	132193610	132393610	harbor1	chr5	132289814	132290888	LTR/ERVL	1464	+	537	132290351	96741
chr5	132193610	132393610	harbor1	chr5	132291157	132291570	LTR/ERVL	1332	+	206	132291363	97753
chr5	132193610	132393610	harbor1	chr5	132291870	132292324	LTR/ERVL	1332	+	227	132292097	98487
chr5	52688976	52888976	harbor1	chr5	52702003	52702540	LTR/ERVL	2082	+	268	52702271	13295
chr5	52688976	52888976	harbor1	chr5	52714551	52714759	LTR/ERVL	621	+	104	52714655	25679
chr5	336002	536002	harbor1	chr5	346713	346958	LTR/ERVL	822	+	122	346835	10833
chr5	79136023	79336023	harbor1	chr5	79139387	79139846	LTR/ERVL	937	+	230	79139617	3594
chr5	79136023	79336023	harbor1	chr5	79206034	79206481	LTR/ERVL	649	+	224	79206258	70235
chr5	79136023	79336023	harbor1	chr5	79221568	79221920	LTR/ERVL	804	+	176	79221744	85721
chr5	79136023	79336023	harbor1	chr5	79225183	79225583	LTR/ERVL	1310	+	200	79225383	89360
chr5	79136023	79336023	harbor1	chr5	79227680	79228060	LTR/ERVL	1044	+	190	79227870	91847
chr5	79136023	79336023	harbor1	chr5	79228212	79229807	LTR/ERVL	3112	+	798	79229010	92987
chr5	79136023	79336023	harbor1	chr5	79230925	79231100	LTR/ERVL	657	+	88	79231013	94990
chr5	79136023	79336023	harbor1	chr5	79231101	79231303	LTR/ERVL	883	+	101	79231202	95179
chr5	79136023	79336023	harbor1	chr5	79231610	79231720	LTR/ERVL	883	+	55	79231665	95642
chr5	79136023	79336023	harbor1	chr5	79232019	79232082	LTR/ERVL	883	+	32	79232051	96028
chr5	10151040	10351040	harbor1	chr5	10191041	10191152	LTR/ERVL	440	+	56	10191097	40057
chr5	10151040	10351040	harbor1	chr5	10196808	10197381	LTR/ERVL	2154	+	286	10197094	46054
chr5	10205523	10405523	harbor1	chr5	10278182	10279043	LTR/ERVL	4610	+	430	10278612	73089
chr5	10184091	10384091	harbor1	chr5	10191041	10191152	LTR/ERVL	440	+	56	10191097	7006
chr5	10184091	10384091	harbor1	chr5	10196808	10197381	LTR/ERVL	2154	+	286	10197094	13003
chr5	10184091	10384091	harbor1	chr5	10278182	10279043	LTR/ERVL	4610	+	430	10278612	94521
chr5	10661221	10861221	harbor1	chr5	10672684	10673047	LTR/ERVL	1828	+	182	10672866	11645
chr5	10661221	10861221	harbor1	chr5	10716384	10716832	LTR/ERVL	3087	+	224	10716608	55387
chr5	10661221	10861221	harbor1	chr5	10716833	10717681	LTR/ERVL	6539	+	424	10717257	56036
chr5	10661221	10861221	harbor1	chr5	10717681	10720094	LTR/ERVL	18730	+	1206	10718887	57666
chr5	10661221	10861221	harbor1	chr5	10720111	10720185	LTR/ERVL	416	+	37	10720148	58927
chr5	10661221	10861221	harbor1	chr5	10720334	10722105	LTR/ERVL	13357	+	886	10721220	59999
chr5	10661221	10861221	harbor1	chr5	10722106	10722498	LTR/ERVL	2866	+	196	10722302	61081
chr5	10661221	10861221	harbor1	chr5	10747636	10747809	LTR/ERVL	448	+	86	10747722	86501
chr5	73021050	73221050	harbor1	chr5	73100518	73100693	LTR/ERVL	614	+	88	73100606	79556
chr5	73021050	73221050	harbor1	chr5	73100808	73101046	LTR/ERVL	742	+	119	73100927	79877
chr5	52700111	52900111	harbor1	chr5	52702003	52702540	LTR/ERVL	2082	+	268	52702271	2160
chr5	52700111	52900111	harbor1	chr5	52714551	52714759	LTR/ERVL	621	+	104	52714655	14544
chr5	6533087	6733087	harbor1	chr5	6537900	6538183	LTR/ERVL	1613	+	142	6538042	4955
chr5	6533087	6733087	harbor1	chr5	6557371	6557817	LTR/ERVL	817	+	223	6557594	24507
chr5	6533087	6733087	harbor1	chr5	6572513	6572798	LTR/ERVL	560	+	142	6572655	39568
chr5	6533087	6733087	harbor1	chr5	6591912	6592235	LTR/ERVL	751	+	162	6592074	58987
chr5	6533087	6733087	harbor1	chr5	6595445	6595958	LTR/ERVL	2363	+	256	6595701	62614
chr5	6533087	6733087	harbor1	chr5	6613689	6613801	LTR/ERVL	461	+	56	6613745	80658
chr5	6533087	6733087	harbor1	chr5	6569609	6570026	LTR/ERVL	3100	+	208	6569817	36730
chr5	10333600	10533600	harbor1	chr5	10338272	10338725	LTR/ERVL	3085	+	226	10338498	4898
chr5	73350922	73550922	harbor1	chr5	73395554	73397440	LTR/ERVL	9098	+	943	73396497	45575
chr5	73350922	73550922	harbor1	chr5	73397441	73398002	LTR/ERVL	1348	+	280	73397721	46799
chr5	73350922	73550922	harbor1	chr5	73426255	73426780	LTR/ERVL	2886	+	262	73426517	75595
chr5	10661144	10861144	harbor1	chr5	10672684	10673047	LTR/ERVL	1828	+	182	10672866	11722
chr5	10661144	10861144	harbor1	chr5	10716384	10716832	LTR/ERVL	3087	+	224	10716608	55464
chr5	10661144	10861144	harbor1	chr5	10716833	10717681	LTR/ERVL	6539	+	424	10717257	56113
chr5	10661144	10861144	harbor1	chr5	10717681	10720094	LTR/ERVL	18730	+	1206	10718887	57743
chr5	10661144	10861144	harbor1	chr5	10720111	10720185	LTR/ERVL	416	+	37	10720148	59004
chr5	10661144	10861144	harbor1	chr5	10720334	10722105	LTR/ERVL	13357	+	886	10721220	60076
chr5	10661144	10861144	harbor1	chr5	10722106	10722498	LTR/ERVL	2866	+	196	10722302	61158
chr5	10661144	10861144	harbor1	chr5	10747636	10747809	LTR/ERVL	448	+	86	10747722	86578
chr5	37740447	37940447	harbor1	chr5	37793305	37793724	LTR/ERVL	3102	+	210	37793515	53068
chr5	37740447	37940447	harbor1	chr5	37793725	37795107	LTR/ERVL	33293	+	691	37794416	53969
chr5	37740447	37940447	harbor1	chr5	37795417	37798236	LTR/ERVL	33293	+	1410	37796827	56380
chr5	10186534	10386534	harbor1	chr5	10191041	10191152	LTR/ERVL	440	+	56	10191097	4563
chr5	10186534	10386534	harbor1	chr5	10196808	10197381	LTR/ERVL	2154	+	286	10197094	10560
chr5	10186534	10386534	harbor1	chr5	10278182	10279043	LTR/ERVL	4610	+	430	10278612	92078
chr5	10653254	10853254	harbor1	chr5	10672684	10673047	LTR/ERVL	1828	+	182	10672866	19612
chr5	10653254	10853254	harbor1	chr5	10716384	10716832	LTR/ERVL	3087	+	224	10716608	63354
chr5	10653254	10853254	harbor1	chr5	10716833	10717681	LTR/ERVL	6539	+	424	10717257	64003
chr5	10653254	10853254	harbor1	chr5	10717681	10720094	LTR/ERVL	18730	+	1206	10718887	65633
chr5	10653254	10853254	harbor1	chr5	10720111	10720185	LTR/ERVL	416	+	37	10720148	66894
chr5	10653254	10853254	harbor1	chr5	10720334	10722105	LTR/ERVL	13357	+	886	10721220	67966
chr5	10653254	10853254	harbor1	chr5	10722106	10722498	LTR/ERVL	2866	+	196	10722302	69048
chr5	10653254	10853254	harbor1	chr5	10747636	10747809	LTR/ERVL	448	+	86	10747722	94468
chr5	72733843	72933843	harbor1	chr5	72760323	72760876	LTR/ERVL	2951	+	276	72760599	26756
chr5	73307094	73507094	harbor1	chr5	73317721	73317992	LTR/ERVL	455	+	136	73317857	10763
chr5	73307094	73507094	harbor1	chr5	73395554	73397440	LTR/ERVL	9098	+	943	73396497	89403
chr5	73307094	73507094	harbor1	chr5	73397441	73398002	LTR/ERVL	1348	+	280	73397721	90627
chr5	9289591	9489591	harbor1	chr5	9308161	9308592	LTR/ERVL	996	+	216	9308377	18786
chr5	9289591	9489591	harbor1	chr5	9350337	9350965	LTR/ERVL	2488	+	314	9350651	61060
chr5	9114312	9314312	harbor1	chr5	9127263	9127649	LTR/ERVL	1946	+	193	9127456	13144
chr5	9114312	9314312	harbor1	chr5	9148380	9148712	LTR/ERVL	1097	+	166	9148546	34234
chr5	9114312	9314312	harbor1	chr5	9149019	9149169	LTR/ERVL	1097	+	75	9149094	34782
chr5	79136006	79336006	harbor1	chr5	79139387	79139846	LTR/ERVL	937	+	230	79139617	3611
chr5	79136006	79336006	harbor1	chr5	79206034	79206481	LTR/ERVL	649	+	224	79206258	70252
chr5	79136006	79336006	harbor1	chr5	79221568	79221920	LTR/ERVL	804	+	176	79221744	85738
chr5	79136006	79336006	harbor1	chr5	79225183	79225583	LTR/ERVL	1310	+	200	79225383	89377
chr5	79136006	79336006	harbor1	chr5	79227680	79228060	LTR/ERVL	1044	+	190	79227870	91864
chr5	79136006	79336006	harbor1	chr5	79228212	79229807	LTR/ERVL	3112	+	798	79229010	93004
chr5	79136006	79336006	harbor1	chr5	79230925	79231100	LTR/ERVL	657	+	88	79231013	95007
chr5	79136006	79336006	harbor1	chr5	79231101	79231303	LTR/ERVL	883	+	101	79231202	95196
chr5	79136006	79336006	harbor1	chr5	79231610	79231720	LTR/ERVL	883	+	55	79231665	95659
chr5	79136006	79336006	harbor1	chr5	79232019	79232082	LTR/ERVL	883	+	32	79232051	96045
chr5	10661132	10861132	harbor1	chr5	10672684	10673047	LTR/ERVL	1828	+	182	10672866	11734
chr5	10661132	10861132	harbor1	chr5	10716384	10716832	LTR/ERVL	3087	+	224	10716608	55476
chr5	10661132	10861132	harbor1	chr5	10716833	10717681	LTR/ERVL	6539	+	424	10717257	56125
chr5	10661132	10861132	harbor1	chr5	10717681	10720094	LTR/ERVL	18730	+	1206	10718887	57755
chr5	10661132	10861132	harbor1	chr5	10720111	10720185	LTR/ERVL	416	+	37	10720148	59016
chr5	10661132	10861132	harbor1	chr5	10720334	10722105	LTR/ERVL	13357	+	886	10721220	60088
chr5	10661132	10861132	harbor1	chr5	10722106	10722498	LTR/ERVL	2866	+	196	10722302	61170
chr5	10661132	10861132	harbor1	chr5	10747636	10747809	LTR/ERVL	448	+	86	10747722	86590
chr5	89882308	90082308	harbor1	chr5	89924305	89924668	LTR/ERVL	781	+	182	89924487	42179
chr5	89882308	90082308	harbor1	chr5	89963284	89963711	LTR/ERVL	652	+	214	89963498	81190
chr5	10661219	10861219	harbor1	chr5	10672684	10673047	LTR/ERVL	1828	+	182	10672866	11647
chr5	10661219	10861219	harbor1	chr5	10716384	10716832	LTR/ERVL	3087	+	224	10716608	55389
chr5	10661219	10861219	harbor1	chr5	10716833	10717681	LTR/ERVL	6539	+	424	10717257	56038
chr5	10661219	10861219	harbor1	chr5	10717681	10720094	LTR/ERVL	18730	+	1206	10718887	57668
chr5	10661219	10861219	harbor1	chr5	10720111	10720185	LTR/ERVL	416	+	37	10720148	58929
chr5	10661219	10861219	harbor1	chr5	10720334	10722105	LTR/ERVL	13357	+	886	10721220	60001
chr5	10661219	10861219	harbor1	chr5	10722106	10722498	LTR/ERVL	2866	+	196	10722302	61083
chr5	10661219	10861219	harbor1	chr5	10747636	10747809	LTR/ERVL	448	+	86	10747722	86503
chr5	73338840	73538840	harbor1	chr5	73395554	73397440	LTR/ERVL	9098	+	943	73396497	57657
chr5	73338840	73538840	harbor1	chr5	73397441	73398002	LTR/ERVL	1348	+	280	73397721	58881
chr5	73338840	73538840	harbor1	chr5	73426255	73426780	LTR/ERVL	2886	+	262	73426517	87677
chr5	133511368	133711368	harbor1	chr5	133539868	133540242	LTR/ERVL	1752	+	187	133540055	28687
chr5	133511368	133711368	harbor1	chr5	133547921	133548401	LTR/ERVL	1289	+	240	133548161	36793
chr5	135442075	135642075	harbor1	chr5	135442746	135443256	LTR/ERVL	1000	+	255	135443001	926
chr5	41825178	42025178	harbor1	chr5	41857415	41857804	LTR/ERVL	857	+	194	41857609	32431
chr5	10338301	10538301	harbor1	chr5	10338272	10338725	LTR/ERVL	3085	+	226	10338498	197
chr5	10338313	10538313	harbor1	chr5	10338272	10338725	LTR/ERVL	3085	+	226	10338498	185
chr5	133482188	133682188	harbor1	chr5	133539868	133540242	LTR/ERVL	1752	+	187	133540055	57867
chr5	133482188	133682188	harbor1	chr5	133547921	133548401	LTR/ERVL	1289	+	240	133548161	65973
chr5	9114417	9314417	harbor1	chr5	9127263	9127649	LTR/ERVL	1946	+	193	9127456	13039
chr5	9114417	9314417	harbor1	chr5	9148380	9148712	LTR/ERVL	1097	+	166	9148546	34129
chr5	9114417	9314417	harbor1	chr5	9149019	9149169	LTR/ERVL	1097	+	75	9149094	34677
chr5	73351520	73551520	harbor1	chr5	73395554	73397440	LTR/ERVL	9098	+	943	73396497	44977
chr5	73351520	73551520	harbor1	chr5	73397441	73398002	LTR/ERVL	1348	+	280	73397721	46201
chr5	73351520	73551520	harbor1	chr5	73426255	73426780	LTR/ERVL	2886	+	262	73426517	74997
chr5	171287852	171487852	harbor1	chr5	171332101	171332362	LTR/ERVL	600	+	130	171332231	44379
chr5	171287852	171487852	harbor1	chr5	171332543	171332683	LTR/ERVL	602	+	70	171332613	44761
chr5	171287852	171487852	harbor1	chr5	171356741	171357110	LTR/ERVL	668	+	184	171356925	69073
chr5	171287852	171487852	harbor1	chr5	171357682	171358489	LTR/ERVL	1349	+	404	171358086	70234
chr5	171287852	171487852	harbor1	chr5	171378068	171378196	LTR/ERVL	433	+	64	171378132	90280
chr5	171287852	171487852	harbor1	chr5	171379200	171379339	LTR/ERVL	547	+	70	171379270	91418
chr5	52700146	52900146	harbor1	chr5	52702003	52702540	LTR/ERVL	2082	+	268	52702271	2125
chr5	52700146	52900146	harbor1	chr5	52714551	52714759	LTR/ERVL	621	+	104	52714655	14509
chr5	73351488	73551488	harbor1	chr5	73395554	73397440	LTR/ERVL	9098	+	943	73396497	45009
chr5	73351488	73551488	harbor1	chr5	73397441	73398002	LTR/ERVL	1348	+	280	73397721	46233
chr5	73351488	73551488	harbor1	chr5	73426255	73426780	LTR/ERVL	2886	+	262	73426517	75029
chr5	118403	318403	harbor1	chr5	203849	204319	LTR/ERVL	817	+	235	204084	85681
chr5	118403	318403	harbor1	chr5	217299	217415	LTR/ERVL	584	+	58	217357	98954
chr5	52700057	52900057	harbor1	chr5	52702003	52702540	LTR/ERVL	2082	+	268	52702271	2214
chr5	52700057	52900057	harbor1	chr5	52714551	52714759	LTR/ERVL	621	+	104	52714655	14598
chr5	73351609	73551609	harbor1	chr5	73395554	73397440	LTR/ERVL	9098	+	943	73396497	44888
chr5	73351609	73551609	harbor1	chr5	73397441	73398002	LTR/ERVL	1348	+	280	73397721	46112
chr5	73351609	73551609	harbor1	chr5	73426255	73426780	LTR/ERVL	2886	+	262	73426517	74908
chr5	137653914	137853914	harbor1	chr5	137672986	137673425	LTR/ERVL	2786	+	220	137673206	19292
chr5	4784467	4984467	harbor1	chr5	4785196	4785770	LTR/ERVL	1717	+	287	4785483	1016
chr5	4784467	4984467	harbor1	chr5	4882080	4882530	LTR/ERVL	1520	+	225	4882305	97838
chr5	132773569	132973569	harbor1	chr5	132787307	132787798	LTR/ERVL	2208	+	246	132787553	13984
chr5	132773569	132973569	harbor1	chr5	132788106	132788161	LTR/ERVL	2208	+	28	132788134	14565
chr5	132773569	132973569	harbor1	chr5	132788224	132788503	LTR/ERVL	2208	+	140	132788364	14795
chr5	10661192	10861192	harbor1	chr5	10672684	10673047	LTR/ERVL	1828	+	182	10672866	11674
chr5	10661192	10861192	harbor1	chr5	10716384	10716832	LTR/ERVL	3087	+	224	10716608	55416
chr5	10661192	10861192	harbor1	chr5	10716833	10717681	LTR/ERVL	6539	+	424	10717257	56065
chr5	10661192	10861192	harbor1	chr5	10717681	10720094	LTR/ERVL	18730	+	1206	10718887	57695
chr5	10661192	10861192	harbor1	chr5	10720111	10720185	LTR/ERVL	416	+	37	10720148	58956
chr5	10661192	10861192	harbor1	chr5	10720334	10722105	LTR/ERVL	13357	+	886	10721220	60028
chr5	10661192	10861192	harbor1	chr5	10722106	10722498	LTR/ERVL	2866	+	196	10722302	61110
chr5	10661192	10861192	harbor1	chr5	10747636	10747809	LTR/ERVL	448	+	86	10747722	86530
chr5	73345271	73545271	harbor1	chr5	73395554	73397440	LTR/ERVL	9098	+	943	73396497	51226
chr5	73345271	73545271	harbor1	chr5	73397441	73398002	LTR/ERVL	1348	+	280	73397721	52450
chr5	73345271	73545271	harbor1	chr5	73426255	73426780	LTR/ERVL	2886	+	262	73426517	81246
chr5	133166160	133366160	harbor1	chr5	133191819	133191855	LTR/ERVL	1754	+	18	133191837	25677
chr5	133166160	133366160	harbor1	chr5	133192205	133192290	LTR/ERVL	1754	+	42	133192247	26087
chr5	133166160	133366160	harbor1	chr5	133192598	133192898	LTR/ERVL	1754	+	150	133192748	26588
chr5	133166160	133366160	harbor1	chr5	133240834	133241364	LTR/ERVL	1451	+	265	133241099	74939
chr5	133166160	133366160	harbor1	chr5	133258232	133258516	LTR/ERVL	1713	+	142	133258374	92214
chr5	73350862	73550862	harbor1	chr5	73395554	73397440	LTR/ERVL	9098	+	943	73396497	45635
chr5	73350862	73550862	harbor1	chr5	73397441	73398002	LTR/ERVL	1348	+	280	73397721	46859
chr5	73350862	73550862	harbor1	chr5	73426255	73426780	LTR/ERVL	2886	+	262	73426517	75655
chr5	133206059	133406059	harbor1	chr5	133240834	133241364	LTR/ERVL	1451	+	265	133241099	35040
chr5	133206059	133406059	harbor1	chr5	133258232	133258516	LTR/ERVL	1713	+	142	133258374	52315
chr5	37740476	37940476	harbor1	chr5	37793305	37793724	LTR/ERVL	3102	+	210	37793515	53039
chr5	37740476	37940476	harbor1	chr5	37793725	37795107	LTR/ERVL	33293	+	691	37794416	53940
chr5	37740476	37940476	harbor1	chr5	37795417	37798236	LTR/ERVL	33293	+	1410	37796827	56351
chr5	171287856	171487856	harbor1	chr5	171332101	171332362	LTR/ERVL	600	+	130	171332231	44375
chr5	171287856	171487856	harbor1	chr5	171332543	171332683	LTR/ERVL	602	+	70	171332613	44757
chr5	171287856	171487856	harbor1	chr5	171356741	171357110	LTR/ERVL	668	+	184	171356925	69069
chr5	171287856	171487856	harbor1	chr5	171357682	171358489	LTR/ERVL	1349	+	404	171358086	70230
chr5	171287856	171487856	harbor1	chr5	171378068	171378196	LTR/ERVL	433	+	64	171378132	90276
chr5	171287856	171487856	harbor1	chr5	171379200	171379339	LTR/ERVL	547	+	70	171379270	91414
chr5	73345492	73545492	harbor1	chr5	73395554	73397440	LTR/ERVL	9098	+	943	73396497	51005
chr5	73345492	73545492	harbor1	chr5	73397441	73398002	LTR/ERVL	1348	+	280	73397721	52229
chr5	73345492	73545492	harbor1	chr5	73426255	73426780	LTR/ERVL	2886	+	262	73426517	81025
chr5	73345455	73545455	harbor1	chr5	73395554	73397440	LTR/ERVL	9098	+	943	73396497	51042
chr5	73345455	73545455	harbor1	chr5	73397441	73398002	LTR/ERVL	1348	+	280	73397721	52266
chr5	73345455	73545455	harbor1	chr5	73426255	73426780	LTR/ERVL	2886	+	262	73426517	81062
chr5	9114300	9314300	harbor1	chr5	9127263	9127649	LTR/ERVL	1946	+	193	9127456	13156
chr5	9114300	9314300	harbor1	chr5	9148380	9148712	LTR/ERVL	1097	+	166	9148546	34246
chr5	9114300	9314300	harbor1	chr5	9149019	9149169	LTR/ERVL	1097	+	75	9149094	34794
chr5	4423791	4623791	harbor1	chr5	4458896	4459290	LTR/ERVL	3132	+	197	4459093	35302
chr5	4423791	4623791	harbor1	chr5	4459443	4464212	LTR/ERVL	36048	+	2384	4461827	38036
chr5	4423791	4623791	harbor1	chr5	4464290	4465252	LTR/ERVL	7221	+	481	4464771	40980
chr5	4423791	4623791	harbor1	chr5	4465253	4465702	LTR/ERVL	2916	+	224	4465477	41686
chr5	4423791	4623791	harbor1	chr5	4493180	4493636	LTR/ERVL	1234	+	228	4493408	69617
chr5	52700042	52900042	harbor1	chr5	52702003	52702540	LTR/ERVL	2082	+	268	52702271	2229
chr5	52700042	52900042	harbor1	chr5	52714551	52714759	LTR/ERVL	621	+	104	52714655	14613
chr6	7626958	7826958	harbor1	chr6	7674100	7674671	LTR/ERVL	1086	+	286	7674386	47428
chr6	7626958	7826958	harbor1	chr6	7677028	7677379	LTR/ERVL	2317	+	176	7677204	50246
chr6	7626958	7826958	harbor1	chr6	7677510	7677549	LTR/ERVL	2317	+	20	7677530	50572
chr6	147103351	147303351	harbor1	chr6	147165420	147165865	LTR/ERVL	1974	+	222	147165642	62291
chr6	151352847	151552847	harbor1	chr6	151441268	151442109	LTR/ERVL	3325	+	420	151441688	88841
chr6	7626630	7826630	harbor1	chr6	7674100	7674671	LTR/ERVL	1086	+	286	7674386	47756
chr6	7626630	7826630	harbor1	chr6	7677028	7677379	LTR/ERVL	2317	+	176	7677204	50574
chr6	7626630	7826630	harbor1	chr6	7677510	7677549	LTR/ERVL	2317	+	20	7677530	50900
chr6	124862322	125062322	harbor1	chr6	124917781	124918185	LTR/ERVL	1706	+	202	124917983	55661
chr6	32869543	33069543	harbor1	chr6	32883858	32884205	LTR/ERVL	676	+	174	32884032	14489
chr6	32869543	33069543	harbor1	chr6	32931225	32931649	LTR/ERVL	576	+	212	32931437	61894
chr6	32869543	33069543	harbor1	chr6	32939107	32939521	LTR/ERVL	1468	+	207	32939314	69771
chr6	32869543	33069543	harbor1	chr6	32939748	32940128	LTR/ERVL	1376	+	190	32939938	70395
chr6	28999817	29199817	harbor1	chr6	29012141	29012474	LTR/ERVL	932	+	166	29012307	12490
chr6	28999817	29199817	harbor1	chr6	29012929	29013388	LTR/ERVL	1279	+	230	29013159	13342
chr6	7626969	7826969	harbor1	chr6	7674100	7674671	LTR/ERVL	1086	+	286	7674386	47417
chr6	7626969	7826969	harbor1	chr6	7677028	7677379	LTR/ERVL	2317	+	176	7677204	50235
chr6	7626969	7826969	harbor1	chr6	7677510	7677549	LTR/ERVL	2317	+	20	7677530	50561
chr6	7332945	7532945	harbor1	chr6	7366325	7366841	LTR/ERVL	2355	+	258	7366583	33638
chr6	7332945	7532945	harbor1	chr6	7398962	7399307	LTR/ERVL	706	+	172	7399134	66189
chr6	139275442	139475442	harbor1	chr6	139285693	139285793	LTR/ERVL	726	+	50	139285743	10301
chr6	139275442	139475442	harbor1	chr6	139287058	139287389	LTR/ERVL	2163	+	166	139287224	11782
chr6	45540929	45740929	harbor1	chr6	45621072	45621915	LTR/ERVL	4750	+	422	45621494	80565
chr6	41537009	41737009	harbor1	chr6	41537001	41537453	LTR/ERVL	1401	+	226	41537227	218
chr6	41537009	41737009	harbor1	chr6	41630945	41631472	LTR/ERVL	585	+	264	41631209	94200
chr6	169864030	170064030	harbor1	chr6	169953458	169954304	LTR/ERVL	3116	+	423	169953881	89851
chr6	169864030	170064030	harbor1	chr6	169954339	169954998	LTR/ERVL	3405	+	330	169954669	90639
chr6	139275115	139475115	harbor1	chr6	139285693	139285793	LTR/ERVL	726	+	50	139285743	10628
chr6	139275115	139475115	harbor1	chr6	139287058	139287389	LTR/ERVL	2163	+	166	139287224	12109
chr6	7626955	7826955	harbor1	chr6	7674100	7674671	LTR/ERVL	1086	+	286	7674386	47431
chr6	7626955	7826955	harbor1	chr6	7677028	7677379	LTR/ERVL	2317	+	176	7677204	50249
chr6	7626955	7826955	harbor1	chr6	7677510	7677549	LTR/ERVL	2317	+	20	7677530	50575
chr6	45540939	45740939	harbor1	chr6	45621072	45621915	LTR/ERVL	4750	+	422	45621494	80555
chr6	63473404	63673404	harbor1	chr6	63525227	63525875	LTR/ERVL	1564	+	324	63525551	52147
chr6	139275101	139475101	harbor1	chr6	139285693	139285793	LTR/ERVL	726	+	50	139285743	10642
chr6	139275101	139475101	harbor1	chr6	139287058	139287389	LTR/ERVL	2163	+	166	139287224	12123
chr6	169862720	170062720	harbor1	chr6	169953458	169954304	LTR/ERVL	3116	+	423	169953881	91161
chr6	169862720	170062720	harbor1	chr6	169954339	169954998	LTR/ERVL	3405	+	330	169954669	91949
chr6	41091927	41291927	harbor1	chr6	41155189	41155303	LTR/ERVL	547	+	57	41155246	63319
chr6	41091927	41291927	harbor1	chr6	41155333	41155375	LTR/ERVL	814	+	21	41155354	63427
chr6	41091927	41291927	harbor1	chr6	41155407	41155576	LTR/ERVL	814	+	84	41155491	63564
chr6	41091927	41291927	harbor1	chr6	41170742	41171195	LTR/ERVL	992	+	226	41170968	79041
chr6	139274669	139474669	harbor1	chr6	139285693	139285793	LTR/ERVL	726	+	50	139285743	11074
chr6	139274669	139474669	harbor1	chr6	139287058	139287389	LTR/ERVL	2163	+	166	139287224	12555
chr6	45540991	45740991	harbor1	chr6	45621072	45621915	LTR/ERVL	4750	+	422	45621494	80503
chr6	139272471	139472471	harbor1	chr6	139285693	139285793	LTR/ERVL	726	+	50	139285743	13272
chr6	139272471	139472471	harbor1	chr6	139287058	139287389	LTR/ERVL	2163	+	166	139287224	14753
chr6	35352657	35552657	harbor1	chr6	35432314	35432726	LTR/ERVL	1221	+	206	35432520	79863
chr6	2665180	2865180	harbor1	chr6	2687026	2687401	LTR/ERVL	910	+	188	2687214	22034
chr6	2665180	2865180	harbor1	chr6	2740234	2740692	LTR/ERVL	705	+	229	2740463	75283
chr6	89719739	89919739	harbor1	chr6	89799975	89800145	LTR/ERVL	2469	+	85	89800060	80321
chr6	89719739	89919739	harbor1	chr6	89800455	89800990	LTR/ERVL	2469	+	268	89800723	80984
chr6	7623404	7823404	harbor1	chr6	7674100	7674671	LTR/ERVL	1086	+	286	7674386	50982
chr6	7623404	7823404	harbor1	chr6	7677028	7677379	LTR/ERVL	2317	+	176	7677204	53800
chr6	7623404	7823404	harbor1	chr6	7677510	7677549	LTR/ERVL	2317	+	20	7677530	54126
chr6	6446445	6646445	harbor1	chr6	6454039	6454478	LTR/ERVL	2711	+	220	6454259	7814
chr6	6446445	6646445	harbor1	chr6	6454542	6454592	LTR/ERVL	2711	+	25	6454567	8122
chr6	6446445	6646445	harbor1	chr6	6513120	6513436	LTR/ERVL	535	+	158	6513278	66833
chr6	45533773	45733773	harbor1	chr6	45621072	45621915	LTR/ERVL	4750	+	422	45621494	87721
chr6	127167321	127367321	harbor1	chr6	127223432	127223897	LTR/ERVL	966	+	232	127223664	56343
chr6	127167321	127367321	harbor1	chr6	127239428	127239578	LTR/ERVL	846	+	75	127239503	72182
chr6	127167321	127367321	harbor1	chr6	127249110	127249446	LTR/ERVL	665	+	168	127249278	81957
chr6	127167321	127367321	harbor1	chr6	127249471	127249637	LTR/ERVL	747	+	83	127249554	82233
chr6	139275457	139475457	harbor1	chr6	139285693	139285793	LTR/ERVL	726	+	50	139285743	10286
chr6	139275457	139475457	harbor1	chr6	139287058	139287389	LTR/ERVL	2163	+	166	139287224	11767
chr6	63473429	63673429	harbor1	chr6	63525227	63525875	LTR/ERVL	1564	+	324	63525551	52122
chr6	7626967	7826967	harbor1	chr6	7674100	7674671	LTR/ERVL	1086	+	286	7674386	47419
chr6	7626967	7826967	harbor1	chr6	7677028	7677379	LTR/ERVL	2317	+	176	7677204	50237
chr6	7626967	7826967	harbor1	chr6	7677510	7677549	LTR/ERVL	2317	+	20	7677530	50563
chr6	139275547	139475547	harbor1	chr6	139285693	139285793	LTR/ERVL	726	+	50	139285743	10196
chr6	139275547	139475547	harbor1	chr6	139287058	139287389	LTR/ERVL	2163	+	166	139287224	11677
chr6	139274614	139474614	harbor1	chr6	139285693	139285793	LTR/ERVL	726	+	50	139285743	11129
chr6	139274614	139474614	harbor1	chr6	139287058	139287389	LTR/ERVL	2163	+	166	139287224	12610
chr6	166056777	166256777	harbor1	chr6	166070339	166070867	LTR/ERVL	1208	+	264	166070603	13826
chr6	166056777	166256777	harbor1	chr6	166145443	166145976	LTR/ERVL	2545	+	266	166145709	88932
chr6	166056777	166256777	harbor1	chr6	166153858	166154337	LTR/ERVL	1900	+	240	166154098	97321
chr6	139274583	139474583	harbor1	chr6	139285693	139285793	LTR/ERVL	726	+	50	139285743	11160
chr6	139274583	139474583	harbor1	chr6	139287058	139287389	LTR/ERVL	2163	+	166	139287224	12641
chr6	165559080	165759080	harbor1	chr6	165583523	165584083	LTR/ERVL	2974	+	280	165583803	24723
chr6	165559080	165759080	harbor1	chr6	165584093	165584655	LTR/ERVL	1022	+	281	165584374	25294
chr6	165559080	165759080	harbor1	chr6	165584662	165585303	LTR/ERVL	2663	+	320	165584982	25902
chr6	165559080	165759080	harbor1	chr6	165585304	165585503	LTR/ERVL	625	+	100	165585404	26324
chr6	165559080	165759080	harbor1	chr6	165621869	165622203	LTR/ERVL	1766	+	167	165622036	62956
chr6	165559080	165759080	harbor1	chr6	165645004	165645188	LTR/ERVL	504	+	92	165645096	86016
chr6	33522113	33722113	harbor1	chr6	33523993	33524415	LTR/ERVL	2402	+	211	33524204	2091
chr6	33522113	33722113	harbor1	chr6	33525211	33525377	LTR/ERVL	959	+	83	33525294	3181
chr6	33522113	33722113	harbor1	chr6	33526177	33526412	LTR/ERVL	994	+	118	33526295	4182
chr6	33522113	33722113	harbor1	chr6	33602003	33602233	LTR/ERVL	559	+	115	33602118	80005
chr6	33522113	33722113	harbor1	chr6	33611986	33612362	LTR/ERVL	1333	+	188	33612174	90061
chr6	33522113	33722113	harbor1	chr6	33612658	33612729	LTR/ERVL	1333	+	36	33612694	90581
chr6	127167375	127367375	harbor1	chr6	127223432	127223897	LTR/ERVL	966	+	232	127223664	56289
chr6	127167375	127367375	harbor1	chr6	127239428	127239578	LTR/ERVL	846	+	75	127239503	72128
chr6	127167375	127367375	harbor1	chr6	127249110	127249446	LTR/ERVL	665	+	168	127249278	81903
chr6	127167375	127367375	harbor1	chr6	127249471	127249637	LTR/ERVL	747	+	83	127249554	82179
chr6	127167314	127367314	harbor1	chr6	127223432	127223897	LTR/ERVL	966	+	232	127223664	56350
chr6	127167314	127367314	harbor1	chr6	127239428	127239578	LTR/ERVL	846	+	75	127239503	72189
chr6	127167314	127367314	harbor1	chr6	127249110	127249446	LTR/ERVL	665	+	168	127249278	81964
chr6	127167314	127367314	harbor1	chr6	127249471	127249637	LTR/ERVL	747	+	83	127249554	82240
chr6	52184772	52384772	harbor1	chr6	52194886	52194941	LTR/ERVL	2515	+	28	52194914	10142
chr6	52184772	52384772	harbor1	chr6	52195310	52195486	LTR/ERVL	2515	+	88	52195398	10626
chr6	52184772	52384772	harbor1	chr6	52195532	52195793	LTR/ERVL	2515	+	130	52195662	10890
chr6	52184772	52384772	harbor1	chr6	52237730	52238129	LTR/ERVL	2375	+	200	52237930	53158
chr6	169864008	170064008	harbor1	chr6	169953458	169954304	LTR/ERVL	3116	+	423	169953881	89873
chr6	169864008	170064008	harbor1	chr6	169954339	169954998	LTR/ERVL	3405	+	330	169954669	90661
chr6	139275131	139475131	harbor1	chr6	139285693	139285793	LTR/ERVL	726	+	50	139285743	10612
chr6	139275131	139475131	harbor1	chr6	139287058	139287389	LTR/ERVL	2163	+	166	139287224	12093
chr6	7212661	7412661	harbor1	chr6	7266136	7266589	LTR/ERVL	1323	+	226	7266362	53701
chr6	7212661	7412661	harbor1	chr6	7266702	7266841	LTR/ERVL	565	+	70	7266772	54111
chr6	127167318	127367318	harbor1	chr6	127223432	127223897	LTR/ERVL	966	+	232	127223664	56346
chr6	127167318	127367318	harbor1	chr6	127239428	127239578	LTR/ERVL	846	+	75	127239503	72185
chr6	127167318	127367318	harbor1	chr6	127249110	127249446	LTR/ERVL	665	+	168	127249278	81960
chr6	127167318	127367318	harbor1	chr6	127249471	127249637	LTR/ERVL	747	+	83	127249554	82236
chr6	45540956	45740956	harbor1	chr6	45621072	45621915	LTR/ERVL	4750	+	422	45621494	80538
chr6	45541064	45741064	harbor1	chr6	45621072	45621915	LTR/ERVL	4750	+	422	45621494	80430
chr6	30386552	30586552	harbor1	chr6	30402231	30402587	LTR/ERVL	1427	+	178	30402409	15857
chr6	30386552	30586552	harbor1	chr6	30402943	30403264	LTR/ERVL	4799	+	160	30403103	16551
chr6	30386552	30586552	harbor1	chr6	30404040	30404937	LTR/ERVL	4799	+	448	30404488	17936
chr6	139275446	139475446	harbor1	chr6	139285693	139285793	LTR/ERVL	726	+	50	139285743	10297
chr6	139275446	139475446	harbor1	chr6	139287058	139287389	LTR/ERVL	2163	+	166	139287224	11778
chr6	43738762	43938762	harbor1	chr6	43817695	43817819	LTR/ERVL	639	+	62	43817757	78995
chr6	43738762	43938762	harbor1	chr6	43817820	43818953	LTR/ERVL	11642	+	566	43818386	79624
chr6	43738762	43938762	harbor1	chr6	43819288	43820199	LTR/ERVL	11642	+	456	43819744	80982
chr6	43738762	43938762	harbor1	chr6	43820339	43820352	LTR/ERVL	2202	+	6	43820345	81583
chr6	43738762	43938762	harbor1	chr6	43820380	43820943	LTR/ERVL	2202	+	282	43820662	81900
chr6	52476001	52676001	harbor1	chr6	52492547	52492624	LTR/ERVL	2418	+	38	52492585	16584
chr6	52476001	52676001	harbor1	chr6	52492917	52493390	LTR/ERVL	2418	+	236	52493153	17152
chr6	52476001	52676001	harbor1	chr6	52550144	52550455	LTR/ERVL	586	+	156	52550300	74299
chr6	127167369	127367369	harbor1	chr6	127223432	127223897	LTR/ERVL	966	+	232	127223664	56295
chr6	127167369	127367369	harbor1	chr6	127239428	127239578	LTR/ERVL	846	+	75	127239503	72134
chr6	127167369	127367369	harbor1	chr6	127249110	127249446	LTR/ERVL	665	+	168	127249278	81909
chr6	127167369	127367369	harbor1	chr6	127249471	127249637	LTR/ERVL	747	+	83	127249554	82185
chr6	45540952	45740952	harbor1	chr6	45621072	45621915	LTR/ERVL	4750	+	422	45621494	80542
chr6	30366711	30566711	harbor1	chr6	30370054	30370339	LTR/ERVL	444	+	142	30370196	3485
chr6	30366711	30566711	harbor1	chr6	30402231	30402587	LTR/ERVL	1427	+	178	30402409	35698
chr6	30366711	30566711	harbor1	chr6	30402943	30403264	LTR/ERVL	4799	+	160	30403103	36392
chr6	30366711	30566711	harbor1	chr6	30404040	30404937	LTR/ERVL	4799	+	448	30404488	37777
chr6	27415396	27615396	harbor1	chr6	27435701	27435944	LTR/ERVL	647	+	122	27435823	20427
chr6	27415396	27615396	harbor1	chr6	27461123	27461449	LTR/ERVL	503	+	163	27461286	45890
chr6	27415396	27615396	harbor1	chr6	27491903	27492166	LTR/ERVL	1697	+	132	27492035	76639
chr6	27415396	27615396	harbor1	chr6	27492790	27493135	LTR/ERVL	1327	+	172	27492962	77566
chr6	27415396	27615396	harbor1	chr6	27493205	27493436	LTR/ERVL	593	+	116	27493321	77925
chr6	27415396	27615396	harbor1	chr6	27498116	27498540	LTR/ERVL	1414	+	212	27498328	82932
chr6	27415396	27615396	harbor1	chr6	27492316	27492531	LTR/ERVL	550	+	108	27492424	77028
chr6	139275475	139475475	harbor1	chr6	139285693	139285793	LTR/ERVL	726	+	50	139285743	10268
chr6	139275475	139475475	harbor1	chr6	139287058	139287389	LTR/ERVL	2163	+	166	139287224	11749
chr6	30366632	30566632	harbor1	chr6	30370054	30370339	LTR/ERVL	444	+	142	30370196	3564
chr6	30366632	30566632	harbor1	chr6	30402231	30402587	LTR/ERVL	1427	+	178	30402409	35777
chr6	30366632	30566632	harbor1	chr6	30402943	30403264	LTR/ERVL	4799	+	160	30403103	36471
chr6	30366632	30566632	harbor1	chr6	30404040	30404937	LTR/ERVL	4799	+	448	30404488	37856
chr6	139274465	139474465	harbor1	chr6	139285693	139285793	LTR/ERVL	726	+	50	139285743	11278
chr6	139274465	139474465	harbor1	chr6	139287058	139287389	LTR/ERVL	2163	+	166	139287224	12759
chr6	52184695	52384695	harbor1	chr6	52194886	52194941	LTR/ERVL	2515	+	28	52194914	10219
chr6	52184695	52384695	harbor1	chr6	52195310	52195486	LTR/ERVL	2515	+	88	52195398	10703
chr6	52184695	52384695	harbor1	chr6	52195532	52195793	LTR/ERVL	2515	+	130	52195662	10967
chr6	52184695	52384695	harbor1	chr6	52237730	52238129	LTR/ERVL	2375	+	200	52237930	53235
chr6	3749398	3949398	harbor1	chr6	3832372	3832690	LTR/ERVL	722	+	159	3832531	83133
chr6	150800581	151000581	harbor1	chr6	150857630	150858046	LTR/ERVL	2938	+	208	150857838	57257
chr6	31907277	32107277	harbor1	chr6	31913245	31913293	LTR/ERVL	611	+	24	31913269	5992
chr6	31907277	32107277	harbor1	chr6	31913610	31913647	LTR/ERVL	611	+	18	31913628	6351
chr6	31907277	32107277	harbor1	chr6	31914211	31914310	LTR/ERVL	611	+	50	31914261	6984
chr6	39128541	39328541	harbor1	chr6	39139993	39140192	LTR/ERVL	756	+	100	39140093	11552
chr6	39128541	39328541	harbor1	chr6	39147025	39147310	LTR/ERVL	1768	+	142	39147167	18626
chr6	39128541	39328541	harbor1	chr6	39147446	39147575	LTR/ERVL	1768	+	64	39147510	18969
chr6	39128541	39328541	harbor1	chr6	39180864	39181187	LTR/ERVL	995	+	162	39181026	52485
chr6	39128541	39328541	harbor1	chr6	39183758	39183870	LTR/ERVL	878	+	56	39183814	55273
chr6	39128541	39328541	harbor1	chr6	39184691	39184955	LTR/ERVL	878	+	132	39184823	56282
chr6	124862409	125062409	harbor1	chr6	124917781	124918185	LTR/ERVL	1706	+	202	124917983	55574
chr6	169863974	170063974	harbor1	chr6	169953458	169954304	LTR/ERVL	3116	+	423	169953881	89907
chr6	169863974	170063974	harbor1	chr6	169954339	169954998	LTR/ERVL	3405	+	330	169954669	90695
chr6	146813086	147013086	harbor1	chr6	146854796	146855346	LTR/ERVL	2060	+	275	146855071	41985
chr6	133853442	134053442	harbor1	chr6	133866799	133867292	LTR/ERVL	3270	+	246	133867045	13603
chr6	133853442	134053442	harbor1	chr6	133916248	133916376	LTR/ERVL	525	+	64	133916312	62870
chr6	133853442	134053442	harbor1	chr6	133916898	133917023	LTR/ERVL	440	+	62	133916960	63518
chr6	133853442	134053442	harbor1	chr6	133927067	133927268	LTR/ERVL	951	+	100	133927167	73725
chr6	133853442	134053442	harbor1	chr6	133927579	133927762	LTR/ERVL	951	+	92	133927671	74229
chr6	133853442	134053442	harbor1	chr6	133928084	133928294	LTR/ERVL	951	+	105	133928189	74747
chr6	133853442	134053442	harbor1	chr6	133950229	133950742	LTR/ERVL	2714	+	256	133950485	97043
chr6	27415400	27615400	harbor1	chr6	27435701	27435944	LTR/ERVL	647	+	122	27435823	20423
chr6	27415400	27615400	harbor1	chr6	27461123	27461449	LTR/ERVL	503	+	163	27461286	45886
chr6	27415400	27615400	harbor1	chr6	27491903	27492166	LTR/ERVL	1697	+	132	27492035	76635
chr6	27415400	27615400	harbor1	chr6	27492790	27493135	LTR/ERVL	1327	+	172	27492962	77562
chr6	27415400	27615400	harbor1	chr6	27493205	27493436	LTR/ERVL	593	+	116	27493321	77921
chr6	27415400	27615400	harbor1	chr6	27498116	27498540	LTR/ERVL	1414	+	212	27498328	82928
chr6	27415400	27615400	harbor1	chr6	27492316	27492531	LTR/ERVL	550	+	108	27492424	77024
chr6	41091934	41291934	harbor1	chr6	41155189	41155303	LTR/ERVL	547	+	57	41155246	63312
chr6	41091934	41291934	harbor1	chr6	41155333	41155375	LTR/ERVL	814	+	21	41155354	63420
chr6	41091934	41291934	harbor1	chr6	41155407	41155576	LTR/ERVL	814	+	84	41155491	63557
chr6	41091934	41291934	harbor1	chr6	41170742	41171195	LTR/ERVL	992	+	226	41170968	79034
chr6	139275440	139475440	harbor1	chr6	139285693	139285793	LTR/ERVL	726	+	50	139285743	10303
chr6	139275440	139475440	harbor1	chr6	139287058	139287389	LTR/ERVL	2163	+	166	139287224	11784
chr6	127167312	127367312	harbor1	chr6	127223432	127223897	LTR/ERVL	966	+	232	127223664	56352
chr6	127167312	127367312	harbor1	chr6	127239428	127239578	LTR/ERVL	846	+	75	127239503	72191
chr6	127167312	127367312	harbor1	chr6	127249110	127249446	LTR/ERVL	665	+	168	127249278	81966
chr6	127167312	127367312	harbor1	chr6	127249471	127249637	LTR/ERVL	747	+	83	127249554	82242
chr6	124862399	125062399	harbor1	chr6	124917781	124918185	LTR/ERVL	1706	+	202	124917983	55584
chr6	169864066	170064066	harbor1	chr6	169953458	169954304	LTR/ERVL	3116	+	423	169953881	89815
chr6	169864066	170064066	harbor1	chr6	169954339	169954998	LTR/ERVL	3405	+	330	169954669	90603
chr6	139275439	139475439	harbor1	chr6	139285693	139285793	LTR/ERVL	726	+	50	139285743	10304
chr6	139275439	139475439	harbor1	chr6	139287058	139287389	LTR/ERVL	2163	+	166	139287224	11785
chr6	139275169	139475169	harbor1	chr6	139285693	139285793	LTR/ERVL	726	+	50	139285743	10574
chr6	139275169	139475169	harbor1	chr6	139287058	139287389	LTR/ERVL	2163	+	166	139287224	12055
chr6	139274579	139474579	harbor1	chr6	139285693	139285793	LTR/ERVL	726	+	50	139285743	11164
chr6	139274579	139474579	harbor1	chr6	139287058	139287389	LTR/ERVL	2163	+	166	139287224	12645
chr6	11714941	11914941	harbor1	chr6	11780629	11781171	LTR/ERVL	2195	+	271	11780900	65959
chr6	11714941	11914941	harbor1	chr6	11791264	11791766	LTR/ERVL	2959	+	251	11791515	76574
chr6	45540949	45740949	harbor1	chr6	45621072	45621915	LTR/ERVL	4750	+	422	45621494	80545
chr6	33104683	33304683	harbor1	chr6	33147137	33147313	LTR/ERVL	1109	+	88	33147225	42542
chr6	33104683	33304683	harbor1	chr6	33147586	33147949	LTR/ERVL	1109	+	182	33147768	43085
chr6	18268218	18468218	harbor1	chr6	18272343	18272714	LTR/ERVL	2142	+	186	18272529	4311
chr6	150800587	151000587	harbor1	chr6	150857630	150858046	LTR/ERVL	2938	+	208	150857838	57251
chr6	139275128	139475128	harbor1	chr6	139285693	139285793	LTR/ERVL	726	+	50	139285743	10615
chr6	139275128	139475128	harbor1	chr6	139287058	139287389	LTR/ERVL	2163	+	166	139287224	12096
chr6	139275156	139475156	harbor1	chr6	139285693	139285793	LTR/ERVL	726	+	50	139285743	10587
chr6	139275156	139475156	harbor1	chr6	139287058	139287389	LTR/ERVL	2163	+	166	139287224	12068
chr6	42647151	42847151	harbor1	chr6	42742216	42742364	LTR/ERVL	689	+	74	42742290	95139
chr6	42647151	42847151	harbor1	chr6	42742382	42742655	LTR/ERVL	863	+	136	42742518	95367
chr6	41448352	41648352	harbor1	chr6	41477691	41477858	LTR/ERVL	1295	+	84	41477775	29423
chr6	41448352	41648352	harbor1	chr6	41478143	41478391	LTR/ERVL	1295	+	124	41478267	29915
chr6	41448352	41648352	harbor1	chr6	41508389	41508772	LTR/ERVL	963	+	192	41508581	60229
chr6	41448352	41648352	harbor1	chr6	41537001	41537453	LTR/ERVL	1401	+	226	41537227	88875
chr6	52184723	52384723	harbor1	chr6	52194886	52194941	LTR/ERVL	2515	+	28	52194914	10191
chr6	52184723	52384723	harbor1	chr6	52195310	52195486	LTR/ERVL	2515	+	88	52195398	10675
chr6	52184723	52384723	harbor1	chr6	52195532	52195793	LTR/ERVL	2515	+	130	52195662	10939
chr6	52184723	52384723	harbor1	chr6	52237730	52238129	LTR/ERVL	2375	+	200	52237930	53207
chr6	7626959	7826959	harbor1	chr6	7674100	7674671	LTR/ERVL	1086	+	286	7674386	47427
chr6	7626959	7826959	harbor1	chr6	7677028	7677379	LTR/ERVL	2317	+	176	7677204	50245
chr6	7626959	7826959	harbor1	chr6	7677510	7677549	LTR/ERVL	2317	+	20	7677530	50571
chr6	3682582	3882582	harbor1	chr6	3698697	3699039	LTR/ERVL	2346	+	171	3698868	16286
chr6	3682582	3882582	harbor1	chr6	3699544	3699930	LTR/ERVL	2346	+	193	3699737	17155
chr6	3682582	3882582	harbor1	chr6	3718324	3718854	LTR/ERVL	2473	+	265	3718589	36007
chr6	41460705	41660705	harbor1	chr6	41477691	41477858	LTR/ERVL	1295	+	84	41477775	17070
chr6	41460705	41660705	harbor1	chr6	41478143	41478391	LTR/ERVL	1295	+	124	41478267	17562
chr6	41460705	41660705	harbor1	chr6	41508389	41508772	LTR/ERVL	963	+	192	41508581	47876
chr6	41460705	41660705	harbor1	chr6	41537001	41537453	LTR/ERVL	1401	+	226	41537227	76522
chr6	30620053	30820053	harbor1	chr6	30691876	30691908	LTR/ERVL	488	+	16	30691892	71839
chr6	30620053	30820053	harbor1	chr6	30692209	30692421	LTR/ERVL	488	+	106	30692315	72262
chr6	6446460	6646460	harbor1	chr6	6454039	6454478	LTR/ERVL	2711	+	220	6454259	7799
chr6	6446460	6646460	harbor1	chr6	6454542	6454592	LTR/ERVL	2711	+	25	6454567	8107
chr6	6446460	6646460	harbor1	chr6	6513120	6513436	LTR/ERVL	535	+	158	6513278	66818
chr6	169863372	170063372	harbor1	chr6	169953458	169954304	LTR/ERVL	3116	+	423	169953881	90509
chr6	169863372	170063372	harbor1	chr6	169954339	169954998	LTR/ERVL	3405	+	330	169954669	91297
chr6	127167326	127367326	harbor1	chr6	127223432	127223897	LTR/ERVL	966	+	232	127223664	56338
chr6	127167326	127367326	harbor1	chr6	127239428	127239578	LTR/ERVL	846	+	75	127239503	72177
chr6	127167326	127367326	harbor1	chr6	127249110	127249446	LTR/ERVL	665	+	168	127249278	81952
chr6	127167326	127367326	harbor1	chr6	127249471	127249637	LTR/ERVL	747	+	83	127249554	82228
chr6	169864117	170064117	harbor1	chr6	169953458	169954304	LTR/ERVL	3116	+	423	169953881	89764
chr6	169864117	170064117	harbor1	chr6	169954339	169954998	LTR/ERVL	3405	+	330	169954669	90552
chr6	99421489	99621489	harbor1	chr6	99441973	99442465	LTR/ERVL	842	+	246	99442219	20730
chr6	99421489	99621489	harbor1	chr6	99444407	99444945	LTR/ERVL	2952	+	269	99444676	23187
chr6	99421489	99621489	harbor1	chr6	99501824	99502578	LTR/ERVL	1092	+	377	99502201	80712
chr6	139274599	139474599	harbor1	chr6	139285693	139285793	LTR/ERVL	726	+	50	139285743	11144
chr6	139274599	139474599	harbor1	chr6	139287058	139287389	LTR/ERVL	2163	+	166	139287224	12625
chr6	107718661	107918661	harbor1	chr6	107775433	107775543	LTR/ERVL	579	+	55	107775488	56827
chr6	107718661	107918661	harbor1	chr6	107783740	107784125	LTR/ERVL	601	+	192	107783932	65271
chr6	107718661	107918661	harbor1	chr6	107800633	107800848	LTR/ERVL	692	+	108	107800741	82080
chr6	107718661	107918661	harbor1	chr6	107812433	107812866	LTR/ERVL	2386	+	216	107812649	93988
chr6	107718661	107918661	harbor1	chr6	107812916	107812950	LTR/ERVL	2386	+	17	107812933	94272
chr6	52184760	52384760	harbor1	chr6	52194886	52194941	LTR/ERVL	2515	+	28	52194914	10154
chr6	52184760	52384760	harbor1	chr6	52195310	52195486	LTR/ERVL	2515	+	88	52195398	10638
chr6	52184760	52384760	harbor1	chr6	52195532	52195793	LTR/ERVL	2515	+	130	52195662	10902
chr6	52184760	52384760	harbor1	chr6	52237730	52238129	LTR/ERVL	2375	+	200	52237930	53170
chr6	7626659	7826659	harbor1	chr6	7674100	7674671	LTR/ERVL	1086	+	286	7674386	47727
chr6	7626659	7826659	harbor1	chr6	7677028	7677379	LTR/ERVL	2317	+	176	7677204	50545
chr6	7626659	7826659	harbor1	chr6	7677510	7677549	LTR/ERVL	2317	+	20	7677530	50871
chr6	7626996	7826996	harbor1	chr6	7674100	7674671	LTR/ERVL	1086	+	286	7674386	47390
chr6	7626996	7826996	harbor1	chr6	7677028	7677379	LTR/ERVL	2317	+	176	7677204	50208
chr6	7626996	7826996	harbor1	chr6	7677510	7677549	LTR/ERVL	2317	+	20	7677530	50534
chr6	146813048	147013048	harbor1	chr6	146854796	146855346	LTR/ERVL	2060	+	275	146855071	42023
chr6	157938132	158138132	harbor1	chr6	157946136	157946566	LTR/ERVL	1292	+	215	157946351	8219
chr7	72825086	73025086	harbor1	chr7	72859855	72860077	LTR/ERVL	677	+	111	72859966	34880
chr7	50203887	50403887	harbor1	chr7	50290068	50290313	LTR/ERVL	1021	+	122	50290190	86303
chr7	148600313	148800313	harbor1	chr7	148605309	148605916	LTR/ERVL	1327	+	304	148605613	5300
chr7	148600313	148800313	harbor1	chr7	148610180	148610630	LTR/ERVL	3163	+	225	148610405	10092
chr7	148600313	148800313	harbor1	chr7	148610873	148611157	LTR/ERVL	963	+	142	148611015	10702
chr7	148600313	148800313	harbor1	chr7	148621419	148621550	LTR/ERVL	751	+	66	148621485	21172
chr7	148600313	148800313	harbor1	chr7	148645623	148646166	LTR/ERVL	1629	+	272	148645895	45582
chr7	148600313	148800313	harbor1	chr7	148691527	148691653	LTR/ERVL	1684	+	63	148691590	91277
chr7	148600313	148800313	harbor1	chr7	148691976	148692196	LTR/ERVL	1684	+	110	148692086	91773
chr7	26995062	27195062	harbor1	chr7	26996592	26997073	LTR/ERVL	3040	+	240	26996832	1770
chr7	26995062	27195062	harbor1	chr7	26997074	26998333	LTR/ERVL	21201	+	630	26997704	2642
chr7	26995062	27195062	harbor1	chr7	26998385	27000000	LTR/ERVL	21201	+	808	26999193	4131
chr7	26995062	27195062	harbor1	chr7	27008607	27008873	LTR/ERVL	2077	+	133	27008740	13678
chr7	26995062	27195062	harbor1	chr7	27008874	27009322	LTR/ERVL	3575	+	224	27009098	14036
chr7	26995062	27195062	harbor1	chr7	27067665	27068180	LTR/ERVL	1108	+	258	27067923	72861
chr7	26995062	27195062	harbor1	chr7	27000001	27002445	LTR/ERVL	19624	+	1222	27001223	6161
chr7	1758857	1958857	harbor1	chr7	1795258	1795410	LTR/ERVL	507	+	76	1795334	36477
chr7	1758857	1958857	harbor1	chr7	1795986	1796390	LTR/ERVL	1333	+	202	1796188	37331
chr7	50615319	50815319	harbor1	chr7	50675390	50675775	LTR/ERVL	1981	+	192	50675582	60263
chr7	25270019	25470019	harbor1	chr7	25279018	25279650	LTR/ERVL	3887	+	316	25279334	9315
chr7	25270019	25470019	harbor1	chr7	25365362	25365630	LTR/ERVL	693	+	134	25365496	95477
chr7	25270019	25470019	harbor1	chr7	25365645	25365843	LTR/ERVL	643	+	99	25365744	95725
chr7	148598238	148798238	harbor1	chr7	148605309	148605916	LTR/ERVL	1327	+	304	148605613	7375
chr7	148598238	148798238	harbor1	chr7	148610180	148610630	LTR/ERVL	3163	+	225	148610405	12167
chr7	148598238	148798238	harbor1	chr7	148610873	148611157	LTR/ERVL	963	+	142	148611015	12777
chr7	148598238	148798238	harbor1	chr7	148621419	148621550	LTR/ERVL	751	+	66	148621485	23247
chr7	148598238	148798238	harbor1	chr7	148645623	148646166	LTR/ERVL	1629	+	272	148645895	47657
chr7	148598238	148798238	harbor1	chr7	148691527	148691653	LTR/ERVL	1684	+	63	148691590	93352
chr7	148598238	148798238	harbor1	chr7	148691976	148692196	LTR/ERVL	1684	+	110	148692086	93848
chr7	123649232	123849232	harbor1	chr7	123697669	123698225	LTR/ERVL	2687	+	278	123697947	48715
chr7	47228345	47428345	harbor1	chr7	47255484	47256356	LTR/ERVL	4698	+	436	47255920	27575
chr7	32628568	32828568	harbor1	chr7	32669163	32669692	LTR/ERVL	1738	+	264	32669427	40859
chr7	32628568	32828568	harbor1	chr7	32677452	32677853	LTR/ERVL	1131	+	200	32677652	49084
chr7	73470903	73670903	harbor1	chr7	73503714	73504211	LTR/ERVL	1256	+	248	73503962	33059
chr7	73470903	73670903	harbor1	chr7	73562678	73563067	LTR/ERVL	3128	+	194	73562872	91969
chr7	73470903	73670903	harbor1	chr7	73563106	73563145	LTR/ERVL	3128	+	20	73563126	92223
chr7	26995617	27195617	harbor1	chr7	26996592	26997073	LTR/ERVL	3040	+	240	26996832	1215
chr7	26995617	27195617	harbor1	chr7	26997074	26998333	LTR/ERVL	21201	+	630	26997704	2087
chr7	26995617	27195617	harbor1	chr7	26998385	27000000	LTR/ERVL	21201	+	808	26999193	3576
chr7	26995617	27195617	harbor1	chr7	27008607	27008873	LTR/ERVL	2077	+	133	27008740	13123
chr7	26995617	27195617	harbor1	chr7	27008874	27009322	LTR/ERVL	3575	+	224	27009098	13481
chr7	26995617	27195617	harbor1	chr7	27067665	27068180	LTR/ERVL	1108	+	258	27067923	72306
chr7	26995617	27195617	harbor1	chr7	27000001	27002445	LTR/ERVL	19624	+	1222	27001223	5606
chr7	50203852	50403852	harbor1	chr7	50290068	50290313	LTR/ERVL	1021	+	122	50290190	86338
chr7	1762067	1962067	harbor1	chr7	1795258	1795410	LTR/ERVL	507	+	76	1795334	33267
chr7	1762067	1962067	harbor1	chr7	1795986	1796390	LTR/ERVL	1333	+	202	1796188	34121
chr7	97770965	97970965	harbor1	chr7	97776234	97776735	LTR/ERVL	1290	+	250	97776484	5519
chr7	97770965	97970965	harbor1	chr7	97800865	97800996	LTR/ERVL	1131	+	66	97800931	29966
chr7	97770965	97970965	harbor1	chr7	97801365	97801600	LTR/ERVL	1131	+	118	97801483	30518
chr7	97770965	97970965	harbor1	chr7	97837022	97837148	LTR/ERVL	465	+	63	97837085	66120
chr7	97770965	97970965	harbor1	chr7	97837569	97837912	LTR/ERVL	582	+	172	97837741	66776
chr7	50203883	50403883	harbor1	chr7	50290068	50290313	LTR/ERVL	1021	+	122	50290190	86307
chr7	142715604	142915604	harbor1	chr7	142736313	142736886	LTR/ERVL	1888	+	286	142736599	20995
chr7	142715604	142915604	harbor1	chr7	142736961	142737025	LTR/ERVL	1086	+	32	142736993	21389
chr7	142715604	142915604	harbor1	chr7	142741189	142741796	LTR/ERVL	769	+	304	142741493	25889
chr7	142715604	142915604	harbor1	chr7	142742682	142742810	LTR/ERVL	509	+	64	142742746	27142
chr7	123649230	123849230	harbor1	chr7	123697669	123698225	LTR/ERVL	2687	+	278	123697947	48717
chr7	123649229	123849229	harbor1	chr7	123697669	123698225	LTR/ERVL	2687	+	278	123697947	48718
chr7	123649200	123849200	harbor1	chr7	123697669	123698225	LTR/ERVL	2687	+	278	123697947	48747
chr7	158138716	158338716	harbor1	chr7	158142073	158142523	LTR/ERVL	921	+	225	158142298	3582
chr7	24657323	24857323	harbor1	chr7	24748621	24749018	LTR/ERVL	1607	+	198	24748819	91496
chr7	14798299	14998299	harbor1	chr7	14798594	14799915	LTR/ERVL	7348	+	660	14799254	955
chr7	14798299	14998299	harbor1	chr7	14800216	14800261	LTR/ERVL	511	+	22	14800238	1939
chr7	14798299	14998299	harbor1	chr7	14800262	14800644	LTR/ERVL	2601	+	191	14800453	2154
chr7	14798299	14998299	harbor1	chr7	14800645	14800797	LTR/ERVL	929	+	76	14800721	2422
chr7	14798299	14998299	harbor1	chr7	14800796	14801369	LTR/ERVL	3114	+	286	14801082	2783
chr7	14798299	14998299	harbor1	chr7	14801373	14801850	LTR/ERVL	1713	+	238	14801611	3312
chr7	14798299	14998299	harbor1	chr7	14831316	14831762	LTR/ERVL	1477	+	223	14831539	33240
chr7	14798299	14998299	harbor1	chr7	14848601	14849062	LTR/ERVL	882	+	230	14848831	50532
chr7	149048098	149248098	harbor1	chr7	149051314	149051752	LTR/ERVL	3064	+	219	149051533	3435
chr7	149048098	149248098	harbor1	chr7	149051753	149052280	LTR/ERVL	11049	+	264	149052017	3919
chr7	149048098	149248098	harbor1	chr7	149052619	149053123	LTR/ERVL	11049	+	252	149052871	4773
chr7	149048098	149248098	harbor1	chr7	149053447	149053877	LTR/ERVL	11049	+	215	149053662	5564
chr7	149048098	149248098	harbor1	chr7	149054310	149054573	LTR/ERVL	1714	+	132	149054442	6344
chr7	149048098	149248098	harbor1	chr7	149054901	149055483	LTR/ERVL	10901	+	291	149055192	7094
chr7	149048098	149248098	harbor1	chr7	149055792	149056391	LTR/ERVL	10901	+	300	149056092	7994
chr7	149048098	149248098	harbor1	chr7	149056683	149057025	LTR/ERVL	9280	+	171	149056854	8756
chr7	149048098	149248098	harbor1	chr7	149057331	149057567	LTR/ERVL	9280	+	118	149057449	9351
chr7	149048098	149248098	harbor1	chr7	149057568	149057590	LTR/ERVL	2622	+	11	149057579	9481
chr7	149048098	149248098	harbor1	chr7	149057890	149058264	LTR/ERVL	2622	+	187	149058077	9979
chr7	26995486	27195486	harbor1	chr7	26996592	26997073	LTR/ERVL	3040	+	240	26996832	1346
chr7	26995486	27195486	harbor1	chr7	26997074	26998333	LTR/ERVL	21201	+	630	26997704	2218
chr7	26995486	27195486	harbor1	chr7	26998385	27000000	LTR/ERVL	21201	+	808	26999193	3707
chr7	26995486	27195486	harbor1	chr7	27008607	27008873	LTR/ERVL	2077	+	133	27008740	13254
chr7	26995486	27195486	harbor1	chr7	27008874	27009322	LTR/ERVL	3575	+	224	27009098	13612
chr7	26995486	27195486	harbor1	chr7	27067665	27068180	LTR/ERVL	1108	+	258	27067923	72437
chr7	26995486	27195486	harbor1	chr7	27000001	27002445	LTR/ERVL	19624	+	1222	27001223	5737
chr7	44654661	44854661	harbor1	chr7	44679605	44679928	LTR/ERVL	1614	+	162	44679767	25106
chr7	44654661	44854661	harbor1	chr7	44680242	44680316	LTR/ERVL	1614	+	37	44680279	25618
chr7	44654661	44854661	harbor1	chr7	44725307	44725387	LTR/ERVL	2137	+	40	44725347	70686
chr7	44654661	44854661	harbor1	chr7	44725656	44725673	LTR/ERVL	2137	+	8	44725664	71003
chr7	44654661	44854661	harbor1	chr7	44725950	44726265	LTR/ERVL	2137	+	158	44726108	71447
chr7	44654661	44854661	harbor1	chr7	44726864	44726896	LTR/ERVL	2137	+	16	44726880	72219
chr7	44654661	44854661	harbor1	chr7	44727195	44727384	LTR/ERVL	2137	+	94	44727289	72628
chr7	44654661	44854661	harbor1	chr7	44743827	44744194	LTR/ERVL	1958	+	184	44744011	89350
chr7	47228395	47428395	harbor1	chr7	47255484	47256356	LTR/ERVL	4698	+	436	47255920	27525
chr7	90496291	90696291	harbor1	chr7	90567611	90567846	LTR/ERVL	655	+	118	90567729	71438
chr7	90496291	90696291	harbor1	chr7	90568980	90569279	LTR/ERVL	655	+	150	90569130	72839
chr7	139380111	139580111	harbor1	chr7	139474802	139475249	LTR/ERVL	2129	+	224	139475026	94915
chr7	139380111	139580111	harbor1	chr7	139475548	139476049	LTR/ERVL	2129	+	250	139475798	95687
chr7	73518943	73718943	harbor1	chr7	73562678	73563067	LTR/ERVL	3128	+	194	73562872	43929
chr7	73518943	73718943	harbor1	chr7	73563106	73563145	LTR/ERVL	3128	+	20	73563126	44183
chr7	25244355	25444355	harbor1	chr7	25248780	25249231	LTR/ERVL	2117	+	226	25249006	4651
chr7	25244355	25444355	harbor1	chr7	25249899	25250128	LTR/ERVL	837	+	114	25250013	5658
chr7	25244355	25444355	harbor1	chr7	25250499	25250692	LTR/ERVL	713	+	96	25250595	6240
chr7	25244355	25444355	harbor1	chr7	25250846	25251378	LTR/ERVL	3637	+	266	25251112	6757
chr7	25244355	25444355	harbor1	chr7	25251461	25252367	LTR/ERVL	3637	+	453	25251914	7559
chr7	25244355	25444355	harbor1	chr7	25252366	25252738	LTR/ERVL	1762	+	186	25252552	8197
chr7	25244355	25444355	harbor1	chr7	25279018	25279650	LTR/ERVL	3887	+	316	25279334	34979
chr7	92963	292963	harbor1	chr7	118269	118940	LTR/ERVL	2342	+	336	118605	25642
chr7	92963	292963	harbor1	chr7	135243	135392	LTR/ERVL	616	+	74	135317	42354
chr7	92963	292963	harbor1	chr7	135490	135768	LTR/ERVL	826	+	139	135629	42666
chr7	47228348	47428348	harbor1	chr7	47255484	47256356	LTR/ERVL	4698	+	436	47255920	27572
chr7	47228354	47428354	harbor1	chr7	47255484	47256356	LTR/ERVL	4698	+	436	47255920	27566
chr7	25269481	25469481	harbor1	chr7	25279018	25279650	LTR/ERVL	3887	+	316	25279334	9853
chr7	25269481	25469481	harbor1	chr7	25365362	25365630	LTR/ERVL	693	+	134	25365496	96015
chr7	25269481	25469481	harbor1	chr7	25365645	25365843	LTR/ERVL	643	+	99	25365744	96263
chr7	50615284	50815284	harbor1	chr7	50675390	50675775	LTR/ERVL	1981	+	192	50675582	60298
chr7	128753811	128953811	harbor1	chr7	128785431	128785931	LTR/ERVL	2190	+	250	128785681	31870
chr7	127154041	127354041	harbor1	chr7	127163221	127163576	LTR/ERVL	1010	+	178	127163399	9358
chr7	127154041	127354041	harbor1	chr7	127221328	127221707	LTR/ERVL	501	+	190	127221518	67477
chr7	26995599	27195599	harbor1	chr7	26996592	26997073	LTR/ERVL	3040	+	240	26996832	1233
chr7	26995599	27195599	harbor1	chr7	26997074	26998333	LTR/ERVL	21201	+	630	26997704	2105
chr7	26995599	27195599	harbor1	chr7	26998385	27000000	LTR/ERVL	21201	+	808	26999193	3594
chr7	26995599	27195599	harbor1	chr7	27008607	27008873	LTR/ERVL	2077	+	133	27008740	13141
chr7	26995599	27195599	harbor1	chr7	27008874	27009322	LTR/ERVL	3575	+	224	27009098	13499
chr7	26995599	27195599	harbor1	chr7	27067665	27068180	LTR/ERVL	1108	+	258	27067923	72324
chr7	26995599	27195599	harbor1	chr7	27000001	27002445	LTR/ERVL	19624	+	1222	27001223	5624
chr7	104889111	105089111	harbor1	chr7	104958290	104958659	LTR/ERVL	683	+	184	104958474	69363
chr7	102333429	102533429	harbor1	chr7	102344059	102344281	LTR/ERVL	657	+	111	102344170	10741
chr7	155282486	155482486	harbor1	chr7	155286322	155286768	LTR/ERVL	3554	+	223	155286545	4059
chr7	155282486	155482486	harbor1	chr7	155359037	155359438	LTR/ERVL	870	+	200	155359237	76751
chr7	155282486	155482486	harbor1	chr7	155336301	155336709	LTR/ERVL	1315	+	204	155336505	54019
chr7	31971286	32171286	harbor1	chr7	31971597	31971828	LTR/ERVL	466	+	116	31971713	427
chr7	44696529	44896529	harbor1	chr7	44725307	44725387	LTR/ERVL	2137	+	40	44725347	28818
chr7	44696529	44896529	harbor1	chr7	44725656	44725673	LTR/ERVL	2137	+	8	44725664	29135
chr7	44696529	44896529	harbor1	chr7	44725950	44726265	LTR/ERVL	2137	+	158	44726108	29579
chr7	44696529	44896529	harbor1	chr7	44726864	44726896	LTR/ERVL	2137	+	16	44726880	30351
chr7	44696529	44896529	harbor1	chr7	44727195	44727384	LTR/ERVL	2137	+	94	44727289	30760
chr7	44696529	44896529	harbor1	chr7	44743827	44744194	LTR/ERVL	1958	+	184	44744011	47482
chr7	47520643	47720643	harbor1	chr7	47563800	47563911	LTR/ERVL	1250	+	56	47563856	43213
chr7	47520643	47720643	harbor1	chr7	47564214	47564353	LTR/ERVL	1250	+	70	47564284	43641
chr7	47520643	47720643	harbor1	chr7	47585495	47585898	LTR/ERVL	2387	+	202	47585697	65054
chr7	47520643	47720643	harbor1	chr7	47586199	47586279	LTR/ERVL	2387	+	40	47586239	65596
chr7	20551436	20751436	harbor1	chr7	20604006	20604251	LTR/ERVL	1255	+	122	20604128	52692
chr7	20551436	20751436	harbor1	chr7	20606518	20606748	LTR/ERVL	933	+	115	20606633	55197
chr7	155304444	155504444	harbor1	chr7	155359037	155359438	LTR/ERVL	870	+	200	155359237	54793
chr7	155304444	155504444	harbor1	chr7	155336301	155336709	LTR/ERVL	1315	+	204	155336505	32061
chr7	37817008	38017008	harbor1	chr7	37903211	37903646	LTR/ERVL	1626	+	218	37903429	86421
chr7	21261819	21461819	harbor1	chr7	21314866	21315359	LTR/ERVL	1017	+	246	21315112	53293
chr7	21261819	21461819	harbor1	chr7	21346665	21347404	LTR/ERVL	2393	+	370	21347035	85216
chr7	21261819	21461819	harbor1	chr7	21348147	21348315	LTR/ERVL	600	+	84	21348231	86412
chr7	21261819	21461819	harbor1	chr7	21350281	21350721	LTR/ERVL	2191	+	220	21350501	88682
chr7	1763585	1963585	harbor1	chr7	1795258	1795410	LTR/ERVL	507	+	76	1795334	31749
chr7	1763585	1963585	harbor1	chr7	1795986	1796390	LTR/ERVL	1333	+	202	1796188	32603
chr7	90496236	90696236	harbor1	chr7	90567611	90567846	LTR/ERVL	655	+	118	90567729	71493
chr7	90496236	90696236	harbor1	chr7	90568980	90569279	LTR/ERVL	655	+	150	90569130	72894
chr7	50204685	50404685	harbor1	chr7	50290068	50290313	LTR/ERVL	1021	+	122	50290190	85505
chr7	150858477	151058477	harbor1	chr7	150870586	150870871	LTR/ERVL	745	+	142	150870728	12251
chr7	150858477	151058477	harbor1	chr7	150891628	150892138	LTR/ERVL	2232	+	255	150891883	33406
chr7	150858477	151058477	harbor1	chr7	150911736	150912454	LTR/ERVL	1118	+	359	150912095	53618
chr7	150858477	151058477	harbor1	chr7	150916796	150917155	LTR/ERVL	788	+	180	150916976	58499
chr7	150858477	151058477	harbor1	chr7	150922299	150922486	LTR/ERVL	619	+	94	150922393	63916
chr7	150858477	151058477	harbor1	chr7	150927536	150927931	LTR/ERVL	1151	+	198	150927734	69257
chr7	157236661	157436661	harbor1	chr7	157313066	157313301	LTR/ERVL	1390	+	118	157313184	76523
chr7	90496254	90696254	harbor1	chr7	90567611	90567846	LTR/ERVL	655	+	118	90567729	71475
chr7	90496254	90696254	harbor1	chr7	90568980	90569279	LTR/ERVL	655	+	150	90569130	72876
chr7	47228189	47428189	harbor1	chr7	47255484	47256356	LTR/ERVL	4698	+	436	47255920	27731
chr7	123639349	123839349	harbor1	chr7	123697669	123698225	LTR/ERVL	2687	+	278	123697947	58598
chr7	26994913	27194913	harbor1	chr7	26996592	26997073	LTR/ERVL	3040	+	240	26996832	1919
chr7	26994913	27194913	harbor1	chr7	26997074	26998333	LTR/ERVL	21201	+	630	26997704	2791
chr7	26994913	27194913	harbor1	chr7	26998385	27000000	LTR/ERVL	21201	+	808	26999193	4280
chr7	26994913	27194913	harbor1	chr7	27008607	27008873	LTR/ERVL	2077	+	133	27008740	13827
chr7	26994913	27194913	harbor1	chr7	27008874	27009322	LTR/ERVL	3575	+	224	27009098	14185
chr7	26994913	27194913	harbor1	chr7	27067665	27068180	LTR/ERVL	1108	+	258	27067923	73010
chr7	26994913	27194913	harbor1	chr7	27000001	27002445	LTR/ERVL	19624	+	1222	27001223	6310
chr7	45871804	46071804	harbor1	chr7	45953512	45954058	LTR/ERVL	1328	+	273	45953785	81981
chr7	50203893	50403893	harbor1	chr7	50290068	50290313	LTR/ERVL	1021	+	122	50290190	86297
chr7	50203935	50403935	harbor1	chr7	50290068	50290313	LTR/ERVL	1021	+	122	50290190	86255
chr7	25465106	25665106	harbor1	chr7	25486226	25486618	LTR/ERVL	1453	+	196	25486422	21316
chr7	25465106	25665106	harbor1	chr7	25523021	25523802	LTR/ERVL	2812	+	390	25523411	58305
chr7	93685527	93885527	harbor1	chr7	93690376	93690768	LTR/ERVL	707	+	196	93690572	5045
chr7	93685527	93885527	harbor1	chr7	93691756	93692063	LTR/ERVL	478	+	154	93691910	6383
chr7	93685527	93885527	harbor1	chr7	93724584	93724707	LTR/ERVL	491	+	62	93724646	39119
chr7	93685527	93885527	harbor1	chr7	93760051	93760456	LTR/ERVL	2063	+	202	93760253	74726
chr7	93685527	93885527	harbor1	chr7	93774408	93774690	LTR/ERVL	688	+	141	93774549	89022
chr7	152754707	152954707	harbor1	chr7	152806298	152806416	LTR/ERVL	511	+	59	152806357	51650
chr7	152754707	152954707	harbor1	chr7	152806920	152807158	LTR/ERVL	564	+	119	152807039	52332
chr8	23408871	23608871	harbor1	chr8	23476479	23477036	LTR/ERVL	1571	+	278	23476757	67886
chr8	23409382	23609382	harbor1	chr8	23476479	23477036	LTR/ERVL	1571	+	278	23476757	67375
chr8	23428927	23628927	harbor1	chr8	23476479	23477036	LTR/ERVL	1571	+	278	23476757	47830
chr8	124271348	124471348	harbor1	chr8	124294704	124295275	LTR/ERVL	1620	+	286	124294990	23642
chr8	124271348	124471348	harbor1	chr8	124354460	124354849	LTR/ERVL	1463	+	194	124354654	83306
chr8	23428510	23628510	harbor1	chr8	23476479	23477036	LTR/ERVL	1571	+	278	23476757	48247
chr8	23428925	23628925	harbor1	chr8	23476479	23477036	LTR/ERVL	1571	+	278	23476757	47832
chr8	23428297	23628297	harbor1	chr8	23476479	23477036	LTR/ERVL	1571	+	278	23476757	48460
chr8	138636000	138836000	harbor1	chr8	138657818	138658090	LTR/ERVL	1211	+	136	138657954	21954
chr8	138636000	138836000	harbor1	chr8	138658192	138658755	LTR/ERVL	3276	+	282	138658474	22474
chr8	138636000	138836000	harbor1	chr8	138659959	138660401	LTR/ERVL	628	+	221	138660180	24180
chr8	138636000	138836000	harbor1	chr8	138673798	138674169	LTR/ERVL	914	+	186	138673984	37984
chr8	138636000	138836000	harbor1	chr8	138699825	138699918	LTR/ERVL	453	+	46	138699871	63871
chr8	138636000	138836000	harbor1	chr8	138720149	138720597	LTR/ERVL	822	+	224	138720373	84373
chr8	138636000	138836000	harbor1	chr8	138733753	138734264	LTR/ERVL	1519	+	256	138734009	98009
chr8	142524992	142724992	harbor1	chr8	142554851	142555631	LTR/ERVL	3303	+	390	142555241	30249
chr8	142524992	142724992	harbor1	chr8	142564749	142565392	LTR/ERVL	619	+	322	142565071	40079
chr8	23408903	23608903	harbor1	chr8	23476479	23477036	LTR/ERVL	1571	+	278	23476757	67854
chr8	23379720	23579720	harbor1	chr8	23476479	23477036	LTR/ERVL	1571	+	278	23476757	97037
chr8	23428962	23628962	harbor1	chr8	23476479	23477036	LTR/ERVL	1571	+	278	23476757	47795
chr8	23428983	23628983	harbor1	chr8	23476479	23477036	LTR/ERVL	1571	+	278	23476757	47774
chr8	23428928	23628928	harbor1	chr8	23476479	23477036	LTR/ERVL	1571	+	278	23476757	47829
chr8	10820948	11020948	harbor1	chr8	10837025	10837535	LTR/ERVL	2636	+	255	10837280	16332
chr8	23428391	23628391	harbor1	chr8	23476479	23477036	LTR/ERVL	1571	+	278	23476757	48366
chr8	23428850	23628850	harbor1	chr8	23476479	23477036	LTR/ERVL	1571	+	278	23476757	47907
chr8	23428493	23628493	harbor1	chr8	23476479	23477036	LTR/ERVL	1571	+	278	23476757	48264
chr8	23428942	23628942	harbor1	chr8	23476479	23477036	LTR/ERVL	1571	+	278	23476757	47815
chr8	23428811	23628811	harbor1	chr8	23476479	23477036	LTR/ERVL	1571	+	278	23476757	47946
chr8	23409313	23609313	harbor1	chr8	23476479	23477036	LTR/ERVL	1571	+	278	23476757	67444
chr8	9314880	9514880	harbor1	chr8	9356363	9356897	LTR/ERVL	1778	+	267	9356630	41750
chr8	9314880	9514880	harbor1	chr8	9390164	9390916	LTR/ERVL	2029	+	376	9390540	75660
chr8	23398381	23598381	harbor1	chr8	23476479	23477036	LTR/ERVL	1571	+	278	23476757	78376
chr8	23382036	23582036	harbor1	chr8	23476479	23477036	LTR/ERVL	1571	+	278	23476757	94721
chr8	23409011	23609011	harbor1	chr8	23476479	23477036	LTR/ERVL	1571	+	278	23476757	67746
chr8	23428813	23628813	harbor1	chr8	23476479	23477036	LTR/ERVL	1571	+	278	23476757	47944
chr8	23380145	23580145	harbor1	chr8	23476479	23477036	LTR/ERVL	1571	+	278	23476757	96612
chr8	23407361	23607361	harbor1	chr8	23476479	23477036	LTR/ERVL	1571	+	278	23476757	69396
chr8	109366219	109566219	harbor1	chr8	109380339	109380846	LTR/ERVL	609	+	254	109380593	14374
chr8	109366219	109566219	harbor1	chr8	109378678	109380056	LTR/ERVL	1776	+	689	109379367	13148
chr8	23428529	23628529	harbor1	chr8	23476479	23477036	LTR/ERVL	1571	+	278	23476757	48228
chr8	23428549	23628549	harbor1	chr8	23476479	23477036	LTR/ERVL	1571	+	278	23476757	48208
chr8	23428888	23628888	harbor1	chr8	23476479	23477036	LTR/ERVL	1571	+	278	23476757	47869
chr8	23428866	23628866	harbor1	chr8	23476479	23477036	LTR/ERVL	1571	+	278	23476757	47891
chr8	23393384	23593384	harbor1	chr8	23476479	23477036	LTR/ERVL	1571	+	278	23476757	83373
chr8	23408040	23608040	harbor1	chr8	23476479	23477036	LTR/ERVL	1571	+	278	23476757	68717
chr8	23428871	23628871	harbor1	chr8	23476479	23477036	LTR/ERVL	1571	+	278	23476757	47886
chr8	23428530	23628530	harbor1	chr8	23476479	23477036	LTR/ERVL	1571	+	278	23476757	48227
chr8	29983333	30183333	harbor1	chr8	29983604	29984157	LTR/ERVL	1965	+	276	29983880	547
chr8	29983333	30183333	harbor1	chr8	30005503	30006054	LTR/ERVL	1207	+	276	30005779	22446
chr8	29983333	30183333	harbor1	chr8	30007218	30007318	LTR/ERVL	1207	+	50	30007268	23935
chr8	29983333	30183333	harbor1	chr8	30048922	30048990	LTR/ERVL	430	+	34	30048956	65623
chr8	29983333	30183333	harbor1	chr8	30056873	30057055	LTR/ERVL	779	+	91	30056964	73631
chr8	29983333	30183333	harbor1	chr8	30075384	30075655	LTR/ERVL	440	+	136	30075520	92187
chr8	23428833	23628833	harbor1	chr8	23476479	23477036	LTR/ERVL	1571	+	278	23476757	47924
chr8	102556520	102756520	harbor1	chr8	102644172	102644667	LTR/ERVL	2016	+	248	102644420	87900
chr8	23382024	23582024	harbor1	chr8	23476479	23477036	LTR/ERVL	1571	+	278	23476757	94733
chr8	23382929	23582929	harbor1	chr8	23476479	23477036	LTR/ERVL	1571	+	278	23476757	93828
chr8	23428812	23628812	harbor1	chr8	23476479	23477036	LTR/ERVL	1571	+	278	23476757	47945
chr8	23428407	23628407	harbor1	chr8	23476479	23477036	LTR/ERVL	1571	+	278	23476757	48350
chr8	23428497	23628497	harbor1	chr8	23476479	23477036	LTR/ERVL	1571	+	278	23476757	48260
chr8	23419568	23619568	harbor1	chr8	23476479	23477036	LTR/ERVL	1571	+	278	23476757	57189
chr8	27225680	27425680	harbor1	chr8	27286695	27287214	LTR/ERVL	1919	+	260	27286955	61275
chr8	27225680	27425680	harbor1	chr8	27312216	27312594	LTR/ERVL	1334	+	189	27312405	86725
chr8	23428434	23628434	harbor1	chr8	23476479	23477036	LTR/ERVL	1571	+	278	23476757	48323
chr8	23428557	23628557	harbor1	chr8	23476479	23477036	LTR/ERVL	1571	+	278	23476757	48200
chr8	23428919	23628919	harbor1	chr8	23476479	23477036	LTR/ERVL	1571	+	278	23476757	47838
chr8	90970524	91170524	harbor1	chr8	91007641	91008180	LTR/ERVL	2810	+	270	91007911	37387
chr8	90970524	91170524	harbor1	chr8	91026021	91026701	LTR/ERVL	2046	+	340	91026361	55837
chr8	90970524	91170524	harbor1	chr8	91026905	91028303	LTR/ERVL	2931	+	699	91027604	57080
chr8	90970524	91170524	harbor1	chr8	91028324	91028799	LTR/ERVL	963	+	238	91028562	58038
chr8	90970524	91170524	harbor1	chr8	91034388	91034825	LTR/ERVL	669	+	218	91034606	64082
chr8	90970524	91170524	harbor1	chr8	91065575	91065663	LTR/ERVL	455	+	44	91065619	95095
chr8	23428835	23628835	harbor1	chr8	23476479	23477036	LTR/ERVL	1571	+	278	23476757	47922
chr8	23428480	23628480	harbor1	chr8	23476479	23477036	LTR/ERVL	1571	+	278	23476757	48277
chr8	2481328	2681328	harbor1	chr8	2538263	2538755	LTR/ERVL	637	+	246	2538509	57181
chr8	2481328	2681328	harbor1	chr8	2542533	2542963	LTR/ERVL	3310	+	215	2542748	61420
chr8	23428515	23628515	harbor1	chr8	23476479	23477036	LTR/ERVL	1571	+	278	23476757	48242
chr8	23393484	23593484	harbor1	chr8	23476479	23477036	LTR/ERVL	1571	+	278	23476757	83273
chr8	23380424	23580424	harbor1	chr8	23476479	23477036	LTR/ERVL	1571	+	278	23476757	96333
chr8	23428487	23628487	harbor1	chr8	23476479	23477036	LTR/ERVL	1571	+	278	23476757	48270
chr8	23393608	23593608	harbor1	chr8	23476479	23477036	LTR/ERVL	1571	+	278	23476757	83149
chr8	23428433	23628433	harbor1	chr8	23476479	23477036	LTR/ERVL	1571	+	278	23476757	48324
chr8	29983365	30183365	harbor1	chr8	29983604	29984157	LTR/ERVL	1965	+	276	29983880	515
chr8	29983365	30183365	harbor1	chr8	30005503	30006054	LTR/ERVL	1207	+	276	30005779	22414
chr8	29983365	30183365	harbor1	chr8	30007218	30007318	LTR/ERVL	1207	+	50	30007268	23903
chr8	29983365	30183365	harbor1	chr8	30048922	30048990	LTR/ERVL	430	+	34	30048956	65591
chr8	29983365	30183365	harbor1	chr8	30056873	30057055	LTR/ERVL	779	+	91	30056964	73599
chr8	29983365	30183365	harbor1	chr8	30075384	30075655	LTR/ERVL	440	+	136	30075520	92155
chr8	23398492	23598492	harbor1	chr8	23476479	23477036	LTR/ERVL	1571	+	278	23476757	78265
chr8	23428524	23628524	harbor1	chr8	23476479	23477036	LTR/ERVL	1571	+	278	23476757	48233
chr8	23384163	23584163	harbor1	chr8	23476479	23477036	LTR/ERVL	1571	+	278	23476757	92594
chr8	23428822	23628822	harbor1	chr8	23476479	23477036	LTR/ERVL	1571	+	278	23476757	47935
chr8	9051756	9251756	harbor1	chr8	9052697	9053007	LTR/ERVL	1888	+	155	9052852	1096
chr8	9051756	9251756	harbor1	chr8	9053317	9053786	LTR/ERVL	1888	+	234	9053551	1795
chr8	23428849	23628849	harbor1	chr8	23476479	23477036	LTR/ERVL	1571	+	278	23476757	47908
chr8	94973525	95173525	harbor1	chr8	94977551	94977795	LTR/ERVL	757	+	122	94977673	4148
chr8	94973525	95173525	harbor1	chr8	94978733	94979077	LTR/ERVL	3693	+	172	94978905	5380
chr8	94973525	95173525	harbor1	chr8	95021718	95022039	LTR/ERVL	1005	+	160	95021878	48353
chr8	94973525	95173525	harbor1	chr8	95064578	95065400	LTR/ERVL	3907	+	411	95064989	91464
chr8	94973525	95173525	harbor1	chr8	94977876	94978433	LTR/ERVL	3693	+	278	94978154	4629
chr8	140984887	141184887	harbor1	chr8	141040908	141041284	LTR/ERVL	900	+	188	141041096	56209
chr8	140984887	141184887	harbor1	chr8	141084124	141084415	LTR/ERVL	481	+	146	141084270	99383
chr8	140984887	141184887	harbor1	chr8	141066023	141066486	LTR/ERVL	1787	+	232	141066255	81368
chr8	23428936	23628936	harbor1	chr8	23476479	23477036	LTR/ERVL	1571	+	278	23476757	47821
chr8	143147120	143347120	harbor1	chr8	143165743	143165996	LTR/ERVL	789	+	126	143165869	18749
chr8	143147120	143347120	harbor1	chr8	143193481	143193894	LTR/ERVL	1855	+	206	143193687	46567
chr8	143147120	143347120	harbor1	chr8	143196487	143196561	LTR/ERVL	546	+	37	143196524	49404
chr8	143147120	143347120	harbor1	chr8	143196560	143196761	LTR/ERVL	1462	+	100	143196660	49540
chr8	143147120	143347120	harbor1	chr8	143196827	143196865	LTR/ERVL	1462	+	19	143196846	49726
chr8	143147120	143347120	harbor1	chr8	143195432	143196486	LTR/ERVL	7686	+	527	143195959	48839
chr8	23409024	23609024	harbor1	chr8	23476479	23477036	LTR/ERVL	1571	+	278	23476757	67733
chr8	23428958	23628958	harbor1	chr8	23476479	23477036	LTR/ERVL	1571	+	278	23476757	47799
chr8	26477624	26677624	harbor1	chr8	26477707	26477996	LTR/ERVL	1586	+	144	26477851	227
chr8	26477624	26677624	harbor1	chr8	26478378	26478458	LTR/ERVL	1586	+	40	26478418	794
chr8	26477624	26677624	harbor1	chr8	26485629	26486111	LTR/ERVL	2095	+	241	26485870	8246
chr8	8286401	8486401	harbor1	chr8	8314798	8315467	LTR/ERVL	3909	+	334	8315132	28731
chr8	23382017	23582017	harbor1	chr8	23476479	23477036	LTR/ERVL	1571	+	278	23476757	94740
chr8	23428526	23628526	harbor1	chr8	23476479	23477036	LTR/ERVL	1571	+	278	23476757	48231
chr8	27519509	27719509	harbor1	chr8	27591212	27591596	LTR/ERVL	2014	+	192	27591404	71895
chr8	25084956	25284956	harbor1	chr8	25122545	25123006	LTR/ERVL	1634	+	230	25122775	37819
chr8	25084956	25284956	harbor1	chr8	25123009	25123490	LTR/ERVL	2825	+	240	25123249	38293
chr8	25084956	25284956	harbor1	chr8	25123537	25123863	LTR/ERVL	1891	+	163	25123700	38744
chr8	25084956	25284956	harbor1	chr8	25123926	25124192	LTR/ERVL	1439	+	133	25124059	39103
chr8	25084956	25284956	harbor1	chr8	25124197	25124527	LTR/ERVL	1369	+	165	25124362	39406
chr8	25084956	25284956	harbor1	chr8	25161905	25162072	LTR/ERVL	414	+	84	25161989	77033
chr8	21328820	21528820	harbor1	chr8	21339495	21339813	LTR/ERVL	1524	+	159	21339654	10834
chr8	21328820	21528820	harbor1	chr8	21339866	21339898	LTR/ERVL	1524	+	16	21339882	11062
chr8	21328820	21528820	harbor1	chr8	21342498	21342965	LTR/ERVL	1623	+	234	21342732	13912
chr8	21328820	21528820	harbor1	chr8	21349319	21349782	LTR/ERVL	2320	+	232	21349551	20731
chr8	21328820	21528820	harbor1	chr8	21391375	21391426	LTR/ERVL	524	+	26	21391401	62581
chr8	21328820	21528820	harbor1	chr8	21392075	21392457	LTR/ERVL	524	+	191	21392266	63446
chr8	21328820	21528820	harbor1	chr8	21392622	21392927	LTR/ERVL	686	+	152	21392774	63954
chr8	21328820	21528820	harbor1	chr8	21393040	21393443	LTR/ERVL	793	+	202	21393242	64422
chr8	23382188	23582188	harbor1	chr8	23476479	23477036	LTR/ERVL	1571	+	278	23476757	94569
chr8	20295312	20495312	harbor1	chr8	20358808	20359236	LTR/ERVL	2362	+	214	20359022	63710
chr8	23381183	23581183	harbor1	chr8	23476479	23477036	LTR/ERVL	1571	+	278	23476757	95574
chr8	23428879	23628879	harbor1	chr8	23476479	23477036	LTR/ERVL	1571	+	278	23476757	47878
chr8	144299476	144499476	harbor1	chr8	144343454	144343779	LTR/ERVL	533	+	162	144343616	44140
chr8	142677225	142877225	harbor1	chr8	142761500	142762292	LTR/ERVL	3591	+	396	142761896	84671
chr8	142524934	142724934	harbor1	chr8	142554851	142555631	LTR/ERVL	3303	+	390	142555241	30307
chr8	142524934	142724934	harbor1	chr8	142564749	142565392	LTR/ERVL	619	+	322	142565071	40137
chr8	142524957	142724957	harbor1	chr8	142554851	142555631	LTR/ERVL	3303	+	390	142555241	30284
chr8	142524957	142724957	harbor1	chr8	142564749	142565392	LTR/ERVL	619	+	322	142565071	40114
chr8	23429068	23629068	harbor1	chr8	23476479	23477036	LTR/ERVL	1571	+	278	23476757	47689
chr8	58558195	58758195	harbor1	chr8	58611933	58612790	LTR/ERVL	3302	+	428	58612361	54166
chr8	58558195	58758195	harbor1	chr8	58624947	58625335	LTR/ERVL	1433	+	194	58625141	66946
chr8	23424122	23624122	harbor1	chr8	23476479	23477036	LTR/ERVL	1571	+	278	23476757	52635
chr8	23381900	23581900	harbor1	chr8	23476479	23477036	LTR/ERVL	1571	+	278	23476757	94857
chr8	11745829	11945829	harbor1	chr8	11836486	11836655	LTR/ERVL	503	+	84	11836570	90741
chr8	142524984	142724984	harbor1	chr8	142554851	142555631	LTR/ERVL	3303	+	390	142555241	30257
chr8	142524984	142724984	harbor1	chr8	142564749	142565392	LTR/ERVL	619	+	322	142565071	40087
chr8	142524942	142724942	harbor1	chr8	142554851	142555631	LTR/ERVL	3303	+	390	142555241	30299
chr8	142524942	142724942	harbor1	chr8	142564749	142565392	LTR/ERVL	619	+	322	142565071	40129
chr8	138710548	138910548	harbor1	chr8	138720149	138720597	LTR/ERVL	822	+	224	138720373	9825
chr8	138710548	138910548	harbor1	chr8	138733753	138734264	LTR/ERVL	1519	+	256	138734009	23461
chr8	138710548	138910548	harbor1	chr8	138765485	138766087	LTR/ERVL	2854	+	301	138765786	55238
chr8	102556596	102756596	harbor1	chr8	102644172	102644667	LTR/ERVL	2016	+	248	102644420	87824
chr8	23428939	23628939	harbor1	chr8	23476479	23477036	LTR/ERVL	1571	+	278	23476757	47818
chr8	23412882	23612882	harbor1	chr8	23476479	23477036	LTR/ERVL	1571	+	278	23476757	63875
chr8	29983323	30183323	harbor1	chr8	29983604	29984157	LTR/ERVL	1965	+	276	29983880	557
chr8	29983323	30183323	harbor1	chr8	30005503	30006054	LTR/ERVL	1207	+	276	30005779	22456
chr8	29983323	30183323	harbor1	chr8	30007218	30007318	LTR/ERVL	1207	+	50	30007268	23945
chr8	29983323	30183323	harbor1	chr8	30048922	30048990	LTR/ERVL	430	+	34	30048956	65633
chr8	29983323	30183323	harbor1	chr8	30056873	30057055	LTR/ERVL	779	+	91	30056964	73641
chr8	29983323	30183323	harbor1	chr8	30075384	30075655	LTR/ERVL	440	+	136	30075520	92197
chr8	29983355	30183355	harbor1	chr8	29983604	29984157	LTR/ERVL	1965	+	276	29983880	525
chr8	29983355	30183355	harbor1	chr8	30005503	30006054	LTR/ERVL	1207	+	276	30005779	22424
chr8	29983355	30183355	harbor1	chr8	30007218	30007318	LTR/ERVL	1207	+	50	30007268	23913
chr8	29983355	30183355	harbor1	chr8	30048922	30048990	LTR/ERVL	430	+	34	30048956	65601
chr8	29983355	30183355	harbor1	chr8	30056873	30057055	LTR/ERVL	779	+	91	30056964	73609
chr8	29983355	30183355	harbor1	chr8	30075384	30075655	LTR/ERVL	440	+	136	30075520	92165
chr8	89884330	90084330	harbor1	chr8	89934372	89934593	LTR/ERVL	532	+	110	89934482	50152
chr8	104489421	104689421	harbor1	chr8	104493456	104494086	LTR/ERVL	2576	+	315	104493771	4350
chr8	28286313	28486313	harbor1	chr8	28297354	28297568	LTR/ERVL	414	+	107	28297461	11148
chr8	23583116	23783116	harbor1	chr8	23591977	23592310	LTR/ERVL	945	+	166	23592143	9027
chr8	23583116	23783116	harbor1	chr8	23608750	23609142	LTR/ERVL	1371	+	196	23608946	25830
chr8	23583116	23783116	harbor1	chr8	23675804	23676073	LTR/ERVL	483	+	134	23675938	92822
chr8	138710571	138910571	harbor1	chr8	138720149	138720597	LTR/ERVL	822	+	224	138720373	9802
chr8	138710571	138910571	harbor1	chr8	138733753	138734264	LTR/ERVL	1519	+	256	138734009	23438
chr8	138710571	138910571	harbor1	chr8	138765485	138766087	LTR/ERVL	2854	+	301	138765786	55215
chr9	4883718	5083718	harbor1	chr9	4971442	4971760	LTR/ERVL	1353	+	159	4971601	87883
chr9	4883718	5083718	harbor1	chr9	4972365	4972544	LTR/ERVL	1353	+	90	4972455	88737
chr9	4884896	5084896	harbor1	chr9	4971442	4971760	LTR/ERVL	1353	+	159	4971601	86705
chr9	4884896	5084896	harbor1	chr9	4972365	4972544	LTR/ERVL	1353	+	90	4972455	87559
chr9	4883068	5083068	harbor1	chr9	4971442	4971760	LTR/ERVL	1353	+	159	4971601	88533
chr9	4883068	5083068	harbor1	chr9	4972365	4972544	LTR/ERVL	1353	+	90	4972455	89387
chr9	137214159	137414159	harbor1	chr9	137249416	137249649	LTR/ERVL	867	+	116	137249532	35373
chr9	137214159	137414159	harbor1	chr9	137249657	137250192	LTR/ERVL	1825	+	268	137249925	35766
chr9	4884791	5084791	harbor1	chr9	4971442	4971760	LTR/ERVL	1353	+	159	4971601	86810
chr9	4884791	5084791	harbor1	chr9	4972365	4972544	LTR/ERVL	1353	+	90	4972455	87664
chr9	4879886	5079886	harbor1	chr9	4971442	4971760	LTR/ERVL	1353	+	159	4971601	91715
chr9	4879886	5079886	harbor1	chr9	4972365	4972544	LTR/ERVL	1353	+	90	4972455	92569
chr9	4692784	4892784	harbor1	chr9	4719472	4719754	LTR/ERVL	1402	+	141	4719613	26829
chr9	4692784	4892784	harbor1	chr9	4767974	4768533	LTR/ERVL	2710	+	280	4768254	75470
chr9	4692784	4892784	harbor1	chr9	4768560	4768598	LTR/ERVL	623	+	19	4768579	75795
chr9	4692784	4892784	harbor1	chr9	4776096	4776156	LTR/ERVL	1756	+	30	4776126	83342
chr9	4692784	4892784	harbor1	chr9	4776449	4776750	LTR/ERVL	1756	+	150	4776599	83815
chr9	137213401	137413401	harbor1	chr9	137249416	137249649	LTR/ERVL	867	+	116	137249532	36131
chr9	137213401	137413401	harbor1	chr9	137249657	137250192	LTR/ERVL	1825	+	268	137249925	36524
chr9	4884806	5084806	harbor1	chr9	4971442	4971760	LTR/ERVL	1353	+	159	4971601	86795
chr9	4884806	5084806	harbor1	chr9	4972365	4972544	LTR/ERVL	1353	+	90	4972455	87649
chr9	4669274	4869274	harbor1	chr9	4719472	4719754	LTR/ERVL	1402	+	141	4719613	50339
chr9	4669274	4869274	harbor1	chr9	4767974	4768533	LTR/ERVL	2710	+	280	4768254	98980
chr9	4669274	4869274	harbor1	chr9	4768560	4768598	LTR/ERVL	623	+	19	4768579	99305
chr9	4692259	4892259	harbor1	chr9	4719472	4719754	LTR/ERVL	1402	+	141	4719613	27354
chr9	4692259	4892259	harbor1	chr9	4767974	4768533	LTR/ERVL	2710	+	280	4768254	75995
chr9	4692259	4892259	harbor1	chr9	4768560	4768598	LTR/ERVL	623	+	19	4768579	76320
chr9	4692259	4892259	harbor1	chr9	4776096	4776156	LTR/ERVL	1756	+	30	4776126	83867
chr9	4692259	4892259	harbor1	chr9	4776449	4776750	LTR/ERVL	1756	+	150	4776599	84340
chr9	4883408	5083408	harbor1	chr9	4971442	4971760	LTR/ERVL	1353	+	159	4971601	88193
chr9	4883408	5083408	harbor1	chr9	4972365	4972544	LTR/ERVL	1353	+	90	4972455	89047
chr9	4884822	5084822	harbor1	chr9	4971442	4971760	LTR/ERVL	1353	+	159	4971601	86779
chr9	4884822	5084822	harbor1	chr9	4972365	4972544	LTR/ERVL	1353	+	90	4972455	87633
chr9	4641119	4841119	harbor1	chr9	4719472	4719754	LTR/ERVL	1402	+	141	4719613	78494
chr9	4580286	4780286	harbor1	chr9	4625983	4626718	LTR/ERVL	1044	+	368	4626351	46065
chr9	112387325	112587325	harbor1	chr9	112474175	112474321	LTR/ERVL	2525	+	73	112474248	86923
chr9	112387325	112587325	harbor1	chr9	112474401	112474977	LTR/ERVL	2525	+	288	112474689	87364
chr9	112387325	112587325	harbor1	chr9	112483117	112483243	LTR/ERVL	1393	+	63	112483180	95855
chr9	112387325	112587325	harbor1	chr9	112483549	112483647	LTR/ERVL	1393	+	49	112483598	96273
chr9	112387325	112587325	harbor1	chr9	112483945	112484074	LTR/ERVL	1393	+	64	112484009	96684
chr9	4692922	4892922	harbor1	chr9	4719472	4719754	LTR/ERVL	1402	+	141	4719613	26691
chr9	4692922	4892922	harbor1	chr9	4767974	4768533	LTR/ERVL	2710	+	280	4768254	75332
chr9	4692922	4892922	harbor1	chr9	4768560	4768598	LTR/ERVL	623	+	19	4768579	75657
chr9	4692922	4892922	harbor1	chr9	4776096	4776156	LTR/ERVL	1756	+	30	4776126	83204
chr9	4692922	4892922	harbor1	chr9	4776449	4776750	LTR/ERVL	1756	+	150	4776599	83677
chr9	79473193	79673193	harbor1	chr9	79535421	79535886	LTR/ERVL	1983	+	232	79535653	62460
chr9	79473193	79673193	harbor1	chr9	79553267	79553721	LTR/ERVL	2669	+	227	79553494	80301
chr9	4694655	4894655	harbor1	chr9	4719472	4719754	LTR/ERVL	1402	+	141	4719613	24958
chr9	4694655	4894655	harbor1	chr9	4767974	4768533	LTR/ERVL	2710	+	280	4768254	73599
chr9	4694655	4894655	harbor1	chr9	4768560	4768598	LTR/ERVL	623	+	19	4768579	73924
chr9	4694655	4894655	harbor1	chr9	4776096	4776156	LTR/ERVL	1756	+	30	4776126	81471
chr9	4694655	4894655	harbor1	chr9	4776449	4776750	LTR/ERVL	1756	+	150	4776599	81944
chr9	4771292	4971292	harbor1	chr9	4776096	4776156	LTR/ERVL	1756	+	30	4776126	4834
chr9	4771292	4971292	harbor1	chr9	4776449	4776750	LTR/ERVL	1756	+	150	4776599	5307
chr9	4726841	4926841	harbor1	chr9	4767974	4768533	LTR/ERVL	2710	+	280	4768254	41413
chr9	4726841	4926841	harbor1	chr9	4768560	4768598	LTR/ERVL	623	+	19	4768579	41738
chr9	4726841	4926841	harbor1	chr9	4776096	4776156	LTR/ERVL	1756	+	30	4776126	49285
chr9	4726841	4926841	harbor1	chr9	4776449	4776750	LTR/ERVL	1756	+	150	4776599	49758
chr9	4883803	5083803	harbor1	chr9	4971442	4971760	LTR/ERVL	1353	+	159	4971601	87798
chr9	4883803	5083803	harbor1	chr9	4972365	4972544	LTR/ERVL	1353	+	90	4972455	88652
chr9	112387187	112587187	harbor1	chr9	112474175	112474321	LTR/ERVL	2525	+	73	112474248	87061
chr9	112387187	112587187	harbor1	chr9	112474401	112474977	LTR/ERVL	2525	+	288	112474689	87502
chr9	112387187	112587187	harbor1	chr9	112483117	112483243	LTR/ERVL	1393	+	63	112483180	95993
chr9	112387187	112587187	harbor1	chr9	112483549	112483647	LTR/ERVL	1393	+	49	112483598	96411
chr9	112387187	112587187	harbor1	chr9	112483945	112484074	LTR/ERVL	1393	+	64	112484009	96822
chr9	4681965	4881965	harbor1	chr9	4719472	4719754	LTR/ERVL	1402	+	141	4719613	37648
chr9	4681965	4881965	harbor1	chr9	4767974	4768533	LTR/ERVL	2710	+	280	4768254	86289
chr9	4681965	4881965	harbor1	chr9	4768560	4768598	LTR/ERVL	623	+	19	4768579	86614
chr9	4681965	4881965	harbor1	chr9	4776096	4776156	LTR/ERVL	1756	+	30	4776126	94161
chr9	4681965	4881965	harbor1	chr9	4776449	4776750	LTR/ERVL	1756	+	150	4776599	94634
chr9	4885009	5085009	harbor1	chr9	4971442	4971760	LTR/ERVL	1353	+	159	4971601	86592
chr9	4885009	5085009	harbor1	chr9	4972365	4972544	LTR/ERVL	1353	+	90	4972455	87446
chr9	4692767	4892767	harbor1	chr9	4719472	4719754	LTR/ERVL	1402	+	141	4719613	26846
chr9	4692767	4892767	harbor1	chr9	4767974	4768533	LTR/ERVL	2710	+	280	4768254	75487
chr9	4692767	4892767	harbor1	chr9	4768560	4768598	LTR/ERVL	623	+	19	4768579	75812
chr9	4692767	4892767	harbor1	chr9	4776096	4776156	LTR/ERVL	1756	+	30	4776126	83359
chr9	4692767	4892767	harbor1	chr9	4776449	4776750	LTR/ERVL	1756	+	150	4776599	83832
chr9	4697988	4897988	harbor1	chr9	4719472	4719754	LTR/ERVL	1402	+	141	4719613	21625
chr9	4697988	4897988	harbor1	chr9	4767974	4768533	LTR/ERVL	2710	+	280	4768254	70266
chr9	4697988	4897988	harbor1	chr9	4768560	4768598	LTR/ERVL	623	+	19	4768579	70591
chr9	4697988	4897988	harbor1	chr9	4776096	4776156	LTR/ERVL	1756	+	30	4776126	78138
chr9	4697988	4897988	harbor1	chr9	4776449	4776750	LTR/ERVL	1756	+	150	4776599	78611
chr9	4642306	4842306	harbor1	chr9	4719472	4719754	LTR/ERVL	1402	+	141	4719613	77307
chr9	4692228	4892228	harbor1	chr9	4719472	4719754	LTR/ERVL	1402	+	141	4719613	27385
chr9	4692228	4892228	harbor1	chr9	4767974	4768533	LTR/ERVL	2710	+	280	4768254	76026
chr9	4692228	4892228	harbor1	chr9	4768560	4768598	LTR/ERVL	623	+	19	4768579	76351
chr9	4692228	4892228	harbor1	chr9	4776096	4776156	LTR/ERVL	1756	+	30	4776126	83898
chr9	4692228	4892228	harbor1	chr9	4776449	4776750	LTR/ERVL	1756	+	150	4776599	84371
chr9	4663605	4863605	harbor1	chr9	4719472	4719754	LTR/ERVL	1402	+	141	4719613	56008
chr9	4692785	4892785	harbor1	chr9	4719472	4719754	LTR/ERVL	1402	+	141	4719613	26828
chr9	4692785	4892785	harbor1	chr9	4767974	4768533	LTR/ERVL	2710	+	280	4768254	75469
chr9	4692785	4892785	harbor1	chr9	4768560	4768598	LTR/ERVL	623	+	19	4768579	75794
chr9	4692785	4892785	harbor1	chr9	4776096	4776156	LTR/ERVL	1756	+	30	4776126	83341
chr9	4692785	4892785	harbor1	chr9	4776449	4776750	LTR/ERVL	1756	+	150	4776599	83814
chr9	3260153	3460153	harbor1	chr9	3263687	3264172	LTR/ERVL	1309	+	242	3263929	3776
chr9	3260153	3460153	harbor1	chr9	3279858	3280410	LTR/ERVL	580	+	276	3280134	19981
chr9	4692247	4892247	harbor1	chr9	4719472	4719754	LTR/ERVL	1402	+	141	4719613	27366
chr9	4692247	4892247	harbor1	chr9	4767974	4768533	LTR/ERVL	2710	+	280	4768254	76007
chr9	4692247	4892247	harbor1	chr9	4768560	4768598	LTR/ERVL	623	+	19	4768579	76332
chr9	4692247	4892247	harbor1	chr9	4776096	4776156	LTR/ERVL	1756	+	30	4776126	83879
chr9	4692247	4892247	harbor1	chr9	4776449	4776750	LTR/ERVL	1756	+	150	4776599	84352
chr9	4692230	4892230	harbor1	chr9	4719472	4719754	LTR/ERVL	1402	+	141	4719613	27383
chr9	4692230	4892230	harbor1	chr9	4767974	4768533	LTR/ERVL	2710	+	280	4768254	76024
chr9	4692230	4892230	harbor1	chr9	4768560	4768598	LTR/ERVL	623	+	19	4768579	76349
chr9	4692230	4892230	harbor1	chr9	4776096	4776156	LTR/ERVL	1756	+	30	4776126	83896
chr9	4692230	4892230	harbor1	chr9	4776449	4776750	LTR/ERVL	1756	+	150	4776599	84369
chr9	4650540	4850540	harbor1	chr9	4719472	4719754	LTR/ERVL	1402	+	141	4719613	69073
chr9	4883789	5083789	harbor1	chr9	4971442	4971760	LTR/ERVL	1353	+	159	4971601	87812
chr9	4883789	5083789	harbor1	chr9	4972365	4972544	LTR/ERVL	1353	+	90	4972455	88666
chr9	137214640	137414640	harbor1	chr9	137249416	137249649	LTR/ERVL	867	+	116	137249532	34892
chr9	137214640	137414640	harbor1	chr9	137249657	137250192	LTR/ERVL	1825	+	268	137249925	35285
chr9	4692833	4892833	harbor1	chr9	4719472	4719754	LTR/ERVL	1402	+	141	4719613	26780
chr9	4692833	4892833	harbor1	chr9	4767974	4768533	LTR/ERVL	2710	+	280	4768254	75421
chr9	4692833	4892833	harbor1	chr9	4768560	4768598	LTR/ERVL	623	+	19	4768579	75746
chr9	4692833	4892833	harbor1	chr9	4776096	4776156	LTR/ERVL	1756	+	30	4776126	83293
chr9	4692833	4892833	harbor1	chr9	4776449	4776750	LTR/ERVL	1756	+	150	4776599	83766
chr9	92958938	93158938	harbor1	chr9	92988550	92989012	LTR/ERVL	1881	+	231	92988781	29843
chr9	4883747	5083747	harbor1	chr9	4971442	4971760	LTR/ERVL	1353	+	159	4971601	87854
chr9	4883747	5083747	harbor1	chr9	4972365	4972544	LTR/ERVL	1353	+	90	4972455	88708
chr9	4883810	5083810	harbor1	chr9	4971442	4971760	LTR/ERVL	1353	+	159	4971601	87791
chr9	4883810	5083810	harbor1	chr9	4972365	4972544	LTR/ERVL	1353	+	90	4972455	88645
chr9	4883816	5083816	harbor1	chr9	4971442	4971760	LTR/ERVL	1353	+	159	4971601	87785
chr9	4883816	5083816	harbor1	chr9	4972365	4972544	LTR/ERVL	1353	+	90	4972455	88639
chr9	4884825	5084825	harbor1	chr9	4971442	4971760	LTR/ERVL	1353	+	159	4971601	86776
chr9	4884825	5084825	harbor1	chr9	4972365	4972544	LTR/ERVL	1353	+	90	4972455	87630
chr9	4884808	5084808	harbor1	chr9	4971442	4971760	LTR/ERVL	1353	+	159	4971601	86793
chr9	4884808	5084808	harbor1	chr9	4972365	4972544	LTR/ERVL	1353	+	90	4972455	87647
chr9	4663129	4863129	harbor1	chr9	4719472	4719754	LTR/ERVL	1402	+	141	4719613	56484
chr9	4692827	4892827	harbor1	chr9	4719472	4719754	LTR/ERVL	1402	+	141	4719613	26786
chr9	4692827	4892827	harbor1	chr9	4767974	4768533	LTR/ERVL	2710	+	280	4768254	75427
chr9	4692827	4892827	harbor1	chr9	4768560	4768598	LTR/ERVL	623	+	19	4768579	75752
chr9	4692827	4892827	harbor1	chr9	4776096	4776156	LTR/ERVL	1756	+	30	4776126	83299
chr9	4692827	4892827	harbor1	chr9	4776449	4776750	LTR/ERVL	1756	+	150	4776599	83772
chr9	111384785	111584785	harbor1	chr9	111390869	111391288	LTR/ERVL	590	+	210	111391079	6294
chr9	111384785	111584785	harbor1	chr9	111455146	111455203	LTR/ERVL	2592	+	28	111455174	70389
chr9	111384785	111584785	harbor1	chr9	111455507	111455994	LTR/ERVL	2592	+	244	111455751	70966
chr9	111384785	111584785	harbor1	chr9	111458652	111459110	LTR/ERVL	952	+	229	111458881	74096
chr9	4692787	4892787	harbor1	chr9	4719472	4719754	LTR/ERVL	1402	+	141	4719613	26826
chr9	4692787	4892787	harbor1	chr9	4767974	4768533	LTR/ERVL	2710	+	280	4768254	75467
chr9	4692787	4892787	harbor1	chr9	4768560	4768598	LTR/ERVL	623	+	19	4768579	75792
chr9	4692787	4892787	harbor1	chr9	4776096	4776156	LTR/ERVL	1756	+	30	4776126	83339
chr9	4692787	4892787	harbor1	chr9	4776449	4776750	LTR/ERVL	1756	+	150	4776599	83812
chr9	4883160	5083160	harbor1	chr9	4971442	4971760	LTR/ERVL	1353	+	159	4971601	88441
chr9	4883160	5083160	harbor1	chr9	4972365	4972544	LTR/ERVL	1353	+	90	4972455	89295
chr9	112387209	112587209	harbor1	chr9	112474175	112474321	LTR/ERVL	2525	+	73	112474248	87039
chr9	112387209	112587209	harbor1	chr9	112474401	112474977	LTR/ERVL	2525	+	288	112474689	87480
chr9	112387209	112587209	harbor1	chr9	112483117	112483243	LTR/ERVL	1393	+	63	112483180	95971
chr9	112387209	112587209	harbor1	chr9	112483549	112483647	LTR/ERVL	1393	+	49	112483598	96389
chr9	112387209	112587209	harbor1	chr9	112483945	112484074	LTR/ERVL	1393	+	64	112484009	96800
chr9	4776709	4976709	harbor1	chr9	4776449	4776750	LTR/ERVL	1756	+	150	4776599	110
chr9	4692828	4892828	harbor1	chr9	4719472	4719754	LTR/ERVL	1402	+	141	4719613	26785
chr9	4692828	4892828	harbor1	chr9	4767974	4768533	LTR/ERVL	2710	+	280	4768254	75426
chr9	4692828	4892828	harbor1	chr9	4768560	4768598	LTR/ERVL	623	+	19	4768579	75751
chr9	4692828	4892828	harbor1	chr9	4776096	4776156	LTR/ERVL	1756	+	30	4776126	83298
chr9	4692828	4892828	harbor1	chr9	4776449	4776750	LTR/ERVL	1756	+	150	4776599	83771
chr9	4884936	5084936	harbor1	chr9	4971442	4971760	LTR/ERVL	1353	+	159	4971601	86665
chr9	4884936	5084936	harbor1	chr9	4972365	4972544	LTR/ERVL	1353	+	90	4972455	87519
chr9	4692847	4892847	harbor1	chr9	4719472	4719754	LTR/ERVL	1402	+	141	4719613	26766
chr9	4692847	4892847	harbor1	chr9	4767974	4768533	LTR/ERVL	2710	+	280	4768254	75407
chr9	4692847	4892847	harbor1	chr9	4768560	4768598	LTR/ERVL	623	+	19	4768579	75732
chr9	4692847	4892847	harbor1	chr9	4776096	4776156	LTR/ERVL	1756	+	30	4776126	83279
chr9	4692847	4892847	harbor1	chr9	4776449	4776750	LTR/ERVL	1756	+	150	4776599	83752
chr9	4740507	4940507	harbor1	chr9	4767974	4768533	LTR/ERVL	2710	+	280	4768254	27747
chr9	4740507	4940507	harbor1	chr9	4768560	4768598	LTR/ERVL	623	+	19	4768579	28072
chr9	4740507	4940507	harbor1	chr9	4776096	4776156	LTR/ERVL	1756	+	30	4776126	35619
chr9	4740507	4940507	harbor1	chr9	4776449	4776750	LTR/ERVL	1756	+	150	4776599	36092
chr9	112387193	112587193	harbor1	chr9	112474175	112474321	LTR/ERVL	2525	+	73	112474248	87055
chr9	112387193	112587193	harbor1	chr9	112474401	112474977	LTR/ERVL	2525	+	288	112474689	87496
chr9	112387193	112587193	harbor1	chr9	112483117	112483243	LTR/ERVL	1393	+	63	112483180	95987
chr9	112387193	112587193	harbor1	chr9	112483549	112483647	LTR/ERVL	1393	+	49	112483598	96405
chr9	112387193	112587193	harbor1	chr9	112483945	112484074	LTR/ERVL	1393	+	64	112484009	96816
chr9	4879772	5079772	harbor1	chr9	4971442	4971760	LTR/ERVL	1353	+	159	4971601	91829
chr9	4879772	5079772	harbor1	chr9	4972365	4972544	LTR/ERVL	1353	+	90	4972455	92683
chr9	4883377	5083377	harbor1	chr9	4971442	4971760	LTR/ERVL	1353	+	159	4971601	88224
chr9	4883377	5083377	harbor1	chr9	4972365	4972544	LTR/ERVL	1353	+	90	4972455	89078
chr9	3122465	3322465	harbor1	chr9	3151363	3151905	LTR/ERVL	2533	+	271	3151634	29169
chr9	3122465	3322465	harbor1	chr9	3177424	3177978	LTR/ERVL	3016	+	277	3177701	55236
chr9	3122465	3322465	harbor1	chr9	3214883	3215793	LTR/ERVL	1079	+	455	3215338	92873
chr9	134035598	134235598	harbor1	chr9	134111144	134111681	LTR/ERVL	1985	+	268	134111412	75814
chr9	4884878	5084878	harbor1	chr9	4971442	4971760	LTR/ERVL	1353	+	159	4971601	86723
chr9	4884878	5084878	harbor1	chr9	4972365	4972544	LTR/ERVL	1353	+	90	4972455	87577
chr9	3361464	3561464	harbor1	chr9	3372035	3372487	LTR/ERVL	1412	+	226	3372261	10797
chr9	4883431	5083431	harbor1	chr9	4971442	4971760	LTR/ERVL	1353	+	159	4971601	88170
chr9	4883431	5083431	harbor1	chr9	4972365	4972544	LTR/ERVL	1353	+	90	4972455	89024
chr9	4738230	4938230	harbor1	chr9	4767974	4768533	LTR/ERVL	2710	+	280	4768254	30024
chr9	4738230	4938230	harbor1	chr9	4768560	4768598	LTR/ERVL	623	+	19	4768579	30349
chr9	4738230	4938230	harbor1	chr9	4776096	4776156	LTR/ERVL	1756	+	30	4776126	37896
chr9	4738230	4938230	harbor1	chr9	4776449	4776750	LTR/ERVL	1756	+	150	4776599	38369
chr9	137214636	137414636	harbor1	chr9	137249416	137249649	LTR/ERVL	867	+	116	137249532	34896
chr9	137214636	137414636	harbor1	chr9	137249657	137250192	LTR/ERVL	1825	+	268	137249925	35289
chr9	92958964	93158964	harbor1	chr9	92988550	92989012	LTR/ERVL	1881	+	231	92988781	29817
chr9	4884856	5084856	harbor1	chr9	4971442	4971760	LTR/ERVL	1353	+	159	4971601	86745
chr9	4884856	5084856	harbor1	chr9	4972365	4972544	LTR/ERVL	1353	+	90	4972455	87599
chr9	4692837	4892837	harbor1	chr9	4719472	4719754	LTR/ERVL	1402	+	141	4719613	26776
chr9	4692837	4892837	harbor1	chr9	4767974	4768533	LTR/ERVL	2710	+	280	4768254	75417
chr9	4692837	4892837	harbor1	chr9	4768560	4768598	LTR/ERVL	623	+	19	4768579	75742
chr9	4692837	4892837	harbor1	chr9	4776096	4776156	LTR/ERVL	1756	+	30	4776126	83289
chr9	4692837	4892837	harbor1	chr9	4776449	4776750	LTR/ERVL	1756	+	150	4776599	83762
chr9	4885107	5085107	harbor1	chr9	4971442	4971760	LTR/ERVL	1353	+	159	4971601	86494
chr9	4885107	5085107	harbor1	chr9	4972365	4972544	LTR/ERVL	1353	+	90	4972455	87348
chr9	112387231	112587231	harbor1	chr9	112474175	112474321	LTR/ERVL	2525	+	73	112474248	87017
chr9	112387231	112587231	harbor1	chr9	112474401	112474977	LTR/ERVL	2525	+	288	112474689	87458
chr9	112387231	112587231	harbor1	chr9	112483117	112483243	LTR/ERVL	1393	+	63	112483180	95949
chr9	112387231	112587231	harbor1	chr9	112483549	112483647	LTR/ERVL	1393	+	49	112483598	96367
chr9	112387231	112587231	harbor1	chr9	112483945	112484074	LTR/ERVL	1393	+	64	112484009	96778
chr9	4669616	4869616	harbor1	chr9	4719472	4719754	LTR/ERVL	1402	+	141	4719613	49997
chr9	4669616	4869616	harbor1	chr9	4767974	4768533	LTR/ERVL	2710	+	280	4768254	98638
chr9	4669616	4869616	harbor1	chr9	4768560	4768598	LTR/ERVL	623	+	19	4768579	98963
chr9	133966927	134166927	harbor1	chr9	134005309	134005829	LTR/ERVL	803	+	260	134005569	38642
chr9	133966927	134166927	harbor1	chr9	134010148	134010798	LTR/ERVL	1139	+	325	134010473	43546
chr9	133966927	134166927	harbor1	chr9	134015217	134015458	LTR/ERVL	851	+	120	134015337	48410
chr9	4776719	4976719	harbor1	chr9	4776449	4776750	LTR/ERVL	1756	+	150	4776599	120
chr9	135508512	135708512	harbor1	chr9	135533607	135533793	LTR/ERVL	549	+	93	135533700	25188
chr9	135508512	135708512	harbor1	chr9	135534154	135534605	LTR/ERVL	1391	+	226	135534380	25868
chr9	4692923	4892923	harbor1	chr9	4719472	4719754	LTR/ERVL	1402	+	141	4719613	26690
chr9	4692923	4892923	harbor1	chr9	4767974	4768533	LTR/ERVL	2710	+	280	4768254	75331
chr9	4692923	4892923	harbor1	chr9	4768560	4768598	LTR/ERVL	623	+	19	4768579	75656
chr9	4692923	4892923	harbor1	chr9	4776096	4776156	LTR/ERVL	1756	+	30	4776126	83203
chr9	4692923	4892923	harbor1	chr9	4776449	4776750	LTR/ERVL	1756	+	150	4776599	83676
chr9	4692123	4892123	harbor1	chr9	4719472	4719754	LTR/ERVL	1402	+	141	4719613	27490
chr9	4692123	4892123	harbor1	chr9	4767974	4768533	LTR/ERVL	2710	+	280	4768254	76131
chr9	4692123	4892123	harbor1	chr9	4768560	4768598	LTR/ERVL	623	+	19	4768579	76456
chr9	4692123	4892123	harbor1	chr9	4776096	4776156	LTR/ERVL	1756	+	30	4776126	84003
chr9	4692123	4892123	harbor1	chr9	4776449	4776750	LTR/ERVL	1756	+	150	4776599	84476
chr9	4692181	4892181	harbor1	chr9	4719472	4719754	LTR/ERVL	1402	+	141	4719613	27432
chr9	4692181	4892181	harbor1	chr9	4767974	4768533	LTR/ERVL	2710	+	280	4768254	76073
chr9	4692181	4892181	harbor1	chr9	4768560	4768598	LTR/ERVL	623	+	19	4768579	76398
chr9	4692181	4892181	harbor1	chr9	4776096	4776156	LTR/ERVL	1756	+	30	4776126	83945
chr9	4692181	4892181	harbor1	chr9	4776449	4776750	LTR/ERVL	1756	+	150	4776599	84418
chr9	4692953	4892953	harbor1	chr9	4719472	4719754	LTR/ERVL	1402	+	141	4719613	26660
chr9	4692953	4892953	harbor1	chr9	4767974	4768533	LTR/ERVL	2710	+	280	4768254	75301
chr9	4692953	4892953	harbor1	chr9	4768560	4768598	LTR/ERVL	623	+	19	4768579	75626
chr9	4692953	4892953	harbor1	chr9	4776096	4776156	LTR/ERVL	1756	+	30	4776126	83173
chr9	4692953	4892953	harbor1	chr9	4776449	4776750	LTR/ERVL	1756	+	150	4776599	83646
chr9	4737755	4937755	harbor1	chr9	4767974	4768533	LTR/ERVL	2710	+	280	4768254	30499
chr9	4737755	4937755	harbor1	chr9	4768560	4768598	LTR/ERVL	623	+	19	4768579	30824
chr9	4737755	4937755	harbor1	chr9	4776096	4776156	LTR/ERVL	1756	+	30	4776126	38371
chr9	4737755	4937755	harbor1	chr9	4776449	4776750	LTR/ERVL	1756	+	150	4776599	38844
chr9	112387246	112587246	harbor1	chr9	112474175	112474321	LTR/ERVL	2525	+	73	112474248	87002
chr9	112387246	112587246	harbor1	chr9	112474401	112474977	LTR/ERVL	2525	+	288	112474689	87443
chr9	112387246	112587246	harbor1	chr9	112483117	112483243	LTR/ERVL	1393	+	63	112483180	95934
chr9	112387246	112587246	harbor1	chr9	112483549	112483647	LTR/ERVL	1393	+	49	112483598	96352
chr9	112387246	112587246	harbor1	chr9	112483945	112484074	LTR/ERVL	1393	+	64	112484009	96763
chr9	133063738	133263738	harbor1	chr9	133156878	133157011	LTR/ERVL	611	+	66	133156944	93206
chr9	133063738	133263738	harbor1	chr9	133157311	133157462	LTR/ERVL	611	+	76	133157387	93649
chr9	4692921	4892921	harbor1	chr9	4719472	4719754	LTR/ERVL	1402	+	141	4719613	26692
chr9	4692921	4892921	harbor1	chr9	4767974	4768533	LTR/ERVL	2710	+	280	4768254	75333
chr9	4692921	4892921	harbor1	chr9	4768560	4768598	LTR/ERVL	623	+	19	4768579	75658
chr9	4692921	4892921	harbor1	chr9	4776096	4776156	LTR/ERVL	1756	+	30	4776126	83205
chr9	4692921	4892921	harbor1	chr9	4776449	4776750	LTR/ERVL	1756	+	150	4776599	83678
chr9	92958998	93158998	harbor1	chr9	92988550	92989012	LTR/ERVL	1881	+	231	92988781	29783
chr9	131570740	131770740	harbor1	chr9	131642266	131642666	LTR/ERVL	1162	+	200	131642466	71726
chr9	131570740	131770740	harbor1	chr9	131665714	131665950	LTR/ERVL	618	+	118	131665832	95092
chr9	112387188	112587188	harbor1	chr9	112474175	112474321	LTR/ERVL	2525	+	73	112474248	87060
chr9	112387188	112587188	harbor1	chr9	112474401	112474977	LTR/ERVL	2525	+	288	112474689	87501
chr9	112387188	112587188	harbor1	chr9	112483117	112483243	LTR/ERVL	1393	+	63	112483180	95992
chr9	112387188	112587188	harbor1	chr9	112483549	112483647	LTR/ERVL	1393	+	49	112483598	96410
chr9	112387188	112587188	harbor1	chr9	112483945	112484074	LTR/ERVL	1393	+	64	112484009	96821
chr9	4883740	5083740	harbor1	chr9	4971442	4971760	LTR/ERVL	1353	+	159	4971601	87861
chr9	4883740	5083740	harbor1	chr9	4972365	4972544	LTR/ERVL	1353	+	90	4972455	88715
chr9	4879743	5079743	harbor1	chr9	4971442	4971760	LTR/ERVL	1353	+	159	4971601	91858
chr9	4879743	5079743	harbor1	chr9	4972365	4972544	LTR/ERVL	1353	+	90	4972455	92712
chr9	4884898	5084898	harbor1	chr9	4971442	4971760	LTR/ERVL	1353	+	159	4971601	86703
chr9	4884898	5084898	harbor1	chr9	4972365	4972544	LTR/ERVL	1353	+	90	4972455	87557
chr9	4692437	4892437	harbor1	chr9	4719472	4719754	LTR/ERVL	1402	+	141	4719613	27176
chr9	4692437	4892437	harbor1	chr9	4767974	4768533	LTR/ERVL	2710	+	280	4768254	75817
chr9	4692437	4892437	harbor1	chr9	4768560	4768598	LTR/ERVL	623	+	19	4768579	76142
chr9	4692437	4892437	harbor1	chr9	4776096	4776156	LTR/ERVL	1756	+	30	4776126	83689
chr9	4692437	4892437	harbor1	chr9	4776449	4776750	LTR/ERVL	1756	+	150	4776599	84162
chr9	112387261	112587261	harbor1	chr9	112474175	112474321	LTR/ERVL	2525	+	73	112474248	86987
chr9	112387261	112587261	harbor1	chr9	112474401	112474977	LTR/ERVL	2525	+	288	112474689	87428
chr9	112387261	112587261	harbor1	chr9	112483117	112483243	LTR/ERVL	1393	+	63	112483180	95919
chr9	112387261	112587261	harbor1	chr9	112483549	112483647	LTR/ERVL	1393	+	49	112483598	96337
chr9	112387261	112587261	harbor1	chr9	112483945	112484074	LTR/ERVL	1393	+	64	112484009	96748
chr9	4884872	5084872	harbor1	chr9	4971442	4971760	LTR/ERVL	1353	+	159	4971601	86729
chr9	4884872	5084872	harbor1	chr9	4972365	4972544	LTR/ERVL	1353	+	90	4972455	87583
chr9	79473185	79673185	harbor1	chr9	79535421	79535886	LTR/ERVL	1983	+	232	79535653	62468
chr9	79473185	79673185	harbor1	chr9	79553267	79553721	LTR/ERVL	2669	+	227	79553494	80309
chr9	4669276	4869276	harbor1	chr9	4719472	4719754	LTR/ERVL	1402	+	141	4719613	50337
chr9	4669276	4869276	harbor1	chr9	4767974	4768533	LTR/ERVL	2710	+	280	4768254	98978
chr9	4669276	4869276	harbor1	chr9	4768560	4768598	LTR/ERVL	623	+	19	4768579	99303
chr9	4663207	4863207	harbor1	chr9	4719472	4719754	LTR/ERVL	1402	+	141	4719613	56406
chr9	4692939	4892939	harbor1	chr9	4719472	4719754	LTR/ERVL	1402	+	141	4719613	26674
chr9	4692939	4892939	harbor1	chr9	4767974	4768533	LTR/ERVL	2710	+	280	4768254	75315
chr9	4692939	4892939	harbor1	chr9	4768560	4768598	LTR/ERVL	623	+	19	4768579	75640
chr9	4692939	4892939	harbor1	chr9	4776096	4776156	LTR/ERVL	1756	+	30	4776126	83187
chr9	4692939	4892939	harbor1	chr9	4776449	4776750	LTR/ERVL	1756	+	150	4776599	83660
chr9	137029517	137229517	harbor1	chr9	137037577	137037963	LTR/ERVL	2567	+	193	137037770	8253
chr9	137029517	137229517	harbor1	chr9	137038258	137038324	LTR/ERVL	684	+	33	137038291	8774
chr9	4883387	5083387	harbor1	chr9	4971442	4971760	LTR/ERVL	1353	+	159	4971601	88214
chr9	4883387	5083387	harbor1	chr9	4972365	4972544	LTR/ERVL	1353	+	90	4972455	89068
chr9	4883374	5083374	harbor1	chr9	4971442	4971760	LTR/ERVL	1353	+	159	4971601	88227
chr9	4883374	5083374	harbor1	chr9	4972365	4972544	LTR/ERVL	1353	+	90	4972455	89081
chr9	137212276	137412276	harbor1	chr9	137249416	137249649	LTR/ERVL	867	+	116	137249532	37256
chr9	137212276	137412276	harbor1	chr9	137249657	137250192	LTR/ERVL	1825	+	268	137249925	37649
chr9	4694199	4894199	harbor1	chr9	4719472	4719754	LTR/ERVL	1402	+	141	4719613	25414
chr9	4694199	4894199	harbor1	chr9	4767974	4768533	LTR/ERVL	2710	+	280	4768254	74055
chr9	4694199	4894199	harbor1	chr9	4768560	4768598	LTR/ERVL	623	+	19	4768579	74380
chr9	4694199	4894199	harbor1	chr9	4776096	4776156	LTR/ERVL	1756	+	30	4776126	81927
chr9	4694199	4894199	harbor1	chr9	4776449	4776750	LTR/ERVL	1756	+	150	4776599	82400
chr9	4883171	5083171	harbor1	chr9	4971442	4971760	LTR/ERVL	1353	+	159	4971601	88430
chr9	4883171	5083171	harbor1	chr9	4972365	4972544	LTR/ERVL	1353	+	90	4972455	89284
chr9	112387224	112587224	harbor1	chr9	112474175	112474321	LTR/ERVL	2525	+	73	112474248	87024
chr9	112387224	112587224	harbor1	chr9	112474401	112474977	LTR/ERVL	2525	+	288	112474689	87465
chr9	112387224	112587224	harbor1	chr9	112483117	112483243	LTR/ERVL	1393	+	63	112483180	95956
chr9	112387224	112587224	harbor1	chr9	112483549	112483647	LTR/ERVL	1393	+	49	112483598	96374
chr9	112387224	112587224	harbor1	chr9	112483945	112484074	LTR/ERVL	1393	+	64	112484009	96785
chr9	92959012	93159012	harbor1	chr9	92988550	92989012	LTR/ERVL	1881	+	231	92988781	29769
chr9	137214593	137414593	harbor1	chr9	137249416	137249649	LTR/ERVL	867	+	116	137249532	34939
chr9	137214593	137414593	harbor1	chr9	137249657	137250192	LTR/ERVL	1825	+	268	137249925	35332
chr9	2024097	2224097	harbor1	chr9	2038334	2038802	LTR/ERVL	849	+	234	2038568	14471
chr9	4692195	4892195	harbor1	chr9	4719472	4719754	LTR/ERVL	1402	+	141	4719613	27418
chr9	4692195	4892195	harbor1	chr9	4767974	4768533	LTR/ERVL	2710	+	280	4768254	76059
chr9	4692195	4892195	harbor1	chr9	4768560	4768598	LTR/ERVL	623	+	19	4768579	76384
chr9	4692195	4892195	harbor1	chr9	4776096	4776156	LTR/ERVL	1756	+	30	4776126	83931
chr9	4692195	4892195	harbor1	chr9	4776449	4776750	LTR/ERVL	1756	+	150	4776599	84404
chr9	92958991	93158991	harbor1	chr9	92988550	92989012	LTR/ERVL	1881	+	231	92988781	29790
chr9	4673229	4873229	harbor1	chr9	4719472	4719754	LTR/ERVL	1402	+	141	4719613	46384
chr9	4673229	4873229	harbor1	chr9	4767974	4768533	LTR/ERVL	2710	+	280	4768254	95025
chr9	4673229	4873229	harbor1	chr9	4768560	4768598	LTR/ERVL	623	+	19	4768579	95350
chr9	4692970	4892970	harbor1	chr9	4719472	4719754	LTR/ERVL	1402	+	141	4719613	26643
chr9	4692970	4892970	harbor1	chr9	4767974	4768533	LTR/ERVL	2710	+	280	4768254	75284
chr9	4692970	4892970	harbor1	chr9	4768560	4768598	LTR/ERVL	623	+	19	4768579	75609
chr9	4692970	4892970	harbor1	chr9	4776096	4776156	LTR/ERVL	1756	+	30	4776126	83156
chr9	4692970	4892970	harbor1	chr9	4776449	4776750	LTR/ERVL	1756	+	150	4776599	83629
chr9	3146618	3346618	harbor1	chr9	3151363	3151905	LTR/ERVL	2533	+	271	3151634	5016
chr9	3146618	3346618	harbor1	chr9	3177424	3177978	LTR/ERVL	3016	+	277	3177701	31083
chr9	3146618	3346618	harbor1	chr9	3214883	3215793	LTR/ERVL	1079	+	455	3215338	68720
chr9	1998082	2198082	harbor1	chr9	2006455	2006732	LTR/ERVL	742	+	138	2006593	8511
chr9	1998082	2198082	harbor1	chr9	2038334	2038802	LTR/ERVL	849	+	234	2038568	40486
chr9	133064057	133264057	harbor1	chr9	133156878	133157011	LTR/ERVL	611	+	66	133156944	92887
chr9	133064057	133264057	harbor1	chr9	133157311	133157462	LTR/ERVL	611	+	76	133157387	93330
chr9	4692737	4892737	harbor1	chr9	4719472	4719754	LTR/ERVL	1402	+	141	4719613	26876
chr9	4692737	4892737	harbor1	chr9	4767974	4768533	LTR/ERVL	2710	+	280	4768254	75517
chr9	4692737	4892737	harbor1	chr9	4768560	4768598	LTR/ERVL	623	+	19	4768579	75842
chr9	4692737	4892737	harbor1	chr9	4776096	4776156	LTR/ERVL	1756	+	30	4776126	83389
chr9	4692737	4892737	harbor1	chr9	4776449	4776750	LTR/ERVL	1756	+	150	4776599	83862
chr9	97401848	97601848	harbor1	chr9	97450820	97451300	LTR/ERVL	3654	+	240	97451060	49212
chr9	97401848	97601848	harbor1	chr9	97451592	97451970	LTR/ERVL	3654	+	189	97451781	49933
chr9	4692768	4892768	harbor1	chr9	4719472	4719754	LTR/ERVL	1402	+	141	4719613	26845
chr9	4692768	4892768	harbor1	chr9	4767974	4768533	LTR/ERVL	2710	+	280	4768254	75486
chr9	4692768	4892768	harbor1	chr9	4768560	4768598	LTR/ERVL	623	+	19	4768579	75811
chr9	4692768	4892768	harbor1	chr9	4776096	4776156	LTR/ERVL	1756	+	30	4776126	83358
chr9	4692768	4892768	harbor1	chr9	4776449	4776750	LTR/ERVL	1756	+	150	4776599	83831
chr9	4693017	4893017	harbor1	chr9	4719472	4719754	LTR/ERVL	1402	+	141	4719613	26596
chr9	4693017	4893017	harbor1	chr9	4767974	4768533	LTR/ERVL	2710	+	280	4768254	75237
chr9	4693017	4893017	harbor1	chr9	4768560	4768598	LTR/ERVL	623	+	19	4768579	75562
chr9	4693017	4893017	harbor1	chr9	4776096	4776156	LTR/ERVL	1756	+	30	4776126	83109
chr9	4693017	4893017	harbor1	chr9	4776449	4776750	LTR/ERVL	1756	+	150	4776599	83582
chr9	137316476	137516476	harbor1	chr9	137332900	137333444	LTR/ERVL	2368	+	272	137333172	16696
chr9	4884823	5084823	harbor1	chr9	4971442	4971760	LTR/ERVL	1353	+	159	4971601	86778
chr9	4884823	5084823	harbor1	chr9	4972365	4972544	LTR/ERVL	1353	+	90	4972455	87632
chr9	4883080	5083080	harbor1	chr9	4971442	4971760	LTR/ERVL	1353	+	159	4971601	88521
chr9	4883080	5083080	harbor1	chr9	4972365	4972544	LTR/ERVL	1353	+	90	4972455	89375
chr9	137029490	137229490	harbor1	chr9	137037577	137037963	LTR/ERVL	2567	+	193	137037770	8280
chr9	137029490	137229490	harbor1	chr9	137038258	137038324	LTR/ERVL	684	+	33	137038291	8801
chr9	91323378	91523378	harbor1	chr9	91334212	91334673	LTR/ERVL	1895	+	230	91334442	11064
chr9	91323378	91523378	harbor1	chr9	91346004	91346560	LTR/ERVL	2146	+	278	91346282	22904
chr9	137214592	137414592	harbor1	chr9	137249416	137249649	LTR/ERVL	867	+	116	137249532	34940
chr9	137214592	137414592	harbor1	chr9	137249657	137250192	LTR/ERVL	1825	+	268	137249925	35333
chr9	4884842	5084842	harbor1	chr9	4971442	4971760	LTR/ERVL	1353	+	159	4971601	86759
chr9	4884842	5084842	harbor1	chr9	4972365	4972544	LTR/ERVL	1353	+	90	4972455	87613
chr9	4692946	4892946	harbor1	chr9	4719472	4719754	LTR/ERVL	1402	+	141	4719613	26667
chr9	4692946	4892946	harbor1	chr9	4767974	4768533	LTR/ERVL	2710	+	280	4768254	75308
chr9	4692946	4892946	harbor1	chr9	4768560	4768598	LTR/ERVL	623	+	19	4768579	75633
chr9	4692946	4892946	harbor1	chr9	4776096	4776156	LTR/ERVL	1756	+	30	4776126	83180
chr9	4692946	4892946	harbor1	chr9	4776449	4776750	LTR/ERVL	1756	+	150	4776599	83653
chr9	4579427	4779427	harbor1	chr9	4625983	4626718	LTR/ERVL	1044	+	368	4626351	46924
chr9	131575355	131775355	harbor1	chr9	131642266	131642666	LTR/ERVL	1162	+	200	131642466	67111
chr9	131575355	131775355	harbor1	chr9	131665714	131665950	LTR/ERVL	618	+	118	131665832	90477
chr9	4659562	4859562	harbor1	chr9	4719472	4719754	LTR/ERVL	1402	+	141	4719613	60051
chr9	131575427	131775427	harbor1	chr9	131642266	131642666	LTR/ERVL	1162	+	200	131642466	67039
chr9	131575427	131775427	harbor1	chr9	131665714	131665950	LTR/ERVL	618	+	118	131665832	90405
chr9	4884794	5084794	harbor1	chr9	4971442	4971760	LTR/ERVL	1353	+	159	4971601	86807
chr9	4884794	5084794	harbor1	chr9	4972365	4972544	LTR/ERVL	1353	+	90	4972455	87661
chr9	129542143	129742143	harbor1	chr9	129542836	129543066	LTR/ERVL	640	+	115	129542951	808
chr9	129542143	129742143	harbor1	chr9	129572708	129573151	LTR/ERVL	1114	+	222	129572930	30787
chr9	133063678	133263678	harbor1	chr9	133156878	133157011	LTR/ERVL	611	+	66	133156944	93266
chr9	133063678	133263678	harbor1	chr9	133157311	133157462	LTR/ERVL	611	+	76	133157387	93709
chr9	4883172	5083172	harbor1	chr9	4971442	4971760	LTR/ERVL	1353	+	159	4971601	88429
chr9	4883172	5083172	harbor1	chr9	4972365	4972544	LTR/ERVL	1353	+	90	4972455	89283
chr9	4692889	4892889	harbor1	chr9	4719472	4719754	LTR/ERVL	1402	+	141	4719613	26724
chr9	4692889	4892889	harbor1	chr9	4767974	4768533	LTR/ERVL	2710	+	280	4768254	75365
chr9	4692889	4892889	harbor1	chr9	4768560	4768598	LTR/ERVL	623	+	19	4768579	75690
chr9	4692889	4892889	harbor1	chr9	4776096	4776156	LTR/ERVL	1756	+	30	4776126	83237
chr9	4692889	4892889	harbor1	chr9	4776449	4776750	LTR/ERVL	1756	+	150	4776599	83710
chr9	89937233	90137233	harbor1	chr9	90017494	90019089	LTR/ERVL	2539	+	798	90018292	81059
chr9	89937233	90137233	harbor1	chr9	90019144	90019501	LTR/ERVL	710	+	178	90019322	82089
chr9	64278589	64478589	harbor1	chr9	64316295	64316437	LTR/ERVL	495	+	71	64316366	37777
chr9	64278589	64478589	harbor1	chr9	64316518	64316945	LTR/ERVL	1279	+	214	64316732	38143
chr9	4884884	5084884	harbor1	chr9	4971442	4971760	LTR/ERVL	1353	+	159	4971601	86717
chr9	4884884	5084884	harbor1	chr9	4972365	4972544	LTR/ERVL	1353	+	90	4972455	87571
chr9	4883057	5083057	harbor1	chr9	4971442	4971760	LTR/ERVL	1353	+	159	4971601	88544
chr9	4883057	5083057	harbor1	chr9	4972365	4972544	LTR/ERVL	1353	+	90	4972455	89398
chr9	4883813	5083813	harbor1	chr9	4971442	4971760	LTR/ERVL	1353	+	159	4971601	87788
chr9	4883813	5083813	harbor1	chr9	4972365	4972544	LTR/ERVL	1353	+	90	4972455	88642
chr9	4884786	5084786	harbor1	chr9	4971442	4971760	LTR/ERVL	1353	+	159	4971601	86815
chr9	4884786	5084786	harbor1	chr9	4972365	4972544	LTR/ERVL	1353	+	90	4972455	87669
chr9	4884810	5084810	harbor1	chr9	4971442	4971760	LTR/ERVL	1353	+	159	4971601	86791
chr9	4884810	5084810	harbor1	chr9	4972365	4972544	LTR/ERVL	1353	+	90	4972455	87645
chr9	4749616	4949616	harbor1	chr9	4767974	4768533	LTR/ERVL	2710	+	280	4768254	18638
chr9	4749616	4949616	harbor1	chr9	4768560	4768598	LTR/ERVL	623	+	19	4768579	18963
chr9	4749616	4949616	harbor1	chr9	4776096	4776156	LTR/ERVL	1756	+	30	4776126	26510
chr9	4749616	4949616	harbor1	chr9	4776449	4776750	LTR/ERVL	1756	+	150	4776599	26983
chr9	4669937	4869937	harbor1	chr9	4719472	4719754	LTR/ERVL	1402	+	141	4719613	49676
chr9	4669937	4869937	harbor1	chr9	4767974	4768533	LTR/ERVL	2710	+	280	4768254	98317
chr9	4669937	4869937	harbor1	chr9	4768560	4768598	LTR/ERVL	623	+	19	4768579	98642
chr9	4694651	4894651	harbor1	chr9	4719472	4719754	LTR/ERVL	1402	+	141	4719613	24962
chr9	4694651	4894651	harbor1	chr9	4767974	4768533	LTR/ERVL	2710	+	280	4768254	73603
chr9	4694651	4894651	harbor1	chr9	4768560	4768598	LTR/ERVL	623	+	19	4768579	73928
chr9	4694651	4894651	harbor1	chr9	4776096	4776156	LTR/ERVL	1756	+	30	4776126	81475
chr9	4694651	4894651	harbor1	chr9	4776449	4776750	LTR/ERVL	1756	+	150	4776599	81948
chr9	135465766	135665766	harbor1	chr9	135533607	135533793	LTR/ERVL	549	+	93	135533700	67934
chr9	135465766	135665766	harbor1	chr9	135534154	135534605	LTR/ERVL	1391	+	226	135534380	68614
chr9	4884784	5084784	harbor1	chr9	4971442	4971760	LTR/ERVL	1353	+	159	4971601	86817
chr9	4884784	5084784	harbor1	chr9	4972365	4972544	LTR/ERVL	1353	+	90	4972455	87671
chr9	4694865	4894865	harbor1	chr9	4719472	4719754	LTR/ERVL	1402	+	141	4719613	24748
chr9	4694865	4894865	harbor1	chr9	4767974	4768533	LTR/ERVL	2710	+	280	4768254	73389
chr9	4694865	4894865	harbor1	chr9	4768560	4768598	LTR/ERVL	623	+	19	4768579	73714
chr9	4694865	4894865	harbor1	chr9	4776096	4776156	LTR/ERVL	1756	+	30	4776126	81261
chr9	4694865	4894865	harbor1	chr9	4776449	4776750	LTR/ERVL	1756	+	150	4776599	81734
chr9	4692795	4892795	harbor1	chr9	4719472	4719754	LTR/ERVL	1402	+	141	4719613	26818
chr9	4692795	4892795	harbor1	chr9	4767974	4768533	LTR/ERVL	2710	+	280	4768254	75459
chr9	4692795	4892795	harbor1	chr9	4768560	4768598	LTR/ERVL	623	+	19	4768579	75784
chr9	4692795	4892795	harbor1	chr9	4776096	4776156	LTR/ERVL	1756	+	30	4776126	83331
chr9	4692795	4892795	harbor1	chr9	4776449	4776750	LTR/ERVL	1756	+	150	4776599	83804
chr9	68605549	68805549	harbor1	chr9	68606573	68607099	LTR/ERVL	2580	+	263	68606836	1287
chr9	68605549	68805549	harbor1	chr9	68634248	68634706	LTR/ERVL	1390	+	229	68634477	28928
chr9	68605549	68805549	harbor1	chr9	68661999	68662160	LTR/ERVL	673	+	80	68662079	56530
chr9	68605549	68805549	harbor1	chr9	68663292	68665299	LTR/ERVL	3516	+	1004	68664296	58747
chr9	68605549	68805549	harbor1	chr9	68667709	68668071	LTR/ERVL	1092	+	181	68667890	62341
chr9	68605549	68805549	harbor1	chr9	68671043	68671520	LTR/ERVL	1601	+	238	68671281	65732
chr9	4884847	5084847	harbor1	chr9	4971442	4971760	LTR/ERVL	1353	+	159	4971601	86754
chr9	4884847	5084847	harbor1	chr9	4972365	4972544	LTR/ERVL	1353	+	90	4972455	87608
chr9	4884951	5084951	harbor1	chr9	4971442	4971760	LTR/ERVL	1353	+	159	4971601	86650
chr9	4884951	5084951	harbor1	chr9	4972365	4972544	LTR/ERVL	1353	+	90	4972455	87504
chr9	4692232	4892232	harbor1	chr9	4719472	4719754	LTR/ERVL	1402	+	141	4719613	27381
chr9	4692232	4892232	harbor1	chr9	4767974	4768533	LTR/ERVL	2710	+	280	4768254	76022
chr9	4692232	4892232	harbor1	chr9	4768560	4768598	LTR/ERVL	623	+	19	4768579	76347
chr9	4692232	4892232	harbor1	chr9	4776096	4776156	LTR/ERVL	1756	+	30	4776126	83894
chr9	4692232	4892232	harbor1	chr9	4776449	4776750	LTR/ERVL	1756	+	150	4776599	84367
chr9	108346093	108546093	harbor1	chr9	108376806	108377073	LTR/ERVL	861	+	134	108376940	30847
chr9	108346093	108546093	harbor1	chr9	108377717	108377977	LTR/ERVL	616	+	130	108377847	31754
chr9	89509793	89709793	harbor1	chr9	89512449	89512721	LTR/ERVL	685	+	136	89512585	2792
chr9	89509793	89709793	harbor1	chr9	89532814	89533354	LTR/ERVL	1898	+	270	89533084	23291
chr9	4884827	5084827	harbor1	chr9	4971442	4971760	LTR/ERVL	1353	+	159	4971601	86774
chr9	4884827	5084827	harbor1	chr9	4972365	4972544	LTR/ERVL	1353	+	90	4972455	87628
chr9	134035554	134235554	harbor1	chr9	134111144	134111681	LTR/ERVL	1985	+	268	134111412	75858
chr9	131575342	131775342	harbor1	chr9	131642266	131642666	LTR/ERVL	1162	+	200	131642466	67124
chr9	131575342	131775342	harbor1	chr9	131665714	131665950	LTR/ERVL	618	+	118	131665832	90490
chr9	4648821	4848821	harbor1	chr9	4719472	4719754	LTR/ERVL	1402	+	141	4719613	70792
chr9	136294898	136494898	harbor1	chr9	136315240	136315754	LTR/ERVL	1101	+	257	136315497	20599
chr9	136294898	136494898	harbor1	chr9	136316858	136317220	LTR/ERVL	718	+	181	136317039	22141
chr9	136294898	136494898	harbor1	chr9	136317581	136318401	LTR/ERVL	718	+	410	136317991	23093
chr9	135905941	136105941	harbor1	chr9	135964526	135964734	LTR/ERVL	538	+	104	135964630	58689
chr9	135905941	136105941	harbor1	chr9	135976221	135976978	LTR/ERVL	2707	+	378	135976599	70658
chr9	87626432	87826432	harbor1	chr9	87638913	87639207	LTR/ERVL	795	+	147	87639060	12628
chr9	4669262	4869262	harbor1	chr9	4719472	4719754	LTR/ERVL	1402	+	141	4719613	50351
chr9	4669262	4869262	harbor1	chr9	4767974	4768533	LTR/ERVL	2710	+	280	4768254	98992
chr9	4669262	4869262	harbor1	chr9	4768560	4768598	LTR/ERVL	623	+	19	4768579	99317
chr9	97885101	98085101	harbor1	chr9	97965278	97965512	LTR/ERVL	769	+	117	97965395	80294
chr9	4692222	4892222	harbor1	chr9	4719472	4719754	LTR/ERVL	1402	+	141	4719613	27391
chr9	4692222	4892222	harbor1	chr9	4767974	4768533	LTR/ERVL	2710	+	280	4768254	76032
chr9	4692222	4892222	harbor1	chr9	4768560	4768598	LTR/ERVL	623	+	19	4768579	76357
chr9	4692222	4892222	harbor1	chr9	4776096	4776156	LTR/ERVL	1756	+	30	4776126	83904
chr9	4692222	4892222	harbor1	chr9	4776449	4776750	LTR/ERVL	1756	+	150	4776599	84377
chr9	68605579	68805579	harbor1	chr9	68606573	68607099	LTR/ERVL	2580	+	263	68606836	1257
chr9	68605579	68805579	harbor1	chr9	68634248	68634706	LTR/ERVL	1390	+	229	68634477	28898
chr9	68605579	68805579	harbor1	chr9	68661999	68662160	LTR/ERVL	673	+	80	68662079	56500
chr9	68605579	68805579	harbor1	chr9	68663292	68665299	LTR/ERVL	3516	+	1004	68664296	58717
chr9	68605579	68805579	harbor1	chr9	68667709	68668071	LTR/ERVL	1092	+	181	68667890	62311
chr9	68605579	68805579	harbor1	chr9	68671043	68671520	LTR/ERVL	1601	+	238	68671281	65702
chr9	4879662	5079662	harbor1	chr9	4971442	4971760	LTR/ERVL	1353	+	159	4971601	91939
chr9	4879662	5079662	harbor1	chr9	4972365	4972544	LTR/ERVL	1353	+	90	4972455	92793
chr9	4579422	4779422	harbor1	chr9	4625983	4626718	LTR/ERVL	1044	+	368	4626351	46929
chr9	85705422	85905422	harbor1	chr9	85724944	85725133	LTR/ERVL	513	+	94	85725038	19616
chr9	85705422	85905422	harbor1	chr9	85730253	85730928	LTR/ERVL	2556	+	338	85730591	25169
chr9	4883218	5083218	harbor1	chr9	4971442	4971760	LTR/ERVL	1353	+	159	4971601	88383
chr9	4883218	5083218	harbor1	chr9	4972365	4972544	LTR/ERVL	1353	+	90	4972455	89237
chr9	4883477	5083477	harbor1	chr9	4971442	4971760	LTR/ERVL	1353	+	159	4971601	88124
chr9	4883477	5083477	harbor1	chr9	4972365	4972544	LTR/ERVL	1353	+	90	4972455	88978
chr9	4663738	4863738	harbor1	chr9	4719472	4719754	LTR/ERVL	1402	+	141	4719613	55875
chr9	4885072	5085072	harbor1	chr9	4971442	4971760	LTR/ERVL	1353	+	159	4971601	86529
chr9	4885072	5085072	harbor1	chr9	4972365	4972544	LTR/ERVL	1353	+	90	4972455	87383
chr9	4663518	4863518	harbor1	chr9	4719472	4719754	LTR/ERVL	1402	+	141	4719613	56095
chr9	130042390	130242390	harbor1	chr9	130046068	130046451	LTR/ERVL	2862	+	192	130046260	3870
chr9	130042390	130242390	harbor1	chr9	130046797	130047096	LTR/ERVL	2862	+	150	130046947	4557
chr9	130042390	130242390	harbor1	chr9	130047207	130047316	LTR/ERVL	609	+	54	130047261	4871
chr9	4692806	4892806	harbor1	chr9	4719472	4719754	LTR/ERVL	1402	+	141	4719613	26807
chr9	4692806	4892806	harbor1	chr9	4767974	4768533	LTR/ERVL	2710	+	280	4768254	75448
chr9	4692806	4892806	harbor1	chr9	4768560	4768598	LTR/ERVL	623	+	19	4768579	75773
chr9	4692806	4892806	harbor1	chr9	4776096	4776156	LTR/ERVL	1756	+	30	4776126	83320
chr9	4692806	4892806	harbor1	chr9	4776449	4776750	LTR/ERVL	1756	+	150	4776599	83793
chr9	4744087	4944087	harbor1	chr9	4767974	4768533	LTR/ERVL	2710	+	280	4768254	24167
chr9	4744087	4944087	harbor1	chr9	4768560	4768598	LTR/ERVL	623	+	19	4768579	24492
chr9	4744087	4944087	harbor1	chr9	4776096	4776156	LTR/ERVL	1756	+	30	4776126	32039
chr9	4744087	4944087	harbor1	chr9	4776449	4776750	LTR/ERVL	1756	+	150	4776599	32512
chr9	133762512	133962512	harbor1	chr9	133817874	133818082	LTR/ERVL	2555	+	104	133817978	55466
chr9	133762512	133962512	harbor1	chr9	133818385	133818735	LTR/ERVL	2555	+	175	133818560	56048
chr9	133762512	133962512	harbor1	chr9	133858019	133858593	LTR/ERVL	2083	+	287	133858306	95794
chr9	4884871	5084871	harbor1	chr9	4971442	4971760	LTR/ERVL	1353	+	159	4971601	86730
chr9	4884871	5084871	harbor1	chr9	4972365	4972544	LTR/ERVL	1353	+	90	4972455	87584
chr9	4692558	4892558	harbor1	chr9	4719472	4719754	LTR/ERVL	1402	+	141	4719613	27055
chr9	4692558	4892558	harbor1	chr9	4767974	4768533	LTR/ERVL	2710	+	280	4768254	75696
chr9	4692558	4892558	harbor1	chr9	4768560	4768598	LTR/ERVL	623	+	19	4768579	76021
chr9	4692558	4892558	harbor1	chr9	4776096	4776156	LTR/ERVL	1756	+	30	4776126	83568
chr9	4692558	4892558	harbor1	chr9	4776449	4776750	LTR/ERVL	1756	+	150	4776599	84041
chr9	4883433	5083433	harbor1	chr9	4971442	4971760	LTR/ERVL	1353	+	159	4971601	88168
chr9	4883433	5083433	harbor1	chr9	4972365	4972544	LTR/ERVL	1353	+	90	4972455	89022
chr9	87626458	87826458	harbor1	chr9	87638913	87639207	LTR/ERVL	795	+	147	87639060	12602
chr9	105145295	105345295	harbor1	chr9	105179871	105180275	LTR/ERVL	2158	+	202	105180073	34778
chr9	112387255	112587255	harbor1	chr9	112474175	112474321	LTR/ERVL	2525	+	73	112474248	86993
chr9	112387255	112587255	harbor1	chr9	112474401	112474977	LTR/ERVL	2525	+	288	112474689	87434
chr9	112387255	112587255	harbor1	chr9	112483117	112483243	LTR/ERVL	1393	+	63	112483180	95925
chr9	112387255	112587255	harbor1	chr9	112483549	112483647	LTR/ERVL	1393	+	49	112483598	96343
chr9	112387255	112587255	harbor1	chr9	112483945	112484074	LTR/ERVL	1393	+	64	112484009	96754
chr9	4730514	4930514	harbor1	chr9	4767974	4768533	LTR/ERVL	2710	+	280	4768254	37740
chr9	4730514	4930514	harbor1	chr9	4768560	4768598	LTR/ERVL	623	+	19	4768579	38065
chr9	4730514	4930514	harbor1	chr9	4776096	4776156	LTR/ERVL	1756	+	30	4776126	45612
chr9	4730514	4930514	harbor1	chr9	4776449	4776750	LTR/ERVL	1756	+	150	4776599	46085
chr9	4692205	4892205	harbor1	chr9	4719472	4719754	LTR/ERVL	1402	+	141	4719613	27408
chr9	4692205	4892205	harbor1	chr9	4767974	4768533	LTR/ERVL	2710	+	280	4768254	76049
chr9	4692205	4892205	harbor1	chr9	4768560	4768598	LTR/ERVL	623	+	19	4768579	76374
chr9	4692205	4892205	harbor1	chr9	4776096	4776156	LTR/ERVL	1756	+	30	4776126	83921
chr9	4692205	4892205	harbor1	chr9	4776449	4776750	LTR/ERVL	1756	+	150	4776599	84394
chr9	137176266	137376266	harbor1	chr9	137249416	137249649	LTR/ERVL	867	+	116	137249532	73266
chr9	137176266	137376266	harbor1	chr9	137249657	137250192	LTR/ERVL	1825	+	268	137249925	73659
chr9	4692312	4892312	harbor1	chr9	4719472	4719754	LTR/ERVL	1402	+	141	4719613	27301
chr9	4692312	4892312	harbor1	chr9	4767974	4768533	LTR/ERVL	2710	+	280	4768254	75942
chr9	4692312	4892312	harbor1	chr9	4768560	4768598	LTR/ERVL	623	+	19	4768579	76267
chr9	4692312	4892312	harbor1	chr9	4776096	4776156	LTR/ERVL	1756	+	30	4776126	83814
chr9	4692312	4892312	harbor1	chr9	4776449	4776750	LTR/ERVL	1756	+	150	4776599	84287
chr9	4694469	4894469	harbor1	chr9	4719472	4719754	LTR/ERVL	1402	+	141	4719613	25144
chr9	4694469	4894469	harbor1	chr9	4767974	4768533	LTR/ERVL	2710	+	280	4768254	73785
chr9	4694469	4894469	harbor1	chr9	4768560	4768598	LTR/ERVL	623	+	19	4768579	74110
chr9	4694469	4894469	harbor1	chr9	4776096	4776156	LTR/ERVL	1756	+	30	4776126	81657
chr9	4694469	4894469	harbor1	chr9	4776449	4776750	LTR/ERVL	1756	+	150	4776599	82130
chr9	133819687	134019687	harbor1	chr9	133858019	133858593	LTR/ERVL	2083	+	287	133858306	38619
chr9	133819687	134019687	harbor1	chr9	133875764	133876260	LTR/ERVL	1656	+	248	133876012	56325
chr9	35625694	35825694	harbor1	chr9	35628541	35628845	LTR/ERVL	894	+	152	35628693	2999
chr9	4884855	5084855	harbor1	chr9	4971442	4971760	LTR/ERVL	1353	+	159	4971601	86746
chr9	4884855	5084855	harbor1	chr9	4972365	4972544	LTR/ERVL	1353	+	90	4972455	87600
chr9	133678135	133878135	harbor1	chr9	133752329	133752682	LTR/ERVL	919	+	176	133752505	74370
chr9	137214581	137414581	harbor1	chr9	137249416	137249649	LTR/ERVL	867	+	116	137249532	34951
chr9	137214581	137414581	harbor1	chr9	137249657	137250192	LTR/ERVL	1825	+	268	137249925	35344
chr9	4692887	4892887	harbor1	chr9	4719472	4719754	LTR/ERVL	1402	+	141	4719613	26726
chr9	4692887	4892887	harbor1	chr9	4767974	4768533	LTR/ERVL	2710	+	280	4768254	75367
chr9	4692887	4892887	harbor1	chr9	4768560	4768598	LTR/ERVL	623	+	19	4768579	75692
chr9	4692887	4892887	harbor1	chr9	4776096	4776156	LTR/ERVL	1756	+	30	4776126	83239
chr9	4692887	4892887	harbor1	chr9	4776449	4776750	LTR/ERVL	1756	+	150	4776599	83712
chr9	4884829	5084829	harbor1	chr9	4971442	4971760	LTR/ERVL	1353	+	159	4971601	86772
chr9	4884829	5084829	harbor1	chr9	4972365	4972544	LTR/ERVL	1353	+	90	4972455	87626
chr9	135829624	136029624	harbor1	chr9	135840002	135840307	LTR/ERVL	888	+	152	135840154	10530
chr9	4885054	5085054	harbor1	chr9	4971442	4971760	LTR/ERVL	1353	+	159	4971601	86547
chr9	4885054	5085054	harbor1	chr9	4972365	4972544	LTR/ERVL	1353	+	90	4972455	87401
chr9	4692851	4892851	harbor1	chr9	4719472	4719754	LTR/ERVL	1402	+	141	4719613	26762
chr9	4692851	4892851	harbor1	chr9	4767974	4768533	LTR/ERVL	2710	+	280	4768254	75403
chr9	4692851	4892851	harbor1	chr9	4768560	4768598	LTR/ERVL	623	+	19	4768579	75728
chr9	4692851	4892851	harbor1	chr9	4776096	4776156	LTR/ERVL	1756	+	30	4776126	83275
chr9	4692851	4892851	harbor1	chr9	4776449	4776750	LTR/ERVL	1756	+	150	4776599	83748
chr9	4692854	4892854	harbor1	chr9	4719472	4719754	LTR/ERVL	1402	+	141	4719613	26759
chr9	4692854	4892854	harbor1	chr9	4767974	4768533	LTR/ERVL	2710	+	280	4768254	75400
chr9	4692854	4892854	harbor1	chr9	4768560	4768598	LTR/ERVL	623	+	19	4768579	75725
chr9	4692854	4892854	harbor1	chr9	4776096	4776156	LTR/ERVL	1756	+	30	4776126	83272
chr9	4692854	4892854	harbor1	chr9	4776449	4776750	LTR/ERVL	1756	+	150	4776599	83745
chr9	137214576	137414576	harbor1	chr9	137249416	137249649	LTR/ERVL	867	+	116	137249532	34956
chr9	137214576	137414576	harbor1	chr9	137249657	137250192	LTR/ERVL	1825	+	268	137249925	35349
chr9	133933666	134133666	harbor1	chr9	133934351	133934887	LTR/ERVL	2441	+	268	133934619	953
chr9	133933666	134133666	harbor1	chr9	134005309	134005829	LTR/ERVL	803	+	260	134005569	71903
chr9	133933666	134133666	harbor1	chr9	134010148	134010798	LTR/ERVL	1139	+	325	134010473	76807
chr9	133933666	134133666	harbor1	chr9	134015217	134015458	LTR/ERVL	851	+	120	134015337	81671
chr9	123912168	124112168	harbor1	chr9	123952750	123953032	LTR/ERVL	796	+	141	123952891	40723
chr9	6658127	6858127	harbor1	chr9	6706759	6706836	LTR/ERVL	2171	+	38	6706797	48670
chr9	6658127	6858127	harbor1	chr9	6707124	6707147	LTR/ERVL	2171	+	12	6707136	49009
chr9	6658127	6858127	harbor1	chr9	6707454	6707771	LTR/ERVL	2171	+	158	6707612	49485
chr9	6658127	6858127	harbor1	chr9	6723717	6723818	LTR/ERVL	485	+	50	6723767	65640
chr9	6658127	6858127	harbor1	chr9	6724130	6724498	LTR/ERVL	586	+	184	6724314	66187
chr9	6658127	6858127	harbor1	chr9	6728092	6728247	LTR/ERVL	796	+	78	6728170	70043
chr9	6658127	6858127	harbor1	chr9	6729561	6729827	LTR/ERVL	2146	+	133	6729694	71567
chr9	6658127	6858127	harbor1	chr9	6730130	6730282	LTR/ERVL	2146	+	76	6730206	72079
chr9	6658127	6858127	harbor1	chr9	6733191	6733601	LTR/ERVL	2911	+	205	6733396	75269
chr9	6658127	6858127	harbor1	chr9	6734151	6734287	LTR/ERVL	2911	+	68	6734219	76092
chr9	6658127	6858127	harbor1	chr9	6735169	6735390	LTR/ERVL	737	+	110	6735279	77152
chr9	6658127	6858127	harbor1	chr9	6700799	6701276	LTR/ERVL	1276	+	238	6701037	42910
chr9	4692645	4892645	harbor1	chr9	4719472	4719754	LTR/ERVL	1402	+	141	4719613	26968
chr9	4692645	4892645	harbor1	chr9	4767974	4768533	LTR/ERVL	2710	+	280	4768254	75609
chr9	4692645	4892645	harbor1	chr9	4768560	4768598	LTR/ERVL	623	+	19	4768579	75934
chr9	4692645	4892645	harbor1	chr9	4776096	4776156	LTR/ERVL	1756	+	30	4776126	83481
chr9	4692645	4892645	harbor1	chr9	4776449	4776750	LTR/ERVL	1756	+	150	4776599	83954
chr9	4732434	4932434	harbor1	chr9	4767974	4768533	LTR/ERVL	2710	+	280	4768254	35820
chr9	4732434	4932434	harbor1	chr9	4768560	4768598	LTR/ERVL	623	+	19	4768579	36145
chr9	4732434	4932434	harbor1	chr9	4776096	4776156	LTR/ERVL	1756	+	30	4776126	43692
chr9	4732434	4932434	harbor1	chr9	4776449	4776750	LTR/ERVL	1756	+	150	4776599	44165
chr9	113949333	114149333	harbor1	chr9	113954670	113955153	LTR/ERVL	1210	+	242	113954912	5579
chr9	13706365	13906365	harbor1	chr9	13761392	13761575	LTR/ERVL	614	+	92	13761484	55119
chr9	13706365	13906365	harbor1	chr9	13769012	13769465	LTR/ERVL	1525	+	226	13769238	62873
chr9	133781981	133981981	harbor1	chr9	133817874	133818082	LTR/ERVL	2555	+	104	133817978	35997
chr9	133781981	133981981	harbor1	chr9	133818385	133818735	LTR/ERVL	2555	+	175	133818560	36579
chr9	133781981	133981981	harbor1	chr9	133858019	133858593	LTR/ERVL	2083	+	287	133858306	76325
chr9	133781981	133981981	harbor1	chr9	133875764	133876260	LTR/ERVL	1656	+	248	133876012	94031
chr9	4663234	4863234	harbor1	chr9	4719472	4719754	LTR/ERVL	1402	+	141	4719613	56379
chr9	135515777	135715777	harbor1	chr9	135533607	135533793	LTR/ERVL	549	+	93	135533700	17923
chr9	135515777	135715777	harbor1	chr9	135534154	135534605	LTR/ERVL	1391	+	226	135534380	18603
chr9	134035491	134235491	harbor1	chr9	134111144	134111681	LTR/ERVL	1985	+	268	134111412	75921
chr9	135956531	136156531	harbor1	chr9	135964526	135964734	LTR/ERVL	538	+	104	135964630	8099
chr9	135956531	136156531	harbor1	chr9	135976221	135976978	LTR/ERVL	2707	+	378	135976599	20068
chr9	4692834	4892834	harbor1	chr9	4719472	4719754	LTR/ERVL	1402	+	141	4719613	26779
chr9	4692834	4892834	harbor1	chr9	4767974	4768533	LTR/ERVL	2710	+	280	4768254	75420
chr9	4692834	4892834	harbor1	chr9	4768560	4768598	LTR/ERVL	623	+	19	4768579	75745
chr9	4692834	4892834	harbor1	chr9	4776096	4776156	LTR/ERVL	1756	+	30	4776126	83292
chr9	4692834	4892834	harbor1	chr9	4776449	4776750	LTR/ERVL	1756	+	150	4776599	83765
chr9	4579693	4779693	harbor1	chr9	4625983	4626718	LTR/ERVL	1044	+	368	4626351	46658
chr9	133242549	133442549	harbor1	chr9	133322837	133323088	LTR/ERVL	1119	+	126	133322963	80414
chr9	4883815	5083815	harbor1	chr9	4971442	4971760	LTR/ERVL	1353	+	159	4971601	87786
chr9	4883815	5083815	harbor1	chr9	4972365	4972544	LTR/ERVL	1353	+	90	4972455	88640
chr9	136299655	136499655	harbor1	chr9	136315240	136315754	LTR/ERVL	1101	+	257	136315497	15842
chr9	136299655	136499655	harbor1	chr9	136316858	136317220	LTR/ERVL	718	+	181	136317039	17384
chr9	136299655	136499655	harbor1	chr9	136317581	136318401	LTR/ERVL	718	+	410	136317991	18336
chr9	109066800	109266800	harbor1	chr9	109145366	109145419	LTR/ERVL	2835	+	26	109145392	78592
chr9	109066800	109266800	harbor1	chr9	109145728	109145917	LTR/ERVL	2835	+	94	109145822	79022
chr9	109066800	109266800	harbor1	chr9	109146224	109146593	LTR/ERVL	2835	+	184	109146408	79608
chr9	109066800	109266800	harbor1	chr9	109153053	109153767	LTR/ERVL	1666	+	357	109153410	86610
chr9	109066800	109266800	harbor1	chr9	109153863	109154414	LTR/ERVL	765	+	276	109154139	87339
chr9	109066800	109266800	harbor1	chr9	109159275	109159388	LTR/ERVL	1661	+	56	109159331	92531
chr9	109066800	109266800	harbor1	chr9	109159681	109159987	LTR/ERVL	1661	+	153	109159834	93034
chr9	4692441	4892441	harbor1	chr9	4719472	4719754	LTR/ERVL	1402	+	141	4719613	27172
chr9	4692441	4892441	harbor1	chr9	4767974	4768533	LTR/ERVL	2710	+	280	4768254	75813
chr9	4692441	4892441	harbor1	chr9	4768560	4768598	LTR/ERVL	623	+	19	4768579	76138
chr9	4692441	4892441	harbor1	chr9	4776096	4776156	LTR/ERVL	1756	+	30	4776126	83685
chr9	4692441	4892441	harbor1	chr9	4776449	4776750	LTR/ERVL	1756	+	150	4776599	84158
chr9	4692933	4892933	harbor1	chr9	4719472	4719754	LTR/ERVL	1402	+	141	4719613	26680
chr9	4692933	4892933	harbor1	chr9	4767974	4768533	LTR/ERVL	2710	+	280	4768254	75321
chr9	4692933	4892933	harbor1	chr9	4768560	4768598	LTR/ERVL	623	+	19	4768579	75646
chr9	4692933	4892933	harbor1	chr9	4776096	4776156	LTR/ERVL	1756	+	30	4776126	83193
chr9	4692933	4892933	harbor1	chr9	4776449	4776750	LTR/ERVL	1756	+	150	4776599	83666
chr9	135400878	135600878	harbor1	chr9	135456742	135456982	LTR/ERVL	644	+	120	135456862	55984
chr9	4885087	5085087	harbor1	chr9	4971442	4971760	LTR/ERVL	1353	+	159	4971601	86514
chr9	4885087	5085087	harbor1	chr9	4972365	4972544	LTR/ERVL	1353	+	90	4972455	87368
chr9	4884787	5084787	harbor1	chr9	4971442	4971760	LTR/ERVL	1353	+	159	4971601	86814
chr9	4884787	5084787	harbor1	chr9	4972365	4972544	LTR/ERVL	1353	+	90	4972455	87668
chr9	134045916	134245916	harbor1	chr9	134111144	134111681	LTR/ERVL	1985	+	268	134111412	65496
chr9	4884870	5084870	harbor1	chr9	4971442	4971760	LTR/ERVL	1353	+	159	4971601	86731
chr9	4884870	5084870	harbor1	chr9	4972365	4972544	LTR/ERVL	1353	+	90	4972455	87585
chr9	4692425	4892425	harbor1	chr9	4719472	4719754	LTR/ERVL	1402	+	141	4719613	27188
chr9	4692425	4892425	harbor1	chr9	4767974	4768533	LTR/ERVL	2710	+	280	4768254	75829
chr9	4692425	4892425	harbor1	chr9	4768560	4768598	LTR/ERVL	623	+	19	4768579	76154
chr9	4692425	4892425	harbor1	chr9	4776096	4776156	LTR/ERVL	1756	+	30	4776126	83701
chr9	4692425	4892425	harbor1	chr9	4776449	4776750	LTR/ERVL	1756	+	150	4776599	84174
chr9	4884906	5084906	harbor1	chr9	4971442	4971760	LTR/ERVL	1353	+	159	4971601	86695
chr9	4884906	5084906	harbor1	chr9	4972365	4972544	LTR/ERVL	1353	+	90	4972455	87549
chr9	134029647	134229647	harbor1	chr9	134111144	134111681	LTR/ERVL	1985	+	268	134111412	81765
chr9	4698187	4898187	harbor1	chr9	4719472	4719754	LTR/ERVL	1402	+	141	4719613	21426
chr9	4698187	4898187	harbor1	chr9	4767974	4768533	LTR/ERVL	2710	+	280	4768254	70067
chr9	4698187	4898187	harbor1	chr9	4768560	4768598	LTR/ERVL	623	+	19	4768579	70392
chr9	4698187	4898187	harbor1	chr9	4776096	4776156	LTR/ERVL	1756	+	30	4776126	77939
chr9	4698187	4898187	harbor1	chr9	4776449	4776750	LTR/ERVL	1756	+	150	4776599	78412
chr9	4729109	4929109	harbor1	chr9	4767974	4768533	LTR/ERVL	2710	+	280	4768254	39145
chr9	4729109	4929109	harbor1	chr9	4768560	4768598	LTR/ERVL	623	+	19	4768579	39470
chr9	4729109	4929109	harbor1	chr9	4776096	4776156	LTR/ERVL	1756	+	30	4776126	47017
chr9	4729109	4929109	harbor1	chr9	4776449	4776750	LTR/ERVL	1756	+	150	4776599	47490
chr9	108349474	108549474	harbor1	chr9	108376806	108377073	LTR/ERVL	861	+	134	108376940	27466
chr9	108349474	108549474	harbor1	chr9	108377717	108377977	LTR/ERVL	616	+	130	108377847	28373
chr9	4215856	4415856	harbor1	chr9	4268776	4269051	LTR/ERVL	551	+	138	4268914	53058
chr9	4215856	4415856	harbor1	chr9	4270724	4270875	LTR/ERVL	615	+	76	4270800	54944
chr9	4215856	4415856	harbor1	chr9	4282251	4282816	LTR/ERVL	2893	+	282	4282533	66677
chr9	4694447	4894447	harbor1	chr9	4719472	4719754	LTR/ERVL	1402	+	141	4719613	25166
chr9	4694447	4894447	harbor1	chr9	4767974	4768533	LTR/ERVL	2710	+	280	4768254	73807
chr9	4694447	4894447	harbor1	chr9	4768560	4768598	LTR/ERVL	623	+	19	4768579	74132
chr9	4694447	4894447	harbor1	chr9	4776096	4776156	LTR/ERVL	1756	+	30	4776126	81679
chr9	4694447	4894447	harbor1	chr9	4776449	4776750	LTR/ERVL	1756	+	150	4776599	82152
chr9	92958957	93158957	harbor1	chr9	92988550	92989012	LTR/ERVL	1881	+	231	92988781	29824
chr10	132232384	132432384	harbor1	chr10	132236606	132236781	LTR/ERVL	693	+	88	132236694	4310
chr10	132232398	132432398	harbor1	chr10	132236606	132236781	LTR/ERVL	693	+	88	132236694	4296
chr10	102136358	102336358	harbor1	chr10	102207252	102207551	LTR/ERVL	1170	+	150	102207402	71044
chr10	102136358	102336358	harbor1	chr10	102207863	102208054	LTR/ERVL	1170	+	96	102207959	71601
chr10	14778680	14978680	harbor1	chr10	14833194	14833598	LTR/ERVL	1299	+	202	14833396	54716
chr10	14778677	14978677	harbor1	chr10	14833194	14833598	LTR/ERVL	1299	+	202	14833396	54719
chr10	75309886	75509886	harbor1	chr10	75366632	75367021	LTR/ERVL	1328	+	194	75366826	56940
chr10	75309886	75509886	harbor1	chr10	75373092	75373456	LTR/ERVL	870	+	182	75373274	63388
chr10	14778676	14978676	harbor1	chr10	14833194	14833598	LTR/ERVL	1299	+	202	14833396	54720
chr10	14771563	14971563	harbor1	chr10	14833194	14833598	LTR/ERVL	1299	+	202	14833396	61833
chr10	97398841	97598841	harbor1	chr10	97416525	97416845	LTR/ERVL	734	+	160	97416685	17844
chr10	97398841	97598841	harbor1	chr10	97418119	97418131	LTR/ERVL	734	+	6	97418125	19284
chr10	95979828	96179828	harbor1	chr10	96002070	96002363	LTR/ERVL	553	+	146	96002216	22388
chr10	95979828	96179828	harbor1	chr10	96010291	96010402	LTR/ERVL	526	+	56	96010347	30519
chr10	95979828	96179828	harbor1	chr10	96077721	96077929	LTR/ERVL	647	+	104	96077825	97997
chr10	22336855	22536855	harbor1	chr10	22422045	22422318	LTR/ERVL	891	+	136	22422181	85326
chr10	22336855	22536855	harbor1	chr10	22422513	22423020	LTR/ERVL	1081	+	254	22422767	85912
chr10	22336855	22536855	harbor1	chr10	22423056	22423267	LTR/ERVL	1365	+	106	22423162	86307
chr10	22336855	22536855	harbor1	chr10	22423572	22424185	LTR/ERVL	1490	+	306	22423878	87023
chr10	22336855	22536855	harbor1	chr10	22424157	22425533	LTR/ERVL	1914	+	688	22424845	87990
chr10	14755514	14955514	harbor1	chr10	14756287	14756520	LTR/ERVL	1330	+	116	14756403	889
chr10	14755514	14955514	harbor1	chr10	14757332	14757508	LTR/ERVL	547	+	88	14757420	1906
chr10	14755514	14955514	harbor1	chr10	14762297	14762514	LTR/ERVL	1338	+	108	14762405	6891
chr10	14755514	14955514	harbor1	chr10	14762810	14762980	LTR/ERVL	1338	+	85	14762895	7381
chr10	14755514	14955514	harbor1	chr10	14763271	14763531	LTR/ERVL	1338	+	130	14763401	7887
chr10	14755514	14955514	harbor1	chr10	14833194	14833598	LTR/ERVL	1299	+	202	14833396	77882
chr10	132202571	132402571	harbor1	chr10	132236606	132236781	LTR/ERVL	693	+	88	132236694	34123
chr10	132642062	132842062	harbor1	chr10	132672117	132672275	LTR/ERVL	974	+	79	132672196	30134
chr10	97398923	97598923	harbor1	chr10	97416525	97416845	LTR/ERVL	734	+	160	97416685	17762
chr10	97398923	97598923	harbor1	chr10	97418119	97418131	LTR/ERVL	734	+	6	97418125	19202
chr10	97672098	97872098	harbor1	chr10	97695971	97696448	LTR/ERVL	2828	+	238	97696209	24111
chr10	97672098	97872098	harbor1	chr10	97696759	97696829	LTR/ERVL	2828	+	35	97696794	24696
chr10	97672098	97872098	harbor1	chr10	97697148	97697358	LTR/ERVL	2828	+	105	97697253	25155
chr10	97672098	97872098	harbor1	chr10	97698904	97699051	LTR/ERVL	765	+	74	97698978	26880
chr10	97672098	97872098	harbor1	chr10	97699352	97699483	LTR/ERVL	765	+	66	97699418	27320
chr10	97672098	97872098	harbor1	chr10	97701473	97701683	LTR/ERVL	863	+	105	97701578	29480
chr10	97672098	97872098	harbor1	chr10	97701955	97702438	LTR/ERVL	1884	+	242	97702197	30099
chr10	97672098	97872098	harbor1	chr10	97705447	97705640	LTR/ERVL	1183	+	96	97705543	33445
chr10	97398845	97598845	harbor1	chr10	97416525	97416845	LTR/ERVL	734	+	160	97416685	17840
chr10	97398845	97598845	harbor1	chr10	97418119	97418131	LTR/ERVL	734	+	6	97418125	19280
chr10	97672148	97872148	harbor1	chr10	97695971	97696448	LTR/ERVL	2828	+	238	97696209	24061
chr10	97672148	97872148	harbor1	chr10	97696759	97696829	LTR/ERVL	2828	+	35	97696794	24646
chr10	97672148	97872148	harbor1	chr10	97697148	97697358	LTR/ERVL	2828	+	105	97697253	25105
chr10	97672148	97872148	harbor1	chr10	97698904	97699051	LTR/ERVL	765	+	74	97698978	26830
chr10	97672148	97872148	harbor1	chr10	97699352	97699483	LTR/ERVL	765	+	66	97699418	27270
chr10	97672148	97872148	harbor1	chr10	97701473	97701683	LTR/ERVL	863	+	105	97701578	29430
chr10	97672148	97872148	harbor1	chr10	97701955	97702438	LTR/ERVL	1884	+	242	97702197	30049
chr10	97672148	97872148	harbor1	chr10	97705447	97705640	LTR/ERVL	1183	+	96	97705543	33395
chr10	23339297	23539297	harbor1	chr10	23338949	23339497	LTR/ERVL	2080	+	274	23339223	74
chr10	23339297	23539297	harbor1	chr10	23339567	23339864	LTR/ERVL	509	+	148	23339715	418
chr10	23339297	23539297	harbor1	chr10	23349544	23349879	LTR/ERVL	869	+	168	23349712	10415
chr10	23339297	23539297	harbor1	chr10	23350180	23350259	LTR/ERVL	869	+	40	23350220	10923
chr10	23339297	23539297	harbor1	chr10	23360877	23361421	LTR/ERVL	2802	+	272	23361149	21852
chr10	23339297	23539297	harbor1	chr10	23375357	23376165	LTR/ERVL	3249	+	404	23375761	36464
chr10	15216571	15416571	harbor1	chr10	15244923	15245053	LTR/ERVL	702	+	65	15244988	28417
chr10	15216571	15416571	harbor1	chr10	15245367	15245430	LTR/ERVL	702	+	32	15245399	28828
chr10	15216571	15416571	harbor1	chr10	15245414	15245551	LTR/ERVL	643	+	68	15245482	28911
chr10	15216571	15416571	harbor1	chr10	15301074	15301179	LTR/ERVL	1786	+	52	15301126	84555
chr10	15216571	15416571	harbor1	chr10	15301503	15301870	LTR/ERVL	1786	+	184	15301687	85116
chr10	15216571	15416571	harbor1	chr10	15304227	15304758	LTR/ERVL	2045	+	266	15304493	87922
chr10	15216571	15416571	harbor1	chr10	15305037	15305126	LTR/ERVL	2045	+	44	15305081	88510
chr10	130648147	130848147	harbor1	chr10	130690350	130690798	LTR/ERVL	616	+	224	130690574	42427
chr10	102141189	102341189	harbor1	chr10	102207252	102207551	LTR/ERVL	1170	+	150	102207402	66213
chr10	102141189	102341189	harbor1	chr10	102207863	102208054	LTR/ERVL	1170	+	96	102207959	66770
chr10	101115534	101315534	harbor1	chr10	101156101	101156269	LTR/ERVL	822	+	84	101156185	40651
chr10	101115534	101315534	harbor1	chr10	101176076	101176288	LTR/ERVL	2159	+	106	101176182	60648
chr10	101115534	101315534	harbor1	chr10	101176601	101177023	LTR/ERVL	2159	+	211	101176812	61278
chr10	101115534	101315534	harbor1	chr10	101182998	101183257	LTR/ERVL	1059	+	130	101183128	67594
chr10	101115534	101315534	harbor1	chr10	101188996	101189085	LTR/ERVL	488	+	44	101189040	73506
chr10	75111011	75311011	harbor1	chr10	75206219	75206389	LTR/ERVL	1753	+	85	75206304	95293
chr10	75111011	75311011	harbor1	chr10	75207534	75207864	LTR/ERVL	1753	+	165	75207699	96688
chr10	101965759	102165759	harbor1	chr10	101982497	101982510	LTR/ERVL	4541	+	6	101982503	16744
chr10	101965759	102165759	harbor1	chr10	101983023	101983273	LTR/ERVL	4541	+	125	101983148	17389
chr10	101965759	102165759	harbor1	chr10	101983547	101984186	LTR/ERVL	4541	+	320	101983867	18108
chr10	4608518	4808518	harbor1	chr10	4614702	4614904	LTR/ERVL	875	+	101	4614803	6285
chr10	4608518	4808518	harbor1	chr10	4688660	4689068	LTR/ERVL	2032	+	204	4688864	80346
chr10	14701889	14901889	harbor1	chr10	14715480	14715979	LTR/ERVL	2476	+	250	14715730	13841
chr10	14701889	14901889	harbor1	chr10	14719527	14719973	LTR/ERVL	1469	+	223	14719750	17861
chr10	14701889	14901889	harbor1	chr10	14727372	14727750	LTR/ERVL	1322	+	189	14727561	25672
chr10	14701889	14901889	harbor1	chr10	14756287	14756520	LTR/ERVL	1330	+	116	14756403	54514
chr10	14701889	14901889	harbor1	chr10	14757332	14757508	LTR/ERVL	547	+	88	14757420	55531
chr10	14701889	14901889	harbor1	chr10	14762297	14762514	LTR/ERVL	1338	+	108	14762405	60516
chr10	14701889	14901889	harbor1	chr10	14762810	14762980	LTR/ERVL	1338	+	85	14762895	61006
chr10	14701889	14901889	harbor1	chr10	14763271	14763531	LTR/ERVL	1338	+	130	14763401	61512
chr10	132232394	132432394	harbor1	chr10	132236606	132236781	LTR/ERVL	693	+	88	132236694	4300
chr10	130532945	130732945	harbor1	chr10	130588133	130588543	LTR/ERVL	917	+	205	130588338	55393
chr10	130532945	130732945	harbor1	chr10	130617433	130618380	LTR/ERVL	2690	+	474	130617907	84962
chr10	22337048	22537048	harbor1	chr10	22422045	22422318	LTR/ERVL	891	+	136	22422181	85133
chr10	22337048	22537048	harbor1	chr10	22422513	22423020	LTR/ERVL	1081	+	254	22422767	85719
chr10	22337048	22537048	harbor1	chr10	22423056	22423267	LTR/ERVL	1365	+	106	22423162	86114
chr10	22337048	22537048	harbor1	chr10	22423572	22424185	LTR/ERVL	1490	+	306	22423878	86830
chr10	22337048	22537048	harbor1	chr10	22424157	22425533	LTR/ERVL	1914	+	688	22424845	87797
chr10	122856480	123056480	harbor1	chr10	122886868	122887166	LTR/ERVL	630	+	149	122887017	30537
chr10	122856480	123056480	harbor1	chr10	122907325	122907847	LTR/ERVL	2693	+	261	122907586	51106
chr10	122856480	123056480	harbor1	chr10	122917023	122917503	LTR/ERVL	2400	+	240	122917263	60783
chr10	69472321	69672321	harbor1	chr10	69521020	69521223	LTR/ERVL	1460	+	102	69521122	48801
chr10	69472321	69672321	harbor1	chr10	69521628	69521940	LTR/ERVL	1672	+	156	69521784	49463
chr10	69472321	69672321	harbor1	chr10	69549158	69549593	LTR/ERVL	2026	+	218	69549376	77055
chr10	69472321	69672321	harbor1	chr10	69550797	69551207	LTR/ERVL	720	+	205	69551002	78681
chr10	69472321	69672321	harbor1	chr10	69533685	69534013	LTR/ERVL	1885	+	164	69533849	61528
chr10	97398878	97598878	harbor1	chr10	97416525	97416845	LTR/ERVL	734	+	160	97416685	17807
chr10	97398878	97598878	harbor1	chr10	97418119	97418131	LTR/ERVL	734	+	6	97418125	19247
chr10	97398451	97598451	harbor1	chr10	97416525	97416845	LTR/ERVL	734	+	160	97416685	18234
chr10	97398451	97598451	harbor1	chr10	97418119	97418131	LTR/ERVL	734	+	6	97418125	19674
chr10	132206329	132406329	harbor1	chr10	132236606	132236781	LTR/ERVL	693	+	88	132236694	30365
chr10	23099346	23299346	harbor1	chr10	23106449	23106906	LTR/ERVL	1088	+	228	23106677	7331
chr10	23099346	23299346	harbor1	chr10	23128559	23128793	LTR/ERVL	478	+	117	23128676	29330
chr10	14778721	14978721	harbor1	chr10	14833194	14833598	LTR/ERVL	1299	+	202	14833396	54675
chr10	75111017	75311017	harbor1	chr10	75206219	75206389	LTR/ERVL	1753	+	85	75206304	95287
chr10	75111017	75311017	harbor1	chr10	75207534	75207864	LTR/ERVL	1753	+	165	75207699	96682
chr10	132232388	132432388	harbor1	chr10	132236606	132236781	LTR/ERVL	693	+	88	132236694	4306
chr10	4382921	4582921	harbor1	chr10	4410035	4410544	LTR/ERVL	2615	+	254	4410289	27368
chr10	97398476	97598476	harbor1	chr10	97416525	97416845	LTR/ERVL	734	+	160	97416685	18209
chr10	97398476	97598476	harbor1	chr10	97418119	97418131	LTR/ERVL	734	+	6	97418125	19649
chr10	23339295	23539295	harbor1	chr10	23338949	23339497	LTR/ERVL	2080	+	274	23339223	72
chr10	23339295	23539295	harbor1	chr10	23339567	23339864	LTR/ERVL	509	+	148	23339715	420
chr10	23339295	23539295	harbor1	chr10	23349544	23349879	LTR/ERVL	869	+	168	23349712	10417
chr10	23339295	23539295	harbor1	chr10	23350180	23350259	LTR/ERVL	869	+	40	23350220	10925
chr10	23339295	23539295	harbor1	chr10	23360877	23361421	LTR/ERVL	2802	+	272	23361149	21854
chr10	23339295	23539295	harbor1	chr10	23375357	23376165	LTR/ERVL	3249	+	404	23375761	36466
chr10	14778699	14978699	harbor1	chr10	14833194	14833598	LTR/ERVL	1299	+	202	14833396	54697
chr10	43004161	43204161	harbor1	chr10	43004636	43005061	LTR/ERVL	1249	+	212	43004848	687
chr10	114073688	114273688	harbor1	chr10	114105609	114106100	LTR/ERVL	2227	+	246	114105855	32167
chr10	114073688	114273688	harbor1	chr10	114146007	114146189	LTR/ERVL	578	+	91	114146098	72410
chr10	114073688	114273688	harbor1	chr10	114146264	114146424	LTR/ERVL	581	+	80	114146344	72656
chr10	101896567	102096567	harbor1	chr10	101916619	101917136	LTR/ERVL	2625	+	258	101916877	20310
chr10	101896567	102096567	harbor1	chr10	101982497	101982510	LTR/ERVL	4541	+	6	101982503	85936
chr10	101896567	102096567	harbor1	chr10	101983023	101983273	LTR/ERVL	4541	+	125	101983148	86581
chr10	101896567	102096567	harbor1	chr10	101983547	101984186	LTR/ERVL	4541	+	320	101983867	87300
chr10	101115425	101315425	harbor1	chr10	101156101	101156269	LTR/ERVL	822	+	84	101156185	40760
chr10	101115425	101315425	harbor1	chr10	101176076	101176288	LTR/ERVL	2159	+	106	101176182	60757
chr10	101115425	101315425	harbor1	chr10	101176601	101177023	LTR/ERVL	2159	+	211	101176812	61387
chr10	101115425	101315425	harbor1	chr10	101182998	101183257	LTR/ERVL	1059	+	130	101183128	67703
chr10	101115425	101315425	harbor1	chr10	101188996	101189085	LTR/ERVL	488	+	44	101189040	73615
chr10	100614422	100814422	harbor1	chr10	100630717	100631102	LTR/ERVL	968	+	192	100630909	16487
chr10	97398967	97598967	harbor1	chr10	97416525	97416845	LTR/ERVL	734	+	160	97416685	17718
chr10	97398967	97598967	harbor1	chr10	97418119	97418131	LTR/ERVL	734	+	6	97418125	19158
chr10	69458778	69658778	harbor1	chr10	69468828	69469455	LTR/ERVL	1259	+	314	69469142	10364
chr10	69458778	69658778	harbor1	chr10	69469845	69470013	LTR/ERVL	636	+	84	69469929	11151
chr10	69458778	69658778	harbor1	chr10	69521020	69521223	LTR/ERVL	1460	+	102	69521122	62344
chr10	69458778	69658778	harbor1	chr10	69521628	69521940	LTR/ERVL	1672	+	156	69521784	63006
chr10	69458778	69658778	harbor1	chr10	69549158	69549593	LTR/ERVL	2026	+	218	69549376	90598
chr10	69458778	69658778	harbor1	chr10	69550797	69551207	LTR/ERVL	720	+	205	69551002	92224
chr10	69458778	69658778	harbor1	chr10	69533685	69534013	LTR/ERVL	1885	+	164	69533849	75071
chr10	102140710	102340710	harbor1	chr10	102207252	102207551	LTR/ERVL	1170	+	150	102207402	66692
chr10	102140710	102340710	harbor1	chr10	102207863	102208054	LTR/ERVL	1170	+	96	102207959	67249
chr10	46006324	46206324	harbor1	chr10	46104397	46104672	LTR/ERVL	550	+	138	46104535	98211
chr10	133556781	133756781	harbor1	chr10	133598602	133599054	LTR/ERVL	2471	+	226	133598828	42047
chr10	133556781	133756781	harbor1	chr10	133599087	133599119	LTR/ERVL	2471	+	16	133599103	42322
chr10	133556781	133756781	harbor1	chr10	133602600	133603186	LTR/ERVL	1952	+	293	133602893	46112
chr10	71360848	71560848	harbor1	chr10	71378388	71378547	LTR/ERVL	476	+	80	71378468	17620
chr10	71360848	71560848	harbor1	chr10	71378735	71378948	LTR/ERVL	943	+	106	71378841	17993
chr10	71360848	71560848	harbor1	chr10	71393682	71393878	LTR/ERVL	638	+	98	71393780	32932
chr10	68160980	68360980	harbor1	chr10	68238313	68238763	LTR/ERVL	1892	+	225	68238538	77558
chr10	68160980	68360980	harbor1	chr10	68239067	68239194	LTR/ERVL	1892	+	64	68239131	78151
chr10	100085650	100285650	harbor1	chr10	100118590	100118763	LTR/ERVL	678	+	86	100118676	33026
chr10	100085650	100285650	harbor1	chr10	100134627	100135248	LTR/ERVL	1748	+	310	100134937	49287
chr10	100085650	100285650	harbor1	chr10	100175141	100175647	LTR/ERVL	2694	+	253	100175394	89744
chr10	125096676	125296676	harbor1	chr10	125169957	125170413	LTR/ERVL	857	+	228	125170185	73509
chr10	125096676	125296676	harbor1	chr10	125174420	125174622	LTR/ERVL	603	+	101	125174521	77845
chr10	47239786	47439786	harbor1	chr10	47260935	47261519	LTR/ERVL	3035	+	292	47261227	21441
chr10	47239786	47439786	harbor1	chr10	47271574	47272078	LTR/ERVL	2811	+	252	47271826	32040
chr10	47239786	47439786	harbor1	chr10	47334608	47334936	LTR/ERVL	548	+	164	47334772	94986
chr10	47239786	47439786	harbor1	chr10	47337297	47337712	LTR/ERVL	1934	+	208	47337505	97719
chr10	13709693	13909693	harbor1	chr10	13727337	13727665	LTR/ERVL	946	+	164	13727501	17808
chr10	13709693	13909693	harbor1	chr10	13769270	13769317	LTR/ERVL	2087	+	24	13769294	59601
chr10	13709693	13909693	harbor1	chr10	13769610	13770069	LTR/ERVL	2087	+	230	13769840	60147
chr10	13709693	13909693	harbor1	chr10	13788086	13788571	LTR/ERVL	2006	+	242	13788328	78635
chr10	7113930	7313930	harbor1	chr10	7150469	7150644	LTR/ERVL	599	+	88	7150557	36627
chr10	7113930	7313930	harbor1	chr10	7180033	7180123	LTR/ERVL	641	+	45	7180078	66148
chr10	7113930	7313930	harbor1	chr10	7180439	7180685	LTR/ERVL	641	+	123	7180562	66632
chr10	97398862	97598862	harbor1	chr10	97416525	97416845	LTR/ERVL	734	+	160	97416685	17823
chr10	97398862	97598862	harbor1	chr10	97418119	97418131	LTR/ERVL	734	+	6	97418125	19263
chr10	78866368	79066368	harbor1	chr10	78874011	78874558	LTR/ERVL	2181	+	274	78874285	7917
chr10	78866368	79066368	harbor1	chr10	78877076	78877820	LTR/ERVL	1342	+	372	78877448	11080
chr10	78866368	79066368	harbor1	chr10	78945719	78946148	LTR/ERVL	1017	+	214	78945933	79565
chr10	102141217	102341217	harbor1	chr10	102207252	102207551	LTR/ERVL	1170	+	150	102207402	66185
chr10	102141217	102341217	harbor1	chr10	102207863	102208054	LTR/ERVL	1170	+	96	102207959	66742
chr10	132143415	132343415	harbor1	chr10	132236606	132236781	LTR/ERVL	693	+	88	132236694	93279
chr10	14778012	14978012	harbor1	chr10	14833194	14833598	LTR/ERVL	1299	+	202	14833396	55384
chr10	132207804	132407804	harbor1	chr10	132236606	132236781	LTR/ERVL	693	+	88	132236694	28890
chr10	4452758	4652758	harbor1	chr10	4486828	4488265	LTR/ERVL	1492	+	718	4487546	34788
chr10	4452758	4652758	harbor1	chr10	4488561	4488791	LTR/ERVL	846	+	115	4488676	35918
chr10	4452758	4652758	harbor1	chr10	4522410	4522746	LTR/ERVL	571	+	168	4522578	69820
chr10	4452758	4652758	harbor1	chr10	4522772	4524975	LTR/ERVL	2417	+	1102	4523874	71116
chr10	4452758	4652758	harbor1	chr10	4524995	4525470	LTR/ERVL	814	+	238	4525233	72475
chr10	75111058	75311058	harbor1	chr10	75206219	75206389	LTR/ERVL	1753	+	85	75206304	95246
chr10	75111058	75311058	harbor1	chr10	75207534	75207864	LTR/ERVL	1753	+	165	75207699	96641
chr10	47239777	47439777	harbor1	chr10	47260935	47261519	LTR/ERVL	3035	+	292	47261227	21450
chr10	47239777	47439777	harbor1	chr10	47271574	47272078	LTR/ERVL	2811	+	252	47271826	32049
chr10	47239777	47439777	harbor1	chr10	47334608	47334936	LTR/ERVL	548	+	164	47334772	94995
chr10	47239777	47439777	harbor1	chr10	47337297	47337712	LTR/ERVL	1934	+	208	47337505	97728
chr10	89132447	89332447	harbor1	chr10	89192167	89192414	LTR/ERVL	1906	+	124	89192291	59844
chr10	47239796	47439796	harbor1	chr10	47260935	47261519	LTR/ERVL	3035	+	292	47261227	21431
chr10	47239796	47439796	harbor1	chr10	47271574	47272078	LTR/ERVL	2811	+	252	47271826	32030
chr10	47239796	47439796	harbor1	chr10	47334608	47334936	LTR/ERVL	548	+	164	47334772	94976
chr10	47239796	47439796	harbor1	chr10	47337297	47337712	LTR/ERVL	1934	+	208	47337505	97709
chr10	131144882	131344882	harbor1	chr10	131161416	131162186	LTR/ERVL	1783	+	385	131161801	16919
chr10	22289372	22489372	harbor1	chr10	22296514	22296851	LTR/ERVL	1221	+	168	22296682	7310
chr10	22289372	22489372	harbor1	chr10	22297151	22297364	LTR/ERVL	1221	+	106	22297257	7885
chr10	102140729	102340729	harbor1	chr10	102207252	102207551	LTR/ERVL	1170	+	150	102207402	66673
chr10	102140729	102340729	harbor1	chr10	102207863	102208054	LTR/ERVL	1170	+	96	102207959	67230
chr10	132232409	132432409	harbor1	chr10	132236606	132236781	LTR/ERVL	693	+	88	132236694	4285
chr10	131310814	131510814	harbor1	chr10	131378281	131378594	LTR/ERVL	878	+	156	131378437	67623
chr10	131310814	131510814	harbor1	chr10	131400841	131401289	LTR/ERVL	1866	+	224	131401065	90251
chr10	68462143	68662143	harbor1	chr10	68553470	68553943	LTR/ERVL	1846	+	236	68553706	91563
chr10	14752857	14952857	harbor1	chr10	14756287	14756520	LTR/ERVL	1330	+	116	14756403	3546
chr10	14752857	14952857	harbor1	chr10	14757332	14757508	LTR/ERVL	547	+	88	14757420	4563
chr10	14752857	14952857	harbor1	chr10	14762297	14762514	LTR/ERVL	1338	+	108	14762405	9548
chr10	14752857	14952857	harbor1	chr10	14762810	14762980	LTR/ERVL	1338	+	85	14762895	10038
chr10	14752857	14952857	harbor1	chr10	14763271	14763531	LTR/ERVL	1338	+	130	14763401	10544
chr10	14752857	14952857	harbor1	chr10	14833194	14833598	LTR/ERVL	1299	+	202	14833396	80539
chr10	131310770	131510770	harbor1	chr10	131378281	131378594	LTR/ERVL	878	+	156	131378437	67667
chr10	131310770	131510770	harbor1	chr10	131400841	131401289	LTR/ERVL	1866	+	224	131401065	90295
chr10	31828950	32028950	harbor1	chr10	31902771	31903084	LTR/ERVL	1382	+	156	31902927	73977
chr10	131310777	131510777	harbor1	chr10	131378281	131378594	LTR/ERVL	878	+	156	131378437	67660
chr10	131310777	131510777	harbor1	chr10	131400841	131401289	LTR/ERVL	1866	+	224	131401065	90288
chr10	14778778	14978778	harbor1	chr10	14833194	14833598	LTR/ERVL	1299	+	202	14833396	54618
chr10	7149143	7349143	harbor1	chr10	7150469	7150644	LTR/ERVL	599	+	88	7150557	1414
chr10	7149143	7349143	harbor1	chr10	7180033	7180123	LTR/ERVL	641	+	45	7180078	30935
chr10	7149143	7349143	harbor1	chr10	7180439	7180685	LTR/ERVL	641	+	123	7180562	31419
chr10	46005969	46205969	harbor1	chr10	46104397	46104672	LTR/ERVL	550	+	138	46104535	98566
chr10	132614280	132814280	harbor1	chr10	132672117	132672275	LTR/ERVL	974	+	79	132672196	57916
chr10	131310769	131510769	harbor1	chr10	131378281	131378594	LTR/ERVL	878	+	156	131378437	67668
chr10	131310769	131510769	harbor1	chr10	131400841	131401289	LTR/ERVL	1866	+	224	131401065	90296
chr10	102134155	102334155	harbor1	chr10	102207252	102207551	LTR/ERVL	1170	+	150	102207402	73247
chr10	102134155	102334155	harbor1	chr10	102207863	102208054	LTR/ERVL	1170	+	96	102207959	73804
chr10	131310837	131510837	harbor1	chr10	131378281	131378594	LTR/ERVL	878	+	156	131378437	67600
chr10	131310837	131510837	harbor1	chr10	131400841	131401289	LTR/ERVL	1866	+	224	131401065	90228
chr10	97398963	97598963	harbor1	chr10	97416525	97416845	LTR/ERVL	734	+	160	97416685	17722
chr10	97398963	97598963	harbor1	chr10	97418119	97418131	LTR/ERVL	734	+	6	97418125	19162
chr10	14763732	14963732	harbor1	chr10	14833194	14833598	LTR/ERVL	1299	+	202	14833396	69664
chr10	102141356	102341356	harbor1	chr10	102207252	102207551	LTR/ERVL	1170	+	150	102207402	66046
chr10	102141356	102341356	harbor1	chr10	102207863	102208054	LTR/ERVL	1170	+	96	102207959	66603
chr10	30655861	30855861	harbor1	chr10	30738940	30738960	LTR/ERVL	476	+	10	30738950	83089
chr10	30655861	30855861	harbor1	chr10	30739664	30739913	LTR/ERVL	1406	+	124	30739788	83927
chr10	30655861	30855861	harbor1	chr10	30740209	30740315	LTR/ERVL	1406	+	53	30740262	84401
chr10	30655861	30855861	harbor1	chr10	30740389	30740546	LTR/ERVL	691	+	78	30740467	84606
chr10	14778075	14978075	harbor1	chr10	14833194	14833598	LTR/ERVL	1299	+	202	14833396	55321
chr10	102140075	102340075	harbor1	chr10	102207252	102207551	LTR/ERVL	1170	+	150	102207402	67327
chr10	102140075	102340075	harbor1	chr10	102207863	102208054	LTR/ERVL	1170	+	96	102207959	67884
chr10	132207865	132407865	harbor1	chr10	132236606	132236781	LTR/ERVL	693	+	88	132236694	28829
chr10	43456421	43656421	harbor1	chr10	43506142	43506231	LTR/ERVL	1856	+	44	43506186	49765
chr10	43456421	43656421	harbor1	chr10	43506532	43506867	LTR/ERVL	1856	+	168	43506700	50279
chr10	43456421	43656421	harbor1	chr10	43507837	43508293	LTR/ERVL	1975	+	228	43508065	51644
chr10	43456421	43656421	harbor1	chr10	43508301	43508526	LTR/ERVL	1994	+	112	43508413	51992
chr10	43456421	43656421	harbor1	chr10	43508868	43508924	LTR/ERVL	1994	+	28	43508896	52475
chr10	43456421	43656421	harbor1	chr10	43509210	43509420	LTR/ERVL	1994	+	105	43509315	52894
chr10	43456421	43656421	harbor1	chr10	43516880	43518522	LTR/ERVL	8892	+	821	43517701	61280
chr10	14778068	14978068	harbor1	chr10	14833194	14833598	LTR/ERVL	1299	+	202	14833396	55328
chr11	3928050	4128050	harbor1	chr11	3931720	3932060	LTR/ERVL	1879	+	170	3931890	3840
chr11	3928050	4128050	harbor1	chr11	3932140	3932294	LTR/ERVL	999	+	77	3932217	4167
chr11	5127208	5327208	harbor1	chr11	5147269	5147661	LTR/ERVL	1627	+	196	5147465	20257
chr11	5126782	5326782	harbor1	chr11	5147269	5147661	LTR/ERVL	1627	+	196	5147465	20683
chr11	5125332	5325332	harbor1	chr11	5147269	5147661	LTR/ERVL	1627	+	196	5147465	22133
chr11	5127125	5327125	harbor1	chr11	5147269	5147661	LTR/ERVL	1627	+	196	5147465	20340
chr11	5126747	5326747	harbor1	chr11	5147269	5147661	LTR/ERVL	1627	+	196	5147465	20718
chr11	76580979	76780979	harbor1	chr11	76644567	76645358	LTR/ERVL	3866	+	396	76644963	63984
chr11	5126823	5326823	harbor1	chr11	5147269	5147661	LTR/ERVL	1627	+	196	5147465	20642
chr11	5134555	5334555	harbor1	chr11	5147269	5147661	LTR/ERVL	1627	+	196	5147465	12910
chr11	5126774	5326774	harbor1	chr11	5147269	5147661	LTR/ERVL	1627	+	196	5147465	20691
chr11	5127340	5327340	harbor1	chr11	5147269	5147661	LTR/ERVL	1627	+	196	5147465	20125
chr11	73038077	73238077	harbor1	chr11	73050583	73050892	LTR/ERVL	662	+	154	73050737	12660
chr11	73038077	73238077	harbor1	chr11	73054284	73054568	LTR/ERVL	994	+	142	73054426	16349
chr11	73038077	73238077	harbor1	chr11	73092809	73093462	LTR/ERVL	2474	+	326	73093135	55058
chr11	5124751	5324751	harbor1	chr11	5147269	5147661	LTR/ERVL	1627	+	196	5147465	22714
chr11	5134559	5334559	harbor1	chr11	5147269	5147661	LTR/ERVL	1627	+	196	5147465	12906
chr11	5134573	5334573	harbor1	chr11	5147269	5147661	LTR/ERVL	1627	+	196	5147465	12892
chr11	5127129	5327129	harbor1	chr11	5147269	5147661	LTR/ERVL	1627	+	196	5147465	20336
chr11	5127170	5327170	harbor1	chr11	5147269	5147661	LTR/ERVL	1627	+	196	5147465	20295
chr11	5127181	5327181	harbor1	chr11	5147269	5147661	LTR/ERVL	1627	+	196	5147465	20284
chr11	5107730	5307730	harbor1	chr11	5147269	5147661	LTR/ERVL	1627	+	196	5147465	39735
chr11	5127269	5327269	harbor1	chr11	5147269	5147661	LTR/ERVL	1627	+	196	5147465	20196
chr11	76329060	76529060	harbor1	chr11	76369453	76370004	LTR/ERVL	2608	+	276	76369729	40669
chr11	76329060	76529060	harbor1	chr11	76399498	76400006	LTR/ERVL	2752	+	254	76399752	70692
chr11	76329060	76529060	harbor1	chr11	76400051	76400092	LTR/ERVL	2752	+	20	76400071	71011
chr11	76329060	76529060	harbor1	chr11	76416705	76416973	LTR/ERVL	632	+	134	76416839	87779
chr11	76329060	76529060	harbor1	chr11	76417042	76417256	LTR/ERVL	529	+	107	76417149	88089
chr11	76329060	76529060	harbor1	chr11	76425619	76425661	LTR/ERVL	1014	+	21	76425640	96580
chr11	76329060	76529060	harbor1	chr11	76425959	76426241	LTR/ERVL	1014	+	141	76426100	97040
chr11	76329060	76529060	harbor1	chr11	76426293	76426393	LTR/ERVL	436	+	50	76426343	97283
chr11	108021573	108221573	harbor1	chr11	108041018	108041268	LTR/ERVL	805	+	125	108041143	19570
chr11	5132965	5332965	harbor1	chr11	5147269	5147661	LTR/ERVL	1627	+	196	5147465	14500
chr11	5127263	5327263	harbor1	chr11	5147269	5147661	LTR/ERVL	1627	+	196	5147465	20202
chr11	5129592	5329592	harbor1	chr11	5147269	5147661	LTR/ERVL	1627	+	196	5147465	17873
chr11	5124885	5324885	harbor1	chr11	5147269	5147661	LTR/ERVL	1627	+	196	5147465	22580
chr11	5127172	5327172	harbor1	chr11	5147269	5147661	LTR/ERVL	1627	+	196	5147465	20293
chr11	5127366	5327366	harbor1	chr11	5147269	5147661	LTR/ERVL	1627	+	196	5147465	20099
chr11	108021539	108221539	harbor1	chr11	108041018	108041268	LTR/ERVL	805	+	125	108041143	19604
chr11	5127203	5327203	harbor1	chr11	5147269	5147661	LTR/ERVL	1627	+	196	5147465	20262
chr11	5127266	5327266	harbor1	chr11	5147269	5147661	LTR/ERVL	1627	+	196	5147465	20199
chr11	5127192	5327192	harbor1	chr11	5147269	5147661	LTR/ERVL	1627	+	196	5147465	20273
chr11	5127243	5327243	harbor1	chr11	5147269	5147661	LTR/ERVL	1627	+	196	5147465	20222
chr11	5127199	5327199	harbor1	chr11	5147269	5147661	LTR/ERVL	1627	+	196	5147465	20266
chr11	5125100	5325100	harbor1	chr11	5147269	5147661	LTR/ERVL	1627	+	196	5147465	22365
chr11	5134601	5334601	harbor1	chr11	5147269	5147661	LTR/ERVL	1627	+	196	5147465	12864
chr11	5127217	5327217	harbor1	chr11	5147269	5147661	LTR/ERVL	1627	+	196	5147465	20248
chr11	5127264	5327264	harbor1	chr11	5147269	5147661	LTR/ERVL	1627	+	196	5147465	20201
chr11	5125708	5325708	harbor1	chr11	5147269	5147661	LTR/ERVL	1627	+	196	5147465	21757
chr11	5127143	5327143	harbor1	chr11	5147269	5147661	LTR/ERVL	1627	+	196	5147465	20322
chr11	5115306	5315306	harbor1	chr11	5147269	5147661	LTR/ERVL	1627	+	196	5147465	32159
chr11	76580390	76780390	harbor1	chr11	76644567	76645358	LTR/ERVL	3866	+	396	76644963	64573
chr11	5127184	5327184	harbor1	chr11	5147269	5147661	LTR/ERVL	1627	+	196	5147465	20281
chr11	5124787	5324787	harbor1	chr11	5147269	5147661	LTR/ERVL	1627	+	196	5147465	22678
chr11	5127327	5327327	harbor1	chr11	5147269	5147661	LTR/ERVL	1627	+	196	5147465	20138
chr11	76580446	76780446	harbor1	chr11	76644567	76645358	LTR/ERVL	3866	+	396	76644963	64517
chr11	27274218	27474218	harbor1	chr11	27285831	27286290	LTR/ERVL	1098	+	230	27286061	11843
chr11	27274218	27474218	harbor1	chr11	27320821	27321267	LTR/ERVL	2118	+	223	27321044	46826
chr11	5134586	5334586	harbor1	chr11	5147269	5147661	LTR/ERVL	1627	+	196	5147465	12879
chr11	126556684	126756684	harbor1	chr11	126629543	126630003	LTR/ERVL	934	+	230	126629773	73089
chr11	5127250	5327250	harbor1	chr11	5147269	5147661	LTR/ERVL	1627	+	196	5147465	20215
chr11	5134209	5334209	harbor1	chr11	5147269	5147661	LTR/ERVL	1627	+	196	5147465	13256
chr11	5134629	5334629	harbor1	chr11	5147269	5147661	LTR/ERVL	1627	+	196	5147465	12836
chr11	5127213	5327213	harbor1	chr11	5147269	5147661	LTR/ERVL	1627	+	196	5147465	20252
chr11	4538274	4738274	harbor1	chr11	4548267	4548637	LTR/ERVL	823	+	185	4548452	10178
chr11	4538274	4738274	harbor1	chr11	4550034	4550543	LTR/ERVL	898	+	254	4550288	12014
chr11	4538274	4738274	harbor1	chr11	4554797	4555690	LTR/ERVL	1846	+	446	4555243	16969
chr11	4538274	4738274	harbor1	chr11	4555811	4558535	LTR/ERVL	7155	+	1362	4557173	18899
chr11	4538274	4738274	harbor1	chr11	4558543	4558978	LTR/ERVL	931	+	218	4558761	20487
chr11	4538274	4738274	harbor1	chr11	4615764	4615965	LTR/ERVL	708	+	100	4615864	77590
chr11	4538274	4738274	harbor1	chr11	4615959	4616232	LTR/ERVL	470	+	136	4616095	77821
chr11	4538274	4738274	harbor1	chr11	4570758	4571487	LTR/ERVL	1216	+	364	4571122	32848
chr11	5127232	5327232	harbor1	chr11	5147269	5147661	LTR/ERVL	1627	+	196	5147465	20233
chr11	5127319	5327319	harbor1	chr11	5147269	5147661	LTR/ERVL	1627	+	196	5147465	20146
chr11	107049890	107249890	harbor1	chr11	107058158	107058274	LTR/ERVL	803	+	58	107058216	8326
chr11	107049890	107249890	harbor1	chr11	107058275	107058787	LTR/ERVL	2271	+	256	107058531	8641
chr11	5125172	5325172	harbor1	chr11	5147269	5147661	LTR/ERVL	1627	+	196	5147465	22293
chr11	5127224	5327224	harbor1	chr11	5147269	5147661	LTR/ERVL	1627	+	196	5147465	20241
chr11	64913893	65113893	harbor1	chr11	64986709	64987070	LTR/ERVL	1972	+	180	64986889	72996
chr11	64913893	65113893	harbor1	chr11	64987698	64987709	LTR/ERVL	1972	+	6	64987704	73811
chr11	64913893	65113893	harbor1	chr11	64987741	64987780	LTR/ERVL	1972	+	20	64987761	73868
chr11	5126003	5326003	harbor1	chr11	5147269	5147661	LTR/ERVL	1627	+	196	5147465	21462
chr11	86572156	86772156	harbor1	chr11	86623017	86623521	LTR/ERVL	2924	+	252	86623269	51113
chr11	86572156	86772156	harbor1	chr11	86626106	86626617	LTR/ERVL	1228	+	256	86626362	54206
chr11	86572156	86772156	harbor1	chr11	86626806	86626940	LTR/ERVL	1005	+	67	86626873	54717
chr11	124700607	124900607	harbor1	chr11	124703390	124703762	LTR/ERVL	719	+	186	124703576	2969
chr11	124700607	124900607	harbor1	chr11	124707745	124708319	LTR/ERVL	1123	+	287	124708032	7425
chr11	124700607	124900607	harbor1	chr11	124713910	124714215	LTR/ERVL	1170	+	152	124714062	13455
chr11	124700607	124900607	harbor1	chr11	124716164	124716348	LTR/ERVL	480	+	92	124716256	15649
chr11	124700607	124900607	harbor1	chr11	124716522	124716751	LTR/ERVL	753	+	114	124716636	16029
chr11	124700607	124900607	harbor1	chr11	124716853	124717057	LTR/ERVL	970	+	102	124716955	16348
chr11	124700607	124900607	harbor1	chr11	124717371	124717588	LTR/ERVL	970	+	108	124717479	16872
chr11	124700607	124900607	harbor1	chr11	124714908	124716158	LTR/ERVL	1328	+	625	124715533	14926
chr11	5127146	5327146	harbor1	chr11	5147269	5147661	LTR/ERVL	1627	+	196	5147465	20319
chr11	69539284	69739284	harbor1	chr11	69601712	69602120	LTR/ERVL	480	+	204	69601916	62632
chr11	5124920	5324920	harbor1	chr11	5147269	5147661	LTR/ERVL	1627	+	196	5147465	22545
chr11	76580636	76780636	harbor1	chr11	76644567	76645358	LTR/ERVL	3866	+	396	76644963	64327
chr11	5134651	5334651	harbor1	chr11	5147269	5147661	LTR/ERVL	1627	+	196	5147465	12814
chr11	5134616	5334616	harbor1	chr11	5147269	5147661	LTR/ERVL	1627	+	196	5147465	12849
chr11	5127345	5327345	harbor1	chr11	5147269	5147661	LTR/ERVL	1627	+	196	5147465	20120
chr11	68444618	68644618	harbor1	chr11	68473015	68473791	LTR/ERVL	4190	+	388	68473403	28785
chr11	5134104	5334104	harbor1	chr11	5147269	5147661	LTR/ERVL	1627	+	196	5147465	13361
chr11	5124806	5324806	harbor1	chr11	5147269	5147661	LTR/ERVL	1627	+	196	5147465	22659
chr11	5125352	5325352	harbor1	chr11	5147269	5147661	LTR/ERVL	1627	+	196	5147465	22113
chr11	86572150	86772150	harbor1	chr11	86623017	86623521	LTR/ERVL	2924	+	252	86623269	51119
chr11	86572150	86772150	harbor1	chr11	86626106	86626617	LTR/ERVL	1228	+	256	86626362	54212
chr11	86572150	86772150	harbor1	chr11	86626806	86626940	LTR/ERVL	1005	+	67	86626873	54723
chr11	5127230	5327230	harbor1	chr11	5147269	5147661	LTR/ERVL	1627	+	196	5147465	20235
chr11	5125771	5325771	harbor1	chr11	5147269	5147661	LTR/ERVL	1627	+	196	5147465	21694
chr11	5127185	5327185	harbor1	chr11	5147269	5147661	LTR/ERVL	1627	+	196	5147465	20280
chr11	5134100	5334100	harbor1	chr11	5147269	5147661	LTR/ERVL	1627	+	196	5147465	13365
chr11	5134575	5334575	harbor1	chr11	5147269	5147661	LTR/ERVL	1627	+	196	5147465	12890
chr11	6140855	6340855	harbor1	chr11	6228929	6229085	LTR/ERVL	627	+	78	6229007	88152
chr11	5127304	5327304	harbor1	chr11	5147269	5147661	LTR/ERVL	1627	+	196	5147465	20161
chr11	5134650	5334650	harbor1	chr11	5147269	5147661	LTR/ERVL	1627	+	196	5147465	12815
chr11	5125398	5325398	harbor1	chr11	5147269	5147661	LTR/ERVL	1627	+	196	5147465	22067
chr11	64806660	65006660	harbor1	chr11	64822081	64822172	LTR/ERVL	496	+	46	64822127	15467
chr11	64806660	65006660	harbor1	chr11	64822598	64822755	LTR/ERVL	496	+	78	64822676	16016
chr11	6512331	6712331	harbor1	chr11	6515483	6515723	LTR/ERVL	588	+	120	6515603	3272
chr11	6512331	6712331	harbor1	chr11	6527915	6528042	LTR/ERVL	434	+	64	6527979	15648
chr11	6512331	6712331	harbor1	chr11	6554997	6555199	LTR/ERVL	1918	+	101	6555098	42767
chr11	6512331	6712331	harbor1	chr11	6555247	6555401	LTR/ERVL	1918	+	77	6555324	42993
chr11	6512331	6712331	harbor1	chr11	6555402	6555596	LTR/ERVL	1448	+	97	6555499	43168
chr11	6512331	6712331	harbor1	chr11	6593478	6593800	LTR/ERVL	698	+	161	6593639	81308
chr11	46430260	46630260	harbor1	chr11	46464556	46464764	LTR/ERVL	2365	+	104	46464660	34400
chr11	46430260	46630260	harbor1	chr11	46465072	46465428	LTR/ERVL	2365	+	178	46465250	34990
chr11	5127284	5327284	harbor1	chr11	5147269	5147661	LTR/ERVL	1627	+	196	5147465	20181
chr11	5124821	5324821	harbor1	chr11	5147269	5147661	LTR/ERVL	1627	+	196	5147465	22644
chr11	5127245	5327245	harbor1	chr11	5147269	5147661	LTR/ERVL	1627	+	196	5147465	20220
chr11	5126970	5326970	harbor1	chr11	5147269	5147661	LTR/ERVL	1627	+	196	5147465	20495
chr11	5052446	5252446	harbor1	chr11	5147269	5147661	LTR/ERVL	1627	+	196	5147465	95019
chr11	5127167	5327167	harbor1	chr11	5147269	5147661	LTR/ERVL	1627	+	196	5147465	20298
chr11	5126888	5326888	harbor1	chr11	5147269	5147661	LTR/ERVL	1627	+	196	5147465	20577
chr11	5125946	5325946	harbor1	chr11	5147269	5147661	LTR/ERVL	1627	+	196	5147465	21519
chr11	5127149	5327149	harbor1	chr11	5147269	5147661	LTR/ERVL	1627	+	196	5147465	20316
chr11	4897645	5097645	harbor1	chr11	4916193	4916352	LTR/ERVL	437	+	80	4916273	18628
chr11	4897645	5097645	harbor1	chr11	4930248	4930567	LTR/ERVL	750	+	160	4930408	32763
chr11	4897645	5097645	harbor1	chr11	4978793	4979128	LTR/ERVL	847	+	168	4978961	81316
chr11	4897645	5097645	harbor1	chr11	4979658	4979965	LTR/ERVL	673	+	154	4979812	82167
chr11	5126804	5326804	harbor1	chr11	5147269	5147661	LTR/ERVL	1627	+	196	5147465	20661
chr11	76580403	76780403	harbor1	chr11	76644567	76645358	LTR/ERVL	3866	+	396	76644963	64560
chr11	5134605	5334605	harbor1	chr11	5147269	5147661	LTR/ERVL	1627	+	196	5147465	12860
chr11	5125064	5325064	harbor1	chr11	5147269	5147661	LTR/ERVL	1627	+	196	5147465	22401
chr11	5125194	5325194	harbor1	chr11	5147269	5147661	LTR/ERVL	1627	+	196	5147465	22271
chr11	76580432	76780432	harbor1	chr11	76644567	76645358	LTR/ERVL	3866	+	396	76644963	64531
chr11	5126793	5326793	harbor1	chr11	5147269	5147661	LTR/ERVL	1627	+	196	5147465	20672
chr11	5134533	5334533	harbor1	chr11	5147269	5147661	LTR/ERVL	1627	+	196	5147465	12932
chr11	5127205	5327205	harbor1	chr11	5147269	5147661	LTR/ERVL	1627	+	196	5147465	20260
chr11	5127241	5327241	harbor1	chr11	5147269	5147661	LTR/ERVL	1627	+	196	5147465	20224
chr11	76580985	76780985	harbor1	chr11	76644567	76645358	LTR/ERVL	3866	+	396	76644963	63978
chr11	5127169	5327169	harbor1	chr11	5147269	5147661	LTR/ERVL	1627	+	196	5147465	20296
chr11	5134210	5334210	harbor1	chr11	5147269	5147661	LTR/ERVL	1627	+	196	5147465	13255
chr11	64348932	64548932	harbor1	chr11	64397783	64398525	LTR/ERVL	3207	+	371	64398154	49222
chr11	64348932	64548932	harbor1	chr11	64398895	64399098	LTR/ERVL	3207	+	102	64398997	50065
chr11	64348932	64548932	harbor1	chr11	64399334	64399598	LTR/ERVL	874	+	132	64399466	50534
chr11	64348932	64548932	harbor1	chr11	64399914	64399988	LTR/ERVL	874	+	37	64399951	51019
chr11	64348932	64548932	harbor1	chr11	64400513	64400807	LTR/ERVL	4906	+	147	64400660	51728
chr11	64348932	64548932	harbor1	chr11	64401022	64402091	LTR/ERVL	4906	+	534	64401556	52624
chr11	64348932	64548932	harbor1	chr11	64402402	64402510	LTR/ERVL	4906	+	54	64402456	53524
chr11	64348932	64548932	harbor1	chr11	64402699	64402762	LTR/ERVL	448	+	32	64402731	53799
chr11	64348932	64548932	harbor1	chr11	64403166	64403305	LTR/ERVL	448	+	70	64403236	54304
chr11	64348932	64548932	harbor1	chr11	64403308	64403465	LTR/ERVL	1128	+	78	64403386	54454
chr11	64348932	64548932	harbor1	chr11	64403848	64404278	LTR/ERVL	1128	+	215	64404063	55131
chr11	64348932	64548932	harbor1	chr11	64406577	64406966	LTR/ERVL	1939	+	194	64406771	57839
chr11	107909152	108109152	harbor1	chr11	107977838	107978293	LTR/ERVL	3206	+	228	107978066	68914
chr11	107909152	108109152	harbor1	chr11	107978294	107981052	LTR/ERVL	22498	+	1379	107979673	70521
chr11	107909152	108109152	harbor1	chr11	107983119	107985675	LTR/ERVL	23366	+	1278	107984397	75245
chr11	107909152	108109152	harbor1	chr11	107985966	107986260	LTR/ERVL	23366	+	147	107986113	76961
chr11	107909152	108109152	harbor1	chr11	107986261	107986311	LTR/ERVL	448	+	25	107986286	77134
chr11	5134609	5334609	harbor1	chr11	5147269	5147661	LTR/ERVL	1627	+	196	5147465	12856
chr11	5127154	5327154	harbor1	chr11	5147269	5147661	LTR/ERVL	1627	+	196	5147465	20311
chr11	5127316	5327316	harbor1	chr11	5147269	5147661	LTR/ERVL	1627	+	196	5147465	20149
chr11	5131436	5331436	harbor1	chr11	5147269	5147661	LTR/ERVL	1627	+	196	5147465	16029
chr11	5127298	5327298	harbor1	chr11	5147269	5147661	LTR/ERVL	1627	+	196	5147465	20167
chr11	5134612	5334612	harbor1	chr11	5147269	5147661	LTR/ERVL	1627	+	196	5147465	12853
chr11	5134643	5334643	harbor1	chr11	5147269	5147661	LTR/ERVL	1627	+	196	5147465	12822
chr11	43448357	43648357	harbor1	chr11	43505405	43505513	LTR/ERVL	768	+	54	43505459	57102
chr11	43448357	43648357	harbor1	chr11	43505940	43506182	LTR/ERVL	768	+	121	43506061	57704
chr11	43448357	43648357	harbor1	chr11	43524498	43524887	LTR/ERVL	793	+	194	43524692	76335
chr11	43448357	43648357	harbor1	chr11	43527366	43527498	LTR/ERVL	467	+	66	43527432	79075
chr11	43448357	43648357	harbor1	chr11	43527580	43528056	LTR/ERVL	1254	+	238	43527818	79461
chr11	43448357	43648357	harbor1	chr11	43528295	43528497	LTR/ERVL	664	+	101	43528396	80039
chr11	43448357	43648357	harbor1	chr11	43528750	43529032	LTR/ERVL	1248	+	141	43528891	80534
chr11	133199713	133399713	harbor1	chr11	133204911	133205716	LTR/ERVL	3408	+	402	133205313	5600
chr11	5127228	5327228	harbor1	chr11	5147269	5147661	LTR/ERVL	1627	+	196	5147465	20237
chr11	5127118	5327118	harbor1	chr11	5147269	5147661	LTR/ERVL	1627	+	196	5147465	20347
chr11	69539187	69739187	harbor1	chr11	69601712	69602120	LTR/ERVL	480	+	204	69601916	62729
chr11	106965389	107165389	harbor1	chr11	107058158	107058274	LTR/ERVL	803	+	58	107058216	92827
chr11	106965389	107165389	harbor1	chr11	107058275	107058787	LTR/ERVL	2271	+	256	107058531	93142
chr11	5127079	5327079	harbor1	chr11	5147269	5147661	LTR/ERVL	1627	+	196	5147465	20386
chr11	61385568	61585568	harbor1	chr11	61390023	61390281	LTR/ERVL	427	+	129	61390152	4584
chr11	61385568	61585568	harbor1	chr11	61473481	61473588	LTR/ERVL	2427	+	54	61473535	87967
chr11	61385568	61585568	harbor1	chr11	61472712	61473188	LTR/ERVL	2427	+	238	61472950	87382
chr11	5127261	5327261	harbor1	chr11	5147269	5147661	LTR/ERVL	1627	+	196	5147465	20204
chr11	5127282	5327282	harbor1	chr11	5147269	5147661	LTR/ERVL	1627	+	196	5147465	20183
chr11	10653639	10853639	harbor1	chr11	10687273	10687634	LTR/ERVL	468	+	180	10687453	33814
chr11	10653639	10853639	harbor1	chr11	10726298	10726598	LTR/ERVL	739	+	150	10726448	72809
chr11	10653639	10853639	harbor1	chr11	10740415	10741049	LTR/ERVL	1168	+	317	10740732	87093
chr11	10653639	10853639	harbor1	chr11	10741340	10741381	LTR/ERVL	1168	+	20	10741360	87721
chr11	10653639	10853639	harbor1	chr11	10743546	10744083	LTR/ERVL	2407	+	268	10743814	90175
chr11	103833171	104033171	harbor1	chr11	103840082	103840278	LTR/ERVL	795	+	98	103840180	7009
chr11	103833171	104033171	harbor1	chr11	103863016	103863348	LTR/ERVL	717	+	166	103863182	30011
chr11	103833171	104033171	harbor1	chr11	103863432	103864646	LTR/ERVL	2323	+	607	103864039	30868
chr11	5127153	5327153	harbor1	chr11	5147269	5147661	LTR/ERVL	1627	+	196	5147465	20312
chr11	5127126	5327126	harbor1	chr11	5147269	5147661	LTR/ERVL	1627	+	196	5147465	20339
chr11	69539232	69739232	harbor1	chr11	69601712	69602120	LTR/ERVL	480	+	204	69601916	62684
chr11	5127166	5327166	harbor1	chr11	5147269	5147661	LTR/ERVL	1627	+	196	5147465	20299
chr11	5125272	5325272	harbor1	chr11	5147269	5147661	LTR/ERVL	1627	+	196	5147465	22193
chr11	5126765	5326765	harbor1	chr11	5147269	5147661	LTR/ERVL	1627	+	196	5147465	20700
chr11	5132426	5332426	harbor1	chr11	5147269	5147661	LTR/ERVL	1627	+	196	5147465	15039
chr11	65109998	65309998	harbor1	chr11	65161208	65161414	LTR/ERVL	1160	+	103	65161311	51313
chr11	65109998	65309998	harbor1	chr11	65161728	65161819	LTR/ERVL	1160	+	46	65161774	51776
chr11	5127151	5327151	harbor1	chr11	5147269	5147661	LTR/ERVL	1627	+	196	5147465	20314
chr11	5127128	5327128	harbor1	chr11	5147269	5147661	LTR/ERVL	1627	+	196	5147465	20337
chr11	69539231	69739231	harbor1	chr11	69601712	69602120	LTR/ERVL	480	+	204	69601916	62685
chr11	682162	882162	harbor1	chr11	751877	752068	LTR/ERVL	3149	+	96	751973	69811
chr11	682162	882162	harbor1	chr11	752380	753087	LTR/ERVL	3149	+	354	752734	70572
chr11	5134590	5334590	harbor1	chr11	5147269	5147661	LTR/ERVL	1627	+	196	5147465	12875
chr11	76580343	76780343	harbor1	chr11	76644567	76645358	LTR/ERVL	3866	+	396	76644963	64620
chr11	5134611	5334611	harbor1	chr11	5147269	5147661	LTR/ERVL	1627	+	196	5147465	12854
chr11	108021604	108221604	harbor1	chr11	108041018	108041268	LTR/ERVL	805	+	125	108041143	19539
chr11	126625737	126825737	harbor1	chr11	126629543	126630003	LTR/ERVL	934	+	230	126629773	4036
chr11	126625737	126825737	harbor1	chr11	126714482	126714831	LTR/ERVL	1052	+	174	126714656	88919
chr11	5127270	5327270	harbor1	chr11	5147269	5147661	LTR/ERVL	1627	+	196	5147465	20195
chr11	360421	560421	harbor1	chr11	360560	361379	LTR/ERVL	1980	+	410	360970	549
chr11	360421	560421	harbor1	chr11	362389	362971	LTR/ERVL	1980	+	291	362680	2259
chr11	360421	560421	harbor1	chr11	364312	365032	LTR/ERVL	885	+	360	364672	4251
chr11	360421	560421	harbor1	chr11	365329	365592	LTR/ERVL	700	+	132	365461	5040
chr11	360421	560421	harbor1	chr11	366008	366821	LTR/ERVL	1721	+	406	366414	5993
chr11	5134672	5334672	harbor1	chr11	5147269	5147661	LTR/ERVL	1627	+	196	5147465	12793
chr11	5134217	5334217	harbor1	chr11	5147269	5147661	LTR/ERVL	1627	+	196	5147465	13248
chr11	5134433	5334433	harbor1	chr11	5147269	5147661	LTR/ERVL	1627	+	196	5147465	13032
chr11	3008641	3208641	harbor1	chr11	3032372	3032602	LTR/ERVL	965	+	115	3032487	23846
chr11	3008641	3208641	harbor1	chr11	3035811	3036319	LTR/ERVL	1383	+	254	3036065	27424
chr11	5132683	5332683	harbor1	chr11	5147269	5147661	LTR/ERVL	1627	+	196	5147465	14782
chr11	5128063	5328063	harbor1	chr11	5147269	5147661	LTR/ERVL	1627	+	196	5147465	19402
chr11	76580230	76780230	harbor1	chr11	76644567	76645358	LTR/ERVL	3866	+	396	76644963	64733
chr11	108021628	108221628	harbor1	chr11	108041018	108041268	LTR/ERVL	805	+	125	108041143	19515
chr11	11317231	11517231	harbor1	chr11	11385663	11385741	LTR/ERVL	940	+	39	11385702	68471
chr11	11317231	11517231	harbor1	chr11	11386182	11386434	LTR/ERVL	940	+	126	11386308	69077
chr11	11317231	11517231	harbor1	chr11	11410196	11410365	LTR/ERVL	464	+	84	11410280	93049
chr11	11317231	11517231	harbor1	chr11	11412709	11413180	LTR/ERVL	1279	+	236	11412945	95714
chr11	108021537	108221537	harbor1	chr11	108041018	108041268	LTR/ERVL	805	+	125	108041143	19606
chr11	5127315	5327315	harbor1	chr11	5147269	5147661	LTR/ERVL	1627	+	196	5147465	20150
chr11	5126814	5326814	harbor1	chr11	5147269	5147661	LTR/ERVL	1627	+	196	5147465	20651
chr11	2952012	3152012	harbor1	chr11	3032372	3032602	LTR/ERVL	965	+	115	3032487	80475
chr11	2952012	3152012	harbor1	chr11	3035811	3036319	LTR/ERVL	1383	+	254	3036065	84053
chr11	5127068	5327068	harbor1	chr11	5147269	5147661	LTR/ERVL	1627	+	196	5147465	20397
chr11	3928045	4128045	harbor1	chr11	3931720	3932060	LTR/ERVL	1879	+	170	3931890	3845
chr11	3928045	4128045	harbor1	chr11	3932140	3932294	LTR/ERVL	999	+	77	3932217	4172
chr11	2205456	2405456	harbor1	chr11	2221298	2221987	LTR/ERVL	963	+	344	2221642	16186
chr11	2205456	2405456	harbor1	chr11	2232877	2233486	LTR/ERVL	2570	+	304	2233181	27725
chr11	2205456	2405456	harbor1	chr11	2233488	2233698	LTR/ERVL	1041	+	105	2233593	28137
chr11	2205456	2405456	harbor1	chr11	2234036	2234301	LTR/ERVL	1150	+	132	2234168	28712
chr11	2205456	2405456	harbor1	chr11	2234803	2237232	LTR/ERVL	9669	+	1214	2236017	30561
chr11	2205456	2405456	harbor1	chr11	2237535	2237736	LTR/ERVL	9669	+	100	2237635	32179
chr11	2205456	2405456	harbor1	chr11	2237859	2238198	LTR/ERVL	2187	+	170	2238029	32573
chr11	2205456	2405456	harbor1	chr11	2247345	2247565	LTR/ERVL	495	+	110	2247455	41999
chr11	2205456	2405456	harbor1	chr11	2247590	2247951	LTR/ERVL	1098	+	180	2247770	42314
chr11	2205456	2405456	harbor1	chr11	2247976	2248634	LTR/ERVL	785	+	329	2248305	42849
chr11	2205456	2405456	harbor1	chr11	2249209	2249406	LTR/ERVL	399	+	98	2249307	43851
chr11	2205456	2405456	harbor1	chr11	2276494	2277005	LTR/ERVL	1946	+	256	2276750	71294
chr11	5127332	5327332	harbor1	chr11	5147269	5147661	LTR/ERVL	1627	+	196	5147465	20133
chr11	61396733	61596733	harbor1	chr11	61473481	61473588	LTR/ERVL	2427	+	54	61473535	76802
chr11	61396733	61596733	harbor1	chr11	61472712	61473188	LTR/ERVL	2427	+	238	61472950	76217
chr11	5134553	5334553	harbor1	chr11	5147269	5147661	LTR/ERVL	1627	+	196	5147465	12912
chr11	5126802	5326802	harbor1	chr11	5147269	5147661	LTR/ERVL	1627	+	196	5147465	20663
chr11	6201425	6401425	harbor1	chr11	6228929	6229085	LTR/ERVL	627	+	78	6229007	27582
chr11	106091678	106291678	harbor1	chr11	106101564	106101911	LTR/ERVL	471	+	174	106101738	10060
chr11	106091678	106291678	harbor1	chr11	106102270	106102562	LTR/ERVL	475	+	146	106102416	10738
chr11	106091678	106291678	harbor1	chr11	106103264	106104154	LTR/ERVL	1394	+	445	106103709	12031
chr11	106091678	106291678	harbor1	chr11	106104479	106104678	LTR/ERVL	790	+	100	106104579	12901
chr11	106091678	106291678	harbor1	chr11	106104866	106105086	LTR/ERVL	528	+	110	106104976	13298
chr11	106091678	106291678	harbor1	chr11	106114832	106117525	LTR/ERVL	19411	+	1346	106116178	24500
chr11	106091678	106291678	harbor1	chr11	106117526	106118062	LTR/ERVL	1752	+	268	106117794	26116
chr11	106091678	106291678	harbor1	chr11	106134645	106135044	LTR/ERVL	798	+	200	106134845	43167
chr11	106091678	106291678	harbor1	chr11	106147569	106147961	LTR/ERVL	1973	+	196	106147765	56087
chr11	106091678	106291678	harbor1	chr11	106171672	106172188	LTR/ERVL	1983	+	258	106171930	80252
chr11	117886589	118086589	harbor1	chr11	117984458	117984780	LTR/ERVL	1593	+	161	117984619	98030
chr11	5134020	5334020	harbor1	chr11	5147269	5147661	LTR/ERVL	1627	+	196	5147465	13445
chr11	67891296	68091296	harbor1	chr11	67957462	67958064	LTR/ERVL	3150	+	301	67957763	66467
chr11	5127223	5327223	harbor1	chr11	5147269	5147661	LTR/ERVL	1627	+	196	5147465	20242
chr11	76517780	76717780	harbor1	chr11	76561602	76561994	LTR/ERVL	860	+	196	76561798	44018
chr11	76517780	76717780	harbor1	chr11	76570258	76570668	LTR/ERVL	2359	+	205	76570463	52683
chr11	70722515	70922515	harbor1	chr11	70722317	70722522	LTR/ERVL	571	+	102	70722419	96
chr11	70722515	70922515	harbor1	chr11	70757331	70757817	LTR/ERVL	1256	+	243	70757574	35059
chr11	70722515	70922515	harbor1	chr11	70790339	70790759	LTR/ERVL	1996	+	210	70790549	68034
chr11	76581027	76781027	harbor1	chr11	76644567	76645358	LTR/ERVL	3866	+	396	76644963	63936
chr11	120126957	120326957	harbor1	chr11	120144248	120144618	LTR/ERVL	1761	+	185	120144433	17476
chr11	120126957	120326957	harbor1	chr11	120156374	120156836	LTR/ERVL	1953	+	231	120156605	29648
chr11	5129651	5329651	harbor1	chr11	5147269	5147661	LTR/ERVL	1627	+	196	5147465	17814
chr11	7991379	8191379	harbor1	chr11	8011868	8012370	LTR/ERVL	1740	+	251	8012119	20740
chr11	7991379	8191379	harbor1	chr11	8012373	8012481	LTR/ERVL	677	+	54	8012427	21048
chr11	70734542	70934542	harbor1	chr11	70757331	70757817	LTR/ERVL	1256	+	243	70757574	23032
chr11	70734542	70934542	harbor1	chr11	70790339	70790759	LTR/ERVL	1996	+	210	70790549	56007
chr11	5127218	5327218	harbor1	chr11	5147269	5147661	LTR/ERVL	1627	+	196	5147465	20247
chr11	5126735	5326735	harbor1	chr11	5147269	5147661	LTR/ERVL	1627	+	196	5147465	20730
chr11	76566217	76766217	harbor1	chr11	76570258	76570668	LTR/ERVL	2359	+	205	76570463	4246
chr11	76566217	76766217	harbor1	chr11	76644567	76645358	LTR/ERVL	3866	+	396	76644963	78746
chr11	61396083	61596083	harbor1	chr11	61473481	61473588	LTR/ERVL	2427	+	54	61473535	77452
chr11	61396083	61596083	harbor1	chr11	61472712	61473188	LTR/ERVL	2427	+	238	61472950	76867
chr11	5134206	5334206	harbor1	chr11	5147269	5147661	LTR/ERVL	1627	+	196	5147465	13259
chr11	64914628	65114628	harbor1	chr11	64986709	64987070	LTR/ERVL	1972	+	180	64986889	72261
chr11	64914628	65114628	harbor1	chr11	64987698	64987709	LTR/ERVL	1972	+	6	64987704	73076
chr11	64914628	65114628	harbor1	chr11	64987741	64987780	LTR/ERVL	1972	+	20	64987761	73133
chr11	133733693	133933693	harbor1	chr11	133736526	133736978	LTR/ERVL	1637	+	226	133736752	3059
chr11	133733693	133933693	harbor1	chr11	133779805	133780133	LTR/ERVL	552	+	164	133779969	46276
chr11	133733693	133933693	harbor1	chr11	133802102	133802203	LTR/ERVL	426	+	50	133802152	68459
chr11	5127023	5327023	harbor1	chr11	5147269	5147661	LTR/ERVL	1627	+	196	5147465	20442
chr11	5132776	5332776	harbor1	chr11	5147269	5147661	LTR/ERVL	1627	+	196	5147465	14689
chr11	61396791	61596791	harbor1	chr11	61473481	61473588	LTR/ERVL	2427	+	54	61473535	76744
chr11	61396791	61596791	harbor1	chr11	61472712	61473188	LTR/ERVL	2427	+	238	61472950	76159
chr11	69539285	69739285	harbor1	chr11	69601712	69602120	LTR/ERVL	480	+	204	69601916	62631
chr11	5125096	5325096	harbor1	chr11	5147269	5147661	LTR/ERVL	1627	+	196	5147465	22369
chr11	6201391	6401391	harbor1	chr11	6228929	6229085	LTR/ERVL	627	+	78	6229007	27616
chr11	76581063	76781063	harbor1	chr11	76644567	76645358	LTR/ERVL	3866	+	396	76644963	63900
chr11	124700054	124900054	harbor1	chr11	124703390	124703762	LTR/ERVL	719	+	186	124703576	3522
chr11	124700054	124900054	harbor1	chr11	124707745	124708319	LTR/ERVL	1123	+	287	124708032	7978
chr11	124700054	124900054	harbor1	chr11	124713910	124714215	LTR/ERVL	1170	+	152	124714062	14008
chr11	124700054	124900054	harbor1	chr11	124716164	124716348	LTR/ERVL	480	+	92	124716256	16202
chr11	124700054	124900054	harbor1	chr11	124716522	124716751	LTR/ERVL	753	+	114	124716636	16582
chr11	124700054	124900054	harbor1	chr11	124716853	124717057	LTR/ERVL	970	+	102	124716955	16901
chr11	124700054	124900054	harbor1	chr11	124717371	124717588	LTR/ERVL	970	+	108	124717479	17425
chr11	124700054	124900054	harbor1	chr11	124714908	124716158	LTR/ERVL	1328	+	625	124715533	15479
chr11	76517810	76717810	harbor1	chr11	76561602	76561994	LTR/ERVL	860	+	196	76561798	43988
chr11	76517810	76717810	harbor1	chr11	76570258	76570668	LTR/ERVL	2359	+	205	76570463	52653
chr12	62962733	63162733	harbor1	chr12	63011959	63012401	LTR/ERVL	2417	+	221	63012180	49447
chr12	52906640	53106640	harbor1	chr12	52962431	52962794	LTR/ERVL	1283	+	182	52962613	55973
chr12	131246237	131446237	harbor1	chr12	131293569	131293964	LTR/ERVL	1224	+	198	131293767	47530
chr12	64356142	64556142	harbor1	chr12	64363363	64363507	LTR/ERVL	647	+	72	64363435	7293
chr12	64356142	64556142	harbor1	chr12	64364323	64364814	LTR/ERVL	1731	+	246	64364569	8427
chr12	116778966	116978966	harbor1	chr12	116781211	116781391	LTR/ERVL	674	+	90	116781301	2335
chr12	21362986	21562986	harbor1	chr12	21430439	21430488	LTR/ERVL	1559	+	24	21430463	67477
chr12	21362986	21562986	harbor1	chr12	21433684	21434114	LTR/ERVL	2084	+	215	21433899	70913
chr12	21362986	21562986	harbor1	chr12	21459044	21459831	LTR/ERVL	4181	+	394	21459438	96452
chr12	21362986	21562986	harbor1	chr12	21430061	21430397	LTR/ERVL	1559	+	168	21430229	67243
chr12	30880777	31080777	harbor1	chr12	30881403	30882232	LTR/ERVL	4215	+	414	30881817	1040
chr12	92828003	93028003	harbor1	chr12	92879736	92880235	LTR/ERVL	2652	+	250	92879986	51983
chr12	64356143	64556143	harbor1	chr12	64363363	64363507	LTR/ERVL	647	+	72	64363435	7292
chr12	64356143	64556143	harbor1	chr12	64364323	64364814	LTR/ERVL	1731	+	246	64364569	8426
chr12	102336329	102536329	harbor1	chr12	102341788	102342609	LTR/ERVL	1351	+	410	102342198	5869
chr12	102336329	102536329	harbor1	chr12	102351439	102351949	LTR/ERVL	2303	+	255	102351694	15365
chr12	102336329	102536329	harbor1	chr12	102351998	102352050	LTR/ERVL	2303	+	26	102352024	15695
chr12	102336329	102536329	harbor1	chr12	102362524	102362970	LTR/ERVL	3373	+	223	102362747	26418
chr12	102336329	102536329	harbor1	chr12	102363416	102363847	LTR/ERVL	1010	+	216	102363632	27303
chr12	102336329	102536329	harbor1	chr12	102364791	102365439	LTR/ERVL	1019	+	324	102365115	28786
chr12	102336329	102536329	harbor1	chr12	102365526	102365894	LTR/ERVL	659	+	184	102365710	29381
chr12	102336329	102536329	harbor1	chr12	102367837	102368287	LTR/ERVL	1185	+	225	102368062	31733
chr12	102336329	102536329	harbor1	chr12	102408663	102408991	LTR/ERVL	634	+	164	102408827	72498
chr12	56840310	57040310	harbor1	chr12	56858931	56859368	LTR/ERVL	3493	+	218	56859149	18839
chr12	56840310	57040310	harbor1	chr12	56874882	56875653	LTR/ERVL	4004	+	386	56875268	34958
chr12	120657977	120857977	harbor1	chr12	120744973	120745363	LTR/ERVL	835	+	195	120745168	87191
chr12	6359134	6559134	harbor1	chr12	6424686	6425252	LTR/ERVL	1139	+	283	6424969	65835
chr12	6359134	6559134	harbor1	chr12	6431061	6431169	LTR/ERVL	947	+	54	6431115	71981
chr12	6359134	6559134	harbor1	chr12	6431471	6431754	LTR/ERVL	947	+	142	6431613	72479
chr12	132625504	132825504	harbor1	chr12	132640000	132640634	LTR/ERVL	2723	+	317	132640317	14813
chr12	49009817	49209817	harbor1	chr12	49078414	49078616	LTR/ERVL	794	+	101	49078515	68698
chr12	49009817	49209817	harbor1	chr12	49103993	49104429	LTR/ERVL	918	+	218	49104211	94394
chr12	31860001	32060001	harbor1	chr12	31888520	31889291	LTR/ERVL	901	+	386	31888906	28905
chr12	31860001	32060001	harbor1	chr12	31937535	31937982	LTR/ERVL	3545	+	224	31937759	77758
chr12	21402089	21602089	harbor1	chr12	21430439	21430488	LTR/ERVL	1559	+	24	21430463	28374
chr12	21402089	21602089	harbor1	chr12	21433684	21434114	LTR/ERVL	2084	+	215	21433899	31810
chr12	21402089	21602089	harbor1	chr12	21459044	21459831	LTR/ERVL	4181	+	394	21459438	57349
chr12	21402089	21602089	harbor1	chr12	21478668	21479250	LTR/ERVL	2264	+	291	21478959	76870
chr12	21402089	21602089	harbor1	chr12	21480840	21481077	LTR/ERVL	804	+	118	21480958	78869
chr12	21402089	21602089	harbor1	chr12	21492564	21493110	LTR/ERVL	1348	+	273	21492837	90748
chr12	21402089	21602089	harbor1	chr12	21493124	21493928	LTR/ERVL	11814	+	402	21493526	91437
chr12	21402089	21602089	harbor1	chr12	21494348	21495314	LTR/ERVL	11814	+	483	21494831	92742
chr12	21402089	21602089	harbor1	chr12	21498975	21499139	LTR/ERVL	622	+	82	21499057	96968
chr12	21402089	21602089	harbor1	chr12	21430061	21430397	LTR/ERVL	1559	+	168	21430229	28140
chr12	21402089	21602089	harbor1	chr12	21495620	21498912	LTR/ERVL	11814	+	1646	21497266	95177
chr12	121527252	121727252	harbor1	chr12	121611350	121611863	LTR/ERVL	1050	+	256	121611606	84354
chr12	94808159	95008159	harbor1	chr12	94899719	94899896	LTR/ERVL	1574	+	88	94899807	91648
chr12	94808159	95008159	harbor1	chr12	94900201	94900668	LTR/ERVL	1574	+	234	94900435	92276
chr13	20315161	20515161	harbor1	chr13	20317636	20318690	LTR/ERVL	6536	+	527	20318163	3002
chr13	20315161	20515161	harbor1	chr13	20318691	20319230	LTR/ERVL	3102	+	270	20318961	3800
chr13	20315161	20515161	harbor1	chr13	20319231	20319602	LTR/ERVL	1435	+	186	20319417	4256
chr13	20315161	20515161	harbor1	chr13	20320754	20321016	LTR/ERVL	502	+	131	20320885	5724
chr13	20315161	20515161	harbor1	chr13	20322602	20322752	LTR/ERVL	602	+	75	20322677	7516
chr13	27925914	28125914	harbor1	chr13	27939692	27940166	LTR/ERVL	825	+	237	27939929	14015
chr13	27925914	28125914	harbor1	chr13	28003274	28003479	LTR/ERVL	1312	+	102	28003376	77462
chr13	20315121	20515121	harbor1	chr13	20317636	20318690	LTR/ERVL	6536	+	527	20318163	3042
chr13	20315121	20515121	harbor1	chr13	20318691	20319230	LTR/ERVL	3102	+	270	20318961	3840
chr13	20315121	20515121	harbor1	chr13	20319231	20319602	LTR/ERVL	1435	+	186	20319417	4296
chr13	20315121	20515121	harbor1	chr13	20320754	20321016	LTR/ERVL	502	+	131	20320885	5764
chr13	20315121	20515121	harbor1	chr13	20322602	20322752	LTR/ERVL	602	+	75	20322677	7556
chr13	48135005	48335005	harbor1	chr13	48165661	48166090	LTR/ERVL	1730	+	214	48165875	30870
chr13	48135005	48335005	harbor1	chr13	48199094	48199226	LTR/ERVL	1201	+	66	48199160	64155
chr13	48135005	48335005	harbor1	chr13	48199534	48199868	LTR/ERVL	1201	+	167	48199701	64696
chr13	20315155	20515155	harbor1	chr13	20317636	20318690	LTR/ERVL	6536	+	527	20318163	3008
chr13	20315155	20515155	harbor1	chr13	20318691	20319230	LTR/ERVL	3102	+	270	20318961	3806
chr13	20315155	20515155	harbor1	chr13	20319231	20319602	LTR/ERVL	1435	+	186	20319417	4262
chr13	20315155	20515155	harbor1	chr13	20320754	20321016	LTR/ERVL	502	+	131	20320885	5730
chr13	20315155	20515155	harbor1	chr13	20322602	20322752	LTR/ERVL	602	+	75	20322677	7522
chr13	72959646	73159646	harbor1	chr13	73036845	73037029	LTR/ERVL	592	+	92	73036937	77291
chr13	20315106	20515106	harbor1	chr13	20317636	20318690	LTR/ERVL	6536	+	527	20318163	3057
chr13	20315106	20515106	harbor1	chr13	20318691	20319230	LTR/ERVL	3102	+	270	20318961	3855
chr13	20315106	20515106	harbor1	chr13	20319231	20319602	LTR/ERVL	1435	+	186	20319417	4311
chr13	20315106	20515106	harbor1	chr13	20320754	20321016	LTR/ERVL	502	+	131	20320885	5779
chr13	20315106	20515106	harbor1	chr13	20322602	20322752	LTR/ERVL	602	+	75	20322677	7571
chr13	72959141	73159141	harbor1	chr13	73036845	73037029	LTR/ERVL	592	+	92	73036937	77796
chr13	100574944	100774944	harbor1	chr13	100620145	100620615	LTR/ERVL	556	+	235	100620380	45436
chr13	20315169	20515169	harbor1	chr13	20317636	20318690	LTR/ERVL	6536	+	527	20318163	2994
chr13	20315169	20515169	harbor1	chr13	20318691	20319230	LTR/ERVL	3102	+	270	20318961	3792
chr13	20315169	20515169	harbor1	chr13	20319231	20319602	LTR/ERVL	1435	+	186	20319417	4248
chr13	20315169	20515169	harbor1	chr13	20320754	20321016	LTR/ERVL	502	+	131	20320885	5716
chr13	20315169	20515169	harbor1	chr13	20322602	20322752	LTR/ERVL	602	+	75	20322677	7508
chr13	100413825	100613825	harbor1	chr13	100438448	100438841	LTR/ERVL	2324	+	196	100438644	24819
chr13	38912775	39112775	harbor1	chr13	38943259	38943727	LTR/ERVL	2456	+	234	38943493	30718
chr13	38912775	39112775	harbor1	chr13	38961120	38961400	LTR/ERVL	716	+	140	38961260	48485
chr13	20315123	20515123	harbor1	chr13	20317636	20318690	LTR/ERVL	6536	+	527	20318163	3040
chr13	20315123	20515123	harbor1	chr13	20318691	20319230	LTR/ERVL	3102	+	270	20318961	3838
chr13	20315123	20515123	harbor1	chr13	20319231	20319602	LTR/ERVL	1435	+	186	20319417	4294
chr13	20315123	20515123	harbor1	chr13	20320754	20321016	LTR/ERVL	502	+	131	20320885	5762
chr13	20315123	20515123	harbor1	chr13	20322602	20322752	LTR/ERVL	602	+	75	20322677	7554
chr13	19764706	19964706	harbor1	chr13	19793726	19793752	LTR/ERVL	778	+	13	19793739	29033
chr13	19764706	19964706	harbor1	chr13	19794055	19794258	LTR/ERVL	778	+	102	19794157	29451
chr13	20315143	20515143	harbor1	chr13	20317636	20318690	LTR/ERVL	6536	+	527	20318163	3020
chr13	20315143	20515143	harbor1	chr13	20318691	20319230	LTR/ERVL	3102	+	270	20318961	3818
chr13	20315143	20515143	harbor1	chr13	20319231	20319602	LTR/ERVL	1435	+	186	20319417	4274
chr13	20315143	20515143	harbor1	chr13	20320754	20321016	LTR/ERVL	502	+	131	20320885	5742
chr13	20315143	20515143	harbor1	chr13	20322602	20322752	LTR/ERVL	602	+	75	20322677	7534
chr13	24917691	25117691	harbor1	chr13	24953680	24954292	LTR/ERVL	2943	+	306	24953986	36295
chr13	24917691	25117691	harbor1	chr13	24983475	24984185	LTR/ERVL	3327	+	355	24983830	66139
chr13	100568699	100768699	harbor1	chr13	100620145	100620615	LTR/ERVL	556	+	235	100620380	51681
chr13	20262753	20462753	harbor1	chr13	20312355	20312501	LTR/ERVL	459	+	73	20312428	49675
chr13	20262753	20462753	harbor1	chr13	20312510	20312689	LTR/ERVL	754	+	90	20312600	49847
chr13	20262753	20462753	harbor1	chr13	20317636	20318690	LTR/ERVL	6536	+	527	20318163	55410
chr13	20262753	20462753	harbor1	chr13	20318691	20319230	LTR/ERVL	3102	+	270	20318961	56208
chr13	20262753	20462753	harbor1	chr13	20319231	20319602	LTR/ERVL	1435	+	186	20319417	56664
chr13	20262753	20462753	harbor1	chr13	20320754	20321016	LTR/ERVL	502	+	131	20320885	58132
chr13	20262753	20462753	harbor1	chr13	20322602	20322752	LTR/ERVL	602	+	75	20322677	59924
chr13	109947746	110147746	harbor1	chr13	109948268	109949580	LTR/ERVL	10389	+	656	109948924	1178
chr13	109947746	110147746	harbor1	chr13	109949548	109951132	LTR/ERVL	12689	+	792	109950340	2594
chr13	109947746	110147746	harbor1	chr13	109951201	109951534	LTR/ERVL	2497	+	166	109951367	3621
chr13	109947746	110147746	harbor1	chr13	109951584	109952007	LTR/ERVL	2984	+	212	109951796	4050
chr13	109947746	110147746	harbor1	chr13	109952008	109952409	LTR/ERVL	2873	+	200	109952208	4462
chr13	109947746	110147746	harbor1	chr13	109957859	109957990	LTR/ERVL	464	+	66	109957925	10179
chr13	109947746	110147746	harbor1	chr13	110003837	110004253	LTR/ERVL	1600	+	208	110004045	56299
chr13	20315206	20515206	harbor1	chr13	20317636	20318690	LTR/ERVL	6536	+	527	20318163	2957
chr13	20315206	20515206	harbor1	chr13	20318691	20319230	LTR/ERVL	3102	+	270	20318961	3755
chr13	20315206	20515206	harbor1	chr13	20319231	20319602	LTR/ERVL	1435	+	186	20319417	4211
chr13	20315206	20515206	harbor1	chr13	20320754	20321016	LTR/ERVL	502	+	131	20320885	5679
chr13	20315206	20515206	harbor1	chr13	20322602	20322752	LTR/ERVL	602	+	75	20322677	7471
chr13	95201275	95401275	harbor1	chr13	95201988	95202404	LTR/ERVL	1937	+	208	95202196	921
chr13	95201275	95401275	harbor1	chr13	95267771	95268020	LTR/ERVL	1278	+	124	95267895	66620
chr13	95201275	95401275	harbor1	chr13	95269004	95269234	LTR/ERVL	1278	+	115	95269119	67844
chr13	95201275	95401275	harbor1	chr13	95274225	95274738	LTR/ERVL	1476	+	256	95274481	73206
chr14	52595151	52795151	harbor1	chr14	52693218	52693551	LTR/ERVL	2456	+	166	52693384	98233
chr14	90282069	90482069	harbor1	chr14	90340655	90341063	LTR/ERVL	865	+	204	90340859	58790
chr14	90282069	90482069	harbor1	chr14	90341356	90341476	LTR/ERVL	865	+	60	90341416	59347
chr14	95434849	95634849	harbor1	chr14	95461447	95461684	LTR/ERVL	596	+	118	95461565	26716
chr14	95434849	95634849	harbor1	chr14	95468377	95468811	LTR/ERVL	930	+	217	95468594	33745
chr14	75885958	76085958	harbor1	chr14	75908703	75908788	LTR/ERVL	2117	+	42	75908745	22787
chr14	75885958	76085958	harbor1	chr14	75909078	75909545	LTR/ERVL	2117	+	234	75909312	23354
chr14	104603549	104803549	harbor1	chr14	104620992	104621099	LTR/ERVL	448	+	54	104621046	17497
chr14	104603549	104803549	harbor1	chr14	104622030	104622339	LTR/ERVL	473	+	154	104622184	18635
chr14	104603549	104803549	harbor1	chr14	104662325	104662713	LTR/ERVL	1267	+	194	104662519	58970
chr14	100185498	100385498	harbor1	chr14	100206120	100206922	LTR/ERVL	2313	+	401	100206521	21023
chr14	75327880	75527880	harbor1	chr14	75344361	75344843	LTR/ERVL	2261	+	241	75344602	16722
chr14	75327880	75527880	harbor1	chr14	75345881	75346312	LTR/ERVL	2049	+	216	75346097	18217
chr14	75327880	75527880	harbor1	chr14	75369589	75370008	LTR/ERVL	1366	+	210	75369799	41919
chr14	75327880	75527880	harbor1	chr14	75370049	75370247	LTR/ERVL	802	+	99	75370148	42268
chr14	75327880	75527880	harbor1	chr14	75370263	75370616	LTR/ERVL	1119	+	176	75370439	42559
chr14	75327880	75527880	harbor1	chr14	75374557	75375034	LTR/ERVL	2698	+	238	75374795	46915
chr14	100185509	100385509	harbor1	chr14	100206120	100206922	LTR/ERVL	2313	+	401	100206521	21012
chr14	90164299	90364299	harbor1	chr14	90172638	90173020	LTR/ERVL	485	+	191	90172829	8530
chr14	90164299	90364299	harbor1	chr14	90227625	90229448	LTR/ERVL	40678	+	912	90228537	64238
chr14	90164299	90364299	harbor1	chr14	90229743	90232953	LTR/ERVL	40678	+	1605	90231348	67049
chr14	90164299	90364299	harbor1	chr14	90233251	90233487	LTR/ERVL	40678	+	118	90233369	69070
chr14	90164299	90364299	harbor1	chr14	90233488	90233938	LTR/ERVL	3245	+	225	90233713	69414
chr14	75328395	75528395	harbor1	chr14	75344361	75344843	LTR/ERVL	2261	+	241	75344602	16207
chr14	75328395	75528395	harbor1	chr14	75345881	75346312	LTR/ERVL	2049	+	216	75346097	17702
chr14	75328395	75528395	harbor1	chr14	75369589	75370008	LTR/ERVL	1366	+	210	75369799	41404
chr14	75328395	75528395	harbor1	chr14	75370049	75370247	LTR/ERVL	802	+	99	75370148	41753
chr14	75328395	75528395	harbor1	chr14	75370263	75370616	LTR/ERVL	1119	+	176	75370439	42044
chr14	75328395	75528395	harbor1	chr14	75374557	75375034	LTR/ERVL	2698	+	238	75374795	46400
chr14	75328436	75528436	harbor1	chr14	75344361	75344843	LTR/ERVL	2261	+	241	75344602	16166
chr14	75328436	75528436	harbor1	chr14	75345881	75346312	LTR/ERVL	2049	+	216	75346097	17661
chr14	75328436	75528436	harbor1	chr14	75369589	75370008	LTR/ERVL	1366	+	210	75369799	41363
chr14	75328436	75528436	harbor1	chr14	75370049	75370247	LTR/ERVL	802	+	99	75370148	41712
chr14	75328436	75528436	harbor1	chr14	75370263	75370616	LTR/ERVL	1119	+	176	75370439	42003
chr14	75328436	75528436	harbor1	chr14	75374557	75375034	LTR/ERVL	2698	+	238	75374795	46359
chr14	95435211	95635211	harbor1	chr14	95461447	95461684	LTR/ERVL	596	+	118	95461565	26354
chr14	95435211	95635211	harbor1	chr14	95468377	95468811	LTR/ERVL	930	+	217	95468594	33383
chr14	90282794	90482794	harbor1	chr14	90340655	90341063	LTR/ERVL	865	+	204	90340859	58065
chr14	90282794	90482794	harbor1	chr14	90341356	90341476	LTR/ERVL	865	+	60	90341416	58622
chr14	75328363	75528363	harbor1	chr14	75344361	75344843	LTR/ERVL	2261	+	241	75344602	16239
chr14	75328363	75528363	harbor1	chr14	75345881	75346312	LTR/ERVL	2049	+	216	75346097	17734
chr14	75328363	75528363	harbor1	chr14	75369589	75370008	LTR/ERVL	1366	+	210	75369799	41436
chr14	75328363	75528363	harbor1	chr14	75370049	75370247	LTR/ERVL	802	+	99	75370148	41785
chr14	75328363	75528363	harbor1	chr14	75370263	75370616	LTR/ERVL	1119	+	176	75370439	42076
chr14	75328363	75528363	harbor1	chr14	75374557	75375034	LTR/ERVL	2698	+	238	75374795	46432
chr14	66148048	66348048	harbor1	chr14	66165692	66165880	LTR/ERVL	746	+	94	66165786	17738
chr14	66148048	66348048	harbor1	chr14	66166631	66166841	LTR/ERVL	737	+	105	66166736	18688
chr14	66148048	66348048	harbor1	chr14	66198313	66198759	LTR/ERVL	1283	+	223	66198536	50488
chr14	81174155	81374155	harbor1	chr14	81229168	81229476	LTR/ERVL	1800	+	154	81229322	55167
chr14	81174155	81374155	harbor1	chr14	81230150	81230236	LTR/ERVL	599	+	43	81230193	56038
chr14	81174155	81374155	harbor1	chr14	81230290	81230331	LTR/ERVL	599	+	20	81230310	56155
chr14	81174155	81374155	harbor1	chr14	81233437	81234145	LTR/ERVL	18766	+	354	81233791	59636
chr14	81174155	81374155	harbor1	chr14	81254494	81255332	LTR/ERVL	4191	+	419	81254913	80758
chr14	81174155	81374155	harbor1	chr14	81230355	81233044	LTR/ERVL	18766	+	1344	81231699	57544
chr14	95435221	95635221	harbor1	chr14	95461447	95461684	LTR/ERVL	596	+	118	95461565	26344
chr14	95435221	95635221	harbor1	chr14	95468377	95468811	LTR/ERVL	930	+	217	95468594	33373
chr14	88923334	89123334	harbor1	chr14	88941625	88941759	LTR/ERVL	455	+	67	88941692	18358
chr14	88923334	89123334	harbor1	chr14	88977208	88977427	LTR/ERVL	596	+	110	88977318	53984
chr14	88923334	89123334	harbor1	chr14	88990317	88990639	LTR/ERVL	1556	+	161	88990478	67144
chr14	88923334	89123334	harbor1	chr14	88990775	88990805	LTR/ERVL	1207	+	15	88990790	67456
chr14	95435535	95635535	harbor1	chr14	95461447	95461684	LTR/ERVL	596	+	118	95461565	26030
chr14	95435535	95635535	harbor1	chr14	95468377	95468811	LTR/ERVL	930	+	217	95468594	33059
chr14	91224851	91424851	harbor1	chr14	91257474	91257894	LTR/ERVL	1034	+	210	91257684	32833
chr14	91224851	91424851	harbor1	chr14	91268100	91268400	LTR/ERVL	2102	+	150	91268250	43399
chr14	91224851	91424851	harbor1	chr14	91269139	91269218	LTR/ERVL	555	+	40	91269179	44328
chr14	91224851	91424851	harbor1	chr14	91320055	91320764	LTR/ERVL	2904	+	354	91320409	95558
chr14	100185484	100385484	harbor1	chr14	100206120	100206922	LTR/ERVL	2313	+	401	100206521	21037
chr14	104590358	104790358	harbor1	chr14	104620992	104621099	LTR/ERVL	448	+	54	104621046	30688
chr14	104590358	104790358	harbor1	chr14	104622030	104622339	LTR/ERVL	473	+	154	104622184	31826
chr14	104590358	104790358	harbor1	chr14	104662325	104662713	LTR/ERVL	1267	+	194	104662519	72161
chr14	103611773	103811773	harbor1	chr14	103617208	103617623	LTR/ERVL	917	+	208	103617416	5643
chr14	100182129	100382129	harbor1	chr14	100206120	100206922	LTR/ERVL	2313	+	401	100206521	24392
chr14	23452131	23652131	harbor1	chr14	23456685	23456957	LTR/ERVL	3361	+	136	23456821	4690
chr14	23452131	23652131	harbor1	chr14	23457679	23458309	LTR/ERVL	3361	+	315	23457994	5863
chr14	105059476	105259476	harbor1	chr14	105124374	105124689	LTR/ERVL	522	+	158	105124532	65056
chr14	105059476	105259476	harbor1	chr14	105129954	105130159	LTR/ERVL	4627	+	102	105130056	70580
chr14	105059476	105259476	harbor1	chr14	105130472	105130786	LTR/ERVL	4627	+	157	105130629	71153
chr14	105059476	105259476	harbor1	chr14	105131090	105131880	LTR/ERVL	4627	+	395	105131485	72009
chr14	67500240	67700240	harbor1	chr14	67530451	67530755	LTR/ERVL	893	+	152	67530603	30363
chr14	76928821	77128821	harbor1	chr14	76948468	76948832	LTR/ERVL	1066	+	182	76948650	19829
chr14	76928821	77128821	harbor1	chr14	76992455	76992672	LTR/ERVL	588	+	108	76992563	63742
chr14	94074221	94274221	harbor1	chr14	94088070	94088490	LTR/ERVL	519	+	210	94088280	14059
chr14	94074221	94274221	harbor1	chr14	94088595	94088691	LTR/ERVL	519	+	48	94088643	14422
chr14	94074221	94274221	harbor1	chr14	94119989	94120091	LTR/ERVL	552	+	51	94120040	45819
chr14	94074221	94274221	harbor1	chr14	94120509	94121304	LTR/ERVL	3421	+	398	94120907	46686
chr14	94074221	94274221	harbor1	chr14	94165938	94166218	LTR/ERVL	567	+	140	94166078	91857
chr14	75327097	75527097	harbor1	chr14	75344361	75344843	LTR/ERVL	2261	+	241	75344602	17505
chr14	75327097	75527097	harbor1	chr14	75345881	75346312	LTR/ERVL	2049	+	216	75346097	19000
chr14	75327097	75527097	harbor1	chr14	75369589	75370008	LTR/ERVL	1366	+	210	75369799	42702
chr14	75327097	75527097	harbor1	chr14	75370049	75370247	LTR/ERVL	802	+	99	75370148	43051
chr14	75327097	75527097	harbor1	chr14	75370263	75370616	LTR/ERVL	1119	+	176	75370439	43342
chr14	75327097	75527097	harbor1	chr14	75374557	75375034	LTR/ERVL	2698	+	238	75374795	47698
chr14	76928851	77128851	harbor1	chr14	76948468	76948832	LTR/ERVL	1066	+	182	76948650	19799
chr14	76928851	77128851	harbor1	chr14	76992455	76992672	LTR/ERVL	588	+	108	76992563	63712
chr14	76928811	77128811	harbor1	chr14	76948468	76948832	LTR/ERVL	1066	+	182	76948650	19839
chr14	76928811	77128811	harbor1	chr14	76992455	76992672	LTR/ERVL	588	+	108	76992563	63752
chr14	76928796	77128796	harbor1	chr14	76948468	76948832	LTR/ERVL	1066	+	182	76948650	19854
chr14	76928796	77128796	harbor1	chr14	76992455	76992672	LTR/ERVL	588	+	108	76992563	63767
chr14	51140268	51340268	harbor1	chr14	51173976	51174147	LTR/ERVL	558	+	86	51174062	33794
chr14	51140268	51340268	harbor1	chr14	51174533	51174975	LTR/ERVL	2010	+	221	51174754	34486
chr14	51140268	51340268	harbor1	chr14	51175944	51176222	LTR/ERVL	748	+	139	51176083	35815
chr14	51140268	51340268	harbor1	chr14	51186692	51187145	LTR/ERVL	2566	+	226	51186918	46650
chr14	51140268	51340268	harbor1	chr14	51187202	51187243	LTR/ERVL	2566	+	20	51187222	46954
chr14	51140268	51340268	harbor1	chr14	51194956	51196415	LTR/ERVL	3145	+	730	51195686	55418
chr14	51140268	51340268	harbor1	chr14	51196495	51196620	LTR/ERVL	459	+	62	51196557	56289
chr14	51140268	51340268	harbor1	chr14	51196813	51196939	LTR/ERVL	476	+	63	51196876	56608
chr14	91224777	91424777	harbor1	chr14	91257474	91257894	LTR/ERVL	1034	+	210	91257684	32907
chr14	91224777	91424777	harbor1	chr14	91268100	91268400	LTR/ERVL	2102	+	150	91268250	43473
chr14	91224777	91424777	harbor1	chr14	91269139	91269218	LTR/ERVL	555	+	40	91269179	44402
chr14	91224777	91424777	harbor1	chr14	91320055	91320764	LTR/ERVL	2904	+	354	91320409	95632
chr14	104623497	104823497	harbor1	chr14	104662325	104662713	LTR/ERVL	1267	+	194	104662519	39022
chr14	76928421	77128421	harbor1	chr14	76948468	76948832	LTR/ERVL	1066	+	182	76948650	20229
chr14	76928421	77128421	harbor1	chr14	76992455	76992672	LTR/ERVL	588	+	108	76992563	64142
chr14	100185531	100385531	harbor1	chr14	100206120	100206922	LTR/ERVL	2313	+	401	100206521	20990
chr14	100032741	100232741	harbor1	chr14	100040943	100041014	LTR/ERVL	493	+	36	100040979	8238
chr14	100032741	100232741	harbor1	chr14	100042739	100043104	LTR/ERVL	1695	+	182	100042921	10180
chr14	100032741	100232741	harbor1	chr14	100054011	100054049	LTR/ERVL	1976	+	19	100054030	21289
chr14	100032741	100232741	harbor1	chr14	100054352	100054875	LTR/ERVL	1976	+	262	100054614	21873
chr14	100032741	100232741	harbor1	chr14	100091050	100091952	LTR/ERVL	2731	+	451	100091501	58760
chr14	100032741	100232741	harbor1	chr14	100092243	100092290	LTR/ERVL	2090	+	24	100092267	59526
chr14	104588146	104788146	harbor1	chr14	104620992	104621099	LTR/ERVL	448	+	54	104621046	32900
chr14	104588146	104788146	harbor1	chr14	104622030	104622339	LTR/ERVL	473	+	154	104622184	34038
chr14	104588146	104788146	harbor1	chr14	104662325	104662713	LTR/ERVL	1267	+	194	104662519	74373
chr14	76928813	77128813	harbor1	chr14	76948468	76948832	LTR/ERVL	1066	+	182	76948650	19837
chr14	76928813	77128813	harbor1	chr14	76992455	76992672	LTR/ERVL	588	+	108	76992563	63750
chr14	76928830	77128830	harbor1	chr14	76948468	76948832	LTR/ERVL	1066	+	182	76948650	19820
chr14	76928830	77128830	harbor1	chr14	76992455	76992672	LTR/ERVL	588	+	108	76992563	63733
chr14	104416746	104616746	harbor1	chr14	104495848	104496408	LTR/ERVL	1620	+	280	104496128	79382
chr14	104416746	104616746	harbor1	chr14	104496785	104497225	LTR/ERVL	886	+	220	104497005	80259
chr14	22776770	22976770	harbor1	chr14	22790356	22790561	LTR/ERVL	721	+	102	22790458	13688
chr14	104000741	104200741	harbor1	chr14	104043839	104044308	LTR/ERVL	1964	+	234	104044073	43332
chr14	104000741	104200741	harbor1	chr14	104068870	104069388	LTR/ERVL	2606	+	259	104069129	68388
chr14	104000741	104200741	harbor1	chr14	104078003	104078184	LTR/ERVL	699	+	90	104078093	77352
chr14	91474368	91674368	harbor1	chr14	91524033	91524441	LTR/ERVL	852	+	204	91524237	49869
chr14	91474368	91674368	harbor1	chr14	91536529	91536714	LTR/ERVL	554	+	92	91536621	62253
chr14	91474368	91674368	harbor1	chr14	91568744	91568935	LTR/ERVL	461	+	96	91568840	94472
chr14	90283195	90483195	harbor1	chr14	90340655	90341063	LTR/ERVL	865	+	204	90340859	57664
chr14	90283195	90483195	harbor1	chr14	90341356	90341476	LTR/ERVL	865	+	60	90341416	58221
chr14	75328380	75528380	harbor1	chr14	75344361	75344843	LTR/ERVL	2261	+	241	75344602	16222
chr14	75328380	75528380	harbor1	chr14	75345881	75346312	LTR/ERVL	2049	+	216	75346097	17717
chr14	75328380	75528380	harbor1	chr14	75369589	75370008	LTR/ERVL	1366	+	210	75369799	41419
chr14	75328380	75528380	harbor1	chr14	75370049	75370247	LTR/ERVL	802	+	99	75370148	41768
chr14	75328380	75528380	harbor1	chr14	75370263	75370616	LTR/ERVL	1119	+	176	75370439	42059
chr14	75328380	75528380	harbor1	chr14	75374557	75375034	LTR/ERVL	2698	+	238	75374795	46415
chr14	64194361	64394361	harbor1	chr14	64243988	64244116	LTR/ERVL	3248	+	64	64244052	49691
chr14	64194361	64394361	harbor1	chr14	64244422	64244864	LTR/ERVL	3248	+	221	64244643	50282
chr14	67499989	67699989	harbor1	chr14	67530451	67530755	LTR/ERVL	893	+	152	67530603	30614
chr14	100182018	100382018	harbor1	chr14	100206120	100206922	LTR/ERVL	2313	+	401	100206521	24503
chr14	104015415	104215415	harbor1	chr14	104043839	104044308	LTR/ERVL	1964	+	234	104044073	28658
chr14	104015415	104215415	harbor1	chr14	104068870	104069388	LTR/ERVL	2606	+	259	104069129	53714
chr14	104015415	104215415	harbor1	chr14	104078003	104078184	LTR/ERVL	699	+	90	104078093	62678
chr14	76925476	77125476	harbor1	chr14	76948468	76948832	LTR/ERVL	1066	+	182	76948650	23174
chr14	76925476	77125476	harbor1	chr14	76992455	76992672	LTR/ERVL	588	+	108	76992563	67087
chr14	90283220	90483220	harbor1	chr14	90340655	90341063	LTR/ERVL	865	+	204	90340859	57639
chr14	90283220	90483220	harbor1	chr14	90341356	90341476	LTR/ERVL	865	+	60	90341416	58196
chr14	105054599	105254599	harbor1	chr14	105124374	105124689	LTR/ERVL	522	+	158	105124532	69933
chr14	105054599	105254599	harbor1	chr14	105129954	105130159	LTR/ERVL	4627	+	102	105130056	75457
chr14	105054599	105254599	harbor1	chr14	105130472	105130786	LTR/ERVL	4627	+	157	105130629	76030
chr14	105054599	105254599	harbor1	chr14	105131090	105131880	LTR/ERVL	4627	+	395	105131485	76886
chr14	101439534	101639534	harbor1	chr14	101472489	101472813	LTR/ERVL	1539	+	162	101472651	33117
chr14	101439534	101639534	harbor1	chr14	101473123	101473213	LTR/ERVL	591	+	45	101473168	33634
chr14	101439534	101639534	harbor1	chr14	101473270	101473320	LTR/ERVL	591	+	25	101473295	33761
chr14	101439534	101639534	harbor1	chr14	101490931	101491222	LTR/ERVL	680	+	146	101491077	51543
chr14	101439534	101639534	harbor1	chr14	101508826	101509217	LTR/ERVL	649	+	196	101509022	69488
chr14	101439534	101639534	harbor1	chr14	101509615	101509800	LTR/ERVL	516	+	92	101509707	70173
chr14	101439534	101639534	harbor1	chr14	101509953	101511021	LTR/ERVL	1764	+	534	101510487	70953
chr14	101439534	101639534	harbor1	chr14	101511051	101511454	LTR/ERVL	1001	+	202	101511253	71719
chr14	101439534	101639534	harbor1	chr14	101511477	101511700	LTR/ERVL	739	+	112	101511589	72055
chr14	101439534	101639534	harbor1	chr14	101511742	101512013	LTR/ERVL	962	+	136	101511878	72344
chr15	29169912	29369912	harbor1	chr15	29188112	29188245	LTR/ERVL	3440	+	66	29188178	18266
chr15	29169912	29369912	harbor1	chr15	29188616	29189372	LTR/ERVL	3440	+	378	29188994	19082
chr15	29169912	29369912	harbor1	chr15	29193151	29193692	LTR/ERVL	2923	+	270	29193421	23509
chr15	29169912	29369912	harbor1	chr15	29209994	29210364	LTR/ERVL	1931	+	185	29210179	40267
chr15	29169912	29369912	harbor1	chr15	29210707	29210866	LTR/ERVL	1931	+	80	29210787	40875
chr15	29169912	29369912	harbor1	chr15	29215185	29215568	LTR/ERVL	3199	+	192	29215377	45465
chr15	29169912	29369912	harbor1	chr15	29215598	29215637	LTR/ERVL	3199	+	20	29215618	45706
chr15	29169912	29369912	harbor1	chr15	29262159	29263033	LTR/ERVL	5139	+	437	29262596	92684
chr15	101843670	102043670	harbor1	chr15	101854750	101855111	LTR/ERVL	4559	+	180	101854930	11260
chr15	101843670	102043670	harbor1	chr15	101855372	101856039	LTR/ERVL	4559	+	334	101855706	12036
chr15	25243057	25443057	harbor1	chr15	25321943	25322565	LTR/ERVL	1481	+	311	25322254	79197
chr15	101728928	101928928	harbor1	chr15	101821232	101821659	LTR/ERVL	1915	+	214	101821446	92518
chr15	101728928	101928928	harbor1	chr15	101821955	101822556	LTR/ERVL	1915	+	300	101822255	93327
chr15	101728928	101928928	harbor1	chr15	101824018	101824358	LTR/ERVL	1004	+	170	101824188	95260
chr15	101728928	101928928	harbor1	chr15	101824366	101824536	LTR/ERVL	474	+	85	101824451	95523
chr15	24856071	25056071	harbor1	chr15	24899312	24899743	LTR/ERVL	1050	+	216	24899528	43457
chr15	24856071	25056071	harbor1	chr15	24899989	24900350	LTR/ERVL	538	+	180	24900169	44098
chr15	24856071	25056071	harbor1	chr15	24901226	24901417	LTR/ERVL	577	+	96	24901322	45251
chr15	66786957	66986957	harbor1	chr15	66790919	66791337	LTR/ERVL	1586	+	209	66791128	4171
chr15	66786957	66986957	harbor1	chr15	66791339	66791429	LTR/ERVL	464	+	45	66791384	4427
chr15	66786957	66986957	harbor1	chr15	66791736	66792209	LTR/ERVL	1528	+	236	66791972	5015
chr15	66786957	66986957	harbor1	chr15	66792282	66792395	LTR/ERVL	2520	+	56	66792338	5381
chr15	66786957	66986957	harbor1	chr15	66792694	66793061	LTR/ERVL	2520	+	184	66792878	5921
chr15	66786957	66986957	harbor1	chr15	66793461	66793659	LTR/ERVL	2520	+	99	66793560	6603
chr15	66786957	66986957	harbor1	chr15	66793952	66794315	LTR/ERVL	2520	+	182	66794134	7177
chr15	66786957	66986957	harbor1	chr15	66794433	66794659	LTR/ERVL	1018	+	113	66794546	7589
chr15	66786957	66986957	harbor1	chr15	66794687	66794980	LTR/ERVL	1347	+	146	66794833	7876
chr15	66786957	66986957	harbor1	chr15	66795264	66795376	LTR/ERVL	1347	+	56	66795320	8363
chr15	66786957	66986957	harbor1	chr15	66795529	66795741	LTR/ERVL	764	+	106	66795635	8678
chr15	101861558	102061558	harbor1	chr15	101948690	101949583	LTR/ERVL	756	+	446	101949136	87578
chr15	34109577	34309577	harbor1	chr15	34109851	34109977	LTR/ERVL	521	+	63	34109914	337
chr15	29944821	30144821	harbor1	chr15	29985339	29986040	LTR/ERVL	1410	+	350	29985689	40868
chr15	29944821	30144821	harbor1	chr15	30005084	30005200	LTR/ERVL	421	+	58	30005142	60321
chr15	101552272	101752272	harbor1	chr15	101565613	101565755	LTR/ERVL	418	+	71	101565684	13412
chr15	101552272	101752272	harbor1	chr15	101608064	101608656	LTR/ERVL	959	+	296	101608360	56088
chr15	101552272	101752272	harbor1	chr15	101608963	101609061	LTR/ERVL	959	+	49	101609012	56740
chr15	22455716	22655716	harbor1	chr15	22502366	22502763	LTR/ERVL	816	+	198	22502564	46848
chr15	22455716	22655716	harbor1	chr15	22522147	22522302	LTR/ERVL	704	+	78	22522225	66509
chr15	101861545	102061545	harbor1	chr15	101948690	101949583	LTR/ERVL	756	+	446	101949136	87591
chr15	101861594	102061594	harbor1	chr15	101948690	101949583	LTR/ERVL	756	+	446	101949136	87542
chr15	74946674	75146674	harbor1	chr15	74965309	74965719	LTR/ERVL	434	+	205	74965514	18840
chr15	74946674	75146674	harbor1	chr15	74979643	74980018	LTR/ERVL	1737	+	188	74979831	33157
chr15	74946674	75146674	harbor1	chr15	74991948	74992195	LTR/ERVL	778	+	124	74992072	45398
chr15	24516009	24716009	harbor1	chr15	24533317	24533745	LTR/ERVL	2235	+	214	24533531	17522
chr15	24516009	24716009	harbor1	chr15	24533753	24534492	LTR/ERVL	2854	+	370	24534123	18114
chr15	24516009	24716009	harbor1	chr15	24534517	24535647	LTR/ERVL	5877	+	565	24535082	19073
chr15	24516009	24716009	harbor1	chr15	24535648	24535977	LTR/ERVL	5669	+	164	24535812	19803
chr15	24516009	24716009	harbor1	chr15	24536275	24536914	LTR/ERVL	5669	+	320	24536595	20586
chr15	24516009	24716009	harbor1	chr15	24604773	24605199	LTR/ERVL	2401	+	213	24604986	88977
chr15	24516009	24716009	harbor1	chr15	24605204	24605967	LTR/ERVL	3057	+	382	24605586	89577
chr15	24516009	24716009	harbor1	chr15	24606000	24606753	LTR/ERVL	4186	+	376	24606376	90367
chr15	24516009	24716009	harbor1	chr15	24606755	24606872	LTR/ERVL	801	+	58	24606813	90804
chr15	24516009	24716009	harbor1	chr15	24606873	24608490	LTR/ERVL	9722	+	808	24607681	91672
chr15	24516009	24716009	harbor1	chr15	24608493	24608589	LTR/ERVL	568	+	48	24608541	92532
chr15	24516009	24716009	harbor1	chr15	24610039	24610728	LTR/ERVL	2868	+	344	24610383	94374
chr15	78668333	78868333	harbor1	chr15	78672413	78673025	LTR/ERVL	3811	+	306	78672719	4386
chr15	78668333	78868333	harbor1	chr15	78693668	78693778	LTR/ERVL	2439	+	55	78693723	25390
chr15	78668333	78868333	harbor1	chr15	78694087	78694539	LTR/ERVL	2439	+	226	78694313	25980
chr15	38153030	38353030	harbor1	chr15	38172787	38173230	LTR/ERVL	3418	+	222	38173009	19979
chr15	38153030	38353030	harbor1	chr15	38177375	38177948	LTR/ERVL	1282	+	286	38177661	24631
chr15	38153030	38353030	harbor1	chr15	38203575	38203997	LTR/ERVL	1570	+	211	38203786	50756
chr15	101854275	102054275	harbor1	chr15	101854750	101855111	LTR/ERVL	4559	+	180	101854930	655
chr15	101854275	102054275	harbor1	chr15	101855372	101856039	LTR/ERVL	4559	+	334	101855706	1431
chr15	101854275	102054275	harbor1	chr15	101948690	101949583	LTR/ERVL	756	+	446	101949136	94861
chr15	29332978	29532978	harbor1	chr15	29343178	29343573	LTR/ERVL	2189	+	198	29343376	10398
chr15	29332978	29532978	harbor1	chr15	29343618	29343660	LTR/ERVL	2189	+	21	29343639	10661
chr15	29332978	29532978	harbor1	chr15	29353934	29354438	LTR/ERVL	2576	+	252	29354186	21208
chr15	29332978	29532978	harbor1	chr15	29354883	29355308	LTR/ERVL	889	+	212	29355095	22117
chr15	29332978	29532978	harbor1	chr15	29375575	29375867	LTR/ERVL	1143	+	146	29375721	42743
chr15	29332978	29532978	harbor1	chr15	29378384	29378743	LTR/ERVL	1804	+	180	29378564	45586
chr15	69999084	70199084	harbor1	chr15	70003072	70003184	LTR/ERVL	430	+	56	70003128	4044
chr15	101861669	102061669	harbor1	chr15	101948690	101949583	LTR/ERVL	756	+	446	101949136	87467
chr15	29332340	29532340	harbor1	chr15	29343178	29343573	LTR/ERVL	2189	+	198	29343376	11036
chr15	29332340	29532340	harbor1	chr15	29343618	29343660	LTR/ERVL	2189	+	21	29343639	11299
chr15	29332340	29532340	harbor1	chr15	29353934	29354438	LTR/ERVL	2576	+	252	29354186	21846
chr15	29332340	29532340	harbor1	chr15	29354883	29355308	LTR/ERVL	889	+	212	29355095	22755
chr15	29332340	29532340	harbor1	chr15	29375575	29375867	LTR/ERVL	1143	+	146	29375721	43381
chr15	29332340	29532340	harbor1	chr15	29378384	29378743	LTR/ERVL	1804	+	180	29378564	46224
chr15	19973464	20173464	harbor1	chr15	19977335	19977490	LTR/ERVL	1121	+	78	19977413	3949
chr15	19973464	20173464	harbor1	chr15	19977492	19977822	LTR/ERVL	2214	+	165	19977657	4193
chr15	19973464	20173464	harbor1	chr15	19977870	19977917	LTR/ERVL	2214	+	24	19977894	4430
chr15	19973464	20173464	harbor1	chr15	19994670	19995049	LTR/ERVL	976	+	190	19994860	21396
chr15	19973464	20173464	harbor1	chr15	19995101	19995325	LTR/ERVL	633	+	112	19995213	21749
chr15	19973464	20173464	harbor1	chr15	20041343	20042724	LTR/ERVL	10232	+	690	20042033	68569
chr15	19973464	20173464	harbor1	chr15	20042725	20043131	LTR/ERVL	3016	+	203	20042928	69464
chr15	19973464	20173464	harbor1	chr15	20068626	20068881	LTR/ERVL	1075	+	128	20068754	95290
chr15	41406104	41606104	harbor1	chr15	41412411	41412934	LTR/ERVL	1637	+	262	41412673	6569
chr15	22880593	23080593	harbor1	chr15	22887087	22887244	LTR/ERVL	530	+	78	22887165	6572
chr15	22880593	23080593	harbor1	chr15	22895535	22896166	LTR/ERVL	713	+	316	22895851	15258
chr15	22880593	23080593	harbor1	chr15	22907363	22907816	LTR/ERVL	556	+	226	22907589	26996
chr15	22880593	23080593	harbor1	chr15	22922034	22922614	LTR/ERVL	1661	+	290	22922324	41731
chr15	22880593	23080593	harbor1	chr15	22968201	22968608	LTR/ERVL	2348	+	204	22968405	87812
chr15	29026774	29226774	harbor1	chr15	29032179	29032570	LTR/ERVL	2110	+	196	29032375	5601
chr15	63405330	63605330	harbor1	chr15	63419809	63420185	LTR/ERVL	915	+	188	63419997	14667
chr15	63405330	63605330	harbor1	chr15	63420639	63420736	LTR/ERVL	915	+	48	63420687	15357
chr15	63405330	63605330	harbor1	chr15	63427678	63428091	LTR/ERVL	1226	+	206	63427884	22554
chr15	63405330	63605330	harbor1	chr15	63460442	63460629	LTR/ERVL	484	+	94	63460536	55206
chr15	63405330	63605330	harbor1	chr15	63460690	63460806	LTR/ERVL	415	+	58	63460748	55418
chr15	29332920	29532920	harbor1	chr15	29343178	29343573	LTR/ERVL	2189	+	198	29343376	10456
chr15	29332920	29532920	harbor1	chr15	29343618	29343660	LTR/ERVL	2189	+	21	29343639	10719
chr15	29332920	29532920	harbor1	chr15	29353934	29354438	LTR/ERVL	2576	+	252	29354186	21266
chr15	29332920	29532920	harbor1	chr15	29354883	29355308	LTR/ERVL	889	+	212	29355095	22175
chr15	29332920	29532920	harbor1	chr15	29375575	29375867	LTR/ERVL	1143	+	146	29375721	42801
chr15	29332920	29532920	harbor1	chr15	29378384	29378743	LTR/ERVL	1804	+	180	29378564	45644
chr15	68960308	69160308	harbor1	chr15	68984119	68984156	LTR/ERVL	1228	+	18	68984137	23829
chr15	68960308	69160308	harbor1	chr15	68984655	68984864	LTR/ERVL	1228	+	104	68984759	24451
chr15	68960308	69160308	harbor1	chr15	68990456	68990923	LTR/ERVL	2274	+	234	68990690	30382
chr15	69999137	70199137	harbor1	chr15	70003072	70003184	LTR/ERVL	430	+	56	70003128	3991
chr15	100113871	100313871	harbor1	chr15	100122137	100122292	LTR/ERVL	696	+	78	100122215	8344
chr15	100113871	100313871	harbor1	chr15	100134268	100134364	LTR/ERVL	424	+	48	100134316	20445
chr15	79822730	80022730	harbor1	chr15	79868461	79868861	LTR/ERVL	1413	+	200	79868661	45931
chr15	79822730	80022730	harbor1	chr15	79822688	79823244	LTR/ERVL	1907	+	278	79822966	236
chr15	74702668	74902668	harbor1	chr15	74715217	74715625	LTR/ERVL	2182	+	204	74715421	12753
chr15	29169385	29369385	harbor1	chr15	29188112	29188245	LTR/ERVL	3440	+	66	29188178	18793
chr15	29169385	29369385	harbor1	chr15	29188616	29189372	LTR/ERVL	3440	+	378	29188994	19609
chr15	29169385	29369385	harbor1	chr15	29193151	29193692	LTR/ERVL	2923	+	270	29193421	24036
chr15	29169385	29369385	harbor1	chr15	29209994	29210364	LTR/ERVL	1931	+	185	29210179	40794
chr15	29169385	29369385	harbor1	chr15	29210707	29210866	LTR/ERVL	1931	+	80	29210787	41402
chr15	29169385	29369385	harbor1	chr15	29215185	29215568	LTR/ERVL	3199	+	192	29215377	45992
chr15	29169385	29369385	harbor1	chr15	29215598	29215637	LTR/ERVL	3199	+	20	29215618	46233
chr15	29169385	29369385	harbor1	chr15	29262159	29263033	LTR/ERVL	5139	+	437	29262596	93211
chr15	73799625	73999625	harbor1	chr15	73830509	73830904	LTR/ERVL	1003	+	198	73830707	31082
chr15	73799625	73999625	harbor1	chr15	73852717	73853131	LTR/ERVL	1651	+	207	73852924	53299
chr15	101623861	101823861	harbor1	chr15	101677104	101677501	LTR/ERVL	2024	+	198	101677302	53441
chr15	101623861	101823861	harbor1	chr15	101691907	101692083	LTR/ERVL	910	+	88	101691995	68134
chr15	101623861	101823861	harbor1	chr15	101692095	101692319	LTR/ERVL	605	+	112	101692207	68346
chr15	101623861	101823861	harbor1	chr15	101692563	101692834	LTR/ERVL	705	+	136	101692699	68838
chr15	101623861	101823861	harbor1	chr15	101709830	101710609	LTR/ERVL	3710	+	390	101710220	86359
chr15	73768197	73968197	harbor1	chr15	73787970	73788242	LTR/ERVL	710	+	136	73788106	19909
chr15	73768197	73968197	harbor1	chr15	73830509	73830904	LTR/ERVL	1003	+	198	73830707	62510
chr15	73768197	73968197	harbor1	chr15	73852717	73853131	LTR/ERVL	1651	+	207	73852924	84727
chr15	73895408	74095408	harbor1	chr15	73901176	73901479	LTR/ERVL	581	+	152	73901328	5920
chr15	73895408	74095408	harbor1	chr15	73903169	73903628	LTR/ERVL	1031	+	230	73903399	7991
chr15	73895408	74095408	harbor1	chr15	73914300	73914682	LTR/ERVL	962	+	191	73914491	19083
chr15	73895408	74095408	harbor1	chr15	73914978	73915068	LTR/ERVL	962	+	45	73915023	19615
chr15	73895408	74095408	harbor1	chr15	73975380	73975561	LTR/ERVL	2779	+	90	73975470	80062
chr15	73895408	74095408	harbor1	chr15	73975856	73976577	LTR/ERVL	2779	+	360	73976216	80808
chr15	77542617	77742617	harbor1	chr15	77584160	77584629	LTR/ERVL	1477	+	234	77584394	41777
chr16	4016559	4216559	harbor1	chr16	4072260	4072613	LTR/ERVL	1546	+	176	4072436	55877
chr16	88717991	88917991	harbor1	chr16	88755245	88755691	LTR/ERVL	1437	+	223	88755468	37477
chr16	88717991	88917991	harbor1	chr16	88766100	88766425	LTR/ERVL	681	+	162	88766262	48271
chr16	688340	888340	harbor1	chr16	735073	735423	LTR/ERVL	814	+	175	735248	46908
chr16	688340	888340	harbor1	chr16	735416	735901	LTR/ERVL	1401	+	242	735658	47318
chr16	688340	888340	harbor1	chr16	760974	761306	LTR/ERVL	802	+	166	761140	72800
chr16	28503971	28703971	harbor1	chr16	28557364	28557867	LTR/ERVL	2622	+	252	28557616	53645
chr16	28503971	28703971	harbor1	chr16	28574909	28575224	LTR/ERVL	1600	+	158	28575067	71096
chr16	686536	886536	harbor1	chr16	735073	735423	LTR/ERVL	814	+	175	735248	48712
chr16	686536	886536	harbor1	chr16	735416	735901	LTR/ERVL	1401	+	242	735658	49122
chr16	686536	886536	harbor1	chr16	760974	761306	LTR/ERVL	802	+	166	761140	74604
chr16	53030875	53230875	harbor1	chr16	53079448	53080213	LTR/ERVL	2754	+	382	53079830	48955
chr16	4084076	4284076	harbor1	chr16	4134690	4134935	LTR/ERVL	1839	+	122	4134812	50736
chr16	4084076	4284076	harbor1	chr16	4135246	4135336	LTR/ERVL	1839	+	45	4135291	51215
chr16	700640	900640	harbor1	chr16	735073	735423	LTR/ERVL	814	+	175	735248	34608
chr16	700640	900640	harbor1	chr16	735416	735901	LTR/ERVL	1401	+	242	735658	35018
chr16	700640	900640	harbor1	chr16	760974	761306	LTR/ERVL	802	+	166	761140	60500
chr16	980068	1180068	harbor1	chr16	1067475	1067768	LTR/ERVL	1121	+	146	1067621	87553
chr16	980068	1180068	harbor1	chr16	1067860	1068025	LTR/ERVL	588	+	82	1067942	87874
chr16	4016535	4216535	harbor1	chr16	4072260	4072613	LTR/ERVL	1546	+	176	4072436	55901
chr16	56533856	56733856	harbor1	chr16	56569217	56569578	LTR/ERVL	1174	+	180	56569397	35541
chr16	1892531	2092531	harbor1	chr16	1904421	1904676	LTR/ERVL	696	+	128	1904549	12018
chr16	1892531	2092531	harbor1	chr16	1936811	1937145	LTR/ERVL	1374	+	167	1936978	44447
chr16	4084117	4284117	harbor1	chr16	4134690	4134935	LTR/ERVL	1839	+	122	4134812	50695
chr16	4084117	4284117	harbor1	chr16	4135246	4135336	LTR/ERVL	1839	+	45	4135291	51174
chr16	870915	1070915	harbor1	chr16	906244	906669	LTR/ERVL	2499	+	212	906456	35541
chr16	1892189	2092189	harbor1	chr16	1904421	1904676	LTR/ERVL	696	+	128	1904549	12360
chr16	1892189	2092189	harbor1	chr16	1936811	1937145	LTR/ERVL	1374	+	167	1936978	44789
chr16	1210306	1410306	harbor1	chr16	1297517	1297646	LTR/ERVL	614	+	64	1297581	87275
chr16	700514	900514	harbor1	chr16	735073	735423	LTR/ERVL	814	+	175	735248	34734
chr16	700514	900514	harbor1	chr16	735416	735901	LTR/ERVL	1401	+	242	735658	35144
chr16	700514	900514	harbor1	chr16	760974	761306	LTR/ERVL	802	+	166	761140	60626
chr16	699537	899537	harbor1	chr16	735073	735423	LTR/ERVL	814	+	175	735248	35711
chr16	699537	899537	harbor1	chr16	735416	735901	LTR/ERVL	1401	+	242	735658	36121
chr16	699537	899537	harbor1	chr16	760974	761306	LTR/ERVL	802	+	166	761140	61603
chr16	700506	900506	harbor1	chr16	735073	735423	LTR/ERVL	814	+	175	735248	34742
chr16	700506	900506	harbor1	chr16	735416	735901	LTR/ERVL	1401	+	242	735658	35152
chr16	700506	900506	harbor1	chr16	760974	761306	LTR/ERVL	802	+	166	761140	60634
chr16	57418274	57618274	harbor1	chr16	57419498	57419912	LTR/ERVL	1081	+	207	57419705	1431
chr16	700537	900537	harbor1	chr16	735073	735423	LTR/ERVL	814	+	175	735248	34711
chr16	700537	900537	harbor1	chr16	735416	735901	LTR/ERVL	1401	+	242	735658	35121
chr16	700537	900537	harbor1	chr16	760974	761306	LTR/ERVL	802	+	166	761140	60603
chr16	47349128	47549128	harbor1	chr16	47378937	47379349	LTR/ERVL	1613	+	206	47379143	30015
chr16	47349128	47549128	harbor1	chr16	47379357	47379405	LTR/ERVL	1670	+	24	47379381	30253
chr16	47349128	47549128	harbor1	chr16	47379705	47380694	LTR/ERVL	1670	+	494	47380199	31071
chr16	47349128	47549128	harbor1	chr16	47387382	47387707	LTR/ERVL	1435	+	162	47387544	38416
chr16	89608858	89808858	harbor1	chr16	89676934	89677316	LTR/ERVL	1321	+	191	89677125	68267
chr16	89608858	89808858	harbor1	chr16	89677627	89677660	LTR/ERVL	1321	+	16	89677643	68785
chr16	1908240	2108240	harbor1	chr16	1936811	1937145	LTR/ERVL	1374	+	167	1936978	28738
chr16	700633	900633	harbor1	chr16	735073	735423	LTR/ERVL	814	+	175	735248	34615
chr16	700633	900633	harbor1	chr16	735416	735901	LTR/ERVL	1401	+	242	735658	35025
chr16	700633	900633	harbor1	chr16	760974	761306	LTR/ERVL	802	+	166	761140	60507
chr16	4016523	4216523	harbor1	chr16	4072260	4072613	LTR/ERVL	1546	+	176	4072436	55913
chr16	2869886	3069886	harbor1	chr16	2942645	2942720	LTR/ERVL	1819	+	38	2942683	72797
chr16	2869886	3069886	harbor1	chr16	2943001	2943487	LTR/ERVL	1819	+	243	2943244	73358
chr16	700659	900659	harbor1	chr16	735073	735423	LTR/ERVL	814	+	175	735248	34589
chr16	700659	900659	harbor1	chr16	735416	735901	LTR/ERVL	1401	+	242	735658	34999
chr16	700659	900659	harbor1	chr16	760974	761306	LTR/ERVL	802	+	166	761140	60481
chr16	56464967	56664967	harbor1	chr16	56479592	56480032	LTR/ERVL	876	+	220	56479812	14845
chr16	56464967	56664967	harbor1	chr16	56511508	56511755	LTR/ERVL	1406	+	124	56511632	46665
chr16	56464967	56664967	harbor1	chr16	56526691	56526988	LTR/ERVL	879	+	148	56526839	61872
chr16	56464967	56664967	harbor1	chr16	56527539	56527593	LTR/ERVL	879	+	27	56527566	62599
chr16	4081966	4281966	harbor1	chr16	4134690	4134935	LTR/ERVL	1839	+	122	4134812	52846
chr16	4081966	4281966	harbor1	chr16	4135246	4135336	LTR/ERVL	1839	+	45	4135291	53325
chr16	31017885	31217885	harbor1	chr16	31100362	31100712	LTR/ERVL	2556	+	175	31100537	82652
chr16	31017885	31217885	harbor1	chr16	31101019	31101264	LTR/ERVL	2556	+	122	31101141	83256
chr16	2863130	3063130	harbor1	chr16	2942645	2942720	LTR/ERVL	1819	+	38	2942683	79553
chr16	2863130	3063130	harbor1	chr16	2943001	2943487	LTR/ERVL	1819	+	243	2943244	80114
chr16	4084087	4284087	harbor1	chr16	4134690	4134935	LTR/ERVL	1839	+	122	4134812	50725
chr16	4084087	4284087	harbor1	chr16	4135246	4135336	LTR/ERVL	1839	+	45	4135291	51204
chr16	56535691	56735691	harbor1	chr16	56569217	56569578	LTR/ERVL	1174	+	180	56569397	33706
chr16	30850099	31050099	harbor1	chr16	30858178	30858643	LTR/ERVL	1492	+	232	30858410	8311
chr16	1892565	2092565	harbor1	chr16	1904421	1904676	LTR/ERVL	696	+	128	1904549	11984
chr16	1892565	2092565	harbor1	chr16	1936811	1937145	LTR/ERVL	1374	+	167	1936978	44413
chr16	698263	898263	harbor1	chr16	735073	735423	LTR/ERVL	814	+	175	735248	36985
chr16	698263	898263	harbor1	chr16	735416	735901	LTR/ERVL	1401	+	242	735658	37395
chr16	698263	898263	harbor1	chr16	760974	761306	LTR/ERVL	802	+	166	761140	62877
chr16	870922	1070922	harbor1	chr16	906244	906669	LTR/ERVL	2499	+	212	906456	35534
chr16	870631	1070631	harbor1	chr16	906244	906669	LTR/ERVL	2499	+	212	906456	35825
chr16	56508557	56708557	harbor1	chr16	56511508	56511755	LTR/ERVL	1406	+	124	56511632	3075
chr16	56508557	56708557	harbor1	chr16	56526691	56526988	LTR/ERVL	879	+	148	56526839	18282
chr16	56508557	56708557	harbor1	chr16	56527539	56527593	LTR/ERVL	879	+	27	56527566	19009
chr16	56508557	56708557	harbor1	chr16	56569217	56569578	LTR/ERVL	1174	+	180	56569397	60840
chr16	1908827	2108827	harbor1	chr16	1936811	1937145	LTR/ERVL	1374	+	167	1936978	28151
chr16	2687551	2887551	harbor1	chr16	2780281	2780399	LTR/ERVL	591	+	59	2780340	92789
chr16	2687551	2887551	harbor1	chr16	2780448	2780868	LTR/ERVL	1987	+	210	2780658	93107
chr16	699137	899137	harbor1	chr16	735073	735423	LTR/ERVL	814	+	175	735248	36111
chr16	699137	899137	harbor1	chr16	735416	735901	LTR/ERVL	1401	+	242	735658	36521
chr16	699137	899137	harbor1	chr16	760974	761306	LTR/ERVL	802	+	166	761140	62003
chr16	2862978	3062978	harbor1	chr16	2942645	2942720	LTR/ERVL	1819	+	38	2942683	79705
chr16	2862978	3062978	harbor1	chr16	2943001	2943487	LTR/ERVL	1819	+	243	2943244	80266
chr16	897415	1097415	harbor1	chr16	906244	906669	LTR/ERVL	2499	+	212	906456	9041
chr16	47360500	47560500	harbor1	chr16	47378937	47379349	LTR/ERVL	1613	+	206	47379143	18643
chr16	47360500	47560500	harbor1	chr16	47379357	47379405	LTR/ERVL	1670	+	24	47379381	18881
chr16	47360500	47560500	harbor1	chr16	47379705	47380694	LTR/ERVL	1670	+	494	47380199	19699
chr16	47360500	47560500	harbor1	chr16	47387382	47387707	LTR/ERVL	1435	+	162	47387544	27044
chr16	88757215	88957215	harbor1	chr16	88766100	88766425	LTR/ERVL	681	+	162	88766262	9047
chr16	4084167	4284167	harbor1	chr16	4134690	4134935	LTR/ERVL	1839	+	122	4134812	50645
chr16	4084167	4284167	harbor1	chr16	4135246	4135336	LTR/ERVL	1839	+	45	4135291	51124
chr16	2865150	3065150	harbor1	chr16	2942645	2942720	LTR/ERVL	1819	+	38	2942683	77533
chr16	2865150	3065150	harbor1	chr16	2943001	2943487	LTR/ERVL	1819	+	243	2943244	78094
chr16	700705	900705	harbor1	chr16	735073	735423	LTR/ERVL	814	+	175	735248	34543
chr16	700705	900705	harbor1	chr16	735416	735901	LTR/ERVL	1401	+	242	735658	34953
chr16	700705	900705	harbor1	chr16	760974	761306	LTR/ERVL	802	+	166	761140	60435
chr16	2865127	3065127	harbor1	chr16	2942645	2942720	LTR/ERVL	1819	+	38	2942683	77556
chr16	2865127	3065127	harbor1	chr16	2943001	2943487	LTR/ERVL	1819	+	243	2943244	78117
chr16	75363916	75563916	harbor1	chr16	75390661	75390972	LTR/ERVL	583	+	156	75390817	26901
chr16	75363916	75563916	harbor1	chr16	75393180	75393382	LTR/ERVL	806	+	101	75393281	29365
chr16	67397829	67597829	harbor1	chr16	67487109	67487255	LTR/ERVL	660	+	73	67487182	89353
chr17	81860212	82060212	harbor1	chr17	81944421	81944983	LTR/ERVL	1723	+	281	81944702	84490
chr17	81860212	82060212	harbor1	chr17	81945888	81945999	LTR/ERVL	944	+	56	81945944	85732
chr17	81860212	82060212	harbor1	chr17	81947212	81947354	LTR/ERVL	944	+	71	81947283	87071
chr17	6528464	6728464	harbor1	chr17	6617438	6617821	LTR/ERVL	4661	+	192	6617630	89166
chr17	6528464	6728464	harbor1	chr17	6618129	6618649	LTR/ERVL	4661	+	260	6618389	89925
chr17	79702899	79902899	harbor1	chr17	79769823	79770126	LTR/ERVL	599	+	152	79769975	67076
chr17	80949175	81149175	harbor1	chr17	80987451	80987662	LTR/ERVL	607	+	106	80987557	38382
chr17	79531584	79731584	harbor1	chr17	79575952	79576277	LTR/ERVL	1335	+	162	79576114	44530
chr17	79690081	79890081	harbor1	chr17	79769823	79770126	LTR/ERVL	599	+	152	79769975	79894
chr17	72946166	73146166	harbor1	chr17	72995407	72995851	LTR/ERVL	2578	+	222	72995629	49463
chr17	72946166	73146166	harbor1	chr17	73000753	73001340	LTR/ERVL	1215	+	294	73001047	54881
chr17	33191705	33391705	harbor1	chr17	33207600	33208037	LTR/ERVL	1682	+	218	33207818	16113
chr17	80933433	81133433	harbor1	chr17	80987451	80987662	LTR/ERVL	607	+	106	80987557	54124
chr17	78891091	79091091	harbor1	chr17	78904630	78904861	LTR/ERVL	1959	+	116	78904746	13655
chr17	78891091	79091091	harbor1	chr17	78905159	78905428	LTR/ERVL	1959	+	134	78905293	14202
chr17	79702898	79902898	harbor1	chr17	79769823	79770126	LTR/ERVL	599	+	152	79769975	67077
chr17	76637237	76837237	harbor1	chr17	76690872	76691732	LTR/ERVL	2986	+	430	76691302	54065
chr17	80932396	81132396	harbor1	chr17	80987451	80987662	LTR/ERVL	607	+	106	80987557	55161
chr17	79041540	79241540	harbor1	chr17	79057858	79058268	LTR/ERVL	1554	+	205	79058063	16523
chr17	79041540	79241540	harbor1	chr17	79058277	79058434	LTR/ERVL	1306	+	78	79058355	16815
chr17	79041540	79241540	harbor1	chr17	79058728	79058848	LTR/ERVL	1306	+	60	79058788	17248
chr17	987890	1187890	harbor1	chr17	1058948	1059482	LTR/ERVL	1125	+	267	1059215	71325
chr17	80932315	81132315	harbor1	chr17	80987451	80987662	LTR/ERVL	607	+	106	80987557	55242
chr17	79702913	79902913	harbor1	chr17	79769823	79770126	LTR/ERVL	599	+	152	79769975	67062
chr17	80931238	81131238	harbor1	chr17	80987451	80987662	LTR/ERVL	607	+	106	80987557	56319
chr17	76637265	76837265	harbor1	chr17	76690872	76691732	LTR/ERVL	2986	+	430	76691302	54037
chr17	80934936	81134936	harbor1	chr17	80987451	80987662	LTR/ERVL	607	+	106	80987557	52621
chr17	76637258	76837258	harbor1	chr17	76690872	76691732	LTR/ERVL	2986	+	430	76691302	54044
chr17	80934866	81134866	harbor1	chr17	80987451	80987662	LTR/ERVL	607	+	106	80987557	52691
chr17	80932802	81132802	harbor1	chr17	80987451	80987662	LTR/ERVL	607	+	106	80987557	54755
chr17	49396359	49596359	harbor1	chr17	49449890	49450354	LTR/ERVL	1345	+	232	49450122	53763
chr17	49396359	49596359	harbor1	chr17	49450432	49450487	LTR/ERVL	1345	+	28	49450460	54101
chr17	15158736	15358736	harbor1	chr17	15184873	15184938	LTR/ERVL	640	+	32	15184905	26169
chr17	15158736	15358736	harbor1	chr17	15185469	15185649	LTR/ERVL	640	+	90	15185559	26823
chr17	7335900	7535900	harbor1	chr17	7368211	7368708	LTR/ERVL	1868	+	248	7368459	32559
chr17	7335900	7535900	harbor1	chr17	7369201	7369565	LTR/ERVL	1483	+	182	7369383	33483
chr17	80934111	81134111	harbor1	chr17	80987451	80987662	LTR/ERVL	607	+	106	80987557	53446
chr17	79702928	79902928	harbor1	chr17	79769823	79770126	LTR/ERVL	599	+	152	79769975	67047
chr17	80934868	81134868	harbor1	chr17	80987451	80987662	LTR/ERVL	607	+	106	80987557	52689
chr17	77288251	77488251	harbor1	chr17	77326601	77327046	LTR/ERVL	2250	+	222	77326823	38572
chr17	77288251	77488251	harbor1	chr17	77343044	77343877	LTR/ERVL	3566	+	416	77343460	55209
chr17	33191625	33391625	harbor1	chr17	33207600	33208037	LTR/ERVL	1682	+	218	33207818	16193
chr17	76637275	76837275	harbor1	chr17	76690872	76691732	LTR/ERVL	2986	+	430	76691302	54027
chr17	79702893	79902893	harbor1	chr17	79769823	79770126	LTR/ERVL	599	+	152	79769975	67082
chr17	75083193	75283193	harbor1	chr17	75134204	75134325	LTR/ERVL	877	+	60	75134264	51071
chr17	75083193	75283193	harbor1	chr17	75134622	75134700	LTR/ERVL	877	+	39	75134661	51468
chr17	75083193	75283193	harbor1	chr17	75142909	75143277	LTR/ERVL	1525	+	184	75143093	59900
chr17	75083193	75283193	harbor1	chr17	75144031	75144241	LTR/ERVL	2352	+	105	75144136	60943
chr17	75083193	75283193	harbor1	chr17	75144530	75144918	LTR/ERVL	2352	+	194	75144724	61531
chr17	75105543	75305543	harbor1	chr17	75134204	75134325	LTR/ERVL	877	+	60	75134264	28721
chr17	75105543	75305543	harbor1	chr17	75134622	75134700	LTR/ERVL	877	+	39	75134661	29118
chr17	75105543	75305543	harbor1	chr17	75142909	75143277	LTR/ERVL	1525	+	184	75143093	37550
chr17	75105543	75305543	harbor1	chr17	75144031	75144241	LTR/ERVL	2352	+	105	75144136	38593
chr17	75105543	75305543	harbor1	chr17	75144530	75144918	LTR/ERVL	2352	+	194	75144724	39181
chr17	76636920	76836920	harbor1	chr17	76690872	76691732	LTR/ERVL	2986	+	430	76691302	54382
chr17	74965179	75165179	harbor1	chr17	74985176	74985679	LTR/ERVL	1368	+	252	74985428	20249
chr17	7336816	7536816	harbor1	chr17	7368211	7368708	LTR/ERVL	1868	+	248	7368459	31643
chr17	7336816	7536816	harbor1	chr17	7369201	7369565	LTR/ERVL	1483	+	182	7369383	32567
chr17	76637277	76837277	harbor1	chr17	76690872	76691732	LTR/ERVL	2986	+	430	76691302	54025
chr17	33191684	33391684	harbor1	chr17	33207600	33208037	LTR/ERVL	1682	+	218	33207818	16134
chr17	76298820	76498820	harbor1	chr17	76365934	76366451	LTR/ERVL	928	+	258	76366192	67372
chr17	68035028	68235028	harbor1	chr17	68068518	68069005	LTR/ERVL	2363	+	244	68068762	33734
chr17	9856240	10056240	harbor1	chr17	9900252	9900688	LTR/ERVL	1062	+	218	9900470	44230
chr17	987887	1187887	harbor1	chr17	1058948	1059482	LTR/ERVL	1125	+	267	1059215	71328
chr17	74979148	75179148	harbor1	chr17	74985176	74985679	LTR/ERVL	1368	+	252	74985428	6280
chr17	79282552	79482552	harbor1	chr17	79310883	79311151	LTR/ERVL	1280	+	134	79311017	28465
chr17	79282552	79482552	harbor1	chr17	79311455	79311574	LTR/ERVL	1280	+	60	79311515	28963
chr17	79282552	79482552	harbor1	chr17	79311605	79311655	LTR/ERVL	1280	+	25	79311630	29078
chr17	79282552	79482552	harbor1	chr17	79366793	79367164	LTR/ERVL	771	+	186	79366979	84427
chr17	79689674	79889674	harbor1	chr17	79769823	79770126	LTR/ERVL	599	+	152	79769975	80301
chr17	76140643	76340643	harbor1	chr17	76196622	76197057	LTR/ERVL	1041	+	218	76196840	56197
chr17	76140643	76340643	harbor1	chr17	76197772	76198244	LTR/ERVL	592	+	236	76198008	57365
chr17	76140643	76340643	harbor1	chr17	76213212	76213288	LTR/ERVL	4401	+	38	76213250	72607
chr17	76140643	76340643	harbor1	chr17	76213588	76214368	LTR/ERVL	4401	+	390	76213978	73335
chr17	76140643	76340643	harbor1	chr17	76236031	76236132	LTR/ERVL	650	+	50	76236081	95438
chr17	76637325	76837325	harbor1	chr17	76690872	76691732	LTR/ERVL	2986	+	430	76691302	53977
chr17	81917695	82117695	harbor1	chr17	81944421	81944983	LTR/ERVL	1723	+	281	81944702	27007
chr17	81917695	82117695	harbor1	chr17	81945888	81945999	LTR/ERVL	944	+	56	81945944	28249
chr17	81917695	82117695	harbor1	chr17	81947212	81947354	LTR/ERVL	944	+	71	81947283	29588
chr17	81917695	82117695	harbor1	chr17	81971652	81972050	LTR/ERVL	1788	+	199	81971851	54156
chr17	79701303	79901303	harbor1	chr17	79769823	79770126	LTR/ERVL	599	+	152	79769975	68672
chr17	79702912	79902912	harbor1	chr17	79769823	79770126	LTR/ERVL	599	+	152	79769975	67063
chr17	76637321	76837321	harbor1	chr17	76690872	76691732	LTR/ERVL	2986	+	430	76691302	53981
chr17	31388321	31588321	harbor1	chr17	31473834	31474186	LTR/ERVL	923	+	176	31474010	85689
chr17	82980527	83180527	harbor1	chr17	83018661	83019256	LTR/ERVL	2290	+	298	83018959	38432
chr17	82980527	83180527	harbor1	chr17	83062385	83062815	LTR/ERVL	808	+	215	83062600	82073
chr17	76637272	76837272	harbor1	chr17	76690872	76691732	LTR/ERVL	2986	+	430	76691302	54030
chr17	80934861	81134861	harbor1	chr17	80987451	80987662	LTR/ERVL	607	+	106	80987557	52696
chr17	38740425	38940425	harbor1	chr17	38774129	38774486	LTR/ERVL	1306	+	178	38774307	33882
chr17	38740425	38940425	harbor1	chr17	38774798	38774871	LTR/ERVL	1293	+	36	38774834	34409
chr17	80928150	81128150	harbor1	chr17	80987451	80987662	LTR/ERVL	607	+	106	80987557	59407
chr17	60048761	60248761	harbor1	chr17	60094054	60094145	LTR/ERVL	2743	+	46	60094100	45339
chr17	60048761	60248761	harbor1	chr17	60094447	60094792	LTR/ERVL	2743	+	172	60094619	45858
chr17	79702897	79902897	harbor1	chr17	79769823	79770126	LTR/ERVL	599	+	152	79769975	67078
chr17	7339761	7539761	harbor1	chr17	7368211	7368708	LTR/ERVL	1868	+	248	7368459	28698
chr17	7339761	7539761	harbor1	chr17	7369201	7369565	LTR/ERVL	1483	+	182	7369383	29622
chr17	2201393	2401393	harbor1	chr17	2209942	2210239	LTR/ERVL	856	+	148	2210090	8697
chr17	76637283	76837283	harbor1	chr17	76690872	76691732	LTR/ERVL	2986	+	430	76691302	54019
chr17	79702896	79902896	harbor1	chr17	79769823	79770126	LTR/ERVL	599	+	152	79769975	67079
chr17	80934979	81134979	harbor1	chr17	80987451	80987662	LTR/ERVL	607	+	106	80987557	52578
chr17	79282553	79482553	harbor1	chr17	79310883	79311151	LTR/ERVL	1280	+	134	79311017	28464
chr17	79282553	79482553	harbor1	chr17	79311455	79311574	LTR/ERVL	1280	+	60	79311515	28962
chr17	79282553	79482553	harbor1	chr17	79311605	79311655	LTR/ERVL	1280	+	25	79311630	29077
chr17	79282553	79482553	harbor1	chr17	79366793	79367164	LTR/ERVL	771	+	186	79366979	84426
chr17	76140876	76340876	harbor1	chr17	76196622	76197057	LTR/ERVL	1041	+	218	76196840	55964
chr17	76140876	76340876	harbor1	chr17	76197772	76198244	LTR/ERVL	592	+	236	76198008	57132
chr17	76140876	76340876	harbor1	chr17	76213212	76213288	LTR/ERVL	4401	+	38	76213250	72374
chr17	76140876	76340876	harbor1	chr17	76213588	76214368	LTR/ERVL	4401	+	390	76213978	73102
chr17	76140876	76340876	harbor1	chr17	76236031	76236132	LTR/ERVL	650	+	50	76236081	95205
chr17	78900634	79100634	harbor1	chr17	78904630	78904861	LTR/ERVL	1959	+	116	78904746	4112
chr17	78900634	79100634	harbor1	chr17	78905159	78905428	LTR/ERVL	1959	+	134	78905293	4659
chr17	76637257	76837257	harbor1	chr17	76690872	76691732	LTR/ERVL	2986	+	430	76691302	54045
chr17	76637285	76837285	harbor1	chr17	76690872	76691732	LTR/ERVL	2986	+	430	76691302	54017
chr17	79282788	79482788	harbor1	chr17	79310883	79311151	LTR/ERVL	1280	+	134	79311017	28229
chr17	79282788	79482788	harbor1	chr17	79311455	79311574	LTR/ERVL	1280	+	60	79311515	28727
chr17	79282788	79482788	harbor1	chr17	79311605	79311655	LTR/ERVL	1280	+	25	79311630	28842
chr17	79282788	79482788	harbor1	chr17	79366793	79367164	LTR/ERVL	771	+	186	79366979	84191
chr17	28742741	28942741	harbor1	chr17	28804112	28804337	LTR/ERVL	1039	+	112	28804224	61483
chr17	80934871	81134871	harbor1	chr17	80987451	80987662	LTR/ERVL	607	+	106	80987557	52686
chr17	987852	1187852	harbor1	chr17	1058948	1059482	LTR/ERVL	1125	+	267	1059215	71363
chr17	76637313	76837313	harbor1	chr17	76690872	76691732	LTR/ERVL	2986	+	430	76691302	53989
chr17	78988152	79188152	harbor1	chr17	79057858	79058268	LTR/ERVL	1554	+	205	79058063	69911
chr17	78988152	79188152	harbor1	chr17	79058277	79058434	LTR/ERVL	1306	+	78	79058355	70203
chr17	78988152	79188152	harbor1	chr17	79058728	79058848	LTR/ERVL	1306	+	60	79058788	70636
chr17	62527967	62727967	harbor1	chr17	62599552	62599792	LTR/ERVL	932	+	120	62599672	71705
chr17	79702953	79902953	harbor1	chr17	79769823	79770126	LTR/ERVL	599	+	152	79769975	67022
chr17	79702900	79902900	harbor1	chr17	79769823	79770126	LTR/ERVL	599	+	152	79769975	67075
chr17	80926830	81126830	harbor1	chr17	80987451	80987662	LTR/ERVL	607	+	106	80987557	60727
chr17	80901662	81101662	harbor1	chr17	80987451	80987662	LTR/ERVL	607	+	106	80987557	85895
chr17	76637274	76837274	harbor1	chr17	76690872	76691732	LTR/ERVL	2986	+	430	76691302	54028
chr17	76637097	76837097	harbor1	chr17	76690872	76691732	LTR/ERVL	2986	+	430	76691302	54205
chr17	57767551	57967551	harbor1	chr17	57802266	57802715	LTR/ERVL	1313	+	224	57802490	34939
chr17	57767551	57967551	harbor1	chr17	57817339	57817660	LTR/ERVL	1059	+	160	57817499	49948
chr17	57767551	57967551	harbor1	chr17	57818024	57818390	LTR/ERVL	842	+	183	57818207	50656
chr17	57767551	57967551	harbor1	chr17	57818386	57818753	LTR/ERVL	1156	+	184	57818570	51019
chr17	57767551	57967551	harbor1	chr17	57818849	57819235	LTR/ERVL	1224	+	193	57819042	51491
chr17	76429510	76629510	harbor1	chr17	76462079	76462339	LTR/ERVL	765	+	130	76462209	32699
chr17	81329309	81529309	harbor1	chr17	81375748	81376170	LTR/ERVL	962	+	211	81375959	46650
chr17	80934867	81134867	harbor1	chr17	80987451	80987662	LTR/ERVL	607	+	106	80987557	52690
chr17	76635280	76835280	harbor1	chr17	76690872	76691732	LTR/ERVL	2986	+	430	76691302	56022
chr17	80934894	81134894	harbor1	chr17	80987451	80987662	LTR/ERVL	607	+	106	80987557	52663
chr17	79703308	79903308	harbor1	chr17	79769823	79770126	LTR/ERVL	599	+	152	79769975	66667
chr17	27194779	27394779	harbor1	chr17	27232350	27232756	LTR/ERVL	2392	+	203	27232553	37774
chr17	27194779	27394779	harbor1	chr17	27245528	27245775	LTR/ERVL	738	+	124	27245652	50873
chr17	27194779	27394779	harbor1	chr17	27259404	27259787	LTR/ERVL	1091	+	192	27259596	64817
chr17	27194779	27394779	harbor1	chr17	27273488	27274075	LTR/ERVL	3281	+	294	27273782	79003
chr17	27194779	27394779	harbor1	chr17	27274530	27274804	LTR/ERVL	1276	+	137	27274667	79888
chr17	27194779	27394779	harbor1	chr17	27275232	27275595	LTR/ERVL	946	+	182	27275414	80635
chr17	27194779	27394779	harbor1	chr17	27276652	27277228	LTR/ERVL	1952	+	288	27276940	82161
chr17	80949209	81149209	harbor1	chr17	80987451	80987662	LTR/ERVL	607	+	106	80987557	38348
chr18	26126451	26326451	harbor1	chr18	26128164	26128552	LTR/ERVL	3226	+	194	26128358	1907
chr18	26126451	26326451	harbor1	chr18	26128647	26128681	LTR/ERVL	3226	+	17	26128664	2213
chr18	26126451	26326451	harbor1	chr18	26210262	26210691	LTR/ERVL	2476	+	214	26210476	84025
chr18	26126451	26326451	harbor1	chr18	26210728	26210776	LTR/ERVL	2476	+	24	26210752	84301
chr18	26126451	26326451	harbor1	chr18	26212511	26212656	LTR/ERVL	604	+	72	26212583	86132
chr18	25990886	26190886	harbor1	chr18	26044753	26044976	LTR/ERVL	781	+	112	26044865	53979
chr18	75105235	75305235	harbor1	chr18	75123144	75123562	LTR/ERVL	597	+	209	75123353	18118
chr18	75105235	75305235	harbor1	chr18	75135636	75135846	LTR/ERVL	833	+	105	75135741	30506
chr18	75105235	75305235	harbor1	chr18	75136097	75136235	LTR/ERVL	484	+	69	75136166	30931
chr18	75105235	75305235	harbor1	chr18	75136540	75136562	LTR/ERVL	484	+	11	75136551	31316
chr18	75105235	75305235	harbor1	chr18	75136597	75136625	LTR/ERVL	484	+	14	75136611	31376
chr18	75105235	75305235	harbor1	chr18	75176480	75176954	LTR/ERVL	2032	+	237	75176717	71482
chr18	26126452	26326452	harbor1	chr18	26128164	26128552	LTR/ERVL	3226	+	194	26128358	1906
chr18	26126452	26326452	harbor1	chr18	26128647	26128681	LTR/ERVL	3226	+	17	26128664	2212
chr18	26126452	26326452	harbor1	chr18	26210262	26210691	LTR/ERVL	2476	+	214	26210476	84024
chr18	26126452	26326452	harbor1	chr18	26210728	26210776	LTR/ERVL	2476	+	24	26210752	84300
chr18	26126452	26326452	harbor1	chr18	26212511	26212656	LTR/ERVL	604	+	72	26212583	86131
chr18	26126169	26326169	harbor1	chr18	26128164	26128552	LTR/ERVL	3226	+	194	26128358	2189
chr18	26126169	26326169	harbor1	chr18	26128647	26128681	LTR/ERVL	3226	+	17	26128664	2495
chr18	26126169	26326169	harbor1	chr18	26210262	26210691	LTR/ERVL	2476	+	214	26210476	84307
chr18	26126169	26326169	harbor1	chr18	26210728	26210776	LTR/ERVL	2476	+	24	26210752	84583
chr18	26126169	26326169	harbor1	chr18	26212511	26212656	LTR/ERVL	604	+	72	26212583	86414
chr18	26126503	26326503	harbor1	chr18	26128164	26128552	LTR/ERVL	3226	+	194	26128358	1855
chr18	26126503	26326503	harbor1	chr18	26128647	26128681	LTR/ERVL	3226	+	17	26128664	2161
chr18	26126503	26326503	harbor1	chr18	26210262	26210691	LTR/ERVL	2476	+	214	26210476	83973
chr18	26126503	26326503	harbor1	chr18	26210728	26210776	LTR/ERVL	2476	+	24	26210752	84249
chr18	26126503	26326503	harbor1	chr18	26212511	26212656	LTR/ERVL	604	+	72	26212583	86080
chr18	26126493	26326493	harbor1	chr18	26128164	26128552	LTR/ERVL	3226	+	194	26128358	1865
chr18	26126493	26326493	harbor1	chr18	26128647	26128681	LTR/ERVL	3226	+	17	26128664	2171
chr18	26126493	26326493	harbor1	chr18	26210262	26210691	LTR/ERVL	2476	+	214	26210476	83983
chr18	26126493	26326493	harbor1	chr18	26210728	26210776	LTR/ERVL	2476	+	24	26210752	84259
chr18	26126493	26326493	harbor1	chr18	26212511	26212656	LTR/ERVL	604	+	72	26212583	86090
chr18	26126535	26326535	harbor1	chr18	26128164	26128552	LTR/ERVL	3226	+	194	26128358	1823
chr18	26126535	26326535	harbor1	chr18	26128647	26128681	LTR/ERVL	3226	+	17	26128664	2129
chr18	26126535	26326535	harbor1	chr18	26210262	26210691	LTR/ERVL	2476	+	214	26210476	83941
chr18	26126535	26326535	harbor1	chr18	26210728	26210776	LTR/ERVL	2476	+	24	26210752	84217
chr18	26126535	26326535	harbor1	chr18	26212511	26212656	LTR/ERVL	604	+	72	26212583	86048
chr18	37465339	37665339	harbor1	chr18	37474783	37475253	LTR/ERVL	1680	+	235	37475018	9679
chr18	12847445	13047445	harbor1	chr18	12890554	12890865	LTR/ERVL	1017	+	156	12890710	43265
chr18	12847445	13047445	harbor1	chr18	12898002	12898188	LTR/ERVL	671	+	93	12898095	50650
chr18	12847445	13047445	harbor1	chr18	12899143	12900349	LTR/ERVL	2069	+	603	12899746	52301
chr18	12847445	13047445	harbor1	chr18	12900956	12901381	LTR/ERVL	2069	+	212	12901168	53723
chr18	12847445	13047445	harbor1	chr18	12901689	12901945	LTR/ERVL	2069	+	128	12901817	54372
chr18	12847445	13047445	harbor1	chr18	12902201	12902599	LTR/ERVL	1321	+	199	12902400	54955
chr18	12847445	13047445	harbor1	chr18	12933412	12933821	LTR/ERVL	1134	+	204	12933616	86171
chr18	12847445	13047445	harbor1	chr18	12933982	12934081	LTR/ERVL	1134	+	50	12934032	86587
chr18	12847445	13047445	harbor1	chr18	12942422	12942439	LTR/ERVL	2480	+	8	12942430	94985
chr18	12847445	13047445	harbor1	chr18	12942750	12943221	LTR/ERVL	2480	+	236	12942986	95541
chr18	57346563	57546563	harbor1	chr18	57399701	57401464	LTR/ERVL	4174	+	882	57400583	54020
chr18	57346563	57546563	harbor1	chr18	57401486	57401876	LTR/ERVL	903	+	195	57401681	55118
chr18	37465426	37665426	harbor1	chr18	37474783	37475253	LTR/ERVL	1680	+	235	37475018	9592
chr18	12207922	12407922	harbor1	chr18	12281922	12282061	LTR/ERVL	2916	+	70	12281992	74070
chr18	12207922	12407922	harbor1	chr18	12282355	12283069	LTR/ERVL	2916	+	357	12282712	74790
chr18	12207922	12407922	harbor1	chr18	12283107	12283438	LTR/ERVL	1373	+	166	12283273	75351
chr18	8509901	8709901	harbor1	chr18	8526001	8526379	LTR/ERVL	644	+	189	8526190	16289
chr18	8509901	8709901	harbor1	chr18	8537248	8537812	LTR/ERVL	870	+	282	8537530	27629
chr18	8509901	8709901	harbor1	chr18	8548196	8548592	LTR/ERVL	797	+	198	8548394	38493
chr18	8509901	8709901	harbor1	chr18	8571062	8571446	LTR/ERVL	880	+	192	8571254	61353
chr18	8509901	8709901	harbor1	chr18	8599267	8599832	LTR/ERVL	2005	+	282	8599549	89648
chr18	74356659	74556659	harbor1	chr18	74392196	74392541	LTR/ERVL	1251	+	172	74392368	35709
chr18	74356659	74556659	harbor1	chr18	74420352	74420900	LTR/ERVL	2150	+	274	74420626	63967
chr18	74356659	74556659	harbor1	chr18	74430294	74430700	LTR/ERVL	2405	+	203	74430497	73838
chr18	74356659	74556659	harbor1	chr18	74431307	74431346	LTR/ERVL	2405	+	20	74431327	74668
chr18	65651276	65851276	harbor1	chr18	65651259	65651420	LTR/ERVL	1816	+	80	65651339	63
chr18	65651276	65851276	harbor1	chr18	65651859	65652216	LTR/ERVL	1816	+	178	65652037	761
chr18	65651276	65851276	harbor1	chr18	65652249	65652307	LTR/ERVL	727	+	29	65652278	1002
chr18	26126455	26326455	harbor1	chr18	26128164	26128552	LTR/ERVL	3226	+	194	26128358	1903
chr18	26126455	26326455	harbor1	chr18	26128647	26128681	LTR/ERVL	3226	+	17	26128664	2209
chr18	26126455	26326455	harbor1	chr18	26210262	26210691	LTR/ERVL	2476	+	214	26210476	84021
chr18	26126455	26326455	harbor1	chr18	26210728	26210776	LTR/ERVL	2476	+	24	26210752	84297
chr18	26126455	26326455	harbor1	chr18	26212511	26212656	LTR/ERVL	604	+	72	26212583	86128
chr18	26126495	26326495	harbor1	chr18	26128164	26128552	LTR/ERVL	3226	+	194	26128358	1863
chr18	26126495	26326495	harbor1	chr18	26128647	26128681	LTR/ERVL	3226	+	17	26128664	2169
chr18	26126495	26326495	harbor1	chr18	26210262	26210691	LTR/ERVL	2476	+	214	26210476	83981
chr18	26126495	26326495	harbor1	chr18	26210728	26210776	LTR/ERVL	2476	+	24	26210752	84257
chr18	26126495	26326495	harbor1	chr18	26212511	26212656	LTR/ERVL	604	+	72	26212583	86088
chr18	65651379	65851379	harbor1	chr18	65651259	65651420	LTR/ERVL	1816	+	80	65651339	40
chr18	65651379	65851379	harbor1	chr18	65651859	65652216	LTR/ERVL	1816	+	178	65652037	658
chr18	65651379	65851379	harbor1	chr18	65652249	65652307	LTR/ERVL	727	+	29	65652278	899
chr18	21921090	22121090	harbor1	chr18	21964125	21964333	LTR/ERVL	1863	+	104	21964229	43139
chr18	21921090	22121090	harbor1	chr18	21964456	21964492	LTR/ERVL	1863	+	18	21964474	43384
chr18	21921090	22121090	harbor1	chr18	21964769	21965012	LTR/ERVL	1863	+	122	21964891	43801
chr18	21921090	22121090	harbor1	chr18	22008663	22009256	LTR/ERVL	2008	+	296	22008959	87869
chr18	79580317	79780317	harbor1	chr18	79602802	79602916	LTR/ERVL	529	+	57	79602859	22542
chr18	79580317	79780317	harbor1	chr18	79602931	79603468	LTR/ERVL	1658	+	268	79603199	22882
chr18	26126454	26326454	harbor1	chr18	26128164	26128552	LTR/ERVL	3226	+	194	26128358	1904
chr18	26126454	26326454	harbor1	chr18	26128647	26128681	LTR/ERVL	3226	+	17	26128664	2210
chr18	26126454	26326454	harbor1	chr18	26210262	26210691	LTR/ERVL	2476	+	214	26210476	84022
chr18	26126454	26326454	harbor1	chr18	26210728	26210776	LTR/ERVL	2476	+	24	26210752	84298
chr18	26126454	26326454	harbor1	chr18	26212511	26212656	LTR/ERVL	604	+	72	26212583	86129
chr18	26126376	26326376	harbor1	chr18	26128164	26128552	LTR/ERVL	3226	+	194	26128358	1982
chr18	26126376	26326376	harbor1	chr18	26128647	26128681	LTR/ERVL	3226	+	17	26128664	2288
chr18	26126376	26326376	harbor1	chr18	26210262	26210691	LTR/ERVL	2476	+	214	26210476	84100
chr18	26126376	26326376	harbor1	chr18	26210728	26210776	LTR/ERVL	2476	+	24	26210752	84376
chr18	26126376	26326376	harbor1	chr18	26212511	26212656	LTR/ERVL	604	+	72	26212583	86207
chr18	59165767	59365767	harbor1	chr18	59212065	59212161	LTR/ERVL	1922	+	48	59212113	46346
chr18	59165767	59365767	harbor1	chr18	59211659	59212008	LTR/ERVL	1922	+	174	59211833	46066
chr19	43523586	43723586	harbor1	chr19	43555234	43555551	LTR/ERVL	844	+	158	43555392	31806
chr19	10618495	10818495	harbor1	chr19	10646676	10646776	LTR/ERVL	1468	+	50	10646726	28231
chr19	10618495	10818495	harbor1	chr19	10647048	10647454	LTR/ERVL	1468	+	203	10647251	28756
chr19	10618467	10818467	harbor1	chr19	10646676	10646776	LTR/ERVL	1468	+	50	10646726	28259
chr19	10618467	10818467	harbor1	chr19	10647048	10647454	LTR/ERVL	1468	+	203	10647251	28784
chr19	10618446	10818446	harbor1	chr19	10646676	10646776	LTR/ERVL	1468	+	50	10646726	28280
chr19	10618446	10818446	harbor1	chr19	10647048	10647454	LTR/ERVL	1468	+	203	10647251	28805
chr19	2663306	2863306	harbor1	chr19	2733975	2734322	LTR/ERVL	1498	+	174	2734149	70843
chr19	2663306	2863306	harbor1	chr19	2737707	2737870	LTR/ERVL	1095	+	82	2737789	74483
chr19	2663306	2863306	harbor1	chr19	2761932	2762235	LTR/ERVL	1060	+	152	2762084	98778
chr19	19675467	19875467	harbor1	chr19	19760002	19760027	LTR/ERVL	1863	+	12	19760014	84547
chr19	19675467	19875467	harbor1	chr19	19760320	19760792	LTR/ERVL	1863	+	236	19760556	85089
chr19	19675467	19875467	harbor1	chr19	19761109	19761520	LTR/ERVL	4637	+	206	19761315	85848
chr19	19675467	19875467	harbor1	chr19	19761837	19761960	LTR/ERVL	4637	+	62	19761899	86432
chr19	19675467	19875467	harbor1	chr19	19762256	19762865	LTR/ERVL	4637	+	304	19762560	87093
chr19	19675467	19875467	harbor1	chr19	19763222	19763463	LTR/ERVL	3870	+	120	19763342	87875
chr19	19675467	19875467	harbor1	chr19	19764169	19764818	LTR/ERVL	3870	+	324	19764493	89026
chr19	34913533	35113533	harbor1	chr19	34916300	34916642	LTR/ERVL	1034	+	171	34916471	2938
chr19	58287222	58487222	harbor1	chr19	58365703	58366062	LTR/ERVL	884	+	180	58365883	78661
chr19	36428193	36628193	harbor1	chr19	36478697	36479121	LTR/ERVL	1783	+	212	36478909	50716
chr19	36428193	36628193	harbor1	chr19	36482772	36483187	LTR/ERVL	1313	+	208	36482980	54787
chr19	51494378	51694378	harbor1	chr19	51514294	51515166	LTR/ERVL	2373	+	436	51514730	20352
chr19	51494378	51694378	harbor1	chr19	51516541	51516888	LTR/ERVL	1193	+	174	51516715	22337
chr19	51494378	51694378	harbor1	chr19	51546780	51546918	LTR/ERVL	843	+	69	51546849	52471
chr19	51494378	51694378	harbor1	chr19	51547055	51547721	LTR/ERVL	3336	+	333	51547388	53010
chr19	19676588	19876588	harbor1	chr19	19760002	19760027	LTR/ERVL	1863	+	12	19760014	83426
chr19	19676588	19876588	harbor1	chr19	19760320	19760792	LTR/ERVL	1863	+	236	19760556	83968
chr19	19676588	19876588	harbor1	chr19	19761109	19761520	LTR/ERVL	4637	+	206	19761315	84727
chr19	19676588	19876588	harbor1	chr19	19761837	19761960	LTR/ERVL	4637	+	62	19761899	85311
chr19	19676588	19876588	harbor1	chr19	19762256	19762865	LTR/ERVL	4637	+	304	19762560	85972
chr19	19676588	19876588	harbor1	chr19	19763222	19763463	LTR/ERVL	3870	+	120	19763342	86754
chr19	19676588	19876588	harbor1	chr19	19764169	19764818	LTR/ERVL	3870	+	324	19764493	87905
chr19	19564047	19764047	harbor1	chr19	19602727	19603269	LTR/ERVL	2296	+	271	19602998	38951
chr19	10617933	10817933	harbor1	chr19	10646676	10646776	LTR/ERVL	1468	+	50	10646726	28793
chr19	10617933	10817933	harbor1	chr19	10647048	10647454	LTR/ERVL	1468	+	203	10647251	29318
chr19	10618461	10818461	harbor1	chr19	10646676	10646776	LTR/ERVL	1468	+	50	10646726	28265
chr19	10618461	10818461	harbor1	chr19	10647048	10647454	LTR/ERVL	1468	+	203	10647251	28790
chr19	48773840	48973840	harbor1	chr19	48779910	48780106	LTR/ERVL	2979	+	98	48780008	6168
chr19	48773840	48973840	harbor1	chr19	48780451	48780674	LTR/ERVL	2979	+	112	48780563	6723
chr19	48773840	48973840	harbor1	chr19	48781616	48782099	LTR/ERVL	2979	+	242	48781858	8018
chr19	19675775	19875775	harbor1	chr19	19760002	19760027	LTR/ERVL	1863	+	12	19760014	84239
chr19	19675775	19875775	harbor1	chr19	19760320	19760792	LTR/ERVL	1863	+	236	19760556	84781
chr19	19675775	19875775	harbor1	chr19	19761109	19761520	LTR/ERVL	4637	+	206	19761315	85540
chr19	19675775	19875775	harbor1	chr19	19761837	19761960	LTR/ERVL	4637	+	62	19761899	86124
chr19	19675775	19875775	harbor1	chr19	19762256	19762865	LTR/ERVL	4637	+	304	19762560	86785
chr19	19675775	19875775	harbor1	chr19	19763222	19763463	LTR/ERVL	3870	+	120	19763342	87567
chr19	19675775	19875775	harbor1	chr19	19764169	19764818	LTR/ERVL	3870	+	324	19764493	88718
chr19	19674533	19874533	harbor1	chr19	19760002	19760027	LTR/ERVL	1863	+	12	19760014	85481
chr19	19674533	19874533	harbor1	chr19	19760320	19760792	LTR/ERVL	1863	+	236	19760556	86023
chr19	19674533	19874533	harbor1	chr19	19761109	19761520	LTR/ERVL	4637	+	206	19761315	86782
chr19	19674533	19874533	harbor1	chr19	19761837	19761960	LTR/ERVL	4637	+	62	19761899	87366
chr19	19674533	19874533	harbor1	chr19	19762256	19762865	LTR/ERVL	4637	+	304	19762560	88027
chr19	19674533	19874533	harbor1	chr19	19763222	19763463	LTR/ERVL	3870	+	120	19763342	88809
chr19	19674533	19874533	harbor1	chr19	19764169	19764818	LTR/ERVL	3870	+	324	19764493	89960
chr19	10618491	10818491	harbor1	chr19	10646676	10646776	LTR/ERVL	1468	+	50	10646726	28235
chr19	10618491	10818491	harbor1	chr19	10647048	10647454	LTR/ERVL	1468	+	203	10647251	28760
chr19	10617851	10817851	harbor1	chr19	10646676	10646776	LTR/ERVL	1468	+	50	10646726	28875
chr19	10617851	10817851	harbor1	chr19	10647048	10647454	LTR/ERVL	1468	+	203	10647251	29400
chr19	10579276	10779276	harbor1	chr19	10646676	10646776	LTR/ERVL	1468	+	50	10646726	67450
chr19	10579276	10779276	harbor1	chr19	10647048	10647454	LTR/ERVL	1468	+	203	10647251	67975
chr19	18959517	19159517	harbor1	chr19	18976719	18976788	LTR/ERVL	914	+	34	18976753	17236
chr19	18959517	19159517	harbor1	chr19	18977090	18977265	LTR/ERVL	914	+	88	18977178	17661
chr19	19675501	19875501	harbor1	chr19	19760002	19760027	LTR/ERVL	1863	+	12	19760014	84513
chr19	19675501	19875501	harbor1	chr19	19760320	19760792	LTR/ERVL	1863	+	236	19760556	85055
chr19	19675501	19875501	harbor1	chr19	19761109	19761520	LTR/ERVL	4637	+	206	19761315	85814
chr19	19675501	19875501	harbor1	chr19	19761837	19761960	LTR/ERVL	4637	+	62	19761899	86398
chr19	19675501	19875501	harbor1	chr19	19762256	19762865	LTR/ERVL	4637	+	304	19762560	87059
chr19	19675501	19875501	harbor1	chr19	19763222	19763463	LTR/ERVL	3870	+	120	19763342	87841
chr19	19675501	19875501	harbor1	chr19	19764169	19764818	LTR/ERVL	3870	+	324	19764493	88992
chr19	3858539	4058539	harbor1	chr19	3858959	3859517	LTR/ERVL	2179	+	279	3859238	699
chr19	3858539	4058539	harbor1	chr19	3904353	3904701	LTR/ERVL	1343	+	174	3904527	45988
chr19	19534101	19734101	harbor1	chr19	19602727	19603269	LTR/ERVL	2296	+	271	19602998	68897
chr19	10601630	10801630	harbor1	chr19	10646676	10646776	LTR/ERVL	1468	+	50	10646726	45096
chr19	10601630	10801630	harbor1	chr19	10647048	10647454	LTR/ERVL	1468	+	203	10647251	45621
chr19	19563666	19763666	harbor1	chr19	19602727	19603269	LTR/ERVL	2296	+	271	19602998	39332
chr19	19675859	19875859	harbor1	chr19	19760002	19760027	LTR/ERVL	1863	+	12	19760014	84155
chr19	19675859	19875859	harbor1	chr19	19760320	19760792	LTR/ERVL	1863	+	236	19760556	84697
chr19	19675859	19875859	harbor1	chr19	19761109	19761520	LTR/ERVL	4637	+	206	19761315	85456
chr19	19675859	19875859	harbor1	chr19	19761837	19761960	LTR/ERVL	4637	+	62	19761899	86040
chr19	19675859	19875859	harbor1	chr19	19762256	19762865	LTR/ERVL	4637	+	304	19762560	86701
chr19	19675859	19875859	harbor1	chr19	19763222	19763463	LTR/ERVL	3870	+	120	19763342	87483
chr19	19675859	19875859	harbor1	chr19	19764169	19764818	LTR/ERVL	3870	+	324	19764493	88634
chr19	10618493	10818493	harbor1	chr19	10646676	10646776	LTR/ERVL	1468	+	50	10646726	28233
chr19	10618493	10818493	harbor1	chr19	10647048	10647454	LTR/ERVL	1468	+	203	10647251	28758
chr19	57140991	57340991	harbor1	chr19	57174415	57175154	LTR/ERVL	2628	+	370	57174785	33794
chr19	57140991	57340991	harbor1	chr19	57186252	57186564	LTR/ERVL	1299	+	156	57186408	45417
chr19	57140991	57340991	harbor1	chr19	57200015	57200337	LTR/ERVL	2629	+	161	57200176	59185
chr19	57140991	57340991	harbor1	chr19	57202393	57202595	LTR/ERVL	800	+	101	57202494	61503
chr19	57140991	57340991	harbor1	chr19	57202602	57203105	LTR/ERVL	2774	+	252	57202854	61863
chr19	57140991	57340991	harbor1	chr19	57223924	57223986	LTR/ERVL	795	+	31	57223955	82964
chr19	57140991	57340991	harbor1	chr19	57224292	57224482	LTR/ERVL	795	+	95	57224387	83396
chr19	57140991	57340991	harbor1	chr19	57227979	57228317	LTR/ERVL	844	+	169	57228148	87157
chr19	2877622	3077622	harbor1	chr19	2893746	2894155	LTR/ERVL	1857	+	204	2893950	16328
chr19	2877622	3077622	harbor1	chr19	2921893	2922575	LTR/ERVL	4553	+	341	2922234	44612
chr19	2877622	3077622	harbor1	chr19	2922888	2923529	LTR/ERVL	4553	+	320	2923208	45586
chr19	2877622	3077622	harbor1	chr19	2923533	2924007	LTR/ERVL	1454	+	237	2923770	46148
chr19	19563642	19763642	harbor1	chr19	19602727	19603269	LTR/ERVL	2296	+	271	19602998	39356
chr19	2663252	2863252	harbor1	chr19	2733975	2734322	LTR/ERVL	1498	+	174	2734149	70897
chr19	2663252	2863252	harbor1	chr19	2737707	2737870	LTR/ERVL	1095	+	82	2737789	74537
chr19	2663252	2863252	harbor1	chr19	2761932	2762235	LTR/ERVL	1060	+	152	2762084	98832
chr19	12569674	12769674	harbor1	chr19	12569851	12570396	LTR/ERVL	2088	+	272	12570123	449
chr19	12569674	12769674	harbor1	chr19	12603100	12603224	LTR/ERVL	2621	+	62	12603162	33488
chr19	12569674	12769674	harbor1	chr19	12603804	12604233	LTR/ERVL	2621	+	214	12604018	34344
chr19	12569674	12769674	harbor1	chr19	12604855	12604871	LTR/ERVL	2621	+	8	12604863	35189
chr19	12569674	12769674	harbor1	chr19	12605179	12605203	LTR/ERVL	2621	+	12	12605191	35517
chr19	12569674	12769674	harbor1	chr19	12605498	12605789	LTR/ERVL	2621	+	146	12605644	35970
chr19	316480	516480	harbor1	chr19	348520	348786	LTR/ERVL	735	+	133	348653	32173
chr19	16976180	17176180	harbor1	chr19	16990941	16991465	LTR/ERVL	890	+	262	16991203	15023
chr19	16976180	17176180	harbor1	chr19	17028903	17029128	LTR/ERVL	1826	+	112	17029015	52835
chr19	16976180	17176180	harbor1	chr19	17029438	17029667	LTR/ERVL	1826	+	114	17029552	53372
chr19	16976180	17176180	harbor1	chr19	17048727	17048899	LTR/ERVL	713	+	86	17048813	72633
chr19	16976180	17176180	harbor1	chr19	17063550	17064039	LTR/ERVL	2044	+	244	17063794	87614
chr19	16976180	17176180	harbor1	chr19	17065371	17065548	LTR/ERVL	1300	+	88	17065459	89279
chr19	16976180	17176180	harbor1	chr19	17065840	17065969	LTR/ERVL	1300	+	64	17065904	89724
chr19	16976180	17176180	harbor1	chr19	17066407	17066722	LTR/ERVL	1738	+	158	17066565	90385
chr19	19563826	19763826	harbor1	chr19	19602727	19603269	LTR/ERVL	2296	+	271	19602998	39172
chr19	8313330	8513330	harbor1	chr19	8329522	8329921	LTR/ERVL	2171	+	200	8329722	16392
chr19	19674783	19874783	harbor1	chr19	19760002	19760027	LTR/ERVL	1863	+	12	19760014	85231
chr19	19674783	19874783	harbor1	chr19	19760320	19760792	LTR/ERVL	1863	+	236	19760556	85773
chr19	19674783	19874783	harbor1	chr19	19761109	19761520	LTR/ERVL	4637	+	206	19761315	86532
chr19	19674783	19874783	harbor1	chr19	19761837	19761960	LTR/ERVL	4637	+	62	19761899	87116
chr19	19674783	19874783	harbor1	chr19	19762256	19762865	LTR/ERVL	4637	+	304	19762560	87777
chr19	19674783	19874783	harbor1	chr19	19763222	19763463	LTR/ERVL	3870	+	120	19763342	88559
chr19	19674783	19874783	harbor1	chr19	19764169	19764818	LTR/ERVL	3870	+	324	19764493	89710
chr19	19675795	19875795	harbor1	chr19	19760002	19760027	LTR/ERVL	1863	+	12	19760014	84219
chr19	19675795	19875795	harbor1	chr19	19760320	19760792	LTR/ERVL	1863	+	236	19760556	84761
chr19	19675795	19875795	harbor1	chr19	19761109	19761520	LTR/ERVL	4637	+	206	19761315	85520
chr19	19675795	19875795	harbor1	chr19	19761837	19761960	LTR/ERVL	4637	+	62	19761899	86104
chr19	19675795	19875795	harbor1	chr19	19762256	19762865	LTR/ERVL	4637	+	304	19762560	86765
chr19	19675795	19875795	harbor1	chr19	19763222	19763463	LTR/ERVL	3870	+	120	19763342	87547
chr19	19675795	19875795	harbor1	chr19	19764169	19764818	LTR/ERVL	3870	+	324	19764493	88698
chr19	57140995	57340995	harbor1	chr19	57174415	57175154	LTR/ERVL	2628	+	370	57174785	33790
chr19	57140995	57340995	harbor1	chr19	57186252	57186564	LTR/ERVL	1299	+	156	57186408	45413
chr19	57140995	57340995	harbor1	chr19	57200015	57200337	LTR/ERVL	2629	+	161	57200176	59181
chr19	57140995	57340995	harbor1	chr19	57202393	57202595	LTR/ERVL	800	+	101	57202494	61499
chr19	57140995	57340995	harbor1	chr19	57202602	57203105	LTR/ERVL	2774	+	252	57202854	61859
chr19	57140995	57340995	harbor1	chr19	57223924	57223986	LTR/ERVL	795	+	31	57223955	82960
chr19	57140995	57340995	harbor1	chr19	57224292	57224482	LTR/ERVL	795	+	95	57224387	83392
chr19	57140995	57340995	harbor1	chr19	57227979	57228317	LTR/ERVL	844	+	169	57228148	87153
chr19	19563766	19763766	harbor1	chr19	19602727	19603269	LTR/ERVL	2296	+	271	19602998	39232
chr19	10618492	10818492	harbor1	chr19	10646676	10646776	LTR/ERVL	1468	+	50	10646726	28234
chr19	10618492	10818492	harbor1	chr19	10647048	10647454	LTR/ERVL	1468	+	203	10647251	28759
chr19	57091928	57291928	harbor1	chr19	57095816	57096156	LTR/ERVL	1452	+	170	57095986	4058
chr19	57091928	57291928	harbor1	chr19	57113208	57113338	LTR/ERVL	930	+	65	57113273	21345
chr19	57091928	57291928	harbor1	chr19	57174415	57175154	LTR/ERVL	2628	+	370	57174785	82857
chr19	57091928	57291928	harbor1	chr19	57186252	57186564	LTR/ERVL	1299	+	156	57186408	94480
chr19	2356877	2556877	harbor1	chr19	2440848	2441326	LTR/ERVL	940	+	239	2441087	84210
chr19	19675992	19875992	harbor1	chr19	19760002	19760027	LTR/ERVL	1863	+	12	19760014	84022
chr19	19675992	19875992	harbor1	chr19	19760320	19760792	LTR/ERVL	1863	+	236	19760556	84564
chr19	19675992	19875992	harbor1	chr19	19761109	19761520	LTR/ERVL	4637	+	206	19761315	85323
chr19	19675992	19875992	harbor1	chr19	19761837	19761960	LTR/ERVL	4637	+	62	19761899	85907
chr19	19675992	19875992	harbor1	chr19	19762256	19762865	LTR/ERVL	4637	+	304	19762560	86568
chr19	19675992	19875992	harbor1	chr19	19763222	19763463	LTR/ERVL	3870	+	120	19763342	87350
chr19	19675992	19875992	harbor1	chr19	19764169	19764818	LTR/ERVL	3870	+	324	19764493	88501
chr19	49667530	49867530	harbor1	chr19	49717516	49717903	LTR/ERVL	1134	+	194	49717710	50180
chr19	49667530	49867530	harbor1	chr19	49718210	49718287	LTR/ERVL	1134	+	38	49718248	50718
chr19	49667530	49867530	harbor1	chr19	49718583	49718671	LTR/ERVL	1134	+	44	49718627	51097
chr19	19674614	19874614	harbor1	chr19	19760002	19760027	LTR/ERVL	1863	+	12	19760014	85400
chr19	19674614	19874614	harbor1	chr19	19760320	19760792	LTR/ERVL	1863	+	236	19760556	85942
chr19	19674614	19874614	harbor1	chr19	19761109	19761520	LTR/ERVL	4637	+	206	19761315	86701
chr19	19674614	19874614	harbor1	chr19	19761837	19761960	LTR/ERVL	4637	+	62	19761899	87285
chr19	19674614	19874614	harbor1	chr19	19762256	19762865	LTR/ERVL	4637	+	304	19762560	87946
chr19	19674614	19874614	harbor1	chr19	19763222	19763463	LTR/ERVL	3870	+	120	19763342	88728
chr19	19674614	19874614	harbor1	chr19	19764169	19764818	LTR/ERVL	3870	+	324	19764493	89879
chr19	48094850	48294850	harbor1	chr19	48104206	48104529	LTR/ERVL	1456	+	162	48104368	9518
chr19	48094850	48294850	harbor1	chr19	48154346	48154662	LTR/ERVL	974	+	158	48154504	59654
chr19	48094850	48294850	harbor1	chr19	48158711	48159066	LTR/ERVL	687	+	178	48158889	64039
chr19	41858678	42058678	harbor1	chr19	41955919	41956506	LTR/ERVL	1603	+	294	41956213	97535
chr19	3885261	4085261	harbor1	chr19	3904353	3904701	LTR/ERVL	1343	+	174	3904527	19266
chr19	19675861	19875861	harbor1	chr19	19760002	19760027	LTR/ERVL	1863	+	12	19760014	84153
chr19	19675861	19875861	harbor1	chr19	19760320	19760792	LTR/ERVL	1863	+	236	19760556	84695
chr19	19675861	19875861	harbor1	chr19	19761109	19761520	LTR/ERVL	4637	+	206	19761315	85454
chr19	19675861	19875861	harbor1	chr19	19761837	19761960	LTR/ERVL	4637	+	62	19761899	86038
chr19	19675861	19875861	harbor1	chr19	19762256	19762865	LTR/ERVL	4637	+	304	19762560	86699
chr19	19675861	19875861	harbor1	chr19	19763222	19763463	LTR/ERVL	3870	+	120	19763342	87481
chr19	19675861	19875861	harbor1	chr19	19764169	19764818	LTR/ERVL	3870	+	324	19764493	88632
chr19	41650420	41850420	harbor1	chr19	41668000	41668169	LTR/ERVL	726	+	84	41668084	17664
chr19	41650420	41850420	harbor1	chr19	41677854	41678190	LTR/ERVL	1086	+	168	41678022	27602
chr19	2356934	2556934	harbor1	chr19	2440848	2441326	LTR/ERVL	940	+	239	2441087	84153
chr19	3885621	4085621	harbor1	chr19	3904353	3904701	LTR/ERVL	1343	+	174	3904527	18906
chr19	44518410	44718410	harbor1	chr19	44519736	44520160	LTR/ERVL	917	+	212	44519948	1538
chr19	11878930	12078930	harbor1	chr19	11916909	11917258	LTR/ERVL	713	+	174	11917083	38153
chr19	11878930	12078930	harbor1	chr19	11958139	11958490	LTR/ERVL	654	+	176	11958315	79385
chr19	19675825	19875825	harbor1	chr19	19760002	19760027	LTR/ERVL	1863	+	12	19760014	84189
chr19	19675825	19875825	harbor1	chr19	19760320	19760792	LTR/ERVL	1863	+	236	19760556	84731
chr19	19675825	19875825	harbor1	chr19	19761109	19761520	LTR/ERVL	4637	+	206	19761315	85490
chr19	19675825	19875825	harbor1	chr19	19761837	19761960	LTR/ERVL	4637	+	62	19761899	86074
chr19	19675825	19875825	harbor1	chr19	19762256	19762865	LTR/ERVL	4637	+	304	19762560	86735
chr19	19675825	19875825	harbor1	chr19	19763222	19763463	LTR/ERVL	3870	+	120	19763342	87517
chr19	19675825	19875825	harbor1	chr19	19764169	19764818	LTR/ERVL	3870	+	324	19764493	88668
chr19	19564075	19764075	harbor1	chr19	19602727	19603269	LTR/ERVL	2296	+	271	19602998	38923
chr19	9575315	9775315	harbor1	chr19	9580560	9580947	LTR/ERVL	903	+	194	9580754	5439
chr19	9575315	9775315	harbor1	chr19	9598075	9598129	LTR/ERVL	2583	+	27	9598102	22787
chr19	9575315	9775315	harbor1	chr19	9598426	9598858	LTR/ERVL	2583	+	216	9598642	23327
chr19	9575315	9775315	harbor1	chr19	9599170	9599225	LTR/ERVL	2583	+	28	9599198	23883
chr19	9575315	9775315	harbor1	chr19	9671526	9671970	LTR/ERVL	973	+	222	9671748	96433
chr19	57140996	57340996	harbor1	chr19	57174415	57175154	LTR/ERVL	2628	+	370	57174785	33789
chr19	57140996	57340996	harbor1	chr19	57186252	57186564	LTR/ERVL	1299	+	156	57186408	45412
chr19	57140996	57340996	harbor1	chr19	57200015	57200337	LTR/ERVL	2629	+	161	57200176	59180
chr19	57140996	57340996	harbor1	chr19	57202393	57202595	LTR/ERVL	800	+	101	57202494	61498
chr19	57140996	57340996	harbor1	chr19	57202602	57203105	LTR/ERVL	2774	+	252	57202854	61858
chr19	57140996	57340996	harbor1	chr19	57223924	57223986	LTR/ERVL	795	+	31	57223955	82959
chr19	57140996	57340996	harbor1	chr19	57224292	57224482	LTR/ERVL	795	+	95	57224387	83391
chr19	57140996	57340996	harbor1	chr19	57227979	57228317	LTR/ERVL	844	+	169	57228148	87152
chr19	18894675	19094675	harbor1	chr19	18976719	18976788	LTR/ERVL	914	+	34	18976753	82078
chr19	18894675	19094675	harbor1	chr19	18977090	18977265	LTR/ERVL	914	+	88	18977178	82503
chr19	19676735	19876735	harbor1	chr19	19760002	19760027	LTR/ERVL	1863	+	12	19760014	83279
chr19	19676735	19876735	harbor1	chr19	19760320	19760792	LTR/ERVL	1863	+	236	19760556	83821
chr19	19676735	19876735	harbor1	chr19	19761109	19761520	LTR/ERVL	4637	+	206	19761315	84580
chr19	19676735	19876735	harbor1	chr19	19761837	19761960	LTR/ERVL	4637	+	62	19761899	85164
chr19	19676735	19876735	harbor1	chr19	19762256	19762865	LTR/ERVL	4637	+	304	19762560	85825
chr19	19676735	19876735	harbor1	chr19	19763222	19763463	LTR/ERVL	3870	+	120	19763342	86607
chr19	19676735	19876735	harbor1	chr19	19764169	19764818	LTR/ERVL	3870	+	324	19764493	87758
chr19	19675790	19875790	harbor1	chr19	19760002	19760027	LTR/ERVL	1863	+	12	19760014	84224
chr19	19675790	19875790	harbor1	chr19	19760320	19760792	LTR/ERVL	1863	+	236	19760556	84766
chr19	19675790	19875790	harbor1	chr19	19761109	19761520	LTR/ERVL	4637	+	206	19761315	85525
chr19	19675790	19875790	harbor1	chr19	19761837	19761960	LTR/ERVL	4637	+	62	19761899	86109
chr19	19675790	19875790	harbor1	chr19	19762256	19762865	LTR/ERVL	4637	+	304	19762560	86770
chr19	19675790	19875790	harbor1	chr19	19763222	19763463	LTR/ERVL	3870	+	120	19763342	87552
chr19	19675790	19875790	harbor1	chr19	19764169	19764818	LTR/ERVL	3870	+	324	19764493	88703
chr19	2104874	2304874	harbor1	chr19	2124097	2124407	LTR/ERVL	729	+	155	2124252	19378
chr19	2104874	2304874	harbor1	chr19	2154586	2154897	LTR/ERVL	815	+	156	2154742	49868
chr19	10618545	10818545	harbor1	chr19	10646676	10646776	LTR/ERVL	1468	+	50	10646726	28181
chr19	10618545	10818545	harbor1	chr19	10647048	10647454	LTR/ERVL	1468	+	203	10647251	28706
chr19	19564037	19764037	harbor1	chr19	19602727	19603269	LTR/ERVL	2296	+	271	19602998	38961
chr19	19557012	19757012	harbor1	chr19	19602727	19603269	LTR/ERVL	2296	+	271	19602998	45986
chr19	57140775	57340775	harbor1	chr19	57174415	57175154	LTR/ERVL	2628	+	370	57174785	34010
chr19	57140775	57340775	harbor1	chr19	57186252	57186564	LTR/ERVL	1299	+	156	57186408	45633
chr19	57140775	57340775	harbor1	chr19	57200015	57200337	LTR/ERVL	2629	+	161	57200176	59401
chr19	57140775	57340775	harbor1	chr19	57202393	57202595	LTR/ERVL	800	+	101	57202494	61719
chr19	57140775	57340775	harbor1	chr19	57202602	57203105	LTR/ERVL	2774	+	252	57202854	62079
chr19	57140775	57340775	harbor1	chr19	57223924	57223986	LTR/ERVL	795	+	31	57223955	83180
chr19	57140775	57340775	harbor1	chr19	57224292	57224482	LTR/ERVL	795	+	95	57224387	83612
chr19	57140775	57340775	harbor1	chr19	57227979	57228317	LTR/ERVL	844	+	169	57228148	87373
chr19	19675998	19875998	harbor1	chr19	19760002	19760027	LTR/ERVL	1863	+	12	19760014	84016
chr19	19675998	19875998	harbor1	chr19	19760320	19760792	LTR/ERVL	1863	+	236	19760556	84558
chr19	19675998	19875998	harbor1	chr19	19761109	19761520	LTR/ERVL	4637	+	206	19761315	85317
chr19	19675998	19875998	harbor1	chr19	19761837	19761960	LTR/ERVL	4637	+	62	19761899	85901
chr19	19675998	19875998	harbor1	chr19	19762256	19762865	LTR/ERVL	4637	+	304	19762560	86562
chr19	19675998	19875998	harbor1	chr19	19763222	19763463	LTR/ERVL	3870	+	120	19763342	87344
chr19	19675998	19875998	harbor1	chr19	19764169	19764818	LTR/ERVL	3870	+	324	19764493	88495
chr19	48119191	48319191	harbor1	chr19	48154346	48154662	LTR/ERVL	974	+	158	48154504	35313
chr19	48119191	48319191	harbor1	chr19	48158711	48159066	LTR/ERVL	687	+	178	48158889	39698
chr19	19563483	19763483	harbor1	chr19	19602727	19603269	LTR/ERVL	2296	+	271	19602998	39515
chr19	19676646	19876646	harbor1	chr19	19760002	19760027	LTR/ERVL	1863	+	12	19760014	83368
chr19	19676646	19876646	harbor1	chr19	19760320	19760792	LTR/ERVL	1863	+	236	19760556	83910
chr19	19676646	19876646	harbor1	chr19	19761109	19761520	LTR/ERVL	4637	+	206	19761315	84669
chr19	19676646	19876646	harbor1	chr19	19761837	19761960	LTR/ERVL	4637	+	62	19761899	85253
chr19	19676646	19876646	harbor1	chr19	19762256	19762865	LTR/ERVL	4637	+	304	19762560	85914
chr19	19676646	19876646	harbor1	chr19	19763222	19763463	LTR/ERVL	3870	+	120	19763342	86696
chr19	19676646	19876646	harbor1	chr19	19764169	19764818	LTR/ERVL	3870	+	324	19764493	87847
chr19	10618552	10818552	harbor1	chr19	10646676	10646776	LTR/ERVL	1468	+	50	10646726	28174
chr19	10618552	10818552	harbor1	chr19	10647048	10647454	LTR/ERVL	1468	+	203	10647251	28699
chr19	19564065	19764065	harbor1	chr19	19602727	19603269	LTR/ERVL	2296	+	271	19602998	38933
chr19	10618444	10818444	harbor1	chr19	10646676	10646776	LTR/ERVL	1468	+	50	10646726	28282
chr19	10618444	10818444	harbor1	chr19	10647048	10647454	LTR/ERVL	1468	+	203	10647251	28807
chr19	19676600	19876600	harbor1	chr19	19760002	19760027	LTR/ERVL	1863	+	12	19760014	83414
chr19	19676600	19876600	harbor1	chr19	19760320	19760792	LTR/ERVL	1863	+	236	19760556	83956
chr19	19676600	19876600	harbor1	chr19	19761109	19761520	LTR/ERVL	4637	+	206	19761315	84715
chr19	19676600	19876600	harbor1	chr19	19761837	19761960	LTR/ERVL	4637	+	62	19761899	85299
chr19	19676600	19876600	harbor1	chr19	19762256	19762865	LTR/ERVL	4637	+	304	19762560	85960
chr19	19676600	19876600	harbor1	chr19	19763222	19763463	LTR/ERVL	3870	+	120	19763342	86742
chr19	19676600	19876600	harbor1	chr19	19764169	19764818	LTR/ERVL	3870	+	324	19764493	87893
chr19	19563446	19763446	harbor1	chr19	19602727	19603269	LTR/ERVL	2296	+	271	19602998	39552
chr19	19676648	19876648	harbor1	chr19	19760002	19760027	LTR/ERVL	1863	+	12	19760014	83366
chr19	19676648	19876648	harbor1	chr19	19760320	19760792	LTR/ERVL	1863	+	236	19760556	83908
chr19	19676648	19876648	harbor1	chr19	19761109	19761520	LTR/ERVL	4637	+	206	19761315	84667
chr19	19676648	19876648	harbor1	chr19	19761837	19761960	LTR/ERVL	4637	+	62	19761899	85251
chr19	19676648	19876648	harbor1	chr19	19762256	19762865	LTR/ERVL	4637	+	304	19762560	85912
chr19	19676648	19876648	harbor1	chr19	19763222	19763463	LTR/ERVL	3870	+	120	19763342	86694
chr19	19676648	19876648	harbor1	chr19	19764169	19764818	LTR/ERVL	3870	+	324	19764493	87845
chr19	39685943	39885943	harbor1	chr19	39770440	39770606	LTR/ERVL	1138	+	83	39770523	84580
chr19	39685943	39885943	harbor1	chr19	39771716	39771985	LTR/ERVL	1138	+	134	39771850	85907
chr19	10617879	10817879	harbor1	chr19	10646676	10646776	LTR/ERVL	1468	+	50	10646726	28847
chr19	10617879	10817879	harbor1	chr19	10647048	10647454	LTR/ERVL	1468	+	203	10647251	29372
chr19	4073246	4273246	harbor1	chr19	4116052	4116244	LTR/ERVL	961	+	96	4116148	42902
chr19	19538104	19738104	harbor1	chr19	19602727	19603269	LTR/ERVL	2296	+	271	19602998	64894
chr19	35165609	35365609	harbor1	chr19	35173816	35174053	LTR/ERVL	776	+	118	35173934	8325
chr19	35165609	35365609	harbor1	chr19	35179191	35179552	LTR/ERVL	2206	+	180	35179371	13762
chr19	35165609	35365609	harbor1	chr19	35179864	35180103	LTR/ERVL	2206	+	120	35179984	14375
chr19	35165609	35365609	harbor1	chr19	35180160	35180210	LTR/ERVL	4651	+	25	35180185	14576
chr19	35165609	35365609	harbor1	chr19	35180521	35181581	LTR/ERVL	4651	+	530	35181051	15442
chr19	35165609	35365609	harbor1	chr19	35181919	35182123	LTR/ERVL	952	+	102	35182021	16412
chr19	35165609	35365609	harbor1	chr19	35185038	35185218	LTR/ERVL	855	+	90	35185128	19519
chr19	35165609	35365609	harbor1	chr19	35196745	35196781	LTR/ERVL	3679	+	18	35196763	31154
chr19	35165609	35365609	harbor1	chr19	35197446	35198141	LTR/ERVL	3679	+	348	35197794	32185
chr19	35165609	35365609	harbor1	chr19	35198332	35198426	LTR/ERVL	1416	+	47	35198379	32770
chr19	35165609	35365609	harbor1	chr19	35198739	35199045	LTR/ERVL	1416	+	153	35198892	33283
chr19	10618447	10818447	harbor1	chr19	10646676	10646776	LTR/ERVL	1468	+	50	10646726	28279
chr19	10618447	10818447	harbor1	chr19	10647048	10647454	LTR/ERVL	1468	+	203	10647251	28804
chr19	19676660	19876660	harbor1	chr19	19760002	19760027	LTR/ERVL	1863	+	12	19760014	83354
chr19	19676660	19876660	harbor1	chr19	19760320	19760792	LTR/ERVL	1863	+	236	19760556	83896
chr19	19676660	19876660	harbor1	chr19	19761109	19761520	LTR/ERVL	4637	+	206	19761315	84655
chr19	19676660	19876660	harbor1	chr19	19761837	19761960	LTR/ERVL	4637	+	62	19761899	85239
chr19	19676660	19876660	harbor1	chr19	19762256	19762865	LTR/ERVL	4637	+	304	19762560	85900
chr19	19676660	19876660	harbor1	chr19	19763222	19763463	LTR/ERVL	3870	+	120	19763342	86682
chr19	19676660	19876660	harbor1	chr19	19764169	19764818	LTR/ERVL	3870	+	324	19764493	87833
chr19	10618466	10818466	harbor1	chr19	10646676	10646776	LTR/ERVL	1468	+	50	10646726	28260
chr19	10618466	10818466	harbor1	chr19	10647048	10647454	LTR/ERVL	1468	+	203	10647251	28785
chr19	19676559	19876559	harbor1	chr19	19760002	19760027	LTR/ERVL	1863	+	12	19760014	83455
chr19	19676559	19876559	harbor1	chr19	19760320	19760792	LTR/ERVL	1863	+	236	19760556	83997
chr19	19676559	19876559	harbor1	chr19	19761109	19761520	LTR/ERVL	4637	+	206	19761315	84756
chr19	19676559	19876559	harbor1	chr19	19761837	19761960	LTR/ERVL	4637	+	62	19761899	85340
chr19	19676559	19876559	harbor1	chr19	19762256	19762865	LTR/ERVL	4637	+	304	19762560	86001
chr19	19676559	19876559	harbor1	chr19	19763222	19763463	LTR/ERVL	3870	+	120	19763342	86783
chr19	19676559	19876559	harbor1	chr19	19764169	19764818	LTR/ERVL	3870	+	324	19764493	87934
chr19	19564071	19764071	harbor1	chr19	19602727	19603269	LTR/ERVL	2296	+	271	19602998	38927
chr19	12567170	12767170	harbor1	chr19	12569851	12570396	LTR/ERVL	2088	+	272	12570123	2953
chr19	12567170	12767170	harbor1	chr19	12603100	12603224	LTR/ERVL	2621	+	62	12603162	35992
chr19	12567170	12767170	harbor1	chr19	12603804	12604233	LTR/ERVL	2621	+	214	12604018	36848
chr19	12567170	12767170	harbor1	chr19	12604855	12604871	LTR/ERVL	2621	+	8	12604863	37693
chr19	12567170	12767170	harbor1	chr19	12605179	12605203	LTR/ERVL	2621	+	12	12605191	38021
chr19	12567170	12767170	harbor1	chr19	12605498	12605789	LTR/ERVL	2621	+	146	12605644	38474
chr19	19675701	19875701	harbor1	chr19	19760002	19760027	LTR/ERVL	1863	+	12	19760014	84313
chr19	19675701	19875701	harbor1	chr19	19760320	19760792	LTR/ERVL	1863	+	236	19760556	84855
chr19	19675701	19875701	harbor1	chr19	19761109	19761520	LTR/ERVL	4637	+	206	19761315	85614
chr19	19675701	19875701	harbor1	chr19	19761837	19761960	LTR/ERVL	4637	+	62	19761899	86198
chr19	19675701	19875701	harbor1	chr19	19762256	19762865	LTR/ERVL	4637	+	304	19762560	86859
chr19	19675701	19875701	harbor1	chr19	19763222	19763463	LTR/ERVL	3870	+	120	19763342	87641
chr19	19675701	19875701	harbor1	chr19	19764169	19764818	LTR/ERVL	3870	+	324	19764493	88792
chr19	13953723	14153723	harbor1	chr19	14048480	14048917	LTR/ERVL	1464	+	218	14048698	94975
chr19	56018198	56218198	harbor1	chr19	56071522	56071948	LTR/ERVL	1621	+	213	56071735	53537
chr19	10618454	10818454	harbor1	chr19	10646676	10646776	LTR/ERVL	1468	+	50	10646726	28272
chr19	10618454	10818454	harbor1	chr19	10647048	10647454	LTR/ERVL	1468	+	203	10647251	28797
chr19	208557	408557	harbor1	chr19	217941	218198	LTR/ERVL	3577	+	128	218069	9512
chr19	208557	408557	harbor1	chr19	218494	218803	LTR/ERVL	3577	+	154	218648	10091
chr19	208557	408557	harbor1	chr19	219110	219409	LTR/ERVL	3577	+	150	219260	10703
chr19	12569729	12769729	harbor1	chr19	12569851	12570396	LTR/ERVL	2088	+	272	12570123	394
chr19	12569729	12769729	harbor1	chr19	12603100	12603224	LTR/ERVL	2621	+	62	12603162	33433
chr19	12569729	12769729	harbor1	chr19	12603804	12604233	LTR/ERVL	2621	+	214	12604018	34289
chr19	12569729	12769729	harbor1	chr19	12604855	12604871	LTR/ERVL	2621	+	8	12604863	35134
chr19	12569729	12769729	harbor1	chr19	12605179	12605203	LTR/ERVL	2621	+	12	12605191	35462
chr19	12569729	12769729	harbor1	chr19	12605498	12605789	LTR/ERVL	2621	+	146	12605644	35915
chr19	19563974	19763974	harbor1	chr19	19602727	19603269	LTR/ERVL	2296	+	271	19602998	39024
chr19	2355470	2555470	harbor1	chr19	2440848	2441326	LTR/ERVL	940	+	239	2441087	85617
chr19	8313345	8513345	harbor1	chr19	8329522	8329921	LTR/ERVL	2171	+	200	8329722	16377
chr19	50332480	50532480	harbor1	chr19	50339150	50339407	LTR/ERVL	1346	+	128	50339278	6798
chr19	50332480	50532480	harbor1	chr19	50339692	50339826	LTR/ERVL	1346	+	67	50339759	7279
chr19	19676574	19876574	harbor1	chr19	19760002	19760027	LTR/ERVL	1863	+	12	19760014	83440
chr19	19676574	19876574	harbor1	chr19	19760320	19760792	LTR/ERVL	1863	+	236	19760556	83982
chr19	19676574	19876574	harbor1	chr19	19761109	19761520	LTR/ERVL	4637	+	206	19761315	84741
chr19	19676574	19876574	harbor1	chr19	19761837	19761960	LTR/ERVL	4637	+	62	19761899	85325
chr19	19676574	19876574	harbor1	chr19	19762256	19762865	LTR/ERVL	4637	+	304	19762560	85986
chr19	19676574	19876574	harbor1	chr19	19763222	19763463	LTR/ERVL	3870	+	120	19763342	86768
chr19	19676574	19876574	harbor1	chr19	19764169	19764818	LTR/ERVL	3870	+	324	19764493	87919
chr19	48070297	48270297	harbor1	chr19	48070193	48070433	LTR/ERVL	1573	+	120	48070313	16
chr19	48070297	48270297	harbor1	chr19	48070909	48071013	LTR/ERVL	1573	+	52	48070961	664
chr19	48070297	48270297	harbor1	chr19	48104206	48104529	LTR/ERVL	1456	+	162	48104368	34071
chr19	48070297	48270297	harbor1	chr19	48154346	48154662	LTR/ERVL	974	+	158	48154504	84207
chr19	48070297	48270297	harbor1	chr19	48158711	48159066	LTR/ERVL	687	+	178	48158889	88592
chr19	57091913	57291913	harbor1	chr19	57095816	57096156	LTR/ERVL	1452	+	170	57095986	4073
chr19	57091913	57291913	harbor1	chr19	57113208	57113338	LTR/ERVL	930	+	65	57113273	21360
chr19	57091913	57291913	harbor1	chr19	57174415	57175154	LTR/ERVL	2628	+	370	57174785	82872
chr19	57091913	57291913	harbor1	chr19	57186252	57186564	LTR/ERVL	1299	+	156	57186408	94495
chr19	2116463	2316463	harbor1	chr19	2124097	2124407	LTR/ERVL	729	+	155	2124252	7789
chr19	2116463	2316463	harbor1	chr19	2154586	2154897	LTR/ERVL	815	+	156	2154742	38279
chr19	19563863	19763863	harbor1	chr19	19602727	19603269	LTR/ERVL	2296	+	271	19602998	39135
chr19	19676811	19876811	harbor1	chr19	19760002	19760027	LTR/ERVL	1863	+	12	19760014	83203
chr19	19676811	19876811	harbor1	chr19	19760320	19760792	LTR/ERVL	1863	+	236	19760556	83745
chr19	19676811	19876811	harbor1	chr19	19761109	19761520	LTR/ERVL	4637	+	206	19761315	84504
chr19	19676811	19876811	harbor1	chr19	19761837	19761960	LTR/ERVL	4637	+	62	19761899	85088
chr19	19676811	19876811	harbor1	chr19	19762256	19762865	LTR/ERVL	4637	+	304	19762560	85749
chr19	19676811	19876811	harbor1	chr19	19763222	19763463	LTR/ERVL	3870	+	120	19763342	86531
chr19	19676811	19876811	harbor1	chr19	19764169	19764818	LTR/ERVL	3870	+	324	19764493	87682
chr19	2130409	2330409	harbor1	chr19	2154586	2154897	LTR/ERVL	815	+	156	2154742	24333
chr19	10618479	10818479	harbor1	chr19	10646676	10646776	LTR/ERVL	1468	+	50	10646726	28247
chr19	10618479	10818479	harbor1	chr19	10647048	10647454	LTR/ERVL	1468	+	203	10647251	28772
chr19	208595	408595	harbor1	chr19	217941	218198	LTR/ERVL	3577	+	128	218069	9474
chr19	208595	408595	harbor1	chr19	218494	218803	LTR/ERVL	3577	+	154	218648	10053
chr19	208595	408595	harbor1	chr19	219110	219409	LTR/ERVL	3577	+	150	219260	10665
chr19	32574738	32774738	harbor1	chr19	32575832	32576318	LTR/ERVL	1948	+	243	32576075	1337
chr19	32574738	32774738	harbor1	chr19	32623166	32623548	LTR/ERVL	2372	+	191	32623357	48619
chr19	32574738	32774738	harbor1	chr19	32623851	32624042	LTR/ERVL	2372	+	96	32623947	49209
chr19	19675592	19875592	harbor1	chr19	19760002	19760027	LTR/ERVL	1863	+	12	19760014	84422
chr19	19675592	19875592	harbor1	chr19	19760320	19760792	LTR/ERVL	1863	+	236	19760556	84964
chr19	19675592	19875592	harbor1	chr19	19761109	19761520	LTR/ERVL	4637	+	206	19761315	85723
chr19	19675592	19875592	harbor1	chr19	19761837	19761960	LTR/ERVL	4637	+	62	19761899	86307
chr19	19675592	19875592	harbor1	chr19	19762256	19762865	LTR/ERVL	4637	+	304	19762560	86968
chr19	19675592	19875592	harbor1	chr19	19763222	19763463	LTR/ERVL	3870	+	120	19763342	87750
chr19	19675592	19875592	harbor1	chr19	19764169	19764818	LTR/ERVL	3870	+	324	19764493	88901
chr19	3885637	4085637	harbor1	chr19	3904353	3904701	LTR/ERVL	1343	+	174	3904527	18890
chr19	14879556	15079556	harbor1	chr19	14949180	14949317	LTR/ERVL	906	+	68	14949248	69692
chr19	14879556	15079556	harbor1	chr19	14969225	14969692	LTR/ERVL	1421	+	234	14969459	89903
chr19	19675857	19875857	harbor1	chr19	19760002	19760027	LTR/ERVL	1863	+	12	19760014	84157
chr19	19675857	19875857	harbor1	chr19	19760320	19760792	LTR/ERVL	1863	+	236	19760556	84699
chr19	19675857	19875857	harbor1	chr19	19761109	19761520	LTR/ERVL	4637	+	206	19761315	85458
chr19	19675857	19875857	harbor1	chr19	19761837	19761960	LTR/ERVL	4637	+	62	19761899	86042
chr19	19675857	19875857	harbor1	chr19	19762256	19762865	LTR/ERVL	4637	+	304	19762560	86703
chr19	19675857	19875857	harbor1	chr19	19763222	19763463	LTR/ERVL	3870	+	120	19763342	87485
chr19	19675857	19875857	harbor1	chr19	19764169	19764818	LTR/ERVL	3870	+	324	19764493	88636
chr19	11667295	11867295	harbor1	chr19	11729495	11729822	LTR/ERVL	1482	+	164	11729659	62364
chr19	11667295	11867295	harbor1	chr19	11760263	11760506	LTR/ERVL	700	+	122	11760385	93090
chr19	19675613	19875613	harbor1	chr19	19760002	19760027	LTR/ERVL	1863	+	12	19760014	84401
chr19	19675613	19875613	harbor1	chr19	19760320	19760792	LTR/ERVL	1863	+	236	19760556	84943
chr19	19675613	19875613	harbor1	chr19	19761109	19761520	LTR/ERVL	4637	+	206	19761315	85702
chr19	19675613	19875613	harbor1	chr19	19761837	19761960	LTR/ERVL	4637	+	62	19761899	86286
chr19	19675613	19875613	harbor1	chr19	19762256	19762865	LTR/ERVL	4637	+	304	19762560	86947
chr19	19675613	19875613	harbor1	chr19	19763222	19763463	LTR/ERVL	3870	+	120	19763342	87729
chr19	19675613	19875613	harbor1	chr19	19764169	19764818	LTR/ERVL	3870	+	324	19764493	88880
chr19	19675500	19875500	harbor1	chr19	19760002	19760027	LTR/ERVL	1863	+	12	19760014	84514
chr19	19675500	19875500	harbor1	chr19	19760320	19760792	LTR/ERVL	1863	+	236	19760556	85056
chr19	19675500	19875500	harbor1	chr19	19761109	19761520	LTR/ERVL	4637	+	206	19761315	85815
chr19	19675500	19875500	harbor1	chr19	19761837	19761960	LTR/ERVL	4637	+	62	19761899	86399
chr19	19675500	19875500	harbor1	chr19	19762256	19762865	LTR/ERVL	4637	+	304	19762560	87060
chr19	19675500	19875500	harbor1	chr19	19763222	19763463	LTR/ERVL	3870	+	120	19763342	87842
chr19	19675500	19875500	harbor1	chr19	19764169	19764818	LTR/ERVL	3870	+	324	19764493	88993
chr19	49493098	49693098	harbor1	chr19	49509744	49509855	LTR/ERVL	800	+	56	49509800	16702
chr19	49493098	49693098	harbor1	chr19	49510131	49510236	LTR/ERVL	800	+	52	49510183	17085
chr19	49493098	49693098	harbor1	chr19	49510539	49510614	LTR/ERVL	800	+	38	49510577	17479
chr19	49493098	49693098	harbor1	chr19	49510895	49511160	LTR/ERVL	800	+	132	49511027	17929
chr19	19674780	19874780	harbor1	chr19	19760002	19760027	LTR/ERVL	1863	+	12	19760014	85234
chr19	19674780	19874780	harbor1	chr19	19760320	19760792	LTR/ERVL	1863	+	236	19760556	85776
chr19	19674780	19874780	harbor1	chr19	19761109	19761520	LTR/ERVL	4637	+	206	19761315	86535
chr19	19674780	19874780	harbor1	chr19	19761837	19761960	LTR/ERVL	4637	+	62	19761899	87119
chr19	19674780	19874780	harbor1	chr19	19762256	19762865	LTR/ERVL	4637	+	304	19762560	87780
chr19	19674780	19874780	harbor1	chr19	19763222	19763463	LTR/ERVL	3870	+	120	19763342	88562
chr19	19674780	19874780	harbor1	chr19	19764169	19764818	LTR/ERVL	3870	+	324	19764493	89713
chr19	19676606	19876606	harbor1	chr19	19760002	19760027	LTR/ERVL	1863	+	12	19760014	83408
chr19	19676606	19876606	harbor1	chr19	19760320	19760792	LTR/ERVL	1863	+	236	19760556	83950
chr19	19676606	19876606	harbor1	chr19	19761109	19761520	LTR/ERVL	4637	+	206	19761315	84709
chr19	19676606	19876606	harbor1	chr19	19761837	19761960	LTR/ERVL	4637	+	62	19761899	85293
chr19	19676606	19876606	harbor1	chr19	19762256	19762865	LTR/ERVL	4637	+	304	19762560	85954
chr19	19676606	19876606	harbor1	chr19	19763222	19763463	LTR/ERVL	3870	+	120	19763342	86736
chr19	19676606	19876606	harbor1	chr19	19764169	19764818	LTR/ERVL	3870	+	324	19764493	87887
chr19	10618504	10818504	harbor1	chr19	10646676	10646776	LTR/ERVL	1468	+	50	10646726	28222
chr19	10618504	10818504	harbor1	chr19	10647048	10647454	LTR/ERVL	1468	+	203	10647251	28747
chr19	19674849	19874849	harbor1	chr19	19760002	19760027	LTR/ERVL	1863	+	12	19760014	85165
chr19	19674849	19874849	harbor1	chr19	19760320	19760792	LTR/ERVL	1863	+	236	19760556	85707
chr19	19674849	19874849	harbor1	chr19	19761109	19761520	LTR/ERVL	4637	+	206	19761315	86466
chr19	19674849	19874849	harbor1	chr19	19761837	19761960	LTR/ERVL	4637	+	62	19761899	87050
chr19	19674849	19874849	harbor1	chr19	19762256	19762865	LTR/ERVL	4637	+	304	19762560	87711
chr19	19674849	19874849	harbor1	chr19	19763222	19763463	LTR/ERVL	3870	+	120	19763342	88493
chr19	19674849	19874849	harbor1	chr19	19764169	19764818	LTR/ERVL	3870	+	324	19764493	89644
chr19	3875961	4075961	harbor1	chr19	3904353	3904701	LTR/ERVL	1343	+	174	3904527	28566
chr19	19674760	19874760	harbor1	chr19	19760002	19760027	LTR/ERVL	1863	+	12	19760014	85254
chr19	19674760	19874760	harbor1	chr19	19760320	19760792	LTR/ERVL	1863	+	236	19760556	85796
chr19	19674760	19874760	harbor1	chr19	19761109	19761520	LTR/ERVL	4637	+	206	19761315	86555
chr19	19674760	19874760	harbor1	chr19	19761837	19761960	LTR/ERVL	4637	+	62	19761899	87139
chr19	19674760	19874760	harbor1	chr19	19762256	19762865	LTR/ERVL	4637	+	304	19762560	87800
chr19	19674760	19874760	harbor1	chr19	19763222	19763463	LTR/ERVL	3870	+	120	19763342	88582
chr19	19674760	19874760	harbor1	chr19	19764169	19764818	LTR/ERVL	3870	+	324	19764493	89733
chr19	10617932	10817932	harbor1	chr19	10646676	10646776	LTR/ERVL	1468	+	50	10646726	28794
chr19	10617932	10817932	harbor1	chr19	10647048	10647454	LTR/ERVL	1468	+	203	10647251	29319
chr19	56006815	56206815	harbor1	chr19	56071522	56071948	LTR/ERVL	1621	+	213	56071735	64920
chr19	19563667	19763667	harbor1	chr19	19602727	19603269	LTR/ERVL	2296	+	271	19602998	39331
chr19	10618445	10818445	harbor1	chr19	10646676	10646776	LTR/ERVL	1468	+	50	10646726	28281
chr19	10618445	10818445	harbor1	chr19	10647048	10647454	LTR/ERVL	1468	+	203	10647251	28806
chr19	13407605	13607605	harbor1	chr19	13422474	13423065	LTR/ERVL	3025	+	296	13422770	15165
chr19	13407605	13607605	harbor1	chr19	13453958	13454143	LTR/ERVL	1142	+	92	13454050	46445
chr19	10617962	10817962	harbor1	chr19	10646676	10646776	LTR/ERVL	1468	+	50	10646726	28764
chr19	10617962	10817962	harbor1	chr19	10647048	10647454	LTR/ERVL	1468	+	203	10647251	29289
chr20	62865629	63065629	harbor1	chr20	62873312	62873548	LTR/ERVL	1861	+	118	62873430	7801
chr20	62865629	63065629	harbor1	chr20	62874540	62875101	LTR/ERVL	1861	+	280	62874820	9191
chr20	62865629	63065629	harbor1	chr20	62875746	62876142	LTR/ERVL	1037	+	198	62875944	10315
chr20	20267099	20467099	harbor1	chr20	20279743	20279951	LTR/ERVL	511	+	104	20279847	12748
chr20	4586466	4786466	harbor1	chr20	4635913	4636276	LTR/ERVL	639	+	182	4636095	49629
chr20	4586466	4786466	harbor1	chr20	4653972	4654431	LTR/ERVL	1785	+	230	4654202	67736
chr20	4586466	4786466	harbor1	chr20	4654600	4654811	LTR/ERVL	1117	+	106	4654706	68240
chr20	31622218	31822218	harbor1	chr20	31653798	31654119	LTR/ERVL	632	+	160	31653958	31740
chr20	34691570	34891570	harbor1	chr20	34720987	34721205	LTR/ERVL	484	+	109	34721096	29526
chr20	34691570	34891570	harbor1	chr20	34723043	34723422	LTR/ERVL	1925	+	190	34723233	31663
chr20	59094495	59294495	harbor1	chr20	59104571	59104879	LTR/ERVL	534	+	154	59104725	10230
chr20	59094495	59294495	harbor1	chr20	59186096	59186281	LTR/ERVL	819	+	92	59186188	91693
chr20	50091428	50291428	harbor1	chr20	50172373	50172756	LTR/ERVL	463	+	192	50172565	81137
chr20	1018874	1218874	harbor1	chr20	1109101	1109488	LTR/ERVL	756	+	194	1109295	90421
chr20	1018874	1218874	harbor1	chr20	1109865	1110271	LTR/ERVL	861	+	203	1110068	91194
chr20	1018874	1218874	harbor1	chr20	1114185	1114427	LTR/ERVL	987	+	121	1114306	95432
chr20	4586441	4786441	harbor1	chr20	4635913	4636276	LTR/ERVL	639	+	182	4636095	49654
chr20	4586441	4786441	harbor1	chr20	4653972	4654431	LTR/ERVL	1785	+	230	4654202	67761
chr20	4586441	4786441	harbor1	chr20	4654600	4654811	LTR/ERVL	1117	+	106	4654706	68265
chr20	1018826	1218826	harbor1	chr20	1109101	1109488	LTR/ERVL	756	+	194	1109295	90469
chr20	1018826	1218826	harbor1	chr20	1109865	1110271	LTR/ERVL	861	+	203	1110068	91242
chr20	1018826	1218826	harbor1	chr20	1114185	1114427	LTR/ERVL	987	+	121	1114306	95480
chr20	63437341	63637341	harbor1	chr20	63450733	63450859	LTR/ERVL	515	+	63	63450796	13455
chr20	63437341	63637341	harbor1	chr20	63451166	63451248	LTR/ERVL	515	+	41	63451207	13866
chr20	63437341	63637341	harbor1	chr20	63451296	63451570	LTR/ERVL	912	+	137	63451433	14092
chr20	63437341	63637341	harbor1	chr20	63504284	63504390	LTR/ERVL	468	+	53	63504337	66996
chr20	9473828	9673828	harbor1	chr20	9497607	9498090	LTR/ERVL	1775	+	242	9497849	24021
chr20	9473828	9673828	harbor1	chr20	9535051	9535357	LTR/ERVL	765	+	153	9535204	61376
chr20	9473828	9673828	harbor1	chr20	9556774	9557243	LTR/ERVL	1008	+	234	9557008	83180
chr20	9473828	9673828	harbor1	chr20	9563112	9563836	LTR/ERVL	993	+	362	9563474	89646
chr20	62871332	63071332	harbor1	chr20	62873312	62873548	LTR/ERVL	1861	+	118	62873430	2098
chr20	62871332	63071332	harbor1	chr20	62874540	62875101	LTR/ERVL	1861	+	280	62874820	3488
chr20	62871332	63071332	harbor1	chr20	62875746	62876142	LTR/ERVL	1037	+	198	62875944	4612
chr20	50269776	50469776	harbor1	chr20	50275930	50276139	LTR/ERVL	618	+	104	50276034	6258
chr20	50269776	50469776	harbor1	chr20	50302406	50302917	LTR/ERVL	1427	+	256	50302662	32886
chr20	40589446	40789446	harbor1	chr20	40632523	40632980	LTR/ERVL	1477	+	228	40632751	43305
chr20	40589446	40789446	harbor1	chr20	40636749	40637173	LTR/ERVL	1057	+	212	40636961	47515
chr20	62023008	62223008	harbor1	chr20	62072970	62073517	LTR/ERVL	1969	+	274	62073244	50236
chr20	62023008	62223008	harbor1	chr20	62073537	62074083	LTR/ERVL	4047	+	273	62073810	50802
chr20	62023008	62223008	harbor1	chr20	62083599	62083905	LTR/ERVL	967	+	153	62083752	60744
chr20	62023008	62223008	harbor1	chr20	62113011	62113165	LTR/ERVL	496	+	77	62113088	90080
chr20	62023008	62223008	harbor1	chr20	62113996	62114043	LTR/ERVL	528	+	24	62114020	91012
chr20	62023008	62223008	harbor1	chr20	62114964	62115343	LTR/ERVL	528	+	190	62115154	92146
chr20	63437464	63637464	harbor1	chr20	63450733	63450859	LTR/ERVL	515	+	63	63450796	13332
chr20	63437464	63637464	harbor1	chr20	63451166	63451248	LTR/ERVL	515	+	41	63451207	13743
chr20	63437464	63637464	harbor1	chr20	63451296	63451570	LTR/ERVL	912	+	137	63451433	13969
chr20	63437464	63637464	harbor1	chr20	63504284	63504390	LTR/ERVL	468	+	53	63504337	66873
chr20	1018844	1218844	harbor1	chr20	1109101	1109488	LTR/ERVL	756	+	194	1109295	90451
chr20	1018844	1218844	harbor1	chr20	1109865	1110271	LTR/ERVL	861	+	203	1110068	91224
chr20	1018844	1218844	harbor1	chr20	1114185	1114427	LTR/ERVL	987	+	121	1114306	95462
chr20	9473814	9673814	harbor1	chr20	9497607	9498090	LTR/ERVL	1775	+	242	9497849	24035
chr20	9473814	9673814	harbor1	chr20	9535051	9535357	LTR/ERVL	765	+	153	9535204	61390
chr20	9473814	9673814	harbor1	chr20	9556774	9557243	LTR/ERVL	1008	+	234	9557008	83194
chr20	9473814	9673814	harbor1	chr20	9563112	9563836	LTR/ERVL	993	+	362	9563474	89660
chr20	62040581	62240581	harbor1	chr20	62072970	62073517	LTR/ERVL	1969	+	274	62073244	32663
chr20	62040581	62240581	harbor1	chr20	62073537	62074083	LTR/ERVL	4047	+	273	62073810	33229
chr20	62040581	62240581	harbor1	chr20	62083599	62083905	LTR/ERVL	967	+	153	62083752	43171
chr20	62040581	62240581	harbor1	chr20	62113011	62113165	LTR/ERVL	496	+	77	62113088	72507
chr20	62040581	62240581	harbor1	chr20	62113996	62114043	LTR/ERVL	528	+	24	62114020	73439
chr20	62040581	62240581	harbor1	chr20	62114964	62115343	LTR/ERVL	528	+	190	62115154	74573
chr20	21818076	22018076	harbor1	chr20	21821816	21822116	LTR/ERVL	738	+	150	21821966	3890
chr20	21818076	22018076	harbor1	chr20	21840250	21840531	LTR/ERVL	588	+	140	21840390	22314
chr20	21818076	22018076	harbor1	chr20	21896294	21896586	LTR/ERVL	862	+	146	21896440	78364
chr20	21818076	22018076	harbor1	chr20	21904768	21905019	LTR/ERVL	597	+	126	21904894	86818
chr20	21818076	22018076	harbor1	chr20	21909481	21909820	LTR/ERVL	1093	+	170	21909651	91575
chr20	63471550	63671550	harbor1	chr20	63504284	63504390	LTR/ERVL	468	+	53	63504337	32787
chr20	11791069	11991069	harbor1	chr20	11813389	11813420	LTR/ERVL	813	+	16	11813405	22336
chr20	11791069	11991069	harbor1	chr20	11813879	11814300	LTR/ERVL	813	+	210	11814089	23020
chr20	11791069	11991069	harbor1	chr20	11839985	11840198	LTR/ERVL	747	+	106	11840091	49022
chr20	11791069	11991069	harbor1	chr20	11869580	11870407	LTR/ERVL	4321	+	414	11869994	78925
chr20	11791069	11991069	harbor1	chr20	11872893	11873297	LTR/ERVL	1260	+	202	11873095	82026
chr20	11791069	11991069	harbor1	chr20	11879425	11879664	LTR/ERVL	491	+	120	11879545	88476
chr20	11791069	11991069	harbor1	chr20	11886623	11887076	LTR/ERVL	2582	+	226	11886849	95780
chr20	63472070	63672070	harbor1	chr20	63504284	63504390	LTR/ERVL	468	+	53	63504337	32267
chr20	4586511	4786511	harbor1	chr20	4635913	4636276	LTR/ERVL	639	+	182	4636095	49584
chr20	4586511	4786511	harbor1	chr20	4653972	4654431	LTR/ERVL	1785	+	230	4654202	67691
chr20	4586511	4786511	harbor1	chr20	4654600	4654811	LTR/ERVL	1117	+	106	4654706	68195
chr20	50269786	50469786	harbor1	chr20	50275930	50276139	LTR/ERVL	618	+	104	50276034	6248
chr20	50269786	50469786	harbor1	chr20	50302406	50302917	LTR/ERVL	1427	+	256	50302662	32876
chr21	14337898	14537898	harbor1	chr21	14377531	14378072	LTR/ERVL	1988	+	270	14377801	39903
chr21	29198992	29398992	harbor1	chr21	29284765	29285221	LTR/ERVL	1130	+	228	29284993	86001
chr21	44718448	44918448	harbor1	chr21	44720858	44721216	LTR/ERVL	2181	+	179	44721037	2589
chr21	44718448	44918448	harbor1	chr21	44767842	44768336	LTR/ERVL	1280	+	247	44768089	49641
chr21	46282980	46482980	harbor1	chr21	46320538	46320992	LTR/ERVL	1353	+	227	46320765	37785
chr21	43620271	43820271	harbor1	chr21	43648187	43648357	LTR/ERVL	464	+	85	43648272	28001
chr21	41040224	41240224	harbor1	chr21	41107598	41108098	LTR/ERVL	1726	+	250	41107848	67624
chr21	41040224	41240224	harbor1	chr21	41121870	41122038	LTR/ERVL	483	+	84	41121954	81730
chr21	41040224	41240224	harbor1	chr21	41122297	41122339	LTR/ERVL	444	+	21	41122318	82094
chr21	41040224	41240224	harbor1	chr21	41122912	41123046	LTR/ERVL	444	+	67	41122979	82755
chr21	7645362	7845362	harbor1	chr21	7666170	7666385	LTR/ERVL	742	+	108	7666278	20916
chr21	7645362	7845362	harbor1	chr21	7677129	7677504	LTR/ERVL	783	+	188	7677317	31955
chr21	29198971	29398971	harbor1	chr21	29284765	29285221	LTR/ERVL	1130	+	228	29284993	86022
chr21	29198960	29398960	harbor1	chr21	29284765	29285221	LTR/ERVL	1130	+	228	29284993	86033
chr21	14337849	14537849	harbor1	chr21	14377531	14378072	LTR/ERVL	1988	+	270	14377801	39952
chr21	42595318	42795318	harbor1	chr21	42650570	42651010	LTR/ERVL	1098	+	220	42650790	55472
chr21	29198958	29398958	harbor1	chr21	29284765	29285221	LTR/ERVL	1130	+	228	29284993	86035
chr21	5028549	5228549	harbor1	chr21	5122101	5122298	LTR/ERVL	658	+	98	5122199	93650
chr21	5028549	5228549	harbor1	chr21	5122305	5122609	LTR/ERVL	1084	+	152	5122457	93908
chr21	46358914	46558914	harbor1	chr21	46450898	46451173	LTR/ERVL	789	+	138	46451036	92122
chr21	46358914	46558914	harbor1	chr21	46451459	46451621	LTR/ERVL	789	+	81	46451540	92626
chr21	46081078	46281078	harbor1	chr21	46159249	46159813	LTR/ERVL	1138	+	282	46159531	78453
chr21	46089884	46289884	harbor1	chr21	46159249	46159813	LTR/ERVL	1138	+	282	46159531	69647
chr21	41209974	41409974	harbor1	chr21	41284202	41284735	LTR/ERVL	2180	+	266	41284468	74494
chr21	41209974	41409974	harbor1	chr21	41285297	41285373	LTR/ERVL	481	+	38	41285335	75361
chr21	41209974	41409974	harbor1	chr21	41285750	41286119	LTR/ERVL	1480	+	184	41285934	75960
chr21	41209974	41409974	harbor1	chr21	41286170	41286228	LTR/ERVL	1480	+	29	41286199	76225
chr21	42275771	42475771	harbor1	chr21	42356549	42356618	LTR/ERVL	2008	+	34	42356583	80812
chr21	42275771	42475771	harbor1	chr21	42356619	42357127	LTR/ERVL	2687	+	254	42356873	81102
chr21	42275771	42475771	harbor1	chr21	42357128	42357529	LTR/ERVL	2008	+	200	42357328	81557
chr21	42330687	42530687	harbor1	chr21	42356549	42356618	LTR/ERVL	2008	+	34	42356583	25896
chr21	42330687	42530687	harbor1	chr21	42356619	42357127	LTR/ERVL	2687	+	254	42356873	26186
chr21	42330687	42530687	harbor1	chr21	42357128	42357529	LTR/ERVL	2008	+	200	42357328	26641
chr21	42330687	42530687	harbor1	chr21	42391369	42391847	LTR/ERVL	1973	+	239	42391608	60921
chr21	39008427	39208427	harbor1	chr21	39043229	39043261	LTR/ERVL	1446	+	16	39043245	34818
chr21	39008427	39208427	harbor1	chr21	39058286	39058388	LTR/ERVL	669	+	51	39058337	49910
chr21	39008427	39208427	harbor1	chr21	39042772	39043183	LTR/ERVL	1446	+	206	39042978	34551
chr21	37167966	37367966	harbor1	chr21	37233217	37233312	LTR/ERVL	642	+	48	37233265	65299
chr21	39008529	39208529	harbor1	chr21	39043229	39043261	LTR/ERVL	1446	+	16	39043245	34716
chr21	39008529	39208529	harbor1	chr21	39058286	39058388	LTR/ERVL	669	+	51	39058337	49808
chr21	39008529	39208529	harbor1	chr21	39042772	39043183	LTR/ERVL	1446	+	206	39042978	34449
chr21	44624134	44824134	harbor1	chr21	44652727	44652874	LTR/ERVL	723	+	74	44652801	28667
chr21	44624134	44824134	harbor1	chr21	44720858	44721216	LTR/ERVL	2181	+	179	44721037	96903
chr21	44624134	44824134	harbor1	chr21	44678869	44679282	LTR/ERVL	2560	+	206	44679075	54941
chr21	29198951	29398951	harbor1	chr21	29284765	29285221	LTR/ERVL	1130	+	228	29284993	86042
chr21	39008418	39208418	harbor1	chr21	39043229	39043261	LTR/ERVL	1446	+	16	39043245	34827
chr21	39008418	39208418	harbor1	chr21	39058286	39058388	LTR/ERVL	669	+	51	39058337	49919
chr21	39008418	39208418	harbor1	chr21	39042772	39043183	LTR/ERVL	1446	+	206	39042978	34560
chr21	8119783	8319783	harbor1	chr21	8161565	8161762	LTR/ERVL	1256	+	98	8161663	41880
chr21	8119783	8319783	harbor1	chr21	8161743	8162332	LTR/ERVL	3987	+	294	8162037	42254
chr21	8119783	8319783	harbor1	chr21	8162331	8162541	LTR/ERVL	1004	+	105	8162436	42653
chr21	8119783	8319783	harbor1	chr21	8162544	8162941	LTR/ERVL	2464	+	198	8162742	42959
chr21	8119783	8319783	harbor1	chr21	8162941	8163058	LTR/ERVL	607	+	58	8162999	43216
chr21	8119783	8319783	harbor1	chr21	8163162	8163340	LTR/ERVL	764	+	89	8163251	43468
chr21	8119783	8319783	harbor1	chr21	8190648	8191157	LTR/ERVL	848	+	254	8190902	71119
chr22	44201157	44401157	harbor1	chr22	44255833	44256488	LTR/ERVL	1519	+	328	44256161	55004
chr22	44201157	44401157	harbor1	chr22	44277989	44278428	LTR/ERVL	3295	+	220	44278209	77052
chr22	45966963	46166963	harbor1	chr22	45985438	45985983	LTR/ERVL	1635	+	272	45985710	18747
chr22	45966963	46166963	harbor1	chr22	46020980	46021581	LTR/ERVL	731	+	300	46021280	54317
chr22	45966963	46166963	harbor1	chr22	46021689	46022195	LTR/ERVL	1163	+	253	46021942	54979
chr22	42986422	43186422	harbor1	chr22	43030272	43030719	LTR/ERVL	1679	+	224	43030496	44074
chr22	42986422	43186422	harbor1	chr22	43060196	43060467	LTR/ERVL	498	+	136	43060332	73910
chr22	42989585	43189585	harbor1	chr22	43030272	43030719	LTR/ERVL	1679	+	224	43030496	40911
chr22	42989585	43189585	harbor1	chr22	43060196	43060467	LTR/ERVL	498	+	136	43060332	70747
chr22	23794301	23994301	harbor1	chr22	23867130	23867200	LTR/ERVL	420	+	35	23867165	72864
chr22	23794301	23994301	harbor1	chr22	23867498	23867532	LTR/ERVL	420	+	17	23867515	73214
chr22	23794301	23994301	harbor1	chr22	23867568	23867708	LTR/ERVL	573	+	70	23867638	73337
chr22	23794301	23994301	harbor1	chr22	23867710	23868223	LTR/ERVL	2166	+	256	23867966	73665
chr22	36407036	36607036	harbor1	chr22	36422785	36422906	LTR/ERVL	495	+	60	36422845	15809
chr22	36407036	36607036	harbor1	chr22	36471206	36471377	LTR/ERVL	386	+	86	36471292	64256
chr22	36186433	36386433	harbor1	chr22	36187778	36188078	LTR/ERVL	840	+	150	36187928	1495
chr22	36186433	36386433	harbor1	chr22	36192608	36192816	LTR/ERVL	522	+	104	36192712	6279
chr22	36186433	36386433	harbor1	chr22	36193375	36193650	LTR/ERVL	1188	+	138	36193513	7080
chr22	36186433	36386433	harbor1	chr22	36220385	36220973	LTR/ERVL	2157	+	294	36220679	34246
chr22	36186433	36386433	harbor1	chr22	36223722	36224154	LTR/ERVL	453	+	216	36223938	37505
chr22	36186433	36386433	harbor1	chr22	36224603	36224855	LTR/ERVL	545	+	126	36224729	38296
chr22	36186433	36386433	harbor1	chr22	36228665	36228966	LTR/ERVL	646	+	150	36228815	42382
chr22	36186433	36386433	harbor1	chr22	36229433	36229719	LTR/ERVL	1234	+	143	36229576	43143
chr22	36186433	36386433	harbor1	chr22	36248161	36248356	LTR/ERVL	543	+	98	36248259	61826
chr22	36186433	36386433	harbor1	chr22	36248385	36248801	LTR/ERVL	1139	+	208	36248593	62160
chr22	36186433	36386433	harbor1	chr22	36267213	36267606	LTR/ERVL	2406	+	196	36267409	80976
chr22	36194376	36394376	harbor1	chr22	36220385	36220973	LTR/ERVL	2157	+	294	36220679	26303
chr22	36194376	36394376	harbor1	chr22	36223722	36224154	LTR/ERVL	453	+	216	36223938	29562
chr22	36194376	36394376	harbor1	chr22	36224603	36224855	LTR/ERVL	545	+	126	36224729	30353
chr22	36194376	36394376	harbor1	chr22	36228665	36228966	LTR/ERVL	646	+	150	36228815	34439
chr22	36194376	36394376	harbor1	chr22	36229433	36229719	LTR/ERVL	1234	+	143	36229576	35200
chr22	36194376	36394376	harbor1	chr22	36248161	36248356	LTR/ERVL	543	+	98	36248259	53883
chr22	36194376	36394376	harbor1	chr22	36248385	36248801	LTR/ERVL	1139	+	208	36248593	54217
chr22	36194376	36394376	harbor1	chr22	36267213	36267606	LTR/ERVL	2406	+	196	36267409	73033
chr22	36918544	37118544	harbor1	chr22	36981653	36981754	LTR/ERVL	579	+	50	36981703	63159
chr22	36918544	37118544	harbor1	chr22	36982088	36982223	LTR/ERVL	579	+	68	36982156	63612
chr22	36186444	36386444	harbor1	chr22	36187778	36188078	LTR/ERVL	840	+	150	36187928	1484
chr22	36186444	36386444	harbor1	chr22	36192608	36192816	LTR/ERVL	522	+	104	36192712	6268
chr22	36186444	36386444	harbor1	chr22	36193375	36193650	LTR/ERVL	1188	+	138	36193513	7069
chr22	36186444	36386444	harbor1	chr22	36220385	36220973	LTR/ERVL	2157	+	294	36220679	34235
chr22	36186444	36386444	harbor1	chr22	36223722	36224154	LTR/ERVL	453	+	216	36223938	37494
chr22	36186444	36386444	harbor1	chr22	36224603	36224855	LTR/ERVL	545	+	126	36224729	38285
chr22	36186444	36386444	harbor1	chr22	36228665	36228966	LTR/ERVL	646	+	150	36228815	42371
chr22	36186444	36386444	harbor1	chr22	36229433	36229719	LTR/ERVL	1234	+	143	36229576	43132
chr22	36186444	36386444	harbor1	chr22	36248161	36248356	LTR/ERVL	543	+	98	36248259	61815
chr22	36186444	36386444	harbor1	chr22	36248385	36248801	LTR/ERVL	1139	+	208	36248593	62149
chr22	36186444	36386444	harbor1	chr22	36267213	36267606	LTR/ERVL	2406	+	196	36267409	80965
chr22	36406317	36606317	harbor1	chr22	36422785	36422906	LTR/ERVL	495	+	60	36422845	16528
chr22	36406317	36606317	harbor1	chr22	36471206	36471377	LTR/ERVL	386	+	86	36471292	64975
chr22	23889707	24089707	harbor1	chr22	23939410	23939912	LTR/ERVL	2128	+	251	23939661	49954
chr22	23889707	24089707	harbor1	chr22	23956863	23957075	LTR/ERVL	532	+	106	23956969	67262
chr22	50061640	50261640	harbor1	chr22	50078809	50078968	LTR/ERVL	665	+	80	50078889	17249
chr22	42951342	43151342	harbor1	chr22	43030272	43030719	LTR/ERVL	1679	+	224	43030496	79154
chr22	22547227	22747227	harbor1	chr22	22571018	22571632	LTR/ERVL	1490	+	307	22571325	24098
chr22	22547227	22747227	harbor1	chr22	22595538	22595762	LTR/ERVL	393	+	112	22595650	48423
chr22	22547227	22747227	harbor1	chr22	22620913	22621361	LTR/ERVL	2665	+	224	22621137	73910
chr22	28341001	28541001	harbor1	chr22	28369971	28370421	LTR/ERVL	1098	+	225	28370196	29195
chr22	28341001	28541001	harbor1	chr22	28375614	28376195	LTR/ERVL	2816	+	290	28375904	34903
chr22	32076022	32276022	harbor1	chr22	32115707	32116277	LTR/ERVL	1921	+	285	32115992	39970
chr22	32076022	32276022	harbor1	chr22	32116610	32116894	LTR/ERVL	1607	+	142	32116752	40730
chr22	37218535	37418535	harbor1	chr22	37272429	37272572	LTR/ERVL	593	+	72	37272501	53966
chr22	23214520	23414520	harbor1	chr22	23243045	23243648	LTR/ERVL	2768	+	302	23243347	28827
chr22	23214520	23414520	harbor1	chr22	23243941	23244243	LTR/ERVL	2768	+	151	23244092	29572
chr22	44788190	44988190	harbor1	chr22	44796393	44796892	LTR/ERVL	666	+	250	44796643	8453
chr22	44788190	44988190	harbor1	chr22	44849826	44850106	LTR/ERVL	598	+	140	44849966	61776
chr22	23023578	23223578	harbor1	chr22	23026084	23026412	LTR/ERVL	5220	+	164	23026248	2670
chr22	23023578	23223578	harbor1	chr22	23027289	23027892	LTR/ERVL	5220	+	302	23027591	4013
chr22	23023578	23223578	harbor1	chr22	23029349	23029819	LTR/ERVL	5220	+	235	23029584	6006
chr22	23841607	24041607	harbor1	chr22	23867130	23867200	LTR/ERVL	420	+	35	23867165	25558
chr22	23841607	24041607	harbor1	chr22	23867498	23867532	LTR/ERVL	420	+	17	23867515	25908
chr22	23841607	24041607	harbor1	chr22	23867568	23867708	LTR/ERVL	573	+	70	23867638	26031
chr22	23841607	24041607	harbor1	chr22	23867710	23868223	LTR/ERVL	2166	+	256	23867966	26359
chr22	23841607	24041607	harbor1	chr22	23939410	23939912	LTR/ERVL	2128	+	251	23939661	98054
chr22	24852758	25052758	harbor1	chr22	24948724	24948988	LTR/ERVL	547	+	132	24948856	96098
chr22	24852758	25052758	harbor1	chr22	24870567	24871020	LTR/ERVL	1280	+	226	24870793	18035
chr22	42519774	42719774	harbor1	chr22	42529238	42529277	LTR/ERVL	591	+	20	42529258	9484
chr22	42519774	42719774	harbor1	chr22	42529925	42530034	LTR/ERVL	611	+	54	42529979	10205
chr22	42519774	42719774	harbor1	chr22	42530428	42530581	LTR/ERVL	656	+	76	42530504	10730
chr22	42519774	42719774	harbor1	chr22	42594982	42595492	LTR/ERVL	2447	+	255	42595237	75463
chr22	11997987	12197987	harbor1	chr22	12066841	12067240	LTR/ERVL	730	+	200	12067041	69054
chr22	11997987	12197987	harbor1	chr22	12070218	12070526	LTR/ERVL	822	+	154	12070372	72385
chr22	11997987	12197987	harbor1	chr22	12079381	12079410	LTR/ERVL	555	+	14	12079395	81408
chr22	18756011	18956011	harbor1	chr22	18798457	18798870	LTR/ERVL	1091	+	206	18798663	42652
chr22	38674448	38874448	harbor1	chr22	38762883	38763214	LTR/ERVL	1454	+	166	38763049	88601
chr22	38674424	38874424	harbor1	chr22	38762883	38763214	LTR/ERVL	1454	+	166	38763049	88625
chr22	24852840	25052840	harbor1	chr22	24948724	24948988	LTR/ERVL	547	+	132	24948856	96016
chr22	24852840	25052840	harbor1	chr22	24870567	24871020	LTR/ERVL	1280	+	226	24870793	17953
chr22	23023556	23223556	harbor1	chr22	23026084	23026412	LTR/ERVL	5220	+	164	23026248	2692
chr22	23023556	23223556	harbor1	chr22	23027289	23027892	LTR/ERVL	5220	+	302	23027591	4035
chr22	23023556	23223556	harbor1	chr22	23029349	23029819	LTR/ERVL	5220	+	235	23029584	6028
chr22	20395167	20595167	harbor1	chr22	20467090	20467568	LTR/ERVL	2533	+	239	20467329	72162
chr22	20395167	20595167	harbor1	chr22	20414335	20414829	LTR/ERVL	960	+	247	20414582	19415
chrX	135350040	135550040	harbor1	chrX	135378992	135379543	LTR/ERVL	3255	+	276	135379268	29228
chrX	135350040	135550040	harbor1	chrX	135389547	135390048	LTR/ERVL	1101	+	250	135389797	39757
chrX	135350040	135550040	harbor1	chrX	135390275	135390451	LTR/ERVL	630	+	88	135390363	40323
chrX	135350040	135550040	harbor1	chrX	135390913	135391303	LTR/ERVL	1132	+	195	135391108	41068
chrX	135350040	135550040	harbor1	chrX	135393377	135393626	LTR/ERVL	1667	+	124	135393501	43461
chrX	135350040	135550040	harbor1	chrX	135393968	135394237	LTR/ERVL	6931	+	134	135394102	44062
chrX	135350040	135550040	harbor1	chrX	135394529	135395108	LTR/ERVL	6931	+	290	135394819	44779
chrX	135350040	135550040	harbor1	chrX	135395109	135395485	LTR/ERVL	2917	+	188	135395297	45257
chrX	135350040	135550040	harbor1	chrX	135395532	135395574	LTR/ERVL	2917	+	21	135395553	45513
chrX	135350040	135550040	harbor1	chrX	135404264	135404447	LTR/ERVL	3867	+	92	135404356	54316
chrX	135350040	135550040	harbor1	chrX	135404822	135405758	LTR/ERVL	3867	+	468	135405290	55250
chrX	24365240	24565240	harbor1	chrX	24388367	24388584	LTR/ERVL	819	+	108	24388475	23235
chrX	24365240	24565240	harbor1	chrX	24413482	24413881	LTR/ERVL	1455	+	200	24413682	48442
chrX	24365240	24565240	harbor1	chrX	24428611	24428771	LTR/ERVL	871	+	80	24428691	63451
chrX	24365240	24565240	harbor1	chrX	24451091	24451398	LTR/ERVL	1118	+	154	24451245	86005
chrX	24365240	24565240	harbor1	chrX	24411814	24412265	LTR/ERVL	1389	+	226	24412040	46800
chrX	48953792	49153792	harbor1	chrX	49008483	49008590	LTR/ERVL	1931	+	54	49008537	54745
chrX	48953792	49153792	harbor1	chrX	49008902	49009184	LTR/ERVL	1931	+	141	49009043	55251
chrX	153409879	153609879	harbor1	chrX	153435824	153436159	LTR/ERVL	1540	+	168	153435992	26113
chrX	72206994	72406994	harbor1	chrX	72298654	72299146	LTR/ERVL	2506	+	246	72298900	91906
chrX	48953749	49153749	harbor1	chrX	49008483	49008590	LTR/ERVL	1931	+	54	49008537	54788
chrX	48953749	49153749	harbor1	chrX	49008902	49009184	LTR/ERVL	1931	+	141	49009043	55294
chrX	152928214	153128214	harbor1	chrX	152948413	152948805	LTR/ERVL	1947	+	196	152948609	20395
chrX	152928214	153128214	harbor1	chrX	152981331	152981549	LTR/ERVL	2481	+	109	152981440	53226
chrX	152928214	153128214	harbor1	chrX	152981601	152981921	LTR/ERVL	2481	+	160	152981761	53547
chrX	150672938	150872938	harbor1	chrX	150683624	150683893	LTR/ERVL	888	+	134	150683758	10820
chrX	72206945	72406945	harbor1	chrX	72298654	72299146	LTR/ERVL	2506	+	246	72298900	91955
chrX	17671917	17871917	harbor1	chrX	17709064	17709317	LTR/ERVL	853	+	126	17709190	37273
chrX	17671917	17871917	harbor1	chrX	17756956	17757427	LTR/ERVL	1284	+	236	17757192	85275
chrX	39992279	40192279	harbor1	chrX	40023990	40024446	LTR/ERVL	2326	+	228	40024218	31939
chrX	39992279	40192279	harbor1	chrX	40028562	40029365	LTR/ERVL	4646	+	402	40028964	36685
chrX	153409904	153609904	harbor1	chrX	153435824	153436159	LTR/ERVL	1540	+	168	153435992	26088
