H_chr	H_start	H_end	Harbor	TE_chr	TE_start	TE_end	TE	score	TE_strand	TE_half	TE_middle_pos	TE_dis
chr1	16543082	16743082	harbor1	chr1	16560670	16560870	LTR/ERVL	779	+	100	16560770	17688
chr1	6394942	6594942	harbor1	chr1	6411051	6411736	LTR/ERVL	1562	+	342	6411393	16451
chr1	26400749	26600749	harbor1	chr1	26496945	26497334	LTR/ERVL	993	+	194	26497139	96390
chr1	16423038	16623038	harbor1	chr1	16470035	16470368	LTR/ERVL	1265	+	166	16470201	47163
chr1	16543073	16743073	harbor1	chr1	16560670	16560870	LTR/ERVL	779	+	100	16560770	17697
chr1	16507813	16707813	harbor1	chr1	16560670	16560870	LTR/ERVL	779	+	100	16560770	52957
chr1	227441506	227641506	harbor1	chr1	227444112	227445179	LTR/ERVL	7121	+	534	227444646	3140
chr1	227441506	227641506	harbor1	chr1	227445180	227445567	LTR/ERVL	1998	+	194	227445374	3868
chr1	227441506	227641506	harbor1	chr1	227445872	227445934	LTR/ERVL	1998	+	31	227445903	4397
chr1	227441506	227641506	harbor1	chr1	227453765	227454144	LTR/ERVL	659	+	190	227453955	12449
chr1	108941871	109141871	harbor1	chr1	108955541	108956075	LTR/ERVL	2759	+	267	108955808	13937
chr1	178438257	178638257	harbor1	chr1	178499300	178499699	LTR/ERVL	3027	+	200	178499500	61243
chr1	178438257	178638257	harbor1	chr1	178500008	178500076	LTR/ERVL	565	+	34	178500042	61785
chr1	16544872	16744872	harbor1	chr1	16560670	16560870	LTR/ERVL	779	+	100	16560770	15898
chr1	211033794	211233794	harbor1	chr1	211067248	211067560	LTR/ERVL	791	+	156	211067404	33610
chr1	211033794	211233794	harbor1	chr1	211074301	211074595	LTR/ERVL	1044	+	147	211074448	40654
chr1	211033794	211233794	harbor1	chr1	211074600	211074993	LTR/ERVL	1575	+	196	211074796	41002
chr1	211033794	211233794	harbor1	chr1	211093920	211094076	LTR/ERVL	730	+	78	211093998	60204
chr1	211033794	211233794	harbor1	chr1	211094405	211094497	LTR/ERVL	730	+	46	211094451	60657
chr1	211033794	211233794	harbor1	chr1	211115321	211115701	LTR/ERVL	3316	+	190	211115511	81717
chr1	211033794	211233794	harbor1	chr1	211115732	211115794	LTR/ERVL	3316	+	31	211115763	81969
chr1	33156095	33356095	harbor1	chr1	33190670	33191020	LTR/ERVL	1171	+	175	33190845	34750
chr1	33156095	33356095	harbor1	chr1	33191009	33191267	LTR/ERVL	916	+	129	33191138	35043
chr1	33156095	33356095	harbor1	chr1	33196836	33197412	LTR/ERVL	2383	+	288	33197124	41029
chr1	717645	917645	harbor1	chr1	741124	741629	LTR/ERVL	3337	+	252	741376	23731
chr1	717645	917645	harbor1	chr1	741937	742006	LTR/ERVL	3337	+	34	741971	24326
chr1	717645	917645	harbor1	chr1	742310	742610	LTR/ERVL	3337	+	150	742460	24815
chr1	717645	917645	harbor1	chr1	752876	753134	LTR/ERVL	3365	+	129	753005	35360
chr1	717645	917645	harbor1	chr1	754046	754345	LTR/ERVL	3365	+	150	754196	36551
chr1	717645	917645	harbor1	chr1	753429	753738	LTR/ERVL	3365	+	154	753583	35938
chr1	16544914	16744914	harbor1	chr1	16560670	16560870	LTR/ERVL	779	+	100	16560770	15856
chr1	16544773	16744773	harbor1	chr1	16560670	16560870	LTR/ERVL	779	+	100	16560770	15997
chr1	16504018	16704018	harbor1	chr1	16560670	16560870	LTR/ERVL	779	+	100	16560770	56752
chr1	226479130	226679130	harbor1	chr1	226488716	226489181	LTR/ERVL	2461	+	232	226488948	9818
chr1	226479130	226679130	harbor1	chr1	226533715	226534105	LTR/ERVL	1015	+	195	226533910	54780
chr1	226479130	226679130	harbor1	chr1	226564953	226565365	LTR/ERVL	984	+	206	226565159	86029
chr1	211033705	211233705	harbor1	chr1	211067248	211067560	LTR/ERVL	791	+	156	211067404	33699
chr1	211033705	211233705	harbor1	chr1	211074301	211074595	LTR/ERVL	1044	+	147	211074448	40743
chr1	211033705	211233705	harbor1	chr1	211074600	211074993	LTR/ERVL	1575	+	196	211074796	41091
chr1	211033705	211233705	harbor1	chr1	211093920	211094076	LTR/ERVL	730	+	78	211093998	60293
chr1	211033705	211233705	harbor1	chr1	211094405	211094497	LTR/ERVL	730	+	46	211094451	60746
chr1	211033705	211233705	harbor1	chr1	211115321	211115701	LTR/ERVL	3316	+	190	211115511	81806
chr1	211033705	211233705	harbor1	chr1	211115732	211115794	LTR/ERVL	3316	+	31	211115763	82058
chr1	16513040	16713040	harbor1	chr1	16560670	16560870	LTR/ERVL	779	+	100	16560770	47730
chr1	13662912	13862912	harbor1	chr1	13684986	13685376	LTR/ERVL	1004	+	195	13685181	22269
chr1	16544793	16744793	harbor1	chr1	16560670	16560870	LTR/ERVL	779	+	100	16560770	15977
chr1	211033814	211233814	harbor1	chr1	211067248	211067560	LTR/ERVL	791	+	156	211067404	33590
chr1	211033814	211233814	harbor1	chr1	211074301	211074595	LTR/ERVL	1044	+	147	211074448	40634
chr1	211033814	211233814	harbor1	chr1	211074600	211074993	LTR/ERVL	1575	+	196	211074796	40982
chr1	211033814	211233814	harbor1	chr1	211093920	211094076	LTR/ERVL	730	+	78	211093998	60184
chr1	211033814	211233814	harbor1	chr1	211094405	211094497	LTR/ERVL	730	+	46	211094451	60637
chr1	211033814	211233814	harbor1	chr1	211115321	211115701	LTR/ERVL	3316	+	190	211115511	81697
chr1	211033814	211233814	harbor1	chr1	211115732	211115794	LTR/ERVL	3316	+	31	211115763	81949
chr1	16544707	16744707	harbor1	chr1	16560670	16560870	LTR/ERVL	779	+	100	16560770	16063
chr1	16543134	16743134	harbor1	chr1	16560670	16560870	LTR/ERVL	779	+	100	16560770	17636
chr1	17288486	17488486	harbor1	chr1	17295845	17296296	LTR/ERVL	1682	+	226	17296071	7585
chr1	17288486	17488486	harbor1	chr1	17296525	17296925	LTR/ERVL	1798	+	200	17296725	8239
chr1	16517405	16717405	harbor1	chr1	16560670	16560870	LTR/ERVL	779	+	100	16560770	43365
chr1	16508264	16708264	harbor1	chr1	16560670	16560870	LTR/ERVL	779	+	100	16560770	52506
chr1	16493369	16693369	harbor1	chr1	16560670	16560870	LTR/ERVL	779	+	100	16560770	67401
chr1	21742070	21942070	harbor1	chr1	21754485	21755157	LTR/ERVL	1153	+	336	21754821	12751
chr1	16545030	16745030	harbor1	chr1	16560670	16560870	LTR/ERVL	779	+	100	16560770	15740
chr1	16543007	16743007	harbor1	chr1	16560670	16560870	LTR/ERVL	779	+	100	16560770	17763
chr1	205330408	205530408	harbor1	chr1	205400557	205400689	LTR/ERVL	725	+	66	205400623	70215
chr1	205330408	205530408	harbor1	chr1	205406860	205407049	LTR/ERVL	3417	+	94	205406954	76546
chr1	205330408	205530408	harbor1	chr1	205407350	205407951	LTR/ERVL	3417	+	300	205407650	77242
chr1	2375351	2575351	harbor1	chr1	2383092	2383334	LTR/ERVL	518	+	121	2383213	7862
chr1	16544735	16744735	harbor1	chr1	16560670	16560870	LTR/ERVL	779	+	100	16560770	16035
chr1	2375340	2575340	harbor1	chr1	2383092	2383334	LTR/ERVL	518	+	121	2383213	7873
chr1	5895458	6095458	harbor1	chr1	5946549	5946979	LTR/ERVL	1363	+	215	5946764	51306
chr1	5895458	6095458	harbor1	chr1	5983247	5983721	LTR/ERVL	2349	+	237	5983484	88026
chr1	5895458	6095458	harbor1	chr1	5979819	5980351	LTR/ERVL	1406	+	266	5980085	84627
chr1	39855348	40055348	harbor1	chr1	39908119	39908877	LTR/ERVL	1564	+	379	39908498	53150
chr1	755937	955937	harbor1	chr1	836414	836851	LTR/ERVL	610	+	218	836632	80695
chr1	47234717	47434717	harbor1	chr1	47284909	47285011	LTR/ERVL	949	+	51	47284960	50243
chr1	47234717	47434717	harbor1	chr1	47285332	47285450	LTR/ERVL	949	+	59	47285391	50674
chr1	16542884	16742884	harbor1	chr1	16560670	16560870	LTR/ERVL	779	+	100	16560770	17886
chr1	2992772	3192772	harbor1	chr1	3004196	3004406	LTR/ERVL	459	+	105	3004301	11529
chr1	2992772	3192772	harbor1	chr1	3033129	3033510	LTR/ERVL	636	+	190	3033319	40547
chr1	29137918	29337918	harbor1	chr1	29205083	29205172	LTR/ERVL	755	+	44	29205127	67209
chr1	29137918	29337918	harbor1	chr1	29205484	29205548	LTR/ERVL	755	+	32	29205516	67598
chr1	29137918	29337918	harbor1	chr1	29205830	29205992	LTR/ERVL	755	+	81	29205911	67993
chr1	119470501	119670501	harbor1	chr1	119533108	119533524	LTR/ERVL	1128	+	208	119533316	62815
chr1	119470501	119670501	harbor1	chr1	119558114	119558530	LTR/ERVL	1062	+	208	119558322	87821
chr1	16544757	16744757	harbor1	chr1	16560670	16560870	LTR/ERVL	779	+	100	16560770	16013
chr1	87225746	87425746	harbor1	chr1	87281726	87282263	LTR/ERVL	1897	+	268	87281994	56248
chr1	211033766	211233766	harbor1	chr1	211067248	211067560	LTR/ERVL	791	+	156	211067404	33638
chr1	211033766	211233766	harbor1	chr1	211074301	211074595	LTR/ERVL	1044	+	147	211074448	40682
chr1	211033766	211233766	harbor1	chr1	211074600	211074993	LTR/ERVL	1575	+	196	211074796	41030
chr1	211033766	211233766	harbor1	chr1	211093920	211094076	LTR/ERVL	730	+	78	211093998	60232
chr1	211033766	211233766	harbor1	chr1	211094405	211094497	LTR/ERVL	730	+	46	211094451	60685
chr1	211033766	211233766	harbor1	chr1	211115321	211115701	LTR/ERVL	3316	+	190	211115511	81745
chr1	211033766	211233766	harbor1	chr1	211115732	211115794	LTR/ERVL	3316	+	31	211115763	81997
chr1	16544790	16744790	harbor1	chr1	16560670	16560870	LTR/ERVL	779	+	100	16560770	15980
chr1	11498163	11698163	harbor1	chr1	11552225	11552749	LTR/ERVL	2438	+	262	11552487	54324
chr1	11498163	11698163	harbor1	chr1	11555818	11556334	LTR/ERVL	1920	+	258	11556076	57913
chr1	11498163	11698163	harbor1	chr1	11580502	11580771	LTR/ERVL	794	+	134	11580636	82473
chr1	11498163	11698163	harbor1	chr1	11583833	11584086	LTR/ERVL	430	+	126	11583959	85796
chr1	11498163	11698163	harbor1	chr1	11591409	11591860	LTR/ERVL	2731	+	226	11591635	93472
chr1	16538364	16738364	harbor1	chr1	16560670	16560870	LTR/ERVL	779	+	100	16560770	22406
chr1	26400777	26600777	harbor1	chr1	26496945	26497334	LTR/ERVL	993	+	194	26497139	96362
chr1	16542853	16742853	harbor1	chr1	16560670	16560870	LTR/ERVL	779	+	100	16560770	17917
chr1	16544788	16744788	harbor1	chr1	16560670	16560870	LTR/ERVL	779	+	100	16560770	15982
chr1	244605801	244805801	harbor1	chr1	244644512	244644942	LTR/ERVL	1120	+	215	244644727	38926
chr1	244605801	244805801	harbor1	chr1	244644953	244645618	LTR/ERVL	1325	+	332	244645285	39484
chr1	244605801	244805801	harbor1	chr1	244647978	244648381	LTR/ERVL	590	+	202	244648180	42379
chr1	244605801	244805801	harbor1	chr1	244665526	244665854	LTR/ERVL	1793	+	164	244665690	59889
chr1	244605801	244805801	harbor1	chr1	244696661	244697204	LTR/ERVL	3037	+	272	244696933	91132
chr1	244605801	244805801	harbor1	chr1	244697207	244697225	LTR/ERVL	10237	+	9	244697216	91415
chr1	244605801	244805801	harbor1	chr1	244697494	244699301	LTR/ERVL	10237	+	904	244698398	92597
chr1	244605801	244805801	harbor1	chr1	244699609	244700085	LTR/ERVL	10237	+	238	244699847	94046
chr1	244605801	244805801	harbor1	chr1	244700086	244700259	LTR/ERVL	731	+	86	244700172	94371
chr1	244605801	244805801	harbor1	chr1	244645678	244646518	LTR/ERVL	2943	+	420	244646098	40297
chr1	16543001	16743001	harbor1	chr1	16560670	16560870	LTR/ERVL	779	+	100	16560770	17769
chr1	16544777	16744777	harbor1	chr1	16560670	16560870	LTR/ERVL	779	+	100	16560770	15993
chr1	16543061	16743061	harbor1	chr1	16560670	16560870	LTR/ERVL	779	+	100	16560770	17709
chr1	39855400	40055400	harbor1	chr1	39908119	39908877	LTR/ERVL	1564	+	379	39908498	53098
chr1	205329486	205529486	harbor1	chr1	205400557	205400689	LTR/ERVL	725	+	66	205400623	71137
chr1	205329486	205529486	harbor1	chr1	205406860	205407049	LTR/ERVL	3417	+	94	205406954	77468
chr1	205329486	205529486	harbor1	chr1	205407350	205407951	LTR/ERVL	3417	+	300	205407650	78164
chr1	16543101	16743101	harbor1	chr1	16560670	16560870	LTR/ERVL	779	+	100	16560770	17669
chr1	4224540	4424540	harbor1	chr1	4240184	4240730	LTR/ERVL	1859	+	273	4240457	15917
chr1	4224540	4424540	harbor1	chr1	4252504	4253050	LTR/ERVL	2311	+	273	4252777	28237
chr1	4224540	4424540	harbor1	chr1	4254640	4255755	LTR/ERVL	2513	+	558	4255198	30658
chr1	2375276	2575276	harbor1	chr1	2383092	2383334	LTR/ERVL	518	+	121	2383213	7937
chr1	16544791	16744791	harbor1	chr1	16560670	16560870	LTR/ERVL	779	+	100	16560770	15979
chr1	43447541	43647541	harbor1	chr1	43465255	43465474	LTR/ERVL	601	+	110	43465365	17824
chr1	43447541	43647541	harbor1	chr1	43465486	43465620	LTR/ERVL	485	+	67	43465553	18012
chr1	43447541	43647541	harbor1	chr1	43475797	43476063	LTR/ERVL	630	+	133	43475930	28389
chr1	43447541	43647541	harbor1	chr1	43512809	43513353	LTR/ERVL	1189	+	272	43513081	65540
chr1	43447541	43647541	harbor1	chr1	43521788	43522217	LTR/ERVL	1254	+	214	43522002	74461
chr1	1292629	1492629	harbor1	chr1	1357233	1357526	LTR/ERVL	1029	+	146	1357379	64750
chr1	1292629	1492629	harbor1	chr1	1357817	1357890	LTR/ERVL	1029	+	36	1357853	65224
chr1	726325	926325	harbor1	chr1	741124	741629	LTR/ERVL	3337	+	252	741376	15051
chr1	726325	926325	harbor1	chr1	741937	742006	LTR/ERVL	3337	+	34	741971	15646
chr1	726325	926325	harbor1	chr1	742310	742610	LTR/ERVL	3337	+	150	742460	16135
chr1	726325	926325	harbor1	chr1	752876	753134	LTR/ERVL	3365	+	129	753005	26680
chr1	726325	926325	harbor1	chr1	754046	754345	LTR/ERVL	3365	+	150	754196	27871
chr1	726325	926325	harbor1	chr1	753429	753738	LTR/ERVL	3365	+	154	753583	27258
chr1	2375349	2575349	harbor1	chr1	2383092	2383334	LTR/ERVL	518	+	121	2383213	7864
chr1	25518162	25718162	harbor1	chr1	25589380	25589820	LTR/ERVL	2218	+	220	25589600	71438
chr1	25518162	25718162	harbor1	chr1	25590118	25590184	LTR/ERVL	2218	+	33	25590151	71989
chr1	25518162	25718162	harbor1	chr1	25598359	25598749	LTR/ERVL	1106	+	195	25598554	80392
chr1	25518162	25718162	harbor1	chr1	25613656	25614173	LTR/ERVL	3425	+	258	25613914	95752
chr1	2375585	2575585	harbor1	chr1	2383092	2383334	LTR/ERVL	518	+	121	2383213	7628
chr1	16544924	16744924	harbor1	chr1	16560670	16560870	LTR/ERVL	779	+	100	16560770	15846
chr1	244589301	244789301	harbor1	chr1	244644512	244644942	LTR/ERVL	1120	+	215	244644727	55426
chr1	244589301	244789301	harbor1	chr1	244644953	244645618	LTR/ERVL	1325	+	332	244645285	55984
chr1	244589301	244789301	harbor1	chr1	244647978	244648381	LTR/ERVL	590	+	202	244648180	58879
chr1	244589301	244789301	harbor1	chr1	244665526	244665854	LTR/ERVL	1793	+	164	244665690	76389
chr1	244589301	244789301	harbor1	chr1	244645678	244646518	LTR/ERVL	2943	+	420	244646098	56797
chr1	16544873	16744873	harbor1	chr1	16560670	16560870	LTR/ERVL	779	+	100	16560770	15897
chr1	227440888	227640888	harbor1	chr1	227444112	227445179	LTR/ERVL	7121	+	534	227444646	3758
chr1	227440888	227640888	harbor1	chr1	227445180	227445567	LTR/ERVL	1998	+	194	227445374	4486
chr1	227440888	227640888	harbor1	chr1	227445872	227445934	LTR/ERVL	1998	+	31	227445903	5015
chr1	227440888	227640888	harbor1	chr1	227453765	227454144	LTR/ERVL	659	+	190	227453955	13067
chr1	16545039	16745039	harbor1	chr1	16560670	16560870	LTR/ERVL	779	+	100	16560770	15731
chr1	16530545	16730545	harbor1	chr1	16560670	16560870	LTR/ERVL	779	+	100	16560770	30225
chr1	53846279	54046279	harbor1	chr1	53890504	53890997	LTR/ERVL	1036	+	246	53890750	44471
chr1	53846279	54046279	harbor1	chr1	53891310	53891620	LTR/ERVL	508	+	155	53891465	45186
chr1	53846279	54046279	harbor1	chr1	53891764	53892293	LTR/ERVL	1258	+	264	53892028	45749
chr1	53846279	54046279	harbor1	chr1	53912961	53913417	LTR/ERVL	2123	+	228	53913189	66910
chr1	53846279	54046279	harbor1	chr1	53929028	53929505	LTR/ERVL	1177	+	238	53929266	82987
chr1	53846338	54046338	harbor1	chr1	53890504	53890997	LTR/ERVL	1036	+	246	53890750	44412
chr1	53846338	54046338	harbor1	chr1	53891310	53891620	LTR/ERVL	508	+	155	53891465	45127
chr1	53846338	54046338	harbor1	chr1	53891764	53892293	LTR/ERVL	1258	+	264	53892028	45690
chr1	53846338	54046338	harbor1	chr1	53912961	53913417	LTR/ERVL	2123	+	228	53913189	66851
chr1	53846338	54046338	harbor1	chr1	53929028	53929505	LTR/ERVL	1177	+	238	53929266	82928
chr1	16543014	16743014	harbor1	chr1	16560670	16560870	LTR/ERVL	779	+	100	16560770	17756
chr1	204585380	204785380	harbor1	chr1	204596576	204596725	LTR/ERVL	483	+	74	204596650	11270
chr1	204585380	204785380	harbor1	chr1	204596855	204597643	LTR/ERVL	2255	+	394	204597249	11869
chr1	16544932	16744932	harbor1	chr1	16560670	16560870	LTR/ERVL	779	+	100	16560770	15838
chr1	211033792	211233792	harbor1	chr1	211067248	211067560	LTR/ERVL	791	+	156	211067404	33612
chr1	211033792	211233792	harbor1	chr1	211074301	211074595	LTR/ERVL	1044	+	147	211074448	40656
chr1	211033792	211233792	harbor1	chr1	211074600	211074993	LTR/ERVL	1575	+	196	211074796	41004
chr1	211033792	211233792	harbor1	chr1	211093920	211094076	LTR/ERVL	730	+	78	211093998	60206
chr1	211033792	211233792	harbor1	chr1	211094405	211094497	LTR/ERVL	730	+	46	211094451	60659
chr1	211033792	211233792	harbor1	chr1	211115321	211115701	LTR/ERVL	3316	+	190	211115511	81719
chr1	211033792	211233792	harbor1	chr1	211115732	211115794	LTR/ERVL	3316	+	31	211115763	81971
chr1	59714670	59914670	harbor1	chr1	59739870	59740144	LTR/ERVL	705	+	137	59740007	25337
chr1	59714670	59914670	harbor1	chr1	59748678	59749547	LTR/ERVL	3440	+	434	59749112	34442
chr1	59714670	59914670	harbor1	chr1	59808730	59809101	LTR/ERVL	1449	+	186	59808916	94246
chr1	59714670	59914670	harbor1	chr1	59785190	59785330	LTR/ERVL	475	+	70	59785260	70590
chr1	244735088	244935088	harbor1	chr1	244795446	244795714	LTR/ERVL	1165	+	134	244795580	60492
chr1	9254542	9454542	harbor1	chr1	9297468	9298369	LTR/ERVL	17410	+	450	9297918	43376
chr1	9254542	9454542	harbor1	chr1	9298476	9299356	LTR/ERVL	17410	+	440	9298916	44374
chr1	9254542	9454542	harbor1	chr1	9299983	9301207	LTR/ERVL	17410	+	612	9300595	46053
chr1	9254542	9454542	harbor1	chr1	9301513	9302091	LTR/ERVL	17410	+	289	9301802	47260
chr1	9254542	9454542	harbor1	chr1	9302116	9302225	LTR/ERVL	525	+	54	9302170	47628
chr1	9254542	9454542	harbor1	chr1	9302227	9302644	LTR/ERVL	2100	+	208	9302435	47893
chr1	9254542	9454542	harbor1	chr1	9302649	9303809	LTR/ERVL	6146	+	580	9303229	48687
chr1	9254542	9454542	harbor1	chr1	9303811	9304444	LTR/ERVL	3510	+	316	9304127	49585
chr1	16544427	16744427	harbor1	chr1	16560670	16560870	LTR/ERVL	779	+	100	16560770	16343
chr1	25516681	25716681	harbor1	chr1	25589380	25589820	LTR/ERVL	2218	+	220	25589600	72919
chr1	25516681	25716681	harbor1	chr1	25590118	25590184	LTR/ERVL	2218	+	33	25590151	73470
chr1	25516681	25716681	harbor1	chr1	25598359	25598749	LTR/ERVL	1106	+	195	25598554	81873
chr1	25516681	25716681	harbor1	chr1	25613656	25614173	LTR/ERVL	3425	+	258	25613914	97233
chr1	116272513	116472513	harbor1	chr1	116334973	116335299	LTR/ERVL	684	+	163	116335136	62623
chr1	116272513	116472513	harbor1	chr1	116347794	116347952	LTR/ERVL	497	+	79	116347873	75360
chr1	244605835	244805835	harbor1	chr1	244644512	244644942	LTR/ERVL	1120	+	215	244644727	38892
chr1	244605835	244805835	harbor1	chr1	244644953	244645618	LTR/ERVL	1325	+	332	244645285	39450
chr1	244605835	244805835	harbor1	chr1	244647978	244648381	LTR/ERVL	590	+	202	244648180	42345
chr1	244605835	244805835	harbor1	chr1	244665526	244665854	LTR/ERVL	1793	+	164	244665690	59855
chr1	244605835	244805835	harbor1	chr1	244696661	244697204	LTR/ERVL	3037	+	272	244696933	91098
chr1	244605835	244805835	harbor1	chr1	244697207	244697225	LTR/ERVL	10237	+	9	244697216	91381
chr1	244605835	244805835	harbor1	chr1	244697494	244699301	LTR/ERVL	10237	+	904	244698398	92563
chr1	244605835	244805835	harbor1	chr1	244699609	244700085	LTR/ERVL	10237	+	238	244699847	94012
chr1	244605835	244805835	harbor1	chr1	244700086	244700259	LTR/ERVL	731	+	86	244700172	94337
chr1	244605835	244805835	harbor1	chr1	244645678	244646518	LTR/ERVL	2943	+	420	244646098	40263
chr1	16545027	16745027	harbor1	chr1	16560670	16560870	LTR/ERVL	779	+	100	16560770	15743
chr1	244605400	244805400	harbor1	chr1	244644512	244644942	LTR/ERVL	1120	+	215	244644727	39327
chr1	244605400	244805400	harbor1	chr1	244644953	244645618	LTR/ERVL	1325	+	332	244645285	39885
chr1	244605400	244805400	harbor1	chr1	244647978	244648381	LTR/ERVL	590	+	202	244648180	42780
chr1	244605400	244805400	harbor1	chr1	244665526	244665854	LTR/ERVL	1793	+	164	244665690	60290
chr1	244605400	244805400	harbor1	chr1	244696661	244697204	LTR/ERVL	3037	+	272	244696933	91533
chr1	244605400	244805400	harbor1	chr1	244697207	244697225	LTR/ERVL	10237	+	9	244697216	91816
chr1	244605400	244805400	harbor1	chr1	244697494	244699301	LTR/ERVL	10237	+	904	244698398	92998
chr1	244605400	244805400	harbor1	chr1	244699609	244700085	LTR/ERVL	10237	+	238	244699847	94447
chr1	244605400	244805400	harbor1	chr1	244700086	244700259	LTR/ERVL	731	+	86	244700172	94772
chr1	244605400	244805400	harbor1	chr1	244645678	244646518	LTR/ERVL	2943	+	420	244646098	40698
chr1	16542903	16742903	harbor1	chr1	16560670	16560870	LTR/ERVL	779	+	100	16560770	17867
chr1	6397828	6597828	harbor1	chr1	6411051	6411736	LTR/ERVL	1562	+	342	6411393	13565
chr1	17019452	17219452	harbor1	chr1	17065877	17066151	LTR/ERVL	815	+	137	17066014	46562
chr1	17019452	17219452	harbor1	chr1	17066461	17066524	LTR/ERVL	815	+	32	17066493	47041
chr1	16544809	16744809	harbor1	chr1	16560670	16560870	LTR/ERVL	779	+	100	16560770	15961
chr1	30662344	30862344	harbor1	chr1	30671164	30671509	LTR/ERVL	1730	+	172	30671336	8992
chr1	30662344	30862344	harbor1	chr1	30728465	30728734	LTR/ERVL	775	+	134	30728599	66255
chr1	30662344	30862344	harbor1	chr1	30737921	30738133	LTR/ERVL	927	+	106	30738027	75683
chr1	30662344	30862344	harbor1	chr1	30738643	30738860	LTR/ERVL	927	+	108	30738751	76407
chr1	51419171	51619171	harbor1	chr1	51426467	51426852	LTR/ERVL	2152	+	192	51426659	7488
chr1	16544989	16744989	harbor1	chr1	16560670	16560870	LTR/ERVL	779	+	100	16560770	15781
chr1	16544731	16744731	harbor1	chr1	16560670	16560870	LTR/ERVL	779	+	100	16560770	16039
chr1	110112132	110312132	harbor1	chr1	110126077	110126221	LTR/ERVL	565	+	72	110126149	14017
chr1	110112132	110312132	harbor1	chr1	110126245	110126551	LTR/ERVL	831	+	153	110126398	14266
chr1	110112132	110312132	harbor1	chr1	110127735	110128026	LTR/ERVL	1122	+	146	110127881	15749
chr1	110112132	110312132	harbor1	chr1	110149022	110149492	LTR/ERVL	1653	+	235	110149257	37125
chr1	16544918	16744918	harbor1	chr1	16560670	16560870	LTR/ERVL	779	+	100	16560770	15852
chr1	726411	926411	harbor1	chr1	741124	741629	LTR/ERVL	3337	+	252	741376	14965
chr1	726411	926411	harbor1	chr1	741937	742006	LTR/ERVL	3337	+	34	741971	15560
chr1	726411	926411	harbor1	chr1	742310	742610	LTR/ERVL	3337	+	150	742460	16049
chr1	726411	926411	harbor1	chr1	752876	753134	LTR/ERVL	3365	+	129	753005	26594
chr1	726411	926411	harbor1	chr1	754046	754345	LTR/ERVL	3365	+	150	754196	27785
chr1	726411	926411	harbor1	chr1	753429	753738	LTR/ERVL	3365	+	154	753583	27172
chr1	24895887	25095887	harbor1	chr1	24986398	24986759	LTR/ERVL	2266	+	180	24986578	90691
chr1	32106047	32306047	harbor1	chr1	32159568	32159659	LTR/ERVL	498	+	46	32159614	53567
chr1	32106047	32306047	harbor1	chr1	32159627	32159846	LTR/ERVL	801	+	110	32159737	53690
chr1	244605782	244805782	harbor1	chr1	244644512	244644942	LTR/ERVL	1120	+	215	244644727	38945
chr1	244605782	244805782	harbor1	chr1	244644953	244645618	LTR/ERVL	1325	+	332	244645285	39503
chr1	244605782	244805782	harbor1	chr1	244647978	244648381	LTR/ERVL	590	+	202	244648180	42398
chr1	244605782	244805782	harbor1	chr1	244665526	244665854	LTR/ERVL	1793	+	164	244665690	59908
chr1	244605782	244805782	harbor1	chr1	244696661	244697204	LTR/ERVL	3037	+	272	244696933	91151
chr1	244605782	244805782	harbor1	chr1	244697207	244697225	LTR/ERVL	10237	+	9	244697216	91434
chr1	244605782	244805782	harbor1	chr1	244697494	244699301	LTR/ERVL	10237	+	904	244698398	92616
chr1	244605782	244805782	harbor1	chr1	244699609	244700085	LTR/ERVL	10237	+	238	244699847	94065
chr1	244605782	244805782	harbor1	chr1	244700086	244700259	LTR/ERVL	731	+	86	244700172	94390
chr1	244605782	244805782	harbor1	chr1	244645678	244646518	LTR/ERVL	2943	+	420	244646098	40316
chr1	20048547	20248547	harbor1	chr1	20055223	20055839	LTR/ERVL	2101	+	308	20055531	6984
chr1	20048547	20248547	harbor1	chr1	20059578	20059762	LTR/ERVL	516	+	92	20059670	11123
chr1	20048547	20248547	harbor1	chr1	20059879	20059997	LTR/ERVL	481	+	59	20059938	11391
chr1	20048547	20248547	harbor1	chr1	20094082	20094704	LTR/ERVL	1345	+	311	20094393	45846
chr1	20048547	20248547	harbor1	chr1	20094722	20095038	LTR/ERVL	884	+	158	20094880	46333
chr1	20048547	20248547	harbor1	chr1	20095194	20096476	LTR/ERVL	4626	+	641	20095835	47288
chr1	20048547	20248547	harbor1	chr1	20096488	20096749	LTR/ERVL	1079	+	130	20096618	48071
chr1	20048547	20248547	harbor1	chr1	20096756	20097380	LTR/ERVL	1329	+	312	20097068	48521
chr1	16544880	16744880	harbor1	chr1	16560670	16560870	LTR/ERVL	779	+	100	16560770	15890
chr1	16544895	16744895	harbor1	chr1	16560670	16560870	LTR/ERVL	779	+	100	16560770	15875
chr1	3845228	4045228	harbor1	chr1	3879943	3880467	LTR/ERVL	1243	+	262	3880205	34977
chr1	3845228	4045228	harbor1	chr1	3932733	3933030	LTR/ERVL	907	+	148	3932881	87653
chr1	3845228	4045228	harbor1	chr1	3931848	3932322	LTR/ERVL	1312	+	237	3932085	86857
chr1	16544752	16744752	harbor1	chr1	16560670	16560870	LTR/ERVL	779	+	100	16560770	16018
chr1	1204941	1404941	harbor1	chr1	1259547	1259908	LTR/ERVL	794	+	180	1259727	54786
chr1	1204941	1404941	harbor1	chr1	1265307	1265513	LTR/ERVL	583	+	103	1265410	60469
chr1	194372730	194572730	harbor1	chr1	194399371	194399466	LTR/ERVL	448	+	48	194399419	26689
chr1	194372730	194572730	harbor1	chr1	194457506	194458042	LTR/ERVL	1822	+	268	194457774	85044
chr1	230025255	230225255	harbor1	chr1	230026253	230026377	LTR/ERVL	891	+	62	230026315	1060
chr1	230025255	230225255	harbor1	chr1	230027051	230027426	LTR/ERVL	2234	+	188	230027239	1984
chr1	230025255	230225255	harbor1	chr1	230032373	230032548	LTR/ERVL	980	+	88	230032461	7206
chr1	230025255	230225255	harbor1	chr1	230048109	230048648	LTR/ERVL	2383	+	270	230048379	23124
chr1	230025255	230225255	harbor1	chr1	230085176	230085618	LTR/ERVL	2649	+	221	230085397	60142
chr1	230025255	230225255	harbor1	chr1	230091825	230092076	LTR/ERVL	695	+	126	230091951	66696
chr1	165531488	165731488	harbor1	chr1	165627025	165627444	LTR/ERVL	3097	+	210	165627235	95747
chr1	222687998	222887998	harbor1	chr1	222752175	222752705	LTR/ERVL	1988	+	265	222752440	64442
chr1	222687998	222887998	harbor1	chr1	222757100	222757334	LTR/ERVL	1921	+	117	222757217	69219
chr1	222687998	222887998	harbor1	chr1	222757640	222757784	LTR/ERVL	1921	+	72	222757712	69714
chr1	153435311	153635311	harbor1	chr1	153466265	153467099	LTR/ERVL	3077	+	417	153466682	31371
chr1	16523548	16723548	harbor1	chr1	16560670	16560870	LTR/ERVL	779	+	100	16560770	37222
chr1	53187531	53387531	harbor1	chr1	53262933	53263107	LTR/ERVL	557	+	87	53263020	75489
chr1	2375370	2575370	harbor1	chr1	2383092	2383334	LTR/ERVL	518	+	121	2383213	7843
chr1	89721428	89921428	harbor1	chr1	89728850	89729141	LTR/ERVL	487	+	146	89728996	7568
chr1	89721428	89921428	harbor1	chr1	89730971	89731379	LTR/ERVL	2221	+	204	89731175	9747
chr1	89721428	89921428	harbor1	chr1	89742627	89742764	LTR/ERVL	708	+	68	89742695	21267
chr1	220687422	220887422	harbor1	chr1	220708196	220708488	LTR/ERVL	2248	+	146	220708342	20920
chr1	220687422	220887422	harbor1	chr1	220708886	220708951	LTR/ERVL	2248	+	32	220708918	21496
chr1	220687422	220887422	harbor1	chr1	220709052	220709615	LTR/ERVL	2279	+	282	220709334	21912
chr1	220687422	220887422	harbor1	chr1	220772902	220773727	LTR/ERVL	3186	+	412	220773314	85892
chr1	6525772	6725772	harbor1	chr1	6558329	6558418	LTR/ERVL	526	+	44	6558373	32601
chr1	6525772	6725772	harbor1	chr1	6559330	6559374	LTR/ERVL	526	+	22	6559352	33580
chr1	6525772	6725772	harbor1	chr1	6570452	6570671	LTR/ERVL	777	+	110	6570562	44790
chr1	2375291	2575291	harbor1	chr1	2383092	2383334	LTR/ERVL	518	+	121	2383213	7922
chr1	53846292	54046292	harbor1	chr1	53890504	53890997	LTR/ERVL	1036	+	246	53890750	44458
chr1	53846292	54046292	harbor1	chr1	53891310	53891620	LTR/ERVL	508	+	155	53891465	45173
chr1	53846292	54046292	harbor1	chr1	53891764	53892293	LTR/ERVL	1258	+	264	53892028	45736
chr1	53846292	54046292	harbor1	chr1	53912961	53913417	LTR/ERVL	2123	+	228	53913189	66897
chr1	53846292	54046292	harbor1	chr1	53929028	53929505	LTR/ERVL	1177	+	238	53929266	82974
chr1	207924797	208124797	harbor1	chr1	207992024	207992113	LTR/ERVL	1735	+	44	207992068	67271
chr1	207924797	208124797	harbor1	chr1	207992420	207992705	LTR/ERVL	1735	+	142	207992562	67765
chr1	207924797	208124797	harbor1	chr1	208017627	208017985	LTR/ERVL	2264	+	179	208017806	93009
chr1	207924797	208124797	harbor1	chr1	208018038	208018085	LTR/ERVL	2264	+	24	208018062	93265
chr1	1247301	1447301	harbor1	chr1	1259547	1259908	LTR/ERVL	794	+	180	1259727	12426
chr1	1247301	1447301	harbor1	chr1	1265307	1265513	LTR/ERVL	583	+	103	1265410	18109
chr1	43447553	43647553	harbor1	chr1	43465255	43465474	LTR/ERVL	601	+	110	43465365	17812
chr1	43447553	43647553	harbor1	chr1	43465486	43465620	LTR/ERVL	485	+	67	43465553	18000
chr1	43447553	43647553	harbor1	chr1	43475797	43476063	LTR/ERVL	630	+	133	43475930	28377
chr1	43447553	43647553	harbor1	chr1	43512809	43513353	LTR/ERVL	1189	+	272	43513081	65528
chr1	43447553	43647553	harbor1	chr1	43521788	43522217	LTR/ERVL	1254	+	214	43522002	74449
chr1	53846310	54046310	harbor1	chr1	53890504	53890997	LTR/ERVL	1036	+	246	53890750	44440
chr1	53846310	54046310	harbor1	chr1	53891310	53891620	LTR/ERVL	508	+	155	53891465	45155
chr1	53846310	54046310	harbor1	chr1	53891764	53892293	LTR/ERVL	1258	+	264	53892028	45718
chr1	53846310	54046310	harbor1	chr1	53912961	53913417	LTR/ERVL	2123	+	228	53913189	66879
chr1	53846310	54046310	harbor1	chr1	53929028	53929505	LTR/ERVL	1177	+	238	53929266	82956
chr1	6160375	6360375	harbor1	chr1	6200566	6201073	LTR/ERVL	743	+	254	6200820	40445
chr1	25773550	25973550	harbor1	chr1	25848517	25849083	LTR/ERVL	2011	+	283	25848800	75250
chr1	16544750	16744750	harbor1	chr1	16560670	16560870	LTR/ERVL	779	+	100	16560770	16020
chr1	2375268	2575268	harbor1	chr1	2383092	2383334	LTR/ERVL	518	+	121	2383213	7945
chr1	26400758	26600758	harbor1	chr1	26496945	26497334	LTR/ERVL	993	+	194	26497139	96381
chr1	13663032	13863032	harbor1	chr1	13684986	13685376	LTR/ERVL	1004	+	195	13685181	22149
chr1	40761841	40961841	harbor1	chr1	40857375	40857433	LTR/ERVL	1683	+	29	40857404	95563
chr1	40761841	40961841	harbor1	chr1	40857743	40858139	LTR/ERVL	1683	+	198	40857941	96100
chr1	230759103	230959103	harbor1	chr1	230764090	230764531	LTR/ERVL	2539	+	220	230764310	5207
chr1	16544828	16744828	harbor1	chr1	16560670	16560870	LTR/ERVL	779	+	100	16560770	15942
chr1	13662918	13862918	harbor1	chr1	13684986	13685376	LTR/ERVL	1004	+	195	13685181	22263
chr1	16544915	16744915	harbor1	chr1	16560670	16560870	LTR/ERVL	779	+	100	16560770	15855
chr1	31972870	32172870	harbor1	chr1	32009055	32009614	LTR/ERVL	2916	+	280	32009335	36465
chr1	16544721	16744721	harbor1	chr1	16560670	16560870	LTR/ERVL	779	+	100	16560770	16049
chr1	205329484	205529484	harbor1	chr1	205400557	205400689	LTR/ERVL	725	+	66	205400623	71139
chr1	205329484	205529484	harbor1	chr1	205406860	205407049	LTR/ERVL	3417	+	94	205406954	77470
chr1	205329484	205529484	harbor1	chr1	205407350	205407951	LTR/ERVL	3417	+	300	205407650	78166
chr1	2375306	2575306	harbor1	chr1	2383092	2383334	LTR/ERVL	518	+	121	2383213	7907
chr1	13672401	13872401	harbor1	chr1	13684986	13685376	LTR/ERVL	1004	+	195	13685181	12780
chr1	248592141	248792141	harbor1	chr1	248670264	248670680	LTR/ERVL	2316	+	208	248670472	78331
chr1	244605833	244805833	harbor1	chr1	244644512	244644942	LTR/ERVL	1120	+	215	244644727	38894
chr1	244605833	244805833	harbor1	chr1	244644953	244645618	LTR/ERVL	1325	+	332	244645285	39452
chr1	244605833	244805833	harbor1	chr1	244647978	244648381	LTR/ERVL	590	+	202	244648180	42347
chr1	244605833	244805833	harbor1	chr1	244665526	244665854	LTR/ERVL	1793	+	164	244665690	59857
chr1	244605833	244805833	harbor1	chr1	244696661	244697204	LTR/ERVL	3037	+	272	244696933	91100
chr1	244605833	244805833	harbor1	chr1	244697207	244697225	LTR/ERVL	10237	+	9	244697216	91383
chr1	244605833	244805833	harbor1	chr1	244697494	244699301	LTR/ERVL	10237	+	904	244698398	92565
chr1	244605833	244805833	harbor1	chr1	244699609	244700085	LTR/ERVL	10237	+	238	244699847	94014
chr1	244605833	244805833	harbor1	chr1	244700086	244700259	LTR/ERVL	731	+	86	244700172	94339
chr1	244605833	244805833	harbor1	chr1	244645678	244646518	LTR/ERVL	2943	+	420	244646098	40265
chr1	40913010	41113010	harbor1	chr1	40960559	40960815	LTR/ERVL	2236	+	128	40960687	47677
chr1	40913010	41113010	harbor1	chr1	40961126	40961306	LTR/ERVL	2236	+	90	40961216	48206
chr1	40913010	41113010	harbor1	chr1	40961600	40961732	LTR/ERVL	2236	+	66	40961666	48656
chr1	40913010	41113010	harbor1	chr1	40966155	40966664	LTR/ERVL	1998	+	254	40966409	53399
chr1	234508642	234708642	harbor1	chr1	234541781	234542200	LTR/ERVL	1788	+	210	234541991	33349
chr1	234508642	234708642	harbor1	chr1	234570803	234571225	LTR/ERVL	1550	+	211	234571014	62372
chr1	234508642	234708642	harbor1	chr1	234590398	234590847	LTR/ERVL	2284	+	224	234590622	81980
chr1	211033696	211233696	harbor1	chr1	211067248	211067560	LTR/ERVL	791	+	156	211067404	33708
chr1	211033696	211233696	harbor1	chr1	211074301	211074595	LTR/ERVL	1044	+	147	211074448	40752
chr1	211033696	211233696	harbor1	chr1	211074600	211074993	LTR/ERVL	1575	+	196	211074796	41100
chr1	211033696	211233696	harbor1	chr1	211093920	211094076	LTR/ERVL	730	+	78	211093998	60302
chr1	211033696	211233696	harbor1	chr1	211094405	211094497	LTR/ERVL	730	+	46	211094451	60755
chr1	211033696	211233696	harbor1	chr1	211115321	211115701	LTR/ERVL	3316	+	190	211115511	81815
chr1	211033696	211233696	harbor1	chr1	211115732	211115794	LTR/ERVL	3316	+	31	211115763	82067
chr1	24895890	25095890	harbor1	chr1	24986398	24986759	LTR/ERVL	2266	+	180	24986578	90688
chr1	16545016	16745016	harbor1	chr1	16560670	16560870	LTR/ERVL	779	+	100	16560770	15754
chr1	16512786	16712786	harbor1	chr1	16560670	16560870	LTR/ERVL	779	+	100	16560770	47984
chr1	6351794	6551794	harbor1	chr1	6411051	6411736	LTR/ERVL	1562	+	342	6411393	59599
chr1	226307818	226507818	harbor1	chr1	226325545	226325719	LTR/ERVL	552	+	87	226325632	17814
chr1	226307818	226507818	harbor1	chr1	226326806	226327041	LTR/ERVL	1166	+	118	226326924	19106
chr1	226307818	226507818	harbor1	chr1	226328134	226328182	LTR/ERVL	1166	+	24	226328158	20340
chr1	226307818	226507818	harbor1	chr1	226328495	226328619	LTR/ERVL	1166	+	62	226328557	20739
chr1	54786918	54986918	harbor1	chr1	54845389	54845735	LTR/ERVL	1516	+	173	54845562	58644
chr1	54786918	54986918	harbor1	chr1	54847309	54847813	LTR/ERVL	2410	+	252	54847561	60643
chr1	54786918	54986918	harbor1	chr1	54848145	54848205	LTR/ERVL	1903	+	30	54848175	61257
chr1	54786918	54986918	harbor1	chr1	54858128	54858425	LTR/ERVL	834	+	148	54858276	71358
chr2	196073592	196273592	harbor1	chr2	196097023	196097811	LTR/ERVL	2119	+	394	196097417	23825
chr2	218221236	218421236	harbor1	chr2	218303899	218304152	LTR/ERVL	718	+	126	218304025	82789
chr2	218221236	218421236	harbor1	chr2	218304444	218304632	LTR/ERVL	718	+	94	218304538	83302
chr2	86976337	87176337	harbor1	chr2	87056265	87056391	LTR/ERVL	1226	+	63	87056328	79991
chr2	86976337	87176337	harbor1	chr2	87056733	87056850	LTR/ERVL	1226	+	58	87056791	80454
chr2	86976337	87176337	harbor1	chr2	87057058	87057218	LTR/ERVL	862	+	80	87057138	80801
chr2	53759964	53959964	harbor1	chr2	53761402	53761792	LTR/ERVL	1747	+	195	53761597	1633
chr2	53759964	53959964	harbor1	chr2	53846882	53847234	LTR/ERVL	441	+	176	53847058	87094
chr2	53759964	53959964	harbor1	chr2	53847504	53847622	LTR/ERVL	441	+	59	53847563	87599
chr2	53759964	53959964	harbor1	chr2	53848009	53848436	LTR/ERVL	840	+	214	53848223	88259
chr2	63488508	63688508	harbor1	chr2	63527085	63527224	LTR/ERVL	508	+	70	63527155	38647
chr2	63488508	63688508	harbor1	chr2	63530439	63530715	LTR/ERVL	978	+	138	63530577	42069
chr2	983577	1183577	harbor1	chr2	1061339	1061804	LTR/ERVL	1373	+	232	1061571	77994
chr2	15464442	15664442	harbor1	chr2	15472082	15472411	LTR/ERVL	612	+	164	15472246	7804
chr2	15464442	15664442	harbor1	chr2	15472624	15472936	LTR/ERVL	1244	+	156	15472780	8338
chr2	158868018	159068018	harbor1	chr2	158912795	158913019	LTR/ERVL	2143	+	112	158912907	44889
chr2	158868018	159068018	harbor1	chr2	158913308	158913571	LTR/ERVL	2143	+	132	158913440	45422
chr2	158868018	159068018	harbor1	chr2	158955915	158956409	LTR/ERVL	961	+	247	158956162	88144
chr2	175979735	176179735	harbor1	chr2	176019125	176019514	LTR/ERVL	1001	+	194	176019319	39584
chr2	42069399	42269399	harbor1	chr2	42092222	42092519	LTR/ERVL	1205	+	148	42092370	22971
chr2	42069399	42269399	harbor1	chr2	42092593	42092764	LTR/ERVL	936	+	86	42092679	23280
chr2	42033084	42233084	harbor1	chr2	42092222	42092519	LTR/ERVL	1205	+	148	42092370	59286
chr2	42033084	42233084	harbor1	chr2	42092593	42092764	LTR/ERVL	936	+	86	42092679	59595
chr2	84760927	84960927	harbor1	chr2	84768930	84769369	LTR/ERVL	1033	+	220	84769150	8223
chr2	219383264	219583264	harbor1	chr2	219390955	219391314	LTR/ERVL	1248	+	180	219391135	7871
chr2	85461791	85661791	harbor1	chr2	85513464	85513895	LTR/ERVL	767	+	216	85513680	51889
chr2	31910614	32110614	harbor1	chr2	31962772	31963268	LTR/ERVL	2282	+	248	31963020	52406
chr2	71780774	71980774	harbor1	chr2	71842278	71842706	LTR/ERVL	1018	+	214	71842492	61718
chr2	53759991	53959991	harbor1	chr2	53761402	53761792	LTR/ERVL	1747	+	195	53761597	1606
chr2	53759991	53959991	harbor1	chr2	53846882	53847234	LTR/ERVL	441	+	176	53847058	87067
chr2	53759991	53959991	harbor1	chr2	53847504	53847622	LTR/ERVL	441	+	59	53847563	87572
chr2	53759991	53959991	harbor1	chr2	53848009	53848436	LTR/ERVL	840	+	214	53848223	88232
chr2	219335190	219535190	harbor1	chr2	219345124	219345683	LTR/ERVL	860	+	280	219345404	10214
chr2	219335190	219535190	harbor1	chr2	219390955	219391314	LTR/ERVL	1248	+	180	219391135	55945
chr2	47682917	47882917	harbor1	chr2	47711099	47711200	LTR/ERVL	498	+	50	47711149	28232
chr2	47682917	47882917	harbor1	chr2	47709930	47710215	LTR/ERVL	1677	+	142	47710072	27155
chr2	46198512	46398512	harbor1	chr2	46291764	46292092	LTR/ERVL	527	+	164	46291928	93416
chr2	111955709	112155709	harbor1	chr2	111991925	111992055	LTR/ERVL	513	+	65	111991990	36281
chr2	111955709	112155709	harbor1	chr2	111992036	111992470	LTR/ERVL	3043	+	217	111992253	36544
chr2	111955709	112155709	harbor1	chr2	111992781	111993158	LTR/ERVL	3043	+	188	111992969	37260
chr2	111955709	112155709	harbor1	chr2	112047473	112047825	LTR/ERVL	1336	+	176	112047649	91940
chr2	111955709	112155709	harbor1	chr2	112048212	112048303	LTR/ERVL	1336	+	46	112048258	92549
chr2	46198543	46398543	harbor1	chr2	46291764	46292092	LTR/ERVL	527	+	164	46291928	93385
chr2	46198523	46398523	harbor1	chr2	46291764	46292092	LTR/ERVL	527	+	164	46291928	93405
chr2	86976362	87176362	harbor1	chr2	87056265	87056391	LTR/ERVL	1226	+	63	87056328	79966
chr2	86976362	87176362	harbor1	chr2	87056733	87056850	LTR/ERVL	1226	+	58	87056791	80429
chr2	86976362	87176362	harbor1	chr2	87057058	87057218	LTR/ERVL	862	+	80	87057138	80776
chr2	129830912	130030912	harbor1	chr2	129913960	129914252	LTR/ERVL	594	+	146	129914106	83194
chr2	70771149	70971149	harbor1	chr2	70771784	70772105	LTR/ERVL	1228	+	160	70771944	795
chr2	70771149	70971149	harbor1	chr2	70774042	70774346	LTR/ERVL	721	+	152	70774194	3045
chr2	70771149	70971149	harbor1	chr2	70821185	70821726	LTR/ERVL	1873	+	270	70821455	50306
chr2	70771149	70971149	harbor1	chr2	70822059	70822288	LTR/ERVL	1873	+	114	70822173	51024
chr2	70771149	70971149	harbor1	chr2	70850061	70850324	LTR/ERVL	512	+	132	70850193	79044
chr2	60880293	61080293	harbor1	chr2	60957288	60957515	LTR/ERVL	1091	+	114	60957402	77109
chr2	60880293	61080293	harbor1	chr2	60957511	60957801	LTR/ERVL	1615	+	145	60957656	77363
chr2	60880293	61080293	harbor1	chr2	60957803	60958158	LTR/ERVL	2248	+	178	60957981	77688
chr2	9945874	10145874	harbor1	chr2	10003790	10004183	LTR/ERVL	1035	+	196	10003986	58112
chr2	9945874	10145874	harbor1	chr2	10004987	10005150	LTR/ERVL	652	+	82	10005069	59195
chr2	9945874	10145874	harbor1	chr2	10005162	10005518	LTR/ERVL	1675	+	178	10005340	59466
chr2	9945874	10145874	harbor1	chr2	10022504	10022815	LTR/ERVL	866	+	156	10022660	76786
chr2	30046187	30246187	harbor1	chr2	30053020	30053442	LTR/ERVL	1366	+	211	30053231	7044
chr2	30046187	30246187	harbor1	chr2	30078646	30078879	LTR/ERVL	2072	+	116	30078762	32575
chr2	30046187	30246187	harbor1	chr2	30079172	30079589	LTR/ERVL	2072	+	208	30079380	33193
chr2	30046187	30246187	harbor1	chr2	30087030	30087261	LTR/ERVL	574	+	116	30087146	40959
chr2	30046187	30246187	harbor1	chr2	30087417	30087611	LTR/ERVL	961	+	97	30087514	41327
chr2	30046187	30246187	harbor1	chr2	30095983	30096025	LTR/ERVL	1755	+	21	30096004	49817
chr2	30046187	30246187	harbor1	chr2	30096339	30096896	LTR/ERVL	1755	+	278	30096617	50430
chr2	30046187	30246187	harbor1	chr2	30112625	30113166	LTR/ERVL	2512	+	270	30112895	66708
chr2	30046187	30246187	harbor1	chr2	30121020	30121456	LTR/ERVL	970	+	218	30121238	75051
chr2	30046187	30246187	harbor1	chr2	30129650	30129954	LTR/ERVL	723	+	152	30129802	83615
chr2	72971135	73171135	harbor1	chr2	72994297	72994549	LTR/ERVL	456	+	126	72994423	23288
chr2	72046074	72246074	harbor1	chr2	72074203	72074507	LTR/ERVL	695	+	152	72074355	28281
chr2	152250414	152450414	harbor1	chr2	152273167	152273627	LTR/ERVL	2135	+	230	152273397	22983
chr2	152250414	152450414	harbor1	chr2	152279763	152279874	LTR/ERVL	717	+	56	152279819	29405
chr2	152250414	152450414	harbor1	chr2	152330516	152330947	LTR/ERVL	1970	+	216	152330732	80318
chr2	66333430	66533430	harbor1	chr2	66345834	66346161	LTR/ERVL	995	+	164	66345998	12568
chr2	66333430	66533430	harbor1	chr2	66399252	66399573	LTR/ERVL	1972	+	160	66399412	65982
chr2	66333430	66533430	harbor1	chr2	66399702	66399847	LTR/ERVL	794	+	72	66399774	66344
chr2	85502391	85702391	harbor1	chr2	85513464	85513895	LTR/ERVL	767	+	216	85513680	11289
chr2	131392202	131592202	harbor1	chr2	131415432	131415878	LTR/ERVL	1316	+	223	131415655	23453
chr2	131392202	131592202	harbor1	chr2	131485198	131485689	LTR/ERVL	1984	+	246	131485444	93242
chr2	22969090	23169090	harbor1	chr2	22973165	22973614	LTR/ERVL	3408	+	224	22973389	4299
chr2	22969090	23169090	harbor1	chr2	22978861	22979574	LTR/ERVL	2669	+	356	22979217	10127
chr2	217888302	218088302	harbor1	chr2	217961773	217962131	LTR/ERVL	1747	+	179	217961952	73650
chr2	217888302	218088302	harbor1	chr2	217983833	217984250	LTR/ERVL	2135	+	208	217984041	95739
chr2	21176381	21376381	harbor1	chr2	21179421	21179887	LTR/ERVL	1715	+	233	21179654	3273
chr2	21176381	21376381	harbor1	chr2	21237363	21237702	LTR/ERVL	1757	+	170	21237533	61152
chr2	21176381	21376381	harbor1	chr2	21267449	21267713	LTR/ERVL	724	+	132	21267581	91200
chr2	237589573	237789573	harbor1	chr2	237602391	237602641	LTR/ERVL	1242	+	125	237602516	12943
chr2	237589573	237789573	harbor1	chr2	237602647	237603178	LTR/ERVL	2879	+	266	237602913	13340
chr2	237589573	237789573	harbor1	chr2	237632247	237632450	LTR/ERVL	450	+	102	237632349	42776
chr2	218773740	218973740	harbor1	chr2	218798919	218799127	LTR/ERVL	1484	+	104	218799023	25283
chr2	218773740	218973740	harbor1	chr2	218799636	218799739	LTR/ERVL	1484	+	52	218799688	25948
chr2	218773740	218973740	harbor1	chr2	218851377	218851739	LTR/ERVL	951	+	181	218851558	77818
chr2	85502849	85702849	harbor1	chr2	85513464	85513895	LTR/ERVL	767	+	216	85513680	10831
chr2	56085032	56285032	harbor1	chr2	56169031	56169532	LTR/ERVL	1790	+	250	56169281	84249
chr2	46198453	46398453	harbor1	chr2	46291764	46292092	LTR/ERVL	527	+	164	46291928	93475
chr2	46198517	46398517	harbor1	chr2	46291764	46292092	LTR/ERVL	527	+	164	46291928	93411
chr2	200971419	201171419	harbor1	chr2	201004116	201004733	LTR/ERVL	4691	+	308	201004424	33005
chr2	200971419	201171419	harbor1	chr2	201005037	201005824	LTR/ERVL	4691	+	394	201005431	34012
chr2	200971419	201171419	harbor1	chr2	201006437	201006694	LTR/ERVL	4691	+	128	201006565	35146
chr2	200971419	201171419	harbor1	chr2	201007572	201008193	LTR/ERVL	2098	+	310	201007882	36463
chr2	200971419	201171419	harbor1	chr2	201054192	201054425	LTR/ERVL	981	+	116	201054308	82889
chr2	200971419	201171419	harbor1	chr2	201055724	201055779	LTR/ERVL	850	+	28	201055752	84333
chr2	200971419	201171419	harbor1	chr2	201056224	201056393	LTR/ERVL	965	+	84	201056308	84889
chr2	200971419	201171419	harbor1	chr2	201056694	201056818	LTR/ERVL	965	+	62	201056756	85337
chr2	200971419	201171419	harbor1	chr2	201057036	201057225	LTR/ERVL	687	+	94	201057130	85711
chr2	200971419	201171419	harbor1	chr2	201057584	201057807	LTR/ERVL	654	+	112	201057696	86277
chr2	200971419	201171419	harbor1	chr2	201058834	201059293	LTR/ERVL	2159	+	230	201059064	87645
chr2	46198560	46398560	harbor1	chr2	46291764	46292092	LTR/ERVL	527	+	164	46291928	93368
chr2	72971209	73171209	harbor1	chr2	72994297	72994549	LTR/ERVL	456	+	126	72994423	23214
chr2	42971427	43171427	harbor1	chr2	43010107	43010530	LTR/ERVL	1011	+	212	43010319	38892
chr2	74405689	74605689	harbor1	chr2	74407004	74407322	LTR/ERVL	927	+	159	74407163	1474
chr2	74405689	74605689	harbor1	chr2	74407632	74407711	LTR/ERVL	927	+	40	74407672	1983
chr2	72043426	72243426	harbor1	chr2	72074203	72074507	LTR/ERVL	695	+	152	72074355	30929
chr2	231861900	232061900	harbor1	chr2	231890950	231891551	LTR/ERVL	3856	+	300	231891250	29350
chr2	156336151	156536151	harbor1	chr2	156345566	156345762	LTR/ERVL	799	+	98	156345664	9513
chr2	156336151	156536151	harbor1	chr2	156345775	156346002	LTR/ERVL	762	+	114	156345889	9738
chr2	1486893	1686893	harbor1	chr2	1544499	1545024	LTR/ERVL	1868	+	262	1544761	57868
chr2	1486893	1686893	harbor1	chr2	1575467	1575751	LTR/ERVL	803	+	142	1575609	88716
chr2	111023146	111223146	harbor1	chr2	111090807	111091346	LTR/ERVL	713	+	270	111091077	67931
chr2	69729666	69929666	harbor1	chr2	69729829	69730057	LTR/ERVL	635	+	114	69729943	277
chr2	69729666	69929666	harbor1	chr2	69730198	69730219	LTR/ERVL	635	+	10	69730208	542
chr2	69729666	69929666	harbor1	chr2	69730505	69730824	LTR/ERVL	701	+	160	69730665	999
chr2	64294495	64494495	harbor1	chr2	64341654	64341993	LTR/ERVL	1026	+	170	64341824	47329
chr2	64294495	64494495	harbor1	chr2	64342414	64342551	LTR/ERVL	1026	+	68	64342482	47987
chr2	64294495	64494495	harbor1	chr2	64343699	64343831	LTR/ERVL	480	+	66	64343765	49270
chr2	64294495	64494495	harbor1	chr2	64345085	64345603	LTR/ERVL	1026	+	259	64345344	50849
chr2	64294495	64494495	harbor1	chr2	64361350	64361789	LTR/ERVL	1112	+	220	64361570	67075
chr2	85502856	85702856	harbor1	chr2	85513464	85513895	LTR/ERVL	767	+	216	85513680	10824
chr2	204956154	205156154	harbor1	chr2	204985361	204985819	LTR/ERVL	550	+	229	204985590	29436
chr2	204956154	205156154	harbor1	chr2	204986127	204986176	LTR/ERVL	550	+	24	204986151	29997
chr2	204956154	205156154	harbor1	chr2	205042254	205042697	LTR/ERVL	767	+	222	205042476	86322
chr2	95924862	96124862	harbor1	chr2	95972074	95972624	LTR/ERVL	2355	+	275	95972349	47487
chr2	175979808	176179808	harbor1	chr2	176019125	176019514	LTR/ERVL	1001	+	194	176019319	39511
chr2	89546776	89746776	harbor1	chr2	89593228	89593308	LTR/ERVL	524	+	40	89593268	46492
chr2	239594717	239794717	harbor1	chr2	239612269	239612714	LTR/ERVL	1193	+	222	239612491	17774
chr2	239594717	239794717	harbor1	chr2	239670356	239670553	LTR/ERVL	539	+	98	239670454	75737
chr2	239594717	239794717	harbor1	chr2	239670631	239670787	LTR/ERVL	624	+	78	239670709	75992
chr2	119120408	119320408	harbor1	chr2	119177292	119177536	LTR/ERVL	530	+	122	119177414	57006
chr2	119120408	119320408	harbor1	chr2	119190438	119190710	LTR/ERVL	521	+	136	119190574	70166
chr2	119120408	119320408	harbor1	chr2	119209211	119209379	LTR/ERVL	556	+	84	119209295	88887
chr2	61805680	62005680	harbor1	chr2	61846579	61846871	LTR/ERVL	1195	+	146	61846725	41045
chr2	61805680	62005680	harbor1	chr2	61862980	61863168	LTR/ERVL	536	+	94	61863074	57394
chr2	61805680	62005680	harbor1	chr2	61863375	61863441	LTR/ERVL	5329	+	33	61863408	57728
chr2	61805680	62005680	harbor1	chr2	61863723	61864768	LTR/ERVL	5329	+	522	61864245	58565
chr2	61805680	62005680	harbor1	chr2	61865071	61865106	LTR/ERVL	4824	+	18	61865089	59409
chr2	61805680	62005680	harbor1	chr2	61865118	61865287	LTR/ERVL	851	+	84	61865202	59522
chr2	70771714	70971714	harbor1	chr2	70771784	70772105	LTR/ERVL	1228	+	160	70771944	230
chr2	70771714	70971714	harbor1	chr2	70774042	70774346	LTR/ERVL	721	+	152	70774194	2480
chr2	70771714	70971714	harbor1	chr2	70821185	70821726	LTR/ERVL	1873	+	270	70821455	49741
chr2	70771714	70971714	harbor1	chr2	70822059	70822288	LTR/ERVL	1873	+	114	70822173	50459
chr2	70771714	70971714	harbor1	chr2	70850061	70850324	LTR/ERVL	512	+	132	70850193	78479
chr2	218914258	219114258	harbor1	chr2	218928982	218929185	LTR/ERVL	833	+	102	218929084	14826
chr2	53759983	53959983	harbor1	chr2	53761402	53761792	LTR/ERVL	1747	+	195	53761597	1614
chr2	53759983	53959983	harbor1	chr2	53846882	53847234	LTR/ERVL	441	+	176	53847058	87075
chr2	53759983	53959983	harbor1	chr2	53847504	53847622	LTR/ERVL	441	+	59	53847563	87580
chr2	53759983	53959983	harbor1	chr2	53848009	53848436	LTR/ERVL	840	+	214	53848223	88240
chr2	42069583	42269583	harbor1	chr2	42092222	42092519	LTR/ERVL	1205	+	148	42092370	22787
chr2	42069583	42269583	harbor1	chr2	42092593	42092764	LTR/ERVL	936	+	86	42092679	23096
chr2	158868003	159068003	harbor1	chr2	158912795	158913019	LTR/ERVL	2143	+	112	158912907	44904
chr2	158868003	159068003	harbor1	chr2	158913308	158913571	LTR/ERVL	2143	+	132	158913440	45437
chr2	158868003	159068003	harbor1	chr2	158955915	158956409	LTR/ERVL	961	+	247	158956162	88159
chr2	97589114	97789114	harbor1	chr2	97634421	97634685	LTR/ERVL	730	+	132	97634553	45439
chr2	97589114	97789114	harbor1	chr2	97634901	97634952	LTR/ERVL	539	+	26	97634927	45813
chr2	72971106	73171106	harbor1	chr2	72994297	72994549	LTR/ERVL	456	+	126	72994423	23317
chr2	27395167	27595167	harbor1	chr2	27415916	27415996	LTR/ERVL	917	+	40	27415956	20789
chr2	27395167	27595167	harbor1	chr2	27416294	27416514	LTR/ERVL	917	+	110	27416404	21237
chr2	27395167	27595167	harbor1	chr2	27416809	27416819	LTR/ERVL	917	+	5	27416814	21647
chr2	27395167	27595167	harbor1	chr2	27417095	27417246	LTR/ERVL	917	+	76	27417171	22004
chr2	27395167	27595167	harbor1	chr2	27452008	27452474	LTR/ERVL	2430	+	233	27452241	57074
chr2	46198514	46398514	harbor1	chr2	46291764	46292092	LTR/ERVL	527	+	164	46291928	93414
chr2	983530	1183530	harbor1	chr2	1061339	1061804	LTR/ERVL	1373	+	232	1061571	78041
chr2	42069420	42269420	harbor1	chr2	42092222	42092519	LTR/ERVL	1205	+	148	42092370	22950
chr2	42069420	42269420	harbor1	chr2	42092593	42092764	LTR/ERVL	936	+	86	42092679	23259
chr2	217614103	217814103	harbor1	chr2	217623426	217623546	LTR/ERVL	544	+	60	217623486	9383
chr2	217614103	217814103	harbor1	chr2	217623547	217623918	LTR/ERVL	1886	+	186	217623733	9630
chr2	217614103	217814103	harbor1	chr2	217623956	217623995	LTR/ERVL	1886	+	20	217623976	9873
chr2	217614103	217814103	harbor1	chr2	217623996	217624048	LTR/ERVL	544	+	26	217624022	9919
chr2	217614103	217814103	harbor1	chr2	217629642	217629979	LTR/ERVL	672	+	168	217629810	15707
chr2	217614103	217814103	harbor1	chr2	217636294	217636497	LTR/ERVL	742	+	102	217636396	22293
chr2	217614103	217814103	harbor1	chr2	217636609	217636747	LTR/ERVL	742	+	69	217636678	22575
chr2	217614103	217814103	harbor1	chr2	217650806	217651158	LTR/ERVL	1055	+	176	217650982	36879
chr2	217614103	217814103	harbor1	chr2	217657300	217657722	LTR/ERVL	814	+	211	217657511	43408
chr2	217614103	217814103	harbor1	chr2	217662856	217663180	LTR/ERVL	1302	+	162	217663018	48915
chr2	217614103	217814103	harbor1	chr2	217689150	217689448	LTR/ERVL	1264	+	149	217689299	75196
chr2	94934942	95134942	harbor1	chr2	94996529	94997248	LTR/ERVL	3077	+	360	94996889	61947
chr2	94934942	95134942	harbor1	chr2	95013207	95013678	LTR/ERVL	2075	+	236	95013443	78501
chr2	94934942	95134942	harbor1	chr2	95014043	95014492	LTR/ERVL	1910	+	224	95014267	79325
chr2	94934942	95134942	harbor1	chr2	95014882	95015086	LTR/ERVL	792	+	102	95014984	80042
chr2	94934942	95134942	harbor1	chr2	95015093	95015540	LTR/ERVL	2141	+	224	95015317	80375
chr2	97564374	97764374	harbor1	chr2	97570309	97570858	LTR/ERVL	2380	+	274	97570583	6209
chr2	97564374	97764374	harbor1	chr2	97634421	97634685	LTR/ERVL	730	+	132	97634553	70179
chr2	97564374	97764374	harbor1	chr2	97634901	97634952	LTR/ERVL	539	+	26	97634927	70553
chr2	111955759	112155759	harbor1	chr2	111991925	111992055	LTR/ERVL	513	+	65	111991990	36231
chr2	111955759	112155759	harbor1	chr2	111992036	111992470	LTR/ERVL	3043	+	217	111992253	36494
chr2	111955759	112155759	harbor1	chr2	111992781	111993158	LTR/ERVL	3043	+	188	111992969	37210
chr2	111955759	112155759	harbor1	chr2	112047473	112047825	LTR/ERVL	1336	+	176	112047649	91890
chr2	111955759	112155759	harbor1	chr2	112048212	112048303	LTR/ERVL	1336	+	46	112048258	92499
chr2	217374869	217574869	harbor1	chr2	217401087	217401472	LTR/ERVL	573	+	192	217401279	26410
chr2	112779792	112979792	harbor1	chr2	112864735	112865462	LTR/ERVL	2033	+	364	112865099	85307
chr2	217726903	217926903	harbor1	chr2	217732673	217733143	LTR/ERVL	1485	+	235	217732908	6005
chr2	217726903	217926903	harbor1	chr2	217770591	217770773	LTR/ERVL	845	+	91	217770682	43779
chr2	217726903	217926903	harbor1	chr2	217770819	217771410	LTR/ERVL	1673	+	296	217771115	44212
chr2	217726903	217926903	harbor1	chr2	217771635	217772071	LTR/ERVL	460	+	218	217771853	44950
chr2	217726903	217926903	harbor1	chr2	217772082	217772627	LTR/ERVL	1006	+	272	217772354	45451
chr2	217726903	217926903	harbor1	chr2	217825145	217825468	LTR/ERVL	478	+	162	217825307	98404
chr3	127489937	127689937	harbor1	chr3	127527079	127527488	LTR/ERVL	1203	+	204	127527283	37346
chr3	127489937	127689937	harbor1	chr3	127540128	127540464	LTR/ERVL	1450	+	168	127540296	50359
chr3	138334620	138534620	harbor1	chr3	138334856	138335364	LTR/ERVL	2026	+	254	138335110	490
chr3	138334620	138534620	harbor1	chr3	138339350	138339522	LTR/ERVL	628	+	86	138339436	4816
chr3	138334620	138534620	harbor1	chr3	138341428	138341708	LTR/ERVL	921	+	140	138341568	6948
chr3	138334620	138534620	harbor1	chr3	138424814	138425205	LTR/ERVL	2189	+	196	138425010	90390
chr3	138334620	138534620	harbor1	chr3	138425754	138425846	LTR/ERVL	2189	+	46	138425800	91180
chr3	49071722	49271722	harbor1	chr3	49170199	49170644	LTR/ERVL	1232	+	222	49170421	98699
chr3	49071623	49271623	harbor1	chr3	49170199	49170644	LTR/ERVL	1232	+	222	49170421	98798
chr3	42586603	42786603	harbor1	chr3	42671392	42671905	LTR/ERVL	3075	+	256	42671648	85045
chr3	49071690	49271690	harbor1	chr3	49170199	49170644	LTR/ERVL	1232	+	222	49170421	98731
chr3	46799563	46999563	harbor1	chr3	46816558	46817200	LTR/ERVL	1947	+	321	46816879	17316
chr3	46799563	46999563	harbor1	chr3	46827947	46828376	LTR/ERVL	2404	+	214	46828161	28598
chr3	46799563	46999563	harbor1	chr3	46854846	46855131	LTR/ERVL	575	+	142	46854988	55425
chr3	49071619	49271619	harbor1	chr3	49170199	49170644	LTR/ERVL	1232	+	222	49170421	98802
chr3	49829994	50029994	harbor1	chr3	49888864	49889239	LTR/ERVL	1179	+	188	49889052	59058
chr3	129021155	129221155	harbor1	chr3	129065773	129066179	LTR/ERVL	2018	+	203	129065976	44821
chr3	129021155	129221155	harbor1	chr3	129101852	129102178	LTR/ERVL	545	+	163	129102015	80860
chr3	147453950	147653950	harbor1	chr3	147538854	147539249	LTR/ERVL	2059	+	198	147539052	85102
chr3	161005424	161205424	harbor1	chr3	161095356	161095941	LTR/ERVL	2218	+	292	161095648	90224
chr3	43899206	44099206	harbor1	chr3	43908438	43908861	LTR/ERVL	1124	+	212	43908650	9444
chr3	43899206	44099206	harbor1	chr3	43917384	43917879	LTR/ERVL	604	+	248	43917632	18426
chr3	43899206	44099206	harbor1	chr3	43951223	43951670	LTR/ERVL	864	+	224	43951447	52241
chr3	43899206	44099206	harbor1	chr3	43962761	43963102	LTR/ERVL	1073	+	170	43962931	63725
chr3	43899206	44099206	harbor1	chr3	43963362	43963516	LTR/ERVL	1073	+	77	43963439	64233
chr3	43899206	44099206	harbor1	chr3	43965554	43965664	LTR/ERVL	506	+	55	43965609	66403
chr3	43899206	44099206	harbor1	chr3	43967431	43967778	LTR/ERVL	1509	+	174	43967605	68399
chr3	47681961	47881961	harbor1	chr3	47752416	47752504	LTR/ERVL	857	+	44	47752460	70499
chr3	47681961	47881961	harbor1	chr3	47752778	47753034	LTR/ERVL	857	+	128	47752906	70945
chr3	49071660	49271660	harbor1	chr3	49170199	49170644	LTR/ERVL	1232	+	222	49170421	98761
chr3	125916736	126116736	harbor1	chr3	125921029	125921386	LTR/ERVL	515	+	178	125921207	4471
chr3	125916736	126116736	harbor1	chr3	125984069	125984217	LTR/ERVL	567	+	74	125984143	67407
chr3	125916736	126116736	harbor1	chr3	125984240	125984513	LTR/ERVL	833	+	136	125984376	67640
chr3	125916736	126116736	harbor1	chr3	125984594	125984840	LTR/ERVL	833	+	123	125984717	67981
chr3	125916736	126116736	harbor1	chr3	126005489	126005729	LTR/ERVL	1030	+	120	126005609	88873
chr3	49829545	50029545	harbor1	chr3	49888864	49889239	LTR/ERVL	1179	+	188	49889052	59507
chr3	43899195	44099195	harbor1	chr3	43908438	43908861	LTR/ERVL	1124	+	212	43908650	9455
chr3	43899195	44099195	harbor1	chr3	43917384	43917879	LTR/ERVL	604	+	248	43917632	18437
chr3	43899195	44099195	harbor1	chr3	43951223	43951670	LTR/ERVL	864	+	224	43951447	52252
chr3	43899195	44099195	harbor1	chr3	43962761	43963102	LTR/ERVL	1073	+	170	43962931	63736
chr3	43899195	44099195	harbor1	chr3	43963362	43963516	LTR/ERVL	1073	+	77	43963439	64244
chr3	43899195	44099195	harbor1	chr3	43965554	43965664	LTR/ERVL	506	+	55	43965609	66414
chr3	43899195	44099195	harbor1	chr3	43967431	43967778	LTR/ERVL	1509	+	174	43967605	68410
chr3	184085534	184285534	harbor1	chr3	184112171	184112275	LTR/ERVL	687	+	52	184112223	26689
chr3	123349837	123549837	harbor1	chr3	123405936	123406484	LTR/ERVL	3253	+	274	123406210	56373
chr3	123349837	123549837	harbor1	chr3	123418197	123418336	LTR/ERVL	2919	+	70	123418267	68430
chr3	123349837	123549837	harbor1	chr3	123418770	123419145	LTR/ERVL	2919	+	188	123418958	69121
chr3	185838095	186038095	harbor1	chr3	185873385	185873737	LTR/ERVL	2418	+	176	185873561	35466
chr3	185838095	186038095	harbor1	chr3	185874032	185874149	LTR/ERVL	2418	+	58	185874090	35995
chr3	185838095	186038095	harbor1	chr3	185874731	185874742	LTR/ERVL	2418	+	6	185874737	36642
chr3	185838095	186038095	harbor1	chr3	185875168	185875201	LTR/ERVL	2418	+	16	185875184	37089
chr3	185838095	186038095	harbor1	chr3	185881366	185881483	LTR/ERVL	570	+	58	185881424	43329
chr3	49071742	49271742	harbor1	chr3	49170199	49170644	LTR/ERVL	1232	+	222	49170421	98679
chr3	142754359	142954359	harbor1	chr3	142766161	142766394	LTR/ERVL	3366	+	116	142766277	11918
chr3	142754359	142954359	harbor1	chr3	142766681	142766886	LTR/ERVL	3366	+	102	142766783	12424
chr3	196916565	197116565	harbor1	chr3	196952315	196952433	LTR/ERVL	2475	+	59	196952374	35809
chr3	196916565	197116565	harbor1	chr3	196952735	196953196	LTR/ERVL	2475	+	230	196952965	36400
chr3	196916565	197116565	harbor1	chr3	196959817	196960086	LTR/ERVL	780	+	134	196959951	43386
chr3	196916565	197116565	harbor1	chr3	196960995	196961404	LTR/ERVL	1657	+	204	196961199	44634
chr3	196916565	197116565	harbor1	chr3	196991651	196992059	LTR/ERVL	994	+	204	196991855	75290
chr3	23710846	23910846	harbor1	chr3	23729611	23729960	LTR/ERVL	745	+	174	23729785	18939
chr3	23710846	23910846	harbor1	chr3	23775239	23775651	LTR/ERVL	1395	+	206	23775445	64599
chr3	39004795	39204795	harbor1	chr3	39007257	39007497	LTR/ERVL	1199	+	120	39007377	2582
chr3	39004795	39204795	harbor1	chr3	39007516	39008116	LTR/ERVL	2172	+	300	39007816	3021
chr3	39004795	39204795	harbor1	chr3	39020466	39020747	LTR/ERVL	528	+	140	39020606	15811
chr3	49071622	49271622	harbor1	chr3	49170199	49170644	LTR/ERVL	1232	+	222	49170421	98799
chr3	127581151	127781151	harbor1	chr3	127593439	127594637	LTR/ERVL	1782	+	599	127594038	12887
chr3	123544681	123744681	harbor1	chr3	123553476	123553916	LTR/ERVL	1098	+	220	123553696	9015
chr3	123544681	123744681	harbor1	chr3	123573545	123573755	LTR/ERVL	665	+	105	123573650	28969
chr3	123544681	123744681	harbor1	chr3	123600940	123601490	LTR/ERVL	2132	+	275	123601215	56534
chr3	123544681	123744681	harbor1	chr3	123602293	123602600	LTR/ERVL	2105	+	154	123602447	57766
chr3	123544681	123744681	harbor1	chr3	123608666	123608971	LTR/ERVL	878	+	152	123608818	64137
chr3	16431951	16631951	harbor1	chr3	16474761	16474914	LTR/ERVL	1863	+	76	16474837	42886
chr3	16431951	16631951	harbor1	chr3	16475315	16475780	LTR/ERVL	1863	+	232	16475547	43596
chr3	16431951	16631951	harbor1	chr3	16478062	16478180	LTR/ERVL	493	+	59	16478121	46170
chr3	23710841	23910841	harbor1	chr3	23729611	23729960	LTR/ERVL	745	+	174	23729785	18944
chr3	23710841	23910841	harbor1	chr3	23775239	23775651	LTR/ERVL	1395	+	206	23775445	64604
chr3	123349752	123549752	harbor1	chr3	123405936	123406484	LTR/ERVL	3253	+	274	123406210	56458
chr3	123349752	123549752	harbor1	chr3	123418197	123418336	LTR/ERVL	2919	+	70	123418267	68515
chr3	123349752	123549752	harbor1	chr3	123418770	123419145	LTR/ERVL	2919	+	188	123418958	69206
chr3	46771747	46971747	harbor1	chr3	46798515	46799040	LTR/ERVL	2916	+	262	46798777	27030
chr3	46771747	46971747	harbor1	chr3	46816558	46817200	LTR/ERVL	1947	+	321	46816879	45132
chr3	46771747	46971747	harbor1	chr3	46827947	46828376	LTR/ERVL	2404	+	214	46828161	56414
chr3	46771747	46971747	harbor1	chr3	46854846	46855131	LTR/ERVL	575	+	142	46854988	83241
chr3	138334619	138534619	harbor1	chr3	138334856	138335364	LTR/ERVL	2026	+	254	138335110	491
chr3	138334619	138534619	harbor1	chr3	138339350	138339522	LTR/ERVL	628	+	86	138339436	4817
chr3	138334619	138534619	harbor1	chr3	138341428	138341708	LTR/ERVL	921	+	140	138341568	6949
chr3	138334619	138534619	harbor1	chr3	138424814	138425205	LTR/ERVL	2189	+	196	138425010	90391
chr3	138334619	138534619	harbor1	chr3	138425754	138425846	LTR/ERVL	2189	+	46	138425800	91181
chr3	127490156	127690156	harbor1	chr3	127527079	127527488	LTR/ERVL	1203	+	204	127527283	37127
chr3	127490156	127690156	harbor1	chr3	127540128	127540464	LTR/ERVL	1450	+	168	127540296	50140
chr3	179842465	180042465	harbor1	chr3	179843979	179844157	LTR/ERVL	561	+	89	179844068	1603
chr3	179842465	180042465	harbor1	chr3	179846501	179846980	LTR/ERVL	2215	+	240	179846741	4276
chr3	127490312	127690312	harbor1	chr3	127527079	127527488	LTR/ERVL	1203	+	204	127527283	36971
chr3	127490312	127690312	harbor1	chr3	127540128	127540464	LTR/ERVL	1450	+	168	127540296	49984
chr3	184199369	184399369	harbor1	chr3	184225023	184225216	LTR/ERVL	726	+	96	184225119	25750
chr3	184199369	184399369	harbor1	chr3	184225247	184225284	LTR/ERVL	726	+	18	184225265	25896
chr3	123544677	123744677	harbor1	chr3	123553476	123553916	LTR/ERVL	1098	+	220	123553696	9019
chr3	123544677	123744677	harbor1	chr3	123573545	123573755	LTR/ERVL	665	+	105	123573650	28973
chr3	123544677	123744677	harbor1	chr3	123600940	123601490	LTR/ERVL	2132	+	275	123601215	56538
chr3	123544677	123744677	harbor1	chr3	123602293	123602600	LTR/ERVL	2105	+	154	123602447	57770
chr3	123544677	123744677	harbor1	chr3	123608666	123608971	LTR/ERVL	878	+	152	123608818	64141
chr3	49071668	49271668	harbor1	chr3	49170199	49170644	LTR/ERVL	1232	+	222	49170421	98753
chr3	47681964	47881964	harbor1	chr3	47752416	47752504	LTR/ERVL	857	+	44	47752460	70496
chr3	47681964	47881964	harbor1	chr3	47752778	47753034	LTR/ERVL	857	+	128	47752906	70942
chr3	122414401	122614401	harbor1	chr3	122464988	122465217	LTR/ERVL	1170	+	114	122465102	50701
chr3	122414401	122614401	harbor1	chr3	122465583	122465615	LTR/ERVL	1170	+	16	122465599	51198
chr3	122414401	122614401	harbor1	chr3	122465791	122465996	LTR/ERVL	1020	+	102	122465893	51492
chr3	138087580	138287580	harbor1	chr3	138098836	138098863	LTR/ERVL	749	+	14	138098850	11270
chr3	138087580	138287580	harbor1	chr3	138099145	138099204	LTR/ERVL	749	+	30	138099175	11595
chr3	138087580	138287580	harbor1	chr3	138099423	138099527	LTR/ERVL	749	+	52	138099475	11895
chr3	138087580	138287580	harbor1	chr3	138099943	138099980	LTR/ERVL	749	+	18	138099961	12381
chr3	138087580	138287580	harbor1	chr3	138100091	138100716	LTR/ERVL	3050	+	312	138100403	12823
chr3	138087580	138287580	harbor1	chr3	138138926	138139494	LTR/ERVL	3186	+	284	138139210	51630
chr3	138087580	138287580	harbor1	chr3	138179995	138180189	LTR/ERVL	594	+	97	138180092	92512
chr3	138087580	138287580	harbor1	chr3	138185182	138185629	LTR/ERVL	960	+	224	138185406	97826
chr3	49071631	49271631	harbor1	chr3	49170199	49170644	LTR/ERVL	1232	+	222	49170421	98790
chr3	51571820	51771820	harbor1	chr3	51598200	51598426	LTR/ERVL	1415	+	113	51598313	26493
chr3	51571820	51771820	harbor1	chr3	51598429	51598459	LTR/ERVL	2372	+	15	51598444	26624
chr3	51571820	51771820	harbor1	chr3	51598770	51599267	LTR/ERVL	2372	+	248	51599018	27198
chr3	19954840	20154840	harbor1	chr3	20013827	20014338	LTR/ERVL	1059	+	256	20014083	59243
chr3	49071632	49271632	harbor1	chr3	49170199	49170644	LTR/ERVL	1232	+	222	49170421	98789
chr3	47725179	47925179	harbor1	chr3	47752416	47752504	LTR/ERVL	857	+	44	47752460	27281
chr3	47725179	47925179	harbor1	chr3	47752778	47753034	LTR/ERVL	857	+	128	47752906	27727
chr3	197857923	198057923	harbor1	chr3	197906039	197906279	LTR/ERVL	837	+	120	197906159	48236
chr3	197857923	198057923	harbor1	chr3	197926549	197926950	LTR/ERVL	1139	+	200	197926749	68826
chr3	197857923	198057923	harbor1	chr3	197947704	197947878	LTR/ERVL	595	+	87	197947791	89868
chr3	30507293	30707293	harbor1	chr3	30513221	30513727	LTR/ERVL	1361	+	253	30513474	6181
chr3	30507293	30707293	harbor1	chr3	30515731	30516075	LTR/ERVL	1299	+	172	30515903	8610
chr3	30507293	30707293	harbor1	chr3	30516118	30516159	LTR/ERVL	1299	+	20	30516138	8845
chr3	30507293	30707293	harbor1	chr3	30532522	30533352	LTR/ERVL	3030	+	415	30532937	25644
chr3	30507293	30707293	harbor1	chr3	30581453	30581824	LTR/ERVL	1118	+	186	30581639	74346
chr3	23710887	23910887	harbor1	chr3	23729611	23729960	LTR/ERVL	745	+	174	23729785	18898
chr3	23710887	23910887	harbor1	chr3	23775239	23775651	LTR/ERVL	1395	+	206	23775445	64558
chr3	53395675	53595675	harbor1	chr3	53411097	53411437	LTR/ERVL	1077	+	170	53411267	15592
chr3	53395675	53595675	harbor1	chr3	53411621	53411789	LTR/ERVL	583	+	84	53411705	16030
chr3	159480531	159680531	harbor1	chr3	159545184	159545583	LTR/ERVL	3136	+	200	159545384	64853
chr3	159480531	159680531	harbor1	chr3	159554403	159554824	LTR/ERVL	1414	+	210	159554613	74082
chr3	48538345	48738345	harbor1	chr3	48546560	48547122	LTR/ERVL	2950	+	281	48546841	8496
chr3	49071610	49271610	harbor1	chr3	49170199	49170644	LTR/ERVL	1232	+	222	49170421	98811
chr3	123544615	123744615	harbor1	chr3	123553476	123553916	LTR/ERVL	1098	+	220	123553696	9081
chr3	123544615	123744615	harbor1	chr3	123573545	123573755	LTR/ERVL	665	+	105	123573650	29035
chr3	123544615	123744615	harbor1	chr3	123600940	123601490	LTR/ERVL	2132	+	275	123601215	56600
chr3	123544615	123744615	harbor1	chr3	123602293	123602600	LTR/ERVL	2105	+	154	123602447	57832
chr3	123544615	123744615	harbor1	chr3	123608666	123608971	LTR/ERVL	878	+	152	123608818	64203
chr3	46799778	46999778	harbor1	chr3	46816558	46817200	LTR/ERVL	1947	+	321	46816879	17101
chr3	46799778	46999778	harbor1	chr3	46827947	46828376	LTR/ERVL	2404	+	214	46828161	28383
chr3	46799778	46999778	harbor1	chr3	46854846	46855131	LTR/ERVL	575	+	142	46854988	55210
chr3	38066121	38266121	harbor1	chr3	38151231	38151652	LTR/ERVL	1461	+	210	38151441	85320
chr3	38066121	38266121	harbor1	chr3	38158523	38158986	LTR/ERVL	1111	+	232	38158755	92634
chr3	129021082	129221082	harbor1	chr3	129065773	129066179	LTR/ERVL	2018	+	203	129065976	44894
chr3	129021082	129221082	harbor1	chr3	129101852	129102178	LTR/ERVL	545	+	163	129102015	80933
chr3	47725235	47925235	harbor1	chr3	47752416	47752504	LTR/ERVL	857	+	44	47752460	27225
chr3	47725235	47925235	harbor1	chr3	47752778	47753034	LTR/ERVL	857	+	128	47752906	27671
chr3	12827739	13027739	harbor1	chr3	12885369	12885864	LTR/ERVL	1280	+	248	12885617	57878
chr3	126256502	126456502	harbor1	chr3	126282414	126282429	LTR/ERVL	4118	+	8	126282422	25920
chr3	126256502	126456502	harbor1	chr3	126282477	126283289	LTR/ERVL	4118	+	406	126282883	26381
chr3	51571305	51771305	harbor1	chr3	51598200	51598426	LTR/ERVL	1415	+	113	51598313	27008
chr3	51571305	51771305	harbor1	chr3	51598429	51598459	LTR/ERVL	2372	+	15	51598444	27139
chr3	51571305	51771305	harbor1	chr3	51598770	51599267	LTR/ERVL	2372	+	248	51599018	27713
chr3	138334857	138534857	harbor1	chr3	138334856	138335364	LTR/ERVL	2026	+	254	138335110	253
chr3	138334857	138534857	harbor1	chr3	138339350	138339522	LTR/ERVL	628	+	86	138339436	4579
chr3	138334857	138534857	harbor1	chr3	138341428	138341708	LTR/ERVL	921	+	140	138341568	6711
chr3	138334857	138534857	harbor1	chr3	138424814	138425205	LTR/ERVL	2189	+	196	138425010	90153
chr3	138334857	138534857	harbor1	chr3	138425754	138425846	LTR/ERVL	2189	+	46	138425800	90943
chr3	42482018	42682018	harbor1	chr3	42486820	42487214	LTR/ERVL	551	+	197	42487017	4999
chr3	42482018	42682018	harbor1	chr3	42498129	42498522	LTR/ERVL	1170	+	196	42498325	16307
chr3	127581163	127781163	harbor1	chr3	127593439	127594637	LTR/ERVL	1782	+	599	127594038	12875
chr4	2656082	2856082	harbor1	chr4	2737628	2738039	LTR/ERVL	3215	+	206	2737834	81752
chr4	2656082	2856082	harbor1	chr4	2738042	2739874	LTR/ERVL	17885	+	916	2738958	82876
chr4	2656082	2856082	harbor1	chr4	2740175	2740627	LTR/ERVL	17885	+	226	2740401	84319
chr4	2656082	2856082	harbor1	chr4	2740929	2741098	LTR/ERVL	17885	+	84	2741013	84931
chr4	2656082	2856082	harbor1	chr4	2741101	2741531	LTR/ERVL	3383	+	215	2741316	85234
chr4	800333	1000333	harbor1	chr4	814030	814219	LTR/ERVL	2957	+	94	814124	13791
chr4	800333	1000333	harbor1	chr4	814513	814987	LTR/ERVL	2957	+	237	814750	14417
chr4	910346	1110346	harbor1	chr4	981650	981816	LTR/ERVL	2422	+	83	981733	71387
chr4	910346	1110346	harbor1	chr4	982119	982755	LTR/ERVL	2422	+	318	982437	72091
chr4	551216	751216	harbor1	chr4	557230	557623	LTR/ERVL	2676	+	196	557426	6210
chr4	551216	751216	harbor1	chr4	617717	618131	LTR/ERVL	1714	+	207	617924	66708
chr4	25761117	25961117	harbor1	chr4	25803505	25804037	LTR/ERVL	2077	+	266	25803771	42654
chr4	903149	1103149	harbor1	chr4	981650	981816	LTR/ERVL	2422	+	83	981733	78584
chr4	903149	1103149	harbor1	chr4	982119	982755	LTR/ERVL	2422	+	318	982437	79288
chr4	893424	1093424	harbor1	chr4	981650	981816	LTR/ERVL	2422	+	83	981733	88309
chr4	893424	1093424	harbor1	chr4	982119	982755	LTR/ERVL	2422	+	318	982437	89013
chr4	726100	926100	harbor1	chr4	798985	799580	LTR/ERVL	3564	+	298	799283	73183
chr4	726100	926100	harbor1	chr4	799884	800261	LTR/ERVL	3564	+	188	800072	73972
chr4	726100	926100	harbor1	chr4	814030	814219	LTR/ERVL	2957	+	94	814124	88024
chr4	726100	926100	harbor1	chr4	814513	814987	LTR/ERVL	2957	+	237	814750	88650
chr4	1420272	1620272	harbor1	chr4	1447015	1447329	LTR/ERVL	847	+	157	1447172	26900
chr4	159002387	159202387	harbor1	chr4	159036245	159036583	LTR/ERVL	583	+	169	159036414	34027
chr4	159002387	159202387	harbor1	chr4	159023102	159023496	LTR/ERVL	1492	+	197	159023299	20912
chr4	159002718	159202718	harbor1	chr4	159036245	159036583	LTR/ERVL	583	+	169	159036414	33696
chr4	159002718	159202718	harbor1	chr4	159023102	159023496	LTR/ERVL	1492	+	197	159023299	20581
chr4	139456023	139656023	harbor1	chr4	139498147	139498594	LTR/ERVL	2143	+	224	139498371	42348
chr4	3263597	3463597	harbor1	chr4	3282882	3283053	LTR/ERVL	592	+	86	3282968	19371
chr4	3263597	3463597	harbor1	chr4	3284750	3285147	LTR/ERVL	1474	+	198	3284948	21351
chr4	3263597	3463597	harbor1	chr4	3314808	3315328	LTR/ERVL	2242	+	260	3315068	51471
chr4	3263597	3463597	harbor1	chr4	3321589	3321896	LTR/ERVL	650	+	154	3321743	58146
chr4	1365432	1565432	harbor1	chr4	1447015	1447329	LTR/ERVL	847	+	157	1447172	81740
chr4	910850	1110850	harbor1	chr4	981650	981816	LTR/ERVL	2422	+	83	981733	70883
chr4	910850	1110850	harbor1	chr4	982119	982755	LTR/ERVL	2422	+	318	982437	71587
chr4	1107423	1307423	harbor1	chr4	1134868	1135048	LTR/ERVL	603	+	90	1134958	27535
chr4	1402290	1602290	harbor1	chr4	1447015	1447329	LTR/ERVL	847	+	157	1447172	44882
chr4	551200	751200	harbor1	chr4	557230	557623	LTR/ERVL	2676	+	196	557426	6226
chr4	551200	751200	harbor1	chr4	617717	618131	LTR/ERVL	1714	+	207	617924	66724
chr4	150608140	150808140	harbor1	chr4	150613584	150614238	LTR/ERVL	3011	+	327	150613911	5771
chr4	910370	1110370	harbor1	chr4	981650	981816	LTR/ERVL	2422	+	83	981733	71363
chr4	910370	1110370	harbor1	chr4	982119	982755	LTR/ERVL	2422	+	318	982437	72067
chr4	52497288	52697288	harbor1	chr4	52552114	52552789	LTR/ERVL	2445	+	338	52552452	55164
chr4	52497288	52697288	harbor1	chr4	52560034	52560169	LTR/ERVL	1009	+	68	52560102	62814
chr4	52497288	52697288	harbor1	chr4	52560631	52560928	LTR/ERVL	972	+	148	52560779	63491
chr4	52497288	52697288	harbor1	chr4	52561155	52561571	LTR/ERVL	1369	+	208	52561363	64075
chr4	128711743	128911743	harbor1	chr4	128775703	128775934	LTR/ERVL	664	+	116	128775819	64076
chr4	76113424	76313424	harbor1	chr4	76156011	76156530	LTR/ERVL	1223	+	260	76156271	42847
chr4	76113424	76313424	harbor1	chr4	76176563	76177032	LTR/ERVL	2396	+	234	76176797	63373
chr4	120822653	121022653	harbor1	chr4	120834201	120834217	LTR/ERVL	1937	+	8	120834209	11556
chr4	120822653	121022653	harbor1	chr4	120834583	120834988	LTR/ERVL	1937	+	202	120834785	12132
chr4	120822653	121022653	harbor1	chr4	120852247	120852648	LTR/ERVL	1606	+	200	120852447	29794
chr4	120822653	121022653	harbor1	chr4	120862543	120862876	LTR/ERVL	2314	+	166	120862709	40056
chr4	120822653	121022653	harbor1	chr4	120863177	120863191	LTR/ERVL	2314	+	7	120863184	40531
chr4	120822653	121022653	harbor1	chr4	120863227	120863460	LTR/ERVL	2314	+	116	120863343	40690
chr4	120822653	121022653	harbor1	chr4	120905319	120905744	LTR/ERVL	1522	+	212	120905531	82878
chr4	1420361	1620361	harbor1	chr4	1447015	1447329	LTR/ERVL	847	+	157	1447172	26811
chr4	2363119	2563119	harbor1	chr4	2363239	2363809	LTR/ERVL	1713	+	285	2363524	405
chr4	8767896	8967896	harbor1	chr4	8835980	8836352	LTR/ERVL	678	+	186	8836166	68270
chr4	8767896	8967896	harbor1	chr4	8854460	8854749	LTR/ERVL	918	+	144	8854604	86708
chr4	143414065	143614065	harbor1	chr4	143477588	143477699	LTR/ERVL	574	+	56	143477644	63579
chr4	143414065	143614065	harbor1	chr4	143503250	143503644	LTR/ERVL	1125	+	197	143503447	89382
chr4	143414065	143614065	harbor1	chr4	143503943	143504027	LTR/ERVL	1125	+	42	143503985	89920
chr4	143414065	143614065	harbor1	chr4	143474416	143474820	LTR/ERVL	2287	+	202	143474618	60553
chr4	120822725	121022725	harbor1	chr4	120834201	120834217	LTR/ERVL	1937	+	8	120834209	11484
chr4	120822725	121022725	harbor1	chr4	120834583	120834988	LTR/ERVL	1937	+	202	120834785	12060
chr4	120822725	121022725	harbor1	chr4	120852247	120852648	LTR/ERVL	1606	+	200	120852447	29722
chr4	120822725	121022725	harbor1	chr4	120862543	120862876	LTR/ERVL	2314	+	166	120862709	39984
chr4	120822725	121022725	harbor1	chr4	120863177	120863191	LTR/ERVL	2314	+	7	120863184	40459
chr4	120822725	121022725	harbor1	chr4	120863227	120863460	LTR/ERVL	2314	+	116	120863343	40618
chr4	120822725	121022725	harbor1	chr4	120905319	120905744	LTR/ERVL	1522	+	212	120905531	82806
chr4	55295888	55495888	harbor1	chr4	55385774	55386120	LTR/ERVL	1706	+	173	55385947	90059
chr4	25762833	25962833	harbor1	chr4	25803505	25804037	LTR/ERVL	2077	+	266	25803771	40938
chr4	551205	751205	harbor1	chr4	557230	557623	LTR/ERVL	2676	+	196	557426	6221
chr4	551205	751205	harbor1	chr4	617717	618131	LTR/ERVL	1714	+	207	617924	66719
chr4	15581883	15781883	harbor1	chr4	15677257	15678023	LTR/ERVL	2078	+	383	15677640	95757
chr4	139076181	139276181	harbor1	chr4	139103173	139103666	LTR/ERVL	2952	+	246	139103419	27238
chr4	139076181	139276181	harbor1	chr4	139103677	139103877	LTR/ERVL	875	+	100	139103777	27596
chr4	139076181	139276181	harbor1	chr4	139119314	139119457	LTR/ERVL	614	+	72	139119386	43205
chr4	120822783	121022783	harbor1	chr4	120834201	120834217	LTR/ERVL	1937	+	8	120834209	11426
chr4	120822783	121022783	harbor1	chr4	120834583	120834988	LTR/ERVL	1937	+	202	120834785	12002
chr4	120822783	121022783	harbor1	chr4	120852247	120852648	LTR/ERVL	1606	+	200	120852447	29664
chr4	120822783	121022783	harbor1	chr4	120862543	120862876	LTR/ERVL	2314	+	166	120862709	39926
chr4	120822783	121022783	harbor1	chr4	120863177	120863191	LTR/ERVL	2314	+	7	120863184	40401
chr4	120822783	121022783	harbor1	chr4	120863227	120863460	LTR/ERVL	2314	+	116	120863343	40560
chr4	120822783	121022783	harbor1	chr4	120905319	120905744	LTR/ERVL	1522	+	212	120905531	82748
chr4	55295797	55495797	harbor1	chr4	55385774	55386120	LTR/ERVL	1706	+	173	55385947	90150
chr4	1350400	1550400	harbor1	chr4	1447015	1447329	LTR/ERVL	847	+	157	1447172	96772
chr5	73351493	73551493	harbor1	chr5	73395554	73397440	LTR/ERVL	9098	+	943	73396497	45004
chr5	73351493	73551493	harbor1	chr5	73397441	73398002	LTR/ERVL	1348	+	280	73397721	46228
chr5	73351493	73551493	harbor1	chr5	73426255	73426780	LTR/ERVL	2886	+	262	73426517	75024
chr5	9549845	9749845	harbor1	chr5	9604678	9605212	LTR/ERVL	2183	+	267	9604945	55100
chr5	10661237	10861237	harbor1	chr5	10672684	10673047	LTR/ERVL	1828	+	182	10672866	11629
chr5	10661237	10861237	harbor1	chr5	10716384	10716832	LTR/ERVL	3087	+	224	10716608	55371
chr5	10661237	10861237	harbor1	chr5	10716833	10717681	LTR/ERVL	6539	+	424	10717257	56020
chr5	10661237	10861237	harbor1	chr5	10717681	10720094	LTR/ERVL	18730	+	1206	10718887	57650
chr5	10661237	10861237	harbor1	chr5	10720111	10720185	LTR/ERVL	416	+	37	10720148	58911
chr5	10661237	10861237	harbor1	chr5	10720334	10722105	LTR/ERVL	13357	+	886	10721220	59983
chr5	10661237	10861237	harbor1	chr5	10722106	10722498	LTR/ERVL	2866	+	196	10722302	61065
chr5	10661237	10861237	harbor1	chr5	10747636	10747809	LTR/ERVL	448	+	86	10747722	86485
chr5	9114326	9314326	harbor1	chr5	9127263	9127649	LTR/ERVL	1946	+	193	9127456	13130
chr5	9114326	9314326	harbor1	chr5	9148380	9148712	LTR/ERVL	1097	+	166	9148546	34220
chr5	9114326	9314326	harbor1	chr5	9149019	9149169	LTR/ERVL	1097	+	75	9149094	34768
chr5	10150551	10350551	harbor1	chr5	10191041	10191152	LTR/ERVL	440	+	56	10191097	40546
chr5	10150551	10350551	harbor1	chr5	10196808	10197381	LTR/ERVL	2154	+	286	10197094	46543
chr5	150532654	150732654	harbor1	chr5	150577196	150577432	LTR/ERVL	896	+	118	150577314	44660
chr5	150532654	150732654	harbor1	chr5	150578171	150578285	LTR/ERVL	530	+	57	150578228	45574
chr5	6633235	6833235	harbor1	chr5	6678448	6678817	LTR/ERVL	1386	+	184	6678632	45397
chr5	6633235	6833235	harbor1	chr5	6680307	6681281	LTR/ERVL	2057	+	487	6680794	47559
chr5	10102676	10302676	harbor1	chr5	10112043	10112519	LTR/ERVL	1210	+	238	10112281	9605
chr5	10102676	10302676	harbor1	chr5	10112873	10112990	LTR/ERVL	1210	+	58	10112931	10255
chr5	10102676	10302676	harbor1	chr5	10142728	10143105	LTR/ERVL	2816	+	188	10142916	40240
chr5	10102676	10302676	harbor1	chr5	10143268	10143303	LTR/ERVL	2816	+	18	10143286	40610
chr5	10102676	10302676	harbor1	chr5	10191041	10191152	LTR/ERVL	440	+	56	10191097	88421
chr5	10102676	10302676	harbor1	chr5	10196808	10197381	LTR/ERVL	2154	+	286	10197094	94418
chr5	10296849	10496849	harbor1	chr5	10315613	10315631	LTR/ERVL	1795	+	9	10315622	18773
chr5	10296849	10496849	harbor1	chr5	10315944	10316109	LTR/ERVL	1795	+	82	10316026	19177
chr5	10296849	10496849	harbor1	chr5	10316440	10316690	LTR/ERVL	1795	+	125	10316565	19716
chr5	10296849	10496849	harbor1	chr5	10324392	10324739	LTR/ERVL	1990	+	174	10324566	27717
chr5	10296849	10496849	harbor1	chr5	10338272	10338725	LTR/ERVL	3085	+	226	10338498	41649
chr5	10661256	10861256	harbor1	chr5	10672684	10673047	LTR/ERVL	1828	+	182	10672866	11610
chr5	10661256	10861256	harbor1	chr5	10716384	10716832	LTR/ERVL	3087	+	224	10716608	55352
chr5	10661256	10861256	harbor1	chr5	10716833	10717681	LTR/ERVL	6539	+	424	10717257	56001
chr5	10661256	10861256	harbor1	chr5	10717681	10720094	LTR/ERVL	18730	+	1206	10718887	57631
chr5	10661256	10861256	harbor1	chr5	10720111	10720185	LTR/ERVL	416	+	37	10720148	58892
chr5	10661256	10861256	harbor1	chr5	10720334	10722105	LTR/ERVL	13357	+	886	10721220	59964
chr5	10661256	10861256	harbor1	chr5	10722106	10722498	LTR/ERVL	2866	+	196	10722302	61046
chr5	10661256	10861256	harbor1	chr5	10747636	10747809	LTR/ERVL	448	+	86	10747722	86466
chr5	139560781	139760781	harbor1	chr5	139575092	139575306	LTR/ERVL	570	+	107	139575199	14418
chr5	40697590	40897590	harbor1	chr5	40740494	40740877	LTR/ERVL	1099	+	192	40740686	43096
chr5	139559543	139759543	harbor1	chr5	139575092	139575306	LTR/ERVL	570	+	107	139575199	15656
chr5	10661135	10861135	harbor1	chr5	10672684	10673047	LTR/ERVL	1828	+	182	10672866	11731
chr5	10661135	10861135	harbor1	chr5	10716384	10716832	LTR/ERVL	3087	+	224	10716608	55473
chr5	10661135	10861135	harbor1	chr5	10716833	10717681	LTR/ERVL	6539	+	424	10717257	56122
chr5	10661135	10861135	harbor1	chr5	10717681	10720094	LTR/ERVL	18730	+	1206	10718887	57752
chr5	10661135	10861135	harbor1	chr5	10720111	10720185	LTR/ERVL	416	+	37	10720148	59013
chr5	10661135	10861135	harbor1	chr5	10720334	10722105	LTR/ERVL	13357	+	886	10721220	60085
chr5	10661135	10861135	harbor1	chr5	10722106	10722498	LTR/ERVL	2866	+	196	10722302	61167
chr5	10661135	10861135	harbor1	chr5	10747636	10747809	LTR/ERVL	448	+	86	10747722	86587
chr5	10184404	10384404	harbor1	chr5	10191041	10191152	LTR/ERVL	440	+	56	10191097	6693
chr5	10184404	10384404	harbor1	chr5	10196808	10197381	LTR/ERVL	2154	+	286	10197094	12690
chr5	10184404	10384404	harbor1	chr5	10278182	10279043	LTR/ERVL	4610	+	430	10278612	94208
chr5	132128916	132328916	harbor1	chr5	132190262	132190427	LTR/ERVL	498	+	82	132190344	61428
chr5	132128916	132328916	harbor1	chr5	132202871	132203347	LTR/ERVL	2804	+	238	132203109	74193
chr5	132128916	132328916	harbor1	chr5	132223209	132223263	LTR/ERVL	530	+	27	132223236	94320
chr5	132128916	132328916	harbor1	chr5	132223556	132223675	LTR/ERVL	530	+	60	132223616	94700
chr5	73351452	73551452	harbor1	chr5	73395554	73397440	LTR/ERVL	9098	+	943	73396497	45045
chr5	73351452	73551452	harbor1	chr5	73397441	73398002	LTR/ERVL	1348	+	280	73397721	46269
chr5	73351452	73551452	harbor1	chr5	73426255	73426780	LTR/ERVL	2886	+	262	73426517	75065
chr5	37740423	37940423	harbor1	chr5	37793305	37793724	LTR/ERVL	3102	+	210	37793515	53092
chr5	37740423	37940423	harbor1	chr5	37793725	37795107	LTR/ERVL	33293	+	691	37794416	53993
chr5	37740423	37940423	harbor1	chr5	37795417	37798236	LTR/ERVL	33293	+	1410	37796827	56404
chr5	9749157	9949157	harbor1	chr5	9749947	9750402	LTR/ERVL	1129	+	228	9750175	1018
chr5	9749157	9949157	harbor1	chr5	9780727	9781068	LTR/ERVL	1711	+	170	9780897	31740
chr5	9749157	9949157	harbor1	chr5	9836732	9837508	LTR/ERVL	1231	+	388	9837120	87963
chr5	9749157	9949157	harbor1	chr5	9841624	9842080	LTR/ERVL	1706	+	228	9841852	92695
chr5	73350932	73550932	harbor1	chr5	73395554	73397440	LTR/ERVL	9098	+	943	73396497	45565
chr5	73350932	73550932	harbor1	chr5	73397441	73398002	LTR/ERVL	1348	+	280	73397721	46789
chr5	73350932	73550932	harbor1	chr5	73426255	73426780	LTR/ERVL	2886	+	262	73426517	75585
chr5	9879703	10079703	harbor1	chr5	9896200	9896436	LTR/ERVL	960	+	118	9896318	16615
chr5	9879703	10079703	harbor1	chr5	9912794	9913083	LTR/ERVL	684	+	144	9912938	33235
chr5	9879703	10079703	harbor1	chr5	9913527	9913596	LTR/ERVL	684	+	34	9913561	33858
chr5	9879703	10079703	harbor1	chr5	9924071	9924615	LTR/ERVL	2838	+	272	9924343	44640
chr5	9879703	10079703	harbor1	chr5	9956428	9956593	LTR/ERVL	734	+	82	9956510	76807
chr5	9879703	10079703	harbor1	chr5	9895725	9896129	LTR/ERVL	935	+	202	9895927	16224
chr5	10661236	10861236	harbor1	chr5	10672684	10673047	LTR/ERVL	1828	+	182	10672866	11630
chr5	10661236	10861236	harbor1	chr5	10716384	10716832	LTR/ERVL	3087	+	224	10716608	55372
chr5	10661236	10861236	harbor1	chr5	10716833	10717681	LTR/ERVL	6539	+	424	10717257	56021
chr5	10661236	10861236	harbor1	chr5	10717681	10720094	LTR/ERVL	18730	+	1206	10718887	57651
chr5	10661236	10861236	harbor1	chr5	10720111	10720185	LTR/ERVL	416	+	37	10720148	58912
chr5	10661236	10861236	harbor1	chr5	10720334	10722105	LTR/ERVL	13357	+	886	10721220	59984
chr5	10661236	10861236	harbor1	chr5	10722106	10722498	LTR/ERVL	2866	+	196	10722302	61066
chr5	10661236	10861236	harbor1	chr5	10747636	10747809	LTR/ERVL	448	+	86	10747722	86486
chr5	79136023	79336023	harbor1	chr5	79139387	79139846	LTR/ERVL	937	+	230	79139617	3594
chr5	79136023	79336023	harbor1	chr5	79206034	79206481	LTR/ERVL	649	+	224	79206258	70235
chr5	79136023	79336023	harbor1	chr5	79221568	79221920	LTR/ERVL	804	+	176	79221744	85721
chr5	79136023	79336023	harbor1	chr5	79225183	79225583	LTR/ERVL	1310	+	200	79225383	89360
chr5	79136023	79336023	harbor1	chr5	79227680	79228060	LTR/ERVL	1044	+	190	79227870	91847
chr5	79136023	79336023	harbor1	chr5	79228212	79229807	LTR/ERVL	3112	+	798	79229010	92987
chr5	79136023	79336023	harbor1	chr5	79230925	79231100	LTR/ERVL	657	+	88	79231013	94990
chr5	79136023	79336023	harbor1	chr5	79231101	79231303	LTR/ERVL	883	+	101	79231202	95179
chr5	79136023	79336023	harbor1	chr5	79231610	79231720	LTR/ERVL	883	+	55	79231665	95642
chr5	79136023	79336023	harbor1	chr5	79232019	79232082	LTR/ERVL	883	+	32	79232051	96028
chr5	135374498	135574498	harbor1	chr5	135424518	135425079	LTR/ERVL	785	+	280	135424798	50300
chr5	135374498	135574498	harbor1	chr5	135428715	135429016	LTR/ERVL	549	+	150	135428865	54367
chr5	135374498	135574498	harbor1	chr5	135429037	135429166	LTR/ERVL	482	+	64	135429101	54603
chr5	135374498	135574498	harbor1	chr5	135442746	135443256	LTR/ERVL	1000	+	255	135443001	68503
chr5	135830655	136030655	harbor1	chr5	135924622	135925210	LTR/ERVL	2020	+	294	135924916	94261
chr5	71628508	71828508	harbor1	chr5	71677462	71677746	LTR/ERVL	475	+	142	71677604	49096
chr5	71628508	71828508	harbor1	chr5	71677774	71678515	LTR/ERVL	1971	+	370	71678144	49636
chr5	71628508	71828508	harbor1	chr5	71679435	71679743	LTR/ERVL	924	+	154	71679589	51081
chr5	52700042	52900042	harbor1	chr5	52702003	52702540	LTR/ERVL	2082	+	268	52702271	2229
chr5	52700042	52900042	harbor1	chr5	52714551	52714759	LTR/ERVL	621	+	104	52714655	14613
chr5	73350824	73550824	harbor1	chr5	73395554	73397440	LTR/ERVL	9098	+	943	73396497	45673
chr5	73350824	73550824	harbor1	chr5	73397441	73398002	LTR/ERVL	1348	+	280	73397721	46897
chr5	73350824	73550824	harbor1	chr5	73426255	73426780	LTR/ERVL	2886	+	262	73426517	75693
chr5	10661301	10861301	harbor1	chr5	10672684	10673047	LTR/ERVL	1828	+	182	10672866	11565
chr5	10661301	10861301	harbor1	chr5	10716384	10716832	LTR/ERVL	3087	+	224	10716608	55307
chr5	10661301	10861301	harbor1	chr5	10716833	10717681	LTR/ERVL	6539	+	424	10717257	55956
chr5	10661301	10861301	harbor1	chr5	10717681	10720094	LTR/ERVL	18730	+	1206	10718887	57586
chr5	10661301	10861301	harbor1	chr5	10720111	10720185	LTR/ERVL	416	+	37	10720148	58847
chr5	10661301	10861301	harbor1	chr5	10720334	10722105	LTR/ERVL	13357	+	886	10721220	59919
chr5	10661301	10861301	harbor1	chr5	10722106	10722498	LTR/ERVL	2866	+	196	10722302	61001
chr5	10661301	10861301	harbor1	chr5	10747636	10747809	LTR/ERVL	448	+	86	10747722	86421
chr5	175976844	176176844	harbor1	chr5	176008931	176009434	LTR/ERVL	2027	+	252	176009183	32339
chr5	175976844	176176844	harbor1	chr5	176029753	176029898	LTR/ERVL	534	+	72	176029825	52981
chr5	175976844	176176844	harbor1	chr5	176069575	176070355	LTR/ERVL	3424	+	390	176069965	93121
chr5	73336206	73536206	harbor1	chr5	73395554	73397440	LTR/ERVL	9098	+	943	73396497	60291
chr5	73336206	73536206	harbor1	chr5	73397441	73398002	LTR/ERVL	1348	+	280	73397721	61515
chr5	73336206	73536206	harbor1	chr5	73426255	73426780	LTR/ERVL	2886	+	262	73426517	90311
chr5	9111212	9311212	harbor1	chr5	9127263	9127649	LTR/ERVL	1946	+	193	9127456	16244
chr5	9111212	9311212	harbor1	chr5	9148380	9148712	LTR/ERVL	1097	+	166	9148546	37334
chr5	9111212	9311212	harbor1	chr5	9149019	9149169	LTR/ERVL	1097	+	75	9149094	37882
chr5	79136006	79336006	harbor1	chr5	79139387	79139846	LTR/ERVL	937	+	230	79139617	3611
chr5	79136006	79336006	harbor1	chr5	79206034	79206481	LTR/ERVL	649	+	224	79206258	70252
chr5	79136006	79336006	harbor1	chr5	79221568	79221920	LTR/ERVL	804	+	176	79221744	85738
chr5	79136006	79336006	harbor1	chr5	79225183	79225583	LTR/ERVL	1310	+	200	79225383	89377
chr5	79136006	79336006	harbor1	chr5	79227680	79228060	LTR/ERVL	1044	+	190	79227870	91864
chr5	79136006	79336006	harbor1	chr5	79228212	79229807	LTR/ERVL	3112	+	798	79229010	93004
chr5	79136006	79336006	harbor1	chr5	79230925	79231100	LTR/ERVL	657	+	88	79231013	95007
chr5	79136006	79336006	harbor1	chr5	79231101	79231303	LTR/ERVL	883	+	101	79231202	95196
chr5	79136006	79336006	harbor1	chr5	79231610	79231720	LTR/ERVL	883	+	55	79231665	95659
chr5	79136006	79336006	harbor1	chr5	79232019	79232082	LTR/ERVL	883	+	32	79232051	96045
chr5	181061441	181261441	harbor1	chr5	181081170	181081393	LTR/ERVL	1267	+	112	181081282	19841
chr5	181061441	181261441	harbor1	chr5	181081635	181081839	LTR/ERVL	1089	+	102	181081737	20296
chr5	181061441	181261441	harbor1	chr5	181120456	181120578	LTR/ERVL	452	+	61	181120517	59076
chr5	181061441	181261441	harbor1	chr5	181120881	181121078	LTR/ERVL	452	+	98	181120979	59538
chr5	181061441	181261441	harbor1	chr5	181121098	181121571	LTR/ERVL	1516	+	236	181121334	59893
chr5	181061441	181261441	harbor1	chr5	181122591	181122650	LTR/ERVL	424	+	30	181122621	61180
chr5	181061441	181261441	harbor1	chr5	181122896	181122970	LTR/ERVL	424	+	37	181122933	61492
chr5	181061441	181261441	harbor1	chr5	181140795	181141314	LTR/ERVL	1884	+	260	181141055	79614
chr5	4034239	4234239	harbor1	chr5	4070919	4071189	LTR/ERVL	475	+	135	4071054	36815
chr5	10660380	10860380	harbor1	chr5	10672684	10673047	LTR/ERVL	1828	+	182	10672866	12486
chr5	10660380	10860380	harbor1	chr5	10716384	10716832	LTR/ERVL	3087	+	224	10716608	56228
chr5	10660380	10860380	harbor1	chr5	10716833	10717681	LTR/ERVL	6539	+	424	10717257	56877
chr5	10660380	10860380	harbor1	chr5	10717681	10720094	LTR/ERVL	18730	+	1206	10718887	58507
chr5	10660380	10860380	harbor1	chr5	10720111	10720185	LTR/ERVL	416	+	37	10720148	59768
chr5	10660380	10860380	harbor1	chr5	10720334	10722105	LTR/ERVL	13357	+	886	10721220	60840
chr5	10660380	10860380	harbor1	chr5	10722106	10722498	LTR/ERVL	2866	+	196	10722302	61922
chr5	10660380	10860380	harbor1	chr5	10747636	10747809	LTR/ERVL	448	+	86	10747722	87342
chr5	73351484	73551484	harbor1	chr5	73395554	73397440	LTR/ERVL	9098	+	943	73396497	45013
chr5	73351484	73551484	harbor1	chr5	73397441	73398002	LTR/ERVL	1348	+	280	73397721	46237
chr5	73351484	73551484	harbor1	chr5	73426255	73426780	LTR/ERVL	2886	+	262	73426517	75033
chr5	9114356	9314356	harbor1	chr5	9127263	9127649	LTR/ERVL	1946	+	193	9127456	13100
chr5	9114356	9314356	harbor1	chr5	9148380	9148712	LTR/ERVL	1097	+	166	9148546	34190
chr5	9114356	9314356	harbor1	chr5	9149019	9149169	LTR/ERVL	1097	+	75	9149094	34738
chr5	9114296	9314296	harbor1	chr5	9127263	9127649	LTR/ERVL	1946	+	193	9127456	13160
chr5	9114296	9314296	harbor1	chr5	9148380	9148712	LTR/ERVL	1097	+	166	9148546	34250
chr5	9114296	9314296	harbor1	chr5	9149019	9149169	LTR/ERVL	1097	+	75	9149094	34798
chr5	132103968	132303968	harbor1	chr5	132190262	132190427	LTR/ERVL	498	+	82	132190344	86376
chr5	132103968	132303968	harbor1	chr5	132202871	132203347	LTR/ERVL	2804	+	238	132203109	99141
chr5	150964914	151164914	harbor1	chr5	151000078	151000460	LTR/ERVL	959	+	191	151000269	35355
chr5	150964914	151164914	harbor1	chr5	151014808	151015352	LTR/ERVL	2646	+	272	151015080	50166
chr5	150964914	151164914	harbor1	chr5	151016043	151016486	LTR/ERVL	1932	+	222	151016265	51351
chr5	135980228	136180228	harbor1	chr5	135986067	135986327	LTR/ERVL	1059	+	130	135986197	5969
chr5	73351560	73551560	harbor1	chr5	73395554	73397440	LTR/ERVL	9098	+	943	73396497	44937
chr5	73351560	73551560	harbor1	chr5	73397441	73398002	LTR/ERVL	1348	+	280	73397721	46161
chr5	73351560	73551560	harbor1	chr5	73426255	73426780	LTR/ERVL	2886	+	262	73426517	74957
chr5	10661235	10861235	harbor1	chr5	10672684	10673047	LTR/ERVL	1828	+	182	10672866	11631
chr5	10661235	10861235	harbor1	chr5	10716384	10716832	LTR/ERVL	3087	+	224	10716608	55373
chr5	10661235	10861235	harbor1	chr5	10716833	10717681	LTR/ERVL	6539	+	424	10717257	56022
chr5	10661235	10861235	harbor1	chr5	10717681	10720094	LTR/ERVL	18730	+	1206	10718887	57652
chr5	10661235	10861235	harbor1	chr5	10720111	10720185	LTR/ERVL	416	+	37	10720148	58913
chr5	10661235	10861235	harbor1	chr5	10720334	10722105	LTR/ERVL	13357	+	886	10721220	59985
chr5	10661235	10861235	harbor1	chr5	10722106	10722498	LTR/ERVL	2866	+	196	10722302	61067
chr5	10661235	10861235	harbor1	chr5	10747636	10747809	LTR/ERVL	448	+	86	10747722	86487
chr5	9114331	9314331	harbor1	chr5	9127263	9127649	LTR/ERVL	1946	+	193	9127456	13125
chr5	9114331	9314331	harbor1	chr5	9148380	9148712	LTR/ERVL	1097	+	166	9148546	34215
chr5	9114331	9314331	harbor1	chr5	9149019	9149169	LTR/ERVL	1097	+	75	9149094	34763
chr5	52699384	52899384	harbor1	chr5	52702003	52702540	LTR/ERVL	2082	+	268	52702271	2887
chr5	52699384	52899384	harbor1	chr5	52714551	52714759	LTR/ERVL	621	+	104	52714655	15271
chr5	9114252	9314252	harbor1	chr5	9127263	9127649	LTR/ERVL	1946	+	193	9127456	13204
chr5	9114252	9314252	harbor1	chr5	9148380	9148712	LTR/ERVL	1097	+	166	9148546	34294
chr5	9114252	9314252	harbor1	chr5	9149019	9149169	LTR/ERVL	1097	+	75	9149094	34842
chr5	9114320	9314320	harbor1	chr5	9127263	9127649	LTR/ERVL	1946	+	193	9127456	13136
chr5	9114320	9314320	harbor1	chr5	9148380	9148712	LTR/ERVL	1097	+	166	9148546	34226
chr5	9114320	9314320	harbor1	chr5	9149019	9149169	LTR/ERVL	1097	+	75	9149094	34774
chr5	171287664	171487664	harbor1	chr5	171332101	171332362	LTR/ERVL	600	+	130	171332231	44567
chr5	171287664	171487664	harbor1	chr5	171332543	171332683	LTR/ERVL	602	+	70	171332613	44949
chr5	171287664	171487664	harbor1	chr5	171356741	171357110	LTR/ERVL	668	+	184	171356925	69261
chr5	171287664	171487664	harbor1	chr5	171357682	171358489	LTR/ERVL	1349	+	404	171358086	70422
chr5	171287664	171487664	harbor1	chr5	171378068	171378196	LTR/ERVL	433	+	64	171378132	90468
chr5	171287664	171487664	harbor1	chr5	171379200	171379339	LTR/ERVL	547	+	70	171379270	91606
chr5	93472721	93672721	harbor1	chr5	93491469	93492030	LTR/ERVL	2839	+	280	93491749	19028
chr5	93472721	93672721	harbor1	chr5	93503494	93503987	LTR/ERVL	2798	+	246	93503740	31019
chr5	93472721	93672721	harbor1	chr5	93511062	93511453	LTR/ERVL	1805	+	196	93511258	38537
chr5	93472721	93672721	harbor1	chr5	93546784	93547230	LTR/ERVL	2232	+	223	93547007	74286
chr5	73351469	73551469	harbor1	chr5	73395554	73397440	LTR/ERVL	9098	+	943	73396497	45028
chr5	73351469	73551469	harbor1	chr5	73397441	73398002	LTR/ERVL	1348	+	280	73397721	46252
chr5	73351469	73551469	harbor1	chr5	73426255	73426780	LTR/ERVL	2886	+	262	73426517	75048
chr5	7622638	7822638	harbor1	chr5	7668114	7668505	LTR/ERVL	1819	+	196	7668310	45672
chr5	9057233	9257233	harbor1	chr5	9127263	9127649	LTR/ERVL	1946	+	193	9127456	70223
chr5	9057233	9257233	harbor1	chr5	9148380	9148712	LTR/ERVL	1097	+	166	9148546	91313
chr5	9057233	9257233	harbor1	chr5	9149019	9149169	LTR/ERVL	1097	+	75	9149094	91861
chr5	9114329	9314329	harbor1	chr5	9127263	9127649	LTR/ERVL	1946	+	193	9127456	13127
chr5	9114329	9314329	harbor1	chr5	9148380	9148712	LTR/ERVL	1097	+	166	9148546	34217
chr5	9114329	9314329	harbor1	chr5	9149019	9149169	LTR/ERVL	1097	+	75	9149094	34765
chr5	10311688	10511688	harbor1	chr5	10315613	10315631	LTR/ERVL	1795	+	9	10315622	3934
chr5	10311688	10511688	harbor1	chr5	10315944	10316109	LTR/ERVL	1795	+	82	10316026	4338
chr5	10311688	10511688	harbor1	chr5	10316440	10316690	LTR/ERVL	1795	+	125	10316565	4877
chr5	10311688	10511688	harbor1	chr5	10324392	10324739	LTR/ERVL	1990	+	174	10324566	12878
chr5	10311688	10511688	harbor1	chr5	10338272	10338725	LTR/ERVL	3085	+	226	10338498	26810
chr5	74950541	75150541	harbor1	chr5	74955787	74956226	LTR/ERVL	2096	+	220	74956007	5466
chr5	74950541	75150541	harbor1	chr5	74956263	74956274	LTR/ERVL	1570	+	6	74956269	5728
chr5	74950541	75150541	harbor1	chr5	75020069	75020661	LTR/ERVL	2879	+	296	75020365	69824
chr5	73114177	73314177	harbor1	chr5	73139198	73139277	LTR/ERVL	482	+	40	73139238	25061
chr5	73114177	73314177	harbor1	chr5	73139432	73139821	LTR/ERVL	1990	+	194	73139626	25449
chr5	73114177	73314177	harbor1	chr5	73139860	73139916	LTR/ERVL	1990	+	28	73139888	25711
chr5	73114177	73314177	harbor1	chr5	73167179	73167615	LTR/ERVL	1392	+	218	73167397	53220
chr5	171288209	171488209	harbor1	chr5	171332101	171332362	LTR/ERVL	600	+	130	171332231	44022
chr5	171288209	171488209	harbor1	chr5	171332543	171332683	LTR/ERVL	602	+	70	171332613	44404
chr5	171288209	171488209	harbor1	chr5	171356741	171357110	LTR/ERVL	668	+	184	171356925	68716
chr5	171288209	171488209	harbor1	chr5	171357682	171358489	LTR/ERVL	1349	+	404	171358086	69877
chr5	171288209	171488209	harbor1	chr5	171378068	171378196	LTR/ERVL	433	+	64	171378132	89923
chr5	171288209	171488209	harbor1	chr5	171379200	171379339	LTR/ERVL	547	+	70	171379270	91061
chr5	181061409	181261409	harbor1	chr5	181081170	181081393	LTR/ERVL	1267	+	112	181081282	19873
chr5	181061409	181261409	harbor1	chr5	181081635	181081839	LTR/ERVL	1089	+	102	181081737	20328
chr5	181061409	181261409	harbor1	chr5	181120456	181120578	LTR/ERVL	452	+	61	181120517	59108
chr5	181061409	181261409	harbor1	chr5	181120881	181121078	LTR/ERVL	452	+	98	181120979	59570
chr5	181061409	181261409	harbor1	chr5	181121098	181121571	LTR/ERVL	1516	+	236	181121334	59925
chr5	181061409	181261409	harbor1	chr5	181122591	181122650	LTR/ERVL	424	+	30	181122621	61212
chr5	181061409	181261409	harbor1	chr5	181122896	181122970	LTR/ERVL	424	+	37	181122933	61524
chr5	181061409	181261409	harbor1	chr5	181140795	181141314	LTR/ERVL	1884	+	260	181141055	79646
chr5	10661175	10861175	harbor1	chr5	10672684	10673047	LTR/ERVL	1828	+	182	10672866	11691
chr5	10661175	10861175	harbor1	chr5	10716384	10716832	LTR/ERVL	3087	+	224	10716608	55433
chr5	10661175	10861175	harbor1	chr5	10716833	10717681	LTR/ERVL	6539	+	424	10717257	56082
chr5	10661175	10861175	harbor1	chr5	10717681	10720094	LTR/ERVL	18730	+	1206	10718887	57712
chr5	10661175	10861175	harbor1	chr5	10720111	10720185	LTR/ERVL	416	+	37	10720148	58973
chr5	10661175	10861175	harbor1	chr5	10720334	10722105	LTR/ERVL	13357	+	886	10721220	60045
chr5	10661175	10861175	harbor1	chr5	10722106	10722498	LTR/ERVL	2866	+	196	10722302	61127
chr5	10661175	10861175	harbor1	chr5	10747636	10747809	LTR/ERVL	448	+	86	10747722	86547
chr5	93221055	93421055	harbor1	chr5	93240421	93240830	LTR/ERVL	734	+	204	93240625	19570
chr5	93221055	93421055	harbor1	chr5	93253165	93253613	LTR/ERVL	578	+	224	93253389	32334
chr5	93221055	93421055	harbor1	chr5	93305993	93306494	LTR/ERVL	506	+	250	93306243	85188
chr5	93221055	93421055	harbor1	chr5	93314163	93314522	LTR/ERVL	1467	+	180	93314343	93288
chr5	93221055	93421055	harbor1	chr5	93316520	93316746	LTR/ERVL	806	+	113	93316633	95578
chr5	52700079	52900079	harbor1	chr5	52702003	52702540	LTR/ERVL	2082	+	268	52702271	2192
chr5	52700079	52900079	harbor1	chr5	52714551	52714759	LTR/ERVL	621	+	104	52714655	14576
chr5	4842506	5042506	harbor1	chr5	4901655	4902098	LTR/ERVL	571	+	222	4901877	59371
chr5	4842506	5042506	harbor1	chr5	4923826	4924340	LTR/ERVL	1739	+	257	4924083	81577
chr5	4842506	5042506	harbor1	chr5	4939477	4939685	LTR/ERVL	744	+	104	4939581	97075
chr5	4842506	5042506	harbor1	chr5	4882080	4882530	LTR/ERVL	1520	+	225	4882305	39799
chr5	150964913	151164913	harbor1	chr5	151000078	151000460	LTR/ERVL	959	+	191	151000269	35356
chr5	150964913	151164913	harbor1	chr5	151014808	151015352	LTR/ERVL	2646	+	272	151015080	50167
chr5	150964913	151164913	harbor1	chr5	151016043	151016486	LTR/ERVL	1932	+	222	151016265	51352
chr5	52699708	52899708	harbor1	chr5	52702003	52702540	LTR/ERVL	2082	+	268	52702271	2563
chr5	52699708	52899708	harbor1	chr5	52714551	52714759	LTR/ERVL	621	+	104	52714655	14947
chr5	10660536	10860536	harbor1	chr5	10672684	10673047	LTR/ERVL	1828	+	182	10672866	12330
chr5	10660536	10860536	harbor1	chr5	10716384	10716832	LTR/ERVL	3087	+	224	10716608	56072
chr5	10660536	10860536	harbor1	chr5	10716833	10717681	LTR/ERVL	6539	+	424	10717257	56721
chr5	10660536	10860536	harbor1	chr5	10717681	10720094	LTR/ERVL	18730	+	1206	10718887	58351
chr5	10660536	10860536	harbor1	chr5	10720111	10720185	LTR/ERVL	416	+	37	10720148	59612
chr5	10660536	10860536	harbor1	chr5	10720334	10722105	LTR/ERVL	13357	+	886	10721220	60684
chr5	10660536	10860536	harbor1	chr5	10722106	10722498	LTR/ERVL	2866	+	196	10722302	61766
chr5	10660536	10860536	harbor1	chr5	10747636	10747809	LTR/ERVL	448	+	86	10747722	87186
chr5	10024023	10224023	harbor1	chr5	10042934	10043303	LTR/ERVL	1966	+	184	10043118	19095
chr5	10024023	10224023	harbor1	chr5	10072015	10072160	LTR/ERVL	1226	+	72	10072087	48064
chr5	10024023	10224023	harbor1	chr5	10072509	10073020	LTR/ERVL	1226	+	256	10072765	48742
chr5	10024023	10224023	harbor1	chr5	10112043	10112519	LTR/ERVL	1210	+	238	10112281	88258
chr5	10024023	10224023	harbor1	chr5	10112873	10112990	LTR/ERVL	1210	+	58	10112931	88908
chr5	2003356	2203356	harbor1	chr5	2010372	2010658	LTR/ERVL	970	+	143	2010515	7159
chr5	2003356	2203356	harbor1	chr5	2010804	2010957	LTR/ERVL	625	+	76	2010880	7524
chr5	2003356	2203356	harbor1	chr5	2012700	2012947	LTR/ERVL	448	+	124	2012824	9468
chr5	2003356	2203356	harbor1	chr5	2045445	2045818	LTR/ERVL	635	+	186	2045631	42275
chr5	132103911	132303911	harbor1	chr5	132190262	132190427	LTR/ERVL	498	+	82	132190344	86433
chr5	132103911	132303911	harbor1	chr5	132202871	132203347	LTR/ERVL	2804	+	238	132203109	99198
chr5	79136012	79336012	harbor1	chr5	79139387	79139846	LTR/ERVL	937	+	230	79139617	3605
chr5	79136012	79336012	harbor1	chr5	79206034	79206481	LTR/ERVL	649	+	224	79206258	70246
chr5	79136012	79336012	harbor1	chr5	79221568	79221920	LTR/ERVL	804	+	176	79221744	85732
chr5	79136012	79336012	harbor1	chr5	79225183	79225583	LTR/ERVL	1310	+	200	79225383	89371
chr5	79136012	79336012	harbor1	chr5	79227680	79228060	LTR/ERVL	1044	+	190	79227870	91858
chr5	79136012	79336012	harbor1	chr5	79228212	79229807	LTR/ERVL	3112	+	798	79229010	92998
chr5	79136012	79336012	harbor1	chr5	79230925	79231100	LTR/ERVL	657	+	88	79231013	95001
chr5	79136012	79336012	harbor1	chr5	79231101	79231303	LTR/ERVL	883	+	101	79231202	95190
chr5	79136012	79336012	harbor1	chr5	79231610	79231720	LTR/ERVL	883	+	55	79231665	95653
chr5	79136012	79336012	harbor1	chr5	79232019	79232082	LTR/ERVL	883	+	32	79232051	96039
chr5	73350822	73550822	harbor1	chr5	73395554	73397440	LTR/ERVL	9098	+	943	73396497	45675
chr5	73350822	73550822	harbor1	chr5	73397441	73398002	LTR/ERVL	1348	+	280	73397721	46899
chr5	73350822	73550822	harbor1	chr5	73426255	73426780	LTR/ERVL	2886	+	262	73426517	75695
chr5	10661147	10861147	harbor1	chr5	10672684	10673047	LTR/ERVL	1828	+	182	10672866	11719
chr5	10661147	10861147	harbor1	chr5	10716384	10716832	LTR/ERVL	3087	+	224	10716608	55461
chr5	10661147	10861147	harbor1	chr5	10716833	10717681	LTR/ERVL	6539	+	424	10717257	56110
chr5	10661147	10861147	harbor1	chr5	10717681	10720094	LTR/ERVL	18730	+	1206	10718887	57740
chr5	10661147	10861147	harbor1	chr5	10720111	10720185	LTR/ERVL	416	+	37	10720148	59001
chr5	10661147	10861147	harbor1	chr5	10720334	10722105	LTR/ERVL	13357	+	886	10721220	60073
chr5	10661147	10861147	harbor1	chr5	10722106	10722498	LTR/ERVL	2866	+	196	10722302	61155
chr5	10661147	10861147	harbor1	chr5	10747636	10747809	LTR/ERVL	448	+	86	10747722	86575
chr5	135919218	136119218	harbor1	chr5	135924622	135925210	LTR/ERVL	2020	+	294	135924916	5698
chr5	135919218	136119218	harbor1	chr5	135986067	135986327	LTR/ERVL	1059	+	130	135986197	66979
chr5	6533033	6733033	harbor1	chr5	6537900	6538183	LTR/ERVL	1613	+	142	6538042	5009
chr5	6533033	6733033	harbor1	chr5	6557371	6557817	LTR/ERVL	817	+	223	6557594	24561
chr5	6533033	6733033	harbor1	chr5	6572513	6572798	LTR/ERVL	560	+	142	6572655	39622
chr5	6533033	6733033	harbor1	chr5	6591912	6592235	LTR/ERVL	751	+	162	6592074	59041
chr5	6533033	6733033	harbor1	chr5	6595445	6595958	LTR/ERVL	2363	+	256	6595701	62668
chr5	6533033	6733033	harbor1	chr5	6613689	6613801	LTR/ERVL	461	+	56	6613745	80712
chr5	6533033	6733033	harbor1	chr5	6569609	6570026	LTR/ERVL	3100	+	208	6569817	36784
chr5	126677744	126877744	harbor1	chr5	126677887	126678136	LTR/ERVL	3771	+	124	126678011	267
chr5	126677744	126877744	harbor1	chr5	126678447	126678473	LTR/ERVL	3771	+	13	126678460	716
chr5	126677744	126877744	harbor1	chr5	126678772	126679348	LTR/ERVL	3771	+	288	126679060	1316
chr5	126677744	126877744	harbor1	chr5	126679649	126680044	LTR/ERVL	3771	+	198	126679847	2103
chr5	126677744	126877744	harbor1	chr5	126680236	126680468	LTR/ERVL	551	+	116	126680352	2608
chr5	10231669	10431669	harbor1	chr5	10278182	10279043	LTR/ERVL	4610	+	430	10278612	46943
chr5	10231669	10431669	harbor1	chr5	10315613	10315631	LTR/ERVL	1795	+	9	10315622	83953
chr5	10231669	10431669	harbor1	chr5	10315944	10316109	LTR/ERVL	1795	+	82	10316026	84357
chr5	10231669	10431669	harbor1	chr5	10316440	10316690	LTR/ERVL	1795	+	125	10316565	84896
chr5	10231669	10431669	harbor1	chr5	10324392	10324739	LTR/ERVL	1990	+	174	10324566	92897
chr5	93490732	93690732	harbor1	chr5	93491469	93492030	LTR/ERVL	2839	+	280	93491749	1017
chr5	93490732	93690732	harbor1	chr5	93503494	93503987	LTR/ERVL	2798	+	246	93503740	13008
chr5	93490732	93690732	harbor1	chr5	93511062	93511453	LTR/ERVL	1805	+	196	93511258	20526
chr5	93490732	93690732	harbor1	chr5	93546784	93547230	LTR/ERVL	2232	+	223	93547007	56275
chr5	10150998	10350998	harbor1	chr5	10191041	10191152	LTR/ERVL	440	+	56	10191097	40099
chr5	10150998	10350998	harbor1	chr5	10196808	10197381	LTR/ERVL	2154	+	286	10197094	46096
chr5	71628507	71828507	harbor1	chr5	71677462	71677746	LTR/ERVL	475	+	142	71677604	49097
chr5	71628507	71828507	harbor1	chr5	71677774	71678515	LTR/ERVL	1971	+	370	71678144	49637
chr5	71628507	71828507	harbor1	chr5	71679435	71679743	LTR/ERVL	924	+	154	71679589	51082
chr5	179703607	179903607	harbor1	chr5	179782044	179782397	LTR/ERVL	859	+	176	179782220	78613
chr5	78709775	78909775	harbor1	chr5	78716552	78716976	LTR/ERVL	799	+	212	78716764	6989
chr5	78709775	78909775	harbor1	chr5	78774678	78775192	LTR/ERVL	2935	+	257	78774935	65160
chr5	139559517	139759517	harbor1	chr5	139575092	139575306	LTR/ERVL	570	+	107	139575199	15682
chr5	10661144	10861144	harbor1	chr5	10672684	10673047	LTR/ERVL	1828	+	182	10672866	11722
chr5	10661144	10861144	harbor1	chr5	10716384	10716832	LTR/ERVL	3087	+	224	10716608	55464
chr5	10661144	10861144	harbor1	chr5	10716833	10717681	LTR/ERVL	6539	+	424	10717257	56113
chr5	10661144	10861144	harbor1	chr5	10717681	10720094	LTR/ERVL	18730	+	1206	10718887	57743
chr5	10661144	10861144	harbor1	chr5	10720111	10720185	LTR/ERVL	416	+	37	10720148	59004
chr5	10661144	10861144	harbor1	chr5	10720334	10722105	LTR/ERVL	13357	+	886	10721220	60076
chr5	10661144	10861144	harbor1	chr5	10722106	10722498	LTR/ERVL	2866	+	196	10722302	61158
chr5	10661144	10861144	harbor1	chr5	10747636	10747809	LTR/ERVL	448	+	86	10747722	86578
chr5	10661231	10861231	harbor1	chr5	10672684	10673047	LTR/ERVL	1828	+	182	10672866	11635
chr5	10661231	10861231	harbor1	chr5	10716384	10716832	LTR/ERVL	3087	+	224	10716608	55377
chr5	10661231	10861231	harbor1	chr5	10716833	10717681	LTR/ERVL	6539	+	424	10717257	56026
chr5	10661231	10861231	harbor1	chr5	10717681	10720094	LTR/ERVL	18730	+	1206	10718887	57656
chr5	10661231	10861231	harbor1	chr5	10720111	10720185	LTR/ERVL	416	+	37	10720148	58917
chr5	10661231	10861231	harbor1	chr5	10720334	10722105	LTR/ERVL	13357	+	886	10721220	59989
chr5	10661231	10861231	harbor1	chr5	10722106	10722498	LTR/ERVL	2866	+	196	10722302	61071
chr5	10661231	10861231	harbor1	chr5	10747636	10747809	LTR/ERVL	448	+	86	10747722	86491
chr5	137653913	137853913	harbor1	chr5	137672986	137673425	LTR/ERVL	2786	+	220	137673206	19293
chr5	133904558	134104558	harbor1	chr5	133909956	133910354	LTR/ERVL	1892	+	199	133910155	5597
chr5	133904558	134104558	harbor1	chr5	133932730	133933224	LTR/ERVL	2602	+	247	133932977	28419
chr5	133904558	134104558	harbor1	chr5	133983644	133983702	LTR/ERVL	434	+	29	133983673	79115
chr5	133904558	134104558	harbor1	chr5	133984964	133985256	LTR/ERVL	1893	+	146	133985110	80552
chr5	133904558	134104558	harbor1	chr5	133999419	133999688	LTR/ERVL	1046	+	134	133999553	94995
chr6	139275451	139475451	harbor1	chr6	139285693	139285793	LTR/ERVL	726	+	50	139285743	10292
chr6	139275451	139475451	harbor1	chr6	139287058	139287389	LTR/ERVL	2163	+	166	139287224	11773
chr6	31056818	31256818	harbor1	chr6	31078491	31078952	LTR/ERVL	676	+	230	31078721	21903
chr6	31056818	31256818	harbor1	chr6	31079255	31079306	LTR/ERVL	676	+	26	31079281	22463
chr6	31056818	31256818	harbor1	chr6	31082397	31082553	LTR/ERVL	568	+	78	31082475	25657
chr6	139275552	139475552	harbor1	chr6	139285693	139285793	LTR/ERVL	726	+	50	139285743	10191
chr6	139275552	139475552	harbor1	chr6	139287058	139287389	LTR/ERVL	2163	+	166	139287224	11672
chr6	139268099	139468099	harbor1	chr6	139285693	139285793	LTR/ERVL	726	+	50	139285743	17644
chr6	139268099	139468099	harbor1	chr6	139287058	139287389	LTR/ERVL	2163	+	166	139287224	19125
chr6	127167311	127367311	harbor1	chr6	127223432	127223897	LTR/ERVL	966	+	232	127223664	56353
chr6	127167311	127367311	harbor1	chr6	127239428	127239578	LTR/ERVL	846	+	75	127239503	72192
chr6	127167311	127367311	harbor1	chr6	127249110	127249446	LTR/ERVL	665	+	168	127249278	81967
chr6	127167311	127367311	harbor1	chr6	127249471	127249637	LTR/ERVL	747	+	83	127249554	82243
chr6	89719728	89919728	harbor1	chr6	89799975	89800145	LTR/ERVL	2469	+	85	89800060	80332
chr6	89719728	89919728	harbor1	chr6	89800455	89800990	LTR/ERVL	2469	+	268	89800723	80995
chr6	166512562	166712562	harbor1	chr6	166519863	166520568	LTR/ERVL	1870	+	352	166520215	7653
chr6	166512562	166712562	harbor1	chr6	166530155	166530651	LTR/ERVL	2053	+	248	166530403	17841
chr6	166512562	166712562	harbor1	chr6	166596246	166596804	LTR/ERVL	1986	+	279	166596525	83963
chr6	166512562	166712562	harbor1	chr6	166602944	166603377	LTR/ERVL	680	+	216	166603160	90598
chr6	139275170	139475170	harbor1	chr6	139285693	139285793	LTR/ERVL	726	+	50	139285743	10573
chr6	139275170	139475170	harbor1	chr6	139287058	139287389	LTR/ERVL	2163	+	166	139287224	12054
chr6	124862435	125062435	harbor1	chr6	124917781	124918185	LTR/ERVL	1706	+	202	124917983	55548
chr6	11481954	11681954	harbor1	chr6	11483266	11483685	LTR/ERVL	1243	+	210	11483476	1522
chr6	11481954	11681954	harbor1	chr6	11497919	11498231	LTR/ERVL	1199	+	156	11498075	16121
chr6	11481954	11681954	harbor1	chr6	11532035	11532472	LTR/ERVL	1989	+	218	11532253	50299
chr6	7626957	7826957	harbor1	chr6	7674100	7674671	LTR/ERVL	1086	+	286	7674386	47429
chr6	7626957	7826957	harbor1	chr6	7677028	7677379	LTR/ERVL	2317	+	176	7677204	50247
chr6	7626957	7826957	harbor1	chr6	7677510	7677549	LTR/ERVL	2317	+	20	7677530	50573
chr6	105894234	106094234	harbor1	chr6	105907961	105908290	LTR/ERVL	951	+	164	105908125	13891
chr6	105894234	106094234	harbor1	chr6	105929865	105930205	LTR/ERVL	746	+	170	105930035	35801
chr6	105894234	106094234	harbor1	chr6	105964240	105964760	LTR/ERVL	1303	+	260	105964500	70266
chr6	105894234	106094234	harbor1	chr6	105972930	105973372	LTR/ERVL	1868	+	221	105973151	78917
chr6	107387585	107587585	harbor1	chr6	107439409	107440471	LTR/ERVL	1358	+	531	107439940	52355
chr6	107387585	107587585	harbor1	chr6	107440529	107440702	LTR/ERVL	520	+	86	107440615	53030
chr6	138673799	138873799	harbor1	chr6	138698642	138699004	LTR/ERVL	683	+	181	138698823	25024
chr6	138673799	138873799	harbor1	chr6	138734780	138734967	LTR/ERVL	766	+	94	138734874	61075
chr6	138673799	138873799	harbor1	chr6	138737919	138738048	LTR/ERVL	1836	+	64	138737983	64184
chr6	138673799	138873799	harbor1	chr6	138738347	138738793	LTR/ERVL	1836	+	223	138738570	64771
chr6	138673799	138873799	harbor1	chr6	138739104	138739184	LTR/ERVL	1836	+	40	138739144	65345
chr6	138673799	138873799	harbor1	chr6	138740831	138741171	LTR/ERVL	617	+	170	138741001	67202
chr6	138673799	138873799	harbor1	chr6	138742359	138742645	LTR/ERVL	563	+	143	138742502	68703
chr6	138673799	138873799	harbor1	chr6	138742821	138743532	LTR/ERVL	1879	+	356	138743177	69378
chr6	138673799	138873799	harbor1	chr6	138743846	138744048	LTR/ERVL	1879	+	101	138743947	70148
chr6	138673799	138873799	harbor1	chr6	138739471	138740430	LTR/ERVL	1836	+	480	138739951	66152
chr6	35352746	35552746	harbor1	chr6	35432314	35432726	LTR/ERVL	1221	+	206	35432520	79774
chr6	45541025	45741025	harbor1	chr6	45621072	45621915	LTR/ERVL	4750	+	422	45621494	80469
chr6	99421500	99621500	harbor1	chr6	99441973	99442465	LTR/ERVL	842	+	246	99442219	20719
chr6	99421500	99621500	harbor1	chr6	99444407	99444945	LTR/ERVL	2952	+	269	99444676	23176
chr6	99421500	99621500	harbor1	chr6	99501824	99502578	LTR/ERVL	1092	+	377	99502201	80701
chr6	107722375	107922375	harbor1	chr6	107775433	107775543	LTR/ERVL	579	+	55	107775488	53113
chr6	107722375	107922375	harbor1	chr6	107783740	107784125	LTR/ERVL	601	+	192	107783932	61557
chr6	107722375	107922375	harbor1	chr6	107800633	107800848	LTR/ERVL	692	+	108	107800741	78366
chr6	107722375	107922375	harbor1	chr6	107812433	107812866	LTR/ERVL	2386	+	216	107812649	90274
chr6	107722375	107922375	harbor1	chr6	107812916	107812950	LTR/ERVL	2386	+	17	107812933	90558
chr6	139274146	139474146	harbor1	chr6	139285693	139285793	LTR/ERVL	726	+	50	139285743	11597
chr6	139274146	139474146	harbor1	chr6	139287058	139287389	LTR/ERVL	2163	+	166	139287224	13078
chr6	36493941	36693941	harbor1	chr6	36586605	36586742	LTR/ERVL	542	+	68	36586673	92732
chr6	77363005	77563005	harbor1	chr6	77363736	77363902	LTR/ERVL	532	+	83	77363819	814
chr6	77363005	77563005	harbor1	chr6	77364124	77364500	LTR/ERVL	565	+	188	77364312	1307
chr6	77363005	77563005	harbor1	chr6	77364510	77365171	LTR/ERVL	1689	+	330	77364840	1835
chr6	77363005	77563005	harbor1	chr6	77373959	77374381	LTR/ERVL	1296	+	211	77374170	11165
chr6	77363005	77563005	harbor1	chr6	77428294	77428695	LTR/ERVL	1305	+	200	77428494	65489
chr6	77363005	77563005	harbor1	chr6	77440327	77440686	LTR/ERVL	1403	+	180	77440507	77502
chr6	139274683	139474683	harbor1	chr6	139285693	139285793	LTR/ERVL	726	+	50	139285743	11060
chr6	139274683	139474683	harbor1	chr6	139287058	139287389	LTR/ERVL	2163	+	166	139287224	12541
chr6	169864005	170064005	harbor1	chr6	169953458	169954304	LTR/ERVL	3116	+	423	169953881	89876
chr6	169864005	170064005	harbor1	chr6	169954339	169954998	LTR/ERVL	3405	+	330	169954669	90664
chr6	30784323	30984323	harbor1	chr6	30810701	30811222	LTR/ERVL	2188	+	260	30810961	26638
chr6	30784323	30984323	harbor1	chr6	30820210	30820620	LTR/ERVL	1011	+	205	30820415	36092
chr6	30784323	30984323	harbor1	chr6	30832625	30833083	LTR/ERVL	1396	+	229	30832854	48531
chr6	30784323	30984323	harbor1	chr6	30833447	30833491	LTR/ERVL	1089	+	22	30833469	49146
chr6	30784323	30984323	harbor1	chr6	30873343	30873529	LTR/ERVL	608	+	93	30873436	89113
chr6	10421300	10621300	harbor1	chr6	10451060	10451872	LTR/ERVL	4437	+	406	10451466	30166
chr6	10421300	10621300	harbor1	chr6	10469877	10470174	LTR/ERVL	561	+	148	10470025	48725
chr6	10421300	10621300	harbor1	chr6	10475018	10475747	LTR/ERVL	2386	+	364	10475382	54082
chr6	10421300	10621300	harbor1	chr6	10476219	10477348	LTR/ERVL	1726	+	564	10476783	55483
chr6	10421300	10621300	harbor1	chr6	10477445	10477506	LTR/ERVL	963	+	30	10477475	56175
chr6	10421300	10621300	harbor1	chr6	10477801	10478178	LTR/ERVL	963	+	188	10477989	56689
chr6	10421300	10621300	harbor1	chr6	10486070	10486316	LTR/ERVL	1284	+	123	10486193	64893
chr6	139275445	139475445	harbor1	chr6	139285693	139285793	LTR/ERVL	726	+	50	139285743	10298
chr6	139275445	139475445	harbor1	chr6	139287058	139287389	LTR/ERVL	2163	+	166	139287224	11779
chr6	7626988	7826988	harbor1	chr6	7674100	7674671	LTR/ERVL	1086	+	286	7674386	47398
chr6	7626988	7826988	harbor1	chr6	7677028	7677379	LTR/ERVL	2317	+	176	7677204	50216
chr6	7626988	7826988	harbor1	chr6	7677510	7677549	LTR/ERVL	2317	+	20	7677530	50542
chr6	27415355	27615355	harbor1	chr6	27435701	27435944	LTR/ERVL	647	+	122	27435823	20468
chr6	27415355	27615355	harbor1	chr6	27461123	27461449	LTR/ERVL	503	+	163	27461286	45931
chr6	27415355	27615355	harbor1	chr6	27491903	27492166	LTR/ERVL	1697	+	132	27492035	76680
chr6	27415355	27615355	harbor1	chr6	27492790	27493135	LTR/ERVL	1327	+	172	27492962	77607
chr6	27415355	27615355	harbor1	chr6	27493205	27493436	LTR/ERVL	593	+	116	27493321	77966
chr6	27415355	27615355	harbor1	chr6	27498116	27498540	LTR/ERVL	1414	+	212	27498328	82973
chr6	27415355	27615355	harbor1	chr6	27492316	27492531	LTR/ERVL	550	+	108	27492424	77069
chr6	30366671	30566671	harbor1	chr6	30402231	30402587	LTR/ERVL	1427	+	178	30402409	35738
chr6	30366671	30566671	harbor1	chr6	30402943	30403264	LTR/ERVL	4799	+	160	30403103	36432
chr6	30366671	30566671	harbor1	chr6	30404040	30404937	LTR/ERVL	4799	+	448	30404488	37817
chr6	139274657	139474657	harbor1	chr6	139285693	139285793	LTR/ERVL	726	+	50	139285743	11086
chr6	139274657	139474657	harbor1	chr6	139287058	139287389	LTR/ERVL	2163	+	166	139287224	12567
chr6	81650363	81850363	harbor1	chr6	81650238	81650696	LTR/ERVL	2783	+	229	81650467	104
chr6	81650363	81850363	harbor1	chr6	81668894	81669164	LTR/ERVL	723	+	135	81669029	18666
chr6	81650363	81850363	harbor1	chr6	81669473	81669578	LTR/ERVL	723	+	52	81669525	19162
chr6	81650363	81850363	harbor1	chr6	81689812	81690409	LTR/ERVL	1297	+	298	81690110	39747
chr6	81650363	81850363	harbor1	chr6	81691927	81691997	LTR/ERVL	531	+	35	81691962	41599
chr6	81650363	81850363	harbor1	chr6	81692293	81692770	LTR/ERVL	531	+	238	81692531	42168
chr6	81650363	81850363	harbor1	chr6	81735846	81736343	LTR/ERVL	1405	+	248	81736094	85731
chr6	147104160	147304160	harbor1	chr6	147165420	147165865	LTR/ERVL	1974	+	222	147165642	61482
chr6	36343280	36543280	harbor1	chr6	36344458	36344674	LTR/ERVL	1622	+	108	36344566	1286
chr6	36343280	36543280	harbor1	chr6	36350571	36350770	LTR/ERVL	523	+	100	36350671	7391
chr6	52184786	52384786	harbor1	chr6	52194886	52194941	LTR/ERVL	2515	+	28	52194914	10128
chr6	52184786	52384786	harbor1	chr6	52195310	52195486	LTR/ERVL	2515	+	88	52195398	10612
chr6	52184786	52384786	harbor1	chr6	52195532	52195793	LTR/ERVL	2515	+	130	52195662	10876
chr6	52184786	52384786	harbor1	chr6	52237730	52238129	LTR/ERVL	2375	+	200	52237930	53144
chr6	52184744	52384744	harbor1	chr6	52194886	52194941	LTR/ERVL	2515	+	28	52194914	10170
chr6	52184744	52384744	harbor1	chr6	52195310	52195486	LTR/ERVL	2515	+	88	52195398	10654
chr6	52184744	52384744	harbor1	chr6	52195532	52195793	LTR/ERVL	2515	+	130	52195662	10918
chr6	52184744	52384744	harbor1	chr6	52237730	52238129	LTR/ERVL	2375	+	200	52237930	53186
chr6	169864011	170064011	harbor1	chr6	169953458	169954304	LTR/ERVL	3116	+	423	169953881	89870
chr6	169864011	170064011	harbor1	chr6	169954339	169954998	LTR/ERVL	3405	+	330	169954669	90658
chr6	10422562	10622562	harbor1	chr6	10451060	10451872	LTR/ERVL	4437	+	406	10451466	28904
chr6	10422562	10622562	harbor1	chr6	10469877	10470174	LTR/ERVL	561	+	148	10470025	47463
chr6	10422562	10622562	harbor1	chr6	10475018	10475747	LTR/ERVL	2386	+	364	10475382	52820
chr6	10422562	10622562	harbor1	chr6	10476219	10477348	LTR/ERVL	1726	+	564	10476783	54221
chr6	10422562	10622562	harbor1	chr6	10477445	10477506	LTR/ERVL	963	+	30	10477475	54913
chr6	10422562	10622562	harbor1	chr6	10477801	10478178	LTR/ERVL	963	+	188	10477989	55427
chr6	10422562	10622562	harbor1	chr6	10486070	10486316	LTR/ERVL	1284	+	123	10486193	63631
chr6	42878982	43078982	harbor1	chr6	42904089	42904398	LTR/ERVL	1403	+	154	42904243	25261
chr6	42878982	43078982	harbor1	chr6	42905005	42905447	LTR/ERVL	1403	+	221	42905226	26244
chr6	42878982	43078982	harbor1	chr6	42907134	42907383	LTR/ERVL	537	+	124	42907258	28276
chr6	42878982	43078982	harbor1	chr6	42907426	42908133	LTR/ERVL	1344	+	354	42907780	28798
chr6	42878982	43078982	harbor1	chr6	42908163	42908768	LTR/ERVL	2137	+	302	42908465	29483
chr6	147104106	147304106	harbor1	chr6	147165420	147165865	LTR/ERVL	1974	+	222	147165642	61536
chr6	110248805	110448805	harbor1	chr6	110286663	110287058	LTR/ERVL	2662	+	198	110286861	38056
chr6	7626967	7826967	harbor1	chr6	7674100	7674671	LTR/ERVL	1086	+	286	7674386	47419
chr6	7626967	7826967	harbor1	chr6	7677028	7677379	LTR/ERVL	2317	+	176	7677204	50237
chr6	7626967	7826967	harbor1	chr6	7677510	7677549	LTR/ERVL	2317	+	20	7677530	50563
chr6	52476539	52676539	harbor1	chr6	52492547	52492624	LTR/ERVL	2418	+	38	52492585	16046
chr6	52476539	52676539	harbor1	chr6	52492917	52493390	LTR/ERVL	2418	+	236	52493153	16614
chr6	52476539	52676539	harbor1	chr6	52550144	52550455	LTR/ERVL	586	+	156	52550300	73761
chr6	139274673	139474673	harbor1	chr6	139285693	139285793	LTR/ERVL	726	+	50	139285743	11070
chr6	139274673	139474673	harbor1	chr6	139287058	139287389	LTR/ERVL	2163	+	166	139287224	12551
chr6	30366631	30566631	harbor1	chr6	30402231	30402587	LTR/ERVL	1427	+	178	30402409	35778
chr6	30366631	30566631	harbor1	chr6	30402943	30403264	LTR/ERVL	4799	+	160	30403103	36472
chr6	30366631	30566631	harbor1	chr6	30404040	30404937	LTR/ERVL	4799	+	448	30404488	37857
chr6	127167329	127367329	harbor1	chr6	127223432	127223897	LTR/ERVL	966	+	232	127223664	56335
chr6	127167329	127367329	harbor1	chr6	127239428	127239578	LTR/ERVL	846	+	75	127239503	72174
chr6	127167329	127367329	harbor1	chr6	127249110	127249446	LTR/ERVL	665	+	168	127249278	81949
chr6	127167329	127367329	harbor1	chr6	127249471	127249637	LTR/ERVL	747	+	83	127249554	82225
chr6	52184830	52384830	harbor1	chr6	52194886	52194941	LTR/ERVL	2515	+	28	52194914	10084
chr6	52184830	52384830	harbor1	chr6	52195310	52195486	LTR/ERVL	2515	+	88	52195398	10568
chr6	52184830	52384830	harbor1	chr6	52195532	52195793	LTR/ERVL	2515	+	130	52195662	10832
chr6	52184830	52384830	harbor1	chr6	52237730	52238129	LTR/ERVL	2375	+	200	52237930	53100
chr6	139274467	139474467	harbor1	chr6	139285693	139285793	LTR/ERVL	726	+	50	139285743	11276
chr6	139274467	139474467	harbor1	chr6	139287058	139287389	LTR/ERVL	2163	+	166	139287224	12757
chr6	127167314	127367314	harbor1	chr6	127223432	127223897	LTR/ERVL	966	+	232	127223664	56350
chr6	127167314	127367314	harbor1	chr6	127239428	127239578	LTR/ERVL	846	+	75	127239503	72189
chr6	127167314	127367314	harbor1	chr6	127249110	127249446	LTR/ERVL	665	+	168	127249278	81964
chr6	127167314	127367314	harbor1	chr6	127249471	127249637	LTR/ERVL	747	+	83	127249554	82240
chr6	33522121	33722121	harbor1	chr6	33523993	33524415	LTR/ERVL	2402	+	211	33524204	2083
chr6	33522121	33722121	harbor1	chr6	33525211	33525377	LTR/ERVL	959	+	83	33525294	3173
chr6	33522121	33722121	harbor1	chr6	33526177	33526412	LTR/ERVL	994	+	118	33526295	4174
chr6	33522121	33722121	harbor1	chr6	33602003	33602233	LTR/ERVL	559	+	115	33602118	79997
chr6	33522121	33722121	harbor1	chr6	33611986	33612362	LTR/ERVL	1333	+	188	33612174	90053
chr6	33522121	33722121	harbor1	chr6	33612658	33612729	LTR/ERVL	1333	+	36	33612694	90573
chr6	139274604	139474604	harbor1	chr6	139285693	139285793	LTR/ERVL	726	+	50	139285743	11139
chr6	139274604	139474604	harbor1	chr6	139287058	139287389	LTR/ERVL	2163	+	166	139287224	12620
chr6	147104102	147304102	harbor1	chr6	147165420	147165865	LTR/ERVL	1974	+	222	147165642	61540
chr6	139275131	139475131	harbor1	chr6	139285693	139285793	LTR/ERVL	726	+	50	139285743	10612
chr6	139275131	139475131	harbor1	chr6	139287058	139287389	LTR/ERVL	2163	+	166	139287224	12093
chr6	79847089	80047089	harbor1	chr6	79859626	79860016	LTR/ERVL	2128	+	195	79859821	12732
chr6	79847089	80047089	harbor1	chr6	79864474	79865032	LTR/ERVL	1773	+	279	79864753	17664
chr6	79847089	80047089	harbor1	chr6	79902620	79903103	LTR/ERVL	722	+	242	79902862	55773
chr6	165559697	165759697	harbor1	chr6	165583523	165584083	LTR/ERVL	2974	+	280	165583803	24106
chr6	165559697	165759697	harbor1	chr6	165584093	165584655	LTR/ERVL	1022	+	281	165584374	24677
chr6	165559697	165759697	harbor1	chr6	165584662	165585303	LTR/ERVL	2663	+	320	165584982	25285
chr6	165559697	165759697	harbor1	chr6	165585304	165585503	LTR/ERVL	625	+	100	165585404	25707
chr6	165559697	165759697	harbor1	chr6	165621869	165622203	LTR/ERVL	1766	+	167	165622036	62339
chr6	165559697	165759697	harbor1	chr6	165645004	165645188	LTR/ERVL	504	+	92	165645096	85399
chr6	150799534	150999534	harbor1	chr6	150857630	150858046	LTR/ERVL	2938	+	208	150857838	58304
chr6	41091863	41291863	harbor1	chr6	41155189	41155303	LTR/ERVL	547	+	57	41155246	63383
chr6	41091863	41291863	harbor1	chr6	41155333	41155375	LTR/ERVL	814	+	21	41155354	63491
chr6	41091863	41291863	harbor1	chr6	41155407	41155576	LTR/ERVL	814	+	84	41155491	63628
chr6	41091863	41291863	harbor1	chr6	41170742	41171195	LTR/ERVL	992	+	226	41170968	79105
chr6	139275443	139475443	harbor1	chr6	139285693	139285793	LTR/ERVL	726	+	50	139285743	10300
chr6	139275443	139475443	harbor1	chr6	139287058	139287389	LTR/ERVL	2163	+	166	139287224	11781
chr6	45540941	45740941	harbor1	chr6	45621072	45621915	LTR/ERVL	4750	+	422	45621494	80553
chr6	139275520	139475520	harbor1	chr6	139285693	139285793	LTR/ERVL	726	+	50	139285743	10223
chr6	139275520	139475520	harbor1	chr6	139287058	139287389	LTR/ERVL	2163	+	166	139287224	11704
chr6	45540990	45740990	harbor1	chr6	45621072	45621915	LTR/ERVL	4750	+	422	45621494	80504
chr6	43355517	43555517	harbor1	chr6	43378817	43378987	LTR/ERVL	588	+	85	43378902	23385
chr6	43355517	43555517	harbor1	chr6	43383972	43384132	LTR/ERVL	463	+	80	43384052	28535
chr6	43355517	43555517	harbor1	chr6	43389934	43390521	LTR/ERVL	1663	+	294	43390228	34711
chr6	43355517	43555517	harbor1	chr6	43393685	43393797	LTR/ERVL	580	+	56	43393741	38224
chr6	43355517	43555517	harbor1	chr6	43393796	43393919	LTR/ERVL	627	+	62	43393858	38341
chr6	146813054	147013054	harbor1	chr6	146854796	146855346	LTR/ERVL	2060	+	275	146855071	42017
chr6	45540939	45740939	harbor1	chr6	45621072	45621915	LTR/ERVL	4750	+	422	45621494	80555
chr6	166512135	166712135	harbor1	chr6	166519863	166520568	LTR/ERVL	1870	+	352	166520215	8080
chr6	166512135	166712135	harbor1	chr6	166530155	166530651	LTR/ERVL	2053	+	248	166530403	18268
chr6	166512135	166712135	harbor1	chr6	166596246	166596804	LTR/ERVL	1986	+	279	166596525	84390
chr6	166512135	166712135	harbor1	chr6	166602944	166603377	LTR/ERVL	680	+	216	166603160	91025
chr6	43815149	44015149	harbor1	chr6	43817695	43817819	LTR/ERVL	639	+	62	43817757	2608
chr6	43815149	44015149	harbor1	chr6	43817820	43818953	LTR/ERVL	11642	+	566	43818386	3237
chr6	43815149	44015149	harbor1	chr6	43819288	43820199	LTR/ERVL	11642	+	456	43819744	4595
chr6	43815149	44015149	harbor1	chr6	43820339	43820352	LTR/ERVL	2202	+	6	43820345	5196
chr6	43815149	44015149	harbor1	chr6	43820380	43820943	LTR/ERVL	2202	+	282	43820662	5513
chr6	139274545	139474545	harbor1	chr6	139285693	139285793	LTR/ERVL	726	+	50	139285743	11198
chr6	139274545	139474545	harbor1	chr6	139287058	139287389	LTR/ERVL	2163	+	166	139287224	12679
chr6	21629834	21829834	harbor1	chr6	21646653	21646781	LTR/ERVL	470	+	64	21646717	16883
chr6	21629834	21829834	harbor1	chr6	21653219	21653711	LTR/ERVL	1839	+	246	21653465	23631
chr6	21629834	21829834	harbor1	chr6	21654351	21654410	LTR/ERVL	462	+	30	21654381	24547
chr6	7626958	7826958	harbor1	chr6	7674100	7674671	LTR/ERVL	1086	+	286	7674386	47428
chr6	7626958	7826958	harbor1	chr6	7677028	7677379	LTR/ERVL	2317	+	176	7677204	50246
chr6	7626958	7826958	harbor1	chr6	7677510	7677549	LTR/ERVL	2317	+	20	7677530	50572
chr6	144187246	144387246	harbor1	chr6	144234460	144235171	LTR/ERVL	1439	+	356	144234816	47570
chr6	127167324	127367324	harbor1	chr6	127223432	127223897	LTR/ERVL	966	+	232	127223664	56340
chr6	127167324	127367324	harbor1	chr6	127239428	127239578	LTR/ERVL	846	+	75	127239503	72179
chr6	127167324	127367324	harbor1	chr6	127249110	127249446	LTR/ERVL	665	+	168	127249278	81954
chr6	127167324	127367324	harbor1	chr6	127249471	127249637	LTR/ERVL	747	+	83	127249554	82230
chr6	52184746	52384746	harbor1	chr6	52194886	52194941	LTR/ERVL	2515	+	28	52194914	10168
chr6	52184746	52384746	harbor1	chr6	52195310	52195486	LTR/ERVL	2515	+	88	52195398	10652
chr6	52184746	52384746	harbor1	chr6	52195532	52195793	LTR/ERVL	2515	+	130	52195662	10916
chr6	52184746	52384746	harbor1	chr6	52237730	52238129	LTR/ERVL	2375	+	200	52237930	53184
chr6	169863372	170063372	harbor1	chr6	169953458	169954304	LTR/ERVL	3116	+	423	169953881	90509
chr6	169863372	170063372	harbor1	chr6	169954339	169954998	LTR/ERVL	3405	+	330	169954669	91297
chr6	166855964	167055964	harbor1	chr6	166868614	166869023	LTR/ERVL	2917	+	204	166868818	12854
chr6	166855964	167055964	harbor1	chr6	166869194	166869248	LTR/ERVL	462	+	27	166869221	13257
chr6	166855964	167055964	harbor1	chr6	166883969	166884659	LTR/ERVL	1987	+	345	166884314	28350
chr6	127167395	127367395	harbor1	chr6	127223432	127223897	LTR/ERVL	966	+	232	127223664	56269
chr6	127167395	127367395	harbor1	chr6	127239428	127239578	LTR/ERVL	846	+	75	127239503	72108
chr6	127167395	127367395	harbor1	chr6	127249110	127249446	LTR/ERVL	665	+	168	127249278	81883
chr6	127167395	127367395	harbor1	chr6	127249471	127249637	LTR/ERVL	747	+	83	127249554	82159
chr6	324347	524347	harbor1	chr6	384318	384716	LTR/ERVL	604	+	199	384517	60170
chr6	324347	524347	harbor1	chr6	385554	385945	LTR/ERVL	898	+	196	385750	61403
chr6	56854700	57054700	harbor1	chr6	56863937	56864398	LTR/ERVL	2406	+	230	56864167	9467
chr6	56854700	57054700	harbor1	chr6	56897670	56898096	LTR/ERVL	865	+	213	56897883	43183
chr6	56854700	57054700	harbor1	chr6	56914374	56914671	LTR/ERVL	659	+	148	56914522	59822
chr6	56854700	57054700	harbor1	chr6	56885092	56885328	LTR/ERVL	602	+	118	56885210	30510
chr6	24811164	25011164	harbor1	chr6	24903932	24904118	LTR/ERVL	752	+	93	24904025	92861
chr6	24811164	25011164	harbor1	chr6	24904629	24904704	LTR/ERVL	752	+	38	24904667	93503
chr6	139275141	139475141	harbor1	chr6	139285693	139285793	LTR/ERVL	726	+	50	139285743	10602
chr6	139275141	139475141	harbor1	chr6	139287058	139287389	LTR/ERVL	2163	+	166	139287224	12083
chr6	105894232	106094232	harbor1	chr6	105907961	105908290	LTR/ERVL	951	+	164	105908125	13893
chr6	105894232	106094232	harbor1	chr6	105929865	105930205	LTR/ERVL	746	+	170	105930035	35803
chr6	105894232	106094232	harbor1	chr6	105964240	105964760	LTR/ERVL	1303	+	260	105964500	70268
chr6	105894232	106094232	harbor1	chr6	105972930	105973372	LTR/ERVL	1868	+	221	105973151	78919
chr6	127167313	127367313	harbor1	chr6	127223432	127223897	LTR/ERVL	966	+	232	127223664	56351
chr6	127167313	127367313	harbor1	chr6	127239428	127239578	LTR/ERVL	846	+	75	127239503	72190
chr6	127167313	127367313	harbor1	chr6	127249110	127249446	LTR/ERVL	665	+	168	127249278	81965
chr6	127167313	127367313	harbor1	chr6	127249471	127249637	LTR/ERVL	747	+	83	127249554	82241
chr6	45540950	45740950	harbor1	chr6	45621072	45621915	LTR/ERVL	4750	+	422	45621494	80544
chr6	2665182	2865182	harbor1	chr6	2687026	2687401	LTR/ERVL	910	+	188	2687214	22032
chr6	2665182	2865182	harbor1	chr6	2740234	2740692	LTR/ERVL	705	+	229	2740463	75281
chr6	27415346	27615346	harbor1	chr6	27435701	27435944	LTR/ERVL	647	+	122	27435823	20477
chr6	27415346	27615346	harbor1	chr6	27461123	27461449	LTR/ERVL	503	+	163	27461286	45940
chr6	27415346	27615346	harbor1	chr6	27491903	27492166	LTR/ERVL	1697	+	132	27492035	76689
chr6	27415346	27615346	harbor1	chr6	27492790	27493135	LTR/ERVL	1327	+	172	27492962	77616
chr6	27415346	27615346	harbor1	chr6	27493205	27493436	LTR/ERVL	593	+	116	27493321	77975
chr6	27415346	27615346	harbor1	chr6	27498116	27498540	LTR/ERVL	1414	+	212	27498328	82982
chr6	27415346	27615346	harbor1	chr6	27492316	27492531	LTR/ERVL	550	+	108	27492424	77078
chr6	43521769	43721769	harbor1	chr6	43579047	43579886	LTR/ERVL	3810	+	420	43579467	57698
chr6	27415357	27615357	harbor1	chr6	27435701	27435944	LTR/ERVL	647	+	122	27435823	20466
chr6	27415357	27615357	harbor1	chr6	27461123	27461449	LTR/ERVL	503	+	163	27461286	45929
chr6	27415357	27615357	harbor1	chr6	27491903	27492166	LTR/ERVL	1697	+	132	27492035	76678
chr6	27415357	27615357	harbor1	chr6	27492790	27493135	LTR/ERVL	1327	+	172	27492962	77605
chr6	27415357	27615357	harbor1	chr6	27493205	27493436	LTR/ERVL	593	+	116	27493321	77964
chr6	27415357	27615357	harbor1	chr6	27498116	27498540	LTR/ERVL	1414	+	212	27498328	82971
chr6	27415357	27615357	harbor1	chr6	27492316	27492531	LTR/ERVL	550	+	108	27492424	77067
chr6	107857147	108057147	harbor1	chr6	107866061	107866496	LTR/ERVL	1310	+	218	107866279	9132
chr6	35352842	35552842	harbor1	chr6	35432314	35432726	LTR/ERVL	1221	+	206	35432520	79678
chr6	31172336	31372336	harbor1	chr6	31223244	31223678	LTR/ERVL	3352	+	217	31223461	51125
chr6	31172336	31372336	harbor1	chr6	31228580	31229013	LTR/ERVL	939	+	216	31228796	56460
chr6	31172336	31372336	harbor1	chr6	31251167	31251429	LTR/ERVL	936	+	131	31251298	78962
chr6	31172336	31372336	harbor1	chr6	31251432	31251780	LTR/ERVL	1383	+	174	31251606	79270
chr6	31172336	31372336	harbor1	chr6	31252131	31252464	LTR/ERVL	1787	+	166	31252297	79961
chr6	31172336	31372336	harbor1	chr6	31253233	31253484	LTR/ERVL	1787	+	126	31253359	81023
chr6	31172336	31372336	harbor1	chr6	31253584	31254147	LTR/ERVL	2573	+	282	31253866	81530
chr6	31172336	31372336	harbor1	chr6	31261086	31261553	LTR/ERVL	1834	+	234	31261320	88984
chr6	31172336	31372336	harbor1	chr6	31262878	31263151	LTR/ERVL	1033	+	136	31263014	90678
chr6	13611912	13811912	harbor1	chr6	13678416	13678795	LTR/ERVL	1320	+	190	13678606	66694
chr6	52184768	52384768	harbor1	chr6	52194886	52194941	LTR/ERVL	2515	+	28	52194914	10146
chr6	52184768	52384768	harbor1	chr6	52195310	52195486	LTR/ERVL	2515	+	88	52195398	10630
chr6	52184768	52384768	harbor1	chr6	52195532	52195793	LTR/ERVL	2515	+	130	52195662	10894
chr6	52184768	52384768	harbor1	chr6	52237730	52238129	LTR/ERVL	2375	+	200	52237930	53162
chr6	124862446	125062446	harbor1	chr6	124917781	124918185	LTR/ERVL	1706	+	202	124917983	55537
chr6	139275129	139475129	harbor1	chr6	139285693	139285793	LTR/ERVL	726	+	50	139285743	10614
chr6	139275129	139475129	harbor1	chr6	139287058	139287389	LTR/ERVL	2163	+	166	139287224	12095
chr6	139275116	139475116	harbor1	chr6	139285693	139285793	LTR/ERVL	726	+	50	139285743	10627
chr6	139275116	139475116	harbor1	chr6	139287058	139287389	LTR/ERVL	2163	+	166	139287224	12108
chr6	31901468	32101468	harbor1	chr6	31913245	31913293	LTR/ERVL	611	+	24	31913269	11801
chr6	31901468	32101468	harbor1	chr6	31913610	31913647	LTR/ERVL	611	+	18	31913628	12160
chr6	31901468	32101468	harbor1	chr6	31914211	31914310	LTR/ERVL	611	+	50	31914261	12793
chr6	41091918	41291918	harbor1	chr6	41155189	41155303	LTR/ERVL	547	+	57	41155246	63328
chr6	41091918	41291918	harbor1	chr6	41155333	41155375	LTR/ERVL	814	+	21	41155354	63436
chr6	41091918	41291918	harbor1	chr6	41155407	41155576	LTR/ERVL	814	+	84	41155491	63573
chr6	41091918	41291918	harbor1	chr6	41170742	41171195	LTR/ERVL	992	+	226	41170968	79050
chr6	159069545	159269545	harbor1	chr6	159068930	159069586	LTR/ERVL	828	+	328	159069258	287
chr6	159069545	159269545	harbor1	chr6	159148521	159149037	LTR/ERVL	3181	+	258	159148779	79234
chr6	73362002	73562002	harbor1	chr6	73421611	73422177	LTR/ERVL	2126	+	283	73421894	59892
chr6	63473420	63673420	harbor1	chr6	63525227	63525875	LTR/ERVL	1564	+	324	63525551	52131
chr6	146812183	147012183	harbor1	chr6	146854796	146855346	LTR/ERVL	2060	+	275	146855071	42888
chr6	27415340	27615340	harbor1	chr6	27435701	27435944	LTR/ERVL	647	+	122	27435823	20483
chr6	27415340	27615340	harbor1	chr6	27461123	27461449	LTR/ERVL	503	+	163	27461286	45946
chr6	27415340	27615340	harbor1	chr6	27491903	27492166	LTR/ERVL	1697	+	132	27492035	76695
chr6	27415340	27615340	harbor1	chr6	27492790	27493135	LTR/ERVL	1327	+	172	27492962	77622
chr6	27415340	27615340	harbor1	chr6	27493205	27493436	LTR/ERVL	593	+	116	27493321	77981
chr6	27415340	27615340	harbor1	chr6	27498116	27498540	LTR/ERVL	1414	+	212	27498328	82988
chr6	27415340	27615340	harbor1	chr6	27492316	27492531	LTR/ERVL	550	+	108	27492424	77084
chr6	32752654	32952654	harbor1	chr6	32811165	32811646	LTR/ERVL	3139	+	240	32811405	58751
chr6	32752654	32952654	harbor1	chr6	32816470	32816595	LTR/ERVL	625	+	62	32816532	63878
chr6	87813618	88013618	harbor1	chr6	87814752	87814940	LTR/ERVL	983	+	94	87814846	1228
chr6	87813618	88013618	harbor1	chr6	87815244	87815541	LTR/ERVL	983	+	148	87815392	1774
chr6	158719384	158919384	harbor1	chr6	158808132	158808223	LTR/ERVL	626	+	46	158808178	88794
chr6	158719384	158919384	harbor1	chr6	158808235	158808425	LTR/ERVL	842	+	95	158808330	88946
chr6	32050380	32250380	harbor1	chr6	32123744	32123888	LTR/ERVL	543	+	72	32123816	73436
chr6	169863974	170063974	harbor1	chr6	169953458	169954304	LTR/ERVL	3116	+	423	169953881	89907
chr6	169863974	170063974	harbor1	chr6	169954339	169954998	LTR/ERVL	3405	+	330	169954669	90695
chr6	52184773	52384773	harbor1	chr6	52194886	52194941	LTR/ERVL	2515	+	28	52194914	10141
chr6	52184773	52384773	harbor1	chr6	52195310	52195486	LTR/ERVL	2515	+	88	52195398	10625
chr6	52184773	52384773	harbor1	chr6	52195532	52195793	LTR/ERVL	2515	+	130	52195662	10889
chr6	52184773	52384773	harbor1	chr6	52237730	52238129	LTR/ERVL	2375	+	200	52237930	53157
chr7	50203946	50403946	harbor1	chr7	50290068	50290313	LTR/ERVL	1021	+	122	50290190	86244
chr7	130391130	130591130	harbor1	chr7	130446615	130446980	LTR/ERVL	2118	+	182	130446797	55667
chr7	130391130	130591130	harbor1	chr7	130447017	130447068	LTR/ERVL	2118	+	26	130447043	55913
chr7	1136759	1336759	harbor1	chr7	1161625	1161709	LTR/ERVL	2264	+	42	1161667	24908
chr7	1136759	1336759	harbor1	chr7	1162318	1162576	LTR/ERVL	2264	+	129	1162447	25688
chr7	1136759	1336759	harbor1	chr7	1162872	1163166	LTR/ERVL	2264	+	147	1163019	26260
chr7	39729557	39929557	harbor1	chr7	39780788	39780872	LTR/ERVL	429	+	42	39780830	51273
chr7	39729557	39929557	harbor1	chr7	39781175	39781212	LTR/ERVL	429	+	18	39781193	51636
chr7	39729557	39929557	harbor1	chr7	39781500	39781562	LTR/ERVL	429	+	31	39781531	51974
chr7	39729557	39929557	harbor1	chr7	39790896	39791048	LTR/ERVL	741	+	76	39790972	61415
chr7	39729557	39929557	harbor1	chr7	39825736	39825771	LTR/ERVL	2737	+	18	39825754	96197
chr7	39729557	39929557	harbor1	chr7	39826205	39826949	LTR/ERVL	2737	+	372	39826577	97020
chr7	130568057	130768057	harbor1	chr7	130661259	130661508	LTR/ERVL	494	+	124	130661383	93326
chr7	130568057	130768057	harbor1	chr7	130661514	130662373	LTR/ERVL	3697	+	430	130661944	93887
chr7	130568057	130768057	harbor1	chr7	130662374	130662736	LTR/ERVL	968	+	181	130662555	94498
chr7	50203894	50403894	harbor1	chr7	50290068	50290313	LTR/ERVL	1021	+	122	50290190	86296
chr7	50615299	50815299	harbor1	chr7	50675390	50675775	LTR/ERVL	1981	+	192	50675582	60283
chr7	128305676	128505676	harbor1	chr7	128386407	128386928	LTR/ERVL	2235	+	260	128386667	80991
chr7	1293735	1493735	harbor1	chr7	1310453	1310474	LTR/ERVL	730	+	10	1310463	16728
chr7	1293735	1493735	harbor1	chr7	1310764	1311288	LTR/ERVL	730	+	262	1311026	17291
chr7	50283638	50483638	harbor1	chr7	50290068	50290313	LTR/ERVL	1021	+	122	50290190	6552
chr7	149613875	149813875	harbor1	chr7	149645564	149645586	LTR/ERVL	2209	+	11	149645575	31700
chr7	149613875	149813875	harbor1	chr7	149645881	149646225	LTR/ERVL	2209	+	172	149646053	32178
chr7	149613875	149813875	harbor1	chr7	149646258	149646306	LTR/ERVL	2209	+	24	149646282	32407
chr7	123649229	123849229	harbor1	chr7	123697669	123698225	LTR/ERVL	2687	+	278	123697947	48718
chr7	50204667	50404667	harbor1	chr7	50290068	50290313	LTR/ERVL	1021	+	122	50290190	85523
chr7	47567087	47767087	harbor1	chr7	47585495	47585898	LTR/ERVL	2387	+	202	47585697	18610
chr7	47567087	47767087	harbor1	chr7	47586199	47586279	LTR/ERVL	2387	+	40	47586239	19152
chr7	123649386	123849386	harbor1	chr7	123697669	123698225	LTR/ERVL	2687	+	278	123697947	48561
chr7	41324284	41524284	harbor1	chr7	41338406	41338613	LTR/ERVL	648	+	104	41338510	14226
chr7	41324284	41524284	harbor1	chr7	41338622	41338908	LTR/ERVL	828	+	143	41338765	14481
chr7	47246884	47446884	harbor1	chr7	47255484	47256356	LTR/ERVL	4698	+	436	47255920	9036
chr7	50203975	50403975	harbor1	chr7	50290068	50290313	LTR/ERVL	1021	+	122	50290190	86215
chr7	6404408	6604408	harbor1	chr7	6453664	6454220	LTR/ERVL	3045	+	278	6453942	49534
chr7	6404408	6604408	harbor1	chr7	6454512	6454550	LTR/ERVL	3045	+	19	6454531	50123
chr7	47228348	47428348	harbor1	chr7	47255484	47256356	LTR/ERVL	4698	+	436	47255920	27572
chr7	123649293	123849293	harbor1	chr7	123697669	123698225	LTR/ERVL	2687	+	278	123697947	48654
chr7	155249500	155449500	harbor1	chr7	155266577	155267033	LTR/ERVL	853	+	228	155266805	17305
chr7	155249500	155449500	harbor1	chr7	155286322	155286768	LTR/ERVL	3554	+	223	155286545	37045
chr7	155249500	155449500	harbor1	chr7	155336301	155336709	LTR/ERVL	1315	+	204	155336505	87005
chr7	157884935	158084935	harbor1	chr7	157952557	157952764	LTR/ERVL	891	+	104	157952661	67726
chr7	44661435	44861435	harbor1	chr7	44679605	44679928	LTR/ERVL	1614	+	162	44679767	18332
chr7	44661435	44861435	harbor1	chr7	44680242	44680316	LTR/ERVL	1614	+	37	44680279	18844
chr7	44661435	44861435	harbor1	chr7	44725307	44725387	LTR/ERVL	2137	+	40	44725347	63912
chr7	44661435	44861435	harbor1	chr7	44725656	44725673	LTR/ERVL	2137	+	8	44725664	64229
chr7	44661435	44861435	harbor1	chr7	44725950	44726265	LTR/ERVL	2137	+	158	44726108	64673
chr7	44661435	44861435	harbor1	chr7	44726864	44726896	LTR/ERVL	2137	+	16	44726880	65445
chr7	44661435	44861435	harbor1	chr7	44727195	44727384	LTR/ERVL	2137	+	94	44727289	65854
chr7	44661435	44861435	harbor1	chr7	44743827	44744194	LTR/ERVL	1958	+	184	44744011	82576
chr7	123610933	123810933	harbor1	chr7	123697669	123698225	LTR/ERVL	2687	+	278	123697947	87014
chr7	123649263	123849263	harbor1	chr7	123697669	123698225	LTR/ERVL	2687	+	278	123697947	48684
chr7	155231815	155431815	harbor1	chr7	155266577	155267033	LTR/ERVL	853	+	228	155266805	34990
chr7	155231815	155431815	harbor1	chr7	155286322	155286768	LTR/ERVL	3554	+	223	155286545	54730
chr7	1564241	1764241	harbor1	chr7	1591166	1591259	LTR/ERVL	450	+	46	1591212	26971
chr7	1564241	1764241	harbor1	chr7	1591498	1591840	LTR/ERVL	956	+	171	1591669	27428
chr7	50203887	50403887	harbor1	chr7	50290068	50290313	LTR/ERVL	1021	+	122	50290190	86303
chr7	47228344	47428344	harbor1	chr7	47255484	47256356	LTR/ERVL	4698	+	436	47255920	27576
chr7	47228340	47428340	harbor1	chr7	47255484	47256356	LTR/ERVL	4698	+	436	47255920	27580
chr7	80035348	80235348	harbor1	chr7	80079684	80079910	LTR/ERVL	806	+	113	80079797	44449
chr7	80035348	80235348	harbor1	chr7	80128947	80129419	LTR/ERVL	1602	+	236	80129183	93835
chr7	80035348	80235348	harbor1	chr7	80117365	80117896	LTR/ERVL	2425	+	266	80117631	82283
chr7	47228502	47428502	harbor1	chr7	47255484	47256356	LTR/ERVL	4698	+	436	47255920	27418
chr7	123649244	123849244	harbor1	chr7	123697669	123698225	LTR/ERVL	2687	+	278	123697947	48703
chr7	1226149	1426149	harbor1	chr7	1278687	1278802	LTR/ERVL	458	+	58	1278745	52596
chr7	1226149	1426149	harbor1	chr7	1310453	1310474	LTR/ERVL	730	+	10	1310463	84314
chr7	1226149	1426149	harbor1	chr7	1310764	1311288	LTR/ERVL	730	+	262	1311026	84877
chr7	127292503	127492503	harbor1	chr7	127308578	127308708	LTR/ERVL	421	+	65	127308643	16140
chr7	47174241	47374241	harbor1	chr7	47204586	47204794	LTR/ERVL	804	+	104	47204690	30449
chr7	47174241	47374241	harbor1	chr7	47204872	47205139	LTR/ERVL	491	+	134	47205006	30765
chr7	47174241	47374241	harbor1	chr7	47255484	47256356	LTR/ERVL	4698	+	436	47255920	81679
chr7	123649264	123849264	harbor1	chr7	123697669	123698225	LTR/ERVL	2687	+	278	123697947	48683
chr7	47228327	47428327	harbor1	chr7	47255484	47256356	LTR/ERVL	4698	+	436	47255920	27593
chr7	123437338	123637338	harbor1	chr7	123451523	123451988	LTR/ERVL	963	+	232	123451755	14417
chr7	123437338	123637338	harbor1	chr7	123459250	123459711	LTR/ERVL	1456	+	230	123459480	22142
chr7	123437338	123637338	harbor1	chr7	123467270	123467413	LTR/ERVL	477	+	72	123467342	30004
chr7	123437338	123637338	harbor1	chr7	123467563	123467763	LTR/ERVL	873	+	100	123467663	30325
chr7	123437338	123637338	harbor1	chr7	123467793	123468270	LTR/ERVL	806	+	238	123468031	30693
chr7	123437338	123637338	harbor1	chr7	123468418	123468769	LTR/ERVL	1118	+	176	123468594	31256
chr7	123437338	123637338	harbor1	chr7	123480265	123480698	LTR/ERVL	941	+	216	123480481	43143
chr7	123437338	123637338	harbor1	chr7	123522012	123522409	LTR/ERVL	782	+	198	123522210	84872
chr7	102325596	102525596	harbor1	chr7	102344059	102344281	LTR/ERVL	657	+	111	102344170	18574
chr7	141411856	141611856	harbor1	chr7	141501471	141501844	LTR/ERVL	2252	+	186	141501657	89801
chr7	26995642	27195642	harbor1	chr7	26996592	26997073	LTR/ERVL	3040	+	240	26996832	1190
chr7	26995642	27195642	harbor1	chr7	26997074	26998333	LTR/ERVL	21201	+	630	26997704	2062
chr7	26995642	27195642	harbor1	chr7	26998385	27000000	LTR/ERVL	21201	+	808	26999193	3551
chr7	26995642	27195642	harbor1	chr7	27008607	27008873	LTR/ERVL	2077	+	133	27008740	13098
chr7	26995642	27195642	harbor1	chr7	27008874	27009322	LTR/ERVL	3575	+	224	27009098	13456
chr7	26995642	27195642	harbor1	chr7	27067665	27068180	LTR/ERVL	1108	+	258	27067923	72281
chr7	26995642	27195642	harbor1	chr7	27000001	27002445	LTR/ERVL	19624	+	1222	27001223	5581
chr7	66456842	66656842	harbor1	chr7	66463289	66463362	LTR/ERVL	1081	+	36	66463325	6483
chr7	66456842	66656842	harbor1	chr7	66463658	66463833	LTR/ERVL	1081	+	88	66463746	6904
chr7	66456842	66656842	harbor1	chr7	66463841	66464364	LTR/ERVL	2739	+	262	66464103	7261
chr7	66456842	66656842	harbor1	chr7	66465305	66465576	LTR/ERVL	1228	+	136	66465441	8599
chr7	66456842	66656842	harbor1	chr7	66465970	66466277	LTR/ERVL	1228	+	154	66466124	9282
chr7	25270046	25470046	harbor1	chr7	25279018	25279650	LTR/ERVL	3887	+	316	25279334	9288
chr7	25270046	25470046	harbor1	chr7	25365362	25365630	LTR/ERVL	693	+	134	25365496	95450
chr7	25270046	25470046	harbor1	chr7	25365645	25365843	LTR/ERVL	643	+	99	25365744	95698
chr7	24657406	24857406	harbor1	chr7	24748621	24749018	LTR/ERVL	1607	+	198	24748819	91413
chr7	47227890	47427890	harbor1	chr7	47255484	47256356	LTR/ERVL	4698	+	436	47255920	28030
chr7	16531	216531	harbor1	chr7	69965	70400	LTR/ERVL	1791	+	218	70183	53652
chr7	108470160	108670160	harbor1	chr7	108538301	108538639	LTR/ERVL	2218	+	169	108538470	68310
chr7	108470160	108670160	harbor1	chr7	108538651	108538918	LTR/ERVL	8584	+	134	108538785	68625
chr7	108470160	108670160	harbor1	chr7	108538962	108539880	LTR/ERVL	8584	+	459	108539421	69261
chr7	108470160	108670160	harbor1	chr7	108539883	108540233	LTR/ERVL	2630	+	175	108540058	69898
chr7	108470160	108670160	harbor1	chr7	108540274	108540367	LTR/ERVL	2630	+	46	108540320	70160
chr7	47228426	47428426	harbor1	chr7	47255484	47256356	LTR/ERVL	4698	+	436	47255920	27494
chr7	123649335	123849335	harbor1	chr7	123697669	123698225	LTR/ERVL	2687	+	278	123697947	48612
chr7	123649230	123849230	harbor1	chr7	123697669	123698225	LTR/ERVL	2687	+	278	123697947	48717
chr7	73478344	73678344	harbor1	chr7	73503714	73504211	LTR/ERVL	1256	+	248	73503962	25618
chr7	73478344	73678344	harbor1	chr7	73562678	73563067	LTR/ERVL	3128	+	194	73562872	84528
chr7	73478344	73678344	harbor1	chr7	73563106	73563145	LTR/ERVL	3128	+	20	73563126	84782
chr7	47568386	47768386	harbor1	chr7	47585495	47585898	LTR/ERVL	2387	+	202	47585697	17311
chr7	47568386	47768386	harbor1	chr7	47586199	47586279	LTR/ERVL	2387	+	40	47586239	17853
chr7	47227923	47427923	harbor1	chr7	47255484	47256356	LTR/ERVL	4698	+	436	47255920	27997
chr7	1795705	1995705	harbor1	chr7	1795986	1796390	LTR/ERVL	1333	+	202	1796188	483
chr7	123481083	123681083	harbor1	chr7	123522012	123522409	LTR/ERVL	782	+	198	123522210	41127
chr7	155196997	155396997	harbor1	chr7	155201760	155202181	LTR/ERVL	1158	+	210	155201970	4973
chr7	155196997	155396997	harbor1	chr7	155226956	155227111	LTR/ERVL	471	+	78	155227034	30037
chr7	155196997	155396997	harbor1	chr7	155266577	155267033	LTR/ERVL	853	+	228	155266805	69808
chr7	155196997	155396997	harbor1	chr7	155286322	155286768	LTR/ERVL	3554	+	223	155286545	89548
chr7	32628791	32828791	harbor1	chr7	32669163	32669692	LTR/ERVL	1738	+	264	32669427	40636
chr7	32628791	32828791	harbor1	chr7	32677452	32677853	LTR/ERVL	1131	+	200	32677652	48861
chr7	141411783	141611783	harbor1	chr7	141501471	141501844	LTR/ERVL	2252	+	186	141501657	89874
chr7	30975839	31175839	harbor1	chr7	30984811	30985212	LTR/ERVL	1679	+	200	30985011	9172
chr7	30975839	31175839	harbor1	chr7	30985255	30985309	LTR/ERVL	1679	+	27	30985282	9443
chr7	30975839	31175839	harbor1	chr7	31003656	31004115	LTR/ERVL	1676	+	230	31003886	28047
chr7	127133798	127333798	harbor1	chr7	127163221	127163576	LTR/ERVL	1010	+	178	127163399	29601
chr7	127133798	127333798	harbor1	chr7	127221328	127221707	LTR/ERVL	501	+	190	127221518	87720
chr7	43919232	44119232	harbor1	chr7	43941918	43942099	LTR/ERVL	827	+	90	43942008	22776
chr7	43919232	44119232	harbor1	chr7	43942333	43942757	LTR/ERVL	1256	+	212	43942545	23313
chr7	43919232	44119232	harbor1	chr7	43981594	43981749	LTR/ERVL	515	+	78	43981672	62440
chr7	43919232	44119232	harbor1	chr7	43981766	43982023	LTR/ERVL	441	+	128	43981894	62662
chr7	122786849	122986849	harbor1	chr7	122806903	122807379	LTR/ERVL	1244	+	238	122807141	20292
chr7	122786849	122986849	harbor1	chr7	122807373	122807565	LTR/ERVL	882	+	96	122807469	20620
chr7	122786849	122986849	harbor1	chr7	122853099	122853386	LTR/ERVL	534	+	144	122853243	66394
chr7	122786849	122986849	harbor1	chr7	122853370	122853640	LTR/ERVL	798	+	135	122853505	66656
chr7	122786849	122986849	harbor1	chr7	122862246	122862645	LTR/ERVL	506	+	200	122862446	75597
chr7	90112306	90312306	harbor1	chr7	90130790	90130966	LTR/ERVL	583	+	88	90130878	18572
chr7	123648388	123848388	harbor1	chr7	123697669	123698225	LTR/ERVL	2687	+	278	123697947	49559
chr7	123649270	123849270	harbor1	chr7	123697669	123698225	LTR/ERVL	2687	+	278	123697947	48677
chr7	47228349	47428349	harbor1	chr7	47255484	47256356	LTR/ERVL	4698	+	436	47255920	27571
chr7	123457458	123657458	harbor1	chr7	123459250	123459711	LTR/ERVL	1456	+	230	123459480	2022
chr7	123457458	123657458	harbor1	chr7	123467270	123467413	LTR/ERVL	477	+	72	123467342	9884
chr7	123457458	123657458	harbor1	chr7	123467563	123467763	LTR/ERVL	873	+	100	123467663	10205
chr7	123457458	123657458	harbor1	chr7	123467793	123468270	LTR/ERVL	806	+	238	123468031	10573
chr7	123457458	123657458	harbor1	chr7	123468418	123468769	LTR/ERVL	1118	+	176	123468594	11136
chr7	123457458	123657458	harbor1	chr7	123480265	123480698	LTR/ERVL	941	+	216	123480481	23023
chr7	123457458	123657458	harbor1	chr7	123522012	123522409	LTR/ERVL	782	+	198	123522210	64752
chr7	2610078	2810078	harbor1	chr7	2694045	2694461	LTR/ERVL	1096	+	208	2694253	84175
chr7	123649311	123849311	harbor1	chr7	123697669	123698225	LTR/ERVL	2687	+	278	123697947	48636
chr8	142524965	142724965	harbor1	chr8	142554851	142555631	LTR/ERVL	3303	+	390	142555241	30276
chr8	142524965	142724965	harbor1	chr8	142564749	142565392	LTR/ERVL	619	+	322	142565071	40106
chr8	23428482	23628482	harbor1	chr8	23476479	23477036	LTR/ERVL	1571	+	278	23476757	48275
chr8	23381169	23581169	harbor1	chr8	23476479	23477036	LTR/ERVL	1571	+	278	23476757	95588
chr8	23381133	23581133	harbor1	chr8	23476479	23477036	LTR/ERVL	1571	+	278	23476757	95624
chr8	23379942	23579942	harbor1	chr8	23476479	23477036	LTR/ERVL	1571	+	278	23476757	96815
chr8	23382754	23582754	harbor1	chr8	23476479	23477036	LTR/ERVL	1571	+	278	23476757	94003
chr8	1646122	1846122	harbor1	chr8	1646015	1646396	LTR/ERVL	1198	+	190	1646205	83
chr8	23428976	23628976	harbor1	chr8	23476479	23477036	LTR/ERVL	1571	+	278	23476757	47781
chr8	85145898	85345898	harbor1	chr8	85204277	85204370	LTR/ERVL	1147	+	46	85204323	58425
chr8	85145898	85345898	harbor1	chr8	85204703	85204903	LTR/ERVL	1147	+	100	85204803	58905
chr8	85145898	85345898	harbor1	chr8	85205201	85205240	LTR/ERVL	1147	+	20	85205221	59323
chr8	85145898	85345898	harbor1	chr8	85205583	85205761	LTR/ERVL	1147	+	89	85205672	59774
chr8	85145898	85345898	harbor1	chr8	85215277	85216062	LTR/ERVL	3668	+	392	85215669	69771
chr8	85145898	85345898	harbor1	chr8	85234886	85235378	LTR/ERVL	2214	+	246	85235132	89234
chr8	23428919	23628919	harbor1	chr8	23476479	23477036	LTR/ERVL	1571	+	278	23476757	47838
chr8	23428922	23628922	harbor1	chr8	23476479	23477036	LTR/ERVL	1571	+	278	23476757	47835
chr8	23379952	23579952	harbor1	chr8	23476479	23477036	LTR/ERVL	1571	+	278	23476757	96805
chr8	90545266	90745266	harbor1	chr8	90557220	90557690	LTR/ERVL	776	+	235	90557455	12189
chr8	23428500	23628500	harbor1	chr8	23476479	23477036	LTR/ERVL	1571	+	278	23476757	48257
chr8	23409692	23609692	harbor1	chr8	23476479	23477036	LTR/ERVL	1571	+	278	23476757	67065
chr8	23428873	23628873	harbor1	chr8	23476479	23477036	LTR/ERVL	1571	+	278	23476757	47884
chr8	23407606	23607606	harbor1	chr8	23476479	23477036	LTR/ERVL	1571	+	278	23476757	69151
chr8	23428431	23628431	harbor1	chr8	23476479	23477036	LTR/ERVL	1571	+	278	23476757	48326
chr8	129907115	130107115	harbor1	chr8	129932201	129932716	LTR/ERVL	2007	+	258	129932459	25344
chr8	129907115	130107115	harbor1	chr8	129933021	129933594	LTR/ERVL	1521	+	286	129933307	26192
chr8	129907115	130107115	harbor1	chr8	129933923	129934018	LTR/ERVL	1521	+	48	129933971	26856
chr8	129907115	130107115	harbor1	chr8	129934018	129934402	LTR/ERVL	1246	+	192	129934210	27095
chr8	23398445	23598445	harbor1	chr8	23476479	23477036	LTR/ERVL	1571	+	278	23476757	78312
chr8	23428857	23628857	harbor1	chr8	23476479	23477036	LTR/ERVL	1571	+	278	23476757	47900
chr8	8665132	8865132	harbor1	chr8	8743540	8743817	LTR/ERVL	936	+	138	8743678	78546
chr8	23412840	23612840	harbor1	chr8	23476479	23477036	LTR/ERVL	1571	+	278	23476757	63917
chr8	23428958	23628958	harbor1	chr8	23476479	23477036	LTR/ERVL	1571	+	278	23476757	47799
chr8	23409094	23609094	harbor1	chr8	23476479	23477036	LTR/ERVL	1571	+	278	23476757	67663
chr8	23380409	23580409	harbor1	chr8	23476479	23477036	LTR/ERVL	1571	+	278	23476757	96348
chr8	23428835	23628835	harbor1	chr8	23476479	23477036	LTR/ERVL	1571	+	278	23476757	47922
chr8	142524970	142724970	harbor1	chr8	142554851	142555631	LTR/ERVL	3303	+	390	142555241	30271
chr8	142524970	142724970	harbor1	chr8	142564749	142565392	LTR/ERVL	619	+	322	142565071	40101
chr8	23428925	23628925	harbor1	chr8	23476479	23477036	LTR/ERVL	1571	+	278	23476757	47832
chr8	23428499	23628499	harbor1	chr8	23476479	23477036	LTR/ERVL	1571	+	278	23476757	48258
chr8	23428888	23628888	harbor1	chr8	23476479	23477036	LTR/ERVL	1571	+	278	23476757	47869
chr8	22757824	22957824	harbor1	chr8	22798174	22798677	LTR/ERVL	2233	+	252	22798426	40602
chr8	22757824	22957824	harbor1	chr8	22832738	22833247	LTR/ERVL	1841	+	254	22832992	75168
chr8	23380336	23580336	harbor1	chr8	23476479	23477036	LTR/ERVL	1571	+	278	23476757	96421
chr8	40746828	40946828	harbor1	chr8	40757718	40758227	LTR/ERVL	2312	+	254	40757972	11144
chr8	40746828	40946828	harbor1	chr8	40840080	40840511	LTR/ERVL	892	+	216	40840296	93468
chr8	40746828	40946828	harbor1	chr8	40844183	40844657	LTR/ERVL	1853	+	237	40844420	97592
chr8	40746828	40946828	harbor1	chr8	40844699	40844729	LTR/ERVL	523	+	15	40844714	97886
chr8	66077981	66277981	harbor1	chr8	66109128	66109383	LTR/ERVL	1033	+	128	66109256	31275
chr8	66077981	66277981	harbor1	chr8	66120288	66121010	LTR/ERVL	1774	+	361	66120649	42668
chr8	23423555	23623555	harbor1	chr8	23476479	23477036	LTR/ERVL	1571	+	278	23476757	53202
chr8	23428893	23628893	harbor1	chr8	23476479	23477036	LTR/ERVL	1571	+	278	23476757	47864
chr8	23419596	23619596	harbor1	chr8	23476479	23477036	LTR/ERVL	1571	+	278	23476757	57161
chr8	60552749	60752749	harbor1	chr8	60560933	60561296	LTR/ERVL	923	+	182	60561115	8366
chr8	38019471	38219471	harbor1	chr8	38025330	38025414	LTR/ERVL	461	+	42	38025372	5901
chr8	38019471	38219471	harbor1	chr8	38025667	38026042	LTR/ERVL	1524	+	188	38025855	6384
chr8	142524135	142724135	harbor1	chr8	142554851	142555631	LTR/ERVL	3303	+	390	142555241	31106
chr8	142524135	142724135	harbor1	chr8	142564749	142565392	LTR/ERVL	619	+	322	142565071	40936
chr8	23392919	23592919	harbor1	chr8	23476479	23477036	LTR/ERVL	1571	+	278	23476757	83838
chr8	23398382	23598382	harbor1	chr8	23476479	23477036	LTR/ERVL	1571	+	278	23476757	78375
chr8	10625860	10825860	harbor1	chr8	10638755	10638862	LTR/ERVL	1230	+	54	10638809	12949
chr8	10625860	10825860	harbor1	chr8	10639172	10639382	LTR/ERVL	1230	+	105	10639277	13417
chr8	10625860	10825860	harbor1	chr8	10639674	10639803	LTR/ERVL	1230	+	64	10639738	13878
chr8	10625860	10825860	harbor1	chr8	10646932	10647280	LTR/ERVL	516	+	174	10647106	21246
chr8	10625860	10825860	harbor1	chr8	10706765	10707077	LTR/ERVL	753	+	156	10706921	81061
chr8	10625860	10825860	harbor1	chr8	10707529	10707769	LTR/ERVL	711	+	120	10707649	81789
chr8	23428533	23628533	harbor1	chr8	23476479	23477036	LTR/ERVL	1571	+	278	23476757	48224
chr8	23393307	23593307	harbor1	chr8	23476479	23477036	LTR/ERVL	1571	+	278	23476757	83450
chr8	29995437	30195437	harbor1	chr8	30005503	30006054	LTR/ERVL	1207	+	276	30005779	10342
chr8	29995437	30195437	harbor1	chr8	30007218	30007318	LTR/ERVL	1207	+	50	30007268	11831
chr8	29995437	30195437	harbor1	chr8	30048922	30048990	LTR/ERVL	430	+	34	30048956	53519
chr8	29995437	30195437	harbor1	chr8	30056873	30057055	LTR/ERVL	779	+	91	30056964	61527
chr8	29995437	30195437	harbor1	chr8	30075384	30075655	LTR/ERVL	440	+	136	30075520	80083
chr8	66405191	66605191	harbor1	chr8	66482976	66483405	LTR/ERVL	949	+	214	66483190	77999
chr8	23428940	23628940	harbor1	chr8	23476479	23477036	LTR/ERVL	1571	+	278	23476757	47817
chr8	124796482	124996482	harbor1	chr8	124801575	124801682	LTR/ERVL	468	+	54	124801629	5147
chr8	124796482	124996482	harbor1	chr8	124808043	124808301	LTR/ERVL	705	+	129	124808172	11690
chr8	124796482	124996482	harbor1	chr8	124841658	124842052	LTR/ERVL	996	+	197	124841855	45373
chr8	23428850	23628850	harbor1	chr8	23476479	23477036	LTR/ERVL	1571	+	278	23476757	47907
chr8	23428530	23628530	harbor1	chr8	23476479	23477036	LTR/ERVL	1571	+	278	23476757	48227
chr8	23429026	23629026	harbor1	chr8	23476479	23477036	LTR/ERVL	1571	+	278	23476757	47731
chr8	98847692	99047692	harbor1	chr8	98915064	98915432	LTR/ERVL	3034	+	184	98915248	67556
chr8	98847692	99047692	harbor1	chr8	98915471	98915498	LTR/ERVL	3034	+	14	98915485	67793
chr8	23428510	23628510	harbor1	chr8	23476479	23477036	LTR/ERVL	1571	+	278	23476757	48247
chr8	129839917	130039917	harbor1	chr8	129891084	129891353	LTR/ERVL	488	+	134	129891218	51301
chr8	129839917	130039917	harbor1	chr8	129904250	129904641	LTR/ERVL	842	+	196	129904446	64529
chr8	129839917	130039917	harbor1	chr8	129932201	129932716	LTR/ERVL	2007	+	258	129932459	92542
chr8	129839917	130039917	harbor1	chr8	129933021	129933594	LTR/ERVL	1521	+	286	129933307	93390
chr8	129839917	130039917	harbor1	chr8	129933923	129934018	LTR/ERVL	1521	+	48	129933971	94054
chr8	129839917	130039917	harbor1	chr8	129934018	129934402	LTR/ERVL	1246	+	192	129934210	94293
chr8	142524987	142724987	harbor1	chr8	142554851	142555631	LTR/ERVL	3303	+	390	142555241	30254
chr8	142524987	142724987	harbor1	chr8	142564749	142565392	LTR/ERVL	619	+	322	142565071	40084
chr8	142674146	142874146	harbor1	chr8	142761500	142762292	LTR/ERVL	3591	+	396	142761896	87750
chr8	142524957	142724957	harbor1	chr8	142554851	142555631	LTR/ERVL	3303	+	390	142555241	30284
chr8	142524957	142724957	harbor1	chr8	142564749	142565392	LTR/ERVL	619	+	322	142565071	40114
chr8	142482825	142682825	harbor1	chr8	142554851	142555631	LTR/ERVL	3303	+	390	142555241	72416
chr8	142482825	142682825	harbor1	chr8	142564749	142565392	LTR/ERVL	619	+	322	142565071	82246
chr8	23380964	23580964	harbor1	chr8	23476479	23477036	LTR/ERVL	1571	+	278	23476757	95793
chr8	53743525	53943525	harbor1	chr8	53797133	53797698	LTR/ERVL	1669	+	282	53797415	53890
chr8	53743525	53943525	harbor1	chr8	53799471	53799635	LTR/ERVL	2448	+	82	53799553	56028
chr8	53743525	53943525	harbor1	chr8	53799995	53800334	LTR/ERVL	2448	+	170	53800165	56640
chr8	53743525	53943525	harbor1	chr8	53813943	53814386	LTR/ERVL	1746	+	222	53814165	70640
chr8	27322694	27522694	harbor1	chr8	27394137	27394286	LTR/ERVL	513	+	74	27394211	71517
chr8	27322694	27522694	harbor1	chr8	27395645	27395871	LTR/ERVL	669	+	113	27395758	73064
chr8	90970523	91170523	harbor1	chr8	91007641	91008180	LTR/ERVL	2810	+	270	91007911	37388
chr8	90970523	91170523	harbor1	chr8	91026021	91026701	LTR/ERVL	2046	+	340	91026361	55838
chr8	90970523	91170523	harbor1	chr8	91026905	91028303	LTR/ERVL	2931	+	699	91027604	57081
chr8	90970523	91170523	harbor1	chr8	91028324	91028799	LTR/ERVL	963	+	238	91028562	58039
chr8	90970523	91170523	harbor1	chr8	91034388	91034825	LTR/ERVL	669	+	218	91034606	64083
chr8	90970523	91170523	harbor1	chr8	91065575	91065663	LTR/ERVL	455	+	44	91065619	95096
chr8	85145876	85345876	harbor1	chr8	85204277	85204370	LTR/ERVL	1147	+	46	85204323	58447
chr8	85145876	85345876	harbor1	chr8	85204703	85204903	LTR/ERVL	1147	+	100	85204803	58927
chr8	85145876	85345876	harbor1	chr8	85205201	85205240	LTR/ERVL	1147	+	20	85205221	59345
chr8	85145876	85345876	harbor1	chr8	85205583	85205761	LTR/ERVL	1147	+	89	85205672	59796
chr8	85145876	85345876	harbor1	chr8	85215277	85216062	LTR/ERVL	3668	+	392	85215669	69793
chr8	85145876	85345876	harbor1	chr8	85234886	85235378	LTR/ERVL	2214	+	246	85235132	89256
chr8	85144970	85344970	harbor1	chr8	85204277	85204370	LTR/ERVL	1147	+	46	85204323	59353
chr8	85144970	85344970	harbor1	chr8	85204703	85204903	LTR/ERVL	1147	+	100	85204803	59833
chr8	85144970	85344970	harbor1	chr8	85205201	85205240	LTR/ERVL	1147	+	20	85205221	60251
chr8	85144970	85344970	harbor1	chr8	85205583	85205761	LTR/ERVL	1147	+	89	85205672	60702
chr8	85144970	85344970	harbor1	chr8	85215277	85216062	LTR/ERVL	3668	+	392	85215669	70699
chr8	85144970	85344970	harbor1	chr8	85234886	85235378	LTR/ERVL	2214	+	246	85235132	90162
chr8	142523652	142723652	harbor1	chr8	142554851	142555631	LTR/ERVL	3303	+	390	142555241	31589
chr8	142523652	142723652	harbor1	chr8	142564749	142565392	LTR/ERVL	619	+	322	142565071	41419
chr8	23428435	23628435	harbor1	chr8	23476479	23477036	LTR/ERVL	1571	+	278	23476757	48322
chr8	23429035	23629035	harbor1	chr8	23476479	23477036	LTR/ERVL	1571	+	278	23476757	47722
chr8	23388472	23588472	harbor1	chr8	23476479	23477036	LTR/ERVL	1571	+	278	23476757	88285
chr8	129839623	130039623	harbor1	chr8	129891084	129891353	LTR/ERVL	488	+	134	129891218	51595
chr8	129839623	130039623	harbor1	chr8	129904250	129904641	LTR/ERVL	842	+	196	129904446	64823
chr8	129839623	130039623	harbor1	chr8	129932201	129932716	LTR/ERVL	2007	+	258	129932459	92836
chr8	129839623	130039623	harbor1	chr8	129933021	129933594	LTR/ERVL	1521	+	286	129933307	93684
chr8	129839623	130039623	harbor1	chr8	129933923	129934018	LTR/ERVL	1521	+	48	129933971	94348
chr8	129839623	130039623	harbor1	chr8	129934018	129934402	LTR/ERVL	1246	+	192	129934210	94587
chr8	29891739	30091739	harbor1	chr8	29927017	29927228	LTR/ERVL	669	+	106	29927123	35384
chr8	29891739	30091739	harbor1	chr8	29983604	29984157	LTR/ERVL	1965	+	276	29983880	92141
chr8	29983337	30183337	harbor1	chr8	29983604	29984157	LTR/ERVL	1965	+	276	29983880	543
chr8	29983337	30183337	harbor1	chr8	30005503	30006054	LTR/ERVL	1207	+	276	30005779	22442
chr8	29983337	30183337	harbor1	chr8	30007218	30007318	LTR/ERVL	1207	+	50	30007268	23931
chr8	29983337	30183337	harbor1	chr8	30048922	30048990	LTR/ERVL	430	+	34	30048956	65619
chr8	29983337	30183337	harbor1	chr8	30056873	30057055	LTR/ERVL	779	+	91	30056964	73627
chr8	29983337	30183337	harbor1	chr8	30075384	30075655	LTR/ERVL	440	+	136	30075520	92183
chr8	23393297	23593297	harbor1	chr8	23476479	23477036	LTR/ERVL	1571	+	278	23476757	83460
chr8	65059279	65259279	harbor1	chr8	65106247	65107211	LTR/ERVL	4152	+	482	65106729	47450
chr8	65059279	65259279	harbor1	chr8	65107219	65107598	LTR/ERVL	1469	+	190	65107409	48130
chr8	142524862	142724862	harbor1	chr8	142554851	142555631	LTR/ERVL	3303	+	390	142555241	30379
chr8	142524862	142724862	harbor1	chr8	142564749	142565392	LTR/ERVL	619	+	322	142565071	40209
chr8	17057584	17257584	harbor1	chr8	17147325	17147548	LTR/ERVL	544	+	112	17147437	89853
chr8	23382752	23582752	harbor1	chr8	23476479	23477036	LTR/ERVL	1571	+	278	23476757	94005
chr8	23398575	23598575	harbor1	chr8	23476479	23477036	LTR/ERVL	1571	+	278	23476757	78182
chr8	23382836	23582836	harbor1	chr8	23476479	23477036	LTR/ERVL	1571	+	278	23476757	93921
chr8	142524984	142724984	harbor1	chr8	142554851	142555631	LTR/ERVL	3303	+	390	142555241	30257
chr8	142524984	142724984	harbor1	chr8	142564749	142565392	LTR/ERVL	619	+	322	142565071	40087
chr8	29983014	30183014	harbor1	chr8	29983604	29984157	LTR/ERVL	1965	+	276	29983880	866
chr8	29983014	30183014	harbor1	chr8	30005503	30006054	LTR/ERVL	1207	+	276	30005779	22765
chr8	29983014	30183014	harbor1	chr8	30007218	30007318	LTR/ERVL	1207	+	50	30007268	24254
chr8	29983014	30183014	harbor1	chr8	30048922	30048990	LTR/ERVL	430	+	34	30048956	65942
chr8	29983014	30183014	harbor1	chr8	30056873	30057055	LTR/ERVL	779	+	91	30056964	73950
chr8	29983014	30183014	harbor1	chr8	30075384	30075655	LTR/ERVL	440	+	136	30075520	92506
chr8	23146666	23346666	harbor1	chr8	23165997	23166297	LTR/ERVL	2768	+	150	23166147	19481
chr8	23146666	23346666	harbor1	chr8	23167737	23168604	LTR/ERVL	6621	+	434	23168171	21505
chr8	23146666	23346666	harbor1	chr8	23168883	23169135	LTR/ERVL	6621	+	126	23169009	22343
chr8	23146666	23346666	harbor1	chr8	23169551	23169953	LTR/ERVL	6621	+	201	23169752	23086
chr8	23146666	23346666	harbor1	chr8	23170256	23170311	LTR/ERVL	6621	+	28	23170284	23618
chr8	23146666	23346666	harbor1	chr8	23170501	23170843	LTR/ERVL	1497	+	171	23170672	24006
chr8	23146666	23346666	harbor1	chr8	23171154	23171416	LTR/ERVL	1497	+	131	23171285	24619
chr8	23146666	23346666	harbor1	chr8	23172417	23172523	LTR/ERVL	569	+	53	23172470	25804
chr8	23146666	23346666	harbor1	chr8	23172817	23172899	LTR/ERVL	569	+	41	23172858	26192
chr8	23146666	23346666	harbor1	chr8	23239044	23239481	LTR/ERVL	2857	+	218	23239262	92596
chr8	23146666	23346666	harbor1	chr8	23166586	23166990	LTR/ERVL	2768	+	202	23166788	20122
chr8	8665131	8865131	harbor1	chr8	8743540	8743817	LTR/ERVL	936	+	138	8743678	78547
chr8	102556522	102756522	harbor1	chr8	102644172	102644667	LTR/ERVL	2016	+	248	102644420	87898
chr8	142524964	142724964	harbor1	chr8	142554851	142555631	LTR/ERVL	3303	+	390	142555241	30277
chr8	142524964	142724964	harbor1	chr8	142564749	142565392	LTR/ERVL	619	+	322	142565071	40107
chr8	142524925	142724925	harbor1	chr8	142554851	142555631	LTR/ERVL	3303	+	390	142555241	30316
chr8	142524925	142724925	harbor1	chr8	142564749	142565392	LTR/ERVL	619	+	322	142565071	40146
chr8	144006082	144206082	harbor1	chr8	144075920	144076411	LTR/ERVL	1706	+	246	144076166	70084
chr8	23428962	23628962	harbor1	chr8	23476479	23477036	LTR/ERVL	1571	+	278	23476757	47795
chr8	41443390	41643390	harbor1	chr8	41471190	41471556	LTR/ERVL	2571	+	183	41471373	27983
chr8	41443390	41643390	harbor1	chr8	41471862	41471953	LTR/ERVL	2571	+	46	41471908	28518
chr8	41443390	41643390	harbor1	chr8	41517524	41517945	LTR/ERVL	1022	+	210	41517734	74344
chr8	29983347	30183347	harbor1	chr8	29983604	29984157	LTR/ERVL	1965	+	276	29983880	533
chr8	29983347	30183347	harbor1	chr8	30005503	30006054	LTR/ERVL	1207	+	276	30005779	22432
chr8	29983347	30183347	harbor1	chr8	30007218	30007318	LTR/ERVL	1207	+	50	30007268	23921
chr8	29983347	30183347	harbor1	chr8	30048922	30048990	LTR/ERVL	430	+	34	30048956	65609
chr8	29983347	30183347	harbor1	chr8	30056873	30057055	LTR/ERVL	779	+	91	30056964	73617
chr8	29983347	30183347	harbor1	chr8	30075384	30075655	LTR/ERVL	440	+	136	30075520	92173
chr8	72661683	72861683	harbor1	chr8	72752267	72752776	LTR/ERVL	1801	+	254	72752521	90838
chr8	23428892	23628892	harbor1	chr8	23476479	23477036	LTR/ERVL	1571	+	278	23476757	47865
chr8	66405141	66605141	harbor1	chr8	66482976	66483405	LTR/ERVL	949	+	214	66483190	78049
chr8	23384163	23584163	harbor1	chr8	23476479	23477036	LTR/ERVL	1571	+	278	23476757	92594
chr8	58719745	58919745	harbor1	chr8	58746813	58747298	LTR/ERVL	1319	+	242	58747055	27310
chr8	58719745	58919745	harbor1	chr8	58757593	58757995	LTR/ERVL	477	+	201	58757794	38049
chr9	4663254	4863254	harbor1	chr9	4719472	4719754	LTR/ERVL	1402	+	141	4719613	56359
chr9	136629220	136829220	harbor1	chr9	136705861	136706339	LTR/ERVL	3741	+	239	136706100	76880
chr9	136629220	136829220	harbor1	chr9	136706959	136707635	LTR/ERVL	3741	+	338	136707297	78077
chr9	136629220	136829220	harbor1	chr9	136707946	136708531	LTR/ERVL	3741	+	292	136708238	79018
chr9	4692931	4892931	harbor1	chr9	4719472	4719754	LTR/ERVL	1402	+	141	4719613	26682
chr9	4692931	4892931	harbor1	chr9	4767974	4768533	LTR/ERVL	2710	+	280	4768254	75323
chr9	4692931	4892931	harbor1	chr9	4768560	4768598	LTR/ERVL	623	+	19	4768579	75648
chr9	4692931	4892931	harbor1	chr9	4776096	4776156	LTR/ERVL	1756	+	30	4776126	83195
chr9	4692931	4892931	harbor1	chr9	4776449	4776750	LTR/ERVL	1756	+	150	4776599	83668
chr9	4692160	4892160	harbor1	chr9	4719472	4719754	LTR/ERVL	1402	+	141	4719613	27453
chr9	4692160	4892160	harbor1	chr9	4767974	4768533	LTR/ERVL	2710	+	280	4768254	76094
chr9	4692160	4892160	harbor1	chr9	4768560	4768598	LTR/ERVL	623	+	19	4768579	76419
chr9	4692160	4892160	harbor1	chr9	4776096	4776156	LTR/ERVL	1756	+	30	4776126	83966
chr9	4692160	4892160	harbor1	chr9	4776449	4776750	LTR/ERVL	1756	+	150	4776599	84439
chr9	4692665	4892665	harbor1	chr9	4719472	4719754	LTR/ERVL	1402	+	141	4719613	26948
chr9	4692665	4892665	harbor1	chr9	4767974	4768533	LTR/ERVL	2710	+	280	4768254	75589
chr9	4692665	4892665	harbor1	chr9	4768560	4768598	LTR/ERVL	623	+	19	4768579	75914
chr9	4692665	4892665	harbor1	chr9	4776096	4776156	LTR/ERVL	1756	+	30	4776126	83461
chr9	4692665	4892665	harbor1	chr9	4776449	4776750	LTR/ERVL	1756	+	150	4776599	83934
chr9	4883814	5083814	harbor1	chr9	4971442	4971760	LTR/ERVL	1353	+	159	4971601	87787
chr9	4883814	5083814	harbor1	chr9	4972365	4972544	LTR/ERVL	1353	+	90	4972455	88641
chr9	4692207	4892207	harbor1	chr9	4719472	4719754	LTR/ERVL	1402	+	141	4719613	27406
chr9	4692207	4892207	harbor1	chr9	4767974	4768533	LTR/ERVL	2710	+	280	4768254	76047
chr9	4692207	4892207	harbor1	chr9	4768560	4768598	LTR/ERVL	623	+	19	4768579	76372
chr9	4692207	4892207	harbor1	chr9	4776096	4776156	LTR/ERVL	1756	+	30	4776126	83919
chr9	4692207	4892207	harbor1	chr9	4776449	4776750	LTR/ERVL	1756	+	150	4776599	84392
chr9	4692981	4892981	harbor1	chr9	4719472	4719754	LTR/ERVL	1402	+	141	4719613	26632
chr9	4692981	4892981	harbor1	chr9	4767974	4768533	LTR/ERVL	2710	+	280	4768254	75273
chr9	4692981	4892981	harbor1	chr9	4768560	4768598	LTR/ERVL	623	+	19	4768579	75598
chr9	4692981	4892981	harbor1	chr9	4776096	4776156	LTR/ERVL	1756	+	30	4776126	83145
chr9	4692981	4892981	harbor1	chr9	4776449	4776750	LTR/ERVL	1756	+	150	4776599	83618
chr9	4692827	4892827	harbor1	chr9	4719472	4719754	LTR/ERVL	1402	+	141	4719613	26786
chr9	4692827	4892827	harbor1	chr9	4767974	4768533	LTR/ERVL	2710	+	280	4768254	75427
chr9	4692827	4892827	harbor1	chr9	4768560	4768598	LTR/ERVL	623	+	19	4768579	75752
chr9	4692827	4892827	harbor1	chr9	4776096	4776156	LTR/ERVL	1756	+	30	4776126	83299
chr9	4692827	4892827	harbor1	chr9	4776449	4776750	LTR/ERVL	1756	+	150	4776599	83772
chr9	4693009	4893009	harbor1	chr9	4719472	4719754	LTR/ERVL	1402	+	141	4719613	26604
chr9	4693009	4893009	harbor1	chr9	4767974	4768533	LTR/ERVL	2710	+	280	4768254	75245
chr9	4693009	4893009	harbor1	chr9	4768560	4768598	LTR/ERVL	623	+	19	4768579	75570
chr9	4693009	4893009	harbor1	chr9	4776096	4776156	LTR/ERVL	1756	+	30	4776126	83117
chr9	4693009	4893009	harbor1	chr9	4776449	4776750	LTR/ERVL	1756	+	150	4776599	83590
chr9	4663492	4863492	harbor1	chr9	4719472	4719754	LTR/ERVL	1402	+	141	4719613	56121
chr9	4692473	4892473	harbor1	chr9	4719472	4719754	LTR/ERVL	1402	+	141	4719613	27140
chr9	4692473	4892473	harbor1	chr9	4767974	4768533	LTR/ERVL	2710	+	280	4768254	75781
chr9	4692473	4892473	harbor1	chr9	4768560	4768598	LTR/ERVL	623	+	19	4768579	76106
chr9	4692473	4892473	harbor1	chr9	4776096	4776156	LTR/ERVL	1756	+	30	4776126	83653
chr9	4692473	4892473	harbor1	chr9	4776449	4776750	LTR/ERVL	1756	+	150	4776599	84126
chr9	1955525	2155525	harbor1	chr9	2006455	2006732	LTR/ERVL	742	+	138	2006593	51068
chr9	1955525	2155525	harbor1	chr9	2038334	2038802	LTR/ERVL	849	+	234	2038568	83043
chr9	4766620	4966620	harbor1	chr9	4767974	4768533	LTR/ERVL	2710	+	280	4768254	1634
chr9	4766620	4966620	harbor1	chr9	4768560	4768598	LTR/ERVL	623	+	19	4768579	1959
chr9	4766620	4966620	harbor1	chr9	4776096	4776156	LTR/ERVL	1756	+	30	4776126	9506
chr9	4766620	4966620	harbor1	chr9	4776449	4776750	LTR/ERVL	1756	+	150	4776599	9979
chr9	4663979	4863979	harbor1	chr9	4719472	4719754	LTR/ERVL	1402	+	141	4719613	55634
chr9	100252658	100452658	harbor1	chr9	100337990	100338608	LTR/ERVL	1426	+	309	100338299	85641
chr9	100252658	100452658	harbor1	chr9	100338900	100338937	LTR/ERVL	1426	+	18	100338918	86260
chr9	4879874	5079874	harbor1	chr9	4971442	4971760	LTR/ERVL	1353	+	159	4971601	91727
chr9	4879874	5079874	harbor1	chr9	4972365	4972544	LTR/ERVL	1353	+	90	4972455	92581
chr9	4883151	5083151	harbor1	chr9	4971442	4971760	LTR/ERVL	1353	+	159	4971601	88450
chr9	4883151	5083151	harbor1	chr9	4972365	4972544	LTR/ERVL	1353	+	90	4972455	89304
chr9	4692614	4892614	harbor1	chr9	4719472	4719754	LTR/ERVL	1402	+	141	4719613	26999
chr9	4692614	4892614	harbor1	chr9	4767974	4768533	LTR/ERVL	2710	+	280	4768254	75640
chr9	4692614	4892614	harbor1	chr9	4768560	4768598	LTR/ERVL	623	+	19	4768579	75965
chr9	4692614	4892614	harbor1	chr9	4776096	4776156	LTR/ERVL	1756	+	30	4776126	83512
chr9	4692614	4892614	harbor1	chr9	4776449	4776750	LTR/ERVL	1756	+	150	4776599	83985
chr9	4692270	4892270	harbor1	chr9	4719472	4719754	LTR/ERVL	1402	+	141	4719613	27343
chr9	4692270	4892270	harbor1	chr9	4767974	4768533	LTR/ERVL	2710	+	280	4768254	75984
chr9	4692270	4892270	harbor1	chr9	4768560	4768598	LTR/ERVL	623	+	19	4768579	76309
chr9	4692270	4892270	harbor1	chr9	4776096	4776156	LTR/ERVL	1756	+	30	4776126	83856
chr9	4692270	4892270	harbor1	chr9	4776449	4776750	LTR/ERVL	1756	+	150	4776599	84329
chr9	4669979	4869979	harbor1	chr9	4719472	4719754	LTR/ERVL	1402	+	141	4719613	49634
chr9	4669979	4869979	harbor1	chr9	4767974	4768533	LTR/ERVL	2710	+	280	4768254	98275
chr9	4669979	4869979	harbor1	chr9	4768560	4768598	LTR/ERVL	623	+	19	4768579	98600
chr9	4692437	4892437	harbor1	chr9	4719472	4719754	LTR/ERVL	1402	+	141	4719613	27176
chr9	4692437	4892437	harbor1	chr9	4767974	4768533	LTR/ERVL	2710	+	280	4768254	75817
chr9	4692437	4892437	harbor1	chr9	4768560	4768598	LTR/ERVL	623	+	19	4768579	76142
chr9	4692437	4892437	harbor1	chr9	4776096	4776156	LTR/ERVL	1756	+	30	4776126	83689
chr9	4692437	4892437	harbor1	chr9	4776449	4776750	LTR/ERVL	1756	+	150	4776599	84162
chr9	4693668	4893668	harbor1	chr9	4719472	4719754	LTR/ERVL	1402	+	141	4719613	25945
chr9	4693668	4893668	harbor1	chr9	4767974	4768533	LTR/ERVL	2710	+	280	4768254	74586
chr9	4693668	4893668	harbor1	chr9	4768560	4768598	LTR/ERVL	623	+	19	4768579	74911
chr9	4693668	4893668	harbor1	chr9	4776096	4776156	LTR/ERVL	1756	+	30	4776126	82458
chr9	4693668	4893668	harbor1	chr9	4776449	4776750	LTR/ERVL	1756	+	150	4776599	82931
chr9	4884822	5084822	harbor1	chr9	4971442	4971760	LTR/ERVL	1353	+	159	4971601	86779
chr9	4884822	5084822	harbor1	chr9	4972365	4972544	LTR/ERVL	1353	+	90	4972455	87633
chr9	132382125	132582125	harbor1	chr9	132478162	132478314	LTR/ERVL	828	+	76	132478238	96113
chr9	68605581	68805581	harbor1	chr9	68606573	68607099	LTR/ERVL	2580	+	263	68606836	1255
chr9	68605581	68805581	harbor1	chr9	68634248	68634706	LTR/ERVL	1390	+	229	68634477	28896
chr9	68605581	68805581	harbor1	chr9	68661999	68662160	LTR/ERVL	673	+	80	68662079	56498
chr9	68605581	68805581	harbor1	chr9	68663292	68665299	LTR/ERVL	3516	+	1004	68664296	58715
chr9	68605581	68805581	harbor1	chr9	68667709	68668071	LTR/ERVL	1092	+	181	68667890	62309
chr9	68605581	68805581	harbor1	chr9	68671043	68671520	LTR/ERVL	1601	+	238	68671281	65700
chr9	4669278	4869278	harbor1	chr9	4719472	4719754	LTR/ERVL	1402	+	141	4719613	50335
chr9	4669278	4869278	harbor1	chr9	4767974	4768533	LTR/ERVL	2710	+	280	4768254	98976
chr9	4669278	4869278	harbor1	chr9	4768560	4768598	LTR/ERVL	623	+	19	4768579	99301
chr9	4755861	4955861	harbor1	chr9	4767974	4768533	LTR/ERVL	2710	+	280	4768254	12393
chr9	4755861	4955861	harbor1	chr9	4768560	4768598	LTR/ERVL	623	+	19	4768579	12718
chr9	4755861	4955861	harbor1	chr9	4776096	4776156	LTR/ERVL	1756	+	30	4776126	20265
chr9	4755861	4955861	harbor1	chr9	4776449	4776750	LTR/ERVL	1756	+	150	4776599	20738
chr9	4884838	5084838	harbor1	chr9	4971442	4971760	LTR/ERVL	1353	+	159	4971601	86763
chr9	4884838	5084838	harbor1	chr9	4972365	4972544	LTR/ERVL	1353	+	90	4972455	87617
chr9	4703727	4903727	harbor1	chr9	4719472	4719754	LTR/ERVL	1402	+	141	4719613	15886
chr9	4703727	4903727	harbor1	chr9	4767974	4768533	LTR/ERVL	2710	+	280	4768254	64527
chr9	4703727	4903727	harbor1	chr9	4768560	4768598	LTR/ERVL	623	+	19	4768579	64852
chr9	4703727	4903727	harbor1	chr9	4776096	4776156	LTR/ERVL	1756	+	30	4776126	72399
chr9	4703727	4903727	harbor1	chr9	4776449	4776750	LTR/ERVL	1756	+	150	4776599	72872
chr9	4567404	4767404	harbor1	chr9	4625983	4626718	LTR/ERVL	1044	+	368	4626351	58947
chr9	4747782	4947782	harbor1	chr9	4767974	4768533	LTR/ERVL	2710	+	280	4768254	20472
chr9	4747782	4947782	harbor1	chr9	4768560	4768598	LTR/ERVL	623	+	19	4768579	20797
chr9	4747782	4947782	harbor1	chr9	4776096	4776156	LTR/ERVL	1756	+	30	4776126	28344
chr9	4747782	4947782	harbor1	chr9	4776449	4776750	LTR/ERVL	1756	+	150	4776599	28817
chr9	4884786	5084786	harbor1	chr9	4971442	4971760	LTR/ERVL	1353	+	159	4971601	86815
chr9	4884786	5084786	harbor1	chr9	4972365	4972544	LTR/ERVL	1353	+	90	4972455	87669
chr9	4692442	4892442	harbor1	chr9	4719472	4719754	LTR/ERVL	1402	+	141	4719613	27171
chr9	4692442	4892442	harbor1	chr9	4767974	4768533	LTR/ERVL	2710	+	280	4768254	75812
chr9	4692442	4892442	harbor1	chr9	4768560	4768598	LTR/ERVL	623	+	19	4768579	76137
chr9	4692442	4892442	harbor1	chr9	4776096	4776156	LTR/ERVL	1756	+	30	4776126	83684
chr9	4692442	4892442	harbor1	chr9	4776449	4776750	LTR/ERVL	1756	+	150	4776599	84157
chr9	4692263	4892263	harbor1	chr9	4719472	4719754	LTR/ERVL	1402	+	141	4719613	27350
chr9	4692263	4892263	harbor1	chr9	4767974	4768533	LTR/ERVL	2710	+	280	4768254	75991
chr9	4692263	4892263	harbor1	chr9	4768560	4768598	LTR/ERVL	623	+	19	4768579	76316
chr9	4692263	4892263	harbor1	chr9	4776096	4776156	LTR/ERVL	1756	+	30	4776126	83863
chr9	4692263	4892263	harbor1	chr9	4776449	4776750	LTR/ERVL	1756	+	150	4776599	84336
chr9	4884812	5084812	harbor1	chr9	4971442	4971760	LTR/ERVL	1353	+	159	4971601	86789
chr9	4884812	5084812	harbor1	chr9	4972365	4972544	LTR/ERVL	1353	+	90	4972455	87643
chr9	4692767	4892767	harbor1	chr9	4719472	4719754	LTR/ERVL	1402	+	141	4719613	26846
chr9	4692767	4892767	harbor1	chr9	4767974	4768533	LTR/ERVL	2710	+	280	4768254	75487
chr9	4692767	4892767	harbor1	chr9	4768560	4768598	LTR/ERVL	623	+	19	4768579	75812
chr9	4692767	4892767	harbor1	chr9	4776096	4776156	LTR/ERVL	1756	+	30	4776126	83359
chr9	4692767	4892767	harbor1	chr9	4776449	4776750	LTR/ERVL	1756	+	150	4776599	83832
chr9	4884794	5084794	harbor1	chr9	4971442	4971760	LTR/ERVL	1353	+	159	4971601	86807
chr9	4884794	5084794	harbor1	chr9	4972365	4972544	LTR/ERVL	1353	+	90	4972455	87661
chr9	68603685	68803685	harbor1	chr9	68606573	68607099	LTR/ERVL	2580	+	263	68606836	3151
chr9	68603685	68803685	harbor1	chr9	68634248	68634706	LTR/ERVL	1390	+	229	68634477	30792
chr9	68603685	68803685	harbor1	chr9	68661999	68662160	LTR/ERVL	673	+	80	68662079	58394
chr9	68603685	68803685	harbor1	chr9	68663292	68665299	LTR/ERVL	3516	+	1004	68664296	60611
chr9	68603685	68803685	harbor1	chr9	68667709	68668071	LTR/ERVL	1092	+	181	68667890	64205
chr9	68603685	68803685	harbor1	chr9	68671043	68671520	LTR/ERVL	1601	+	238	68671281	67596
chr9	4663011	4863011	harbor1	chr9	4719472	4719754	LTR/ERVL	1402	+	141	4719613	56602
chr9	4704642	4904642	harbor1	chr9	4719472	4719754	LTR/ERVL	1402	+	141	4719613	14971
chr9	4704642	4904642	harbor1	chr9	4767974	4768533	LTR/ERVL	2710	+	280	4768254	63612
chr9	4704642	4904642	harbor1	chr9	4768560	4768598	LTR/ERVL	623	+	19	4768579	63937
chr9	4704642	4904642	harbor1	chr9	4776096	4776156	LTR/ERVL	1756	+	30	4776126	71484
chr9	4704642	4904642	harbor1	chr9	4776449	4776750	LTR/ERVL	1756	+	150	4776599	71957
chr9	95414535	95614535	harbor1	chr9	95430638	95430831	LTR/ERVL	551	+	96	95430734	16199
chr9	95414535	95614535	harbor1	chr9	95430868	95431012	LTR/ERVL	591	+	72	95430940	16405
chr9	95414535	95614535	harbor1	chr9	95434424	95434622	LTR/ERVL	672	+	99	95434523	19988
chr9	4698312	4898312	harbor1	chr9	4719472	4719754	LTR/ERVL	1402	+	141	4719613	21301
chr9	4698312	4898312	harbor1	chr9	4767974	4768533	LTR/ERVL	2710	+	280	4768254	69942
chr9	4698312	4898312	harbor1	chr9	4768560	4768598	LTR/ERVL	623	+	19	4768579	70267
chr9	4698312	4898312	harbor1	chr9	4776096	4776156	LTR/ERVL	1756	+	30	4776126	77814
chr9	4698312	4898312	harbor1	chr9	4776449	4776750	LTR/ERVL	1756	+	150	4776599	78287
chr9	4883407	5083407	harbor1	chr9	4971442	4971760	LTR/ERVL	1353	+	159	4971601	88194
chr9	4883407	5083407	harbor1	chr9	4972365	4972544	LTR/ERVL	1353	+	90	4972455	89048
chr9	4766714	4966714	harbor1	chr9	4767974	4768533	LTR/ERVL	2710	+	280	4768254	1540
chr9	4766714	4966714	harbor1	chr9	4768560	4768598	LTR/ERVL	623	+	19	4768579	1865
chr9	4766714	4966714	harbor1	chr9	4776096	4776156	LTR/ERVL	1756	+	30	4776126	9412
chr9	4766714	4966714	harbor1	chr9	4776449	4776750	LTR/ERVL	1756	+	150	4776599	9885
chr9	133063758	133263758	harbor1	chr9	133156878	133157011	LTR/ERVL	611	+	66	133156944	93186
chr9	133063758	133263758	harbor1	chr9	133157311	133157462	LTR/ERVL	611	+	76	133157387	93629
chr9	4883310	5083310	harbor1	chr9	4971442	4971760	LTR/ERVL	1353	+	159	4971601	88291
chr9	4883310	5083310	harbor1	chr9	4972365	4972544	LTR/ERVL	1353	+	90	4972455	89145
chr9	4883306	5083306	harbor1	chr9	4971442	4971760	LTR/ERVL	1353	+	159	4971601	88295
chr9	4883306	5083306	harbor1	chr9	4972365	4972544	LTR/ERVL	1353	+	90	4972455	89149
chr9	111796999	111996999	harbor1	chr9	111870273	111871099	LTR/ERVL	3837	+	413	111870686	73687
chr9	4663450	4863450	harbor1	chr9	4719472	4719754	LTR/ERVL	1402	+	141	4719613	56163
chr9	3230875	3430875	harbor1	chr9	3263687	3264172	LTR/ERVL	1309	+	242	3263929	33054
chr9	3230875	3430875	harbor1	chr9	3279858	3280410	LTR/ERVL	580	+	276	3280134	49259
chr9	4739858	4939858	harbor1	chr9	4767974	4768533	LTR/ERVL	2710	+	280	4768254	28396
chr9	4739858	4939858	harbor1	chr9	4768560	4768598	LTR/ERVL	623	+	19	4768579	28721
chr9	4739858	4939858	harbor1	chr9	4776096	4776156	LTR/ERVL	1756	+	30	4776126	36268
chr9	4739858	4939858	harbor1	chr9	4776449	4776750	LTR/ERVL	1756	+	150	4776599	36741
chr9	4663900	4863900	harbor1	chr9	4719472	4719754	LTR/ERVL	1402	+	141	4719613	55713
chr9	4884859	5084859	harbor1	chr9	4971442	4971760	LTR/ERVL	1353	+	159	4971601	86742
chr9	4884859	5084859	harbor1	chr9	4972365	4972544	LTR/ERVL	1353	+	90	4972455	87596
chr9	4692956	4892956	harbor1	chr9	4719472	4719754	LTR/ERVL	1402	+	141	4719613	26657
chr9	4692956	4892956	harbor1	chr9	4767974	4768533	LTR/ERVL	2710	+	280	4768254	75298
chr9	4692956	4892956	harbor1	chr9	4768560	4768598	LTR/ERVL	623	+	19	4768579	75623
chr9	4692956	4892956	harbor1	chr9	4776096	4776156	LTR/ERVL	1756	+	30	4776126	83170
chr9	4692956	4892956	harbor1	chr9	4776449	4776750	LTR/ERVL	1756	+	150	4776599	83643
chr9	4694138	4894138	harbor1	chr9	4719472	4719754	LTR/ERVL	1402	+	141	4719613	25475
chr9	4694138	4894138	harbor1	chr9	4767974	4768533	LTR/ERVL	2710	+	280	4768254	74116
chr9	4694138	4894138	harbor1	chr9	4768560	4768598	LTR/ERVL	623	+	19	4768579	74441
chr9	4694138	4894138	harbor1	chr9	4776096	4776156	LTR/ERVL	1756	+	30	4776126	81988
chr9	4694138	4894138	harbor1	chr9	4776449	4776750	LTR/ERVL	1756	+	150	4776599	82461
chr9	4692434	4892434	harbor1	chr9	4719472	4719754	LTR/ERVL	1402	+	141	4719613	27179
chr9	4692434	4892434	harbor1	chr9	4767974	4768533	LTR/ERVL	2710	+	280	4768254	75820
chr9	4692434	4892434	harbor1	chr9	4768560	4768598	LTR/ERVL	623	+	19	4768579	76145
chr9	4692434	4892434	harbor1	chr9	4776096	4776156	LTR/ERVL	1756	+	30	4776126	83692
chr9	4692434	4892434	harbor1	chr9	4776449	4776750	LTR/ERVL	1756	+	150	4776599	84165
chr9	4663906	4863906	harbor1	chr9	4719472	4719754	LTR/ERVL	1402	+	141	4719613	55707
chr9	4879900	5079900	harbor1	chr9	4971442	4971760	LTR/ERVL	1353	+	159	4971601	91701
chr9	4879900	5079900	harbor1	chr9	4972365	4972544	LTR/ERVL	1353	+	90	4972455	92555
chr9	4877201	5077201	harbor1	chr9	4971442	4971760	LTR/ERVL	1353	+	159	4971601	94400
chr9	4877201	5077201	harbor1	chr9	4972365	4972544	LTR/ERVL	1353	+	90	4972455	95254
chr9	1	114163	harbor1	chr9	57588	57794	LTR/ERVL	891	+	103	57691	57690
chr9	1	114163	harbor1	chr9	58216	58448	LTR/ERVL	1535	+	116	58332	58331
chr9	4663278	4863278	harbor1	chr9	4719472	4719754	LTR/ERVL	1402	+	141	4719613	56335
chr9	35598598	35798598	harbor1	chr9	35628541	35628845	LTR/ERVL	894	+	152	35628693	30095
chr9	4755859	4955859	harbor1	chr9	4767974	4768533	LTR/ERVL	2710	+	280	4768254	12395
chr9	4755859	4955859	harbor1	chr9	4768560	4768598	LTR/ERVL	623	+	19	4768579	12720
chr9	4755859	4955859	harbor1	chr9	4776096	4776156	LTR/ERVL	1756	+	30	4776126	20267
chr9	4755859	4955859	harbor1	chr9	4776449	4776750	LTR/ERVL	1756	+	150	4776599	20740
chr9	1915302	2115302	harbor1	chr9	1937631	1938089	LTR/ERVL	1492	+	229	1937860	22558
chr9	1915302	2115302	harbor1	chr9	2006455	2006732	LTR/ERVL	742	+	138	2006593	91291
chr9	133063183	133263183	harbor1	chr9	133156878	133157011	LTR/ERVL	611	+	66	133156944	93761
chr9	133063183	133263183	harbor1	chr9	133157311	133157462	LTR/ERVL	611	+	76	133157387	94204
chr9	137214690	137414690	harbor1	chr9	137249416	137249649	LTR/ERVL	867	+	116	137249532	34842
chr9	137214690	137414690	harbor1	chr9	137249657	137250192	LTR/ERVL	1825	+	268	137249925	35235
chr9	4692945	4892945	harbor1	chr9	4719472	4719754	LTR/ERVL	1402	+	141	4719613	26668
chr9	4692945	4892945	harbor1	chr9	4767974	4768533	LTR/ERVL	2710	+	280	4768254	75309
chr9	4692945	4892945	harbor1	chr9	4768560	4768598	LTR/ERVL	623	+	19	4768579	75634
chr9	4692945	4892945	harbor1	chr9	4776096	4776156	LTR/ERVL	1756	+	30	4776126	83181
chr9	4692945	4892945	harbor1	chr9	4776449	4776750	LTR/ERVL	1756	+	150	4776599	83654
chr9	4663875	4863875	harbor1	chr9	4719472	4719754	LTR/ERVL	1402	+	141	4719613	55738
chr9	1987488	2187488	harbor1	chr9	2006455	2006732	LTR/ERVL	742	+	138	2006593	19105
chr9	1987488	2187488	harbor1	chr9	2038334	2038802	LTR/ERVL	849	+	234	2038568	51080
chr9	4692940	4892940	harbor1	chr9	4719472	4719754	LTR/ERVL	1402	+	141	4719613	26673
chr9	4692940	4892940	harbor1	chr9	4767974	4768533	LTR/ERVL	2710	+	280	4768254	75314
chr9	4692940	4892940	harbor1	chr9	4768560	4768598	LTR/ERVL	623	+	19	4768579	75639
chr9	4692940	4892940	harbor1	chr9	4776096	4776156	LTR/ERVL	1756	+	30	4776126	83186
chr9	4692940	4892940	harbor1	chr9	4776449	4776750	LTR/ERVL	1756	+	150	4776599	83659
chr9	134036206	134236206	harbor1	chr9	134111144	134111681	LTR/ERVL	1985	+	268	134111412	75206
chr9	4669568	4869568	harbor1	chr9	4719472	4719754	LTR/ERVL	1402	+	141	4719613	50045
chr9	4669568	4869568	harbor1	chr9	4767974	4768533	LTR/ERVL	2710	+	280	4768254	98686
chr9	4669568	4869568	harbor1	chr9	4768560	4768598	LTR/ERVL	623	+	19	4768579	99011
chr9	4884854	5084854	harbor1	chr9	4971442	4971760	LTR/ERVL	1353	+	159	4971601	86747
chr9	4884854	5084854	harbor1	chr9	4972365	4972544	LTR/ERVL	1353	+	90	4972455	87601
chr9	4884933	5084933	harbor1	chr9	4971442	4971760	LTR/ERVL	1353	+	159	4971601	86668
chr9	4884933	5084933	harbor1	chr9	4972365	4972544	LTR/ERVL	1353	+	90	4972455	87522
chr9	4692448	4892448	harbor1	chr9	4719472	4719754	LTR/ERVL	1402	+	141	4719613	27165
chr9	4692448	4892448	harbor1	chr9	4767974	4768533	LTR/ERVL	2710	+	280	4768254	75806
chr9	4692448	4892448	harbor1	chr9	4768560	4768598	LTR/ERVL	623	+	19	4768579	76131
chr9	4692448	4892448	harbor1	chr9	4776096	4776156	LTR/ERVL	1756	+	30	4776126	83678
chr9	4692448	4892448	harbor1	chr9	4776449	4776750	LTR/ERVL	1756	+	150	4776599	84151
chr9	21875478	22075478	harbor1	chr9	21920601	21920750	LTR/ERVL	712	+	74	21920675	45197
chr9	4692452	4892452	harbor1	chr9	4719472	4719754	LTR/ERVL	1402	+	141	4719613	27161
chr9	4692452	4892452	harbor1	chr9	4767974	4768533	LTR/ERVL	2710	+	280	4768254	75802
chr9	4692452	4892452	harbor1	chr9	4768560	4768598	LTR/ERVL	623	+	19	4768579	76127
chr9	4692452	4892452	harbor1	chr9	4776096	4776156	LTR/ERVL	1756	+	30	4776126	83674
chr9	4692452	4892452	harbor1	chr9	4776449	4776750	LTR/ERVL	1756	+	150	4776599	84147
chr9	4885046	5085046	harbor1	chr9	4971442	4971760	LTR/ERVL	1353	+	159	4971601	86555
chr9	4885046	5085046	harbor1	chr9	4972365	4972544	LTR/ERVL	1353	+	90	4972455	87409
chr9	134035557	134235557	harbor1	chr9	134111144	134111681	LTR/ERVL	1985	+	268	134111412	75855
chr9	4692258	4892258	harbor1	chr9	4719472	4719754	LTR/ERVL	1402	+	141	4719613	27355
chr9	4692258	4892258	harbor1	chr9	4767974	4768533	LTR/ERVL	2710	+	280	4768254	75996
chr9	4692258	4892258	harbor1	chr9	4768560	4768598	LTR/ERVL	623	+	19	4768579	76321
chr9	4692258	4892258	harbor1	chr9	4776096	4776156	LTR/ERVL	1756	+	30	4776126	83868
chr9	4692258	4892258	harbor1	chr9	4776449	4776750	LTR/ERVL	1756	+	150	4776599	84341
chr9	137214689	137414689	harbor1	chr9	137249416	137249649	LTR/ERVL	867	+	116	137249532	34843
chr9	137214689	137414689	harbor1	chr9	137249657	137250192	LTR/ERVL	1825	+	268	137249925	35236
chr9	4747506	4947506	harbor1	chr9	4767974	4768533	LTR/ERVL	2710	+	280	4768254	20748
chr9	4747506	4947506	harbor1	chr9	4768560	4768598	LTR/ERVL	623	+	19	4768579	21073
chr9	4747506	4947506	harbor1	chr9	4776096	4776156	LTR/ERVL	1756	+	30	4776126	28620
chr9	4747506	4947506	harbor1	chr9	4776449	4776750	LTR/ERVL	1756	+	150	4776599	29093
chr9	137213986	137413986	harbor1	chr9	137249416	137249649	LTR/ERVL	867	+	116	137249532	35546
chr9	137213986	137413986	harbor1	chr9	137249657	137250192	LTR/ERVL	1825	+	268	137249925	35939
chr9	4884905	5084905	harbor1	chr9	4971442	4971760	LTR/ERVL	1353	+	159	4971601	86696
chr9	4884905	5084905	harbor1	chr9	4972365	4972544	LTR/ERVL	1353	+	90	4972455	87550
chr9	35580921	35780921	harbor1	chr9	35628541	35628845	LTR/ERVL	894	+	152	35628693	47772
chr9	1955526	2155526	harbor1	chr9	2006455	2006732	LTR/ERVL	742	+	138	2006593	51067
chr9	1955526	2155526	harbor1	chr9	2038334	2038802	LTR/ERVL	849	+	234	2038568	83042
chr9	89260220	89460220	harbor1	chr9	89286886	89287630	LTR/ERVL	1781	+	372	89287258	27038
chr9	4884994	5084994	harbor1	chr9	4971442	4971760	LTR/ERVL	1353	+	159	4971601	86607
chr9	4884994	5084994	harbor1	chr9	4972365	4972544	LTR/ERVL	1353	+	90	4972455	87461
chr9	92958896	93158896	harbor1	chr9	92988550	92989012	LTR/ERVL	1881	+	231	92988781	29885
chr9	137214628	137414628	harbor1	chr9	137249416	137249649	LTR/ERVL	867	+	116	137249532	34904
chr9	137214628	137414628	harbor1	chr9	137249657	137250192	LTR/ERVL	1825	+	268	137249925	35297
chr9	4692158	4892158	harbor1	chr9	4719472	4719754	LTR/ERVL	1402	+	141	4719613	27455
chr9	4692158	4892158	harbor1	chr9	4767974	4768533	LTR/ERVL	2710	+	280	4768254	76096
chr9	4692158	4892158	harbor1	chr9	4768560	4768598	LTR/ERVL	623	+	19	4768579	76421
chr9	4692158	4892158	harbor1	chr9	4776096	4776156	LTR/ERVL	1756	+	30	4776126	83968
chr9	4692158	4892158	harbor1	chr9	4776449	4776750	LTR/ERVL	1756	+	150	4776599	84441
chr9	134035364	134235364	harbor1	chr9	134111144	134111681	LTR/ERVL	1985	+	268	134111412	76048
chr9	134577518	134777518	harbor1	chr9	134591103	134591633	LTR/ERVL	2328	+	265	134591368	13850
chr9	134577518	134777518	harbor1	chr9	134595533	134595713	LTR/ERVL	563	+	90	134595623	18105
chr9	134577518	134777518	harbor1	chr9	134631242	134631789	LTR/ERVL	1864	+	274	134631516	53998
chr9	134577518	134777518	harbor1	chr9	134647908	134648288	LTR/ERVL	3094	+	190	134648098	70580
chr9	134577518	134777518	harbor1	chr9	134648321	134648377	LTR/ERVL	3094	+	28	134648349	70831
chr9	4669265	4869265	harbor1	chr9	4719472	4719754	LTR/ERVL	1402	+	141	4719613	50348
chr9	4669265	4869265	harbor1	chr9	4767974	4768533	LTR/ERVL	2710	+	280	4768254	98989
chr9	4669265	4869265	harbor1	chr9	4768560	4768598	LTR/ERVL	623	+	19	4768579	99314
chr9	97885114	98085114	harbor1	chr9	97965278	97965512	LTR/ERVL	769	+	117	97965395	80281
chr9	4748106	4948106	harbor1	chr9	4767974	4768533	LTR/ERVL	2710	+	280	4768254	20148
chr9	4748106	4948106	harbor1	chr9	4768560	4768598	LTR/ERVL	623	+	19	4768579	20473
chr9	4748106	4948106	harbor1	chr9	4776096	4776156	LTR/ERVL	1756	+	30	4776126	28020
chr9	4748106	4948106	harbor1	chr9	4776449	4776750	LTR/ERVL	1756	+	150	4776599	28493
chr9	83553396	83753396	harbor1	chr9	83621065	83621575	LTR/ERVL	1178	+	255	83621320	67924
chr9	4884926	5084926	harbor1	chr9	4971442	4971760	LTR/ERVL	1353	+	159	4971601	86675
chr9	4884926	5084926	harbor1	chr9	4972365	4972544	LTR/ERVL	1353	+	90	4972455	87529
chr9	4692312	4892312	harbor1	chr9	4719472	4719754	LTR/ERVL	1402	+	141	4719613	27301
chr9	4692312	4892312	harbor1	chr9	4767974	4768533	LTR/ERVL	2710	+	280	4768254	75942
chr9	4692312	4892312	harbor1	chr9	4768560	4768598	LTR/ERVL	623	+	19	4768579	76267
chr9	4692312	4892312	harbor1	chr9	4776096	4776156	LTR/ERVL	1756	+	30	4776126	83814
chr9	4692312	4892312	harbor1	chr9	4776449	4776750	LTR/ERVL	1756	+	150	4776599	84287
chr9	4692909	4892909	harbor1	chr9	4719472	4719754	LTR/ERVL	1402	+	141	4719613	26704
chr9	4692909	4892909	harbor1	chr9	4767974	4768533	LTR/ERVL	2710	+	280	4768254	75345
chr9	4692909	4892909	harbor1	chr9	4768560	4768598	LTR/ERVL	623	+	19	4768579	75670
chr9	4692909	4892909	harbor1	chr9	4776096	4776156	LTR/ERVL	1756	+	30	4776126	83217
chr9	4692909	4892909	harbor1	chr9	4776449	4776750	LTR/ERVL	1756	+	150	4776599	83690
chr9	4663127	4863127	harbor1	chr9	4719472	4719754	LTR/ERVL	1402	+	141	4719613	56486
chr9	133904999	134104999	harbor1	chr9	133934351	133934887	LTR/ERVL	2441	+	268	133934619	29620
chr9	94048912	94248912	harbor1	chr9	94106208	94106673	LTR/ERVL	1523	+	232	94106440	57528
chr9	68605563	68805563	harbor1	chr9	68606573	68607099	LTR/ERVL	2580	+	263	68606836	1273
chr9	68605563	68805563	harbor1	chr9	68634248	68634706	LTR/ERVL	1390	+	229	68634477	28914
chr9	68605563	68805563	harbor1	chr9	68661999	68662160	LTR/ERVL	673	+	80	68662079	56516
chr9	68605563	68805563	harbor1	chr9	68663292	68665299	LTR/ERVL	3516	+	1004	68664296	58733
chr9	68605563	68805563	harbor1	chr9	68667709	68668071	LTR/ERVL	1092	+	181	68667890	62327
chr9	68605563	68805563	harbor1	chr9	68671043	68671520	LTR/ERVL	1601	+	238	68671281	65718
chr9	4692971	4892971	harbor1	chr9	4719472	4719754	LTR/ERVL	1402	+	141	4719613	26642
chr9	4692971	4892971	harbor1	chr9	4767974	4768533	LTR/ERVL	2710	+	280	4768254	75283
chr9	4692971	4892971	harbor1	chr9	4768560	4768598	LTR/ERVL	623	+	19	4768579	75608
chr9	4692971	4892971	harbor1	chr9	4776096	4776156	LTR/ERVL	1756	+	30	4776126	83155
chr9	4692971	4892971	harbor1	chr9	4776449	4776750	LTR/ERVL	1756	+	150	4776599	83628
chr9	137214596	137414596	harbor1	chr9	137249416	137249649	LTR/ERVL	867	+	116	137249532	34936
chr9	137214596	137414596	harbor1	chr9	137249657	137250192	LTR/ERVL	1825	+	268	137249925	35329
chr9	137214600	137414600	harbor1	chr9	137249416	137249649	LTR/ERVL	867	+	116	137249532	34932
chr9	137214600	137414600	harbor1	chr9	137249657	137250192	LTR/ERVL	1825	+	268	137249925	35325
chr9	4884847	5084847	harbor1	chr9	4971442	4971760	LTR/ERVL	1353	+	159	4971601	86754
chr9	4884847	5084847	harbor1	chr9	4972365	4972544	LTR/ERVL	1353	+	90	4972455	87608
chr9	112387221	112587221	harbor1	chr9	112474175	112474321	LTR/ERVL	2525	+	73	112474248	87027
chr9	112387221	112587221	harbor1	chr9	112474401	112474977	LTR/ERVL	2525	+	288	112474689	87468
chr9	112387221	112587221	harbor1	chr9	112483117	112483243	LTR/ERVL	1393	+	63	112483180	95959
chr9	112387221	112587221	harbor1	chr9	112483549	112483647	LTR/ERVL	1393	+	49	112483598	96377
chr9	112387221	112587221	harbor1	chr9	112483945	112484074	LTR/ERVL	1393	+	64	112484009	96788
chr9	4692946	4892946	harbor1	chr9	4719472	4719754	LTR/ERVL	1402	+	141	4719613	26667
chr9	4692946	4892946	harbor1	chr9	4767974	4768533	LTR/ERVL	2710	+	280	4768254	75308
chr9	4692946	4892946	harbor1	chr9	4768560	4768598	LTR/ERVL	623	+	19	4768579	75633
chr9	4692946	4892946	harbor1	chr9	4776096	4776156	LTR/ERVL	1756	+	30	4776126	83180
chr9	4692946	4892946	harbor1	chr9	4776449	4776750	LTR/ERVL	1756	+	150	4776599	83653
chr9	4883816	5083816	harbor1	chr9	4971442	4971760	LTR/ERVL	1353	+	159	4971601	87785
chr9	4883816	5083816	harbor1	chr9	4972365	4972544	LTR/ERVL	1353	+	90	4972455	88639
chr9	4663649	4863649	harbor1	chr9	4719472	4719754	LTR/ERVL	1402	+	141	4719613	55964
chr9	4663080	4863080	harbor1	chr9	4719472	4719754	LTR/ERVL	1402	+	141	4719613	56533
chr9	125322076	125522076	harbor1	chr9	125394412	125394651	LTR/ERVL	637	+	120	125394532	72456
chr9	125322076	125522076	harbor1	chr9	125395969	125396094	LTR/ERVL	493	+	62	125396031	73955
chr9	125322076	125522076	harbor1	chr9	125399808	125400250	LTR/ERVL	796	+	221	125400029	77953
chr9	4884823	5084823	harbor1	chr9	4971442	4971760	LTR/ERVL	1353	+	159	4971601	86778
chr9	4884823	5084823	harbor1	chr9	4972365	4972544	LTR/ERVL	1353	+	90	4972455	87632
chr9	133063738	133263738	harbor1	chr9	133156878	133157011	LTR/ERVL	611	+	66	133156944	93206
chr9	133063738	133263738	harbor1	chr9	133157311	133157462	LTR/ERVL	611	+	76	133157387	93649
chr9	68605579	68805579	harbor1	chr9	68606573	68607099	LTR/ERVL	2580	+	263	68606836	1257
chr9	68605579	68805579	harbor1	chr9	68634248	68634706	LTR/ERVL	1390	+	229	68634477	28898
chr9	68605579	68805579	harbor1	chr9	68661999	68662160	LTR/ERVL	673	+	80	68662079	56500
chr9	68605579	68805579	harbor1	chr9	68663292	68665299	LTR/ERVL	3516	+	1004	68664296	58717
chr9	68605579	68805579	harbor1	chr9	68667709	68668071	LTR/ERVL	1092	+	181	68667890	62311
chr9	68605579	68805579	harbor1	chr9	68671043	68671520	LTR/ERVL	1601	+	238	68671281	65702
chr9	6658046	6858046	harbor1	chr9	6706759	6706836	LTR/ERVL	2171	+	38	6706797	48751
chr9	6658046	6858046	harbor1	chr9	6707124	6707147	LTR/ERVL	2171	+	12	6707136	49090
chr9	6658046	6858046	harbor1	chr9	6707454	6707771	LTR/ERVL	2171	+	158	6707612	49566
chr9	6658046	6858046	harbor1	chr9	6724130	6724498	LTR/ERVL	586	+	184	6724314	66268
chr9	6658046	6858046	harbor1	chr9	6728092	6728247	LTR/ERVL	796	+	78	6728170	70124
chr9	6658046	6858046	harbor1	chr9	6729561	6729827	LTR/ERVL	2146	+	133	6729694	71648
chr9	6658046	6858046	harbor1	chr9	6730130	6730282	LTR/ERVL	2146	+	76	6730206	72160
chr9	6658046	6858046	harbor1	chr9	6733191	6733601	LTR/ERVL	2911	+	205	6733396	75350
chr9	6658046	6858046	harbor1	chr9	6734151	6734287	LTR/ERVL	2911	+	68	6734219	76173
chr9	6658046	6858046	harbor1	chr9	6735169	6735390	LTR/ERVL	737	+	110	6735279	77233
chr9	6658046	6858046	harbor1	chr9	6700799	6701276	LTR/ERVL	1276	+	238	6701037	42991
chr9	89262840	89462840	harbor1	chr9	89286886	89287630	LTR/ERVL	1781	+	372	89287258	24418
chr9	4883473	5083473	harbor1	chr9	4971442	4971760	LTR/ERVL	1353	+	159	4971601	88128
chr9	4883473	5083473	harbor1	chr9	4972365	4972544	LTR/ERVL	1353	+	90	4972455	88982
chr9	4669986	4869986	harbor1	chr9	4719472	4719754	LTR/ERVL	1402	+	141	4719613	49627
chr9	4669986	4869986	harbor1	chr9	4767974	4768533	LTR/ERVL	2710	+	280	4768254	98268
chr9	4669986	4869986	harbor1	chr9	4768560	4768598	LTR/ERVL	623	+	19	4768579	98593
chr9	4884959	5084959	harbor1	chr9	4971442	4971760	LTR/ERVL	1353	+	159	4971601	86642
chr9	4884959	5084959	harbor1	chr9	4972365	4972544	LTR/ERVL	1353	+	90	4972455	87496
chr9	4692882	4892882	harbor1	chr9	4719472	4719754	LTR/ERVL	1402	+	141	4719613	26731
chr9	4692882	4892882	harbor1	chr9	4767974	4768533	LTR/ERVL	2710	+	280	4768254	75372
chr9	4692882	4892882	harbor1	chr9	4768560	4768598	LTR/ERVL	623	+	19	4768579	75697
chr9	4692882	4892882	harbor1	chr9	4776096	4776156	LTR/ERVL	1756	+	30	4776126	83244
chr9	4692882	4892882	harbor1	chr9	4776449	4776750	LTR/ERVL	1756	+	150	4776599	83717
chr9	4884897	5084897	harbor1	chr9	4971442	4971760	LTR/ERVL	1353	+	159	4971601	86704
chr9	4884897	5084897	harbor1	chr9	4972365	4972544	LTR/ERVL	1353	+	90	4972455	87558
chr9	4884936	5084936	harbor1	chr9	4971442	4971760	LTR/ERVL	1353	+	159	4971601	86665
chr9	4884936	5084936	harbor1	chr9	4972365	4972544	LTR/ERVL	1353	+	90	4972455	87519
chr9	134036095	134236095	harbor1	chr9	134111144	134111681	LTR/ERVL	1985	+	268	134111412	75317
chr9	4722331	4922331	harbor1	chr9	4767974	4768533	LTR/ERVL	2710	+	280	4768254	45923
chr9	4722331	4922331	harbor1	chr9	4768560	4768598	LTR/ERVL	623	+	19	4768579	46248
chr9	4722331	4922331	harbor1	chr9	4776096	4776156	LTR/ERVL	1756	+	30	4776126	53795
chr9	4722331	4922331	harbor1	chr9	4776449	4776750	LTR/ERVL	1756	+	150	4776599	54268
chr9	4883068	5083068	harbor1	chr9	4971442	4971760	LTR/ERVL	1353	+	159	4971601	88533
chr9	4883068	5083068	harbor1	chr9	4972365	4972544	LTR/ERVL	1353	+	90	4972455	89387
chr9	4884790	5084790	harbor1	chr9	4971442	4971760	LTR/ERVL	1353	+	159	4971601	86811
chr9	4884790	5084790	harbor1	chr9	4972365	4972544	LTR/ERVL	1353	+	90	4972455	87665
chr9	137214599	137414599	harbor1	chr9	137249416	137249649	LTR/ERVL	867	+	116	137249532	34933
chr9	137214599	137414599	harbor1	chr9	137249657	137250192	LTR/ERVL	1825	+	268	137249925	35326
chr9	127963374	128163374	harbor1	chr9	128040205	128040322	LTR/ERVL	860	+	58	128040263	76889
chr9	127963374	128163374	harbor1	chr9	128040609	128040625	LTR/ERVL	860	+	8	128040617	77243
chr9	127963374	128163374	harbor1	chr9	128041138	128041197	LTR/ERVL	860	+	30	128041168	77794
chr9	127963374	128163374	harbor1	chr9	128041197	128041713	LTR/ERVL	2930	+	258	128041455	78081
chr9	127963374	128163374	harbor1	chr9	128056204	128056491	LTR/ERVL	1184	+	144	128056348	92974
chr9	127963374	128163374	harbor1	chr9	128056987	128057287	LTR/ERVL	1072	+	150	128057137	93763
chr9	4663076	4863076	harbor1	chr9	4719472	4719754	LTR/ERVL	1402	+	141	4719613	56537
chr9	4663656	4863656	harbor1	chr9	4719472	4719754	LTR/ERVL	1402	+	141	4719613	55957
chr9	137214587	137414587	harbor1	chr9	137249416	137249649	LTR/ERVL	867	+	116	137249532	34945
chr9	137214587	137414587	harbor1	chr9	137249657	137250192	LTR/ERVL	1825	+	268	137249925	35338
chr9	114075621	114275621	harbor1	chr9	114130255	114130554	LTR/ERVL	790	+	150	114130405	54784
chr9	79473211	79673211	harbor1	chr9	79535421	79535886	LTR/ERVL	1983	+	232	79535653	62442
chr9	79473211	79673211	harbor1	chr9	79553267	79553721	LTR/ERVL	2669	+	227	79553494	80283
chr9	137214594	137414594	harbor1	chr9	137249416	137249649	LTR/ERVL	867	+	116	137249532	34938
chr9	137214594	137414594	harbor1	chr9	137249657	137250192	LTR/ERVL	1825	+	268	137249925	35331
chr9	4669933	4869933	harbor1	chr9	4719472	4719754	LTR/ERVL	1402	+	141	4719613	49680
chr9	4669933	4869933	harbor1	chr9	4767974	4768533	LTR/ERVL	2710	+	280	4768254	98321
chr9	4669933	4869933	harbor1	chr9	4768560	4768598	LTR/ERVL	623	+	19	4768579	98646
chr9	137214592	137414592	harbor1	chr9	137249416	137249649	LTR/ERVL	867	+	116	137249532	34940
chr9	137214592	137414592	harbor1	chr9	137249657	137250192	LTR/ERVL	1825	+	268	137249925	35333
chr9	4751750	4951750	harbor1	chr9	4767974	4768533	LTR/ERVL	2710	+	280	4768254	16504
chr9	4751750	4951750	harbor1	chr9	4768560	4768598	LTR/ERVL	623	+	19	4768579	16829
chr9	4751750	4951750	harbor1	chr9	4776096	4776156	LTR/ERVL	1756	+	30	4776126	24376
chr9	4751750	4951750	harbor1	chr9	4776449	4776750	LTR/ERVL	1756	+	150	4776599	24849
chr9	137179535	137379535	harbor1	chr9	137249416	137249649	LTR/ERVL	867	+	116	137249532	69997
chr9	137179535	137379535	harbor1	chr9	137249657	137250192	LTR/ERVL	1825	+	268	137249925	70390
chr9	137214601	137414601	harbor1	chr9	137249416	137249649	LTR/ERVL	867	+	116	137249532	34931
chr9	137214601	137414601	harbor1	chr9	137249657	137250192	LTR/ERVL	1825	+	268	137249925	35324
chr9	76918823	77118823	harbor1	chr9	76924408	76924931	LTR/ERVL	1089	+	262	76924670	5847
chr9	76918823	77118823	harbor1	chr9	76942261	76942655	LTR/ERVL	1482	+	197	76942458	23635
chr9	76918823	77118823	harbor1	chr9	76954753	76954829	LTR/ERVL	553	+	38	76954791	35968
chr9	76918823	77118823	harbor1	chr9	76956286	76956332	LTR/ERVL	553	+	23	76956309	37486
chr9	76918823	77118823	harbor1	chr9	76980759	76981131	LTR/ERVL	1864	+	186	76980945	62122
chr9	4663097	4863097	harbor1	chr9	4719472	4719754	LTR/ERVL	1402	+	141	4719613	56516
chr9	68605569	68805569	harbor1	chr9	68606573	68607099	LTR/ERVL	2580	+	263	68606836	1267
chr9	68605569	68805569	harbor1	chr9	68634248	68634706	LTR/ERVL	1390	+	229	68634477	28908
chr9	68605569	68805569	harbor1	chr9	68661999	68662160	LTR/ERVL	673	+	80	68662079	56510
chr9	68605569	68805569	harbor1	chr9	68663292	68665299	LTR/ERVL	3516	+	1004	68664296	58727
chr9	68605569	68805569	harbor1	chr9	68667709	68668071	LTR/ERVL	1092	+	181	68667890	62321
chr9	68605569	68805569	harbor1	chr9	68671043	68671520	LTR/ERVL	1601	+	238	68671281	65712
chr9	97885166	98085166	harbor1	chr9	97965278	97965512	LTR/ERVL	769	+	117	97965395	80229
chr9	4668976	4868976	harbor1	chr9	4719472	4719754	LTR/ERVL	1402	+	141	4719613	50637
chr9	4668976	4868976	harbor1	chr9	4767974	4768533	LTR/ERVL	2710	+	280	4768254	99278
chr9	4668976	4868976	harbor1	chr9	4768560	4768598	LTR/ERVL	623	+	19	4768579	99603
chr9	93084336	93284336	harbor1	chr9	93154383	93154523	LTR/ERVL	508	+	70	93154453	70117
chr9	4885042	5085042	harbor1	chr9	4971442	4971760	LTR/ERVL	1353	+	159	4971601	86559
chr9	4885042	5085042	harbor1	chr9	4972365	4972544	LTR/ERVL	1353	+	90	4972455	87413
chr9	92958971	93158971	harbor1	chr9	92988550	92989012	LTR/ERVL	1881	+	231	92988781	29810
chr9	4883803	5083803	harbor1	chr9	4971442	4971760	LTR/ERVL	1353	+	159	4971601	87798
chr9	4883803	5083803	harbor1	chr9	4972365	4972544	LTR/ERVL	1353	+	90	4972455	88652
chr9	4692784	4892784	harbor1	chr9	4719472	4719754	LTR/ERVL	1402	+	141	4719613	26829
chr9	4692784	4892784	harbor1	chr9	4767974	4768533	LTR/ERVL	2710	+	280	4768254	75470
chr9	4692784	4892784	harbor1	chr9	4768560	4768598	LTR/ERVL	623	+	19	4768579	75795
chr9	4692784	4892784	harbor1	chr9	4776096	4776156	LTR/ERVL	1756	+	30	4776126	83342
chr9	4692784	4892784	harbor1	chr9	4776449	4776750	LTR/ERVL	1756	+	150	4776599	83815
chr9	4662994	4862994	harbor1	chr9	4719472	4719754	LTR/ERVL	1402	+	141	4719613	56619
chr9	111383307	111583307	harbor1	chr9	111390869	111391288	LTR/ERVL	590	+	210	111391079	7772
chr9	111383307	111583307	harbor1	chr9	111455146	111455203	LTR/ERVL	2592	+	28	111455174	71867
chr9	111383307	111583307	harbor1	chr9	111455507	111455994	LTR/ERVL	2592	+	244	111455751	72444
chr9	111383307	111583307	harbor1	chr9	111458652	111459110	LTR/ERVL	952	+	229	111458881	75574
chr9	4692921	4892921	harbor1	chr9	4719472	4719754	LTR/ERVL	1402	+	141	4719613	26692
chr9	4692921	4892921	harbor1	chr9	4767974	4768533	LTR/ERVL	2710	+	280	4768254	75333
chr9	4692921	4892921	harbor1	chr9	4768560	4768598	LTR/ERVL	623	+	19	4768579	75658
chr9	4692921	4892921	harbor1	chr9	4776096	4776156	LTR/ERVL	1756	+	30	4776126	83205
chr9	4692921	4892921	harbor1	chr9	4776449	4776750	LTR/ERVL	1756	+	150	4776599	83678
chr9	133063669	133263669	harbor1	chr9	133156878	133157011	LTR/ERVL	611	+	66	133156944	93275
chr9	133063669	133263669	harbor1	chr9	133157311	133157462	LTR/ERVL	611	+	76	133157387	93718
chr9	112387266	112587266	harbor1	chr9	112474175	112474321	LTR/ERVL	2525	+	73	112474248	86982
chr9	112387266	112587266	harbor1	chr9	112474401	112474977	LTR/ERVL	2525	+	288	112474689	87423
chr9	112387266	112587266	harbor1	chr9	112483117	112483243	LTR/ERVL	1393	+	63	112483180	95914
chr9	112387266	112587266	harbor1	chr9	112483549	112483647	LTR/ERVL	1393	+	49	112483598	96332
chr9	112387266	112587266	harbor1	chr9	112483945	112484074	LTR/ERVL	1393	+	64	112484009	96743
chr9	2521362	2721362	harbor1	chr9	2569695	2570031	LTR/ERVL	1665	+	168	2569863	48501
chr9	2521362	2721362	harbor1	chr9	2580820	2581280	LTR/ERVL	2870	+	230	2581050	59688
chr9	4884820	5084820	harbor1	chr9	4971442	4971760	LTR/ERVL	1353	+	159	4971601	86781
chr9	4884820	5084820	harbor1	chr9	4972365	4972544	LTR/ERVL	1353	+	90	4972455	87635
chr9	4692190	4892190	harbor1	chr9	4719472	4719754	LTR/ERVL	1402	+	141	4719613	27423
chr9	4692190	4892190	harbor1	chr9	4767974	4768533	LTR/ERVL	2710	+	280	4768254	76064
chr9	4692190	4892190	harbor1	chr9	4768560	4768598	LTR/ERVL	623	+	19	4768579	76389
chr9	4692190	4892190	harbor1	chr9	4776096	4776156	LTR/ERVL	1756	+	30	4776126	83936
chr9	4692190	4892190	harbor1	chr9	4776449	4776750	LTR/ERVL	1756	+	150	4776599	84409
chr9	112387344	112587344	harbor1	chr9	112474175	112474321	LTR/ERVL	2525	+	73	112474248	86904
chr9	112387344	112587344	harbor1	chr9	112474401	112474977	LTR/ERVL	2525	+	288	112474689	87345
chr9	112387344	112587344	harbor1	chr9	112483117	112483243	LTR/ERVL	1393	+	63	112483180	95836
chr9	112387344	112587344	harbor1	chr9	112483549	112483647	LTR/ERVL	1393	+	49	112483598	96254
chr9	112387344	112587344	harbor1	chr9	112483945	112484074	LTR/ERVL	1393	+	64	112484009	96665
chr9	4658000	4858000	harbor1	chr9	4719472	4719754	LTR/ERVL	1402	+	141	4719613	61613
chr9	6658192	6858192	harbor1	chr9	6706759	6706836	LTR/ERVL	2171	+	38	6706797	48605
chr9	6658192	6858192	harbor1	chr9	6707124	6707147	LTR/ERVL	2171	+	12	6707136	48944
chr9	6658192	6858192	harbor1	chr9	6707454	6707771	LTR/ERVL	2171	+	158	6707612	49420
chr9	6658192	6858192	harbor1	chr9	6724130	6724498	LTR/ERVL	586	+	184	6724314	66122
chr9	6658192	6858192	harbor1	chr9	6728092	6728247	LTR/ERVL	796	+	78	6728170	69978
chr9	6658192	6858192	harbor1	chr9	6729561	6729827	LTR/ERVL	2146	+	133	6729694	71502
chr9	6658192	6858192	harbor1	chr9	6730130	6730282	LTR/ERVL	2146	+	76	6730206	72014
chr9	6658192	6858192	harbor1	chr9	6733191	6733601	LTR/ERVL	2911	+	205	6733396	75204
chr9	6658192	6858192	harbor1	chr9	6734151	6734287	LTR/ERVL	2911	+	68	6734219	76027
chr9	6658192	6858192	harbor1	chr9	6735169	6735390	LTR/ERVL	737	+	110	6735279	77087
chr9	6658192	6858192	harbor1	chr9	6700799	6701276	LTR/ERVL	1276	+	238	6701037	42845
chr9	4883030	5083030	harbor1	chr9	4971442	4971760	LTR/ERVL	1353	+	159	4971601	88571
chr9	4883030	5083030	harbor1	chr9	4972365	4972544	LTR/ERVL	1353	+	90	4972455	89425
chr9	1	129273	harbor1	chr9	57588	57794	LTR/ERVL	891	+	103	57691	57690
chr9	1	129273	harbor1	chr9	58216	58448	LTR/ERVL	1535	+	116	58332	58331
chr9	135905941	136105941	harbor1	chr9	135964526	135964734	LTR/ERVL	538	+	104	135964630	58689
chr9	135905941	136105941	harbor1	chr9	135976221	135976978	LTR/ERVL	2707	+	378	135976599	70658
chr9	4692910	4892910	harbor1	chr9	4719472	4719754	LTR/ERVL	1402	+	141	4719613	26703
chr9	4692910	4892910	harbor1	chr9	4767974	4768533	LTR/ERVL	2710	+	280	4768254	75344
chr9	4692910	4892910	harbor1	chr9	4768560	4768598	LTR/ERVL	623	+	19	4768579	75669
chr9	4692910	4892910	harbor1	chr9	4776096	4776156	LTR/ERVL	1756	+	30	4776126	83216
chr9	4692910	4892910	harbor1	chr9	4776449	4776750	LTR/ERVL	1756	+	150	4776599	83689
chr9	4663850	4863850	harbor1	chr9	4719472	4719754	LTR/ERVL	1402	+	141	4719613	55763
chr9	4669263	4869263	harbor1	chr9	4719472	4719754	LTR/ERVL	1402	+	141	4719613	50350
chr9	4669263	4869263	harbor1	chr9	4767974	4768533	LTR/ERVL	2710	+	280	4768254	98991
chr9	4669263	4869263	harbor1	chr9	4768560	4768598	LTR/ERVL	623	+	19	4768579	99316
chr9	4597199	4797199	harbor1	chr9	4625983	4626718	LTR/ERVL	1044	+	368	4626351	29152
chr9	133968504	134168504	harbor1	chr9	134005309	134005829	LTR/ERVL	803	+	260	134005569	37065
chr9	133968504	134168504	harbor1	chr9	134010148	134010798	LTR/ERVL	1139	+	325	134010473	41969
chr9	133968504	134168504	harbor1	chr9	134015217	134015458	LTR/ERVL	851	+	120	134015337	46833
chr9	127963377	128163377	harbor1	chr9	128040205	128040322	LTR/ERVL	860	+	58	128040263	76886
chr9	127963377	128163377	harbor1	chr9	128040609	128040625	LTR/ERVL	860	+	8	128040617	77240
chr9	127963377	128163377	harbor1	chr9	128041138	128041197	LTR/ERVL	860	+	30	128041168	77791
chr9	127963377	128163377	harbor1	chr9	128041197	128041713	LTR/ERVL	2930	+	258	128041455	78078
chr9	127963377	128163377	harbor1	chr9	128056204	128056491	LTR/ERVL	1184	+	144	128056348	92971
chr9	127963377	128163377	harbor1	chr9	128056987	128057287	LTR/ERVL	1072	+	150	128057137	93760
chr9	61551186	61751186	harbor1	chr9	61563921	61564444	LTR/ERVL	2107	+	262	61564183	12997
chr9	61551186	61751186	harbor1	chr9	61574373	61574460	LTR/ERVL	4197	+	44	61574417	23231
chr9	61551186	61751186	harbor1	chr9	61574762	61575496	LTR/ERVL	4197	+	367	61575129	23943
chr9	61551186	61751186	harbor1	chr9	61591623	61592142	LTR/ERVL	1938	+	260	61591883	40697
chr9	61551186	61751186	harbor1	chr9	61605612	61605959	LTR/ERVL	1240	+	174	61605786	54600
chr9	4692901	4892901	harbor1	chr9	4719472	4719754	LTR/ERVL	1402	+	141	4719613	26712
chr9	4692901	4892901	harbor1	chr9	4767974	4768533	LTR/ERVL	2710	+	280	4768254	75353
chr9	4692901	4892901	harbor1	chr9	4768560	4768598	LTR/ERVL	623	+	19	4768579	75678
chr9	4692901	4892901	harbor1	chr9	4776096	4776156	LTR/ERVL	1756	+	30	4776126	83225
chr9	4692901	4892901	harbor1	chr9	4776449	4776750	LTR/ERVL	1756	+	150	4776599	83698
chr9	113807755	114007755	harbor1	chr9	113822454	113822934	LTR/ERVL	2226	+	240	113822694	14939
chr9	113807755	114007755	harbor1	chr9	113854089	113854581	LTR/ERVL	1643	+	246	113854335	46580
chr9	133063664	133263664	harbor1	chr9	133156878	133157011	LTR/ERVL	611	+	66	133156944	93280
chr9	133063664	133263664	harbor1	chr9	133157311	133157462	LTR/ERVL	611	+	76	133157387	93723
chr9	97885101	98085101	harbor1	chr9	97965278	97965512	LTR/ERVL	769	+	117	97965395	80294
chr9	133934915	134134915	harbor1	chr9	134005309	134005829	LTR/ERVL	803	+	260	134005569	70654
chr9	133934915	134134915	harbor1	chr9	134010148	134010798	LTR/ERVL	1139	+	325	134010473	75558
chr9	133934915	134134915	harbor1	chr9	134015217	134015458	LTR/ERVL	851	+	120	134015337	80422
chr9	4692868	4892868	harbor1	chr9	4719472	4719754	LTR/ERVL	1402	+	141	4719613	26745
chr9	4692868	4892868	harbor1	chr9	4767974	4768533	LTR/ERVL	2710	+	280	4768254	75386
chr9	4692868	4892868	harbor1	chr9	4768560	4768598	LTR/ERVL	623	+	19	4768579	75711
chr9	4692868	4892868	harbor1	chr9	4776096	4776156	LTR/ERVL	1756	+	30	4776126	83258
chr9	4692868	4892868	harbor1	chr9	4776449	4776750	LTR/ERVL	1756	+	150	4776599	83731
chr9	4692205	4892205	harbor1	chr9	4719472	4719754	LTR/ERVL	1402	+	141	4719613	27408
chr9	4692205	4892205	harbor1	chr9	4767974	4768533	LTR/ERVL	2710	+	280	4768254	76049
chr9	4692205	4892205	harbor1	chr9	4768560	4768598	LTR/ERVL	623	+	19	4768579	76374
chr9	4692205	4892205	harbor1	chr9	4776096	4776156	LTR/ERVL	1756	+	30	4776126	83921
chr9	4692205	4892205	harbor1	chr9	4776449	4776750	LTR/ERVL	1756	+	150	4776599	84394
chr9	4884858	5084858	harbor1	chr9	4971442	4971760	LTR/ERVL	1353	+	159	4971601	86743
chr9	4884858	5084858	harbor1	chr9	4972365	4972544	LTR/ERVL	1353	+	90	4972455	87597
chr9	4692961	4892961	harbor1	chr9	4719472	4719754	LTR/ERVL	1402	+	141	4719613	26652
chr9	4692961	4892961	harbor1	chr9	4767974	4768533	LTR/ERVL	2710	+	280	4768254	75293
chr9	4692961	4892961	harbor1	chr9	4768560	4768598	LTR/ERVL	623	+	19	4768579	75618
chr9	4692961	4892961	harbor1	chr9	4776096	4776156	LTR/ERVL	1756	+	30	4776126	83165
chr9	4692961	4892961	harbor1	chr9	4776449	4776750	LTR/ERVL	1756	+	150	4776599	83638
chr9	4692661	4892661	harbor1	chr9	4719472	4719754	LTR/ERVL	1402	+	141	4719613	26952
chr9	4692661	4892661	harbor1	chr9	4767974	4768533	LTR/ERVL	2710	+	280	4768254	75593
chr9	4692661	4892661	harbor1	chr9	4768560	4768598	LTR/ERVL	623	+	19	4768579	75918
chr9	4692661	4892661	harbor1	chr9	4776096	4776156	LTR/ERVL	1756	+	30	4776126	83465
chr9	4692661	4892661	harbor1	chr9	4776449	4776750	LTR/ERVL	1756	+	150	4776599	83938
chr10	102140008	102340008	harbor1	chr10	102207252	102207551	LTR/ERVL	1170	+	150	102207402	67394
chr10	102140008	102340008	harbor1	chr10	102207863	102208054	LTR/ERVL	1170	+	96	102207959	67951
chr10	131310777	131510777	harbor1	chr10	131378281	131378594	LTR/ERVL	878	+	156	131378437	67660
chr10	131310777	131510777	harbor1	chr10	131400841	131401289	LTR/ERVL	1866	+	224	131401065	90288
chr10	78865729	79065729	harbor1	chr10	78874011	78874558	LTR/ERVL	2181	+	274	78874285	8556
chr10	78865729	79065729	harbor1	chr10	78877076	78877820	LTR/ERVL	1342	+	372	78877448	11719
chr10	78865729	79065729	harbor1	chr10	78945719	78946148	LTR/ERVL	1017	+	214	78945933	80204
chr10	97399009	97599009	harbor1	chr10	97416525	97416845	LTR/ERVL	734	+	160	97416685	17676
chr10	97399009	97599009	harbor1	chr10	97418119	97418131	LTR/ERVL	734	+	6	97418125	19116
chr10	560140	760140	harbor1	chr10	596946	597395	LTR/ERVL	667	+	224	597170	37030
chr10	97398813	97598813	harbor1	chr10	97416525	97416845	LTR/ERVL	734	+	160	97416685	17872
chr10	97398813	97598813	harbor1	chr10	97418119	97418131	LTR/ERVL	734	+	6	97418125	19312
chr10	49511878	49711878	harbor1	chr10	49560163	49560310	LTR/ERVL	530	+	74	49560237	48359
chr10	49511878	49711878	harbor1	chr10	49560513	49561085	LTR/ERVL	907	+	286	49560799	48921
chr10	49511878	49711878	harbor1	chr10	49561700	49561809	LTR/ERVL	540	+	54	49561754	49876
chr10	49511878	49711878	harbor1	chr10	49561823	49562031	LTR/ERVL	966	+	104	49561927	50049
chr10	49511878	49711878	harbor1	chr10	49587820	49588475	LTR/ERVL	4222	+	328	49588148	76270
chr10	102141807	102341807	harbor1	chr10	102207252	102207551	LTR/ERVL	1170	+	150	102207402	65595
chr10	102141807	102341807	harbor1	chr10	102207863	102208054	LTR/ERVL	1170	+	96	102207959	66152
chr10	14778677	14978677	harbor1	chr10	14833194	14833598	LTR/ERVL	1299	+	202	14833396	54719
chr10	7566933	7766933	harbor1	chr10	7651101	7651301	LTR/ERVL	1797	+	100	7651201	84268
chr10	7566933	7766933	harbor1	chr10	7651642	7651988	LTR/ERVL	1797	+	173	7651815	84882
chr10	7566933	7766933	harbor1	chr10	7654325	7654814	LTR/ERVL	1864	+	244	7654569	87636
chr10	37911041	38111041	harbor1	chr10	37994729	37994835	LTR/ERVL	562	+	53	37994782	83741
chr10	37911041	38111041	harbor1	chr10	38002471	38002782	LTR/ERVL	754	+	156	38002627	91586
chr10	37911041	38111041	harbor1	chr10	38007387	38007855	LTR/ERVL	1946	+	234	38007621	96580
chr10	37911041	38111041	harbor1	chr10	37944937	37945411	LTR/ERVL	1674	+	237	37945174	34133
chr10	69458832	69658832	harbor1	chr10	69468828	69469455	LTR/ERVL	1259	+	314	69469142	10310
chr10	69458832	69658832	harbor1	chr10	69469845	69470013	LTR/ERVL	636	+	84	69469929	11097
chr10	69458832	69658832	harbor1	chr10	69521020	69521223	LTR/ERVL	1460	+	102	69521122	62290
chr10	69458832	69658832	harbor1	chr10	69521628	69521940	LTR/ERVL	1672	+	156	69521784	62952
chr10	69458832	69658832	harbor1	chr10	69549158	69549593	LTR/ERVL	2026	+	218	69549376	90544
chr10	69458832	69658832	harbor1	chr10	69550797	69551207	LTR/ERVL	720	+	205	69551002	92170
chr10	69458832	69658832	harbor1	chr10	69533685	69534013	LTR/ERVL	1885	+	164	69533849	75017
chr10	13709746	13909746	harbor1	chr10	13727337	13727665	LTR/ERVL	946	+	164	13727501	17755
chr10	13709746	13909746	harbor1	chr10	13769270	13769317	LTR/ERVL	2087	+	24	13769294	59548
chr10	13709746	13909746	harbor1	chr10	13769610	13770069	LTR/ERVL	2087	+	230	13769840	60094
chr10	13709746	13909746	harbor1	chr10	13788086	13788571	LTR/ERVL	2006	+	242	13788328	78582
chr10	100086018	100286018	harbor1	chr10	100118590	100118763	LTR/ERVL	678	+	86	100118676	32658
chr10	100086018	100286018	harbor1	chr10	100134627	100135248	LTR/ERVL	1748	+	310	100134937	48919
chr10	100086018	100286018	harbor1	chr10	100175141	100175647	LTR/ERVL	2694	+	253	100175394	89376
chr10	97398947	97598947	harbor1	chr10	97416525	97416845	LTR/ERVL	734	+	160	97416685	17738
chr10	97398947	97598947	harbor1	chr10	97418119	97418131	LTR/ERVL	734	+	6	97418125	19178
chr10	14778710	14978710	harbor1	chr10	14833194	14833598	LTR/ERVL	1299	+	202	14833396	54686
chr10	113669309	113869309	harbor1	chr10	113742464	113742811	LTR/ERVL	1250	+	174	113742638	73329
chr10	113669309	113869309	harbor1	chr10	113744594	113744905	LTR/ERVL	760	+	156	113744750	75441
chr10	75111057	75311057	harbor1	chr10	75206219	75206389	LTR/ERVL	1753	+	85	75206304	95247
chr10	75111057	75311057	harbor1	chr10	75207534	75207864	LTR/ERVL	1753	+	165	75207699	96642
chr10	132232440	132432440	harbor1	chr10	132236606	132236781	LTR/ERVL	693	+	88	132236694	4254
chr10	14673058	14873058	harbor1	chr10	14676792	14677190	LTR/ERVL	1256	+	199	14676991	3933
chr10	14673058	14873058	harbor1	chr10	14680778	14680918	LTR/ERVL	624	+	70	14680848	7790
chr10	14673058	14873058	harbor1	chr10	14687897	14688439	LTR/ERVL	2141	+	271	14688168	15110
chr10	14673058	14873058	harbor1	chr10	14690147	14690444	LTR/ERVL	888	+	148	14690295	17237
chr10	14673058	14873058	harbor1	chr10	14690752	14690832	LTR/ERVL	888	+	40	14690792	17734
chr10	14673058	14873058	harbor1	chr10	14715480	14715979	LTR/ERVL	2476	+	250	14715730	42672
chr10	14673058	14873058	harbor1	chr10	14719527	14719973	LTR/ERVL	1469	+	223	14719750	46692
chr10	14673058	14873058	harbor1	chr10	14727372	14727750	LTR/ERVL	1322	+	189	14727561	54503
chr10	14673058	14873058	harbor1	chr10	14756287	14756520	LTR/ERVL	1330	+	116	14756403	83345
chr10	14673058	14873058	harbor1	chr10	14757332	14757508	LTR/ERVL	547	+	88	14757420	84362
chr10	14673058	14873058	harbor1	chr10	14762297	14762514	LTR/ERVL	1338	+	108	14762405	89347
chr10	14673058	14873058	harbor1	chr10	14762810	14762980	LTR/ERVL	1338	+	85	14762895	89837
chr10	14673058	14873058	harbor1	chr10	14763271	14763531	LTR/ERVL	1338	+	130	14763401	90343
chr10	14673058	14873058	harbor1	chr10	14679652	14680102	LTR/ERVL	3583	+	225	14679877	6819
chr10	14778691	14978691	harbor1	chr10	14833194	14833598	LTR/ERVL	1299	+	202	14833396	54705
chr10	102140695	102340695	harbor1	chr10	102207252	102207551	LTR/ERVL	1170	+	150	102207402	66707
chr10	102140695	102340695	harbor1	chr10	102207863	102208054	LTR/ERVL	1170	+	96	102207959	67264
chr10	102141695	102341695	harbor1	chr10	102207252	102207551	LTR/ERVL	1170	+	150	102207402	65707
chr10	102141695	102341695	harbor1	chr10	102207863	102208054	LTR/ERVL	1170	+	96	102207959	66264
chr10	100611262	100811262	harbor1	chr10	100630717	100631102	LTR/ERVL	968	+	192	100630909	19647
chr10	6020235	6220235	harbor1	chr10	6079305	6079454	LTR/ERVL	455	+	74	6079379	59144
chr10	6020235	6220235	harbor1	chr10	6079929	6080133	LTR/ERVL	535	+	102	6080031	59796
chr10	6020235	6220235	harbor1	chr10	6080817	6081014	LTR/ERVL	1144	+	98	6080915	60680
chr10	6020235	6220235	harbor1	chr10	6081322	6081474	LTR/ERVL	1144	+	76	6081398	61163
chr10	102141682	102341682	harbor1	chr10	102207252	102207551	LTR/ERVL	1170	+	150	102207402	65720
chr10	102141682	102341682	harbor1	chr10	102207863	102208054	LTR/ERVL	1170	+	96	102207959	66277
chr10	114721980	114921980	harbor1	chr10	114793563	114793955	LTR/ERVL	1659	+	196	114793759	71779
chr10	114721980	114921980	harbor1	chr10	114801597	114801744	LTR/ERVL	472	+	74	114801671	79691
chr10	114721980	114921980	harbor1	chr10	114801841	114801983	LTR/ERVL	435	+	71	114801912	79932
chr10	114721980	114921980	harbor1	chr10	114802955	114802977	LTR/ERVL	8896	+	11	114802966	80986
chr10	114721980	114921980	harbor1	chr10	114803269	114803588	LTR/ERVL	8896	+	160	114803429	81449
chr10	114721980	114921980	harbor1	chr10	114804031	114805893	LTR/ERVL	8896	+	931	114804962	82982
chr10	114721980	114921980	harbor1	chr10	114806175	114807340	LTR/ERVL	8896	+	582	114806757	84777
chr10	114721980	114921980	harbor1	chr10	114809794	114810025	LTR/ERVL	718	+	116	114809910	87930
chr10	114721980	114921980	harbor1	chr10	114810729	114810880	LTR/ERVL	718	+	76	114810805	88825
chr10	62704867	62904867	harbor1	chr10	62725059	62725606	LTR/ERVL	788	+	274	62725333	20466
chr10	132984294	133184294	harbor1	chr10	133026723	133026871	LTR/ERVL	658	+	74	133026797	42503
chr10	132984294	133184294	harbor1	chr10	133026932	133027103	LTR/ERVL	501	+	86	133027018	42724
chr10	132984294	133184294	harbor1	chr10	133027429	133027609	LTR/ERVL	435	+	90	133027519	43225
chr10	132207804	132407804	harbor1	chr10	132236606	132236781	LTR/ERVL	693	+	88	132236694	28890
chr10	78346452	78546452	harbor1	chr10	78373150	78373315	LTR/ERVL	631	+	82	78373232	26780
chr10	78346452	78546452	harbor1	chr10	78388623	78388786	LTR/ERVL	549	+	82	78388705	42253
chr10	78346452	78546452	harbor1	chr10	78427358	78428348	LTR/ERVL	3228	+	495	78427853	81401
chr10	2967276	3167276	harbor1	chr10	3018602	3018902	LTR/ERVL	1029	+	150	3018752	51476
chr10	2967276	3167276	harbor1	chr10	3019154	3019307	LTR/ERVL	2037	+	76	3019230	51954
chr10	2967276	3167276	harbor1	chr10	3019587	3019871	LTR/ERVL	2037	+	142	3019729	52453
chr10	2967276	3167276	harbor1	chr10	3019943	3020366	LTR/ERVL	512	+	212	3020155	52879
chr10	2967276	3167276	harbor1	chr10	3020658	3020902	LTR/ERVL	459	+	122	3020780	53504
chr10	132232445	132432445	harbor1	chr10	132236606	132236781	LTR/ERVL	693	+	88	132236694	4249
chr10	14778054	14978054	harbor1	chr10	14833194	14833598	LTR/ERVL	1299	+	202	14833396	55342
chr10	89151734	89351734	harbor1	chr10	89192167	89192414	LTR/ERVL	1906	+	124	89192291	40557
chr10	131255629	131455629	harbor1	chr10	131264466	131265005	LTR/ERVL	1905	+	270	131264736	9107
chr10	14778029	14978029	harbor1	chr10	14833194	14833598	LTR/ERVL	1299	+	202	14833396	55367
chr10	97398990	97598990	harbor1	chr10	97416525	97416845	LTR/ERVL	734	+	160	97416685	17695
chr10	97398990	97598990	harbor1	chr10	97418119	97418131	LTR/ERVL	734	+	6	97418125	19135
chr10	97398875	97598875	harbor1	chr10	97416525	97416845	LTR/ERVL	734	+	160	97416685	17810
chr10	97398875	97598875	harbor1	chr10	97418119	97418131	LTR/ERVL	734	+	6	97418125	19250
chr10	22337593	22537593	harbor1	chr10	22422045	22422318	LTR/ERVL	891	+	136	22422181	84588
chr10	22337593	22537593	harbor1	chr10	22422513	22423020	LTR/ERVL	1081	+	254	22422767	85174
chr10	22337593	22537593	harbor1	chr10	22423056	22423267	LTR/ERVL	1365	+	106	22423162	85569
chr10	22337593	22537593	harbor1	chr10	22423572	22424185	LTR/ERVL	1490	+	306	22423878	86285
chr10	22337593	22537593	harbor1	chr10	22424157	22425533	LTR/ERVL	1914	+	688	22424845	87252
chr10	132232398	132432398	harbor1	chr10	132236606	132236781	LTR/ERVL	693	+	88	132236694	4296
chr10	89151741	89351741	harbor1	chr10	89192167	89192414	LTR/ERVL	1906	+	124	89192291	40550
chr10	95979828	96179828	harbor1	chr10	96002070	96002363	LTR/ERVL	553	+	146	96002216	22388
chr10	95979828	96179828	harbor1	chr10	96010291	96010402	LTR/ERVL	526	+	56	96010347	30519
chr10	95979828	96179828	harbor1	chr10	96077721	96077929	LTR/ERVL	647	+	104	96077825	97997
chr10	46006427	46206427	harbor1	chr10	46104397	46104672	LTR/ERVL	550	+	138	46104535	98108
chr10	43474486	43674486	harbor1	chr10	43506142	43506231	LTR/ERVL	1856	+	44	43506186	31700
chr10	43474486	43674486	harbor1	chr10	43506532	43506867	LTR/ERVL	1856	+	168	43506700	32214
chr10	43474486	43674486	harbor1	chr10	43507837	43508293	LTR/ERVL	1975	+	228	43508065	33579
chr10	43474486	43674486	harbor1	chr10	43508301	43508526	LTR/ERVL	1994	+	112	43508413	33927
chr10	43474486	43674486	harbor1	chr10	43508868	43508924	LTR/ERVL	1994	+	28	43508896	34410
chr10	43474486	43674486	harbor1	chr10	43509210	43509420	LTR/ERVL	1994	+	105	43509315	34829
chr10	43474486	43674486	harbor1	chr10	43516880	43518522	LTR/ERVL	8892	+	821	43517701	43215
chr10	131310773	131510773	harbor1	chr10	131378281	131378594	LTR/ERVL	878	+	156	131378437	67664
chr10	131310773	131510773	harbor1	chr10	131400841	131401289	LTR/ERVL	1866	+	224	131401065	90292
chr10	75302350	75502350	harbor1	chr10	75366632	75367021	LTR/ERVL	1328	+	194	75366826	64476
chr10	75302350	75502350	harbor1	chr10	75373092	75373456	LTR/ERVL	870	+	182	75373274	70924
chr10	86532110	86732110	harbor1	chr10	86546897	86546971	LTR/ERVL	986	+	37	86546934	14824
chr10	86532110	86732110	harbor1	chr10	86547284	86547576	LTR/ERVL	986	+	146	86547430	15320
chr10	86532110	86732110	harbor1	chr10	86547863	86547907	LTR/ERVL	924	+	22	86547885	15775
chr10	86532110	86732110	harbor1	chr10	86603676	86603742	LTR/ERVL	558	+	33	86603709	71599
chr10	86532110	86732110	harbor1	chr10	86604034	86604222	LTR/ERVL	558	+	94	86604128	72018
chr10	22219191	22419191	harbor1	chr10	22219007	22219296	LTR/ERVL	523	+	144	22219151	40
chr10	22219191	22419191	harbor1	chr10	22219374	22220274	LTR/ERVL	1403	+	450	22219824	633
chr10	22219191	22419191	harbor1	chr10	22220529	22220897	LTR/ERVL	1403	+	184	22220713	1522
chr10	22219191	22419191	harbor1	chr10	22223685	22224014	LTR/ERVL	1048	+	164	22223849	4658
chr10	22219191	22419191	harbor1	chr10	22266185	22266291	LTR/ERVL	466	+	53	22266238	47047
chr10	22219191	22419191	harbor1	chr10	22296514	22296851	LTR/ERVL	1221	+	168	22296682	77491
chr10	22219191	22419191	harbor1	chr10	22297151	22297364	LTR/ERVL	1221	+	106	22297257	78066
chr10	46184879	46384879	harbor1	chr10	46206935	46207209	LTR/ERVL	1533	+	137	46207072	22193
chr10	46184879	46384879	harbor1	chr10	46222719	46222949	LTR/ERVL	1070	+	115	46222834	37955
chr10	46184879	46384879	harbor1	chr10	46280885	46281162	LTR/ERVL	444	+	138	46281023	96144
chr10	132232418	132432418	harbor1	chr10	132236606	132236781	LTR/ERVL	693	+	88	132236694	4276
chr10	47239932	47439932	harbor1	chr10	47260935	47261519	LTR/ERVL	3035	+	292	47261227	21295
chr10	47239932	47439932	harbor1	chr10	47271574	47272078	LTR/ERVL	2811	+	252	47271826	31894
chr10	47239932	47439932	harbor1	chr10	47334608	47334936	LTR/ERVL	548	+	164	47334772	94840
chr10	47239932	47439932	harbor1	chr10	47337297	47337712	LTR/ERVL	1934	+	208	47337505	97573
chr10	4842408	5042408	harbor1	chr10	4859745	4860120	LTR/ERVL	495	+	188	4859933	17525
chr10	47239964	47439964	harbor1	chr10	47260935	47261519	LTR/ERVL	3035	+	292	47261227	21263
chr10	47239964	47439964	harbor1	chr10	47271574	47272078	LTR/ERVL	2811	+	252	47271826	31862
chr10	47239964	47439964	harbor1	chr10	47334608	47334936	LTR/ERVL	548	+	164	47334772	94808
chr10	47239964	47439964	harbor1	chr10	47337297	47337712	LTR/ERVL	1934	+	208	47337505	97541
chr10	75111030	75311030	harbor1	chr10	75206219	75206389	LTR/ERVL	1753	+	85	75206304	95274
chr10	75111030	75311030	harbor1	chr10	75207534	75207864	LTR/ERVL	1753	+	165	75207699	96669
chr10	131309416	131509416	harbor1	chr10	131378281	131378594	LTR/ERVL	878	+	156	131378437	69021
chr10	131309416	131509416	harbor1	chr10	131400841	131401289	LTR/ERVL	1866	+	224	131401065	91649
chr10	78865014	79065014	harbor1	chr10	78874011	78874558	LTR/ERVL	2181	+	274	78874285	9271
chr10	78865014	79065014	harbor1	chr10	78877076	78877820	LTR/ERVL	1342	+	372	78877448	12434
chr10	78865014	79065014	harbor1	chr10	78945719	78946148	LTR/ERVL	1017	+	214	78945933	80919
chr10	14778674	14978674	harbor1	chr10	14833194	14833598	LTR/ERVL	1299	+	202	14833396	54722
chr10	77303746	77503746	harbor1	chr10	77375652	77376015	LTR/ERVL	703	+	182	77375834	72088
chr10	132232385	132432385	harbor1	chr10	132236606	132236781	LTR/ERVL	693	+	88	132236694	4309
chr10	75111036	75311036	harbor1	chr10	75206219	75206389	LTR/ERVL	1753	+	85	75206304	95268
chr10	75111036	75311036	harbor1	chr10	75207534	75207864	LTR/ERVL	1753	+	165	75207699	96663
chr10	62704945	62904945	harbor1	chr10	62725059	62725606	LTR/ERVL	788	+	274	62725333	20388
chr10	132977795	133177795	harbor1	chr10	133026723	133026871	LTR/ERVL	658	+	74	133026797	49002
chr10	132977795	133177795	harbor1	chr10	133026932	133027103	LTR/ERVL	501	+	86	133027018	49223
chr10	132977795	133177795	harbor1	chr10	133027429	133027609	LTR/ERVL	435	+	90	133027519	49724
chr10	97672149	97872149	harbor1	chr10	97695971	97696448	LTR/ERVL	2828	+	238	97696209	24060
chr10	97672149	97872149	harbor1	chr10	97696759	97696829	LTR/ERVL	2828	+	35	97696794	24645
chr10	97672149	97872149	harbor1	chr10	97697148	97697358	LTR/ERVL	2828	+	105	97697253	25104
chr10	97672149	97872149	harbor1	chr10	97698904	97699051	LTR/ERVL	765	+	74	97698978	26829
chr10	97672149	97872149	harbor1	chr10	97699352	97699483	LTR/ERVL	765	+	66	97699418	27269
chr10	97672149	97872149	harbor1	chr10	97701473	97701683	LTR/ERVL	863	+	105	97701578	29429
chr10	97672149	97872149	harbor1	chr10	97701955	97702438	LTR/ERVL	1884	+	242	97702197	30048
chr10	97672149	97872149	harbor1	chr10	97705447	97705640	LTR/ERVL	1183	+	96	97705543	33394
chr10	14778680	14978680	harbor1	chr10	14833194	14833598	LTR/ERVL	1299	+	202	14833396	54716
chr10	35265	235265	harbor1	chr10	68041	68146	LTR/ERVL	691	+	52	68093	32828
chr10	102141613	102341613	harbor1	chr10	102207252	102207551	LTR/ERVL	1170	+	150	102207402	65789
chr10	102141613	102341613	harbor1	chr10	102207863	102208054	LTR/ERVL	1170	+	96	102207959	66346
chr10	132207902	132407902	harbor1	chr10	132236606	132236781	LTR/ERVL	693	+	88	132236694	28792
chr10	79279347	79479347	harbor1	chr10	79319465	79319902	LTR/ERVL	996	+	218	79319683	40336
chr10	79279347	79479347	harbor1	chr10	79320020	79320454	LTR/ERVL	595	+	217	79320237	40890
chr10	79279347	79479347	harbor1	chr10	79320462	79321531	LTR/ERVL	3234	+	534	79320996	41649
chr10	79279347	79479347	harbor1	chr10	79321633	79322018	LTR/ERVL	970	+	192	79321825	42478
chr10	79279347	79479347	harbor1	chr10	79336763	79337052	LTR/ERVL	876	+	144	79336907	57560
chr10	79279347	79479347	harbor1	chr10	79341954	79342297	LTR/ERVL	869	+	172	79342126	62779
chr10	79279347	79479347	harbor1	chr10	79358580	79358604	LTR/ERVL	2420	+	12	79358592	79245
chr10	79279347	79479347	harbor1	chr10	79358898	79359361	LTR/ERVL	2420	+	232	79359130	79783
chr10	110707741	110907741	harbor1	chr10	110745258	110745454	LTR/ERVL	514	+	98	110745356	37615
chr10	110707741	110907741	harbor1	chr10	110779038	110779798	LTR/ERVL	3995	+	380	110779418	71677
chr10	89202972	89402972	harbor1	chr10	89270016	89271779	LTR/ERVL	6419	+	882	89270898	67926
chr10	89202972	89402972	harbor1	chr10	89274256	89274702	LTR/ERVL	831	+	223	89274479	71507
chr10	89202972	89402972	harbor1	chr10	89275040	89275666	LTR/ERVL	2523	+	313	89275353	72381
chr10	46006339	46206339	harbor1	chr10	46104397	46104672	LTR/ERVL	550	+	138	46104535	98196
chr10	47239866	47439866	harbor1	chr10	47260935	47261519	LTR/ERVL	3035	+	292	47261227	21361
chr10	47239866	47439866	harbor1	chr10	47271574	47272078	LTR/ERVL	2811	+	252	47271826	31960
chr10	47239866	47439866	harbor1	chr10	47334608	47334936	LTR/ERVL	548	+	164	47334772	94906
chr10	47239866	47439866	harbor1	chr10	47337297	47337712	LTR/ERVL	1934	+	208	47337505	97639
chr10	62704875	62904875	harbor1	chr10	62725059	62725606	LTR/ERVL	788	+	274	62725333	20458
chr10	47239913	47439913	harbor1	chr10	47260935	47261519	LTR/ERVL	3035	+	292	47261227	21314
chr10	47239913	47439913	harbor1	chr10	47271574	47272078	LTR/ERVL	2811	+	252	47271826	31913
chr10	47239913	47439913	harbor1	chr10	47334608	47334936	LTR/ERVL	548	+	164	47334772	94859
chr10	47239913	47439913	harbor1	chr10	47337297	47337712	LTR/ERVL	1934	+	208	47337505	97592
chr10	69472286	69672286	harbor1	chr10	69521020	69521223	LTR/ERVL	1460	+	102	69521122	48836
chr10	69472286	69672286	harbor1	chr10	69521628	69521940	LTR/ERVL	1672	+	156	69521784	49498
chr10	69472286	69672286	harbor1	chr10	69549158	69549593	LTR/ERVL	2026	+	218	69549376	77090
chr10	69472286	69672286	harbor1	chr10	69550797	69551207	LTR/ERVL	720	+	205	69551002	78716
chr10	69472286	69672286	harbor1	chr10	69533685	69534013	LTR/ERVL	1885	+	164	69533849	61563
chr11	112678749	112878749	harbor1	chr11	112726552	112726741	LTR/ERVL	509	+	94	112726646	47897
chr11	112678749	112878749	harbor1	chr11	112726761	112726892	LTR/ERVL	456	+	66	112726827	48078
chr11	112678749	112878749	harbor1	chr11	112742442	112742987	LTR/ERVL	819	+	272	112742714	63965
chr11	5127157	5327157	harbor1	chr11	5147269	5147661	LTR/ERVL	1627	+	196	5147465	20308
chr11	5127156	5327156	harbor1	chr11	5147269	5147661	LTR/ERVL	1627	+	196	5147465	20309
chr11	5129450	5329450	harbor1	chr11	5147269	5147661	LTR/ERVL	1627	+	196	5147465	18015
chr11	5127277	5327277	harbor1	chr11	5147269	5147661	LTR/ERVL	1627	+	196	5147465	20188
chr11	5127135	5327135	harbor1	chr11	5147269	5147661	LTR/ERVL	1627	+	196	5147465	20330
chr11	5127181	5327181	harbor1	chr11	5147269	5147661	LTR/ERVL	1627	+	196	5147465	20284
chr11	5127341	5327341	harbor1	chr11	5147269	5147661	LTR/ERVL	1627	+	196	5147465	20124
chr11	5127230	5327230	harbor1	chr11	5147269	5147661	LTR/ERVL	1627	+	196	5147465	20235
chr11	5134663	5334663	harbor1	chr11	5147269	5147661	LTR/ERVL	1627	+	196	5147465	12802
chr11	5126804	5326804	harbor1	chr11	5147269	5147661	LTR/ERVL	1627	+	196	5147465	20661
chr11	5127222	5327222	harbor1	chr11	5147269	5147661	LTR/ERVL	1627	+	196	5147465	20243
chr11	5127226	5327226	harbor1	chr11	5147269	5147661	LTR/ERVL	1627	+	196	5147465	20239
chr11	89682097	89882097	harbor1	chr11	89750923	89751351	LTR/ERVL	1039	+	214	89751137	69040
chr11	5127150	5327150	harbor1	chr11	5147269	5147661	LTR/ERVL	1627	+	196	5147465	20315
chr11	5127250	5327250	harbor1	chr11	5147269	5147661	LTR/ERVL	1627	+	196	5147465	20215
chr11	5126803	5326803	harbor1	chr11	5147269	5147661	LTR/ERVL	1627	+	196	5147465	20662
chr11	5134612	5334612	harbor1	chr11	5147269	5147661	LTR/ERVL	1627	+	196	5147465	12853
chr11	5134133	5334133	harbor1	chr11	5147269	5147661	LTR/ERVL	1627	+	196	5147465	13332
chr11	113773314	113973314	harbor1	chr11	113847830	113849952	LTR/ERVL	8539	+	1061	113848891	75577
chr11	5125277	5325277	harbor1	chr11	5147269	5147661	LTR/ERVL	1627	+	196	5147465	22188
chr11	108021540	108221540	harbor1	chr11	108041018	108041268	LTR/ERVL	805	+	125	108041143	19603
chr11	5125978	5325978	harbor1	chr11	5147269	5147661	LTR/ERVL	1627	+	196	5147465	21487
chr11	5127141	5327141	harbor1	chr11	5147269	5147661	LTR/ERVL	1627	+	196	5147465	20324
chr11	5127172	5327172	harbor1	chr11	5147269	5147661	LTR/ERVL	1627	+	196	5147465	20293
chr11	5134086	5334086	harbor1	chr11	5147269	5147661	LTR/ERVL	1627	+	196	5147465	13379
chr11	5127261	5327261	harbor1	chr11	5147269	5147661	LTR/ERVL	1627	+	196	5147465	20204
chr11	5134533	5334533	harbor1	chr11	5147269	5147661	LTR/ERVL	1627	+	196	5147465	12932
chr11	5126745	5326745	harbor1	chr11	5147269	5147661	LTR/ERVL	1627	+	196	5147465	20720
chr11	46185687	46385687	harbor1	chr11	46251557	46252009	LTR/ERVL	763	+	226	46251783	66096
chr11	5134641	5334641	harbor1	chr11	5147269	5147661	LTR/ERVL	1627	+	196	5147465	12824
chr11	108004348	108204348	harbor1	chr11	108041018	108041268	LTR/ERVL	805	+	125	108041143	36795
chr11	5127278	5327278	harbor1	chr11	5147269	5147661	LTR/ERVL	1627	+	196	5147465	20187
chr11	5134115	5334115	harbor1	chr11	5147269	5147661	LTR/ERVL	1627	+	196	5147465	13350
chr11	5134546	5334546	harbor1	chr11	5147269	5147661	LTR/ERVL	1627	+	196	5147465	12919
chr11	5124980	5324980	harbor1	chr11	5147269	5147661	LTR/ERVL	1627	+	196	5147465	22485
chr11	5127317	5327317	harbor1	chr11	5147269	5147661	LTR/ERVL	1627	+	196	5147465	20148
chr11	5127257	5327257	harbor1	chr11	5147269	5147661	LTR/ERVL	1627	+	196	5147465	20208
chr11	86559546	86759546	harbor1	chr11	86623017	86623521	LTR/ERVL	2924	+	252	86623269	63723
chr11	86559546	86759546	harbor1	chr11	86626106	86626617	LTR/ERVL	1228	+	256	86626362	66816
chr11	86559546	86759546	harbor1	chr11	86626806	86626940	LTR/ERVL	1005	+	67	86626873	67327
chr11	5100509	5300509	harbor1	chr11	5147269	5147661	LTR/ERVL	1627	+	196	5147465	46956
chr11	5127273	5327273	harbor1	chr11	5147269	5147661	LTR/ERVL	1627	+	196	5147465	20192
chr11	91718101	91918101	harbor1	chr11	91726558	91726793	LTR/ERVL	405	+	118	91726676	8575
chr11	91718101	91918101	harbor1	chr11	91740635	91740919	LTR/ERVL	1628	+	142	91740777	22676
chr11	91718101	91918101	harbor1	chr11	91814747	91815114	LTR/ERVL	1592	+	184	91814931	96830
chr11	91718101	91918101	harbor1	chr11	91815407	91815540	LTR/ERVL	1565	+	66	91815473	97372
chr11	4695187	4895187	harbor1	chr11	4728283	4728645	LTR/ERVL	977	+	181	4728464	33277
chr11	4695187	4895187	harbor1	chr11	4730431	4730735	LTR/ERVL	512	+	152	4730583	35396
chr11	4695187	4895187	harbor1	chr11	4730782	4730917	LTR/ERVL	427	+	68	4730850	35663
chr11	4695187	4895187	harbor1	chr11	4731328	4731780	LTR/ERVL	421	+	226	4731554	36367
chr11	4695187	4895187	harbor1	chr11	4742448	4742600	LTR/ERVL	941	+	76	4742524	47337
chr11	4695187	4895187	harbor1	chr11	4765177	4765419	LTR/ERVL	892	+	121	4765298	70111
chr11	5134560	5334560	harbor1	chr11	5147269	5147661	LTR/ERVL	1627	+	196	5147465	12905
chr11	108021573	108221573	harbor1	chr11	108041018	108041268	LTR/ERVL	805	+	125	108041143	19570
chr11	76580974	76780974	harbor1	chr11	76644567	76645358	LTR/ERVL	3866	+	396	76644963	63989
chr11	5127126	5327126	harbor1	chr11	5147269	5147661	LTR/ERVL	1627	+	196	5147465	20339
chr11	65758060	65958060	harbor1	chr11	65764462	65765178	LTR/ERVL	3272	+	358	65764820	6760
chr11	65758060	65958060	harbor1	chr11	65771400	65771659	LTR/ERVL	741	+	130	65771530	13470
chr11	65758060	65958060	harbor1	chr11	65775372	65775785	LTR/ERVL	487	+	206	65775578	17518
chr11	5125006	5325006	harbor1	chr11	5147269	5147661	LTR/ERVL	1627	+	196	5147465	22459
chr11	5134608	5334608	harbor1	chr11	5147269	5147661	LTR/ERVL	1627	+	196	5147465	12857
chr11	5126778	5326778	harbor1	chr11	5147269	5147661	LTR/ERVL	1627	+	196	5147465	20687
chr11	5134653	5334653	harbor1	chr11	5147269	5147661	LTR/ERVL	1627	+	196	5147465	12812
chr11	5134111	5334111	harbor1	chr11	5147269	5147661	LTR/ERVL	1627	+	196	5147465	13354
chr11	5127183	5327183	harbor1	chr11	5147269	5147661	LTR/ERVL	1627	+	196	5147465	20282
chr11	5127132	5327132	harbor1	chr11	5147269	5147661	LTR/ERVL	1627	+	196	5147465	20333
chr11	10401686	10601686	harbor1	chr11	10440433	10440633	LTR/ERVL	524	+	100	10440533	38847
chr11	5126760	5326760	harbor1	chr11	5147269	5147661	LTR/ERVL	1627	+	196	5147465	20705
chr11	34816228	35016228	harbor1	chr11	34846637	34847034	LTR/ERVL	1466	+	198	34846835	30607
chr11	34816228	35016228	harbor1	chr11	34847037	34848671	LTR/ERVL	4468	+	817	34847854	31626
chr11	34816228	35016228	harbor1	chr11	34849041	34850231	LTR/ERVL	4468	+	595	34849636	33408
chr11	34816228	35016228	harbor1	chr11	34850237	34850312	LTR/ERVL	413	+	38	34850275	34047
chr11	34816228	35016228	harbor1	chr11	34872114	34872941	LTR/ERVL	4469	+	414	34872528	56300
chr11	34816228	35016228	harbor1	chr11	34912452	34912884	LTR/ERVL	3276	+	216	34912668	96440
chr11	5127108	5327108	harbor1	chr11	5147269	5147661	LTR/ERVL	1627	+	196	5147465	20357
chr11	5127203	5327203	harbor1	chr11	5147269	5147661	LTR/ERVL	1627	+	196	5147465	20262
chr11	5127281	5327281	harbor1	chr11	5147269	5147661	LTR/ERVL	1627	+	196	5147465	20184
chr11	5134553	5334553	harbor1	chr11	5147269	5147661	LTR/ERVL	1627	+	196	5147465	12912
chr11	86572150	86772150	harbor1	chr11	86623017	86623521	LTR/ERVL	2924	+	252	86623269	51119
chr11	86572150	86772150	harbor1	chr11	86626106	86626617	LTR/ERVL	1228	+	256	86626362	54212
chr11	86572150	86772150	harbor1	chr11	86626806	86626940	LTR/ERVL	1005	+	67	86626873	54723
chr11	5134570	5334570	harbor1	chr11	5147269	5147661	LTR/ERVL	1627	+	196	5147465	12895
chr11	76580440	76780440	harbor1	chr11	76644567	76645358	LTR/ERVL	3866	+	396	76644963	64523
chr11	5126802	5326802	harbor1	chr11	5147269	5147661	LTR/ERVL	1627	+	196	5147465	20663
chr11	106768224	106968224	harbor1	chr11	106807595	106808146	LTR/ERVL	2064	+	276	106807871	39647
chr11	106768224	106968224	harbor1	chr11	106829530	106829584	LTR/ERVL	407	+	27	106829557	61333
chr11	106768224	106968224	harbor1	chr11	106829592	106830355	LTR/ERVL	5541	+	382	106829974	61750
chr11	106768224	106968224	harbor1	chr11	106830356	106830803	LTR/ERVL	3435	+	224	106830580	62356
chr11	106768224	106968224	harbor1	chr11	106841904	106842373	LTR/ERVL	1535	+	234	106842138	73914
chr11	133733693	133933693	harbor1	chr11	133736526	133736978	LTR/ERVL	1637	+	226	133736752	3059
chr11	133733693	133933693	harbor1	chr11	133779805	133780133	LTR/ERVL	552	+	164	133779969	46276
chr11	133733693	133933693	harbor1	chr11	133802102	133802203	LTR/ERVL	426	+	50	133802152	68459
chr11	5125241	5325241	harbor1	chr11	5147269	5147661	LTR/ERVL	1627	+	196	5147465	22224
chr11	5134190	5334190	harbor1	chr11	5147269	5147661	LTR/ERVL	1627	+	196	5147465	13275
chr11	5125737	5325737	harbor1	chr11	5147269	5147661	LTR/ERVL	1627	+	196	5147465	21728
chr11	5127241	5327241	harbor1	chr11	5147269	5147661	LTR/ERVL	1627	+	196	5147465	20224
chr11	5126766	5326766	harbor1	chr11	5147269	5147661	LTR/ERVL	1627	+	196	5147465	20699
chr11	5134609	5334609	harbor1	chr11	5147269	5147661	LTR/ERVL	1627	+	196	5147465	12856
chr11	5134091	5334091	harbor1	chr11	5147269	5147661	LTR/ERVL	1627	+	196	5147465	13374
chr11	5127300	5327300	harbor1	chr11	5147269	5147661	LTR/ERVL	1627	+	196	5147465	20165
chr11	5127229	5327229	harbor1	chr11	5147269	5147661	LTR/ERVL	1627	+	196	5147465	20236
chr11	107465643	107665643	harbor1	chr11	107483387	107483789	LTR/ERVL	1318	+	201	107483588	17945
chr11	107465643	107665643	harbor1	chr11	107484436	107484522	LTR/ERVL	1318	+	43	107484479	18836
chr11	107465643	107665643	harbor1	chr11	107501828	107502440	LTR/ERVL	2178	+	306	107502134	36491
chr11	107465643	107665643	harbor1	chr11	107547971	107548480	LTR/ERVL	924	+	254	107548225	82582
chr11	108021539	108221539	harbor1	chr11	108041018	108041268	LTR/ERVL	805	+	125	108041143	19604
chr11	5126785	5326785	harbor1	chr11	5147269	5147661	LTR/ERVL	1627	+	196	5147465	20680
chr11	5127144	5327144	harbor1	chr11	5147269	5147661	LTR/ERVL	1627	+	196	5147465	20321
chr11	5127200	5327200	harbor1	chr11	5147269	5147661	LTR/ERVL	1627	+	196	5147465	20265
chr11	117886632	118086632	harbor1	chr11	117984458	117984780	LTR/ERVL	1593	+	161	117984619	97987
chr11	5103484	5303484	harbor1	chr11	5147269	5147661	LTR/ERVL	1627	+	196	5147465	43981
chr11	69539230	69739230	harbor1	chr11	69601712	69602120	LTR/ERVL	480	+	204	69601916	62686
chr11	5127304	5327304	harbor1	chr11	5147269	5147661	LTR/ERVL	1627	+	196	5147465	20161
chr11	6512326	6712326	harbor1	chr11	6515483	6515723	LTR/ERVL	588	+	120	6515603	3277
chr11	6512326	6712326	harbor1	chr11	6527915	6528042	LTR/ERVL	434	+	64	6527979	15653
chr11	6512326	6712326	harbor1	chr11	6554997	6555199	LTR/ERVL	1918	+	101	6555098	42772
chr11	6512326	6712326	harbor1	chr11	6555247	6555401	LTR/ERVL	1918	+	77	6555324	42998
chr11	6512326	6712326	harbor1	chr11	6555402	6555596	LTR/ERVL	1448	+	97	6555499	43173
chr11	6512326	6712326	harbor1	chr11	6593478	6593800	LTR/ERVL	698	+	161	6593639	81313
chr11	6201318	6401318	harbor1	chr11	6228929	6229085	LTR/ERVL	627	+	78	6229007	27689
chr11	70734522	70934522	harbor1	chr11	70757331	70757817	LTR/ERVL	1256	+	243	70757574	23052
chr11	70734522	70934522	harbor1	chr11	70790339	70790759	LTR/ERVL	1996	+	210	70790549	56027
chr11	46138065	46338065	harbor1	chr11	46176715	46177138	LTR/ERVL	1759	+	212	46176927	38862
chr11	46138065	46338065	harbor1	chr11	46177160	46177717	LTR/ERVL	1438	+	278	46177438	39373
chr11	46138065	46338065	harbor1	chr11	46178083	46178239	LTR/ERVL	618	+	78	46178161	40096
chr11	46138065	46338065	harbor1	chr11	46178266	46178457	LTR/ERVL	939	+	96	46178362	40297
chr11	46138065	46338065	harbor1	chr11	46178463	46178606	LTR/ERVL	532	+	72	46178535	40470
chr11	12139700	12339700	harbor1	chr11	12177921	12178250	LTR/ERVL	1196	+	164	12178085	38385
chr11	6512331	6712331	harbor1	chr11	6515483	6515723	LTR/ERVL	588	+	120	6515603	3272
chr11	6512331	6712331	harbor1	chr11	6527915	6528042	LTR/ERVL	434	+	64	6527979	15648
chr11	6512331	6712331	harbor1	chr11	6554997	6555199	LTR/ERVL	1918	+	101	6555098	42767
chr11	6512331	6712331	harbor1	chr11	6555247	6555401	LTR/ERVL	1918	+	77	6555324	42993
chr11	6512331	6712331	harbor1	chr11	6555402	6555596	LTR/ERVL	1448	+	97	6555499	43168
chr11	6512331	6712331	harbor1	chr11	6593478	6593800	LTR/ERVL	698	+	161	6593639	81308
chr11	107914515	108114515	harbor1	chr11	107977838	107978293	LTR/ERVL	3206	+	228	107978066	63551
chr11	107914515	108114515	harbor1	chr11	107978294	107981052	LTR/ERVL	22498	+	1379	107979673	65158
chr11	107914515	108114515	harbor1	chr11	107983119	107985675	LTR/ERVL	23366	+	1278	107984397	69882
chr11	107914515	108114515	harbor1	chr11	107985966	107986260	LTR/ERVL	23366	+	147	107986113	71598
chr11	107914515	108114515	harbor1	chr11	107986261	107986311	LTR/ERVL	448	+	25	107986286	71771
chr11	731095	931095	harbor1	chr11	751877	752068	LTR/ERVL	3149	+	96	751973	20878
chr11	731095	931095	harbor1	chr11	752380	753087	LTR/ERVL	3149	+	354	752734	21639
chr11	76580499	76780499	harbor1	chr11	76644567	76645358	LTR/ERVL	3866	+	396	76644963	64464
chr11	76580347	76780347	harbor1	chr11	76644567	76645358	LTR/ERVL	3866	+	396	76644963	64616
chr11	5127117	5327117	harbor1	chr11	5147269	5147661	LTR/ERVL	1627	+	196	5147465	20348
chr11	76580972	76780972	harbor1	chr11	76644567	76645358	LTR/ERVL	3866	+	396	76644963	63991
chr11	5134657	5334657	harbor1	chr11	5147269	5147661	LTR/ERVL	1627	+	196	5147465	12808
chr11	6201420	6401420	harbor1	chr11	6228929	6229085	LTR/ERVL	627	+	78	6229007	27587
chr11	108021633	108221633	harbor1	chr11	108041018	108041268	LTR/ERVL	805	+	125	108041143	19510
chr11	5127276	5327276	harbor1	chr11	5147269	5147661	LTR/ERVL	1627	+	196	5147465	20189
chr11	19099393	19299393	harbor1	chr11	19105015	19105173	LTR/ERVL	979	+	79	19105094	5701
chr11	19099393	19299393	harbor1	chr11	19105581	19105685	LTR/ERVL	979	+	52	19105633	6240
chr11	19099393	19299393	harbor1	chr11	19105853	19106067	LTR/ERVL	410	+	107	19105960	6567
chr11	19099393	19299393	harbor1	chr11	19106213	19106474	LTR/ERVL	737	+	130	19106343	6950
chr11	19099393	19299393	harbor1	chr11	19178102	19178319	LTR/ERVL	581	+	108	19178210	78817
chr11	19099393	19299393	harbor1	chr11	19103734	19103969	LTR/ERVL	619	+	118	19103852	4459
chr11	5134554	5334554	harbor1	chr11	5147269	5147661	LTR/ERVL	1627	+	196	5147465	12911
chr11	6201346	6401346	harbor1	chr11	6228929	6229085	LTR/ERVL	627	+	78	6229007	27661
chr11	5134601	5334601	harbor1	chr11	5147269	5147661	LTR/ERVL	1627	+	196	5147465	12864
chr11	70734529	70934529	harbor1	chr11	70757331	70757817	LTR/ERVL	1256	+	243	70757574	23045
chr11	70734529	70934529	harbor1	chr11	70790339	70790759	LTR/ERVL	1996	+	210	70790549	56020
chr11	5127104	5327104	harbor1	chr11	5147269	5147661	LTR/ERVL	1627	+	196	5147465	20361
chr11	5127078	5327078	harbor1	chr11	5147269	5147661	LTR/ERVL	1627	+	196	5147465	20387
chr11	70734576	70934576	harbor1	chr11	70757331	70757817	LTR/ERVL	1256	+	243	70757574	22998
chr11	70734576	70934576	harbor1	chr11	70790339	70790759	LTR/ERVL	1996	+	210	70790549	55973
chr11	22725288	22925288	harbor1	chr11	22823369	22823740	LTR/ERVL	1833	+	186	22823555	98267
chr11	22725288	22925288	harbor1	chr11	22824039	22824117	LTR/ERVL	1833	+	39	22824078	98790
chr11	5132790	5332790	harbor1	chr11	5147269	5147661	LTR/ERVL	1627	+	196	5147465	14675
chr11	75668477	75868477	harbor1	chr11	75711156	75712681	LTR/ERVL	5509	+	762	75711918	43441
chr11	75668477	75868477	harbor1	chr11	75712663	75712828	LTR/ERVL	880	+	82	75712745	44268
chr11	75668477	75868477	harbor1	chr11	75712836	75712988	LTR/ERVL	671	+	76	75712912	44435
chr11	75668477	75868477	harbor1	chr11	75712977	75713343	LTR/ERVL	554	+	183	75713160	44683
chr11	75668477	75868477	harbor1	chr11	75713724	75714405	LTR/ERVL	2659	+	340	75714064	45587
chr11	75668477	75868477	harbor1	chr11	75744602	75745036	LTR/ERVL	914	+	217	75744819	76342
chr11	75668477	75868477	harbor1	chr11	75763453	75763708	LTR/ERVL	635	+	128	75763581	95104
chr11	5134186	5334186	harbor1	chr11	5147269	5147661	LTR/ERVL	1627	+	196	5147465	13279
chr11	4514263	4714263	harbor1	chr11	4520855	4521271	LTR/ERVL	1472	+	208	4521063	6800
chr11	4514263	4714263	harbor1	chr11	4526892	4527400	LTR/ERVL	2479	+	254	4527146	12883
chr11	4514263	4714263	harbor1	chr11	4548267	4548637	LTR/ERVL	823	+	185	4548452	34189
chr11	4514263	4714263	harbor1	chr11	4550034	4550543	LTR/ERVL	898	+	254	4550288	36025
chr11	4514263	4714263	harbor1	chr11	4554797	4555690	LTR/ERVL	1846	+	446	4555243	40980
chr11	4514263	4714263	harbor1	chr11	4555811	4558535	LTR/ERVL	7155	+	1362	4557173	42910
chr11	4514263	4714263	harbor1	chr11	4558543	4558978	LTR/ERVL	931	+	218	4558761	44498
chr11	4514263	4714263	harbor1	chr11	4570758	4571487	LTR/ERVL	1216	+	364	4571122	56859
chr11	73042808	73242808	harbor1	chr11	73050583	73050892	LTR/ERVL	662	+	154	73050737	7929
chr11	73042808	73242808	harbor1	chr11	73054284	73054568	LTR/ERVL	994	+	142	73054426	11618
chr11	73042808	73242808	harbor1	chr11	73092809	73093462	LTR/ERVL	2474	+	326	73093135	50327
chr11	5126808	5326808	harbor1	chr11	5147269	5147661	LTR/ERVL	1627	+	196	5147465	20657
chr11	69539219	69739219	harbor1	chr11	69601712	69602120	LTR/ERVL	480	+	204	69601916	62697
chr11	76581035	76781035	harbor1	chr11	76644567	76645358	LTR/ERVL	3866	+	396	76644963	63928
chr11	305556	505556	harbor1	chr11	359363	359496	LTR/ERVL	524	+	66	359429	53873
chr11	305556	505556	harbor1	chr11	360560	361379	LTR/ERVL	1980	+	410	360970	55414
chr11	305556	505556	harbor1	chr11	362389	362971	LTR/ERVL	1980	+	291	362680	57124
chr11	305556	505556	harbor1	chr11	364312	365032	LTR/ERVL	885	+	360	364672	59116
chr11	305556	505556	harbor1	chr11	365329	365592	LTR/ERVL	700	+	132	365461	59905
chr11	305556	505556	harbor1	chr11	366008	366821	LTR/ERVL	1721	+	406	366414	60858
chr11	32073529	32273529	harbor1	chr11	32080815	32081195	LTR/ERVL	1292	+	190	32081005	7476
chr11	32073529	32273529	harbor1	chr11	32137953	32138177	LTR/ERVL	839	+	112	32138065	64536
chr11	5127131	5327131	harbor1	chr11	5147269	5147661	LTR/ERVL	1627	+	196	5147465	20334
chr11	69539220	69739220	harbor1	chr11	69601712	69602120	LTR/ERVL	480	+	204	69601916	62696
chr11	5125969	5325969	harbor1	chr11	5147269	5147661	LTR/ERVL	1627	+	196	5147465	21496
chr11	72610267	72810267	harbor1	chr11	72663887	72664332	LTR/ERVL	646	+	222	72664109	53842
chr11	682053	882053	harbor1	chr11	751877	752068	LTR/ERVL	3149	+	96	751973	69920
chr11	682053	882053	harbor1	chr11	752380	753087	LTR/ERVL	3149	+	354	752734	70681
chr11	5126984	5326984	harbor1	chr11	5147269	5147661	LTR/ERVL	1627	+	196	5147465	20481
chr11	5127187	5327187	harbor1	chr11	5147269	5147661	LTR/ERVL	1627	+	196	5147465	20278
chr11	69575154	69775154	harbor1	chr11	69601712	69602120	LTR/ERVL	480	+	204	69601916	26762
chr11	33157309	33357309	harbor1	chr11	33198256	33198619	LTR/ERVL	1149	+	182	33198438	41129
chr11	33157309	33357309	harbor1	chr11	33202751	33202978	LTR/ERVL	832	+	114	33202865	45556
chr11	33157309	33357309	harbor1	chr11	33202984	33203034	LTR/ERVL	664	+	25	33203009	45700
chr11	33157309	33357309	harbor1	chr11	33203321	33203516	LTR/ERVL	698	+	98	33203419	46110
chr11	33157309	33357309	harbor1	chr11	33205925	33206384	LTR/ERVL	1516	+	230	33206155	48846
chr11	77964208	78164208	harbor1	chr11	78035173	78035560	LTR/ERVL	917	+	194	78035367	71159
chr11	6512394	6712394	harbor1	chr11	6515483	6515723	LTR/ERVL	588	+	120	6515603	3209
chr11	6512394	6712394	harbor1	chr11	6527915	6528042	LTR/ERVL	434	+	64	6527979	15585
chr11	6512394	6712394	harbor1	chr11	6554997	6555199	LTR/ERVL	1918	+	101	6555098	42704
chr11	6512394	6712394	harbor1	chr11	6555247	6555401	LTR/ERVL	1918	+	77	6555324	42930
chr11	6512394	6712394	harbor1	chr11	6555402	6555596	LTR/ERVL	1448	+	97	6555499	43105
chr11	6512394	6712394	harbor1	chr11	6593478	6593800	LTR/ERVL	698	+	161	6593639	81245
chr11	5132879	5332879	harbor1	chr11	5147269	5147661	LTR/ERVL	1627	+	196	5147465	14586
chr11	6201311	6401311	harbor1	chr11	6228929	6229085	LTR/ERVL	627	+	78	6229007	27696
chr11	113773432	113973432	harbor1	chr11	113847830	113849952	LTR/ERVL	8539	+	1061	113848891	75459
chr11	5126814	5326814	harbor1	chr11	5147269	5147661	LTR/ERVL	1627	+	196	5147465	20651
chr11	5132579	5332579	harbor1	chr11	5147269	5147661	LTR/ERVL	1627	+	196	5147465	14886
chr11	5127120	5327120	harbor1	chr11	5147269	5147661	LTR/ERVL	1627	+	196	5147465	20345
chr11	76580334	76780334	harbor1	chr11	76644567	76645358	LTR/ERVL	3866	+	396	76644963	64629
chr11	69539244	69739244	harbor1	chr11	69601712	69602120	LTR/ERVL	480	+	204	69601916	62672
chr11	7933373	8133373	harbor1	chr11	7936058	7936393	LTR/ERVL	742	+	168	7936226	2853
chr11	7933373	8133373	harbor1	chr11	7936428	7936564	LTR/ERVL	406	+	68	7936496	3123
chr11	7933373	8133373	harbor1	chr11	7936645	7936922	LTR/ERVL	543	+	138	7936783	3410
chr11	7933373	8133373	harbor1	chr11	7948238	7948600	LTR/ERVL	803	+	181	7948419	15046
chr11	7933373	8133373	harbor1	chr11	7984358	7984833	LTR/ERVL	2568	+	238	7984596	51223
chr11	7933373	8133373	harbor1	chr11	8011868	8012370	LTR/ERVL	1740	+	251	8012119	78746
chr11	7933373	8133373	harbor1	chr11	8012373	8012481	LTR/ERVL	677	+	54	8012427	79054
chr11	122556267	122756267	harbor1	chr11	122595385	122595814	LTR/ERVL	1046	+	214	122595599	39332
chr11	122556267	122756267	harbor1	chr11	122596107	122596265	LTR/ERVL	430	+	79	122596186	39919
chr11	122556267	122756267	harbor1	chr11	122596562	122596683	LTR/ERVL	430	+	60	122596622	40355
chr11	122556267	122756267	harbor1	chr11	122630466	122630872	LTR/ERVL	514	+	203	122630669	74402
chr11	76580627	76780627	harbor1	chr11	76644567	76645358	LTR/ERVL	3866	+	396	76644963	64336
chr11	5127220	5327220	harbor1	chr11	5147269	5147661	LTR/ERVL	1627	+	196	5147465	20245
chr11	5127275	5327275	harbor1	chr11	5147269	5147661	LTR/ERVL	1627	+	196	5147465	20190
chr11	76575076	76775076	harbor1	chr11	76644567	76645358	LTR/ERVL	3866	+	396	76644963	69887
chr11	7520537	7720537	harbor1	chr11	7545811	7546157	LTR/ERVL	1504	+	173	7545984	25447
chr11	7520537	7720537	harbor1	chr11	7550640	7551093	LTR/ERVL	3069	+	226	7550866	30329
chr11	5127188	5327188	harbor1	chr11	5147269	5147661	LTR/ERVL	1627	+	196	5147465	20277
chr11	76580968	76780968	harbor1	chr11	76644567	76645358	LTR/ERVL	3866	+	396	76644963	63995
chr11	64752705	64952705	harbor1	chr11	64822081	64822172	LTR/ERVL	496	+	46	64822127	69422
chr11	64752705	64952705	harbor1	chr11	64822598	64822755	LTR/ERVL	496	+	78	64822676	69971
chr11	5127127	5327127	harbor1	chr11	5147269	5147661	LTR/ERVL	1627	+	196	5147465	20338
chr11	3160998	3360998	harbor1	chr11	3234992	3235204	LTR/ERVL	477	+	106	3235098	74100
chr11	65286790	65486790	harbor1	chr11	65359541	65360206	LTR/ERVL	1440	+	332	65359873	73083
chr11	64348428	64548428	harbor1	chr11	64397783	64398525	LTR/ERVL	3207	+	371	64398154	49726
chr11	64348428	64548428	harbor1	chr11	64398895	64399098	LTR/ERVL	3207	+	102	64398997	50569
chr11	64348428	64548428	harbor1	chr11	64399334	64399598	LTR/ERVL	874	+	132	64399466	51038
chr11	64348428	64548428	harbor1	chr11	64399914	64399988	LTR/ERVL	874	+	37	64399951	51523
chr11	64348428	64548428	harbor1	chr11	64400513	64400807	LTR/ERVL	4906	+	147	64400660	52232
chr11	64348428	64548428	harbor1	chr11	64401022	64402091	LTR/ERVL	4906	+	534	64401556	53128
chr11	64348428	64548428	harbor1	chr11	64402402	64402510	LTR/ERVL	4906	+	54	64402456	54028
chr11	64348428	64548428	harbor1	chr11	64402699	64402762	LTR/ERVL	448	+	32	64402731	54303
chr11	64348428	64548428	harbor1	chr11	64403166	64403305	LTR/ERVL	448	+	70	64403236	54808
chr11	64348428	64548428	harbor1	chr11	64403308	64403465	LTR/ERVL	1128	+	78	64403386	54958
chr11	64348428	64548428	harbor1	chr11	64403848	64404278	LTR/ERVL	1128	+	215	64404063	55635
chr11	64348428	64548428	harbor1	chr11	64406577	64406966	LTR/ERVL	1939	+	194	64406771	58343
chr11	69112726	69312726	harbor1	chr11	69145976	69146173	LTR/ERVL	832	+	98	69146074	33348
chr11	69112726	69312726	harbor1	chr11	69164878	69165420	LTR/ERVL	1454	+	271	69165149	52423
chr11	69112726	69312726	harbor1	chr11	69170396	69170828	LTR/ERVL	3467	+	216	69170612	57886
chr11	69539269	69739269	harbor1	chr11	69601712	69602120	LTR/ERVL	480	+	204	69601916	62647
chr11	5127170	5327170	harbor1	chr11	5147269	5147661	LTR/ERVL	1627	+	196	5147465	20295
chr11	5127159	5327159	harbor1	chr11	5147269	5147661	LTR/ERVL	1627	+	196	5147465	20306
chr11	46818647	47018647	harbor1	chr11	46840613	46840986	LTR/ERVL	2480	+	186	46840799	22152
chr11	46818647	47018647	harbor1	chr11	46841283	46841435	LTR/ERVL	2480	+	76	46841359	22712
chr11	46818647	47018647	harbor1	chr11	46841453	46841718	LTR/ERVL	3173	+	132	46841585	22938
chr11	46818647	47018647	harbor1	chr11	46842019	46842319	LTR/ERVL	3173	+	150	46842169	23522
chr11	46818647	47018647	harbor1	chr11	46843128	46843366	LTR/ERVL	1155	+	119	46843247	24600
chr11	46818647	47018647	harbor1	chr11	46843754	46843895	LTR/ERVL	527	+	70	46843824	25177
chr11	46818647	47018647	harbor1	chr11	46844317	46844414	LTR/ERVL	453	+	48	46844365	25718
chr11	19613809	19813809	harbor1	chr11	19639038	19639214	LTR/ERVL	1033	+	88	19639126	25317
chr11	5125968	5325968	harbor1	chr11	5147269	5147661	LTR/ERVL	1627	+	196	5147465	21497
chr11	680085	880085	harbor1	chr11	751877	752068	LTR/ERVL	3149	+	96	751973	71888
chr11	680085	880085	harbor1	chr11	752380	753087	LTR/ERVL	3149	+	354	752734	72649
chr11	5127290	5327290	harbor1	chr11	5147269	5147661	LTR/ERVL	1627	+	196	5147465	20175
chr11	5126787	5326787	harbor1	chr11	5147269	5147661	LTR/ERVL	1627	+	196	5147465	20678
chr11	5134597	5334597	harbor1	chr11	5147269	5147661	LTR/ERVL	1627	+	196	5147465	12868
chr11	86572183	86772183	harbor1	chr11	86623017	86623521	LTR/ERVL	2924	+	252	86623269	51086
chr11	86572183	86772183	harbor1	chr11	86626106	86626617	LTR/ERVL	1228	+	256	86626362	54179
chr11	86572183	86772183	harbor1	chr11	86626806	86626940	LTR/ERVL	1005	+	67	86626873	54690
chr12	123133097	123333097	harbor1	chr12	123173301	123174184	LTR/ERVL	3803	+	442	123173743	40646
chr12	131268647	131468647	harbor1	chr12	131293569	131293964	LTR/ERVL	1224	+	198	131293767	25120
chr12	10112880	10312880	harbor1	chr12	10174027	10174048	LTR/ERVL	955	+	10	10174037	61157
chr12	10112880	10312880	harbor1	chr12	10183840	10184602	LTR/ERVL	3897	+	381	10184221	71341
chr12	10112880	10312880	harbor1	chr12	10174362	10174732	LTR/ERVL	955	+	185	10174547	61667
chr12	2940625	3140625	harbor1	chr12	2988205	2988230	LTR/ERVL	3323	+	12	2988217	47592
chr12	2940625	3140625	harbor1	chr12	2988529	2989164	LTR/ERVL	3323	+	318	2988847	48222
chr12	12257335	12457335	harbor1	chr12	12301289	12301711	LTR/ERVL	1642	+	211	12301500	44165
chr12	12257335	12457335	harbor1	chr12	12321510	12321895	LTR/ERVL	3175	+	192	12321702	64367
chr12	12257335	12457335	harbor1	chr12	12321952	12322016	LTR/ERVL	3175	+	32	12321984	64649
chr12	12257335	12457335	harbor1	chr12	12344240	12344475	LTR/ERVL	2949	+	118	12344358	87023
chr12	12257335	12457335	harbor1	chr12	12344767	12344916	LTR/ERVL	2949	+	74	12344841	87506
chr12	12257335	12457335	harbor1	chr12	12344969	12345008	LTR/ERVL	2949	+	20	12344989	87654
chr12	48880879	49080879	harbor1	chr12	48897781	48898002	LTR/ERVL	2167	+	110	48897891	17012
chr12	48880879	49080879	harbor1	chr12	48898244	48898258	LTR/ERVL	2167	+	7	48898251	17372
chr12	48880879	49080879	harbor1	chr12	48898611	48898845	LTR/ERVL	2167	+	117	48898728	17849
chr12	48880879	49080879	harbor1	chr12	48898845	48898946	LTR/ERVL	619	+	50	48898895	18016
chr12	48880879	49080879	harbor1	chr12	48899547	48900104	LTR/ERVL	3010	+	278	48899825	18946
chr12	48880879	49080879	harbor1	chr12	48900548	48900622	LTR/ERVL	1965	+	37	48900585	19706
chr12	48880879	49080879	harbor1	chr12	48901252	48901663	LTR/ERVL	1965	+	206	48901458	20579
chr12	49467542	49667542	harbor1	chr12	49482211	49482680	LTR/ERVL	855	+	234	49482445	14903
chr12	68421784	68621784	harbor1	chr12	68428296	68428659	LTR/ERVL	1134	+	182	68428478	6694
chr12	68421784	68621784	harbor1	chr12	68449890	68450315	LTR/ERVL	2850	+	212	68450102	28318
chr12	130738919	130938919	harbor1	chr12	130763098	130763189	LTR/ERVL	2653	+	46	130763144	24225
chr12	130738919	130938919	harbor1	chr12	130763490	130764073	LTR/ERVL	2653	+	292	130763782	24863
chr12	130738919	130938919	harbor1	chr12	130804308	130804733	LTR/ERVL	2165	+	212	130804520	65601
chr12	130061504	130261504	harbor1	chr12	130106570	130107092	LTR/ERVL	2204	+	261	130106831	45327
chr12	130061504	130261504	harbor1	chr12	130112268	130112595	LTR/ERVL	2276	+	164	130112432	50928
chr12	130061504	130261504	harbor1	chr12	130112960	130113160	LTR/ERVL	2276	+	100	130113060	51556
chr12	130061504	130261504	harbor1	chr12	130131747	130132220	LTR/ERVL	855	+	236	130131983	70479
chr12	92828990	93028990	harbor1	chr12	92879736	92880235	LTR/ERVL	2652	+	250	92879986	50996
chr12	6248395	6448395	harbor1	chr12	6250405	6250724	LTR/ERVL	1013	+	160	6250565	2170
chr12	6248395	6448395	harbor1	chr12	6263354	6263458	LTR/ERVL	1327	+	52	6263406	15011
chr12	6248395	6448395	harbor1	chr12	6263770	6264086	LTR/ERVL	1327	+	158	6263928	15533
chr12	96299297	96499297	harbor1	chr12	96337828	96338449	LTR/ERVL	2433	+	310	96338138	38841
chr13	94612331	94812331	harbor1	chr13	94630805	94631325	LTR/ERVL	1510	+	260	94631065	18734
chr13	94612331	94812331	harbor1	chr13	94632655	94633305	LTR/ERVL	1572	+	325	94632980	20649
chr13	94612331	94812331	harbor1	chr13	94686806	94687030	LTR/ERVL	1398	+	112	94686918	74587
chr13	100574884	100774884	harbor1	chr13	100620145	100620615	LTR/ERVL	556	+	235	100620380	45496
chr13	20315145	20515145	harbor1	chr13	20317636	20318690	LTR/ERVL	6536	+	527	20318163	3018
chr13	20315145	20515145	harbor1	chr13	20318691	20319230	LTR/ERVL	3102	+	270	20318961	3816
chr13	20315145	20515145	harbor1	chr13	20319231	20319602	LTR/ERVL	1435	+	186	20319417	4272
chr13	20315145	20515145	harbor1	chr13	20320754	20321016	LTR/ERVL	502	+	131	20320885	5740
chr13	20315145	20515145	harbor1	chr13	20322602	20322752	LTR/ERVL	602	+	75	20322677	7532
chr13	27728634	27928634	harbor1	chr13	27778934	27779075	LTR/ERVL	902	+	70	27779004	50370
chr13	27728634	27928634	harbor1	chr13	27779527	27779707	LTR/ERVL	902	+	90	27779617	50983
chr13	20314698	20514698	harbor1	chr13	20317636	20318690	LTR/ERVL	6536	+	527	20318163	3465
chr13	20314698	20514698	harbor1	chr13	20318691	20319230	LTR/ERVL	3102	+	270	20318961	4263
chr13	20314698	20514698	harbor1	chr13	20319231	20319602	LTR/ERVL	1435	+	186	20319417	4719
chr13	20314698	20514698	harbor1	chr13	20320754	20321016	LTR/ERVL	502	+	131	20320885	6187
chr13	20314698	20514698	harbor1	chr13	20322602	20322752	LTR/ERVL	602	+	75	20322677	7979
chr13	50025212	50225212	harbor1	chr13	50115164	50115408	LTR/ERVL	813	+	122	50115286	90074
chr13	50025212	50225212	harbor1	chr13	50115466	50115714	LTR/ERVL	574	+	124	50115590	90378
chr13	20315192	20515192	harbor1	chr13	20317636	20318690	LTR/ERVL	6536	+	527	20318163	2971
chr13	20315192	20515192	harbor1	chr13	20318691	20319230	LTR/ERVL	3102	+	270	20318961	3769
chr13	20315192	20515192	harbor1	chr13	20319231	20319602	LTR/ERVL	1435	+	186	20319417	4225
chr13	20315192	20515192	harbor1	chr13	20320754	20321016	LTR/ERVL	502	+	131	20320885	5693
chr13	20315192	20515192	harbor1	chr13	20322602	20322752	LTR/ERVL	602	+	75	20322677	7485
chr13	48133654	48333654	harbor1	chr13	48165661	48166090	LTR/ERVL	1730	+	214	48165875	32221
chr13	48133654	48333654	harbor1	chr13	48199094	48199226	LTR/ERVL	1201	+	66	48199160	65506
chr13	48133654	48333654	harbor1	chr13	48199534	48199868	LTR/ERVL	1201	+	167	48199701	66047
chr13	110254287	110454287	harbor1	chr13	110285488	110285923	LTR/ERVL	1206	+	218	110285706	31419
chr13	100574881	100774881	harbor1	chr13	100620145	100620615	LTR/ERVL	556	+	235	100620380	45499
chr13	100574914	100774914	harbor1	chr13	100620145	100620615	LTR/ERVL	556	+	235	100620380	45466
chr13	20315123	20515123	harbor1	chr13	20317636	20318690	LTR/ERVL	6536	+	527	20318163	3040
chr13	20315123	20515123	harbor1	chr13	20318691	20319230	LTR/ERVL	3102	+	270	20318961	3838
chr13	20315123	20515123	harbor1	chr13	20319231	20319602	LTR/ERVL	1435	+	186	20319417	4294
chr13	20315123	20515123	harbor1	chr13	20320754	20321016	LTR/ERVL	502	+	131	20320885	5762
chr13	20315123	20515123	harbor1	chr13	20322602	20322752	LTR/ERVL	602	+	75	20322677	7554
chr13	94612324	94812324	harbor1	chr13	94630805	94631325	LTR/ERVL	1510	+	260	94631065	18741
chr13	94612324	94812324	harbor1	chr13	94632655	94633305	LTR/ERVL	1572	+	325	94632980	20656
chr13	94612324	94812324	harbor1	chr13	94686806	94687030	LTR/ERVL	1398	+	112	94686918	74594
chr13	98425553	98625553	harbor1	chr13	98497985	98498600	LTR/ERVL	2772	+	308	98498293	72740
chr13	98425553	98625553	harbor1	chr13	98509543	98510400	LTR/ERVL	3166	+	428	98509971	84418
chr13	51810106	52010106	harbor1	chr13	51811868	51812385	LTR/ERVL	2146	+	258	51812126	2020
chr13	51810106	52010106	harbor1	chr13	51892422	51892685	LTR/ERVL	447	+	132	51892554	82448
chr13	51810106	52010106	harbor1	chr13	51892747	51892962	LTR/ERVL	591	+	108	51892855	82749
chr13	51810106	52010106	harbor1	chr13	51907260	51907813	LTR/ERVL	2708	+	276	51907536	97430
chr13	27707987	27907987	harbor1	chr13	27708325	27708935	LTR/ERVL	1179	+	305	27708630	643
chr13	27707987	27907987	harbor1	chr13	27716453	27716733	LTR/ERVL	546	+	140	27716593	8606
chr13	27707987	27907987	harbor1	chr13	27716758	27717258	LTR/ERVL	2303	+	250	27717008	9021
chr13	27707987	27907987	harbor1	chr13	27778934	27779075	LTR/ERVL	902	+	70	27779004	71017
chr13	27707987	27907987	harbor1	chr13	27779527	27779707	LTR/ERVL	902	+	90	27779617	71630
chr13	28720365	28920365	harbor1	chr13	28804889	28805248	LTR/ERVL	1071	+	180	28805069	84704
chr13	28720365	28920365	harbor1	chr13	28805450	28805688	LTR/ERVL	443	+	119	28805569	85204
chr13	28720365	28920365	harbor1	chr13	28806739	28806910	LTR/ERVL	497	+	86	28806825	86460
chr13	28720365	28920365	harbor1	chr13	28806892	28807078	LTR/ERVL	732	+	93	28806985	86620
chr13	28720365	28920365	harbor1	chr13	28807424	28807621	LTR/ERVL	811	+	98	28807522	87157
chr13	28720365	28920365	harbor1	chr13	28814305	28814505	LTR/ERVL	563	+	100	28814405	94040
chr13	28720365	28920365	harbor1	chr13	28815547	28815801	LTR/ERVL	761	+	127	28815674	95309
chr13	28720365	28920365	harbor1	chr13	28816107	28816179	LTR/ERVL	761	+	36	28816143	95778
chr13	110254344	110454344	harbor1	chr13	110285488	110285923	LTR/ERVL	1206	+	218	110285706	31362
chr13	27925914	28125914	harbor1	chr13	27939692	27940166	LTR/ERVL	825	+	237	27939929	14015
chr13	27925914	28125914	harbor1	chr13	28003274	28003479	LTR/ERVL	1312	+	102	28003376	77462
chr13	19461422	19661422	harbor1	chr13	19557300	19557683	LTR/ERVL	2142	+	192	19557492	96070
chr13	21574752	21774752	harbor1	chr13	21595176	21595318	LTR/ERVL	651	+	71	21595247	20495
chr13	21574752	21774752	harbor1	chr13	21636543	21636672	LTR/ERVL	489	+	64	21636607	61855
chr13	21574752	21774752	harbor1	chr13	21648936	21649065	LTR/ERVL	508	+	64	21649000	74248
chr13	21574752	21774752	harbor1	chr13	21650303	21650520	LTR/ERVL	668	+	108	21650411	75659
chr13	20315141	20515141	harbor1	chr13	20317636	20318690	LTR/ERVL	6536	+	527	20318163	3022
chr13	20315141	20515141	harbor1	chr13	20318691	20319230	LTR/ERVL	3102	+	270	20318961	3820
chr13	20315141	20515141	harbor1	chr13	20319231	20319602	LTR/ERVL	1435	+	186	20319417	4276
chr13	20315141	20515141	harbor1	chr13	20320754	20321016	LTR/ERVL	502	+	131	20320885	5744
chr13	20315141	20515141	harbor1	chr13	20322602	20322752	LTR/ERVL	602	+	75	20322677	7536
chr13	20315163	20515163	harbor1	chr13	20317636	20318690	LTR/ERVL	6536	+	527	20318163	3000
chr13	20315163	20515163	harbor1	chr13	20318691	20319230	LTR/ERVL	3102	+	270	20318961	3798
chr13	20315163	20515163	harbor1	chr13	20319231	20319602	LTR/ERVL	1435	+	186	20319417	4254
chr13	20315163	20515163	harbor1	chr13	20320754	20321016	LTR/ERVL	502	+	131	20320885	5722
chr13	20315163	20515163	harbor1	chr13	20322602	20322752	LTR/ERVL	602	+	75	20322677	7514
chr13	100574912	100774912	harbor1	chr13	100620145	100620615	LTR/ERVL	556	+	235	100620380	45468
chr13	72959194	73159194	harbor1	chr13	73036845	73037029	LTR/ERVL	592	+	92	73036937	77743
chr13	110254257	110454257	harbor1	chr13	110285488	110285923	LTR/ERVL	1206	+	218	110285706	31449
chr13	112670833	112870833	harbor1	chr13	112684156	112684583	LTR/ERVL	2365	+	214	112684370	13537
chr13	50026224	50226224	harbor1	chr13	50115164	50115408	LTR/ERVL	813	+	122	50115286	89062
chr13	50026224	50226224	harbor1	chr13	50115466	50115714	LTR/ERVL	574	+	124	50115590	89366
chr13	20315167	20515167	harbor1	chr13	20317636	20318690	LTR/ERVL	6536	+	527	20318163	2996
chr13	20315167	20515167	harbor1	chr13	20318691	20319230	LTR/ERVL	3102	+	270	20318961	3794
chr13	20315167	20515167	harbor1	chr13	20319231	20319602	LTR/ERVL	1435	+	186	20319417	4250
chr13	20315167	20515167	harbor1	chr13	20320754	20321016	LTR/ERVL	502	+	131	20320885	5718
chr13	20315167	20515167	harbor1	chr13	20322602	20322752	LTR/ERVL	602	+	75	20322677	7510
chr14	102975689	103175689	harbor1	chr14	103065568	103066764	LTR/ERVL	2689	+	598	103066166	90477
chr14	99103274	99303274	harbor1	chr14	99105101	99105559	LTR/ERVL	1132	+	229	99105330	2056
chr14	99103274	99303274	harbor1	chr14	99148338	99148580	LTR/ERVL	457	+	121	99148459	45185
chr14	88724597	88924597	harbor1	chr14	88764974	88765096	LTR/ERVL	560	+	61	88765035	40438
chr14	88724597	88924597	harbor1	chr14	88779910	88779956	LTR/ERVL	689	+	23	88779933	55336
chr14	88724597	88924597	harbor1	chr14	88780253	88780431	LTR/ERVL	765	+	89	88780342	55745
chr14	88724597	88924597	harbor1	chr14	88781033	88781326	LTR/ERVL	1068	+	146	88781179	56582
chr14	88724597	88924597	harbor1	chr14	88808415	88808487	LTR/ERVL	525	+	36	88808451	83854
chr14	88724597	88924597	harbor1	chr14	88809107	88809477	LTR/ERVL	2048	+	185	88809292	84695
chr14	64194243	64394243	harbor1	chr14	64243988	64244116	LTR/ERVL	3248	+	64	64244052	49809
chr14	64194243	64394243	harbor1	chr14	64244422	64244864	LTR/ERVL	3248	+	221	64244643	50400
chr14	66383081	66583081	harbor1	chr14	66406671	66407134	LTR/ERVL	1519	+	232	66406903	23822
chr14	66383081	66583081	harbor1	chr14	66456946	66457376	LTR/ERVL	2890	+	215	66457161	74080
chr14	99583656	99783656	harbor1	chr14	99643632	99644081	LTR/ERVL	1139	+	224	99643856	60200
chr14	100183362	100383362	harbor1	chr14	100206120	100206922	LTR/ERVL	2313	+	401	100206521	23159
chr14	75327984	75527984	harbor1	chr14	75344361	75344843	LTR/ERVL	2261	+	241	75344602	16618
chr14	75327984	75527984	harbor1	chr14	75345881	75346312	LTR/ERVL	2049	+	216	75346097	18113
chr14	75327984	75527984	harbor1	chr14	75369589	75370008	LTR/ERVL	1366	+	210	75369799	41815
chr14	75327984	75527984	harbor1	chr14	75370049	75370247	LTR/ERVL	802	+	99	75370148	42164
chr14	75327984	75527984	harbor1	chr14	75370263	75370616	LTR/ERVL	1119	+	176	75370439	42455
chr14	75327984	75527984	harbor1	chr14	75374557	75375034	LTR/ERVL	2698	+	238	75374795	46811
chr14	100185484	100385484	harbor1	chr14	100206120	100206922	LTR/ERVL	2313	+	401	100206521	21037
chr14	63247906	63447906	harbor1	chr14	63310519	63310642	LTR/ERVL	1439	+	62	63310581	62675
chr14	63247906	63447906	harbor1	chr14	63310945	63311291	LTR/ERVL	1439	+	173	63311118	63212
chr14	90282762	90482762	harbor1	chr14	90340655	90341063	LTR/ERVL	865	+	204	90340859	58097
chr14	90282762	90482762	harbor1	chr14	90341356	90341476	LTR/ERVL	865	+	60	90341416	58654
chr14	90283216	90483216	harbor1	chr14	90340655	90341063	LTR/ERVL	865	+	204	90340859	57643
chr14	90283216	90483216	harbor1	chr14	90341356	90341476	LTR/ERVL	865	+	60	90341416	58200
chr14	57989413	58189413	harbor1	chr14	58022498	58022724	LTR/ERVL	636	+	113	58022611	33198
chr14	57989413	58189413	harbor1	chr14	58038926	58039367	LTR/ERVL	1684	+	220	58039146	49733
chr14	67488947	67688947	harbor1	chr14	67530451	67530755	LTR/ERVL	893	+	152	67530603	41656
chr14	54388477	54588477	harbor1	chr14	54395308	54395767	LTR/ERVL	1487	+	230	54395538	7061
chr14	75328384	75528384	harbor1	chr14	75344361	75344843	LTR/ERVL	2261	+	241	75344602	16218
chr14	75328384	75528384	harbor1	chr14	75345881	75346312	LTR/ERVL	2049	+	216	75346097	17713
chr14	75328384	75528384	harbor1	chr14	75369589	75370008	LTR/ERVL	1366	+	210	75369799	41415
chr14	75328384	75528384	harbor1	chr14	75370049	75370247	LTR/ERVL	802	+	99	75370148	41764
chr14	75328384	75528384	harbor1	chr14	75370263	75370616	LTR/ERVL	1119	+	176	75370439	42055
chr14	75328384	75528384	harbor1	chr14	75374557	75375034	LTR/ERVL	2698	+	238	75374795	46411
chr14	51349924	51549924	harbor1	chr14	51353726	51354142	LTR/ERVL	1904	+	208	51353934	4010
chr14	51349924	51549924	harbor1	chr14	51373849	51376815	LTR/ERVL	23233	+	1483	51375332	25408
chr14	51349924	51549924	harbor1	chr14	51376817	51377284	LTR/ERVL	1391	+	234	51377051	27127
chr14	104195767	104395767	harbor1	chr14	104294525	104294946	LTR/ERVL	740	+	210	104294735	98968
chr14	65117756	65317756	harbor1	chr14	65132051	65132173	LTR/ERVL	533	+	61	65132112	14356
chr14	65117756	65317756	harbor1	chr14	65133087	65133373	LTR/ERVL	967	+	143	65133230	15474
chr14	65117756	65317756	harbor1	chr14	65133430	65133655	LTR/ERVL	687	+	112	65133542	15786
chr14	65117756	65317756	harbor1	chr14	65158961	65159420	LTR/ERVL	2669	+	230	65159191	41435
chr14	93015942	93215942	harbor1	chr14	93018026	93018470	LTR/ERVL	598	+	222	93018248	2306
chr14	93015942	93215942	harbor1	chr14	93059918	93060354	LTR/ERVL	885	+	218	93060136	44194
chr14	90283244	90483244	harbor1	chr14	90340655	90341063	LTR/ERVL	865	+	204	90340859	57615
chr14	90283244	90483244	harbor1	chr14	90341356	90341476	LTR/ERVL	865	+	60	90341416	58172
chr14	23419129	23619129	harbor1	chr14	23456685	23456957	LTR/ERVL	3361	+	136	23456821	37692
chr14	23419129	23619129	harbor1	chr14	23457679	23458309	LTR/ERVL	3361	+	315	23457994	38865
chr14	75328363	75528363	harbor1	chr14	75344361	75344843	LTR/ERVL	2261	+	241	75344602	16239
chr14	75328363	75528363	harbor1	chr14	75345881	75346312	LTR/ERVL	2049	+	216	75346097	17734
chr14	75328363	75528363	harbor1	chr14	75369589	75370008	LTR/ERVL	1366	+	210	75369799	41436
chr14	75328363	75528363	harbor1	chr14	75370049	75370247	LTR/ERVL	802	+	99	75370148	41785
chr14	75328363	75528363	harbor1	chr14	75370263	75370616	LTR/ERVL	1119	+	176	75370439	42076
chr14	75328363	75528363	harbor1	chr14	75374557	75375034	LTR/ERVL	2698	+	238	75374795	46432
chr14	105103095	105303095	harbor1	chr14	105124374	105124689	LTR/ERVL	522	+	158	105124532	21437
chr14	105103095	105303095	harbor1	chr14	105129954	105130159	LTR/ERVL	4627	+	102	105130056	26961
chr14	105103095	105303095	harbor1	chr14	105130472	105130786	LTR/ERVL	4627	+	157	105130629	27534
chr14	105103095	105303095	harbor1	chr14	105131090	105131880	LTR/ERVL	4627	+	395	105131485	28390
chr14	105255513	105455513	harbor1	chr14	105306924	105307027	LTR/ERVL	469	+	52	105306976	51463
chr14	105255513	105455513	harbor1	chr14	105307209	105307583	LTR/ERVL	1150	+	187	105307396	51883
chr14	75328401	75528401	harbor1	chr14	75344361	75344843	LTR/ERVL	2261	+	241	75344602	16201
chr14	75328401	75528401	harbor1	chr14	75345881	75346312	LTR/ERVL	2049	+	216	75346097	17696
chr14	75328401	75528401	harbor1	chr14	75369589	75370008	LTR/ERVL	1366	+	210	75369799	41398
chr14	75328401	75528401	harbor1	chr14	75370049	75370247	LTR/ERVL	802	+	99	75370148	41747
chr14	75328401	75528401	harbor1	chr14	75370263	75370616	LTR/ERVL	1119	+	176	75370439	42038
chr14	75328401	75528401	harbor1	chr14	75374557	75375034	LTR/ERVL	2698	+	238	75374795	46394
chr14	90282174	90482174	harbor1	chr14	90340655	90341063	LTR/ERVL	865	+	204	90340859	58685
chr14	90282174	90482174	harbor1	chr14	90341356	90341476	LTR/ERVL	865	+	60	90341416	59242
chr14	104017094	104217094	harbor1	chr14	104043839	104044308	LTR/ERVL	1964	+	234	104044073	26979
chr14	104017094	104217094	harbor1	chr14	104068870	104069388	LTR/ERVL	2606	+	259	104069129	52035
chr14	104017094	104217094	harbor1	chr14	104078003	104078184	LTR/ERVL	699	+	90	104078093	60999
chr14	100185630	100385630	harbor1	chr14	100206120	100206922	LTR/ERVL	2313	+	401	100206521	20891
chr14	100118258	100318258	harbor1	chr14	100152360	100152877	LTR/ERVL	1711	+	258	100152618	34360
chr14	100118258	100318258	harbor1	chr14	100165019	100165498	LTR/ERVL	1848	+	240	100165259	47001
chr14	100118258	100318258	harbor1	chr14	100168871	100169180	LTR/ERVL	889	+	154	100169025	50767
chr14	100118258	100318258	harbor1	chr14	100169554	100169761	LTR/ERVL	776	+	104	100169658	51400
chr14	100118258	100318258	harbor1	chr14	100169791	100169871	LTR/ERVL	1909	+	40	100169831	51573
chr14	100118258	100318258	harbor1	chr14	100170160	100170426	LTR/ERVL	3785	+	133	100170293	52035
chr14	100118258	100318258	harbor1	chr14	100170716	100171532	LTR/ERVL	3785	+	408	100171124	52866
chr14	100118258	100318258	harbor1	chr14	100172870	100173125	LTR/ERVL	824	+	128	100172998	54740
chr14	100118258	100318258	harbor1	chr14	100173144	100173687	LTR/ERVL	2696	+	272	100173416	55158
chr14	100118258	100318258	harbor1	chr14	100206120	100206922	LTR/ERVL	2313	+	401	100206521	88263
chr14	100118258	100318258	harbor1	chr14	100171658	100172164	LTR/ERVL	3785	+	253	100171911	53653
chr14	67482246	67682246	harbor1	chr14	67530451	67530755	LTR/ERVL	893	+	152	67530603	48357
chr14	72958440	73158440	harbor1	chr14	72959726	72960080	LTR/ERVL	612	+	177	72959903	1463
chr14	104457988	104657988	harbor1	chr14	104495848	104496408	LTR/ERVL	1620	+	280	104496128	38140
chr14	104457988	104657988	harbor1	chr14	104517054	104517436	LTR/ERVL	871	+	191	104517245	59257
chr14	104457988	104657988	harbor1	chr14	104520054	104520967	LTR/ERVL	1070	+	456	104520510	62522
chr14	104457988	104657988	harbor1	chr14	104520989	104522034	LTR/ERVL	3338	+	522	104521511	63523
chr14	104457988	104657988	harbor1	chr14	104496785	104497225	LTR/ERVL	886	+	220	104497005	39017
chr14	75328399	75528399	harbor1	chr14	75344361	75344843	LTR/ERVL	2261	+	241	75344602	16203
chr14	75328399	75528399	harbor1	chr14	75345881	75346312	LTR/ERVL	2049	+	216	75346097	17698
chr14	75328399	75528399	harbor1	chr14	75369589	75370008	LTR/ERVL	1366	+	210	75369799	41400
chr14	75328399	75528399	harbor1	chr14	75370049	75370247	LTR/ERVL	802	+	99	75370148	41749
chr14	75328399	75528399	harbor1	chr14	75370263	75370616	LTR/ERVL	1119	+	176	75370439	42040
chr14	75328399	75528399	harbor1	chr14	75374557	75375034	LTR/ERVL	2698	+	238	75374795	46396
chr14	88724593	88924593	harbor1	chr14	88764974	88765096	LTR/ERVL	560	+	61	88765035	40442
chr14	88724593	88924593	harbor1	chr14	88779910	88779956	LTR/ERVL	689	+	23	88779933	55340
chr14	88724593	88924593	harbor1	chr14	88780253	88780431	LTR/ERVL	765	+	89	88780342	55749
chr14	88724593	88924593	harbor1	chr14	88781033	88781326	LTR/ERVL	1068	+	146	88781179	56586
chr14	88724593	88924593	harbor1	chr14	88808415	88808487	LTR/ERVL	525	+	36	88808451	83858
chr14	88724593	88924593	harbor1	chr14	88809107	88809477	LTR/ERVL	2048	+	185	88809292	84699
chr14	73545047	73745047	harbor1	chr14	73609103	73609631	LTR/ERVL	5350	+	264	73609367	64320
chr14	73545047	73745047	harbor1	chr14	73609939	73610290	LTR/ERVL	5350	+	176	73610115	65068
chr14	73545047	73745047	harbor1	chr14	73610591	73610697	LTR/ERVL	5350	+	53	73610644	65597
chr14	73545047	73745047	harbor1	chr14	73610704	73611149	LTR/ERVL	2638	+	222	73610926	65879
chr14	100182074	100382074	harbor1	chr14	100206120	100206922	LTR/ERVL	2313	+	401	100206521	24447
chr14	100146444	100346444	harbor1	chr14	100152360	100152877	LTR/ERVL	1711	+	258	100152618	6174
chr14	100146444	100346444	harbor1	chr14	100165019	100165498	LTR/ERVL	1848	+	240	100165259	18815
chr14	100146444	100346444	harbor1	chr14	100168871	100169180	LTR/ERVL	889	+	154	100169025	22581
chr14	100146444	100346444	harbor1	chr14	100169554	100169761	LTR/ERVL	776	+	104	100169658	23214
chr14	100146444	100346444	harbor1	chr14	100169791	100169871	LTR/ERVL	1909	+	40	100169831	23387
chr14	100146444	100346444	harbor1	chr14	100170160	100170426	LTR/ERVL	3785	+	133	100170293	23849
chr14	100146444	100346444	harbor1	chr14	100170716	100171532	LTR/ERVL	3785	+	408	100171124	24680
chr14	100146444	100346444	harbor1	chr14	100172870	100173125	LTR/ERVL	824	+	128	100172998	26554
chr14	100146444	100346444	harbor1	chr14	100173144	100173687	LTR/ERVL	2696	+	272	100173416	26972
chr14	100146444	100346444	harbor1	chr14	100206120	100206922	LTR/ERVL	2313	+	401	100206521	60077
chr14	100146444	100346444	harbor1	chr14	100171658	100172164	LTR/ERVL	3785	+	253	100171911	25467
chr14	90283172	90483172	harbor1	chr14	90340655	90341063	LTR/ERVL	865	+	204	90340859	57687
chr14	90283172	90483172	harbor1	chr14	90341356	90341476	LTR/ERVL	865	+	60	90341416	58244
chr14	55014896	55214896	harbor1	chr14	55081514	55081697	LTR/ERVL	728	+	92	55081606	66710
chr14	55014896	55214896	harbor1	chr14	55085390	55085659	LTR/ERVL	679	+	134	55085524	70628
chr14	55014896	55214896	harbor1	chr14	55085952	55085991	LTR/ERVL	679	+	20	55085972	71076
chr14	55014896	55214896	harbor1	chr14	55109946	55110212	LTR/ERVL	2095	+	133	55110079	95183
chr14	55014896	55214896	harbor1	chr14	55110518	55110614	LTR/ERVL	2095	+	48	55110566	95670
chr14	55014896	55214896	harbor1	chr14	55110750	55110830	LTR/ERVL	2095	+	40	55110790	95894
chr14	55014896	55214896	harbor1	chr14	55110946	55111255	LTR/ERVL	1036	+	154	55111100	96204
chr14	55014896	55214896	harbor1	chr14	55111540	55111662	LTR/ERVL	2595	+	61	55111601	96705
chr14	55014896	55214896	harbor1	chr14	55111933	55112261	LTR/ERVL	2595	+	164	55112097	97201
chr14	92893583	93093583	harbor1	chr14	92975502	92975805	LTR/ERVL	1188	+	152	92975654	82071
chr14	92893583	93093583	harbor1	chr14	92976163	92976245	LTR/ERVL	1188	+	41	92976204	82621
chr14	100185510	100385510	harbor1	chr14	100206120	100206922	LTR/ERVL	2313	+	401	100206521	21011
chr14	75328390	75528390	harbor1	chr14	75344361	75344843	LTR/ERVL	2261	+	241	75344602	16212
chr14	75328390	75528390	harbor1	chr14	75345881	75346312	LTR/ERVL	2049	+	216	75346097	17707
chr14	75328390	75528390	harbor1	chr14	75369589	75370008	LTR/ERVL	1366	+	210	75369799	41409
chr14	75328390	75528390	harbor1	chr14	75370049	75370247	LTR/ERVL	802	+	99	75370148	41758
chr14	75328390	75528390	harbor1	chr14	75370263	75370616	LTR/ERVL	1119	+	176	75370439	42049
chr14	75328390	75528390	harbor1	chr14	75374557	75375034	LTR/ERVL	2698	+	238	75374795	46405
chr14	71816792	72016792	harbor1	chr14	71869031	71869164	LTR/ERVL	476	+	66	71869097	52305
chr14	71816792	72016792	harbor1	chr14	71883175	71883501	LTR/ERVL	1827	+	163	71883338	66546
chr14	71816792	72016792	harbor1	chr14	71884140	71884222	LTR/ERVL	1827	+	41	71884181	67389
chr14	71816792	72016792	harbor1	chr14	71892993	71893505	LTR/ERVL	1455	+	256	71893249	76457
chr14	71816792	72016792	harbor1	chr14	71894650	71894774	LTR/ERVL	1455	+	62	71894712	77920
chr14	104542901	104742901	harbor1	chr14	104558162	104558583	LTR/ERVL	605	+	210	104558372	15471
chr14	104542901	104742901	harbor1	chr14	104622030	104622339	LTR/ERVL	473	+	154	104622184	79283
chr14	104017097	104217097	harbor1	chr14	104043839	104044308	LTR/ERVL	1964	+	234	104044073	26976
chr14	104017097	104217097	harbor1	chr14	104068870	104069388	LTR/ERVL	2606	+	259	104069129	52032
chr14	104017097	104217097	harbor1	chr14	104078003	104078184	LTR/ERVL	699	+	90	104078093	60996
chr14	100581636	100781636	harbor1	chr14	100607634	100608022	LTR/ERVL	971	+	194	100607828	26192
chr14	100581636	100781636	harbor1	chr14	100616680	100617256	LTR/ERVL	1421	+	288	100616968	35332
chr14	100581636	100781636	harbor1	chr14	100624119	100624571	LTR/ERVL	1104	+	226	100624345	42709
chr14	100581636	100781636	harbor1	chr14	100629659	100630121	LTR/ERVL	1970	+	231	100629890	48254
chr14	20369071	20569071	harbor1	chr14	20394794	20395023	LTR/ERVL	584	+	114	20394908	25837
chr14	75328424	75528424	harbor1	chr14	75344361	75344843	LTR/ERVL	2261	+	241	75344602	16178
chr14	75328424	75528424	harbor1	chr14	75345881	75346312	LTR/ERVL	2049	+	216	75346097	17673
chr14	75328424	75528424	harbor1	chr14	75369589	75370008	LTR/ERVL	1366	+	210	75369799	41375
chr14	75328424	75528424	harbor1	chr14	75370049	75370247	LTR/ERVL	802	+	99	75370148	41724
chr14	75328424	75528424	harbor1	chr14	75370263	75370616	LTR/ERVL	1119	+	176	75370439	42015
chr14	75328424	75528424	harbor1	chr14	75374557	75375034	LTR/ERVL	2698	+	238	75374795	46371
chr14	50142883	50342883	harbor1	chr14	50184918	50185409	LTR/ERVL	2227	+	246	50185164	42281
chr14	50142883	50342883	harbor1	chr14	50185709	50185730	LTR/ERVL	2227	+	10	50185719	42836
chr14	50142883	50342883	harbor1	chr14	50208872	50209274	LTR/ERVL	1647	+	201	50209073	66190
chr14	50142883	50342883	harbor1	chr14	50209323	50209353	LTR/ERVL	1647	+	15	50209338	66455
chr14	20357270	20557270	harbor1	chr14	20394794	20395023	LTR/ERVL	584	+	114	20394908	37638
chr14	95435221	95635221	harbor1	chr14	95461447	95461684	LTR/ERVL	596	+	118	95461565	26344
chr14	95435221	95635221	harbor1	chr14	95468377	95468811	LTR/ERVL	930	+	217	95468594	33373
chr14	100012246	100212246	harbor1	chr14	100040943	100041014	LTR/ERVL	493	+	36	100040979	28733
chr14	100012246	100212246	harbor1	chr14	100042739	100043104	LTR/ERVL	1695	+	182	100042921	30675
chr14	100012246	100212246	harbor1	chr14	100054011	100054049	LTR/ERVL	1976	+	19	100054030	41784
chr14	100012246	100212246	harbor1	chr14	100054352	100054875	LTR/ERVL	1976	+	262	100054614	42368
chr14	100012246	100212246	harbor1	chr14	100091050	100091952	LTR/ERVL	2731	+	451	100091501	79255
chr14	100012246	100212246	harbor1	chr14	100092243	100092290	LTR/ERVL	2090	+	24	100092267	80021
chr14	67500383	67700383	harbor1	chr14	67530451	67530755	LTR/ERVL	893	+	152	67530603	30220
chr14	81336737	81536737	harbor1	chr14	81337976	81338854	LTR/ERVL	4089	+	439	81338415	1678
chr14	81336737	81536737	harbor1	chr14	81364865	81365309	LTR/ERVL	2546	+	222	81365087	28350
chr14	81336737	81536737	harbor1	chr14	81405765	81406297	LTR/ERVL	2186	+	266	81406031	69294
chr14	105287660	105487660	harbor1	chr14	105306924	105307027	LTR/ERVL	469	+	52	105306976	19316
chr14	105287660	105487660	harbor1	chr14	105307209	105307583	LTR/ERVL	1150	+	187	105307396	19736
chr14	55029359	55229359	harbor1	chr14	55081514	55081697	LTR/ERVL	728	+	92	55081606	52247
chr14	55029359	55229359	harbor1	chr14	55085390	55085659	LTR/ERVL	679	+	134	55085524	56165
chr14	55029359	55229359	harbor1	chr14	55085952	55085991	LTR/ERVL	679	+	20	55085972	56613
chr14	55029359	55229359	harbor1	chr14	55109946	55110212	LTR/ERVL	2095	+	133	55110079	80720
chr14	55029359	55229359	harbor1	chr14	55110518	55110614	LTR/ERVL	2095	+	48	55110566	81207
chr14	55029359	55229359	harbor1	chr14	55110750	55110830	LTR/ERVL	2095	+	40	55110790	81431
chr14	55029359	55229359	harbor1	chr14	55110946	55111255	LTR/ERVL	1036	+	154	55111100	81741
chr14	55029359	55229359	harbor1	chr14	55111540	55111662	LTR/ERVL	2595	+	61	55111601	82242
chr14	55029359	55229359	harbor1	chr14	55111933	55112261	LTR/ERVL	2595	+	164	55112097	82738
chr14	91224876	91424876	harbor1	chr14	91257474	91257894	LTR/ERVL	1034	+	210	91257684	32808
chr14	91224876	91424876	harbor1	chr14	91268100	91268400	LTR/ERVL	2102	+	150	91268250	43374
chr14	91224876	91424876	harbor1	chr14	91269139	91269218	LTR/ERVL	555	+	40	91269179	44303
chr14	91224876	91424876	harbor1	chr14	91320055	91320764	LTR/ERVL	2904	+	354	91320409	95533
chr15	89279015	89479015	harbor1	chr15	89341869	89342061	LTR/ERVL	741	+	96	89341965	62950
chr15	29169894	29369894	harbor1	chr15	29188112	29188245	LTR/ERVL	3440	+	66	29188178	18284
chr15	29169894	29369894	harbor1	chr15	29188616	29189372	LTR/ERVL	3440	+	378	29188994	19100
chr15	29169894	29369894	harbor1	chr15	29193151	29193692	LTR/ERVL	2923	+	270	29193421	23527
chr15	29169894	29369894	harbor1	chr15	29209994	29210364	LTR/ERVL	1931	+	185	29210179	40285
chr15	29169894	29369894	harbor1	chr15	29210707	29210866	LTR/ERVL	1931	+	80	29210787	40893
chr15	29169894	29369894	harbor1	chr15	29215185	29215568	LTR/ERVL	3199	+	192	29215377	45483
chr15	29169894	29369894	harbor1	chr15	29215598	29215637	LTR/ERVL	3199	+	20	29215618	45724
chr15	29169894	29369894	harbor1	chr15	29262159	29263033	LTR/ERVL	5139	+	437	29262596	92702
chr15	50319048	50519048	harbor1	chr15	50388354	50388548	LTR/ERVL	1056	+	97	50388451	69403
chr15	50319048	50519048	harbor1	chr15	50388553	50389509	LTR/ERVL	13488	+	478	50389031	69983
chr15	50319048	50519048	harbor1	chr15	50389834	50390115	LTR/ERVL	13488	+	140	50389974	70926
chr15	50319048	50519048	harbor1	chr15	50390435	50391559	LTR/ERVL	13488	+	562	50390997	71949
chr15	50319048	50519048	harbor1	chr15	50391565	50391819	LTR/ERVL	1151	+	127	50391692	72644
chr15	50319048	50519048	harbor1	chr15	50392067	50392241	LTR/ERVL	1093	+	87	50392154	73106
chr15	50319048	50519048	harbor1	chr15	50415912	50416104	LTR/ERVL	479	+	96	50416008	96960
chr15	32313757	32513757	harbor1	chr15	32317406	32317844	LTR/ERVL	921	+	219	32317625	3868
chr15	32313757	32513757	harbor1	chr15	32325552	32325900	LTR/ERVL	1828	+	174	32325726	11969
chr15	75330451	75530451	harbor1	chr15	75379854	75380375	LTR/ERVL	2904	+	260	75380114	49663
chr15	101861586	102061586	harbor1	chr15	101948690	101949583	LTR/ERVL	756	+	446	101949136	87550
chr15	101858909	102058909	harbor1	chr15	101948690	101949583	LTR/ERVL	756	+	446	101949136	90227
chr15	75576188	75776188	harbor1	chr15	75592068	75592407	LTR/ERVL	2139	+	170	75592238	16050
chr15	75576188	75776188	harbor1	chr15	75592715	75592925	LTR/ERVL	2139	+	105	75592820	16632
chr15	79796978	79996978	harbor1	chr15	79804459	79804736	LTR/ERVL	866	+	138	79804597	7619
chr15	79796978	79996978	harbor1	chr15	79821616	79822026	LTR/ERVL	3407	+	205	79821821	24843
chr15	79796978	79996978	harbor1	chr15	79822206	79822682	LTR/ERVL	3407	+	238	79822444	25466
chr15	79796978	79996978	harbor1	chr15	79868461	79868861	LTR/ERVL	1413	+	200	79868661	71683
chr15	79796978	79996978	harbor1	chr15	79822688	79823244	LTR/ERVL	1907	+	278	79822966	25988
chr15	75247615	75447615	harbor1	chr15	75247677	75248288	LTR/ERVL	3748	+	306	75247983	368
chr15	75247615	75447615	harbor1	chr15	75314899	75315870	LTR/ERVL	1509	+	486	75315385	67770
chr15	75247615	75447615	harbor1	chr15	75316169	75316770	LTR/ERVL	1509	+	300	75316469	68854
chr15	29332904	29532904	harbor1	chr15	29343178	29343573	LTR/ERVL	2189	+	198	29343376	10472
chr15	29332904	29532904	harbor1	chr15	29343618	29343660	LTR/ERVL	2189	+	21	29343639	10735
chr15	29332904	29532904	harbor1	chr15	29353934	29354438	LTR/ERVL	2576	+	252	29354186	21282
chr15	29332904	29532904	harbor1	chr15	29354883	29355308	LTR/ERVL	889	+	212	29355095	22191
chr15	29332904	29532904	harbor1	chr15	29375575	29375867	LTR/ERVL	1143	+	146	29375721	42817
chr15	29332904	29532904	harbor1	chr15	29378384	29378743	LTR/ERVL	1804	+	180	29378564	45660
chr15	69999125	70199125	harbor1	chr15	70003072	70003184	LTR/ERVL	430	+	56	70003128	4003
chr15	29332913	29532913	harbor1	chr15	29343178	29343573	LTR/ERVL	2189	+	198	29343376	10463
chr15	29332913	29532913	harbor1	chr15	29343618	29343660	LTR/ERVL	2189	+	21	29343639	10726
chr15	29332913	29532913	harbor1	chr15	29353934	29354438	LTR/ERVL	2576	+	252	29354186	21273
chr15	29332913	29532913	harbor1	chr15	29354883	29355308	LTR/ERVL	889	+	212	29355095	22182
chr15	29332913	29532913	harbor1	chr15	29375575	29375867	LTR/ERVL	1143	+	146	29375721	42808
chr15	29332913	29532913	harbor1	chr15	29378384	29378743	LTR/ERVL	1804	+	180	29378564	45651
chr15	99950832	100150832	harbor1	chr15	99963615	99964437	LTR/ERVL	3894	+	411	99964026	13194
chr15	99950832	100150832	harbor1	chr15	99964734	99965736	LTR/ERVL	3894	+	501	99965235	14403
chr15	99950832	100150832	harbor1	chr15	99965737	99965793	LTR/ERVL	3692	+	28	99965765	14933
chr15	99950832	100150832	harbor1	chr15	99966052	99966495	LTR/ERVL	3692	+	222	99966274	15442
chr15	99950832	100150832	harbor1	chr15	99966771	99967011	LTR/ERVL	3692	+	120	99966891	16059
chr15	99950832	100150832	harbor1	chr15	99967012	99967595	LTR/ERVL	3894	+	292	99967304	16472
chr15	99950832	100150832	harbor1	chr15	99967897	99968055	LTR/ERVL	3894	+	79	99967976	17144
chr15	99950832	100150832	harbor1	chr15	99968435	99968879	LTR/ERVL	2106	+	222	99968657	17825
chr15	99950832	100150832	harbor1	chr15	100026422	100026823	LTR/ERVL	2247	+	200	100026622	75790
chr15	69999141	70199141	harbor1	chr15	70003072	70003184	LTR/ERVL	430	+	56	70003128	3987
chr15	63405315	63605315	harbor1	chr15	63419809	63420185	LTR/ERVL	915	+	188	63419997	14682
chr15	63405315	63605315	harbor1	chr15	63420639	63420736	LTR/ERVL	915	+	48	63420687	15372
chr15	63405315	63605315	harbor1	chr15	63427678	63428091	LTR/ERVL	1226	+	206	63427884	22569
chr15	63405315	63605315	harbor1	chr15	63460442	63460629	LTR/ERVL	484	+	94	63460536	55221
chr15	90133990	90333990	harbor1	chr15	90139944	90140065	LTR/ERVL	631	+	60	90140004	6014
chr15	45302919	45502919	harbor1	chr15	45344538	45344780	LTR/ERVL	2150	+	121	45344659	41740
chr15	45302919	45502919	harbor1	chr15	45345099	45345266	LTR/ERVL	2150	+	84	45345183	42264
chr15	45302919	45502919	harbor1	chr15	45345310	45345422	LTR/ERVL	2150	+	56	45345366	42447
chr15	45302919	45502919	harbor1	chr15	45397084	45398013	LTR/ERVL	4102	+	464	45397548	94629
chr15	98321796	98521796	harbor1	chr15	98324641	98324959	LTR/ERVL	1314	+	159	98324800	3004
chr15	98321796	98521796	harbor1	chr15	98325313	98325705	LTR/ERVL	1314	+	196	98325509	3713
chr15	98321796	98521796	harbor1	chr15	98349551	98349758	LTR/ERVL	897	+	104	98349655	27859
chr15	98321796	98521796	harbor1	chr15	98360016	98360448	LTR/ERVL	1009	+	216	98360232	38436
chr15	98321796	98521796	harbor1	chr15	98363449	98363889	LTR/ERVL	727	+	220	98363669	41873
chr15	98321796	98521796	harbor1	chr15	98416953	98417391	LTR/ERVL	1391	+	219	98417172	95376
chr15	69713052	69913052	harbor1	chr15	69785013	69785240	LTR/ERVL	636	+	114	69785127	72075
chr15	88185139	88385139	harbor1	chr15	88202945	88203296	LTR/ERVL	756	+	176	88203121	17982
chr15	88185139	88385139	harbor1	chr15	88242114	88242210	LTR/ERVL	447	+	48	88242162	57023
chr15	20916532	21116532	harbor1	chr15	21001333	21001712	LTR/ERVL	937	+	190	21001523	84991
chr15	20916532	21116532	harbor1	chr15	21001764	21001983	LTR/ERVL	602	+	110	21001874	85342
chr15	22459893	22659893	harbor1	chr15	22502366	22502763	LTR/ERVL	816	+	198	22502564	42671
chr15	22459893	22659893	harbor1	chr15	22522147	22522302	LTR/ERVL	704	+	78	22522225	62332
chr15	101859054	102059054	harbor1	chr15	101948690	101949583	LTR/ERVL	756	+	446	101949136	90082
chr15	74944603	75144603	harbor1	chr15	74965309	74965719	LTR/ERVL	434	+	205	74965514	20911
chr15	74944603	75144603	harbor1	chr15	74979643	74980018	LTR/ERVL	1737	+	188	74979831	35228
chr15	74944603	75144603	harbor1	chr15	74991948	74992195	LTR/ERVL	778	+	124	74992072	47469
chr15	74947211	75147211	harbor1	chr15	74965309	74965719	LTR/ERVL	434	+	205	74965514	18303
chr15	74947211	75147211	harbor1	chr15	74979643	74980018	LTR/ERVL	1737	+	188	74979831	32620
chr15	74947211	75147211	harbor1	chr15	74991948	74992195	LTR/ERVL	778	+	124	74992072	44861
chr15	75354646	75554646	harbor1	chr15	75379854	75380375	LTR/ERVL	2904	+	260	75380114	25468
chr15	52686084	52886084	harbor1	chr15	52725082	52725277	LTR/ERVL	1426	+	98	52725180	39096
chr15	52686084	52886084	harbor1	chr15	52725789	52726021	LTR/ERVL	1426	+	116	52725905	39821
chr15	52686084	52886084	harbor1	chr15	52760891	52761354	LTR/ERVL	705	+	232	52761123	75039
chr15	101854375	102054375	harbor1	chr15	101854750	101855111	LTR/ERVL	4559	+	180	101854930	555
chr15	101854375	102054375	harbor1	chr15	101855372	101856039	LTR/ERVL	4559	+	334	101855706	1331
chr15	101854375	102054375	harbor1	chr15	101948690	101949583	LTR/ERVL	756	+	446	101949136	94761
chr15	101861607	102061607	harbor1	chr15	101948690	101949583	LTR/ERVL	756	+	446	101949136	87529
chr15	66727112	66927112	harbor1	chr15	66790919	66791337	LTR/ERVL	1586	+	209	66791128	64016
chr15	66727112	66927112	harbor1	chr15	66791339	66791429	LTR/ERVL	464	+	45	66791384	64272
chr15	66727112	66927112	harbor1	chr15	66791736	66792209	LTR/ERVL	1528	+	236	66791972	64860
chr15	66727112	66927112	harbor1	chr15	66792282	66792395	LTR/ERVL	2520	+	56	66792338	65226
chr15	66727112	66927112	harbor1	chr15	66792694	66793061	LTR/ERVL	2520	+	184	66792878	65766
chr15	66727112	66927112	harbor1	chr15	66793461	66793659	LTR/ERVL	2520	+	99	66793560	66448
chr15	66727112	66927112	harbor1	chr15	66793952	66794315	LTR/ERVL	2520	+	182	66794134	67022
chr15	66727112	66927112	harbor1	chr15	66794433	66794659	LTR/ERVL	1018	+	113	66794546	67434
chr15	66727112	66927112	harbor1	chr15	66794687	66794980	LTR/ERVL	1347	+	146	66794833	67721
chr15	66727112	66927112	harbor1	chr15	66795264	66795376	LTR/ERVL	1347	+	56	66795320	68208
chr15	66727112	66927112	harbor1	chr15	66795529	66795741	LTR/ERVL	764	+	106	66795635	68523
chr16	699531	899531	harbor1	chr16	735073	735423	LTR/ERVL	814	+	175	735248	35717
chr16	699531	899531	harbor1	chr16	735416	735901	LTR/ERVL	1401	+	242	735658	36127
chr16	699531	899531	harbor1	chr16	760974	761306	LTR/ERVL	802	+	166	761140	61609
chr16	699766	899766	harbor1	chr16	735073	735423	LTR/ERVL	814	+	175	735248	35482
chr16	699766	899766	harbor1	chr16	735416	735901	LTR/ERVL	1401	+	242	735658	35892
chr16	699766	899766	harbor1	chr16	760974	761306	LTR/ERVL	802	+	166	761140	61374
chr16	88702482	88902482	harbor1	chr16	88755245	88755691	LTR/ERVL	1437	+	223	88755468	52986
chr16	88702482	88902482	harbor1	chr16	88766100	88766425	LTR/ERVL	681	+	162	88766262	63780
chr16	66189905	66389905	harbor1	chr16	66197005	66197191	LTR/ERVL	1144	+	93	66197098	7193
chr16	66189905	66389905	harbor1	chr16	66197327	66197729	LTR/ERVL	1664	+	201	66197528	7623
chr16	66189905	66389905	harbor1	chr16	66253500	66253995	LTR/ERVL	2122	+	248	66253748	63843
chr16	66189905	66389905	harbor1	chr16	66273162	66273705	LTR/ERVL	1847	+	272	66273434	83529
chr16	699726	899726	harbor1	chr16	735073	735423	LTR/ERVL	814	+	175	735248	35522
chr16	699726	899726	harbor1	chr16	735416	735901	LTR/ERVL	1401	+	242	735658	35932
chr16	699726	899726	harbor1	chr16	760974	761306	LTR/ERVL	802	+	166	761140	61414
chr16	700733	900733	harbor1	chr16	735073	735423	LTR/ERVL	814	+	175	735248	34515
chr16	700733	900733	harbor1	chr16	735416	735901	LTR/ERVL	1401	+	242	735658	34925
chr16	700733	900733	harbor1	chr16	760974	761306	LTR/ERVL	802	+	166	761140	60407
chr16	87260312	87460312	harbor1	chr16	87268970	87269371	LTR/ERVL	1486	+	200	87269170	8858
chr16	79309359	79509359	harbor1	chr16	79405844	79406276	LTR/ERVL	1393	+	216	79406060	96701
chr16	864044	1064044	harbor1	chr16	906244	906669	LTR/ERVL	2499	+	212	906456	42412
chr16	700637	900637	harbor1	chr16	735073	735423	LTR/ERVL	814	+	175	735248	34611
chr16	700637	900637	harbor1	chr16	735416	735901	LTR/ERVL	1401	+	242	735658	35021
chr16	700637	900637	harbor1	chr16	760974	761306	LTR/ERVL	802	+	166	761140	60503
chr16	88702456	88902456	harbor1	chr16	88755245	88755691	LTR/ERVL	1437	+	223	88755468	53012
chr16	88702456	88902456	harbor1	chr16	88766100	88766425	LTR/ERVL	681	+	162	88766262	63806
chr16	1863921	2063921	harbor1	chr16	1904421	1904676	LTR/ERVL	696	+	128	1904549	40628
chr16	1863921	2063921	harbor1	chr16	1936811	1937145	LTR/ERVL	1374	+	167	1936978	73057
chr16	870964	1070964	harbor1	chr16	906244	906669	LTR/ERVL	2499	+	212	906456	35492
chr16	89759369	89959369	harbor1	chr16	89804287	89804524	LTR/ERVL	1419	+	118	89804405	45036
chr16	46873236	47073236	harbor1	chr16	46873330	46873664	LTR/ERVL	1170	+	167	46873497	261
chr16	1892189	2092189	harbor1	chr16	1904421	1904676	LTR/ERVL	696	+	128	1904549	12360
chr16	1892189	2092189	harbor1	chr16	1936811	1937145	LTR/ERVL	1374	+	167	1936978	44789
chr16	1892191	2092191	harbor1	chr16	1904421	1904676	LTR/ERVL	696	+	128	1904549	12358
chr16	1892191	2092191	harbor1	chr16	1936811	1937145	LTR/ERVL	1374	+	167	1936978	44787
chr16	4077581	4277581	harbor1	chr16	4134690	4134935	LTR/ERVL	1839	+	122	4134812	57231
chr16	4077581	4277581	harbor1	chr16	4135246	4135336	LTR/ERVL	1839	+	45	4135291	57710
chr16	870901	1070901	harbor1	chr16	906244	906669	LTR/ERVL	2499	+	212	906456	35555
chr16	699781	899781	harbor1	chr16	735073	735423	LTR/ERVL	814	+	175	735248	35467
chr16	699781	899781	harbor1	chr16	735416	735901	LTR/ERVL	1401	+	242	735658	35877
chr16	699781	899781	harbor1	chr16	760974	761306	LTR/ERVL	802	+	166	761140	61359
chr16	699769	899769	harbor1	chr16	735073	735423	LTR/ERVL	814	+	175	735248	35479
chr16	699769	899769	harbor1	chr16	735416	735901	LTR/ERVL	1401	+	242	735658	35889
chr16	699769	899769	harbor1	chr16	760974	761306	LTR/ERVL	802	+	166	761140	61371
chr16	31026123	31226123	harbor1	chr16	31100362	31100712	LTR/ERVL	2556	+	175	31100537	74414
chr16	31026123	31226123	harbor1	chr16	31101019	31101264	LTR/ERVL	2556	+	122	31101141	75018
chr16	700571	900571	harbor1	chr16	735073	735423	LTR/ERVL	814	+	175	735248	34677
chr16	700571	900571	harbor1	chr16	735416	735901	LTR/ERVL	1401	+	242	735658	35087
chr16	700571	900571	harbor1	chr16	760974	761306	LTR/ERVL	802	+	166	761140	60569
chr16	1889985	2089985	harbor1	chr16	1904421	1904676	LTR/ERVL	696	+	128	1904549	14564
chr16	1889985	2089985	harbor1	chr16	1936811	1937145	LTR/ERVL	1374	+	167	1936978	46993
chr16	56526501	56726501	harbor1	chr16	56526691	56526988	LTR/ERVL	879	+	148	56526839	338
chr16	56526501	56726501	harbor1	chr16	56527539	56527593	LTR/ERVL	879	+	27	56527566	1065
chr16	56526501	56726501	harbor1	chr16	56569217	56569578	LTR/ERVL	1174	+	180	56569397	42896
chr16	700566	900566	harbor1	chr16	735073	735423	LTR/ERVL	814	+	175	735248	34682
chr16	700566	900566	harbor1	chr16	735416	735901	LTR/ERVL	1401	+	242	735658	35092
chr16	700566	900566	harbor1	chr16	760974	761306	LTR/ERVL	802	+	166	761140	60574
chr16	700526	900526	harbor1	chr16	735073	735423	LTR/ERVL	814	+	175	735248	34722
chr16	700526	900526	harbor1	chr16	735416	735901	LTR/ERVL	1401	+	242	735658	35132
chr16	700526	900526	harbor1	chr16	760974	761306	LTR/ERVL	802	+	166	761140	60614
chr16	46871997	47071997	harbor1	chr16	46873330	46873664	LTR/ERVL	1170	+	167	46873497	1500
chr16	27963715	28163715	harbor1	chr16	27984292	27984461	LTR/ERVL	703	+	84	27984376	20661
chr16	27963715	28163715	harbor1	chr16	27991981	27992214	LTR/ERVL	2403	+	116	27992097	28382
chr16	27963715	28163715	harbor1	chr16	27992509	27992695	LTR/ERVL	2403	+	93	27992602	28887
chr16	27963715	28163715	harbor1	chr16	28007939	28008076	LTR/ERVL	1002	+	68	28008007	44292
chr16	27963715	28163715	harbor1	chr16	28008379	28008474	LTR/ERVL	1002	+	48	28008427	44712
chr16	27963715	28163715	harbor1	chr16	27983844	27984289	LTR/ERVL	2374	+	222	27984066	20351
chr16	47360972	47560972	harbor1	chr16	47378937	47379349	LTR/ERVL	1613	+	206	47379143	18171
chr16	47360972	47560972	harbor1	chr16	47379357	47379405	LTR/ERVL	1670	+	24	47379381	18409
chr16	47360972	47560972	harbor1	chr16	47379705	47380694	LTR/ERVL	1670	+	494	47380199	19227
chr16	47360972	47560972	harbor1	chr16	47380664	47380776	LTR/ERVL	553	+	56	47380720	19748
chr16	47360972	47560972	harbor1	chr16	47387382	47387707	LTR/ERVL	1435	+	162	47387544	26572
chr16	700532	900532	harbor1	chr16	735073	735423	LTR/ERVL	814	+	175	735248	34716
chr16	700532	900532	harbor1	chr16	735416	735901	LTR/ERVL	1401	+	242	735658	35126
chr16	700532	900532	harbor1	chr16	760974	761306	LTR/ERVL	802	+	166	761140	60608
chr16	816011	1016011	harbor1	chr16	906244	906669	LTR/ERVL	2499	+	212	906456	90445
chr16	88756404	88956404	harbor1	chr16	88766100	88766425	LTR/ERVL	681	+	162	88766262	9858
chr16	66743175	66943175	harbor1	chr16	66795274	66795549	LTR/ERVL	1253	+	138	66795412	52237
chr16	700506	900506	harbor1	chr16	735073	735423	LTR/ERVL	814	+	175	735248	34742
chr16	700506	900506	harbor1	chr16	735416	735901	LTR/ERVL	1401	+	242	735658	35152
chr16	700506	900506	harbor1	chr16	760974	761306	LTR/ERVL	802	+	166	761140	60634
chr16	699176	899176	harbor1	chr16	735073	735423	LTR/ERVL	814	+	175	735248	36072
chr16	699176	899176	harbor1	chr16	735416	735901	LTR/ERVL	1401	+	242	735658	36482
chr16	699176	899176	harbor1	chr16	760974	761306	LTR/ERVL	802	+	166	761140	61964
chr16	1892466	2092466	harbor1	chr16	1904421	1904676	LTR/ERVL	696	+	128	1904549	12083
chr16	1892466	2092466	harbor1	chr16	1936811	1937145	LTR/ERVL	1374	+	167	1936978	44512
chr16	700587	900587	harbor1	chr16	735073	735423	LTR/ERVL	814	+	175	735248	34661
chr16	700587	900587	harbor1	chr16	735416	735901	LTR/ERVL	1401	+	242	735658	35071
chr16	700587	900587	harbor1	chr16	760974	761306	LTR/ERVL	802	+	166	761140	60553
chr16	57566222	57766222	harbor1	chr16	57594796	57595008	LTR/ERVL	632	+	106	57594902	28680
chr16	4084073	4284073	harbor1	chr16	4134690	4134935	LTR/ERVL	1839	+	122	4134812	50739
chr16	4084073	4284073	harbor1	chr16	4135246	4135336	LTR/ERVL	1839	+	45	4135291	51218
chr16	4084073	4284073	harbor1	chr16	4180175	4180381	LTR/ERVL	552	+	103	4180278	96205
chr16	870936	1070936	harbor1	chr16	906244	906669	LTR/ERVL	2499	+	212	906456	35520
chr16	2865141	3065141	harbor1	chr16	2942645	2942720	LTR/ERVL	1819	+	38	2942683	77542
chr16	2865141	3065141	harbor1	chr16	2943001	2943487	LTR/ERVL	1819	+	243	2943244	78103
chr16	58571260	58771260	harbor1	chr16	58614215	58614704	LTR/ERVL	2345	+	244	58614459	43199
chr16	58571260	58771260	harbor1	chr16	58615008	58615107	LTR/ERVL	2345	+	50	58615058	43798
chr16	58571260	58771260	harbor1	chr16	58623255	58623702	LTR/ERVL	3381	+	224	58623479	52219
chr16	58571260	58771260	harbor1	chr16	58624004	58624303	LTR/ERVL	3381	+	150	58624154	52894
chr16	47360990	47560990	harbor1	chr16	47378937	47379349	LTR/ERVL	1613	+	206	47379143	18153
chr16	47360990	47560990	harbor1	chr16	47379357	47379405	LTR/ERVL	1670	+	24	47379381	18391
chr16	47360990	47560990	harbor1	chr16	47379705	47380694	LTR/ERVL	1670	+	494	47380199	19209
chr16	47360990	47560990	harbor1	chr16	47380664	47380776	LTR/ERVL	553	+	56	47380720	19730
chr16	47360990	47560990	harbor1	chr16	47387382	47387707	LTR/ERVL	1435	+	162	47387544	26554
chr16	47361018	47561018	harbor1	chr16	47378937	47379349	LTR/ERVL	1613	+	206	47379143	18125
chr16	47361018	47561018	harbor1	chr16	47379357	47379405	LTR/ERVL	1670	+	24	47379381	18363
chr16	47361018	47561018	harbor1	chr16	47379705	47380694	LTR/ERVL	1670	+	494	47380199	19181
chr16	47361018	47561018	harbor1	chr16	47380664	47380776	LTR/ERVL	553	+	56	47380720	19702
chr16	47361018	47561018	harbor1	chr16	47387382	47387707	LTR/ERVL	1435	+	162	47387544	26526
chr16	688378	888378	harbor1	chr16	735073	735423	LTR/ERVL	814	+	175	735248	46870
chr16	688378	888378	harbor1	chr16	735416	735901	LTR/ERVL	1401	+	242	735658	47280
chr16	688378	888378	harbor1	chr16	760974	761306	LTR/ERVL	802	+	166	761140	72762
chr16	1001885	1201885	harbor1	chr16	1067475	1067768	LTR/ERVL	1121	+	146	1067621	65736
chr16	1001885	1201885	harbor1	chr16	1067860	1068025	LTR/ERVL	588	+	82	1067942	66057
chr16	47360574	47560574	harbor1	chr16	47378937	47379349	LTR/ERVL	1613	+	206	47379143	18569
chr16	47360574	47560574	harbor1	chr16	47379357	47379405	LTR/ERVL	1670	+	24	47379381	18807
chr16	47360574	47560574	harbor1	chr16	47379705	47380694	LTR/ERVL	1670	+	494	47380199	19625
chr16	47360574	47560574	harbor1	chr16	47380664	47380776	LTR/ERVL	553	+	56	47380720	20146
chr16	47360574	47560574	harbor1	chr16	47387382	47387707	LTR/ERVL	1435	+	162	47387544	26970
chr16	30253473	30453473	harbor1	chr16	30310607	30310709	LTR/ERVL	2102	+	51	30310658	57185
chr16	30253473	30453473	harbor1	chr16	30310969	30311437	LTR/ERVL	2102	+	234	30311203	57730
chr16	30253473	30453473	harbor1	chr16	30311734	30311816	LTR/ERVL	2102	+	41	30311775	58302
chr16	979342	1179342	harbor1	chr16	1067475	1067768	LTR/ERVL	1121	+	146	1067621	88279
chr16	979342	1179342	harbor1	chr16	1067860	1068025	LTR/ERVL	588	+	82	1067942	88600
chr16	56535629	56735629	harbor1	chr16	56569217	56569578	LTR/ERVL	1174	+	180	56569397	33768
chr16	47149798	47349798	harbor1	chr16	47171768	47172066	LTR/ERVL	703	+	149	47171917	22119
chr16	47149798	47349798	harbor1	chr16	47213609	47214174	LTR/ERVL	2428	+	282	47213891	64093
chr16	47149798	47349798	harbor1	chr16	47236795	47237126	LTR/ERVL	772	+	166	47236961	87163
chr16	47149798	47349798	harbor1	chr16	47244140	47244551	LTR/ERVL	2029	+	206	47244346	94548
chr16	47149798	47349798	harbor1	chr16	47153117	47153341	LTR/ERVL	844	+	112	47153229	3431
chr16	31032745	31232745	harbor1	chr16	31100362	31100712	LTR/ERVL	2556	+	175	31100537	67792
chr16	31032745	31232745	harbor1	chr16	31101019	31101264	LTR/ERVL	2556	+	122	31101141	68396
chr16	79500579	79700579	harbor1	chr16	79514654	79514906	LTR/ERVL	562	+	126	79514780	14201
chr16	79500579	79700579	harbor1	chr16	79555116	79555312	LTR/ERVL	708	+	98	79555214	54635
chr16	31042643	31242643	harbor1	chr16	31100362	31100712	LTR/ERVL	2556	+	175	31100537	57894
chr16	31042643	31242643	harbor1	chr16	31101019	31101264	LTR/ERVL	2556	+	122	31101141	58498
chr16	4718894	4918894	harbor1	chr16	4759487	4759716	LTR/ERVL	719	+	114	4759601	40707
chr16	870548	1070548	harbor1	chr16	906244	906669	LTR/ERVL	2499	+	212	906456	35908
chr16	870915	1070915	harbor1	chr16	906244	906669	LTR/ERVL	2499	+	212	906456	35541
chr16	1872249	2072249	harbor1	chr16	1904421	1904676	LTR/ERVL	696	+	128	1904549	32300
chr16	1872249	2072249	harbor1	chr16	1936811	1937145	LTR/ERVL	1374	+	167	1936978	64729
chr16	18689988	18889988	harbor1	chr16	18698109	18698547	LTR/ERVL	4208	+	219	18698328	8340
chr16	18689988	18889988	harbor1	chr16	18698913	18699359	LTR/ERVL	4208	+	223	18699136	9148
chr16	18689988	18889988	harbor1	chr16	18755216	18755266	LTR/ERVL	2317	+	25	18755241	65253
chr16	18689988	18889988	harbor1	chr16	18755580	18756036	LTR/ERVL	2317	+	228	18755808	65820
chr16	18689988	18889988	harbor1	chr16	18756317	18756378	LTR/ERVL	797	+	30	18756347	66359
chr16	697833	897833	harbor1	chr16	735073	735423	LTR/ERVL	814	+	175	735248	37415
chr16	697833	897833	harbor1	chr16	735416	735901	LTR/ERVL	1401	+	242	735658	37825
chr16	697833	897833	harbor1	chr16	760974	761306	LTR/ERVL	802	+	166	761140	63307
chr16	4084077	4284077	harbor1	chr16	4134690	4134935	LTR/ERVL	1839	+	122	4134812	50735
chr16	4084077	4284077	harbor1	chr16	4135246	4135336	LTR/ERVL	1839	+	45	4135291	51214
chr16	4084077	4284077	harbor1	chr16	4180175	4180381	LTR/ERVL	552	+	103	4180278	96201
chr16	30599212	30799212	harbor1	chr16	30680306	30680546	LTR/ERVL	1208	+	120	30680426	81214
chr16	2721710	2921710	harbor1	chr16	2780281	2780399	LTR/ERVL	591	+	59	2780340	58630
chr16	2721710	2921710	harbor1	chr16	2780448	2780868	LTR/ERVL	1987	+	210	2780658	58948
chr16	28018013	28218013	harbor1	chr16	28084670	28084775	LTR/ERVL	4013	+	52	28084722	66709
chr16	28018013	28218013	harbor1	chr16	28085070	28085858	LTR/ERVL	4013	+	394	28085464	67451
chr16	4084076	4284076	harbor1	chr16	4134690	4134935	LTR/ERVL	1839	+	122	4134812	50736
chr16	4084076	4284076	harbor1	chr16	4135246	4135336	LTR/ERVL	1839	+	45	4135291	51215
chr16	4084076	4284076	harbor1	chr16	4180175	4180381	LTR/ERVL	552	+	103	4180278	96202
chr16	897114	1097114	harbor1	chr16	906244	906669	LTR/ERVL	2499	+	212	906456	9342
chr16	980073	1180073	harbor1	chr16	1067475	1067768	LTR/ERVL	1121	+	146	1067621	87548
chr16	980073	1180073	harbor1	chr16	1067860	1068025	LTR/ERVL	588	+	82	1067942	87869
chr16	700569	900569	harbor1	chr16	735073	735423	LTR/ERVL	814	+	175	735248	34679
chr16	700569	900569	harbor1	chr16	735416	735901	LTR/ERVL	1401	+	242	735658	35089
chr16	700569	900569	harbor1	chr16	760974	761306	LTR/ERVL	802	+	166	761140	60571
chr16	870430	1070430	harbor1	chr16	906244	906669	LTR/ERVL	2499	+	212	906456	36026
chr16	75364612	75564612	harbor1	chr16	75390661	75390972	LTR/ERVL	583	+	156	75390817	26205
chr16	75364612	75564612	harbor1	chr16	75393180	75393382	LTR/ERVL	806	+	101	75393281	28669
chr16	89168748	89368748	harbor1	chr16	89231483	89231837	LTR/ERVL	671	+	177	89231660	62912
chr16	89168748	89368748	harbor1	chr16	89233796	89234135	LTR/ERVL	857	+	170	89233966	65218
chr16	875427	1075427	harbor1	chr16	906244	906669	LTR/ERVL	2499	+	212	906456	31029
chr16	2865156	3065156	harbor1	chr16	2942645	2942720	LTR/ERVL	1819	+	38	2942683	77527
chr16	2865156	3065156	harbor1	chr16	2943001	2943487	LTR/ERVL	1819	+	243	2943244	78088
chr16	89586911	89786911	harbor1	chr16	89676934	89677316	LTR/ERVL	1321	+	191	89677125	90214
chr16	89586911	89786911	harbor1	chr16	89677627	89677660	LTR/ERVL	1321	+	16	89677643	90732
chr16	87748370	87948370	harbor1	chr16	87799466	87800115	LTR/ERVL	2692	+	324	87799790	51420
chr16	2865150	3065150	harbor1	chr16	2942645	2942720	LTR/ERVL	1819	+	38	2942683	77533
chr16	2865150	3065150	harbor1	chr16	2943001	2943487	LTR/ERVL	1819	+	243	2943244	78094
chr17	79709440	79909440	harbor1	chr17	79769823	79770126	LTR/ERVL	599	+	152	79769975	60535
chr17	80933421	81133421	harbor1	chr17	80987451	80987662	LTR/ERVL	607	+	106	80987557	54136
chr17	28783357	28983357	harbor1	chr17	28804112	28804337	LTR/ERVL	1039	+	112	28804224	20867
chr17	79817297	80017297	harbor1	chr17	79888747	79889305	LTR/ERVL	2149	+	279	79889026	71729
chr17	76637323	76837323	harbor1	chr17	76690872	76691732	LTR/ERVL	2986	+	430	76691302	53979
chr17	76637252	76837252	harbor1	chr17	76690872	76691732	LTR/ERVL	2986	+	430	76691302	54050
chr17	79702953	79902953	harbor1	chr17	79769823	79770126	LTR/ERVL	599	+	152	79769975	67022
chr17	55165220	55365220	harbor1	chr17	55176609	55177198	LTR/ERVL	2345	+	294	55176903	11683
chr17	63676342	63876342	harbor1	chr17	63757706	63758391	LTR/ERVL	1729	+	342	63758048	81706
chr17	63676342	63876342	harbor1	chr17	63733557	63734088	LTR/ERVL	3004	+	266	63733823	57481
chr17	80934871	81134871	harbor1	chr17	80987451	80987662	LTR/ERVL	607	+	106	80987557	52686
chr17	80931269	81131269	harbor1	chr17	80987451	80987662	LTR/ERVL	607	+	106	80987557	56288
chr17	987890	1187890	harbor1	chr17	1058948	1059482	LTR/ERVL	1125	+	267	1059215	71325
chr17	74972414	75172414	harbor1	chr17	74985176	74985679	LTR/ERVL	1368	+	252	74985428	13014
chr17	76637238	76837238	harbor1	chr17	76690872	76691732	LTR/ERVL	2986	+	430	76691302	54064
chr17	76637301	76837301	harbor1	chr17	76690872	76691732	LTR/ERVL	2986	+	430	76691302	54001
chr17	76637314	76837314	harbor1	chr17	76690872	76691732	LTR/ERVL	2986	+	430	76691302	53988
chr17	79702897	79902897	harbor1	chr17	79769823	79770126	LTR/ERVL	599	+	152	79769975	67078
chr17	43299144	43499144	harbor1	chr17	43304458	43304875	LTR/ERVL	953	+	208	43304666	5522
chr17	43299144	43499144	harbor1	chr17	43356532	43357143	LTR/ERVL	3096	+	306	43356838	57694
chr17	43299144	43499144	harbor1	chr17	43363466	43363767	LTR/ERVL	782	+	150	43363616	64472
chr17	79702898	79902898	harbor1	chr17	79769823	79770126	LTR/ERVL	599	+	152	79769975	67077
chr17	76637283	76837283	harbor1	chr17	76690872	76691732	LTR/ERVL	2986	+	430	76691302	54019
chr17	79818751	80018751	harbor1	chr17	79888747	79889305	LTR/ERVL	2149	+	279	79889026	70275
chr17	56020599	56220599	harbor1	chr17	56021850	56022373	LTR/ERVL	2862	+	262	56022112	1513
chr17	56020599	56220599	harbor1	chr17	56022411	56022448	LTR/ERVL	2862	+	18	56022429	1830
chr17	80949235	81149235	harbor1	chr17	80987451	80987662	LTR/ERVL	607	+	106	80987557	38322
chr17	7142998	7342998	harbor1	chr17	7148619	7149062	LTR/ERVL	926	+	222	7148841	5843
chr17	7142998	7342998	harbor1	chr17	7149382	7149629	LTR/ERVL	971	+	124	7149506	6508
chr17	7142998	7342998	harbor1	chr17	7149655	7149799	LTR/ERVL	681	+	72	7149727	6729
chr17	7142998	7342998	harbor1	chr17	7150104	7150211	LTR/ERVL	681	+	54	7150158	7160
chr17	7142998	7342998	harbor1	chr17	7160754	7161235	LTR/ERVL	1728	+	240	7160994	17996
chr17	7142998	7342998	harbor1	chr17	7164990	7165410	LTR/ERVL	1201	+	210	7165200	22202
chr17	79702899	79902899	harbor1	chr17	79769823	79770126	LTR/ERVL	599	+	152	79769975	67076
chr17	80934909	81134909	harbor1	chr17	80987451	80987662	LTR/ERVL	607	+	106	80987557	52648
chr17	67266541	67466541	harbor1	chr17	67274373	67274830	LTR/ERVL	2144	+	228	67274601	8060
chr17	80934880	81134880	harbor1	chr17	80987451	80987662	LTR/ERVL	607	+	106	80987557	52677
chr17	79689709	79889709	harbor1	chr17	79769823	79770126	LTR/ERVL	599	+	152	79769975	80266
chr17	82589285	82789285	harbor1	chr17	82641344	82641613	LTR/ERVL	3146	+	134	82641478	52193
chr17	82589285	82789285	harbor1	chr17	82641896	82642150	LTR/ERVL	3146	+	127	82642023	52738
chr17	82589285	82789285	harbor1	chr17	82642465	82642825	LTR/ERVL	3146	+	180	82642645	53360
chr17	79743478	79943478	harbor1	chr17	79769823	79770126	LTR/ERVL	599	+	152	79769975	26497
chr17	76283247	76483247	harbor1	chr17	76365934	76366451	LTR/ERVL	928	+	258	76366192	82945
chr17	50408598	50608598	harbor1	chr17	50505904	50506106	LTR/ERVL	728	+	101	50506005	97407
chr17	76637247	76837247	harbor1	chr17	76690872	76691732	LTR/ERVL	2986	+	430	76691302	54055
chr17	17393446	17593446	harbor1	chr17	17417877	17418549	LTR/ERVL	3383	+	336	17418213	24767
chr17	30610000	30810000	harbor1	chr17	30677573	30677954	LTR/ERVL	869	+	190	30677763	67763
chr17	79696398	79896398	harbor1	chr17	79769823	79770126	LTR/ERVL	599	+	152	79769975	73577
chr17	80933241	81133241	harbor1	chr17	80987451	80987662	LTR/ERVL	607	+	106	80987557	54316
chr17	15555287	15755287	harbor1	chr17	15603253	15603451	LTR/ERVL	927	+	99	15603352	48065
chr17	80934865	81134865	harbor1	chr17	80987451	80987662	LTR/ERVL	607	+	106	80987557	52692
chr17	80934914	81134914	harbor1	chr17	80987451	80987662	LTR/ERVL	607	+	106	80987557	52643
chr17	76283501	76483501	harbor1	chr17	76365934	76366451	LTR/ERVL	928	+	258	76366192	82691
chr17	33191683	33391683	harbor1	chr17	33207600	33208037	LTR/ERVL	1682	+	218	33207818	16135
chr17	75105495	75305495	harbor1	chr17	75134204	75134325	LTR/ERVL	877	+	60	75134264	28769
chr17	75105495	75305495	harbor1	chr17	75134622	75134700	LTR/ERVL	877	+	39	75134661	29166
chr17	75105495	75305495	harbor1	chr17	75142909	75143277	LTR/ERVL	1525	+	184	75143093	37598
chr17	75105495	75305495	harbor1	chr17	75144031	75144241	LTR/ERVL	2352	+	105	75144136	38641
chr17	75105495	75305495	harbor1	chr17	75144530	75144918	LTR/ERVL	2352	+	194	75144724	39229
chr17	33191705	33391705	harbor1	chr17	33207600	33208037	LTR/ERVL	1682	+	218	33207818	16113
chr17	43590747	43790747	harbor1	chr17	43624654	43625150	LTR/ERVL	2423	+	248	43624902	34155
chr17	78477092	78677092	harbor1	chr17	78531871	78532394	LTR/ERVL	2425	+	262	78532133	55041
chr17	78477092	78677092	harbor1	chr17	78533643	78533688	LTR/ERVL	965	+	22	78533665	56573
chr17	78477092	78677092	harbor1	chr17	78533986	78534231	LTR/ERVL	965	+	122	78534108	57016
chr17	78477092	78677092	harbor1	chr17	78555655	78556131	LTR/ERVL	1734	+	238	78555893	78801
chr17	286286	486286	harbor1	chr17	297083	297661	LTR/ERVL	1861	+	289	297372	11086
chr17	57767550	57967550	harbor1	chr17	57802266	57802715	LTR/ERVL	1313	+	224	57802490	34940
chr17	57767550	57967550	harbor1	chr17	57817339	57817660	LTR/ERVL	1059	+	160	57817499	49949
chr17	57767550	57967550	harbor1	chr17	57818024	57818390	LTR/ERVL	842	+	183	57818207	50657
chr17	57767550	57967550	harbor1	chr17	57818386	57818753	LTR/ERVL	1156	+	184	57818570	51020
chr17	57767550	57967550	harbor1	chr17	57818849	57819235	LTR/ERVL	1224	+	193	57819042	51492
chr17	987847	1187847	harbor1	chr17	1058948	1059482	LTR/ERVL	1125	+	267	1059215	71368
chr17	80949194	81149194	harbor1	chr17	80987451	80987662	LTR/ERVL	607	+	106	80987557	38363
chr17	80928173	81128173	harbor1	chr17	80987451	80987662	LTR/ERVL	607	+	106	80987557	59384
chr17	41516785	41716785	harbor1	chr17	41547226	41547536	LTR/ERVL	643	+	155	41547381	30596
chr17	41516785	41716785	harbor1	chr17	41560938	41560995	LTR/ERVL	647	+	28	41560966	44181
chr17	41516785	41716785	harbor1	chr17	41561307	41561541	LTR/ERVL	647	+	117	41561424	44639
chr17	987852	1187852	harbor1	chr17	1058948	1059482	LTR/ERVL	1125	+	267	1059215	71363
chr17	79702893	79902893	harbor1	chr17	79769823	79770126	LTR/ERVL	599	+	152	79769975	67082
chr17	79702970	79902970	harbor1	chr17	79769823	79770126	LTR/ERVL	599	+	152	79769975	67005
chr17	15134573	15334573	harbor1	chr17	15151983	15152486	LTR/ERVL	1971	+	252	15152235	17662
chr17	15134573	15334573	harbor1	chr17	15184873	15184938	LTR/ERVL	640	+	32	15184905	50332
chr17	15134573	15334573	harbor1	chr17	15185469	15185649	LTR/ERVL	640	+	90	15185559	50986
chr17	80934866	81134866	harbor1	chr17	80987451	80987662	LTR/ERVL	607	+	106	80987557	52691
chr17	79689289	79889289	harbor1	chr17	79769823	79770126	LTR/ERVL	599	+	152	79769975	80686
chr17	76636928	76836928	harbor1	chr17	76690872	76691732	LTR/ERVL	2986	+	430	76691302	54374
chr17	6918778	7118778	harbor1	chr17	6964461	6964688	LTR/ERVL	2403	+	114	6964575	45797
chr17	6918778	7118778	harbor1	chr17	6964967	6965223	LTR/ERVL	2403	+	128	6965095	46317
chr17	76637263	76837263	harbor1	chr17	76690872	76691732	LTR/ERVL	2986	+	430	76691302	54039
chr17	79689683	79889683	harbor1	chr17	79769823	79770126	LTR/ERVL	599	+	152	79769975	80292
chr17	76283274	76483274	harbor1	chr17	76365934	76366451	LTR/ERVL	928	+	258	76366192	82918
chr17	33191648	33391648	harbor1	chr17	33207600	33208037	LTR/ERVL	1682	+	218	33207818	16170
chr17	77858865	78058865	harbor1	chr17	77867281	77867806	LTR/ERVL	2829	+	262	77867543	8678
chr17	77858865	78058865	harbor1	chr17	77941055	77941434	LTR/ERVL	1175	+	190	77941245	82380
chr17	77858865	78058865	harbor1	chr17	77941729	77941746	LTR/ERVL	1175	+	8	77941737	82872
chr17	80934923	81134923	harbor1	chr17	80987451	80987662	LTR/ERVL	607	+	106	80987557	52634
chr17	79689660	79889660	harbor1	chr17	79769823	79770126	LTR/ERVL	599	+	152	79769975	80315
chr17	45358313	45558313	harbor1	chr17	45389246	45389658	LTR/ERVL	1045	+	206	45389452	31139
chr17	30610045	30810045	harbor1	chr17	30677573	30677954	LTR/ERVL	869	+	190	30677763	67718
chr17	48808683	49008683	harbor1	chr17	48883156	48883375	LTR/ERVL	733	+	110	48883266	74583
chr17	30994986	31194986	harbor1	chr17	30999443	30999979	LTR/ERVL	2575	+	268	30999711	4725
chr17	30994986	31194986	harbor1	chr17	31075123	31075553	LTR/ERVL	1115	+	215	31075338	80352
chr17	28784220	28984220	harbor1	chr17	28804112	28804337	LTR/ERVL	1039	+	112	28804224	20004
chr17	7079598	7279598	harbor1	chr17	7123610	7124135	LTR/ERVL	2525	+	262	7123872	44274
chr17	7079598	7279598	harbor1	chr17	7148619	7149062	LTR/ERVL	926	+	222	7148841	69243
chr17	7079598	7279598	harbor1	chr17	7149382	7149629	LTR/ERVL	971	+	124	7149506	69908
chr17	7079598	7279598	harbor1	chr17	7149655	7149799	LTR/ERVL	681	+	72	7149727	70129
chr17	7079598	7279598	harbor1	chr17	7150104	7150211	LTR/ERVL	681	+	54	7150158	70560
chr17	7079598	7279598	harbor1	chr17	7160754	7161235	LTR/ERVL	1728	+	240	7160994	81396
chr17	7079598	7279598	harbor1	chr17	7164990	7165410	LTR/ERVL	1201	+	210	7165200	85602
chr17	80949213	81149213	harbor1	chr17	80987451	80987662	LTR/ERVL	607	+	106	80987557	38344
chr17	987876	1187876	harbor1	chr17	1058948	1059482	LTR/ERVL	1125	+	267	1059215	71339
chr17	76637321	76837321	harbor1	chr17	76690872	76691732	LTR/ERVL	2986	+	430	76691302	53981
chr17	15161857	15361857	harbor1	chr17	15184873	15184938	LTR/ERVL	640	+	32	15184905	23048
chr17	15161857	15361857	harbor1	chr17	15185469	15185649	LTR/ERVL	640	+	90	15185559	23702
chr17	1990653	2190653	harbor1	chr17	2013333	2013571	LTR/ERVL	887	+	119	2013452	22799
chr17	1990653	2190653	harbor1	chr17	2013842	2014102	LTR/ERVL	933	+	130	2013972	23319
chr17	9856590	10056590	harbor1	chr17	9900252	9900688	LTR/ERVL	1062	+	218	9900470	43880
chr18	26126454	26326454	harbor1	chr18	26128164	26128552	LTR/ERVL	3226	+	194	26128358	1904
chr18	26126454	26326454	harbor1	chr18	26128647	26128681	LTR/ERVL	3226	+	17	26128664	2210
chr18	26126454	26326454	harbor1	chr18	26210262	26210691	LTR/ERVL	2476	+	214	26210476	84022
chr18	26126454	26326454	harbor1	chr18	26210728	26210776	LTR/ERVL	2476	+	24	26210752	84298
chr18	26126454	26326454	harbor1	chr18	26212511	26212656	LTR/ERVL	604	+	72	26212583	86129
chr18	37465330	37665330	harbor1	chr18	37474783	37475253	LTR/ERVL	1680	+	235	37475018	9688
chr18	26126532	26326532	harbor1	chr18	26128164	26128552	LTR/ERVL	3226	+	194	26128358	1826
chr18	26126532	26326532	harbor1	chr18	26128647	26128681	LTR/ERVL	3226	+	17	26128664	2132
chr18	26126532	26326532	harbor1	chr18	26210262	26210691	LTR/ERVL	2476	+	214	26210476	83944
chr18	26126532	26326532	harbor1	chr18	26210728	26210776	LTR/ERVL	2476	+	24	26210752	84220
chr18	26126532	26326532	harbor1	chr18	26212511	26212656	LTR/ERVL	604	+	72	26212583	86051
chr18	49713903	49913903	harbor1	chr18	49746296	49746627	LTR/ERVL	909	+	166	49746462	32559
chr18	49713903	49913903	harbor1	chr18	49747029	49747652	LTR/ERVL	2999	+	312	49747341	33438
chr18	49713903	49913903	harbor1	chr18	49781993	49782311	LTR/ERVL	566	+	159	49782152	68249
chr18	26126502	26326502	harbor1	chr18	26128164	26128552	LTR/ERVL	3226	+	194	26128358	1856
chr18	26126502	26326502	harbor1	chr18	26128647	26128681	LTR/ERVL	3226	+	17	26128664	2162
chr18	26126502	26326502	harbor1	chr18	26210262	26210691	LTR/ERVL	2476	+	214	26210476	83974
chr18	26126502	26326502	harbor1	chr18	26210728	26210776	LTR/ERVL	2476	+	24	26210752	84250
chr18	26126502	26326502	harbor1	chr18	26212511	26212656	LTR/ERVL	604	+	72	26212583	86081
chr18	31997343	32197343	harbor1	chr18	32081713	32081799	LTR/ERVL	564	+	43	32081756	84413
chr18	31997343	32197343	harbor1	chr18	32087088	32087213	LTR/ERVL	768	+	62	32087150	89807
chr18	31997343	32197343	harbor1	chr18	32087266	32087640	LTR/ERVL	2244	+	187	32087453	90110
chr18	31997343	32197343	harbor1	chr18	32087650	32088072	LTR/ERVL	1892	+	211	32087861	90518
chr18	26126451	26326451	harbor1	chr18	26128164	26128552	LTR/ERVL	3226	+	194	26128358	1907
chr18	26126451	26326451	harbor1	chr18	26128647	26128681	LTR/ERVL	3226	+	17	26128664	2213
chr18	26126451	26326451	harbor1	chr18	26210262	26210691	LTR/ERVL	2476	+	214	26210476	84025
chr18	26126451	26326451	harbor1	chr18	26210728	26210776	LTR/ERVL	2476	+	24	26210752	84301
chr18	26126451	26326451	harbor1	chr18	26212511	26212656	LTR/ERVL	604	+	72	26212583	86132
chr18	26126452	26326452	harbor1	chr18	26128164	26128552	LTR/ERVL	3226	+	194	26128358	1906
chr18	26126452	26326452	harbor1	chr18	26128647	26128681	LTR/ERVL	3226	+	17	26128664	2212
chr18	26126452	26326452	harbor1	chr18	26210262	26210691	LTR/ERVL	2476	+	214	26210476	84024
chr18	26126452	26326452	harbor1	chr18	26210728	26210776	LTR/ERVL	2476	+	24	26210752	84300
chr18	26126452	26326452	harbor1	chr18	26212511	26212656	LTR/ERVL	604	+	72	26212583	86131
chr18	74356692	74556692	harbor1	chr18	74392196	74392541	LTR/ERVL	1251	+	172	74392368	35676
chr18	74356692	74556692	harbor1	chr18	74395368	74395438	LTR/ERVL	448	+	35	74395403	38711
chr18	74356692	74556692	harbor1	chr18	74420352	74420900	LTR/ERVL	2150	+	274	74420626	63934
chr18	74356692	74556692	harbor1	chr18	74430294	74430700	LTR/ERVL	2405	+	203	74430497	73805
chr18	74356692	74556692	harbor1	chr18	74431307	74431346	LTR/ERVL	2405	+	20	74431327	74635
chr18	74356714	74556714	harbor1	chr18	74392196	74392541	LTR/ERVL	1251	+	172	74392368	35654
chr18	74356714	74556714	harbor1	chr18	74395368	74395438	LTR/ERVL	448	+	35	74395403	38689
chr18	74356714	74556714	harbor1	chr18	74420352	74420900	LTR/ERVL	2150	+	274	74420626	63912
chr18	74356714	74556714	harbor1	chr18	74430294	74430700	LTR/ERVL	2405	+	203	74430497	73783
chr18	74356714	74556714	harbor1	chr18	74431307	74431346	LTR/ERVL	2405	+	20	74431327	74613
chr18	23734554	23934554	harbor1	chr18	23735911	23736055	LTR/ERVL	442	+	72	23735983	1429
chr18	74356712	74556712	harbor1	chr18	74392196	74392541	LTR/ERVL	1251	+	172	74392368	35656
chr18	74356712	74556712	harbor1	chr18	74395368	74395438	LTR/ERVL	448	+	35	74395403	38691
chr18	74356712	74556712	harbor1	chr18	74420352	74420900	LTR/ERVL	2150	+	274	74420626	63914
chr18	74356712	74556712	harbor1	chr18	74430294	74430700	LTR/ERVL	2405	+	203	74430497	73785
chr18	74356712	74556712	harbor1	chr18	74431307	74431346	LTR/ERVL	2405	+	20	74431327	74615
chr18	26126453	26326453	harbor1	chr18	26128164	26128552	LTR/ERVL	3226	+	194	26128358	1905
chr18	26126453	26326453	harbor1	chr18	26128647	26128681	LTR/ERVL	3226	+	17	26128664	2211
chr18	26126453	26326453	harbor1	chr18	26210262	26210691	LTR/ERVL	2476	+	214	26210476	84023
chr18	26126453	26326453	harbor1	chr18	26210728	26210776	LTR/ERVL	2476	+	24	26210752	84299
chr18	26126453	26326453	harbor1	chr18	26212511	26212656	LTR/ERVL	604	+	72	26212583	86130
chr18	37465383	37665383	harbor1	chr18	37474783	37475253	LTR/ERVL	1680	+	235	37475018	9635
chr18	75105267	75305267	harbor1	chr18	75123144	75123562	LTR/ERVL	597	+	209	75123353	18086
chr18	75105267	75305267	harbor1	chr18	75135636	75135846	LTR/ERVL	833	+	105	75135741	30474
chr18	75105267	75305267	harbor1	chr18	75136097	75136235	LTR/ERVL	484	+	69	75136166	30899
chr18	75105267	75305267	harbor1	chr18	75136540	75136562	LTR/ERVL	484	+	11	75136551	31284
chr18	75105267	75305267	harbor1	chr18	75136597	75136625	LTR/ERVL	484	+	14	75136611	31344
chr18	75105267	75305267	harbor1	chr18	75176480	75176954	LTR/ERVL	2032	+	237	75176717	71450
chr18	57486434	57686434	harbor1	chr18	57498792	57498882	LTR/ERVL	435	+	45	57498837	12403
chr18	57486434	57686434	harbor1	chr18	57502474	57502923	LTR/ERVL	771	+	224	57502698	16264
chr18	57486434	57686434	harbor1	chr18	57526439	57527019	LTR/ERVL	2086	+	290	57526729	40295
chr18	59165754	59365754	harbor1	chr18	59212065	59212161	LTR/ERVL	1922	+	48	59212113	46359
chr18	59165754	59365754	harbor1	chr18	59211659	59212008	LTR/ERVL	1922	+	174	59211833	46079
chr18	11589068	11789068	harbor1	chr18	11677907	11678305	LTR/ERVL	896	+	199	11678106	89038
chr18	12207967	12407967	harbor1	chr18	12281922	12282061	LTR/ERVL	2916	+	70	12281992	74025
chr18	12207967	12407967	harbor1	chr18	12282355	12283069	LTR/ERVL	2916	+	357	12282712	74745
chr18	12207967	12407967	harbor1	chr18	12283107	12283438	LTR/ERVL	1373	+	166	12283273	75306
chr18	65651295	65851295	harbor1	chr18	65651259	65651420	LTR/ERVL	1816	+	80	65651339	44
chr18	65651295	65851295	harbor1	chr18	65651859	65652216	LTR/ERVL	1816	+	178	65652037	742
chr18	65651295	65851295	harbor1	chr18	65652249	65652307	LTR/ERVL	727	+	29	65652278	983
chr18	74356740	74556740	harbor1	chr18	74392196	74392541	LTR/ERVL	1251	+	172	74392368	35628
chr18	74356740	74556740	harbor1	chr18	74395368	74395438	LTR/ERVL	448	+	35	74395403	38663
chr18	74356740	74556740	harbor1	chr18	74420352	74420900	LTR/ERVL	2150	+	274	74420626	63886
chr18	74356740	74556740	harbor1	chr18	74430294	74430700	LTR/ERVL	2405	+	203	74430497	73757
chr18	74356740	74556740	harbor1	chr18	74431307	74431346	LTR/ERVL	2405	+	20	74431327	74587
chr18	59165766	59365766	harbor1	chr18	59212065	59212161	LTR/ERVL	1922	+	48	59212113	46347
chr18	59165766	59365766	harbor1	chr18	59211659	59212008	LTR/ERVL	1922	+	174	59211833	46067
chr18	59165800	59365800	harbor1	chr18	59212065	59212161	LTR/ERVL	1922	+	48	59212113	46313
chr18	59165800	59365800	harbor1	chr18	59211659	59212008	LTR/ERVL	1922	+	174	59211833	46033
chr18	65651274	65851274	harbor1	chr18	65651259	65651420	LTR/ERVL	1816	+	80	65651339	65
chr18	65651274	65851274	harbor1	chr18	65651859	65652216	LTR/ERVL	1816	+	178	65652037	763
chr18	65651274	65851274	harbor1	chr18	65652249	65652307	LTR/ERVL	727	+	29	65652278	1004
chr19	19675843	19875843	harbor1	chr19	19760002	19760027	LTR/ERVL	1863	+	12	19760014	84171
chr19	19675843	19875843	harbor1	chr19	19760320	19760792	LTR/ERVL	1863	+	236	19760556	84713
chr19	19675843	19875843	harbor1	chr19	19761109	19761520	LTR/ERVL	4637	+	206	19761315	85472
chr19	19675843	19875843	harbor1	chr19	19761837	19761960	LTR/ERVL	4637	+	62	19761899	86056
chr19	19675843	19875843	harbor1	chr19	19762256	19762865	LTR/ERVL	4637	+	304	19762560	86717
chr19	19675843	19875843	harbor1	chr19	19763222	19763463	LTR/ERVL	3870	+	120	19763342	87499
chr19	19675843	19875843	harbor1	chr19	19764169	19764818	LTR/ERVL	3870	+	324	19764493	88650
chr19	49461215	49661215	harbor1	chr19	49509744	49509855	LTR/ERVL	800	+	56	49509800	48585
chr19	49461215	49661215	harbor1	chr19	49510131	49510236	LTR/ERVL	800	+	52	49510183	48968
chr19	49461215	49661215	harbor1	chr19	49510539	49510614	LTR/ERVL	800	+	38	49510577	49362
chr19	49461215	49661215	harbor1	chr19	49510895	49511160	LTR/ERVL	800	+	132	49511027	49812
chr19	9669009	9869009	harbor1	chr19	9671526	9671970	LTR/ERVL	973	+	222	9671748	2739
chr19	9669009	9869009	harbor1	chr19	9731507	9731729	LTR/ERVL	688	+	111	9731618	62609
chr19	19675720	19875720	harbor1	chr19	19760002	19760027	LTR/ERVL	1863	+	12	19760014	84294
chr19	19675720	19875720	harbor1	chr19	19760320	19760792	LTR/ERVL	1863	+	236	19760556	84836
chr19	19675720	19875720	harbor1	chr19	19761109	19761520	LTR/ERVL	4637	+	206	19761315	85595
chr19	19675720	19875720	harbor1	chr19	19761837	19761960	LTR/ERVL	4637	+	62	19761899	86179
chr19	19675720	19875720	harbor1	chr19	19762256	19762865	LTR/ERVL	4637	+	304	19762560	86840
chr19	19675720	19875720	harbor1	chr19	19763222	19763463	LTR/ERVL	3870	+	120	19763342	87622
chr19	19675720	19875720	harbor1	chr19	19764169	19764818	LTR/ERVL	3870	+	324	19764493	88773
chr19	56021024	56221024	harbor1	chr19	56071522	56071948	LTR/ERVL	1621	+	213	56071735	50711
chr19	10618449	10818449	harbor1	chr19	10646676	10646776	LTR/ERVL	1468	+	50	10646726	28277
chr19	10618449	10818449	harbor1	chr19	10647048	10647454	LTR/ERVL	1468	+	203	10647251	28802
chr19	10618445	10818445	harbor1	chr19	10646676	10646776	LTR/ERVL	1468	+	50	10646726	28281
chr19	10618445	10818445	harbor1	chr19	10647048	10647454	LTR/ERVL	1468	+	203	10647251	28806
chr19	10618454	10818454	harbor1	chr19	10646676	10646776	LTR/ERVL	1468	+	50	10646726	28272
chr19	10618454	10818454	harbor1	chr19	10647048	10647454	LTR/ERVL	1468	+	203	10647251	28797
chr19	18894675	19094675	harbor1	chr19	18976719	18976788	LTR/ERVL	914	+	34	18976753	82078
chr19	18894675	19094675	harbor1	chr19	18977090	18977265	LTR/ERVL	914	+	88	18977178	82503
chr19	35101286	35301286	harbor1	chr19	35173816	35174053	LTR/ERVL	776	+	118	35173934	72648
chr19	35101286	35301286	harbor1	chr19	35179191	35179552	LTR/ERVL	2206	+	180	35179371	78085
chr19	35101286	35301286	harbor1	chr19	35179864	35180103	LTR/ERVL	2206	+	120	35179984	78698
chr19	35101286	35301286	harbor1	chr19	35180160	35180210	LTR/ERVL	4651	+	25	35180185	78899
chr19	35101286	35301286	harbor1	chr19	35180521	35181581	LTR/ERVL	4651	+	530	35181051	79765
chr19	35101286	35301286	harbor1	chr19	35181919	35182123	LTR/ERVL	952	+	102	35182021	80735
chr19	35101286	35301286	harbor1	chr19	35185038	35185218	LTR/ERVL	855	+	90	35185128	83842
chr19	35101286	35301286	harbor1	chr19	35196745	35196781	LTR/ERVL	3679	+	18	35196763	95477
chr19	35101286	35301286	harbor1	chr19	35197446	35198141	LTR/ERVL	3679	+	348	35197794	96508
chr19	35101286	35301286	harbor1	chr19	35198332	35198426	LTR/ERVL	1416	+	47	35198379	97093
chr19	35101286	35301286	harbor1	chr19	35198739	35199045	LTR/ERVL	1416	+	153	35198892	97606
chr19	19676004	19876004	harbor1	chr19	19760002	19760027	LTR/ERVL	1863	+	12	19760014	84010
chr19	19676004	19876004	harbor1	chr19	19760320	19760792	LTR/ERVL	1863	+	236	19760556	84552
chr19	19676004	19876004	harbor1	chr19	19761109	19761520	LTR/ERVL	4637	+	206	19761315	85311
chr19	19676004	19876004	harbor1	chr19	19761837	19761960	LTR/ERVL	4637	+	62	19761899	85895
chr19	19676004	19876004	harbor1	chr19	19762256	19762865	LTR/ERVL	4637	+	304	19762560	86556
chr19	19676004	19876004	harbor1	chr19	19763222	19763463	LTR/ERVL	3870	+	120	19763342	87338
chr19	19676004	19876004	harbor1	chr19	19764169	19764818	LTR/ERVL	3870	+	324	19764493	88489
chr19	2710214	2910214	harbor1	chr19	2733975	2734322	LTR/ERVL	1498	+	174	2734149	23935
chr19	2710214	2910214	harbor1	chr19	2737707	2737870	LTR/ERVL	1095	+	82	2737789	27575
chr19	2710214	2910214	harbor1	chr19	2761932	2762235	LTR/ERVL	1060	+	152	2762084	51870
chr19	2710214	2910214	harbor1	chr19	2763312	2763580	LTR/ERVL	715	+	134	2763446	53232
chr19	10618489	10818489	harbor1	chr19	10646676	10646776	LTR/ERVL	1468	+	50	10646726	28237
chr19	10618489	10818489	harbor1	chr19	10647048	10647454	LTR/ERVL	1468	+	203	10647251	28762
chr19	10618492	10818492	harbor1	chr19	10646676	10646776	LTR/ERVL	1468	+	50	10646726	28234
chr19	10618492	10818492	harbor1	chr19	10647048	10647454	LTR/ERVL	1468	+	203	10647251	28759
chr19	19563965	19763965	harbor1	chr19	19602727	19603269	LTR/ERVL	2296	+	271	19602998	39033
chr19	35166986	35366986	harbor1	chr19	35173816	35174053	LTR/ERVL	776	+	118	35173934	6948
chr19	35166986	35366986	harbor1	chr19	35179191	35179552	LTR/ERVL	2206	+	180	35179371	12385
chr19	35166986	35366986	harbor1	chr19	35179864	35180103	LTR/ERVL	2206	+	120	35179984	12998
chr19	35166986	35366986	harbor1	chr19	35180160	35180210	LTR/ERVL	4651	+	25	35180185	13199
chr19	35166986	35366986	harbor1	chr19	35180521	35181581	LTR/ERVL	4651	+	530	35181051	14065
chr19	35166986	35366986	harbor1	chr19	35181919	35182123	LTR/ERVL	952	+	102	35182021	15035
chr19	35166986	35366986	harbor1	chr19	35185038	35185218	LTR/ERVL	855	+	90	35185128	18142
chr19	35166986	35366986	harbor1	chr19	35196745	35196781	LTR/ERVL	3679	+	18	35196763	29777
chr19	35166986	35366986	harbor1	chr19	35197446	35198141	LTR/ERVL	3679	+	348	35197794	30808
chr19	35166986	35366986	harbor1	chr19	35198332	35198426	LTR/ERVL	1416	+	47	35198379	31393
chr19	35166986	35366986	harbor1	chr19	35198739	35199045	LTR/ERVL	1416	+	153	35198892	31906
chr19	2710232	2910232	harbor1	chr19	2733975	2734322	LTR/ERVL	1498	+	174	2734149	23917
chr19	2710232	2910232	harbor1	chr19	2737707	2737870	LTR/ERVL	1095	+	82	2737789	27557
chr19	2710232	2910232	harbor1	chr19	2761932	2762235	LTR/ERVL	1060	+	152	2762084	51852
chr19	2710232	2910232	harbor1	chr19	2763312	2763580	LTR/ERVL	715	+	134	2763446	53214
chr19	19676749	19876749	harbor1	chr19	19760002	19760027	LTR/ERVL	1863	+	12	19760014	83265
chr19	19676749	19876749	harbor1	chr19	19760320	19760792	LTR/ERVL	1863	+	236	19760556	83807
chr19	19676749	19876749	harbor1	chr19	19761109	19761520	LTR/ERVL	4637	+	206	19761315	84566
chr19	19676749	19876749	harbor1	chr19	19761837	19761960	LTR/ERVL	4637	+	62	19761899	85150
chr19	19676749	19876749	harbor1	chr19	19762256	19762865	LTR/ERVL	4637	+	304	19762560	85811
chr19	19676749	19876749	harbor1	chr19	19763222	19763463	LTR/ERVL	3870	+	120	19763342	86593
chr19	19676749	19876749	harbor1	chr19	19764169	19764818	LTR/ERVL	3870	+	324	19764493	87744
chr19	56018924	56218924	harbor1	chr19	56071522	56071948	LTR/ERVL	1621	+	213	56071735	52811
chr19	19675652	19875652	harbor1	chr19	19760002	19760027	LTR/ERVL	1863	+	12	19760014	84362
chr19	19675652	19875652	harbor1	chr19	19760320	19760792	LTR/ERVL	1863	+	236	19760556	84904
chr19	19675652	19875652	harbor1	chr19	19761109	19761520	LTR/ERVL	4637	+	206	19761315	85663
chr19	19675652	19875652	harbor1	chr19	19761837	19761960	LTR/ERVL	4637	+	62	19761899	86247
chr19	19675652	19875652	harbor1	chr19	19762256	19762865	LTR/ERVL	4637	+	304	19762560	86908
chr19	19675652	19875652	harbor1	chr19	19763222	19763463	LTR/ERVL	3870	+	120	19763342	87690
chr19	19675652	19875652	harbor1	chr19	19764169	19764818	LTR/ERVL	3870	+	324	19764493	88841
chr19	19563648	19763648	harbor1	chr19	19602727	19603269	LTR/ERVL	2296	+	271	19602998	39350
chr19	41922838	42122838	harbor1	chr19	41955919	41956506	LTR/ERVL	1603	+	294	41956213	33375
chr19	41922838	42122838	harbor1	chr19	42000883	42001196	LTR/ERVL	1490	+	156	42001039	78201
chr19	10618444	10818444	harbor1	chr19	10646676	10646776	LTR/ERVL	1468	+	50	10646726	28282
chr19	10618444	10818444	harbor1	chr19	10647048	10647454	LTR/ERVL	1468	+	203	10647251	28807
chr19	19675776	19875776	harbor1	chr19	19760002	19760027	LTR/ERVL	1863	+	12	19760014	84238
chr19	19675776	19875776	harbor1	chr19	19760320	19760792	LTR/ERVL	1863	+	236	19760556	84780
chr19	19675776	19875776	harbor1	chr19	19761109	19761520	LTR/ERVL	4637	+	206	19761315	85539
chr19	19675776	19875776	harbor1	chr19	19761837	19761960	LTR/ERVL	4637	+	62	19761899	86123
chr19	19675776	19875776	harbor1	chr19	19762256	19762865	LTR/ERVL	4637	+	304	19762560	86784
chr19	19675776	19875776	harbor1	chr19	19763222	19763463	LTR/ERVL	3870	+	120	19763342	87566
chr19	19675776	19875776	harbor1	chr19	19764169	19764818	LTR/ERVL	3870	+	324	19764493	88717
chr19	9484484	9684484	harbor1	chr19	9487877	9487952	LTR/ERVL	691	+	38	9487915	3431
chr19	9484484	9684484	harbor1	chr19	9488377	9488750	LTR/ERVL	691	+	186	9488563	4079
chr19	9484484	9684484	harbor1	chr19	9490046	9490508	LTR/ERVL	1071	+	231	9490277	5793
chr19	9484484	9684484	harbor1	chr19	9492439	9493362	LTR/ERVL	2159	+	462	9492901	8417
chr19	9484484	9684484	harbor1	chr19	9493656	9493848	LTR/ERVL	2159	+	96	9493752	9268
chr19	9484484	9684484	harbor1	chr19	9570284	9570558	LTR/ERVL	1305	+	137	9570421	85937
chr19	9484484	9684484	harbor1	chr19	9570881	9571095	LTR/ERVL	1305	+	107	9570988	86504
chr19	9484484	9684484	harbor1	chr19	9571415	9571752	LTR/ERVL	881	+	168	9571583	87099
chr19	9484484	9684484	harbor1	chr19	9580560	9580947	LTR/ERVL	903	+	194	9580754	96270
chr19	19952525	20152525	harbor1	chr19	19957701	19958100	LTR/ERVL	3355	+	200	19957901	5376
chr19	19952525	20152525	harbor1	chr19	19958164	19958689	LTR/ERVL	4031	+	262	19958426	5901
chr19	19952525	20152525	harbor1	chr19	19959694	19959789	LTR/ERVL	4031	+	48	19959742	7217
chr19	19952525	20152525	harbor1	chr19	19959790	19961467	LTR/ERVL	12830	+	838	19960628	8103
chr19	19952525	20152525	harbor1	chr19	19962598	19962713	LTR/ERVL	793	+	58	19962656	10131
chr19	19952525	20152525	harbor1	chr19	19962700	19964290	LTR/ERVL	11117	+	795	19963495	10970
chr19	19952525	20152525	harbor1	chr19	19964291	19964935	LTR/ERVL	3797	+	322	19964613	12088
chr19	317396	517396	harbor1	chr19	348520	348786	LTR/ERVL	735	+	133	348653	31257
chr19	1960150	2160150	harbor1	chr19	2001514	2001743	LTR/ERVL	803	+	114	2001628	41478
chr19	1960150	2160150	harbor1	chr19	2002039	2002069	LTR/ERVL	803	+	15	2002054	41904
chr19	1960150	2160150	harbor1	chr19	2002361	2002592	LTR/ERVL	803	+	116	2002477	42327
chr19	1960150	2160150	harbor1	chr19	2002905	2003009	LTR/ERVL	803	+	52	2002957	42807
chr19	12451258	12651258	harbor1	chr19	12470569	12470646	LTR/ERVL	1269	+	38	12470607	19349
chr19	12451258	12651258	harbor1	chr19	12470943	12471214	LTR/ERVL	1269	+	136	12471079	19821
chr19	12451258	12651258	harbor1	chr19	12502034	12502299	LTR/ERVL	933	+	132	12502166	50908
chr19	12451258	12651258	harbor1	chr19	12502351	12502673	LTR/ERVL	994	+	161	12502512	51254
chr19	12451258	12651258	harbor1	chr19	12517690	12517879	LTR/ERVL	2263	+	94	12517784	66526
chr19	12451258	12651258	harbor1	chr19	12544391	12544862	LTR/ERVL	2179	+	236	12544627	93369
chr19	12451258	12651258	harbor1	chr19	12517029	12517379	LTR/ERVL	2263	+	175	12517204	65946
chr19	10618507	10818507	harbor1	chr19	10646676	10646776	LTR/ERVL	1468	+	50	10646726	28219
chr19	10618507	10818507	harbor1	chr19	10647048	10647454	LTR/ERVL	1468	+	203	10647251	28744
chr19	9728412	9928412	harbor1	chr19	9731507	9731729	LTR/ERVL	688	+	111	9731618	3206
chr19	19675868	19875868	harbor1	chr19	19760002	19760027	LTR/ERVL	1863	+	12	19760014	84146
chr19	19675868	19875868	harbor1	chr19	19760320	19760792	LTR/ERVL	1863	+	236	19760556	84688
chr19	19675868	19875868	harbor1	chr19	19761109	19761520	LTR/ERVL	4637	+	206	19761315	85447
chr19	19675868	19875868	harbor1	chr19	19761837	19761960	LTR/ERVL	4637	+	62	19761899	86031
chr19	19675868	19875868	harbor1	chr19	19762256	19762865	LTR/ERVL	4637	+	304	19762560	86692
chr19	19675868	19875868	harbor1	chr19	19763222	19763463	LTR/ERVL	3870	+	120	19763342	87474
chr19	19675868	19875868	harbor1	chr19	19764169	19764818	LTR/ERVL	3870	+	324	19764493	88625
chr19	190676	390676	harbor1	chr19	206165	206670	LTR/ERVL	3544	+	252	206417	15741
chr19	190676	390676	harbor1	chr19	206978	207047	LTR/ERVL	3544	+	34	207012	16336
chr19	190676	390676	harbor1	chr19	207351	207651	LTR/ERVL	3544	+	150	207501	16825
chr19	190676	390676	harbor1	chr19	217941	218198	LTR/ERVL	3577	+	128	218069	27393
chr19	190676	390676	harbor1	chr19	218494	218803	LTR/ERVL	3577	+	154	218648	27972
chr19	190676	390676	harbor1	chr19	219110	219409	LTR/ERVL	3577	+	150	219260	28584
chr19	10887632	11087632	harbor1	chr19	10970164	10970426	LTR/ERVL	1363	+	131	10970295	82663
chr19	10887632	11087632	harbor1	chr19	10970704	10970867	LTR/ERVL	1363	+	82	10970786	83154
chr19	14106923	14306923	harbor1	chr19	14142172	14142677	LTR/ERVL	2436	+	252	14142424	35501
chr19	14106923	14306923	harbor1	chr19	14177937	14178046	LTR/ERVL	1600	+	54	14177991	71068
chr19	14106923	14306923	harbor1	chr19	14179953	14180260	LTR/ERVL	1600	+	154	14180107	73184
chr19	14106923	14306923	harbor1	chr19	14180854	14180893	LTR/ERVL	1600	+	20	14180874	73951
chr19	19675817	19875817	harbor1	chr19	19760002	19760027	LTR/ERVL	1863	+	12	19760014	84197
chr19	19675817	19875817	harbor1	chr19	19760320	19760792	LTR/ERVL	1863	+	236	19760556	84739
chr19	19675817	19875817	harbor1	chr19	19761109	19761520	LTR/ERVL	4637	+	206	19761315	85498
chr19	19675817	19875817	harbor1	chr19	19761837	19761960	LTR/ERVL	4637	+	62	19761899	86082
chr19	19675817	19875817	harbor1	chr19	19762256	19762865	LTR/ERVL	4637	+	304	19762560	86743
chr19	19675817	19875817	harbor1	chr19	19763222	19763463	LTR/ERVL	3870	+	120	19763342	87525
chr19	19675817	19875817	harbor1	chr19	19764169	19764818	LTR/ERVL	3870	+	324	19764493	88676
chr19	31989361	32189361	harbor1	chr19	31990481	31990902	LTR/ERVL	669	+	210	31990691	1330
chr19	2356892	2556892	harbor1	chr19	2440848	2441326	LTR/ERVL	940	+	239	2441087	84195
chr19	2131495	2331495	harbor1	chr19	2154586	2154897	LTR/ERVL	815	+	156	2154742	23247
chr19	10617604	10817604	harbor1	chr19	10646676	10646776	LTR/ERVL	1468	+	50	10646726	29122
chr19	10617604	10817604	harbor1	chr19	10647048	10647454	LTR/ERVL	1468	+	203	10647251	29647
chr19	2356895	2556895	harbor1	chr19	2440848	2441326	LTR/ERVL	940	+	239	2441087	84192
chr19	19674767	19874767	harbor1	chr19	19760002	19760027	LTR/ERVL	1863	+	12	19760014	85247
chr19	19674767	19874767	harbor1	chr19	19760320	19760792	LTR/ERVL	1863	+	236	19760556	85789
chr19	19674767	19874767	harbor1	chr19	19761109	19761520	LTR/ERVL	4637	+	206	19761315	86548
chr19	19674767	19874767	harbor1	chr19	19761837	19761960	LTR/ERVL	4637	+	62	19761899	87132
chr19	19674767	19874767	harbor1	chr19	19762256	19762865	LTR/ERVL	4637	+	304	19762560	87793
chr19	19674767	19874767	harbor1	chr19	19763222	19763463	LTR/ERVL	3870	+	120	19763342	88575
chr19	19674767	19874767	harbor1	chr19	19764169	19764818	LTR/ERVL	3870	+	324	19764493	89726
chr19	41650423	41850423	harbor1	chr19	41668000	41668169	LTR/ERVL	726	+	84	41668084	17661
chr19	41650423	41850423	harbor1	chr19	41677854	41678190	LTR/ERVL	1086	+	168	41678022	27599
chr19	48639075	48839075	harbor1	chr19	48712221	48712408	LTR/ERVL	783	+	94	48712315	73240
chr19	48639075	48839075	harbor1	chr19	48712732	48712807	LTR/ERVL	783	+	38	48712770	73695
chr19	48639075	48839075	harbor1	chr19	48709558	48709855	LTR/ERVL	798	+	148	48709706	70631
chr19	2356896	2556896	harbor1	chr19	2440848	2441326	LTR/ERVL	940	+	239	2441087	84191
chr19	10618468	10818468	harbor1	chr19	10646676	10646776	LTR/ERVL	1468	+	50	10646726	28258
chr19	10618468	10818468	harbor1	chr19	10647048	10647454	LTR/ERVL	1468	+	203	10647251	28783
chr19	19676769	19876769	harbor1	chr19	19760002	19760027	LTR/ERVL	1863	+	12	19760014	83245
chr19	19676769	19876769	harbor1	chr19	19760320	19760792	LTR/ERVL	1863	+	236	19760556	83787
chr19	19676769	19876769	harbor1	chr19	19761109	19761520	LTR/ERVL	4637	+	206	19761315	84546
chr19	19676769	19876769	harbor1	chr19	19761837	19761960	LTR/ERVL	4637	+	62	19761899	85130
chr19	19676769	19876769	harbor1	chr19	19762256	19762865	LTR/ERVL	4637	+	304	19762560	85791
chr19	19676769	19876769	harbor1	chr19	19763222	19763463	LTR/ERVL	3870	+	120	19763342	86573
chr19	19676769	19876769	harbor1	chr19	19764169	19764818	LTR/ERVL	3870	+	324	19764493	87724
chr19	317267	517267	harbor1	chr19	348520	348786	LTR/ERVL	735	+	133	348653	31386
chr19	35167341	35367341	harbor1	chr19	35173816	35174053	LTR/ERVL	776	+	118	35173934	6593
chr19	35167341	35367341	harbor1	chr19	35179191	35179552	LTR/ERVL	2206	+	180	35179371	12030
chr19	35167341	35367341	harbor1	chr19	35179864	35180103	LTR/ERVL	2206	+	120	35179984	12643
chr19	35167341	35367341	harbor1	chr19	35180160	35180210	LTR/ERVL	4651	+	25	35180185	12844
chr19	35167341	35367341	harbor1	chr19	35180521	35181581	LTR/ERVL	4651	+	530	35181051	13710
chr19	35167341	35367341	harbor1	chr19	35181919	35182123	LTR/ERVL	952	+	102	35182021	14680
chr19	35167341	35367341	harbor1	chr19	35185038	35185218	LTR/ERVL	855	+	90	35185128	17787
chr19	35167341	35367341	harbor1	chr19	35196745	35196781	LTR/ERVL	3679	+	18	35196763	29422
chr19	35167341	35367341	harbor1	chr19	35197446	35198141	LTR/ERVL	3679	+	348	35197794	30453
chr19	35167341	35367341	harbor1	chr19	35198332	35198426	LTR/ERVL	1416	+	47	35198379	31038
chr19	35167341	35367341	harbor1	chr19	35198739	35199045	LTR/ERVL	1416	+	153	35198892	31551
chr19	4691699	4891699	harbor1	chr19	4708034	4708493	LTR/ERVL	2793	+	230	4708264	16565
chr19	49239891	49439891	harbor1	chr19	49278812	49278876	LTR/ERVL	1260	+	32	49278844	38953
chr19	49239891	49439891	harbor1	chr19	49279174	49279350	LTR/ERVL	1260	+	88	49279262	39371
chr19	49239891	49439891	harbor1	chr19	49279361	49280305	LTR/ERVL	3923	+	472	49279833	39942
chr19	49239891	49439891	harbor1	chr19	49280598	49280807	LTR/ERVL	3923	+	104	49280702	40811
chr19	49239891	49439891	harbor1	chr19	49281247	49281580	LTR/ERVL	3262	+	166	49281413	41522
chr19	49239891	49439891	harbor1	chr19	49281893	49282163	LTR/ERVL	3262	+	135	49282028	42137
chr19	49239891	49439891	harbor1	chr19	49285376	49285585	LTR/ERVL	1305	+	104	49285480	45589
chr19	49239891	49439891	harbor1	chr19	49282675	49283162	LTR/ERVL	3262	+	244	49282919	43028
chr19	19563439	19763439	harbor1	chr19	19602727	19603269	LTR/ERVL	2296	+	271	19602998	39559
chr19	19675630	19875630	harbor1	chr19	19760002	19760027	LTR/ERVL	1863	+	12	19760014	84384
chr19	19675630	19875630	harbor1	chr19	19760320	19760792	LTR/ERVL	1863	+	236	19760556	84926
chr19	19675630	19875630	harbor1	chr19	19761109	19761520	LTR/ERVL	4637	+	206	19761315	85685
chr19	19675630	19875630	harbor1	chr19	19761837	19761960	LTR/ERVL	4637	+	62	19761899	86269
chr19	19675630	19875630	harbor1	chr19	19762256	19762865	LTR/ERVL	4637	+	304	19762560	86930
chr19	19675630	19875630	harbor1	chr19	19763222	19763463	LTR/ERVL	3870	+	120	19763342	87712
chr19	19675630	19875630	harbor1	chr19	19764169	19764818	LTR/ERVL	3870	+	324	19764493	88863
chr19	19563929	19763929	harbor1	chr19	19602727	19603269	LTR/ERVL	2296	+	271	19602998	39069
chr19	208646	408646	harbor1	chr19	217941	218198	LTR/ERVL	3577	+	128	218069	9423
chr19	208646	408646	harbor1	chr19	218494	218803	LTR/ERVL	3577	+	154	218648	10002
chr19	208646	408646	harbor1	chr19	219110	219409	LTR/ERVL	3577	+	150	219260	10614
chr19	23321895	23521895	harbor1	chr19	23343496	23343852	LTR/ERVL	1448	+	178	23343674	21779
chr19	10618496	10818496	harbor1	chr19	10646676	10646776	LTR/ERVL	1468	+	50	10646726	28230
chr19	10618496	10818496	harbor1	chr19	10647048	10647454	LTR/ERVL	1468	+	203	10647251	28755
chr19	19563750	19763750	harbor1	chr19	19602727	19603269	LTR/ERVL	2296	+	271	19602998	39248
chr19	10612630	10812630	harbor1	chr19	10646676	10646776	LTR/ERVL	1468	+	50	10646726	34096
chr19	10612630	10812630	harbor1	chr19	10647048	10647454	LTR/ERVL	1468	+	203	10647251	34621
chr19	49707032	49907032	harbor1	chr19	49717516	49717903	LTR/ERVL	1134	+	194	49717710	10678
chr19	49707032	49907032	harbor1	chr19	49718210	49718287	LTR/ERVL	1134	+	38	49718248	11216
chr19	49707032	49907032	harbor1	chr19	49718583	49718671	LTR/ERVL	1134	+	44	49718627	11595
chr19	49707032	49907032	harbor1	chr19	49730381	49730545	LTR/ERVL	636	+	82	49730463	23431
chr19	9719420	9919420	harbor1	chr19	9731507	9731729	LTR/ERVL	688	+	111	9731618	12198
chr19	19563676	19763676	harbor1	chr19	19602727	19603269	LTR/ERVL	2296	+	271	19602998	39322
chr19	44993164	45193164	harbor1	chr19	45031424	45031555	LTR/ERVL	698	+	66	45031490	38326
chr19	19952303	20152303	harbor1	chr19	19957701	19958100	LTR/ERVL	3355	+	200	19957901	5598
chr19	19952303	20152303	harbor1	chr19	19958164	19958689	LTR/ERVL	4031	+	262	19958426	6123
chr19	19952303	20152303	harbor1	chr19	19959694	19959789	LTR/ERVL	4031	+	48	19959742	7439
chr19	19952303	20152303	harbor1	chr19	19959790	19961467	LTR/ERVL	12830	+	838	19960628	8325
chr19	19952303	20152303	harbor1	chr19	19962598	19962713	LTR/ERVL	793	+	58	19962656	10353
chr19	19952303	20152303	harbor1	chr19	19962700	19964290	LTR/ERVL	11117	+	795	19963495	11192
chr19	19952303	20152303	harbor1	chr19	19964291	19964935	LTR/ERVL	3797	+	322	19964613	12310
chr19	18421887	18621887	harbor1	chr19	18470580	18470967	LTR/ERVL	935	+	194	18470774	48887
chr19	18421887	18621887	harbor1	chr19	18490962	18491084	LTR/ERVL	1593	+	61	18491023	69136
chr19	18421887	18621887	harbor1	chr19	18491413	18491632	LTR/ERVL	1593	+	110	18491523	69636
chr19	18421887	18621887	harbor1	chr19	18491913	18492006	LTR/ERVL	1593	+	46	18491959	70072
chr19	10618530	10818530	harbor1	chr19	10646676	10646776	LTR/ERVL	1468	+	50	10646726	28196
chr19	10618530	10818530	harbor1	chr19	10647048	10647454	LTR/ERVL	1468	+	203	10647251	28721
chr19	7762917	7962917	harbor1	chr19	7771351	7771570	LTR/ERVL	640	+	110	7771461	8544
chr19	2685572	2885572	harbor1	chr19	2733975	2734322	LTR/ERVL	1498	+	174	2734149	48577
chr19	2685572	2885572	harbor1	chr19	2737707	2737870	LTR/ERVL	1095	+	82	2737789	52217
chr19	2685572	2885572	harbor1	chr19	2761932	2762235	LTR/ERVL	1060	+	152	2762084	76512
chr19	2685572	2885572	harbor1	chr19	2763312	2763580	LTR/ERVL	715	+	134	2763446	77874
chr19	317228	517228	harbor1	chr19	348520	348786	LTR/ERVL	735	+	133	348653	31425
chr19	19676555	19876555	harbor1	chr19	19760002	19760027	LTR/ERVL	1863	+	12	19760014	83459
chr19	19676555	19876555	harbor1	chr19	19760320	19760792	LTR/ERVL	1863	+	236	19760556	84001
chr19	19676555	19876555	harbor1	chr19	19761109	19761520	LTR/ERVL	4637	+	206	19761315	84760
chr19	19676555	19876555	harbor1	chr19	19761837	19761960	LTR/ERVL	4637	+	62	19761899	85344
chr19	19676555	19876555	harbor1	chr19	19762256	19762865	LTR/ERVL	4637	+	304	19762560	86005
chr19	19676555	19876555	harbor1	chr19	19763222	19763463	LTR/ERVL	3870	+	120	19763342	86787
chr19	19676555	19876555	harbor1	chr19	19764169	19764818	LTR/ERVL	3870	+	324	19764493	87938
chr19	50329057	50529057	harbor1	chr19	50339150	50339407	LTR/ERVL	1346	+	128	50339278	10221
chr19	50329057	50529057	harbor1	chr19	50339692	50339826	LTR/ERVL	1346	+	67	50339759	10702
chr19	19676645	19876645	harbor1	chr19	19760002	19760027	LTR/ERVL	1863	+	12	19760014	83369
chr19	19676645	19876645	harbor1	chr19	19760320	19760792	LTR/ERVL	1863	+	236	19760556	83911
chr19	19676645	19876645	harbor1	chr19	19761109	19761520	LTR/ERVL	4637	+	206	19761315	84670
chr19	19676645	19876645	harbor1	chr19	19761837	19761960	LTR/ERVL	4637	+	62	19761899	85254
chr19	19676645	19876645	harbor1	chr19	19762256	19762865	LTR/ERVL	4637	+	304	19762560	85915
chr19	19676645	19876645	harbor1	chr19	19763222	19763463	LTR/ERVL	3870	+	120	19763342	86697
chr19	19676645	19876645	harbor1	chr19	19764169	19764818	LTR/ERVL	3870	+	324	19764493	87848
chr19	48342797	48542797	harbor1	chr19	48355663	48356106	LTR/ERVL	2501	+	222	48355885	13088
chr19	51194759	51394759	harbor1	chr19	51257531	51258278	LTR/ERVL	3121	+	374	51257905	63146
chr19	51194759	51394759	harbor1	chr19	51258284	51258680	LTR/ERVL	1434	+	198	51258482	63723
chr19	51194759	51394759	harbor1	chr19	51258732	51259118	LTR/ERVL	1387	+	193	51258925	64166
chr19	51194759	51394759	harbor1	chr19	51259238	51260130	LTR/ERVL	2315	+	446	51259684	64925
chr19	1939769	2139769	harbor1	chr19	2001514	2001743	LTR/ERVL	803	+	114	2001628	61859
chr19	1939769	2139769	harbor1	chr19	2002039	2002069	LTR/ERVL	803	+	15	2002054	62285
chr19	1939769	2139769	harbor1	chr19	2002361	2002592	LTR/ERVL	803	+	116	2002477	62708
chr19	1939769	2139769	harbor1	chr19	2002905	2003009	LTR/ERVL	803	+	52	2002957	63188
chr19	19563919	19763919	harbor1	chr19	19602727	19603269	LTR/ERVL	2296	+	271	19602998	39079
chr19	2356931	2556931	harbor1	chr19	2440848	2441326	LTR/ERVL	940	+	239	2441087	84156
chr19	54031600	54231600	harbor1	chr19	54043134	54043411	LTR/ERVL	1484	+	138	54043272	11672
chr19	54031600	54231600	harbor1	chr19	54043711	54043764	LTR/ERVL	1484	+	26	54043737	12137
chr19	54031600	54231600	harbor1	chr19	54055889	54056209	LTR/ERVL	1738	+	160	54056049	24449
chr19	54031600	54231600	harbor1	chr19	54056521	54056720	LTR/ERVL	1854	+	100	54056621	25021
chr19	54031600	54231600	harbor1	chr19	54079372	54079571	LTR/ERVL	788	+	100	54079472	47872
chr19	19675815	19875815	harbor1	chr19	19760002	19760027	LTR/ERVL	1863	+	12	19760014	84199
chr19	19675815	19875815	harbor1	chr19	19760320	19760792	LTR/ERVL	1863	+	236	19760556	84741
chr19	19675815	19875815	harbor1	chr19	19761109	19761520	LTR/ERVL	4637	+	206	19761315	85500
chr19	19675815	19875815	harbor1	chr19	19761837	19761960	LTR/ERVL	4637	+	62	19761899	86084
chr19	19675815	19875815	harbor1	chr19	19762256	19762865	LTR/ERVL	4637	+	304	19762560	86745
chr19	19675815	19875815	harbor1	chr19	19763222	19763463	LTR/ERVL	3870	+	120	19763342	87527
chr19	19675815	19875815	harbor1	chr19	19764169	19764818	LTR/ERVL	3870	+	324	19764493	88678
chr19	19564039	19764039	harbor1	chr19	19602727	19603269	LTR/ERVL	2296	+	271	19602998	38959
chr19	1946248	2146248	harbor1	chr19	2001514	2001743	LTR/ERVL	803	+	114	2001628	55380
chr19	1946248	2146248	harbor1	chr19	2002039	2002069	LTR/ERVL	803	+	15	2002054	55806
chr19	1946248	2146248	harbor1	chr19	2002361	2002592	LTR/ERVL	803	+	116	2002477	56229
chr19	1946248	2146248	harbor1	chr19	2002905	2003009	LTR/ERVL	803	+	52	2002957	56709
chr19	19562572	19762572	harbor1	chr19	19602727	19603269	LTR/ERVL	2296	+	271	19602998	40426
chr19	19675563	19875563	harbor1	chr19	19760002	19760027	LTR/ERVL	1863	+	12	19760014	84451
chr19	19675563	19875563	harbor1	chr19	19760320	19760792	LTR/ERVL	1863	+	236	19760556	84993
chr19	19675563	19875563	harbor1	chr19	19761109	19761520	LTR/ERVL	4637	+	206	19761315	85752
chr19	19675563	19875563	harbor1	chr19	19761837	19761960	LTR/ERVL	4637	+	62	19761899	86336
chr19	19675563	19875563	harbor1	chr19	19762256	19762865	LTR/ERVL	4637	+	304	19762560	86997
chr19	19675563	19875563	harbor1	chr19	19763222	19763463	LTR/ERVL	3870	+	120	19763342	87779
chr19	19675563	19875563	harbor1	chr19	19764169	19764818	LTR/ERVL	3870	+	324	19764493	88930
chr19	208555	408555	harbor1	chr19	217941	218198	LTR/ERVL	3577	+	128	218069	9514
chr19	208555	408555	harbor1	chr19	218494	218803	LTR/ERVL	3577	+	154	218648	10093
chr19	208555	408555	harbor1	chr19	219110	219409	LTR/ERVL	3577	+	150	219260	10705
chr19	34913533	35113533	harbor1	chr19	34916300	34916642	LTR/ERVL	1034	+	171	34916471	2938
chr19	19674601	19874601	harbor1	chr19	19760002	19760027	LTR/ERVL	1863	+	12	19760014	85413
chr19	19674601	19874601	harbor1	chr19	19760320	19760792	LTR/ERVL	1863	+	236	19760556	85955
chr19	19674601	19874601	harbor1	chr19	19761109	19761520	LTR/ERVL	4637	+	206	19761315	86714
chr19	19674601	19874601	harbor1	chr19	19761837	19761960	LTR/ERVL	4637	+	62	19761899	87298
chr19	19674601	19874601	harbor1	chr19	19762256	19762865	LTR/ERVL	4637	+	304	19762560	87959
chr19	19674601	19874601	harbor1	chr19	19763222	19763463	LTR/ERVL	3870	+	120	19763342	88741
chr19	19674601	19874601	harbor1	chr19	19764169	19764818	LTR/ERVL	3870	+	324	19764493	89892
chr19	19564047	19764047	harbor1	chr19	19602727	19603269	LTR/ERVL	2296	+	271	19602998	38951
chr19	19676479	19876479	harbor1	chr19	19760002	19760027	LTR/ERVL	1863	+	12	19760014	83535
chr19	19676479	19876479	harbor1	chr19	19760320	19760792	LTR/ERVL	1863	+	236	19760556	84077
chr19	19676479	19876479	harbor1	chr19	19761109	19761520	LTR/ERVL	4637	+	206	19761315	84836
chr19	19676479	19876479	harbor1	chr19	19761837	19761960	LTR/ERVL	4637	+	62	19761899	85420
chr19	19676479	19876479	harbor1	chr19	19762256	19762865	LTR/ERVL	4637	+	304	19762560	86081
chr19	19676479	19876479	harbor1	chr19	19763222	19763463	LTR/ERVL	3870	+	120	19763342	86863
chr19	19676479	19876479	harbor1	chr19	19764169	19764818	LTR/ERVL	3870	+	324	19764493	88014
chr19	19519375	19719375	harbor1	chr19	19602727	19603269	LTR/ERVL	2296	+	271	19602998	83623
chr19	19553859	19753859	harbor1	chr19	19602727	19603269	LTR/ERVL	2296	+	271	19602998	49139
chr19	2483587	2683587	harbor1	chr19	2519607	2519837	LTR/ERVL	1409	+	115	2519722	36135
chr19	56021112	56221112	harbor1	chr19	56071522	56071948	LTR/ERVL	1621	+	213	56071735	50623
chr19	12581893	12781893	harbor1	chr19	12603100	12603224	LTR/ERVL	2621	+	62	12603162	21269
chr19	12581893	12781893	harbor1	chr19	12603804	12604233	LTR/ERVL	2621	+	214	12604018	22125
chr19	12581893	12781893	harbor1	chr19	12604855	12604871	LTR/ERVL	2621	+	8	12604863	22970
chr19	12581893	12781893	harbor1	chr19	12605179	12605203	LTR/ERVL	2621	+	12	12605191	23298
chr19	12581893	12781893	harbor1	chr19	12605498	12605789	LTR/ERVL	2621	+	146	12605644	23751
chr19	12596104	12796104	harbor1	chr19	12603100	12603224	LTR/ERVL	2621	+	62	12603162	7058
chr19	12596104	12796104	harbor1	chr19	12603804	12604233	LTR/ERVL	2621	+	214	12604018	7914
chr19	12596104	12796104	harbor1	chr19	12604855	12604871	LTR/ERVL	2621	+	8	12604863	8759
chr19	12596104	12796104	harbor1	chr19	12605179	12605203	LTR/ERVL	2621	+	12	12605191	9087
chr19	12596104	12796104	harbor1	chr19	12605498	12605789	LTR/ERVL	2621	+	146	12605644	9540
chr19	19579986	19779986	harbor1	chr19	19602727	19603269	LTR/ERVL	2296	+	271	19602998	23012
chr19	19676008	19876008	harbor1	chr19	19760002	19760027	LTR/ERVL	1863	+	12	19760014	84006
chr19	19676008	19876008	harbor1	chr19	19760320	19760792	LTR/ERVL	1863	+	236	19760556	84548
chr19	19676008	19876008	harbor1	chr19	19761109	19761520	LTR/ERVL	4637	+	206	19761315	85307
chr19	19676008	19876008	harbor1	chr19	19761837	19761960	LTR/ERVL	4637	+	62	19761899	85891
chr19	19676008	19876008	harbor1	chr19	19762256	19762865	LTR/ERVL	4637	+	304	19762560	86552
chr19	19676008	19876008	harbor1	chr19	19763222	19763463	LTR/ERVL	3870	+	120	19763342	87334
chr19	19676008	19876008	harbor1	chr19	19764169	19764818	LTR/ERVL	3870	+	324	19764493	88485
chr20	63353319	63553319	harbor1	chr20	63450733	63450859	LTR/ERVL	515	+	63	63450796	97477
chr20	63353319	63553319	harbor1	chr20	63451166	63451248	LTR/ERVL	515	+	41	63451207	97888
chr20	63353319	63553319	harbor1	chr20	63451296	63451570	LTR/ERVL	912	+	137	63451433	98114
chr20	44866470	45066470	harbor1	chr20	44870970	44871103	LTR/ERVL	503	+	66	44871036	4566
chr20	63596384	63796384	harbor1	chr20	63633757	63634116	LTR/ERVL	1072	+	180	63633937	37553
chr20	63596384	63796384	harbor1	chr20	63663061	63663280	LTR/ERVL	653	+	110	63663171	66787
chr20	1018818	1218818	harbor1	chr20	1109101	1109488	LTR/ERVL	756	+	194	1109295	90477
chr20	1018818	1218818	harbor1	chr20	1109865	1110271	LTR/ERVL	861	+	203	1110068	91250
chr20	1018818	1218818	harbor1	chr20	1114185	1114427	LTR/ERVL	987	+	121	1114306	95488
chr20	2370770	2570770	harbor1	chr20	2409992	2410790	LTR/ERVL	3172	+	399	2410391	39621
chr20	2370770	2570770	harbor1	chr20	2442777	2443055	LTR/ERVL	2048	+	139	2442916	72146
chr20	2370770	2570770	harbor1	chr20	2443851	2444094	LTR/ERVL	1456	+	122	2443973	73203
chr20	2370770	2570770	harbor1	chr20	2453790	2453897	LTR/ERVL	539	+	54	2453844	83074
chr20	4586429	4786429	harbor1	chr20	4635913	4636276	LTR/ERVL	639	+	182	4636095	49666
chr20	4586429	4786429	harbor1	chr20	4653972	4654431	LTR/ERVL	1785	+	230	4654202	67773
chr20	4586429	4786429	harbor1	chr20	4654600	4654811	LTR/ERVL	1117	+	106	4654706	68277
chr20	22734563	22934563	harbor1	chr20	22770605	22770829	LTR/ERVL	533	+	112	22770717	36154
chr20	63362224	63562224	harbor1	chr20	63450733	63450859	LTR/ERVL	515	+	63	63450796	88572
chr20	63362224	63562224	harbor1	chr20	63451166	63451248	LTR/ERVL	515	+	41	63451207	88983
chr20	63362224	63562224	harbor1	chr20	63451296	63451570	LTR/ERVL	912	+	137	63451433	89209
chr20	63429646	63629646	harbor1	chr20	63450733	63450859	LTR/ERVL	515	+	63	63450796	21150
chr20	63429646	63629646	harbor1	chr20	63451166	63451248	LTR/ERVL	515	+	41	63451207	21561
chr20	63429646	63629646	harbor1	chr20	63451296	63451570	LTR/ERVL	912	+	137	63451433	21787
chr20	49710583	49910583	harbor1	chr20	49725704	49725877	LTR/ERVL	568	+	86	49725790	15207
chr20	49710583	49910583	harbor1	chr20	49758681	49759078	LTR/ERVL	1485	+	198	49758879	48296
chr20	49710583	49910583	harbor1	chr20	49764008	49764168	LTR/ERVL	651	+	80	49764088	53505
chr20	49710583	49910583	harbor1	chr20	49789671	49790144	LTR/ERVL	1584	+	236	49789907	79324
chr20	57552168	57752168	harbor1	chr20	57585184	57585578	LTR/ERVL	796	+	197	57585381	33213
chr20	57552168	57752168	harbor1	chr20	57647869	57648069	LTR/ERVL	618	+	100	57647969	95801
chr20	63420408	63620408	harbor1	chr20	63450733	63450859	LTR/ERVL	515	+	63	63450796	30388
chr20	63420408	63620408	harbor1	chr20	63451166	63451248	LTR/ERVL	515	+	41	63451207	30799
chr20	63420408	63620408	harbor1	chr20	63451296	63451570	LTR/ERVL	912	+	137	63451433	31025
chr20	48275448	48475448	harbor1	chr20	48332192	48332349	LTR/ERVL	538	+	78	48332270	56822
chr20	21818150	22018150	harbor1	chr20	21821816	21822116	LTR/ERVL	738	+	150	21821966	3816
chr20	21818150	22018150	harbor1	chr20	21840250	21840531	LTR/ERVL	588	+	140	21840390	22240
chr20	21818150	22018150	harbor1	chr20	21896294	21896586	LTR/ERVL	862	+	146	21896440	78290
chr20	21818150	22018150	harbor1	chr20	21904768	21905019	LTR/ERVL	597	+	126	21904894	86744
chr20	21818150	22018150	harbor1	chr20	21909481	21909820	LTR/ERVL	1093	+	170	21909651	91501
chr20	40589402	40789402	harbor1	chr20	40632523	40632980	LTR/ERVL	1477	+	228	40632751	43349
chr20	40589402	40789402	harbor1	chr20	40636749	40637173	LTR/ERVL	1057	+	212	40636961	47559
chr20	50269813	50469813	harbor1	chr20	50275930	50276139	LTR/ERVL	618	+	104	50276034	6221
chr20	50269813	50469813	harbor1	chr20	50302406	50302917	LTR/ERVL	1427	+	256	50302662	32849
chr20	4071169	4271169	harbor1	chr20	4076742	4077165	LTR/ERVL	2876	+	212	4076954	5785
chr20	4071169	4271169	harbor1	chr20	4093152	4093665	LTR/ERVL	2964	+	256	4093408	22239
chr20	4071169	4271169	harbor1	chr20	4107139	4107303	LTR/ERVL	600	+	82	4107221	36052
chr20	4071169	4271169	harbor1	chr20	4110830	4111279	LTR/ERVL	1105	+	224	4111054	39885
chr20	4071169	4271169	harbor1	chr20	4140978	4141214	LTR/ERVL	658	+	118	4141096	69927
chr20	4071169	4271169	harbor1	chr20	4143748	4144171	LTR/ERVL	1344	+	212	4143960	72791
chr20	4071169	4271169	harbor1	chr20	4144549	4144804	LTR/ERVL	1779	+	128	4144677	73508
chr20	4071169	4271169	harbor1	chr20	4145115	4145241	LTR/ERVL	1779	+	63	4145178	74009
chr20	43408519	43608519	harbor1	chr20	43438407	43438605	LTR/ERVL	1309	+	99	43438506	29987
chr20	43408519	43608519	harbor1	chr20	43439063	43439350	LTR/ERVL	1309	+	144	43439207	30688
chr20	43408519	43608519	harbor1	chr20	43442353	43442803	LTR/ERVL	864	+	225	43442578	34059
chr20	43408519	43608519	harbor1	chr20	43472524	43472940	LTR/ERVL	558	+	208	43472732	64213
chr20	5027110	5227110	harbor1	chr20	5030580	5030853	LTR/ERVL	924	+	136	5030716	3606
chr20	5027110	5227110	harbor1	chr20	5056022	5056064	LTR/ERVL	1805	+	21	5056043	28933
chr20	5027110	5227110	harbor1	chr20	5056788	5057192	LTR/ERVL	1956	+	202	5056990	29880
chr20	5027110	5227110	harbor1	chr20	5124689	5124881	LTR/ERVL	574	+	96	5124785	97675
chr20	62083219	62283219	harbor1	chr20	62083599	62083905	LTR/ERVL	967	+	153	62083752	533
chr20	62083219	62283219	harbor1	chr20	62113011	62113165	LTR/ERVL	496	+	77	62113088	29869
chr20	62083219	62283219	harbor1	chr20	62113996	62114043	LTR/ERVL	528	+	24	62114020	30801
chr20	62083219	62283219	harbor1	chr20	62114964	62115343	LTR/ERVL	528	+	190	62115154	31935
chr20	54108072	54308072	harbor1	chr20	54115125	54115598	LTR/ERVL	609	+	236	54115361	7289
chr20	54108072	54308072	harbor1	chr20	54152066	54152473	LTR/ERVL	1062	+	204	54152270	44198
chr20	54108072	54308072	harbor1	chr20	54195527	54195871	LTR/ERVL	615	+	172	54195699	87627
chr20	38705777	38905777	harbor1	chr20	38733716	38733954	LTR/ERVL	506	+	119	38733835	28058
chr20	1018817	1218817	harbor1	chr20	1109101	1109488	LTR/ERVL	756	+	194	1109295	90478
chr20	1018817	1218817	harbor1	chr20	1109865	1110271	LTR/ERVL	861	+	203	1110068	91251
chr20	1018817	1218817	harbor1	chr20	1114185	1114427	LTR/ERVL	987	+	121	1114306	95489
chr20	34992759	35192759	harbor1	chr20	35040171	35040598	LTR/ERVL	2038	+	214	35040385	47626
chr20	61966280	62166280	harbor1	chr20	62016248	62016780	LTR/ERVL	1943	+	266	62016514	50234
chr20	50269781	50469781	harbor1	chr20	50275930	50276139	LTR/ERVL	618	+	104	50276034	6253
chr20	50269781	50469781	harbor1	chr20	50302406	50302917	LTR/ERVL	1427	+	256	50302662	32881
chr21	29198953	29398953	harbor1	chr21	29284765	29285221	LTR/ERVL	1130	+	228	29284993	86040
chr21	44576686	44776686	harbor1	chr21	44602464	44602959	LTR/ERVL	1340	+	248	44602712	26026
chr21	44576686	44776686	harbor1	chr21	44652727	44652874	LTR/ERVL	723	+	74	44652801	76115
chr21	14337769	14537769	harbor1	chr21	14377531	14378072	LTR/ERVL	1988	+	270	14377801	40032
chr21	5028567	5228567	harbor1	chr21	5122101	5122298	LTR/ERVL	658	+	98	5122199	93632
chr21	5028567	5228567	harbor1	chr21	5122305	5122609	LTR/ERVL	1084	+	152	5122457	93890
chr21	33070300	33270300	harbor1	chr21	33146477	33146880	LTR/ERVL	1119	+	202	33146679	76379
chr21	14337822	14537822	harbor1	chr21	14377531	14378072	LTR/ERVL	1988	+	270	14377801	39979
chr21	41771682	41971682	harbor1	chr21	41777162	41777569	LTR/ERVL	1421	+	204	41777366	5684
chr21	29199129	29399129	harbor1	chr21	29284765	29285221	LTR/ERVL	1130	+	228	29284993	85864
chr21	29198948	29398948	harbor1	chr21	29284765	29285221	LTR/ERVL	1130	+	228	29284993	86045
chr21	39008447	39208447	harbor1	chr21	39043229	39043261	LTR/ERVL	1446	+	16	39043245	34798
chr21	39008447	39208447	harbor1	chr21	39058286	39058388	LTR/ERVL	669	+	51	39058337	49890
chr21	39008447	39208447	harbor1	chr21	39042772	39043183	LTR/ERVL	1446	+	206	39042978	34531
chr21	42275771	42475771	harbor1	chr21	42356549	42356618	LTR/ERVL	2008	+	34	42356583	80812
chr21	42275771	42475771	harbor1	chr21	42356619	42357127	LTR/ERVL	2687	+	254	42356873	81102
chr21	42275771	42475771	harbor1	chr21	42357128	42357529	LTR/ERVL	2008	+	200	42357328	81557
chr21	14337781	14537781	harbor1	chr21	14377531	14378072	LTR/ERVL	1988	+	270	14377801	40020
chr21	14337791	14537791	harbor1	chr21	14377531	14378072	LTR/ERVL	1988	+	270	14377801	40010
chr21	29199041	29399041	harbor1	chr21	29284765	29285221	LTR/ERVL	1130	+	228	29284993	85952
chr21	46154518	46354518	harbor1	chr21	46159249	46159813	LTR/ERVL	1138	+	282	46159531	5013
chr21	14336442	14536442	harbor1	chr21	14377531	14378072	LTR/ERVL	1988	+	270	14377801	41359
chr21	14337826	14537826	harbor1	chr21	14377531	14378072	LTR/ERVL	1988	+	270	14377801	39975
chr21	39008502	39208502	harbor1	chr21	39043229	39043261	LTR/ERVL	1446	+	16	39043245	34743
chr21	39008502	39208502	harbor1	chr21	39058286	39058388	LTR/ERVL	669	+	51	39058337	49835
chr21	39008502	39208502	harbor1	chr21	39042772	39043183	LTR/ERVL	1446	+	206	39042978	34476
chr21	14337835	14537835	harbor1	chr21	14377531	14378072	LTR/ERVL	1988	+	270	14377801	39966
chr21	42275718	42475718	harbor1	chr21	42356549	42356618	LTR/ERVL	2008	+	34	42356583	80865
chr21	42275718	42475718	harbor1	chr21	42356619	42357127	LTR/ERVL	2687	+	254	42356873	81155
chr21	42275718	42475718	harbor1	chr21	42357128	42357529	LTR/ERVL	2008	+	200	42357328	81610
chr21	29199063	29399063	harbor1	chr21	29284765	29285221	LTR/ERVL	1130	+	228	29284993	85930
chr21	46358530	46558530	harbor1	chr21	46450898	46451173	LTR/ERVL	789	+	138	46451036	92506
chr21	46358530	46558530	harbor1	chr21	46451459	46451621	LTR/ERVL	789	+	81	46451540	93010
chr21	29198984	29398984	harbor1	chr21	29284765	29285221	LTR/ERVL	1130	+	228	29284993	86009
chr21	39008480	39208480	harbor1	chr21	39043229	39043261	LTR/ERVL	1446	+	16	39043245	34765
chr21	39008480	39208480	harbor1	chr21	39058286	39058388	LTR/ERVL	669	+	51	39058337	49857
chr21	39008480	39208480	harbor1	chr21	39042772	39043183	LTR/ERVL	1446	+	206	39042978	34498
chr21	46536367	46736367	harbor1	chr21	46607219	46607590	LTR/ERVL	992	+	186	46607405	71038
chr21	46536367	46736367	harbor1	chr21	46607826	46608051	LTR/ERVL	2078	+	112	46607938	71571
chr21	46536367	46736367	harbor1	chr21	46608603	46609198	LTR/ERVL	2078	+	298	46608901	72534
chr21	46536367	46736367	harbor1	chr21	46609230	46610032	LTR/ERVL	2801	+	401	46609631	73264
chr21	46536367	46736367	harbor1	chr21	46610033	46610311	LTR/ERVL	851	+	139	46610172	73805
chr21	46536367	46736367	harbor1	chr21	46610872	46611133	LTR/ERVL	1142	+	130	46611002	74635
chr21	46536367	46736367	harbor1	chr21	46628756	46629114	LTR/ERVL	610	+	179	46628935	92568
chr21	14173498	14373498	harbor1	chr21	14236776	14236992	LTR/ERVL	496	+	108	14236884	63386
chr21	14173498	14373498	harbor1	chr21	14237095	14237203	LTR/ERVL	458	+	54	14237149	63651
chr21	14173498	14373498	harbor1	chr21	14242817	14243210	LTR/ERVL	1000	+	196	14243013	69515
chr21	14173498	14373498	harbor1	chr21	14245182	14245358	LTR/ERVL	433	+	88	14245270	71772
chr21	14173498	14373498	harbor1	chr21	14259590	14259842	LTR/ERVL	1069	+	126	14259716	86218
chr21	42467105	42667105	harbor1	chr21	42490627	42491388	LTR/ERVL	2067	+	380	42491007	23902
chr21	42467105	42667105	harbor1	chr21	42524753	42525562	LTR/ERVL	2916	+	404	42525157	58052
chr21	46082706	46282706	harbor1	chr21	46159249	46159813	LTR/ERVL	1138	+	282	46159531	76825
chr21	14337834	14537834	harbor1	chr21	14377531	14378072	LTR/ERVL	1988	+	270	14377801	39967
chr21	14337784	14537784	harbor1	chr21	14377531	14378072	LTR/ERVL	1988	+	270	14377801	40017
chr22	46476611	46676611	harbor1	chr22	46512276	46512288	LTR/ERVL	1884	+	6	46512282	35671
chr22	46476611	46676611	harbor1	chr22	46512587	46513072	LTR/ERVL	1884	+	242	46512829	36218
chr22	50579676	50779676	harbor1	chr22	50583743	50584084	LTR/ERVL	1197	+	170	50583913	4237
chr22	50579676	50779676	harbor1	chr22	50584690	50585464	LTR/ERVL	1197	+	387	50585077	5401
chr22	50579676	50779676	harbor1	chr22	50585508	50586147	LTR/ERVL	1078	+	320	50585828	6152
chr22	50579676	50779676	harbor1	chr22	50586209	50586470	LTR/ERVL	664	+	130	50586339	6663
chr22	50579676	50779676	harbor1	chr22	50586558	50587782	LTR/ERVL	1501	+	612	50587170	7494
chr22	50579676	50779676	harbor1	chr22	50656555	50656811	LTR/ERVL	793	+	128	50656683	77007
chr22	50579676	50779676	harbor1	chr22	50657097	50657223	LTR/ERVL	793	+	63	50657160	77484
chr22	50579676	50779676	harbor1	chr22	50657809	50658054	LTR/ERVL	492	+	122	50657931	78255
chr22	26575728	26775728	harbor1	chr22	26650395	26650557	LTR/ERVL	528	+	81	26650476	74748
chr22	43426643	43626643	harbor1	chr22	43466524	43466668	LTR/ERVL	706	+	72	43466596	39953
chr22	43426643	43626643	harbor1	chr22	43512918	43513446	LTR/ERVL	947	+	264	43513182	86539
chr22	43426643	43626643	harbor1	chr22	43466681	43467014	LTR/ERVL	1348	+	166	43466847	40204
chr22	50054112	50254112	harbor1	chr22	50054355	50054652	LTR/ERVL	773	+	148	50054503	391
chr22	50054112	50254112	harbor1	chr22	50078809	50078968	LTR/ERVL	665	+	80	50078889	24777
chr22	42989526	43189526	harbor1	chr22	43030272	43030719	LTR/ERVL	1679	+	224	43030496	40970
chr22	42989526	43189526	harbor1	chr22	43060196	43060467	LTR/ERVL	498	+	136	43060332	70806
chr22	32075946	32275946	harbor1	chr22	32115707	32116277	LTR/ERVL	1921	+	285	32115992	40046
chr22	32075946	32275946	harbor1	chr22	32116610	32116894	LTR/ERVL	1607	+	142	32116752	40806
chr22	36675743	36875743	harbor1	chr22	36743138	36743462	LTR/ERVL	1016	+	162	36743300	67557
chr22	36675743	36875743	harbor1	chr22	36770816	36771382	LTR/ERVL	710	+	283	36771099	95356
chr22	36675743	36875743	harbor1	chr22	36771541	36771779	LTR/ERVL	435	+	119	36771660	95917
chr22	22997061	23197061	harbor1	chr22	23026084	23026412	LTR/ERVL	5220	+	164	23026248	29187
chr22	22997061	23197061	harbor1	chr22	23027289	23027892	LTR/ERVL	5220	+	302	23027591	30530
chr22	22997061	23197061	harbor1	chr22	23029349	23029819	LTR/ERVL	5220	+	235	23029584	32523
chr22	49664026	49864026	harbor1	chr22	49726916	49727122	LTR/ERVL	565	+	103	49727019	62993
chr22	49664026	49864026	harbor1	chr22	49725347	49725618	LTR/ERVL	720	+	136	49725483	61457
chr22	49664089	49864089	harbor1	chr22	49726916	49727122	LTR/ERVL	565	+	103	49727019	62930
chr22	49664089	49864089	harbor1	chr22	49725347	49725618	LTR/ERVL	720	+	136	49725483	61394
chr22	38768951	38968951	harbor1	chr22	38815871	38816464	LTR/ERVL	3442	+	296	38816167	47216
chr22	44201115	44401115	harbor1	chr22	44255833	44256488	LTR/ERVL	1519	+	328	44256161	55046
chr22	44201115	44401115	harbor1	chr22	44277989	44278428	LTR/ERVL	3295	+	220	44278209	77094
chr22	42989515	43189515	harbor1	chr22	43030272	43030719	LTR/ERVL	1679	+	224	43030496	40981
chr22	42989515	43189515	harbor1	chr22	43060196	43060467	LTR/ERVL	498	+	136	43060332	70817
chr22	42989521	43189521	harbor1	chr22	43030272	43030719	LTR/ERVL	1679	+	224	43030496	40975
chr22	42989521	43189521	harbor1	chr22	43060196	43060467	LTR/ERVL	498	+	136	43060332	70811
chr22	23017696	23217696	harbor1	chr22	23026084	23026412	LTR/ERVL	5220	+	164	23026248	8552
chr22	23017696	23217696	harbor1	chr22	23027289	23027892	LTR/ERVL	5220	+	302	23027591	9895
chr22	23017696	23217696	harbor1	chr22	23029349	23029819	LTR/ERVL	5220	+	235	23029584	11888
chr22	36186442	36386442	harbor1	chr22	36187778	36188078	LTR/ERVL	840	+	150	36187928	1486
chr22	36186442	36386442	harbor1	chr22	36192608	36192816	LTR/ERVL	522	+	104	36192712	6270
chr22	36186442	36386442	harbor1	chr22	36193375	36193650	LTR/ERVL	1188	+	138	36193513	7071
chr22	36186442	36386442	harbor1	chr22	36220385	36220973	LTR/ERVL	2157	+	294	36220679	34237
chr22	36186442	36386442	harbor1	chr22	36223722	36224154	LTR/ERVL	453	+	216	36223938	37496
chr22	36186442	36386442	harbor1	chr22	36224603	36224855	LTR/ERVL	545	+	126	36224729	38287
chr22	36186442	36386442	harbor1	chr22	36228665	36228966	LTR/ERVL	646	+	150	36228815	42373
chr22	36186442	36386442	harbor1	chr22	36229433	36229719	LTR/ERVL	1234	+	143	36229576	43134
chr22	36186442	36386442	harbor1	chr22	36248161	36248356	LTR/ERVL	543	+	98	36248259	61817
chr22	36186442	36386442	harbor1	chr22	36248385	36248801	LTR/ERVL	1139	+	208	36248593	62151
chr22	36186442	36386442	harbor1	chr22	36267213	36267606	LTR/ERVL	2406	+	196	36267409	80967
chr22	30996891	31196891	harbor1	chr22	31049103	31049451	LTR/ERVL	1050	+	174	31049277	52386
chr22	42597660	42797660	harbor1	chr22	42667137	42667275	LTR/ERVL	1672	+	69	42667206	69546
chr22	42597660	42797660	harbor1	chr22	42667885	42668116	LTR/ERVL	1672	+	116	42668001	70341
chr22	42597660	42797660	harbor1	chr22	42680611	42680977	LTR/ERVL	820	+	183	42680794	83134
chr22	42597660	42797660	harbor1	chr22	42682224	42682407	LTR/ERVL	412	+	92	42682316	84656
chr22	42597660	42797660	harbor1	chr22	42682468	42682612	LTR/ERVL	519	+	72	42682540	84880
chr22	42597660	42797660	harbor1	chr22	42682708	42682801	LTR/ERVL	602	+	46	42682754	85094
chr22	42597660	42797660	harbor1	chr22	42683101	42683343	LTR/ERVL	602	+	121	42683222	85562
chr22	42204285	42404285	harbor1	chr22	42220597	42221006	LTR/ERVL	1030	+	204	42220801	16516
chr22	42204285	42404285	harbor1	chr22	42221011	42221211	LTR/ERVL	574	+	100	42221111	16826
chr22	42204285	42404285	harbor1	chr22	42221392	42221458	LTR/ERVL	433	+	33	42221425	17140
chr22	42204285	42404285	harbor1	chr22	42254493	42254672	LTR/ERVL	966	+	90	42254583	50298
chr22	23023459	23223459	harbor1	chr22	23026084	23026412	LTR/ERVL	5220	+	164	23026248	2789
chr22	23023459	23223459	harbor1	chr22	23027289	23027892	LTR/ERVL	5220	+	302	23027591	4132
chr22	23023459	23223459	harbor1	chr22	23029349	23029819	LTR/ERVL	5220	+	235	23029584	6125
chr22	45313205	45513205	harbor1	chr22	45357735	45358544	LTR/ERVL	3069	+	404	45358139	44934
chr22	45313205	45513205	harbor1	chr22	45409683	45410271	LTR/ERVL	2266	+	294	45409977	96772
chr22	43471950	43671950	harbor1	chr22	43512918	43513446	LTR/ERVL	947	+	264	43513182	41232
chr22	36918777	37118777	harbor1	chr22	36981653	36981754	LTR/ERVL	579	+	50	36981703	62926
chr22	36918777	37118777	harbor1	chr22	36982088	36982223	LTR/ERVL	579	+	68	36982156	63379
chr22	36918807	37118807	harbor1	chr22	36981653	36981754	LTR/ERVL	579	+	50	36981703	62896
chr22	36918807	37118807	harbor1	chr22	36982088	36982223	LTR/ERVL	579	+	68	36982156	63349
chr22	20568033	20768033	harbor1	chr22	20647666	20647865	LTR/ERVL	564	+	100	20647766	79733
chr22	36186432	36386432	harbor1	chr22	36187778	36188078	LTR/ERVL	840	+	150	36187928	1496
chr22	36186432	36386432	harbor1	chr22	36192608	36192816	LTR/ERVL	522	+	104	36192712	6280
chr22	36186432	36386432	harbor1	chr22	36193375	36193650	LTR/ERVL	1188	+	138	36193513	7081
chr22	36186432	36386432	harbor1	chr22	36220385	36220973	LTR/ERVL	2157	+	294	36220679	34247
chr22	36186432	36386432	harbor1	chr22	36223722	36224154	LTR/ERVL	453	+	216	36223938	37506
chr22	36186432	36386432	harbor1	chr22	36224603	36224855	LTR/ERVL	545	+	126	36224729	38297
chr22	36186432	36386432	harbor1	chr22	36228665	36228966	LTR/ERVL	646	+	150	36228815	42383
chr22	36186432	36386432	harbor1	chr22	36229433	36229719	LTR/ERVL	1234	+	143	36229576	43144
chr22	36186432	36386432	harbor1	chr22	36248161	36248356	LTR/ERVL	543	+	98	36248259	61827
chr22	36186432	36386432	harbor1	chr22	36248385	36248801	LTR/ERVL	1139	+	208	36248593	62161
chr22	36186432	36386432	harbor1	chr22	36267213	36267606	LTR/ERVL	2406	+	196	36267409	80977
chr22	32529769	32729769	harbor1	chr22	32561561	32561954	LTR/ERVL	761	+	196	32561757	31988
chr22	32529769	32729769	harbor1	chr22	32611711	32612518	LTR/ERVL	3023	+	404	32612115	82346
chr22	23018534	23218534	harbor1	chr22	23026084	23026412	LTR/ERVL	5220	+	164	23026248	7714
chr22	23018534	23218534	harbor1	chr22	23027289	23027892	LTR/ERVL	5220	+	302	23027591	9057
chr22	23018534	23218534	harbor1	chr22	23029349	23029819	LTR/ERVL	5220	+	235	23029584	11050
chr22	36186441	36386441	harbor1	chr22	36187778	36188078	LTR/ERVL	840	+	150	36187928	1487
chr22	36186441	36386441	harbor1	chr22	36192608	36192816	LTR/ERVL	522	+	104	36192712	6271
chr22	36186441	36386441	harbor1	chr22	36193375	36193650	LTR/ERVL	1188	+	138	36193513	7072
chr22	36186441	36386441	harbor1	chr22	36220385	36220973	LTR/ERVL	2157	+	294	36220679	34238
chr22	36186441	36386441	harbor1	chr22	36223722	36224154	LTR/ERVL	453	+	216	36223938	37497
chr22	36186441	36386441	harbor1	chr22	36224603	36224855	LTR/ERVL	545	+	126	36224729	38288
chr22	36186441	36386441	harbor1	chr22	36228665	36228966	LTR/ERVL	646	+	150	36228815	42374
chr22	36186441	36386441	harbor1	chr22	36229433	36229719	LTR/ERVL	1234	+	143	36229576	43135
chr22	36186441	36386441	harbor1	chr22	36248161	36248356	LTR/ERVL	543	+	98	36248259	61818
chr22	36186441	36386441	harbor1	chr22	36248385	36248801	LTR/ERVL	1139	+	208	36248593	62152
chr22	36186441	36386441	harbor1	chr22	36267213	36267606	LTR/ERVL	2406	+	196	36267409	80968
chr22	36186368	36386368	harbor1	chr22	36187778	36188078	LTR/ERVL	840	+	150	36187928	1560
chr22	36186368	36386368	harbor1	chr22	36192608	36192816	LTR/ERVL	522	+	104	36192712	6344
chr22	36186368	36386368	harbor1	chr22	36193375	36193650	LTR/ERVL	1188	+	138	36193513	7145
chr22	36186368	36386368	harbor1	chr22	36220385	36220973	LTR/ERVL	2157	+	294	36220679	34311
chr22	36186368	36386368	harbor1	chr22	36223722	36224154	LTR/ERVL	453	+	216	36223938	37570
chr22	36186368	36386368	harbor1	chr22	36224603	36224855	LTR/ERVL	545	+	126	36224729	38361
chr22	36186368	36386368	harbor1	chr22	36228665	36228966	LTR/ERVL	646	+	150	36228815	42447
chr22	36186368	36386368	harbor1	chr22	36229433	36229719	LTR/ERVL	1234	+	143	36229576	43208
chr22	36186368	36386368	harbor1	chr22	36248161	36248356	LTR/ERVL	543	+	98	36248259	61891
chr22	36186368	36386368	harbor1	chr22	36248385	36248801	LTR/ERVL	1139	+	208	36248593	62225
chr22	36186368	36386368	harbor1	chr22	36267213	36267606	LTR/ERVL	2406	+	196	36267409	81041
chr22	36186428	36386428	harbor1	chr22	36187778	36188078	LTR/ERVL	840	+	150	36187928	1500
chr22	36186428	36386428	harbor1	chr22	36192608	36192816	LTR/ERVL	522	+	104	36192712	6284
chr22	36186428	36386428	harbor1	chr22	36193375	36193650	LTR/ERVL	1188	+	138	36193513	7085
chr22	36186428	36386428	harbor1	chr22	36220385	36220973	LTR/ERVL	2157	+	294	36220679	34251
chr22	36186428	36386428	harbor1	chr22	36223722	36224154	LTR/ERVL	453	+	216	36223938	37510
chr22	36186428	36386428	harbor1	chr22	36224603	36224855	LTR/ERVL	545	+	126	36224729	38301
chr22	36186428	36386428	harbor1	chr22	36228665	36228966	LTR/ERVL	646	+	150	36228815	42387
chr22	36186428	36386428	harbor1	chr22	36229433	36229719	LTR/ERVL	1234	+	143	36229576	43148
chr22	36186428	36386428	harbor1	chr22	36248161	36248356	LTR/ERVL	543	+	98	36248259	61831
chr22	36186428	36386428	harbor1	chr22	36248385	36248801	LTR/ERVL	1139	+	208	36248593	62165
chr22	36186428	36386428	harbor1	chr22	36267213	36267606	LTR/ERVL	2406	+	196	36267409	80981
chrX	46736727	46936727	harbor1	chrX	46739449	46739709	LTR/ERVL	779	+	130	46739579	2852
chrX	46736727	46936727	harbor1	chrX	46767912	46768183	LTR/ERVL	669	+	136	46768048	31321
chrX	46736727	46936727	harbor1	chrX	46780170	46780592	LTR/ERVL	1015	+	211	46780381	43654
chrX	46736727	46936727	harbor1	chrX	46743170	46743735	LTR/ERVL	1057	+	282	46743452	6725
chrX	1354314	1554314	harbor1	chrX	1422144	1422500	LTR/ERVL	1442	+	178	1422322	68008
chrX	1354314	1554314	harbor1	chrX	1433124	1433383	LTR/ERVL	1065	+	130	1433254	78940
chrX	1354314	1554314	harbor1	chrX	1433701	1434176	LTR/ERVL	1065	+	238	1433939	79625
chrX	39996248	40196248	harbor1	chrX	40023990	40024446	LTR/ERVL	2326	+	228	40024218	27970
chrX	39996248	40196248	harbor1	chrX	40028562	40029365	LTR/ERVL	4646	+	402	40028964	32716
chrX	109902871	110102871	harbor1	chrX	109904619	109905091	LTR/ERVL	1647	+	236	109904855	1984
chrX	109902871	110102871	harbor1	chrX	109939552	109940001	LTR/ERVL	1815	+	224	109939776	36905
chrX	109902871	110102871	harbor1	chrX	109967912	109968323	LTR/ERVL	1739	+	206	109968118	65247
chrX	49064231	49264231	harbor1	chrX	49139062	49139364	LTR/ERVL	2025	+	151	49139213	74982
chrX	49064231	49264231	harbor1	chrX	49139454	49139562	LTR/ERVL	573	+	54	49139508	75277
chrX	19445154	19645154	harbor1	chrX	19444940	19445268	LTR/ERVL	999	+	164	19445104	50
chrX	19445154	19645154	harbor1	chrX	19479129	19479563	LTR/ERVL	1126	+	217	19479346	34192
chrX	48792105	48992105	harbor1	chrX	48863941	48864111	LTR/ERVL	780	+	85	48864026	71921
chrX	7048274	7248274	harbor1	chrX	7075036	7075226	LTR/ERVL	2333	+	95	7075131	26857
chrX	7048274	7248274	harbor1	chrX	7075532	7076040	LTR/ERVL	2333	+	254	7075786	27512
