H_chr	H_start	H_end	Harbor	TE_chr	TE_start	TE_end	TE	score	TE_strand	TE_half	TE_middle_pos	TE_dis
chr1	16545136	16745136	harbor1	chr1	16549687	16549813	LTR/ERVL-MaLR	601	+	63	16549750	4614
chr1	16545136	16745136	harbor1	chr1	16601299	16601923	LTR/ERVL-MaLR	1935	+	312	16601611	56475
chr1	16545136	16745136	harbor1	chr1	16605694	16605874	LTR/ERVL-MaLR	544	+	90	16605784	60648
chr1	2137978	2337978	harbor1	chr1	2199627	2199797	LTR/ERVL-MaLR	761	+	85	2199712	61734
chr1	2137978	2337978	harbor1	chr1	2200424	2200663	LTR/ERVL-MaLR	761	+	120	2200544	62566
chr1	16543138	16743138	harbor1	chr1	16549687	16549813	LTR/ERVL-MaLR	601	+	63	16549750	6612
chr1	16543138	16743138	harbor1	chr1	16601299	16601923	LTR/ERVL-MaLR	1935	+	312	16601611	58473
chr1	16543138	16743138	harbor1	chr1	16605694	16605874	LTR/ERVL-MaLR	544	+	90	16605784	62646
chr1	3525011	3725011	harbor1	chr1	3524906	3525098	LTR/ERVL-MaLR	462	+	96	3525002	9
chr1	3525011	3725011	harbor1	chr1	3528445	3528945	LTR/ERVL-MaLR	2127	+	250	3528695	3684
chr1	3525011	3725011	harbor1	chr1	3556957	3557315	LTR/ERVL-MaLR	869	+	179	3557136	32125
chr1	3525011	3725011	harbor1	chr1	3588948	3589362	LTR/ERVL-MaLR	1101	+	207	3589155	64144
chr1	3525011	3725011	harbor1	chr1	3597495	3597874	LTR/ERVL-MaLR	1057	+	190	3597685	72674
chr1	3525011	3725011	harbor1	chr1	3619433	3619776	LTR/ERVL-MaLR	1918	+	172	3619605	94594
chr1	3525011	3725011	harbor1	chr1	3619777	3620647	LTR/ERVL-MaLR	3975	+	435	3620212	95201
chr1	3525011	3725011	harbor1	chr1	3621644	3622155	LTR/ERVL-MaLR	3975	+	256	3621900	96889
chr1	3525011	3725011	harbor1	chr1	3622156	3622504	LTR/ERVL-MaLR	2001	+	174	3622330	97319
chr1	3525011	3725011	harbor1	chr1	3622505	3622858	LTR/ERVL-MaLR	529	+	176	3622681	97670
chr1	63219176	63419176	harbor1	chr1	63226333	63226594	LTR/ERVL-MaLR	1214	+	130	63226463	7287
chr1	63219176	63419176	harbor1	chr1	63255679	63256062	LTR/ERVL-MaLR	1544	+	192	63255871	36695
chr1	63219176	63419176	harbor1	chr1	63259387	63259552	LTR/ERVL-MaLR	603	+	82	63259469	40293
chr1	63219176	63419176	harbor1	chr1	63259574	63259767	LTR/ERVL-MaLR	471	+	96	63259670	40494
chr1	63219176	63419176	harbor1	chr1	63307126	63307741	LTR/ERVL-MaLR	3152	+	308	63307434	88258
chr1	63219176	63419176	harbor1	chr1	63308503	63308839	LTR/ERVL-MaLR	1293	+	168	63308671	89495
chr1	63219176	63419176	harbor1	chr1	63307747	63307922	LTR/ERVL-MaLR	1293	+	88	63307835	88659
chr1	2138436	2338436	harbor1	chr1	2199627	2199797	LTR/ERVL-MaLR	761	+	85	2199712	61276
chr1	2138436	2338436	harbor1	chr1	2200424	2200663	LTR/ERVL-MaLR	761	+	120	2200544	62108
chr1	2138571	2338571	harbor1	chr1	2199627	2199797	LTR/ERVL-MaLR	761	+	85	2199712	61141
chr1	2138571	2338571	harbor1	chr1	2200424	2200663	LTR/ERVL-MaLR	761	+	120	2200544	61973
chr1	150461410	150661410	harbor1	chr1	150517440	150517790	LTR/ERVL-MaLR	1857	+	175	150517615	56205
chr1	150461410	150661410	harbor1	chr1	150523721	150524136	LTR/ERVL-MaLR	834	+	208	150523929	62519
chr1	150461410	150661410	harbor1	chr1	150527989	150528276	LTR/ERVL-MaLR	532	+	144	150528133	66723
chr1	21742123	21942123	harbor1	chr1	21819427	21819486	LTR/ERVL-MaLR	450	+	30	21819457	77334
chr1	1675980	1875980	harbor1	chr1	1767816	1767894	LTR/ERVL-MaLR	744	+	39	1767855	91875
chr1	1675980	1875980	harbor1	chr1	1768195	1768255	LTR/ERVL-MaLR	744	+	30	1768225	92245
chr1	1675980	1875980	harbor1	chr1	1768567	1768805	LTR/ERVL-MaLR	744	+	119	1768686	92706
chr1	51230788	51430788	harbor1	chr1	51300705	51301112	LTR/ERVL-MaLR	562	+	204	51300909	70121
chr1	16542741	16742741	harbor1	chr1	16549687	16549813	LTR/ERVL-MaLR	601	+	63	16549750	7009
chr1	16542741	16742741	harbor1	chr1	16601299	16601923	LTR/ERVL-MaLR	1935	+	312	16601611	58870
chr1	16542741	16742741	harbor1	chr1	16605694	16605874	LTR/ERVL-MaLR	544	+	90	16605784	63043
chr1	16544784	16744784	harbor1	chr1	16549687	16549813	LTR/ERVL-MaLR	601	+	63	16549750	4966
chr1	16544784	16744784	harbor1	chr1	16601299	16601923	LTR/ERVL-MaLR	1935	+	312	16601611	56827
chr1	16544784	16744784	harbor1	chr1	16605694	16605874	LTR/ERVL-MaLR	544	+	90	16605784	61000
chr1	15942113	16142113	harbor1	chr1	15972540	15972796	LTR/ERVL-MaLR	531	+	128	15972668	30555
chr1	16596895	16796895	harbor1	chr1	16601299	16601923	LTR/ERVL-MaLR	1935	+	312	16601611	4716
chr1	16596895	16796895	harbor1	chr1	16605694	16605874	LTR/ERVL-MaLR	544	+	90	16605784	8889
chr1	960023	1160023	harbor1	chr1	993731	994041	LTR/ERVL-MaLR	2047	+	155	993886	33863
chr1	960023	1160023	harbor1	chr1	994335	994401	LTR/ERVL-MaLR	2047	+	33	994368	34345
chr1	2138519	2338519	harbor1	chr1	2199627	2199797	LTR/ERVL-MaLR	761	+	85	2199712	61193
chr1	2138519	2338519	harbor1	chr1	2200424	2200663	LTR/ERVL-MaLR	761	+	120	2200544	62025
chr1	89721500	89921500	harbor1	chr1	89755604	89755725	LTR/ERVL-MaLR	512	+	60	89755664	34164
chr1	89721500	89921500	harbor1	chr1	89760474	89760824	LTR/ERVL-MaLR	1799	+	175	89760649	39149
chr1	89721500	89921500	harbor1	chr1	89775007	89775518	LTR/ERVL-MaLR	2301	+	256	89775263	53763
chr1	89721500	89921500	harbor1	chr1	89791417	89791890	LTR/ERVL-MaLR	622	+	236	89791653	70153
chr1	89721500	89921500	harbor1	chr1	89792055	89792431	LTR/ERVL-MaLR	1917	+	188	89792243	70743
chr1	89721500	89921500	harbor1	chr1	89793899	89794039	LTR/ERVL-MaLR	1917	+	70	89793969	72469
chr1	89721500	89921500	harbor1	chr1	89797029	89797169	LTR/ERVL-MaLR	701	+	70	89797099	75599
chr1	89721500	89921500	harbor1	chr1	89807137	89807310	LTR/ERVL-MaLR	1335	+	86	89807223	85723
chr1	89721500	89921500	harbor1	chr1	89807601	89807872	LTR/ERVL-MaLR	1335	+	136	89807737	86237
chr1	89721500	89921500	harbor1	chr1	89817770	89818072	LTR/ERVL-MaLR	1700	+	151	89817921	96421
chr1	89721500	89921500	harbor1	chr1	89818374	89818443	LTR/ERVL-MaLR	1700	+	34	89818408	96908
chr1	16544947	16744947	harbor1	chr1	16549687	16549813	LTR/ERVL-MaLR	601	+	63	16549750	4803
chr1	16544947	16744947	harbor1	chr1	16601299	16601923	LTR/ERVL-MaLR	1935	+	312	16601611	56664
chr1	16544947	16744947	harbor1	chr1	16605694	16605874	LTR/ERVL-MaLR	544	+	90	16605784	60837
chr1	16526616	16726616	harbor1	chr1	16549687	16549813	LTR/ERVL-MaLR	601	+	63	16549750	23134
chr1	16526616	16726616	harbor1	chr1	16601299	16601923	LTR/ERVL-MaLR	1935	+	312	16601611	74995
chr1	16526616	16726616	harbor1	chr1	16605694	16605874	LTR/ERVL-MaLR	544	+	90	16605784	79168
chr1	16544872	16744872	harbor1	chr1	16549687	16549813	LTR/ERVL-MaLR	601	+	63	16549750	4878
chr1	16544872	16744872	harbor1	chr1	16601299	16601923	LTR/ERVL-MaLR	1935	+	312	16601611	56739
chr1	16544872	16744872	harbor1	chr1	16605694	16605874	LTR/ERVL-MaLR	544	+	90	16605784	60912
chr1	16544810	16744810	harbor1	chr1	16549687	16549813	LTR/ERVL-MaLR	601	+	63	16549750	4940
chr1	16544810	16744810	harbor1	chr1	16601299	16601923	LTR/ERVL-MaLR	1935	+	312	16601611	56801
chr1	16544810	16744810	harbor1	chr1	16605694	16605874	LTR/ERVL-MaLR	544	+	90	16605784	60974
chr1	16544790	16744790	harbor1	chr1	16549687	16549813	LTR/ERVL-MaLR	601	+	63	16549750	4960
chr1	16544790	16744790	harbor1	chr1	16601299	16601923	LTR/ERVL-MaLR	1935	+	312	16601611	56821
chr1	16544790	16744790	harbor1	chr1	16605694	16605874	LTR/ERVL-MaLR	544	+	90	16605784	60994
chr1	227441496	227641496	harbor1	chr1	227444014	227444110	LTR/ERVL-MaLR	693	+	48	227444062	2566
chr1	227441496	227641496	harbor1	chr1	227450807	227450925	LTR/ERVL-MaLR	525	+	59	227450866	9370
chr1	227441496	227641496	harbor1	chr1	227469821	227470200	LTR/ERVL-MaLR	1981	+	190	227470011	28515
chr1	227441496	227641496	harbor1	chr1	227470189	227471795	LTR/ERVL-MaLR	10921	+	803	227470992	29496
chr1	227441496	227641496	harbor1	chr1	227471801	227472189	LTR/ERVL-MaLR	2116	+	194	227471995	30499
chr1	227441496	227641496	harbor1	chr1	227485599	227485957	LTR/ERVL-MaLR	1836	+	179	227485778	44282
chr1	227441496	227641496	harbor1	chr1	227496875	227497027	LTR/ERVL-MaLR	2416	+	76	227496951	55455
chr1	227441496	227641496	harbor1	chr1	227497318	227497527	LTR/ERVL-MaLR	2416	+	104	227497422	55926
chr1	227441496	227641496	harbor1	chr1	227514578	227514630	LTR/ERVL-MaLR	1560	+	26	227514604	73108
chr1	227441496	227641496	harbor1	chr1	227515926	227516405	LTR/ERVL-MaLR	1560	+	240	227516166	74670
chr1	227441496	227641496	harbor1	chr1	227519533	227519868	LTR/ERVL-MaLR	1191	+	168	227519701	78205
chr1	16526581	16726581	harbor1	chr1	16549687	16549813	LTR/ERVL-MaLR	601	+	63	16549750	23169
chr1	16526581	16726581	harbor1	chr1	16601299	16601923	LTR/ERVL-MaLR	1935	+	312	16601611	75030
chr1	16526581	16726581	harbor1	chr1	16605694	16605874	LTR/ERVL-MaLR	544	+	90	16605784	79203
chr1	145348336	145548336	harbor1	chr1	145413596	145414057	LTR/ERVL-MaLR	1156	+	230	145413826	65490
chr1	145348336	145548336	harbor1	chr1	145414086	145414635	LTR/ERVL-MaLR	825	+	274	145414360	66024
chr1	145348336	145548336	harbor1	chr1	145443003	145443397	LTR/ERVL-MaLR	1436	+	197	145443200	94864
chr1	77131620	77331620	harbor1	chr1	77136935	77137423	LTR/ERVL-MaLR	742	+	244	77137179	5559
chr1	77131620	77331620	harbor1	chr1	77138008	77138683	LTR/ERVL-MaLR	2750	+	338	77138346	6726
chr1	77131620	77331620	harbor1	chr1	77140045	77140554	LTR/ERVL-MaLR	1271	+	254	77140299	8679
chr1	77131620	77331620	harbor1	chr1	77157702	77158008	LTR/ERVL-MaLR	2184	+	153	77157855	26235
chr1	77131620	77331620	harbor1	chr1	77158317	77158394	LTR/ERVL-MaLR	2184	+	38	77158355	26735
chr1	77131620	77331620	harbor1	chr1	77158395	77159981	LTR/ERVL-MaLR	10532	+	793	77159188	27568
chr1	77131620	77331620	harbor1	chr1	77159982	77160342	LTR/ERVL-MaLR	2366	+	180	77160162	28542
chr1	77131620	77331620	harbor1	chr1	77205841	77206368	LTR/ERVL-MaLR	546	+	264	77206105	74485
chr1	77131620	77331620	harbor1	chr1	77229441	77229891	LTR/ERVL-MaLR	2229	+	225	77229666	98046
chr1	6685469	6885469	harbor1	chr1	6723372	6723800	LTR/ERVL-MaLR	1341	+	214	6723586	38117
chr1	6685469	6885469	harbor1	chr1	6727933	6728054	LTR/ERVL-MaLR	601	+	60	6727993	42524
chr1	6685469	6885469	harbor1	chr1	6728232	6728264	LTR/ERVL-MaLR	727	+	16	6728248	42779
chr1	6685469	6885469	harbor1	chr1	6728559	6728812	LTR/ERVL-MaLR	727	+	126	6728685	43216
chr1	6685469	6885469	harbor1	chr1	6731368	6731529	LTR/ERVL-MaLR	959	+	80	6731448	45979
chr1	6685469	6885469	harbor1	chr1	6737821	6738131	LTR/ERVL-MaLR	507	+	155	6737976	52507
chr1	6685469	6885469	harbor1	chr1	6748480	6748628	LTR/ERVL-MaLR	570	+	74	6748554	63085
chr1	6685469	6885469	harbor1	chr1	6748792	6749028	LTR/ERVL-MaLR	1494	+	118	6748910	63441
chr1	6685469	6885469	harbor1	chr1	6765629	6766007	LTR/ERVL-MaLR	2323	+	189	6765818	80349
chr1	6685469	6885469	harbor1	chr1	6769039	6769163	LTR/ERVL-MaLR	735	+	62	6769101	83632
chr1	6685469	6885469	harbor1	chr1	6776004	6776116	LTR/ERVL-MaLR	1672	+	56	6776060	90591
chr1	6685469	6885469	harbor1	chr1	6776392	6776760	LTR/ERVL-MaLR	1672	+	184	6776576	91107
chr1	8715651	8915651	harbor1	chr1	8733376	8733791	LTR/ERVL-MaLR	1442	+	208	8733584	17933
chr1	8715651	8915651	harbor1	chr1	8735578	8735955	LTR/ERVL-MaLR	2145	+	188	8735766	20115
chr1	8715651	8915651	harbor1	chr1	8741383	8741775	LTR/ERVL-MaLR	2092	+	196	8741579	25928
chr1	8715651	8915651	harbor1	chr1	8745058	8745417	LTR/ERVL-MaLR	1961	+	180	8745238	29587
chr1	8715651	8915651	harbor1	chr1	8783900	8784100	LTR/ERVL-MaLR	1041	+	100	8784000	68349
chr1	8715651	8915651	harbor1	chr1	8804452	8804926	LTR/ERVL-MaLR	1525	+	237	8804689	89038
chr1	16544755	16744755	harbor1	chr1	16549687	16549813	LTR/ERVL-MaLR	601	+	63	16549750	4995
chr1	16544755	16744755	harbor1	chr1	16601299	16601923	LTR/ERVL-MaLR	1935	+	312	16601611	56856
chr1	16544755	16744755	harbor1	chr1	16605694	16605874	LTR/ERVL-MaLR	544	+	90	16605784	61029
chr1	16544809	16744809	harbor1	chr1	16549687	16549813	LTR/ERVL-MaLR	601	+	63	16549750	4941
chr1	16544809	16744809	harbor1	chr1	16601299	16601923	LTR/ERVL-MaLR	1935	+	312	16601611	56802
chr1	16544809	16744809	harbor1	chr1	16605694	16605874	LTR/ERVL-MaLR	544	+	90	16605784	60975
chr1	3431207	3631207	harbor1	chr1	3512452	3512820	LTR/ERVL-MaLR	2554	+	184	3512636	81429
chr1	3431207	3631207	harbor1	chr1	3524906	3525098	LTR/ERVL-MaLR	462	+	96	3525002	93795
chr1	3431207	3631207	harbor1	chr1	3528445	3528945	LTR/ERVL-MaLR	2127	+	250	3528695	97488
chr1	53846279	54046279	harbor1	chr1	53848656	53848893	LTR/ERVL-MaLR	538	+	118	53848774	2495
chr1	53846279	54046279	harbor1	chr1	53849510	53849730	LTR/ERVL-MaLR	538	+	110	53849620	3341
chr1	53846279	54046279	harbor1	chr1	53850681	53851026	LTR/ERVL-MaLR	2341	+	172	53850853	4574
chr1	53846279	54046279	harbor1	chr1	53856817	53857350	LTR/ERVL-MaLR	1597	+	266	53857083	10804
chr1	53846279	54046279	harbor1	chr1	53913645	53914005	LTR/ERVL-MaLR	1347	+	180	53913825	67546
chr1	53846279	54046279	harbor1	chr1	53919306	53919656	LTR/ERVL-MaLR	757	+	175	53919481	73202
chr1	16538570	16738570	harbor1	chr1	16549687	16549813	LTR/ERVL-MaLR	601	+	63	16549750	11180
chr1	16538570	16738570	harbor1	chr1	16601299	16601923	LTR/ERVL-MaLR	1935	+	312	16601611	63041
chr1	16538570	16738570	harbor1	chr1	16605694	16605874	LTR/ERVL-MaLR	544	+	90	16605784	67214
chr1	16543109	16743109	harbor1	chr1	16549687	16549813	LTR/ERVL-MaLR	601	+	63	16549750	6641
chr1	16543109	16743109	harbor1	chr1	16601299	16601923	LTR/ERVL-MaLR	1935	+	312	16601611	58502
chr1	16543109	16743109	harbor1	chr1	16605694	16605874	LTR/ERVL-MaLR	544	+	90	16605784	62675
chr1	244605525	244805525	harbor1	chr1	244613763	244614189	LTR/ERVL-MaLR	2489	+	213	244613976	8451
chr1	244605525	244805525	harbor1	chr1	244647360	244647825	LTR/ERVL-MaLR	1599	+	232	244647592	42067
chr1	244605525	244805525	harbor1	chr1	244649357	244649835	LTR/ERVL-MaLR	2036	+	239	244649596	44071
chr1	244605525	244805525	harbor1	chr1	244672179	244672539	LTR/ERVL-MaLR	2308	+	180	244672359	66834
chr1	244605525	244805525	harbor1	chr1	244700970	244701719	LTR/ERVL-MaLR	2607	+	374	244701344	95819
chr1	4738326	4938326	harbor1	chr1	4748778	4749015	LTR/ERVL-MaLR	780	+	118	4748896	10570
chr1	4738326	4938326	harbor1	chr1	4757854	4758231	LTR/ERVL-MaLR	2387	+	188	4758042	19716
chr1	4738326	4938326	harbor1	chr1	4798679	4799027	LTR/ERVL-MaLR	2335	+	174	4798853	60527
chr1	4738326	4938326	harbor1	chr1	4802209	4802603	LTR/ERVL-MaLR	1493	+	197	4802406	64080
chr1	4738326	4938326	harbor1	chr1	4808281	4808697	LTR/ERVL-MaLR	2686	+	208	4808489	70163
chr1	4738326	4938326	harbor1	chr1	4828796	4829070	LTR/ERVL-MaLR	493	+	137	4828933	90607
chr1	4738326	4938326	harbor1	chr1	4834102	4834565	LTR/ERVL-MaLR	1977	+	232	4834334	96008
chr1	4738326	4938326	harbor1	chr1	4834570	4834896	LTR/ERVL-MaLR	755	+	163	4834733	96407
chr1	4738326	4938326	harbor1	chr1	4837090	4837534	LTR/ERVL-MaLR	1320	+	222	4837312	98986
chr1	16596777	16796777	harbor1	chr1	16601299	16601923	LTR/ERVL-MaLR	1935	+	312	16601611	4834
chr1	16596777	16796777	harbor1	chr1	16605694	16605874	LTR/ERVL-MaLR	544	+	90	16605784	9007
chr1	2138509	2338509	harbor1	chr1	2199627	2199797	LTR/ERVL-MaLR	761	+	85	2199712	61203
chr1	2138509	2338509	harbor1	chr1	2200424	2200663	LTR/ERVL-MaLR	761	+	120	2200544	62035
chr1	5561024	5761024	harbor1	chr1	5567857	5568255	LTR/ERVL-MaLR	2587	+	199	5568056	7032
chr1	5561024	5761024	harbor1	chr1	5572499	5572886	LTR/ERVL-MaLR	2496	+	194	5572693	11669
chr1	5561024	5761024	harbor1	chr1	5581415	5581831	LTR/ERVL-MaLR	936	+	208	5581623	20599
chr1	5561024	5761024	harbor1	chr1	5582601	5582793	LTR/ERVL-MaLR	1821	+	96	5582697	21673
chr1	5561024	5761024	harbor1	chr1	5582854	5583024	LTR/ERVL-MaLR	1821	+	85	5582939	21915
chr1	5561024	5761024	harbor1	chr1	5587032	5587412	LTR/ERVL-MaLR	1538	+	190	5587222	26198
chr1	5561024	5761024	harbor1	chr1	5592092	5592472	LTR/ERVL-MaLR	2044	+	190	5592282	31258
chr1	5561024	5761024	harbor1	chr1	5592778	5592885	LTR/ERVL-MaLR	2044	+	54	5592832	31808
chr1	5561024	5761024	harbor1	chr1	5595446	5595803	LTR/ERVL-MaLR	1082	+	178	5595624	34600
chr1	5561024	5761024	harbor1	chr1	5612866	5613336	LTR/ERVL-MaLR	2218	+	235	5613101	52077
chr1	5561024	5761024	harbor1	chr1	5637090	5637416	LTR/ERVL-MaLR	1653	+	163	5637253	76229
chr1	5561024	5761024	harbor1	chr1	5637949	5638093	LTR/ERVL-MaLR	1653	+	72	5638021	76997
chr1	5561024	5761024	harbor1	chr1	5645450	5645825	LTR/ERVL-MaLR	2501	+	188	5645638	84614
chr1	5561024	5761024	harbor1	chr1	5656549	5656958	LTR/ERVL-MaLR	2223	+	204	5656753	95729
chr1	6134956	6334956	harbor1	chr1	6140640	6140718	LTR/ERVL-MaLR	1170	+	39	6140679	5723
chr1	6134956	6334956	harbor1	chr1	6141635	6141971	LTR/ERVL-MaLR	1170	+	168	6141803	6847
chr1	227441495	227641495	harbor1	chr1	227444014	227444110	LTR/ERVL-MaLR	693	+	48	227444062	2567
chr1	227441495	227641495	harbor1	chr1	227450807	227450925	LTR/ERVL-MaLR	525	+	59	227450866	9371
chr1	227441495	227641495	harbor1	chr1	227469821	227470200	LTR/ERVL-MaLR	1981	+	190	227470011	28516
chr1	227441495	227641495	harbor1	chr1	227470189	227471795	LTR/ERVL-MaLR	10921	+	803	227470992	29497
chr1	227441495	227641495	harbor1	chr1	227471801	227472189	LTR/ERVL-MaLR	2116	+	194	227471995	30500
chr1	227441495	227641495	harbor1	chr1	227485599	227485957	LTR/ERVL-MaLR	1836	+	179	227485778	44283
chr1	227441495	227641495	harbor1	chr1	227496875	227497027	LTR/ERVL-MaLR	2416	+	76	227496951	55456
chr1	227441495	227641495	harbor1	chr1	227497318	227497527	LTR/ERVL-MaLR	2416	+	104	227497422	55927
chr1	227441495	227641495	harbor1	chr1	227514578	227514630	LTR/ERVL-MaLR	1560	+	26	227514604	73109
chr1	227441495	227641495	harbor1	chr1	227515926	227516405	LTR/ERVL-MaLR	1560	+	240	227516166	74671
chr1	227441495	227641495	harbor1	chr1	227519533	227519868	LTR/ERVL-MaLR	1191	+	168	227519701	78206
chr1	11520750	11720750	harbor1	chr1	11544541	11544661	LTR/ERVL-MaLR	1293	+	60	11544601	23851
chr1	11520750	11720750	harbor1	chr1	11544662	11545071	LTR/ERVL-MaLR	1859	+	204	11544866	24116
chr1	11520750	11720750	harbor1	chr1	11545072	11545387	LTR/ERVL-MaLR	1293	+	158	11545230	24480
chr1	11520750	11720750	harbor1	chr1	11555749	11555817	LTR/ERVL-MaLR	670	+	34	11555783	35033
chr1	11520750	11720750	harbor1	chr1	11556335	11556498	LTR/ERVL-MaLR	670	+	82	11556417	35667
chr1	11520750	11720750	harbor1	chr1	11556515	11556674	LTR/ERVL-MaLR	759	+	80	11556595	35845
chr1	11520750	11720750	harbor1	chr1	11565686	11566136	LTR/ERVL-MaLR	1496	+	225	11565911	45161
chr1	11520750	11720750	harbor1	chr1	11574265	11574445	LTR/ERVL-MaLR	1702	+	90	11574355	53605
chr1	11520750	11720750	harbor1	chr1	11574736	11574883	LTR/ERVL-MaLR	1702	+	74	11574810	54060
chr1	11520750	11720750	harbor1	chr1	11575210	11575322	LTR/ERVL-MaLR	1702	+	56	11575266	54516
chr1	11520750	11720750	harbor1	chr1	11587243	11587661	LTR/ERVL-MaLR	1063	+	209	11587452	66702
chr1	11520750	11720750	harbor1	chr1	11587662	11588085	LTR/ERVL-MaLR	2871	+	212	11587874	67124
chr1	11520750	11720750	harbor1	chr1	11588086	11588199	LTR/ERVL-MaLR	1063	+	56	11588142	67392
chr1	11520750	11720750	harbor1	chr1	11590548	11590885	LTR/ERVL-MaLR	695	+	168	11590716	69966
chr1	11520750	11720750	harbor1	chr1	11590915	11590953	LTR/ERVL-MaLR	1687	+	19	11590934	70184
chr1	11520750	11720750	harbor1	chr1	11591265	11591408	LTR/ERVL-MaLR	1687	+	72	11591337	70587
chr1	11520750	11720750	harbor1	chr1	11591861	11592180	LTR/ERVL-MaLR	1687	+	160	11592021	71271
chr1	11520750	11720750	harbor1	chr1	11608408	11608568	LTR/ERVL-MaLR	474	+	80	11608488	87738
chr1	11520750	11720750	harbor1	chr1	11609921	11609955	LTR/ERVL-MaLR	474	+	17	11609938	89188
chr1	11520750	11720750	harbor1	chr1	11613044	11613407	LTR/ERVL-MaLR	2634	+	182	11613226	92476
chr1	11520750	11720750	harbor1	chr1	11618312	11618390	LTR/ERVL-MaLR	871	+	39	11618351	97601
chr1	11520750	11720750	harbor1	chr1	11618691	11619028	LTR/ERVL-MaLR	871	+	168	11618859	98109
chr1	11520750	11720750	harbor1	chr1	11583285	11583606	LTR/ERVL-MaLR	1618	+	160	11583445	62695
chr1	6620127	6820127	harbor1	chr1	6657149	6657588	LTR/ERVL-MaLR	510	+	220	6657369	37242
chr1	241509049	241709049	harbor1	chr1	241511095	241511422	LTR/ERVL-MaLR	1659	+	164	241511259	2210
chr1	241509049	241709049	harbor1	chr1	241595355	241595526	LTR/ERVL-MaLR	609	+	86	241595441	86392
chr1	2136215	2336215	harbor1	chr1	2199627	2199797	LTR/ERVL-MaLR	761	+	85	2199712	63497
chr1	2136215	2336215	harbor1	chr1	2200424	2200663	LTR/ERVL-MaLR	761	+	120	2200544	64329
chr1	53370442	53570442	harbor1	chr1	53401320	53401788	LTR/ERVL-MaLR	1352	+	234	53401554	31112
chr1	53370442	53570442	harbor1	chr1	53401817	53402203	LTR/ERVL-MaLR	2332	+	193	53402010	31568
chr1	53370442	53570442	harbor1	chr1	53407571	53407973	LTR/ERVL-MaLR	1922	+	201	53407772	37330
chr1	53370442	53570442	harbor1	chr1	53418179	53418294	LTR/ERVL-MaLR	783	+	58	53418237	47795
chr1	53370442	53570442	harbor1	chr1	53418618	53418894	LTR/ERVL-MaLR	783	+	138	53418756	48314
chr1	53370442	53570442	harbor1	chr1	53421096	53421465	LTR/ERVL-MaLR	1976	+	184	53421280	50838
chr1	53370442	53570442	harbor1	chr1	53421467	53421646	LTR/ERVL-MaLR	928	+	90	53421557	51115
chr1	53370442	53570442	harbor1	chr1	53442384	53442765	LTR/ERVL-MaLR	2547	+	190	53442574	72132
chr1	53370442	53570442	harbor1	chr1	53443089	53443129	LTR/ERVL-MaLR	2547	+	20	53443109	72667
chr1	16544792	16744792	harbor1	chr1	16549687	16549813	LTR/ERVL-MaLR	601	+	63	16549750	4958
chr1	16544792	16744792	harbor1	chr1	16601299	16601923	LTR/ERVL-MaLR	1935	+	312	16601611	56819
chr1	16544792	16744792	harbor1	chr1	16605694	16605874	LTR/ERVL-MaLR	544	+	90	16605784	60992
chr1	16544920	16744920	harbor1	chr1	16549687	16549813	LTR/ERVL-MaLR	601	+	63	16549750	4830
chr1	16544920	16744920	harbor1	chr1	16601299	16601923	LTR/ERVL-MaLR	1935	+	312	16601611	56691
chr1	16544920	16744920	harbor1	chr1	16605694	16605874	LTR/ERVL-MaLR	544	+	90	16605784	60864
chr1	53846229	54046229	harbor1	chr1	53848656	53848893	LTR/ERVL-MaLR	538	+	118	53848774	2545
chr1	53846229	54046229	harbor1	chr1	53849510	53849730	LTR/ERVL-MaLR	538	+	110	53849620	3391
chr1	53846229	54046229	harbor1	chr1	53850681	53851026	LTR/ERVL-MaLR	2341	+	172	53850853	4624
chr1	53846229	54046229	harbor1	chr1	53856817	53857350	LTR/ERVL-MaLR	1597	+	266	53857083	10854
chr1	53846229	54046229	harbor1	chr1	53913645	53914005	LTR/ERVL-MaLR	1347	+	180	53913825	67596
chr1	53846229	54046229	harbor1	chr1	53919306	53919656	LTR/ERVL-MaLR	757	+	175	53919481	73252
chr1	211033805	211233805	harbor1	chr1	211037763	211037958	LTR/ERVL-MaLR	2260	+	98	211037861	4056
chr1	211033805	211233805	harbor1	chr1	211038261	211038409	LTR/ERVL-MaLR	2260	+	74	211038335	4530
chr1	211033805	211233805	harbor1	chr1	211038410	211039907	LTR/ERVL-MaLR	11957	+	748	211039158	5353
chr1	211033805	211233805	harbor1	chr1	211040208	211040285	LTR/ERVL-MaLR	11957	+	38	211040246	6441
chr1	211033805	211233805	harbor1	chr1	211040286	211040631	LTR/ERVL-MaLR	2413	+	172	211040458	6653
chr1	211033805	211233805	harbor1	chr1	211117273	211117597	LTR/ERVL-MaLR	476	+	162	211117435	83630
chr1	201844506	202044506	harbor1	chr1	201927869	201928244	LTR/ERVL-MaLR	2051	+	188	201928057	83551
chr1	154845979	155045979	harbor1	chr1	154889589	154890033	LTR/ERVL-MaLR	697	+	222	154889811	43832
chr1	154845979	155045979	harbor1	chr1	154890345	154890428	LTR/ERVL-MaLR	635	+	42	154890387	44408
chr1	154845979	155045979	harbor1	chr1	154895345	154895660	LTR/ERVL-MaLR	461	+	158	154895503	49524
chr1	154845979	155045979	harbor1	chr1	154913762	154914165	LTR/ERVL-MaLR	2596	+	202	154913964	67985
chr1	2028839	2228839	harbor1	chr1	2037619	2038028	LTR/ERVL-MaLR	1314	+	204	2037823	8984
chr1	2028839	2228839	harbor1	chr1	2121340	2121444	LTR/ERVL-MaLR	545	+	52	2121392	92553
chr1	16503985	16703985	harbor1	chr1	16549687	16549813	LTR/ERVL-MaLR	601	+	63	16549750	45765
chr1	16503985	16703985	harbor1	chr1	16601299	16601923	LTR/ERVL-MaLR	1935	+	312	16601611	97626
chr1	46122770	46322770	harbor1	chr1	46140406	46140850	LTR/ERVL-MaLR	1681	+	222	46140628	17858
chr1	46122770	46322770	harbor1	chr1	46141160	46141225	LTR/ERVL-MaLR	1681	+	32	46141192	18422
chr1	54316227	54516227	harbor1	chr1	54347602	54347953	LTR/ERVL-MaLR	1344	+	176	54347778	31551
chr1	19766908	19966908	harbor1	chr1	19777065	19777347	LTR/ERVL-MaLR	637	+	141	19777206	10298
chr1	19766908	19966908	harbor1	chr1	19777647	19777771	LTR/ERVL-MaLR	637	+	62	19777709	10801
chr1	19766908	19966908	harbor1	chr1	19778064	19778086	LTR/ERVL-MaLR	582	+	11	19778075	11167
chr1	19766908	19966908	harbor1	chr1	19817231	19817788	LTR/ERVL-MaLR	1174	+	278	19817509	50601
chr1	19766908	19966908	harbor1	chr1	19854400	19854917	LTR/ERVL-MaLR	873	+	258	19854658	87750
chr1	19766908	19966908	harbor1	chr1	19791843	19792187	LTR/ERVL-MaLR	2241	+	172	19792015	25107
chr1	16538366	16738366	harbor1	chr1	16549687	16549813	LTR/ERVL-MaLR	601	+	63	16549750	11384
chr1	16538366	16738366	harbor1	chr1	16601299	16601923	LTR/ERVL-MaLR	1935	+	312	16601611	63245
chr1	16538366	16738366	harbor1	chr1	16605694	16605874	LTR/ERVL-MaLR	544	+	90	16605784	67418
chr1	1526935	1726935	harbor1	chr1	1582794	1583236	LTR/ERVL-MaLR	808	+	221	1583015	56080
chr1	1526935	1726935	harbor1	chr1	1592099	1592227	LTR/ERVL-MaLR	454	+	64	1592163	65228
chr1	1526935	1726935	harbor1	chr1	1610182	1610533	LTR/ERVL-MaLR	2197	+	176	1610358	83423
chr1	6685490	6885490	harbor1	chr1	6723372	6723800	LTR/ERVL-MaLR	1341	+	214	6723586	38096
chr1	6685490	6885490	harbor1	chr1	6727933	6728054	LTR/ERVL-MaLR	601	+	60	6727993	42503
chr1	6685490	6885490	harbor1	chr1	6728232	6728264	LTR/ERVL-MaLR	727	+	16	6728248	42758
chr1	6685490	6885490	harbor1	chr1	6728559	6728812	LTR/ERVL-MaLR	727	+	126	6728685	43195
chr1	6685490	6885490	harbor1	chr1	6731368	6731529	LTR/ERVL-MaLR	959	+	80	6731448	45958
chr1	6685490	6885490	harbor1	chr1	6737821	6738131	LTR/ERVL-MaLR	507	+	155	6737976	52486
chr1	6685490	6885490	harbor1	chr1	6748480	6748628	LTR/ERVL-MaLR	570	+	74	6748554	63064
chr1	6685490	6885490	harbor1	chr1	6748792	6749028	LTR/ERVL-MaLR	1494	+	118	6748910	63420
chr1	6685490	6885490	harbor1	chr1	6765629	6766007	LTR/ERVL-MaLR	2323	+	189	6765818	80328
chr1	6685490	6885490	harbor1	chr1	6769039	6769163	LTR/ERVL-MaLR	735	+	62	6769101	83611
chr1	6685490	6885490	harbor1	chr1	6776004	6776116	LTR/ERVL-MaLR	1672	+	56	6776060	90570
chr1	6685490	6885490	harbor1	chr1	6776392	6776760	LTR/ERVL-MaLR	1672	+	184	6776576	91086
chr1	65154911	65354911	harbor1	chr1	65213720	65214082	LTR/ERVL-MaLR	1823	+	181	65213901	58990
chr1	65154911	65354911	harbor1	chr1	65233186	65233516	LTR/ERVL-MaLR	1166	+	165	65233351	78440
chr1	16544780	16744780	harbor1	chr1	16549687	16549813	LTR/ERVL-MaLR	601	+	63	16549750	4970
chr1	16544780	16744780	harbor1	chr1	16601299	16601923	LTR/ERVL-MaLR	1935	+	312	16601611	56831
chr1	16544780	16744780	harbor1	chr1	16605694	16605874	LTR/ERVL-MaLR	544	+	90	16605784	61004
chr1	167559746	167759746	harbor1	chr1	167569220	167569597	LTR/ERVL-MaLR	1027	+	188	167569408	9662
chr1	167559746	167759746	harbor1	chr1	167578986	167579436	LTR/ERVL-MaLR	1846	+	225	167579211	19465
chr1	167559746	167759746	harbor1	chr1	167589957	167590292	LTR/ERVL-MaLR	2305	+	168	167590125	30379
chr1	167559746	167759746	harbor1	chr1	167590591	167590637	LTR/ERVL-MaLR	2305	+	23	167590614	30868
chr1	167559746	167759746	harbor1	chr1	167593908	167594331	LTR/ERVL-MaLR	1337	+	212	167594120	34374
chr1	167559746	167759746	harbor1	chr1	167594623	167594720	LTR/ERVL-MaLR	1337	+	48	167594671	34925
chr1	167559746	167759746	harbor1	chr1	167604037	167604410	LTR/ERVL-MaLR	682	+	186	167604223	44477
chr1	167559746	167759746	harbor1	chr1	167606325	167606396	LTR/ERVL-MaLR	2308	+	36	167606361	46615
chr1	167559746	167759746	harbor1	chr1	167606705	167607053	LTR/ERVL-MaLR	2308	+	174	167606879	47133
chr1	167559746	167759746	harbor1	chr1	167608600	167609008	LTR/ERVL-MaLR	2499	+	204	167608804	49058
chr1	167559746	167759746	harbor1	chr1	167624787	167624993	LTR/ERVL-MaLR	1784	+	103	167624890	65144
chr1	167559746	167759746	harbor1	chr1	167625027	167625059	LTR/ERVL-MaLR	1784	+	16	167625043	65297
chr1	167559746	167759746	harbor1	chr1	167625193	167625356	LTR/ERVL-MaLR	1784	+	82	167625275	65529
chr1	167559746	167759746	harbor1	chr1	167607054	167608599	LTR/ERVL-MaLR	9035	+	772	167607826	48080
chr1	7122266	7322266	harbor1	chr1	7142462	7142876	LTR/ERVL-MaLR	2247	+	207	7142669	20403
chr1	7122266	7322266	harbor1	chr1	7161405	7161766	LTR/ERVL-MaLR	2244	+	180	7161585	39319
chr1	7122266	7322266	harbor1	chr1	7196035	7196395	LTR/ERVL-MaLR	1705	+	180	7196215	73949
chr1	7122266	7322266	harbor1	chr1	7217044	7217409	LTR/ERVL-MaLR	2405	+	182	7217226	94960
chr1	7122266	7322266	harbor1	chr1	7219589	7219753	LTR/ERVL-MaLR	1731	+	82	7219671	97405
chr1	7122266	7322266	harbor1	chr1	7219889	7220101	LTR/ERVL-MaLR	1731	+	106	7219995	97729
chr1	16544851	16744851	harbor1	chr1	16549687	16549813	LTR/ERVL-MaLR	601	+	63	16549750	4899
chr1	16544851	16744851	harbor1	chr1	16601299	16601923	LTR/ERVL-MaLR	1935	+	312	16601611	56760
chr1	16544851	16744851	harbor1	chr1	16605694	16605874	LTR/ERVL-MaLR	544	+	90	16605784	60933
chr1	16544789	16744789	harbor1	chr1	16549687	16549813	LTR/ERVL-MaLR	601	+	63	16549750	4961
chr1	16544789	16744789	harbor1	chr1	16601299	16601923	LTR/ERVL-MaLR	1935	+	312	16601611	56822
chr1	16544789	16744789	harbor1	chr1	16605694	16605874	LTR/ERVL-MaLR	544	+	90	16605784	60995
chr1	16544721	16744721	harbor1	chr1	16549687	16549813	LTR/ERVL-MaLR	601	+	63	16549750	5029
chr1	16544721	16744721	harbor1	chr1	16601299	16601923	LTR/ERVL-MaLR	1935	+	312	16601611	56890
chr1	16544721	16744721	harbor1	chr1	16605694	16605874	LTR/ERVL-MaLR	544	+	90	16605784	61063
chr1	16544890	16744890	harbor1	chr1	16549687	16549813	LTR/ERVL-MaLR	601	+	63	16549750	4860
chr1	16544890	16744890	harbor1	chr1	16601299	16601923	LTR/ERVL-MaLR	1935	+	312	16601611	56721
chr1	16544890	16744890	harbor1	chr1	16605694	16605874	LTR/ERVL-MaLR	544	+	90	16605784	60894
chr1	2138482	2338482	harbor1	chr1	2199627	2199797	LTR/ERVL-MaLR	761	+	85	2199712	61230
chr1	2138482	2338482	harbor1	chr1	2200424	2200663	LTR/ERVL-MaLR	761	+	120	2200544	62062
chr1	2138561	2338561	harbor1	chr1	2199627	2199797	LTR/ERVL-MaLR	761	+	85	2199712	61151
chr1	2138561	2338561	harbor1	chr1	2200424	2200663	LTR/ERVL-MaLR	761	+	120	2200544	61983
chr1	226010111	226210111	harbor1	chr1	226034114	226034219	LTR/ERVL-MaLR	471	+	52	226034166	24055
chr1	226010111	226210111	harbor1	chr1	226034410	226034863	LTR/ERVL-MaLR	1298	+	226	226034636	24525
chr1	226010111	226210111	harbor1	chr1	226044624	226045033	LTR/ERVL-MaLR	2685	+	204	226044828	34717
chr1	226010111	226210111	harbor1	chr1	226088389	226088656	LTR/ERVL-MaLR	665	+	134	226088523	78412
chr1	226010111	226210111	harbor1	chr1	226088924	226088974	LTR/ERVL-MaLR	706	+	25	226088949	78838
chr1	226010111	226210111	harbor1	chr1	226089295	226089738	LTR/ERVL-MaLR	706	+	222	226089517	79406
chr1	226010111	226210111	harbor1	chr1	226098826	226099032	LTR/ERVL-MaLR	475	+	103	226098929	88818
chr1	2138397	2338397	harbor1	chr1	2199627	2199797	LTR/ERVL-MaLR	761	+	85	2199712	61315
chr1	2138397	2338397	harbor1	chr1	2200424	2200663	LTR/ERVL-MaLR	761	+	120	2200544	62147
chr1	16545018	16745018	harbor1	chr1	16549687	16549813	LTR/ERVL-MaLR	601	+	63	16549750	4732
chr1	16545018	16745018	harbor1	chr1	16601299	16601923	LTR/ERVL-MaLR	1935	+	312	16601611	56593
chr1	16545018	16745018	harbor1	chr1	16605694	16605874	LTR/ERVL-MaLR	544	+	90	16605784	60766
chr1	2460293	2660293	harbor1	chr1	2550717	2550897	LTR/ERVL-MaLR	530	+	90	2550807	90514
chr1	2987716	3187716	harbor1	chr1	2994375	2994817	LTR/ERVL-MaLR	480	+	221	2994596	6880
chr1	2987716	3187716	harbor1	chr1	3006305	3006735	LTR/ERVL-MaLR	2681	+	215	3006520	18804
chr1	2987716	3187716	harbor1	chr1	3006736	3008389	LTR/ERVL-MaLR	9365	+	826	3007562	19846
chr1	2987716	3187716	harbor1	chr1	3008393	3008814	LTR/ERVL-MaLR	2647	+	210	3008603	20887
chr1	2987716	3187716	harbor1	chr1	3013458	3013762	LTR/ERVL-MaLR	585	+	152	3013610	25894
chr1	2987716	3187716	harbor1	chr1	3013982	3014365	LTR/ERVL-MaLR	814	+	192	3014174	26458
chr1	16544940	16744940	harbor1	chr1	16549687	16549813	LTR/ERVL-MaLR	601	+	63	16549750	4810
chr1	16544940	16744940	harbor1	chr1	16601299	16601923	LTR/ERVL-MaLR	1935	+	312	16601611	56671
chr1	16544940	16744940	harbor1	chr1	16605694	16605874	LTR/ERVL-MaLR	544	+	90	16605784	60844
chr1	16520804	16720804	harbor1	chr1	16549687	16549813	LTR/ERVL-MaLR	601	+	63	16549750	28946
chr1	16520804	16720804	harbor1	chr1	16601299	16601923	LTR/ERVL-MaLR	1935	+	312	16601611	80807
chr1	16520804	16720804	harbor1	chr1	16605694	16605874	LTR/ERVL-MaLR	544	+	90	16605784	84980
chr1	33270108	33470108	harbor1	chr1	33325217	33325564	LTR/ERVL-MaLR	852	+	174	33325391	55283
chr1	33270108	33470108	harbor1	chr1	33325660	33325783	LTR/ERVL-MaLR	493	+	62	33325722	55614
chr1	33270108	33470108	harbor1	chr1	33325784	33326671	LTR/ERVL-MaLR	5090	+	444	33326228	56120
chr1	33270108	33470108	harbor1	chr1	33326968	33327462	LTR/ERVL-MaLR	5090	+	247	33327215	57107
chr1	33270108	33470108	harbor1	chr1	33327475	33327957	LTR/ERVL-MaLR	1697	+	241	33327716	57608
chr1	211032764	211232764	harbor1	chr1	211037763	211037958	LTR/ERVL-MaLR	2260	+	98	211037861	5097
chr1	211032764	211232764	harbor1	chr1	211038261	211038409	LTR/ERVL-MaLR	2260	+	74	211038335	5571
chr1	211032764	211232764	harbor1	chr1	211038410	211039907	LTR/ERVL-MaLR	11957	+	748	211039158	6394
chr1	211032764	211232764	harbor1	chr1	211040208	211040285	LTR/ERVL-MaLR	11957	+	38	211040246	7482
chr1	211032764	211232764	harbor1	chr1	211040286	211040631	LTR/ERVL-MaLR	2413	+	172	211040458	7694
chr1	211032764	211232764	harbor1	chr1	211117273	211117597	LTR/ERVL-MaLR	476	+	162	211117435	84671
chr1	227441477	227641477	harbor1	chr1	227444014	227444110	LTR/ERVL-MaLR	693	+	48	227444062	2585
chr1	227441477	227641477	harbor1	chr1	227450807	227450925	LTR/ERVL-MaLR	525	+	59	227450866	9389
chr1	227441477	227641477	harbor1	chr1	227469821	227470200	LTR/ERVL-MaLR	1981	+	190	227470011	28534
chr1	227441477	227641477	harbor1	chr1	227470189	227471795	LTR/ERVL-MaLR	10921	+	803	227470992	29515
chr1	227441477	227641477	harbor1	chr1	227471801	227472189	LTR/ERVL-MaLR	2116	+	194	227471995	30518
chr1	227441477	227641477	harbor1	chr1	227485599	227485957	LTR/ERVL-MaLR	1836	+	179	227485778	44301
chr1	227441477	227641477	harbor1	chr1	227496875	227497027	LTR/ERVL-MaLR	2416	+	76	227496951	55474
chr1	227441477	227641477	harbor1	chr1	227497318	227497527	LTR/ERVL-MaLR	2416	+	104	227497422	55945
chr1	227441477	227641477	harbor1	chr1	227514578	227514630	LTR/ERVL-MaLR	1560	+	26	227514604	73127
chr1	227441477	227641477	harbor1	chr1	227515926	227516405	LTR/ERVL-MaLR	1560	+	240	227516166	74689
chr1	227441477	227641477	harbor1	chr1	227519533	227519868	LTR/ERVL-MaLR	1191	+	168	227519701	78224
chr1	3524787	3724787	harbor1	chr1	3524906	3525098	LTR/ERVL-MaLR	462	+	96	3525002	215
chr1	3524787	3724787	harbor1	chr1	3528445	3528945	LTR/ERVL-MaLR	2127	+	250	3528695	3908
chr1	3524787	3724787	harbor1	chr1	3556957	3557315	LTR/ERVL-MaLR	869	+	179	3557136	32349
chr1	3524787	3724787	harbor1	chr1	3588948	3589362	LTR/ERVL-MaLR	1101	+	207	3589155	64368
chr1	3524787	3724787	harbor1	chr1	3597495	3597874	LTR/ERVL-MaLR	1057	+	190	3597685	72898
chr1	3524787	3724787	harbor1	chr1	3619433	3619776	LTR/ERVL-MaLR	1918	+	172	3619605	94818
chr1	3524787	3724787	harbor1	chr1	3619777	3620647	LTR/ERVL-MaLR	3975	+	435	3620212	95425
chr1	3524787	3724787	harbor1	chr1	3621644	3622155	LTR/ERVL-MaLR	3975	+	256	3621900	97113
chr1	3524787	3724787	harbor1	chr1	3622156	3622504	LTR/ERVL-MaLR	2001	+	174	3622330	97543
chr1	3524787	3724787	harbor1	chr1	3622505	3622858	LTR/ERVL-MaLR	529	+	176	3622681	97894
chr1	16544926	16744926	harbor1	chr1	16549687	16549813	LTR/ERVL-MaLR	601	+	63	16549750	4824
chr1	16544926	16744926	harbor1	chr1	16601299	16601923	LTR/ERVL-MaLR	1935	+	312	16601611	56685
chr1	16544926	16744926	harbor1	chr1	16605694	16605874	LTR/ERVL-MaLR	544	+	90	16605784	60858
chr1	16117451	16317451	harbor1	chr1	16196768	16197117	LTR/ERVL-MaLR	674	+	174	16196942	79491
chr1	16117451	16317451	harbor1	chr1	16197388	16197855	LTR/ERVL-MaLR	1583	+	234	16197622	80171
chr1	16117451	16317451	harbor1	chr1	16197856	16197941	LTR/ERVL-MaLR	674	+	42	16197898	80447
chr1	3431193	3631193	harbor1	chr1	3512452	3512820	LTR/ERVL-MaLR	2554	+	184	3512636	81443
chr1	3431193	3631193	harbor1	chr1	3524906	3525098	LTR/ERVL-MaLR	462	+	96	3525002	93809
chr1	3431193	3631193	harbor1	chr1	3528445	3528945	LTR/ERVL-MaLR	2127	+	250	3528695	97502
chr1	89425139	89625139	harbor1	chr1	89435736	89436083	LTR/ERVL-MaLR	745	+	174	89435910	10771
chr1	89425139	89625139	harbor1	chr1	89464166	89464639	LTR/ERVL-MaLR	1897	+	236	89464402	39263
chr1	89425139	89625139	harbor1	chr1	89484572	89485071	LTR/ERVL-MaLR	1199	+	250	89484822	59683
chr1	89425139	89625139	harbor1	chr1	89514825	89515248	LTR/ERVL-MaLR	2212	+	212	89515037	89898
chr1	153558888	153758888	harbor1	chr1	153559538	153559859	LTR/ERVL-MaLR	492	+	160	153559698	810
chr1	153558888	153758888	harbor1	chr1	153584037	153584256	LTR/ERVL-MaLR	720	+	110	153584147	25259
chr1	2138530	2338530	harbor1	chr1	2199627	2199797	LTR/ERVL-MaLR	761	+	85	2199712	61182
chr1	2138530	2338530	harbor1	chr1	2200424	2200663	LTR/ERVL-MaLR	761	+	120	2200544	62014
chr1	16504141	16704141	harbor1	chr1	16549687	16549813	LTR/ERVL-MaLR	601	+	63	16549750	45609
chr1	16504141	16704141	harbor1	chr1	16601299	16601923	LTR/ERVL-MaLR	1935	+	312	16601611	97470
chr1	2138452	2338452	harbor1	chr1	2199627	2199797	LTR/ERVL-MaLR	761	+	85	2199712	61260
chr1	2138452	2338452	harbor1	chr1	2200424	2200663	LTR/ERVL-MaLR	761	+	120	2200544	62092
chr1	16545003	16745003	harbor1	chr1	16549687	16549813	LTR/ERVL-MaLR	601	+	63	16549750	4747
chr1	16545003	16745003	harbor1	chr1	16601299	16601923	LTR/ERVL-MaLR	1935	+	312	16601611	56608
chr1	16545003	16745003	harbor1	chr1	16605694	16605874	LTR/ERVL-MaLR	544	+	90	16605784	60781
chr1	16542821	16742821	harbor1	chr1	16549687	16549813	LTR/ERVL-MaLR	601	+	63	16549750	6929
chr1	16542821	16742821	harbor1	chr1	16601299	16601923	LTR/ERVL-MaLR	1935	+	312	16601611	58790
chr1	16542821	16742821	harbor1	chr1	16605694	16605874	LTR/ERVL-MaLR	544	+	90	16605784	62963
chr1	202827305	203027305	harbor1	chr1	202842751	202843047	LTR/ERVL-MaLR	485	+	148	202842899	15594
chr1	202827305	203027305	harbor1	chr1	202846493	202846730	LTR/ERVL-MaLR	989	+	118	202846611	19306
chr1	202827305	203027305	harbor1	chr1	202884384	202884594	LTR/ERVL-MaLR	675	+	105	202884489	57184
chr1	4612171	4812171	harbor1	chr1	4628997	4629257	LTR/ERVL-MaLR	648	+	130	4629127	16956
chr1	4612171	4812171	harbor1	chr1	4629229	4629482	LTR/ERVL-MaLR	913	+	126	4629355	17184
chr1	4612171	4812171	harbor1	chr1	4642429	4642808	LTR/ERVL-MaLR	1459	+	190	4642619	30448
chr1	4612171	4812171	harbor1	chr1	4648403	4648741	LTR/ERVL-MaLR	1055	+	169	4648572	36401
chr1	4612171	4812171	harbor1	chr1	4672729	4673283	LTR/ERVL-MaLR	992	+	277	4673006	60835
chr1	53370469	53570469	harbor1	chr1	53401320	53401788	LTR/ERVL-MaLR	1352	+	234	53401554	31085
chr1	53370469	53570469	harbor1	chr1	53401817	53402203	LTR/ERVL-MaLR	2332	+	193	53402010	31541
chr1	53370469	53570469	harbor1	chr1	53407571	53407973	LTR/ERVL-MaLR	1922	+	201	53407772	37303
chr1	53370469	53570469	harbor1	chr1	53418179	53418294	LTR/ERVL-MaLR	783	+	58	53418237	47768
chr1	53370469	53570469	harbor1	chr1	53418618	53418894	LTR/ERVL-MaLR	783	+	138	53418756	48287
chr1	53370469	53570469	harbor1	chr1	53421096	53421465	LTR/ERVL-MaLR	1976	+	184	53421280	50811
chr1	53370469	53570469	harbor1	chr1	53421467	53421646	LTR/ERVL-MaLR	928	+	90	53421557	51088
chr1	53370469	53570469	harbor1	chr1	53442384	53442765	LTR/ERVL-MaLR	2547	+	190	53442574	72105
chr1	53370469	53570469	harbor1	chr1	53443089	53443129	LTR/ERVL-MaLR	2547	+	20	53443109	72640
chr1	204585523	204785523	harbor1	chr1	204629414	204629756	LTR/ERVL-MaLR	2363	+	171	204629585	44062
chr1	204585523	204785523	harbor1	chr1	204632975	204633324	LTR/ERVL-MaLR	1516	+	174	204633149	47626
chr1	204585523	204785523	harbor1	chr1	204634384	204634810	LTR/ERVL-MaLR	1527	+	213	204634597	49074
chr1	204585523	204785523	harbor1	chr1	204650888	204651444	LTR/ERVL-MaLR	1537	+	278	204651166	65643
chr1	7134292	7334292	harbor1	chr1	7142462	7142876	LTR/ERVL-MaLR	2247	+	207	7142669	8377
chr1	7134292	7334292	harbor1	chr1	7161405	7161766	LTR/ERVL-MaLR	2244	+	180	7161585	27293
chr1	7134292	7334292	harbor1	chr1	7196035	7196395	LTR/ERVL-MaLR	1705	+	180	7196215	61923
chr1	7134292	7334292	harbor1	chr1	7217044	7217409	LTR/ERVL-MaLR	2405	+	182	7217226	82934
chr1	7134292	7334292	harbor1	chr1	7219589	7219753	LTR/ERVL-MaLR	1731	+	82	7219671	85379
chr1	7134292	7334292	harbor1	chr1	7219889	7220101	LTR/ERVL-MaLR	1731	+	106	7219995	85703
chr1	205330822	205530822	harbor1	chr1	205331922	205332355	LTR/ERVL-MaLR	1827	+	216	205332138	1316
chr1	3431298	3631298	harbor1	chr1	3512452	3512820	LTR/ERVL-MaLR	2554	+	184	3512636	81338
chr1	3431298	3631298	harbor1	chr1	3524906	3525098	LTR/ERVL-MaLR	462	+	96	3525002	93704
chr1	3431298	3631298	harbor1	chr1	3528445	3528945	LTR/ERVL-MaLR	2127	+	250	3528695	97397
chr1	1562609	1762609	harbor1	chr1	1582794	1583236	LTR/ERVL-MaLR	808	+	221	1583015	20406
chr1	1562609	1762609	harbor1	chr1	1592099	1592227	LTR/ERVL-MaLR	454	+	64	1592163	29554
chr1	1562609	1762609	harbor1	chr1	1610182	1610533	LTR/ERVL-MaLR	2197	+	176	1610358	47749
chr1	2460276	2660276	harbor1	chr1	2550717	2550897	LTR/ERVL-MaLR	530	+	90	2550807	90531
chr1	53370441	53570441	harbor1	chr1	53401320	53401788	LTR/ERVL-MaLR	1352	+	234	53401554	31113
chr1	53370441	53570441	harbor1	chr1	53401817	53402203	LTR/ERVL-MaLR	2332	+	193	53402010	31569
chr1	53370441	53570441	harbor1	chr1	53407571	53407973	LTR/ERVL-MaLR	1922	+	201	53407772	37331
chr1	53370441	53570441	harbor1	chr1	53418179	53418294	LTR/ERVL-MaLR	783	+	58	53418237	47796
chr1	53370441	53570441	harbor1	chr1	53418618	53418894	LTR/ERVL-MaLR	783	+	138	53418756	48315
chr1	53370441	53570441	harbor1	chr1	53421096	53421465	LTR/ERVL-MaLR	1976	+	184	53421280	50839
chr1	53370441	53570441	harbor1	chr1	53421467	53421646	LTR/ERVL-MaLR	928	+	90	53421557	51116
chr1	53370441	53570441	harbor1	chr1	53442384	53442765	LTR/ERVL-MaLR	2547	+	190	53442574	72133
chr1	53370441	53570441	harbor1	chr1	53443089	53443129	LTR/ERVL-MaLR	2547	+	20	53443109	72668
chr1	16544898	16744898	harbor1	chr1	16549687	16549813	LTR/ERVL-MaLR	601	+	63	16549750	4852
chr1	16544898	16744898	harbor1	chr1	16601299	16601923	LTR/ERVL-MaLR	1935	+	312	16601611	56713
chr1	16544898	16744898	harbor1	chr1	16605694	16605874	LTR/ERVL-MaLR	544	+	90	16605784	60886
chr1	148850447	149050447	harbor1	chr1	148932726	148933130	LTR/ERVL-MaLR	1993	+	202	148932928	82481
chr1	16504004	16704004	harbor1	chr1	16549687	16549813	LTR/ERVL-MaLR	601	+	63	16549750	45746
chr1	16504004	16704004	harbor1	chr1	16601299	16601923	LTR/ERVL-MaLR	1935	+	312	16601611	97607
chr1	6601080	6801080	harbor1	chr1	6657149	6657588	LTR/ERVL-MaLR	510	+	220	6657369	56289
chr1	16545023	16745023	harbor1	chr1	16549687	16549813	LTR/ERVL-MaLR	601	+	63	16549750	4727
chr1	16545023	16745023	harbor1	chr1	16601299	16601923	LTR/ERVL-MaLR	1935	+	312	16601611	56588
chr1	16545023	16745023	harbor1	chr1	16605694	16605874	LTR/ERVL-MaLR	544	+	90	16605784	60761
chr1	15330459	15530459	harbor1	chr1	15399896	15400336	LTR/ERVL-MaLR	591	+	220	15400116	69657
chr1	16267485	16467485	harbor1	chr1	16290250	16290410	LTR/ERVL-MaLR	1410	+	80	16290330	22845
chr1	16267485	16467485	harbor1	chr1	16290698	16290916	LTR/ERVL-MaLR	1410	+	109	16290807	23322
chr1	16267485	16467485	harbor1	chr1	16342683	16343110	LTR/ERVL-MaLR	2507	+	214	16342897	75412
chr1	53370472	53570472	harbor1	chr1	53401320	53401788	LTR/ERVL-MaLR	1352	+	234	53401554	31082
chr1	53370472	53570472	harbor1	chr1	53401817	53402203	LTR/ERVL-MaLR	2332	+	193	53402010	31538
chr1	53370472	53570472	harbor1	chr1	53407571	53407973	LTR/ERVL-MaLR	1922	+	201	53407772	37300
chr1	53370472	53570472	harbor1	chr1	53418179	53418294	LTR/ERVL-MaLR	783	+	58	53418237	47765
chr1	53370472	53570472	harbor1	chr1	53418618	53418894	LTR/ERVL-MaLR	783	+	138	53418756	48284
chr1	53370472	53570472	harbor1	chr1	53421096	53421465	LTR/ERVL-MaLR	1976	+	184	53421280	50808
chr1	53370472	53570472	harbor1	chr1	53421467	53421646	LTR/ERVL-MaLR	928	+	90	53421557	51085
chr1	53370472	53570472	harbor1	chr1	53442384	53442765	LTR/ERVL-MaLR	2547	+	190	53442574	72102
chr1	53370472	53570472	harbor1	chr1	53443089	53443129	LTR/ERVL-MaLR	2547	+	20	53443109	72637
chr1	2138464	2338464	harbor1	chr1	2199627	2199797	LTR/ERVL-MaLR	761	+	85	2199712	61248
chr1	2138464	2338464	harbor1	chr1	2200424	2200663	LTR/ERVL-MaLR	761	+	120	2200544	62080
chr1	1729686	1929686	harbor1	chr1	1767816	1767894	LTR/ERVL-MaLR	744	+	39	1767855	38169
chr1	1729686	1929686	harbor1	chr1	1768195	1768255	LTR/ERVL-MaLR	744	+	30	1768225	38539
chr1	1729686	1929686	harbor1	chr1	1768567	1768805	LTR/ERVL-MaLR	744	+	119	1768686	39000
chr1	3429504	3629504	harbor1	chr1	3512452	3512820	LTR/ERVL-MaLR	2554	+	184	3512636	83132
chr1	3429504	3629504	harbor1	chr1	3524906	3525098	LTR/ERVL-MaLR	462	+	96	3525002	95498
chr1	3429504	3629504	harbor1	chr1	3528445	3528945	LTR/ERVL-MaLR	2127	+	250	3528695	99191
chr1	2138502	2338502	harbor1	chr1	2199627	2199797	LTR/ERVL-MaLR	761	+	85	2199712	61210
chr1	2138502	2338502	harbor1	chr1	2200424	2200663	LTR/ERVL-MaLR	761	+	120	2200544	62042
chr1	16600695	16800695	harbor1	chr1	16601299	16601923	LTR/ERVL-MaLR	1935	+	312	16601611	916
chr1	16600695	16800695	harbor1	chr1	16605694	16605874	LTR/ERVL-MaLR	544	+	90	16605784	5089
chr1	53189636	53389636	harbor1	chr1	53201174	53201604	LTR/ERVL-MaLR	1865	+	215	53201389	11753
chr1	53189636	53389636	harbor1	chr1	53204634	53205002	LTR/ERVL-MaLR	2131	+	184	53204818	15182
chr1	53189636	53389636	harbor1	chr1	53205003	53205900	LTR/ERVL-MaLR	11883	+	448	53205451	15815
chr1	53189636	53389636	harbor1	chr1	53206204	53206920	LTR/ERVL-MaLR	11883	+	358	53206562	16926
chr1	53189636	53389636	harbor1	chr1	53206921	53207286	LTR/ERVL-MaLR	2078	+	182	53207103	17467
chr1	53189636	53389636	harbor1	chr1	53233959	53234353	LTR/ERVL-MaLR	1931	+	197	53234156	44520
chr1	53189636	53389636	harbor1	chr1	53283036	53283337	LTR/ERVL-MaLR	1585	+	150	53283186	93550
chr1	16544545	16744545	harbor1	chr1	16549687	16549813	LTR/ERVL-MaLR	601	+	63	16549750	5205
chr1	16544545	16744545	harbor1	chr1	16601299	16601923	LTR/ERVL-MaLR	1935	+	312	16601611	57066
chr1	16544545	16744545	harbor1	chr1	16605694	16605874	LTR/ERVL-MaLR	544	+	90	16605784	61239
chr1	36753751	36953751	harbor1	chr1	36772954	36773193	LTR/ERVL-MaLR	851	+	120	36773074	19323
chr1	36753751	36953751	harbor1	chr1	36784499	36784894	LTR/ERVL-MaLR	524	+	198	36784697	30946
chr1	36753751	36953751	harbor1	chr1	36794335	36794465	LTR/ERVL-MaLR	496	+	65	36794400	40649
chr1	36753751	36953751	harbor1	chr1	36808272	36808811	LTR/ERVL-MaLR	2361	+	270	36808542	54791
chr1	36753751	36953751	harbor1	chr1	36830340	36830527	LTR/ERVL-MaLR	1791	+	94	36830434	76683
chr1	36753751	36953751	harbor1	chr1	36830841	36831085	LTR/ERVL-MaLR	1791	+	122	36830963	77212
chr1	1538666	1738666	harbor1	chr1	1582794	1583236	LTR/ERVL-MaLR	808	+	221	1583015	44349
chr1	1538666	1738666	harbor1	chr1	1592099	1592227	LTR/ERVL-MaLR	454	+	64	1592163	53497
chr1	1538666	1738666	harbor1	chr1	1610182	1610533	LTR/ERVL-MaLR	2197	+	176	1610358	71692
chr1	94137807	94337807	harbor1	chr1	94140293	94140656	LTR/ERVL-MaLR	2448	+	182	94140475	2668
chr1	94137807	94337807	harbor1	chr1	94155320	94155725	LTR/ERVL-MaLR	2126	+	202	94155522	17715
chr1	16543056	16743056	harbor1	chr1	16549687	16549813	LTR/ERVL-MaLR	601	+	63	16549750	6694
chr1	16543056	16743056	harbor1	chr1	16601299	16601923	LTR/ERVL-MaLR	1935	+	312	16601611	58555
chr1	16543056	16743056	harbor1	chr1	16605694	16605874	LTR/ERVL-MaLR	544	+	90	16605784	62728
chr1	229331834	229531834	harbor1	chr1	229344852	229345268	LTR/ERVL-MaLR	2377	+	208	229345060	13226
chr1	229331834	229531834	harbor1	chr1	229347631	229348091	LTR/ERVL-MaLR	515	+	230	229347861	16027
chr1	229331834	229531834	harbor1	chr1	229348097	229348357	LTR/ERVL-MaLR	1170	+	130	229348227	16393
chr1	229331834	229531834	harbor1	chr1	229363694	229364100	LTR/ERVL-MaLR	1960	+	203	229363897	32063
chr1	229331834	229531834	harbor1	chr1	229365609	229365997	LTR/ERVL-MaLR	2178	+	194	229365803	33969
chr1	229331834	229531834	harbor1	chr1	229376821	229377161	LTR/ERVL-MaLR	1841	+	170	229376991	45157
chr1	229331834	229531834	harbor1	chr1	229383962	229384447	LTR/ERVL-MaLR	1522	+	242	229384204	52370
chr1	229331834	229531834	harbor1	chr1	229390062	229390450	LTR/ERVL-MaLR	1943	+	194	229390256	58422
chr1	229331834	229531834	harbor1	chr1	229425994	229426256	LTR/ERVL-MaLR	1458	+	131	229426125	94291
chr1	9589469	9789469	harbor1	chr1	9634865	9635007	LTR/ERVL-MaLR	554	+	71	9634936	45467
chr1	211033758	211233758	harbor1	chr1	211037763	211037958	LTR/ERVL-MaLR	2260	+	98	211037861	4103
chr1	211033758	211233758	harbor1	chr1	211038261	211038409	LTR/ERVL-MaLR	2260	+	74	211038335	4577
chr1	211033758	211233758	harbor1	chr1	211038410	211039907	LTR/ERVL-MaLR	11957	+	748	211039158	5400
chr1	211033758	211233758	harbor1	chr1	211040208	211040285	LTR/ERVL-MaLR	11957	+	38	211040246	6488
chr1	211033758	211233758	harbor1	chr1	211040286	211040631	LTR/ERVL-MaLR	2413	+	172	211040458	6700
chr1	211033758	211233758	harbor1	chr1	211117273	211117597	LTR/ERVL-MaLR	476	+	162	211117435	83677
chr1	185216973	185416973	harbor1	chr1	185278172	185278495	LTR/ERVL-MaLR	1608	+	162	185278334	61361
chr1	185216973	185416973	harbor1	chr1	185280012	185280378	LTR/ERVL-MaLR	2229	+	183	185280195	63222
chr1	7267274	7467274	harbor1	chr1	7271027	7271430	LTR/ERVL-MaLR	1280	+	202	7271229	3955
chr1	7267274	7467274	harbor1	chr1	7289546	7290095	LTR/ERVL-MaLR	1196	+	274	7289820	22546
chr1	7267274	7467274	harbor1	chr1	7319231	7319618	LTR/ERVL-MaLR	2502	+	194	7319425	52151
chr1	7267274	7467274	harbor1	chr1	7326379	7326822	LTR/ERVL-MaLR	2114	+	222	7326601	59327
chr1	39855337	40055337	harbor1	chr1	39929629	39929823	LTR/ERVL-MaLR	561	+	97	39929726	74389
chr1	39855337	40055337	harbor1	chr1	39930802	39931005	LTR/ERVL-MaLR	756	+	102	39930904	75567
chr1	157038008	157238008	harbor1	chr1	157055660	157056049	LTR/ERVL-MaLR	2028	+	194	157055854	17846
chr1	16517974	16717974	harbor1	chr1	16549687	16549813	LTR/ERVL-MaLR	601	+	63	16549750	31776
chr1	16517974	16717974	harbor1	chr1	16601299	16601923	LTR/ERVL-MaLR	1935	+	312	16601611	83637
chr1	16517974	16717974	harbor1	chr1	16605694	16605874	LTR/ERVL-MaLR	544	+	90	16605784	87810
chr1	43447553	43647553	harbor1	chr1	43454657	43454769	LTR/ERVL-MaLR	491	+	56	43454713	7160
chr1	43447553	43647553	harbor1	chr1	43461023	43461274	LTR/ERVL-MaLR	1299	+	126	43461149	13596
chr1	43447553	43647553	harbor1	chr1	43461286	43461478	LTR/ERVL-MaLR	1806	+	96	43461382	13829
chr1	43447553	43647553	harbor1	chr1	43461527	43461692	LTR/ERVL-MaLR	1806	+	82	43461609	14056
chr1	43447553	43647553	harbor1	chr1	43461700	43461948	LTR/ERVL-MaLR	1198	+	124	43461824	14271
chr1	43447553	43647553	harbor1	chr1	43511443	43511888	LTR/ERVL-MaLR	854	+	222	43511665	64112
chr1	43447553	43647553	harbor1	chr1	43466280	43466887	LTR/ERVL-MaLR	3085	+	304	43466584	19031
chr1	16490133	16690133	harbor1	chr1	16495286	16495689	LTR/ERVL-MaLR	1242	+	202	16495488	5355
chr1	16490133	16690133	harbor1	chr1	16549687	16549813	LTR/ERVL-MaLR	601	+	63	16549750	59617
chr1	53370438	53570438	harbor1	chr1	53401320	53401788	LTR/ERVL-MaLR	1352	+	234	53401554	31116
chr1	53370438	53570438	harbor1	chr1	53401817	53402203	LTR/ERVL-MaLR	2332	+	193	53402010	31572
chr1	53370438	53570438	harbor1	chr1	53407571	53407973	LTR/ERVL-MaLR	1922	+	201	53407772	37334
chr1	53370438	53570438	harbor1	chr1	53418179	53418294	LTR/ERVL-MaLR	783	+	58	53418237	47799
chr1	53370438	53570438	harbor1	chr1	53418618	53418894	LTR/ERVL-MaLR	783	+	138	53418756	48318
chr1	53370438	53570438	harbor1	chr1	53421096	53421465	LTR/ERVL-MaLR	1976	+	184	53421280	50842
chr1	53370438	53570438	harbor1	chr1	53421467	53421646	LTR/ERVL-MaLR	928	+	90	53421557	51119
chr1	53370438	53570438	harbor1	chr1	53442384	53442765	LTR/ERVL-MaLR	2547	+	190	53442574	72136
chr1	53370438	53570438	harbor1	chr1	53443089	53443129	LTR/ERVL-MaLR	2547	+	20	53443109	72671
chr1	2133810	2333810	harbor1	chr1	2199627	2199797	LTR/ERVL-MaLR	761	+	85	2199712	65902
chr1	2133810	2333810	harbor1	chr1	2200424	2200663	LTR/ERVL-MaLR	761	+	120	2200544	66734
chr1	2138449	2338449	harbor1	chr1	2199627	2199797	LTR/ERVL-MaLR	761	+	85	2199712	61263
chr1	2138449	2338449	harbor1	chr1	2200424	2200663	LTR/ERVL-MaLR	761	+	120	2200544	62095
chr1	92384641	92584641	harbor1	chr1	92408424	92408754	LTR/ERVL-MaLR	1693	+	165	92408589	23948
chr1	92384641	92584641	harbor1	chr1	92413572	92413944	LTR/ERVL-MaLR	1074	+	186	92413758	29117
chr1	92384641	92584641	harbor1	chr1	92465449	92465866	LTR/ERVL-MaLR	972	+	208	92465657	81016
chr1	6350574	6550574	harbor1	chr1	6355989	6356211	LTR/ERVL-MaLR	638	+	111	6356100	5526
chr1	6350574	6550574	harbor1	chr1	6369959	6370366	LTR/ERVL-MaLR	2322	+	204	6370163	19589
chr1	722912	922912	harbor1	chr1	769363	769790	LTR/ERVL-MaLR	1424	+	214	769577	46665
chr1	722912	922912	harbor1	chr1	813876	814012	LTR/ERVL-MaLR	612	+	68	813944	91032
chr1	722912	922912	harbor1	chr1	819066	819303	LTR/ERVL-MaLR	527	+	118	819184	96272
chr1	204633771	204833771	harbor1	chr1	204634384	204634810	LTR/ERVL-MaLR	1527	+	213	204634597	826
chr1	204633771	204833771	harbor1	chr1	204650888	204651444	LTR/ERVL-MaLR	1537	+	278	204651166	17395
chr1	47317003	47517003	harbor1	chr1	47323492	47323846	LTR/ERVL-MaLR	2069	+	177	47323669	6666
chr1	47317003	47517003	harbor1	chr1	47329042	47329295	LTR/ERVL-MaLR	648	+	126	47329168	12165
chr1	47317003	47517003	harbor1	chr1	47329437	47329587	LTR/ERVL-MaLR	911	+	75	47329512	12509
chr1	47317003	47517003	harbor1	chr1	47330186	47330248	LTR/ERVL-MaLR	911	+	31	47330217	13214
chr1	47317003	47517003	harbor1	chr1	47391189	47391486	LTR/ERVL-MaLR	1629	+	148	47391337	74334
chr1	47317003	47517003	harbor1	chr1	47391786	47391944	LTR/ERVL-MaLR	1629	+	79	47391865	74862
chr1	47317003	47517003	harbor1	chr1	47398337	47398905	LTR/ERVL-MaLR	1325	+	284	47398621	81618
chr1	15262474	15462474	harbor1	chr1	15292031	15292122	LTR/ERVL-MaLR	542	+	46	15292077	29603
chr1	15262474	15462474	harbor1	chr1	15292586	15292812	LTR/ERVL-MaLR	1346	+	113	15292699	30225
chr1	15262474	15462474	harbor1	chr1	15305545	15305895	LTR/ERVL-MaLR	2764	+	175	15305720	43246
chr1	15262474	15462474	harbor1	chr1	15305896	15307461	LTR/ERVL-MaLR	12487	+	782	15306678	44204
chr1	15262474	15462474	harbor1	chr1	15307462	15307728	LTR/ERVL-MaLR	2264	+	133	15307595	45121
chr1	15262474	15462474	harbor1	chr1	15308030	15308092	LTR/ERVL-MaLR	2264	+	31	15308061	45587
chr1	2152526	2352526	harbor1	chr1	2199627	2199797	LTR/ERVL-MaLR	761	+	85	2199712	47186
chr1	2152526	2352526	harbor1	chr1	2200424	2200663	LTR/ERVL-MaLR	761	+	120	2200544	48018
chr1	116052112	116252112	harbor1	chr1	116139749	116140110	LTR/ERVL-MaLR	1555	+	180	116139929	87817
chr1	92386045	92586045	harbor1	chr1	92408424	92408754	LTR/ERVL-MaLR	1693	+	165	92408589	22544
chr1	92386045	92586045	harbor1	chr1	92413572	92413944	LTR/ERVL-MaLR	1074	+	186	92413758	27713
chr1	92386045	92586045	harbor1	chr1	92465449	92465866	LTR/ERVL-MaLR	972	+	208	92465657	79612
chr1	160897940	161097940	harbor1	chr1	160920544	160920895	LTR/ERVL-MaLR	2141	+	176	160920720	22780
chr1	160897940	161097940	harbor1	chr1	160920896	160921391	LTR/ERVL-MaLR	11439	+	248	160921144	23204
chr1	160897940	161097940	harbor1	chr1	160921699	160922772	LTR/ERVL-MaLR	11439	+	536	160922235	24295
chr1	160897940	161097940	harbor1	chr1	160922773	160923066	LTR/ERVL-MaLR	2082	+	146	160922919	24979
chr1	160897940	161097940	harbor1	chr1	160923366	160923429	LTR/ERVL-MaLR	2082	+	32	160923398	25458
chr1	160897940	161097940	harbor1	chr1	160923979	160924337	LTR/ERVL-MaLR	2085	+	179	160924158	26218
chr1	160897940	161097940	harbor1	chr1	160973980	160974065	LTR/ERVL-MaLR	483	+	42	160974022	76082
chr1	160897940	161097940	harbor1	chr1	160974649	160974948	LTR/ERVL-MaLR	694	+	150	160974799	76859
chr1	153245885	153445885	harbor1	chr1	153264566	153264678	LTR/ERVL-MaLR	507	+	56	153264622	18737
chr1	153245885	153445885	harbor1	chr1	153266755	153267155	LTR/ERVL-MaLR	1779	+	200	153266955	21070
chr1	153245885	153445885	harbor1	chr1	153277093	153277277	LTR/ERVL-MaLR	1485	+	92	153277185	31300
chr1	153245885	153445885	harbor1	chr1	153277309	153277485	LTR/ERVL-MaLR	1485	+	88	153277397	31512
chr1	153245885	153445885	harbor1	chr1	153320936	153321329	LTR/ERVL-MaLR	2002	+	196	153321132	75247
chr1	153245885	153445885	harbor1	chr1	153323202	153323316	LTR/ERVL-MaLR	651	+	57	153323259	77374
chr1	153245885	153445885	harbor1	chr1	153323309	153323484	LTR/ERVL-MaLR	985	+	88	153323397	77512
chr1	194321308	194521308	harbor1	chr1	194324444	194324790	LTR/ERVL-MaLR	910	+	173	194324617	3309
chr1	194321308	194521308	harbor1	chr1	194347725	194348076	LTR/ERVL-MaLR	2541	+	176	194347901	26593
chr1	194321308	194521308	harbor1	chr1	194348077	194349635	LTR/ERVL-MaLR	11354	+	779	194348856	27548
chr1	194321308	194521308	harbor1	chr1	194349642	194349995	LTR/ERVL-MaLR	2652	+	176	194349818	28510
chr1	194321308	194521308	harbor1	chr1	194406633	194406978	LTR/ERVL-MaLR	1571	+	172	194406805	85497
chr1	11520749	11720749	harbor1	chr1	11544541	11544661	LTR/ERVL-MaLR	1293	+	60	11544601	23852
chr1	11520749	11720749	harbor1	chr1	11544662	11545071	LTR/ERVL-MaLR	1859	+	204	11544866	24117
chr1	11520749	11720749	harbor1	chr1	11545072	11545387	LTR/ERVL-MaLR	1293	+	158	11545230	24481
chr1	11520749	11720749	harbor1	chr1	11555749	11555817	LTR/ERVL-MaLR	670	+	34	11555783	35034
chr1	11520749	11720749	harbor1	chr1	11556335	11556498	LTR/ERVL-MaLR	670	+	82	11556417	35668
chr1	11520749	11720749	harbor1	chr1	11556515	11556674	LTR/ERVL-MaLR	759	+	80	11556595	35846
chr1	11520749	11720749	harbor1	chr1	11565686	11566136	LTR/ERVL-MaLR	1496	+	225	11565911	45162
chr1	11520749	11720749	harbor1	chr1	11574265	11574445	LTR/ERVL-MaLR	1702	+	90	11574355	53606
chr1	11520749	11720749	harbor1	chr1	11574736	11574883	LTR/ERVL-MaLR	1702	+	74	11574810	54061
chr1	11520749	11720749	harbor1	chr1	11575210	11575322	LTR/ERVL-MaLR	1702	+	56	11575266	54517
chr1	11520749	11720749	harbor1	chr1	11587243	11587661	LTR/ERVL-MaLR	1063	+	209	11587452	66703
chr1	11520749	11720749	harbor1	chr1	11587662	11588085	LTR/ERVL-MaLR	2871	+	212	11587874	67125
chr1	11520749	11720749	harbor1	chr1	11588086	11588199	LTR/ERVL-MaLR	1063	+	56	11588142	67393
chr1	11520749	11720749	harbor1	chr1	11590548	11590885	LTR/ERVL-MaLR	695	+	168	11590716	69967
chr1	11520749	11720749	harbor1	chr1	11590915	11590953	LTR/ERVL-MaLR	1687	+	19	11590934	70185
chr1	11520749	11720749	harbor1	chr1	11591265	11591408	LTR/ERVL-MaLR	1687	+	72	11591337	70588
chr1	11520749	11720749	harbor1	chr1	11591861	11592180	LTR/ERVL-MaLR	1687	+	160	11592021	71272
chr1	11520749	11720749	harbor1	chr1	11608408	11608568	LTR/ERVL-MaLR	474	+	80	11608488	87739
chr1	11520749	11720749	harbor1	chr1	11609921	11609955	LTR/ERVL-MaLR	474	+	17	11609938	89189
chr1	11520749	11720749	harbor1	chr1	11613044	11613407	LTR/ERVL-MaLR	2634	+	182	11613226	92477
chr1	11520749	11720749	harbor1	chr1	11618312	11618390	LTR/ERVL-MaLR	871	+	39	11618351	97602
chr1	11520749	11720749	harbor1	chr1	11618691	11619028	LTR/ERVL-MaLR	871	+	168	11618859	98110
chr1	11520749	11720749	harbor1	chr1	11583285	11583606	LTR/ERVL-MaLR	1618	+	160	11583445	62696
chr1	211033691	211233691	harbor1	chr1	211037763	211037958	LTR/ERVL-MaLR	2260	+	98	211037861	4170
chr1	211033691	211233691	harbor1	chr1	211038261	211038409	LTR/ERVL-MaLR	2260	+	74	211038335	4644
chr1	211033691	211233691	harbor1	chr1	211038410	211039907	LTR/ERVL-MaLR	11957	+	748	211039158	5467
chr1	211033691	211233691	harbor1	chr1	211040208	211040285	LTR/ERVL-MaLR	11957	+	38	211040246	6555
chr1	211033691	211233691	harbor1	chr1	211040286	211040631	LTR/ERVL-MaLR	2413	+	172	211040458	6767
chr1	211033691	211233691	harbor1	chr1	211117273	211117597	LTR/ERVL-MaLR	476	+	162	211117435	83744
chr1	6567487	6767487	harbor1	chr1	6657149	6657588	LTR/ERVL-MaLR	510	+	220	6657369	89882
chr1	29351447	29551447	harbor1	chr1	29356462	29356623	LTR/ERVL-MaLR	570	+	80	29356542	5095
chr1	29351447	29551447	harbor1	chr1	29380651	29381057	LTR/ERVL-MaLR	518	+	203	29380854	29407
chr1	29351447	29551447	harbor1	chr1	29399197	29399624	LTR/ERVL-MaLR	2061	+	214	29399411	47964
chr1	29351447	29551447	harbor1	chr1	29399636	29400046	LTR/ERVL-MaLR	2724	+	205	29399841	48394
chr1	29351447	29551447	harbor1	chr1	29405005	29405643	LTR/ERVL-MaLR	3526	+	319	29405324	53877
chr1	29351447	29551447	harbor1	chr1	29428348	29428683	LTR/ERVL-MaLR	616	+	168	29428516	77069
chr1	29351447	29551447	harbor1	chr1	29431082	29431508	LTR/ERVL-MaLR	1889	+	213	29431295	79848
chr1	29351447	29551447	harbor1	chr1	29434917	29434978	LTR/ERVL-MaLR	1659	+	30	29434947	83500
chr1	29351447	29551447	harbor1	chr1	29435285	29435473	LTR/ERVL-MaLR	1659	+	94	29435379	83932
chr1	29351447	29551447	harbor1	chr1	29435781	29435971	LTR/ERVL-MaLR	1659	+	95	29435876	84429
chr1	29351447	29551447	harbor1	chr1	29435972	29437598	LTR/ERVL-MaLR	7000	+	813	29436785	85338
chr1	29351447	29551447	harbor1	chr1	29437599	29437675	LTR/ERVL-MaLR	435	+	38	29437637	86190
chr1	29351447	29551447	harbor1	chr1	29437666	29437908	LTR/ERVL-MaLR	1123	+	121	29437787	86340
chr1	29351447	29551447	harbor1	chr1	29437914	29438352	LTR/ERVL-MaLR	1332	+	219	29438133	86686
chr1	29351447	29551447	harbor1	chr1	29438678	29438733	LTR/ERVL-MaLR	1332	+	28	29438706	87259
chr1	29351447	29551447	harbor1	chr1	29450461	29450645	LTR/ERVL-MaLR	509	+	92	29450553	99106
chr1	16544832	16744832	harbor1	chr1	16549687	16549813	LTR/ERVL-MaLR	601	+	63	16549750	4918
chr1	16544832	16744832	harbor1	chr1	16601299	16601923	LTR/ERVL-MaLR	1935	+	312	16601611	56779
chr1	16544832	16744832	harbor1	chr1	16605694	16605874	LTR/ERVL-MaLR	544	+	90	16605784	60952
chr1	1676051	1876051	harbor1	chr1	1767816	1767894	LTR/ERVL-MaLR	744	+	39	1767855	91804
chr1	1676051	1876051	harbor1	chr1	1768195	1768255	LTR/ERVL-MaLR	744	+	30	1768225	92174
chr1	1676051	1876051	harbor1	chr1	1768567	1768805	LTR/ERVL-MaLR	744	+	119	1768686	92635
chr1	20561106	20761106	harbor1	chr1	20561048	20561185	LTR/ERVL-MaLR	524	+	68	20561116	10
chr1	20561106	20761106	harbor1	chr1	20561422	20561638	LTR/ERVL-MaLR	507	+	108	20561530	424
chr1	20561106	20761106	harbor1	chr1	20562402	20562467	LTR/ERVL-MaLR	1316	+	32	20562434	1328
chr1	20561106	20761106	harbor1	chr1	20569614	20569933	LTR/ERVL-MaLR	1032	+	160	20569774	8668
chr1	20561106	20761106	harbor1	chr1	20571312	20571757	LTR/ERVL-MaLR	1239	+	222	20571534	10428
chr1	20561106	20761106	harbor1	chr1	20598158	20598506	LTR/ERVL-MaLR	1632	+	174	20598332	37226
chr1	20561106	20761106	harbor1	chr1	20617379	20617682	LTR/ERVL-MaLR	2791	+	152	20617531	56425
chr1	20561106	20761106	harbor1	chr1	20617997	20618069	LTR/ERVL-MaLR	2791	+	36	20618033	56927
chr1	20561106	20761106	harbor1	chr1	20561640	20562106	LTR/ERVL-MaLR	1316	+	233	20561873	767
chr1	211730554	211930554	harbor1	chr1	211731103	211731548	LTR/ERVL-MaLR	1722	+	222	211731325	771
chr1	211730554	211930554	harbor1	chr1	211796280	211796642	LTR/ERVL-MaLR	1405	+	181	211796461	65907
chr1	211730554	211930554	harbor1	chr1	211809494	211809861	LTR/ERVL-MaLR	2833	+	184	211809678	79124
chr1	211730554	211930554	harbor1	chr1	211812575	211812976	LTR/ERVL-MaLR	625	+	200	211812775	82221
chr1	211730554	211930554	harbor1	chr1	211763157	211763566	LTR/ERVL-MaLR	1660	+	204	211763361	32807
chr1	201549223	201749223	harbor1	chr1	201601151	201601199	LTR/ERVL-MaLR	1620	+	24	201601175	51952
chr1	201549223	201749223	harbor1	chr1	201601490	201601810	LTR/ERVL-MaLR	1620	+	160	201601650	52427
chr1	7552592	7752592	harbor1	chr1	7576325	7576685	LTR/ERVL-MaLR	1779	+	180	7576505	23913
chr1	3431300	3631300	harbor1	chr1	3512452	3512820	LTR/ERVL-MaLR	2554	+	184	3512636	81336
chr1	3431300	3631300	harbor1	chr1	3524906	3525098	LTR/ERVL-MaLR	462	+	96	3525002	93702
chr1	3431300	3631300	harbor1	chr1	3528445	3528945	LTR/ERVL-MaLR	2127	+	250	3528695	97395
chr1	152203804	152403804	harbor1	chr1	152237523	152237909	LTR/ERVL-MaLR	2149	+	193	152237716	33912
chr1	152203804	152403804	harbor1	chr1	152253696	152253866	LTR/ERVL-MaLR	1103	+	85	152253781	49977
chr1	152203804	152403804	harbor1	chr1	152290651	152291076	LTR/ERVL-MaLR	2721	+	212	152290863	87059
chr1	209543647	209743647	harbor1	chr1	209578215	209578562	LTR/ERVL-MaLR	2323	+	174	209578389	34742
chr1	53846295	54046295	harbor1	chr1	53848656	53848893	LTR/ERVL-MaLR	538	+	118	53848774	2479
chr1	53846295	54046295	harbor1	chr1	53849510	53849730	LTR/ERVL-MaLR	538	+	110	53849620	3325
chr1	53846295	54046295	harbor1	chr1	53850681	53851026	LTR/ERVL-MaLR	2341	+	172	53850853	4558
chr1	53846295	54046295	harbor1	chr1	53856817	53857350	LTR/ERVL-MaLR	1597	+	266	53857083	10788
chr1	53846295	54046295	harbor1	chr1	53913645	53914005	LTR/ERVL-MaLR	1347	+	180	53913825	67530
chr1	53846295	54046295	harbor1	chr1	53919306	53919656	LTR/ERVL-MaLR	757	+	175	53919481	73186
chr1	12393958	12593958	harbor1	chr1	12438162	12438501	LTR/ERVL-MaLR	1607	+	170	12438332	44374
chr1	25516603	25716603	harbor1	chr1	25598750	25599217	LTR/ERVL-MaLR	996	+	234	25598984	82381
chr1	44307706	44507706	harbor1	chr1	44374448	44374873	LTR/ERVL-MaLR	1906	+	212	44374660	66954
chr1	41562092	41762092	harbor1	chr1	41568821	41569236	LTR/ERVL-MaLR	2696	+	208	41569029	6937
chr1	41562092	41762092	harbor1	chr1	41570268	41570640	LTR/ERVL-MaLR	2469	+	186	41570454	8362
chr1	41562092	41762092	harbor1	chr1	41572888	41573030	LTR/ERVL-MaLR	690	+	71	41572959	10867
chr1	41562092	41762092	harbor1	chr1	41604458	41604747	LTR/ERVL-MaLR	857	+	144	41604602	42510
chr1	41562092	41762092	harbor1	chr1	41629148	41629270	LTR/ERVL-MaLR	486	+	61	41629209	67117
chr1	41562092	41762092	harbor1	chr1	41630440	41630859	LTR/ERVL-MaLR	1679	+	210	41630650	68558
chr1	53846285	54046285	harbor1	chr1	53848656	53848893	LTR/ERVL-MaLR	538	+	118	53848774	2489
chr1	53846285	54046285	harbor1	chr1	53849510	53849730	LTR/ERVL-MaLR	538	+	110	53849620	3335
chr1	53846285	54046285	harbor1	chr1	53850681	53851026	LTR/ERVL-MaLR	2341	+	172	53850853	4568
chr1	53846285	54046285	harbor1	chr1	53856817	53857350	LTR/ERVL-MaLR	1597	+	266	53857083	10798
chr1	53846285	54046285	harbor1	chr1	53913645	53914005	LTR/ERVL-MaLR	1347	+	180	53913825	67540
chr1	53846285	54046285	harbor1	chr1	53919306	53919656	LTR/ERVL-MaLR	757	+	175	53919481	73196
chr1	2138477	2338477	harbor1	chr1	2199627	2199797	LTR/ERVL-MaLR	761	+	85	2199712	61235
chr1	2138477	2338477	harbor1	chr1	2200424	2200663	LTR/ERVL-MaLR	761	+	120	2200544	62067
chr1	16531613	16731613	harbor1	chr1	16549687	16549813	LTR/ERVL-MaLR	601	+	63	16549750	18137
chr1	16531613	16731613	harbor1	chr1	16601299	16601923	LTR/ERVL-MaLR	1935	+	312	16601611	69998
chr1	16531613	16731613	harbor1	chr1	16605694	16605874	LTR/ERVL-MaLR	544	+	90	16605784	74171
chr1	678890	878890	harbor1	chr1	698203	698441	LTR/ERVL-MaLR	1163	+	119	698322	19432
chr1	678890	878890	harbor1	chr1	700724	701000	LTR/ERVL-MaLR	1163	+	138	700862	21972
chr1	678890	878890	harbor1	chr1	704677	705086	LTR/ERVL-MaLR	1130	+	204	704881	25991
chr1	678890	878890	harbor1	chr1	708596	709085	LTR/ERVL-MaLR	1881	+	244	708840	29950
chr1	678890	878890	harbor1	chr1	769363	769790	LTR/ERVL-MaLR	1424	+	214	769577	90687
chr1	16542818	16742818	harbor1	chr1	16549687	16549813	LTR/ERVL-MaLR	601	+	63	16549750	6932
chr1	16542818	16742818	harbor1	chr1	16601299	16601923	LTR/ERVL-MaLR	1935	+	312	16601611	58793
chr1	16542818	16742818	harbor1	chr1	16605694	16605874	LTR/ERVL-MaLR	544	+	90	16605784	62966
chr1	16543037	16743037	harbor1	chr1	16549687	16549813	LTR/ERVL-MaLR	601	+	63	16549750	6713
chr1	16543037	16743037	harbor1	chr1	16601299	16601923	LTR/ERVL-MaLR	1935	+	312	16601611	58574
chr1	16543037	16743037	harbor1	chr1	16605694	16605874	LTR/ERVL-MaLR	544	+	90	16605784	62747
chr1	53312624	53512624	harbor1	chr1	53341155	53341501	LTR/ERVL-MaLR	2541	+	173	53341328	28704
chr1	53312624	53512624	harbor1	chr1	53350502	53350865	LTR/ERVL-MaLR	1147	+	182	53350684	38060
chr1	53312624	53512624	harbor1	chr1	53357012	53357249	LTR/ERVL-MaLR	884	+	118	53357130	44506
chr1	53312624	53512624	harbor1	chr1	53401320	53401788	LTR/ERVL-MaLR	1352	+	234	53401554	88930
chr1	53312624	53512624	harbor1	chr1	53401817	53402203	LTR/ERVL-MaLR	2332	+	193	53402010	89386
chr1	53312624	53512624	harbor1	chr1	53407571	53407973	LTR/ERVL-MaLR	1922	+	201	53407772	95148
chr1	85965115	86165115	harbor1	chr1	85995680	85996030	LTR/ERVL-MaLR	1950	+	175	85995855	30740
chr1	85965115	86165115	harbor1	chr1	85997357	85997502	LTR/ERVL-MaLR	963	+	72	85997429	32314
chr1	85965115	86165115	harbor1	chr1	85997765	85998142	LTR/ERVL-MaLR	963	+	188	85997953	32838
chr1	85965115	86165115	harbor1	chr1	86026312	86026685	LTR/ERVL-MaLR	2190	+	186	86026498	61383
chr1	85965115	86165115	harbor1	chr1	86026688	86028296	LTR/ERVL-MaLR	10394	+	804	86027492	62377
chr1	85965115	86165115	harbor1	chr1	86028297	86028667	LTR/ERVL-MaLR	2283	+	185	86028482	63367
chr1	85965115	86165115	harbor1	chr1	86037192	86037780	LTR/ERVL-MaLR	1443	+	294	86037486	72371
chr1	85965115	86165115	harbor1	chr1	86038517	86039041	LTR/ERVL-MaLR	2330	+	262	86038779	73664
chr1	85965115	86165115	harbor1	chr1	86057006	86057412	LTR/ERVL-MaLR	2221	+	203	86057209	92094
chr1	85965115	86165115	harbor1	chr1	86059712	86060039	LTR/ERVL-MaLR	1318	+	164	86059876	94761
chr1	1676022	1876022	harbor1	chr1	1767816	1767894	LTR/ERVL-MaLR	744	+	39	1767855	91833
chr1	1676022	1876022	harbor1	chr1	1768195	1768255	LTR/ERVL-MaLR	744	+	30	1768225	92203
chr1	1676022	1876022	harbor1	chr1	1768567	1768805	LTR/ERVL-MaLR	744	+	119	1768686	92664
chr1	31913327	32113327	harbor1	chr1	31961094	31961448	LTR/ERVL-MaLR	1101	+	177	31961271	47944
chr1	31913327	32113327	harbor1	chr1	31976440	31976759	LTR/ERVL-MaLR	828	+	160	31976600	63273
chr1	31913327	32113327	harbor1	chr1	31977359	31977494	LTR/ERVL-MaLR	828	+	68	31977427	64100
chr1	16344104	16544104	harbor1	chr1	16403255	16403467	LTR/ERVL-MaLR	511	+	106	16403361	59257
chr1	16344104	16544104	harbor1	chr1	16406314	16406460	LTR/ERVL-MaLR	1604	+	73	16406387	62283
chr1	16344104	16544104	harbor1	chr1	16406764	16406991	LTR/ERVL-MaLR	1604	+	114	16406878	62774
chr1	16344104	16544104	harbor1	chr1	16430659	16431156	LTR/ERVL-MaLR	1210	+	248	16430907	86803
chr1	2460272	2660272	harbor1	chr1	2550717	2550897	LTR/ERVL-MaLR	530	+	90	2550807	90535
chr1	16544840	16744840	harbor1	chr1	16549687	16549813	LTR/ERVL-MaLR	601	+	63	16549750	4910
chr1	16544840	16744840	harbor1	chr1	16601299	16601923	LTR/ERVL-MaLR	1935	+	312	16601611	56771
chr1	16544840	16744840	harbor1	chr1	16605694	16605874	LTR/ERVL-MaLR	544	+	90	16605784	60944
chr1	19565193	19765193	harbor1	chr1	19570696	19570769	LTR/ERVL-MaLR	2037	+	36	19570732	5539
chr1	19565193	19765193	harbor1	chr1	19571073	19571403	LTR/ERVL-MaLR	2037	+	165	19571238	6045
chr1	19565193	19765193	harbor1	chr1	19571676	19572014	LTR/ERVL-MaLR	1489	+	169	19571845	6652
chr1	19565193	19765193	harbor1	chr1	19572550	19572895	LTR/ERVL-MaLR	2192	+	172	19572722	7529
chr1	6685532	6885532	harbor1	chr1	6723372	6723800	LTR/ERVL-MaLR	1341	+	214	6723586	38054
chr1	6685532	6885532	harbor1	chr1	6727933	6728054	LTR/ERVL-MaLR	601	+	60	6727993	42461
chr1	6685532	6885532	harbor1	chr1	6728232	6728264	LTR/ERVL-MaLR	727	+	16	6728248	42716
chr1	6685532	6885532	harbor1	chr1	6728559	6728812	LTR/ERVL-MaLR	727	+	126	6728685	43153
chr1	6685532	6885532	harbor1	chr1	6731368	6731529	LTR/ERVL-MaLR	959	+	80	6731448	45916
chr1	6685532	6885532	harbor1	chr1	6737821	6738131	LTR/ERVL-MaLR	507	+	155	6737976	52444
chr1	6685532	6885532	harbor1	chr1	6748480	6748628	LTR/ERVL-MaLR	570	+	74	6748554	63022
chr1	6685532	6885532	harbor1	chr1	6748792	6749028	LTR/ERVL-MaLR	1494	+	118	6748910	63378
chr1	6685532	6885532	harbor1	chr1	6765629	6766007	LTR/ERVL-MaLR	2323	+	189	6765818	80286
chr1	6685532	6885532	harbor1	chr1	6769039	6769163	LTR/ERVL-MaLR	735	+	62	6769101	83569
chr1	6685532	6885532	harbor1	chr1	6776004	6776116	LTR/ERVL-MaLR	1672	+	56	6776060	90528
chr1	6685532	6885532	harbor1	chr1	6776392	6776760	LTR/ERVL-MaLR	1672	+	184	6776576	91044
chr1	22610011	22810011	harbor1	chr1	22682536	22683033	LTR/ERVL-MaLR	1322	+	248	22682784	72773
chr1	6685524	6885524	harbor1	chr1	6723372	6723800	LTR/ERVL-MaLR	1341	+	214	6723586	38062
chr1	6685524	6885524	harbor1	chr1	6727933	6728054	LTR/ERVL-MaLR	601	+	60	6727993	42469
chr1	6685524	6885524	harbor1	chr1	6728232	6728264	LTR/ERVL-MaLR	727	+	16	6728248	42724
chr1	6685524	6885524	harbor1	chr1	6728559	6728812	LTR/ERVL-MaLR	727	+	126	6728685	43161
chr1	6685524	6885524	harbor1	chr1	6731368	6731529	LTR/ERVL-MaLR	959	+	80	6731448	45924
chr1	6685524	6885524	harbor1	chr1	6737821	6738131	LTR/ERVL-MaLR	507	+	155	6737976	52452
chr1	6685524	6885524	harbor1	chr1	6748480	6748628	LTR/ERVL-MaLR	570	+	74	6748554	63030
chr1	6685524	6885524	harbor1	chr1	6748792	6749028	LTR/ERVL-MaLR	1494	+	118	6748910	63386
chr1	6685524	6885524	harbor1	chr1	6765629	6766007	LTR/ERVL-MaLR	2323	+	189	6765818	80294
chr1	6685524	6885524	harbor1	chr1	6769039	6769163	LTR/ERVL-MaLR	735	+	62	6769101	83577
chr1	6685524	6885524	harbor1	chr1	6776004	6776116	LTR/ERVL-MaLR	1672	+	56	6776060	90536
chr1	6685524	6885524	harbor1	chr1	6776392	6776760	LTR/ERVL-MaLR	1672	+	184	6776576	91052
chr1	211033713	211233713	harbor1	chr1	211037763	211037958	LTR/ERVL-MaLR	2260	+	98	211037861	4148
chr1	211033713	211233713	harbor1	chr1	211038261	211038409	LTR/ERVL-MaLR	2260	+	74	211038335	4622
chr1	211033713	211233713	harbor1	chr1	211038410	211039907	LTR/ERVL-MaLR	11957	+	748	211039158	5445
chr1	211033713	211233713	harbor1	chr1	211040208	211040285	LTR/ERVL-MaLR	11957	+	38	211040246	6533
chr1	211033713	211233713	harbor1	chr1	211040286	211040631	LTR/ERVL-MaLR	2413	+	172	211040458	6745
chr1	211033713	211233713	harbor1	chr1	211117273	211117597	LTR/ERVL-MaLR	476	+	162	211117435	83722
chr1	5847916	6047916	harbor1	chr1	5848431	5848631	LTR/ERVL-MaLR	1439	+	100	5848531	615
chr1	5847916	6047916	harbor1	chr1	5851650	5852027	LTR/ERVL-MaLR	2099	+	188	5851838	3922
chr1	5847916	6047916	harbor1	chr1	5854866	5855070	LTR/ERVL-MaLR	624	+	102	5854968	7052
chr1	5847916	6047916	harbor1	chr1	5860977	5861290	LTR/ERVL-MaLR	875	+	156	5861133	13217
chr1	5847916	6047916	harbor1	chr1	5917264	5917611	LTR/ERVL-MaLR	923	+	174	5917438	69522
chr1	5847916	6047916	harbor1	chr1	5917743	5918090	LTR/ERVL-MaLR	760	+	174	5917917	70001
chr1	5847916	6047916	harbor1	chr1	5921903	5922363	LTR/ERVL-MaLR	1902	+	230	5922133	74217
chr1	5847916	6047916	harbor1	chr1	5936769	5937132	LTR/ERVL-MaLR	569	+	182	5936951	89035
chr1	5847916	6047916	harbor1	chr1	5940094	5940458	LTR/ERVL-MaLR	1717	+	182	5940276	92360
chr1	26595914	26795914	harbor1	chr1	26647904	26648278	LTR/ERVL-MaLR	447	+	187	26648091	52177
chr1	207902897	208102897	harbor1	chr1	207925079	207925630	LTR/ERVL-MaLR	2076	+	276	207925355	22458
chr1	207902897	208102897	harbor1	chr1	207933226	207933438	LTR/ERVL-MaLR	997	+	106	207933332	30435
chr1	207902897	208102897	harbor1	chr1	207933990	207934200	LTR/ERVL-MaLR	997	+	105	207934095	31198
chr1	207902897	208102897	harbor1	chr1	207956074	207956380	LTR/ERVL-MaLR	519	+	153	207956227	53330
chr1	207902897	208102897	harbor1	chr1	207967104	207967210	LTR/ERVL-MaLR	448	+	53	207967157	64260
chr1	207902897	208102897	harbor1	chr1	207967263	207967349	LTR/ERVL-MaLR	430	+	43	207967306	64409
chr1	207902897	208102897	harbor1	chr1	207967596	207967859	LTR/ERVL-MaLR	733	+	132	207967728	64831
chr1	207902897	208102897	harbor1	chr1	208000877	208001207	LTR/ERVL-MaLR	1610	+	165	208001042	98145
chr1	211033788	211233788	harbor1	chr1	211037763	211037958	LTR/ERVL-MaLR	2260	+	98	211037861	4073
chr1	211033788	211233788	harbor1	chr1	211038261	211038409	LTR/ERVL-MaLR	2260	+	74	211038335	4547
chr1	211033788	211233788	harbor1	chr1	211038410	211039907	LTR/ERVL-MaLR	11957	+	748	211039158	5370
chr1	211033788	211233788	harbor1	chr1	211040208	211040285	LTR/ERVL-MaLR	11957	+	38	211040246	6458
chr1	211033788	211233788	harbor1	chr1	211040286	211040631	LTR/ERVL-MaLR	2413	+	172	211040458	6670
chr1	211033788	211233788	harbor1	chr1	211117273	211117597	LTR/ERVL-MaLR	476	+	162	211117435	83647
chr1	2308936	2508936	harbor1	chr1	2352203	2352368	LTR/ERVL-MaLR	444	+	82	2352285	43349
chr1	16544915	16744915	harbor1	chr1	16549687	16549813	LTR/ERVL-MaLR	601	+	63	16549750	4835
chr1	16544915	16744915	harbor1	chr1	16601299	16601923	LTR/ERVL-MaLR	1935	+	312	16601611	56696
chr1	16544915	16744915	harbor1	chr1	16605694	16605874	LTR/ERVL-MaLR	544	+	90	16605784	60869
chr1	14850144	15050144	harbor1	chr1	14861585	14862072	LTR/ERVL-MaLR	1160	+	244	14861829	11685
chr1	14850144	15050144	harbor1	chr1	14865663	14866084	LTR/ERVL-MaLR	1495	+	210	14865873	15729
chr1	14850144	15050144	harbor1	chr1	14896397	14896557	LTR/ERVL-MaLR	442	+	80	14896477	46333
chr1	14850144	15050144	harbor1	chr1	14917744	14917866	LTR/ERVL-MaLR	1794	+	61	14917805	67661
chr1	14850144	15050144	harbor1	chr1	14918177	14918398	LTR/ERVL-MaLR	1794	+	110	14918287	68143
chr1	14850144	15050144	harbor1	chr1	14918750	14919000	LTR/ERVL-MaLR	1794	+	125	14918875	68731
chr1	167355252	167555252	harbor1	chr1	167403306	167403417	LTR/ERVL-MaLR	676	+	56	167403362	48110
chr1	167355252	167555252	harbor1	chr1	167451648	167451824	LTR/ERVL-MaLR	1468	+	88	167451736	96484
chr1	167355252	167555252	harbor1	chr1	167452430	167452531	LTR/ERVL-MaLR	1468	+	50	167452480	97228
chr1	9589463	9789463	harbor1	chr1	9634865	9635007	LTR/ERVL-MaLR	554	+	71	9634936	45473
chr1	2138444	2338444	harbor1	chr1	2199627	2199797	LTR/ERVL-MaLR	761	+	85	2199712	61268
chr1	2138444	2338444	harbor1	chr1	2200424	2200663	LTR/ERVL-MaLR	761	+	120	2200544	62100
chr1	202249009	202449009	harbor1	chr1	202330218	202330582	LTR/ERVL-MaLR	516	+	182	202330400	81391
chr1	202249009	202449009	harbor1	chr1	202325998	202326430	LTR/ERVL-MaLR	893	+	216	202326214	77205
chr1	2138411	2338411	harbor1	chr1	2199627	2199797	LTR/ERVL-MaLR	761	+	85	2199712	61301
chr1	2138411	2338411	harbor1	chr1	2200424	2200663	LTR/ERVL-MaLR	761	+	120	2200544	62133
chr1	2459939	2659939	harbor1	chr1	2550717	2550897	LTR/ERVL-MaLR	530	+	90	2550807	90868
chr1	161066263	161266263	harbor1	chr1	161105946	161106347	LTR/ERVL-MaLR	2216	+	200	161106146	39883
chr1	210684182	210884182	harbor1	chr1	210692495	210692933	LTR/ERVL-MaLR	1416	+	219	210692714	8532
chr1	210684182	210884182	harbor1	chr1	210708932	210708977	LTR/ERVL-MaLR	1807	+	22	210708954	24772
chr1	210684182	210884182	harbor1	chr1	210709252	210709544	LTR/ERVL-MaLR	1807	+	146	210709398	25216
chr1	210684182	210884182	harbor1	chr1	210752752	210753198	LTR/ERVL-MaLR	1570	+	223	210752975	68793
chr1	210684182	210884182	harbor1	chr1	210754426	210754830	LTR/ERVL-MaLR	2314	+	202	210754628	70446
chr1	210684182	210884182	harbor1	chr1	210776390	210776762	LTR/ERVL-MaLR	1962	+	186	210776576	92394
chr1	210684182	210884182	harbor1	chr1	210777803	210778304	LTR/ERVL-MaLR	1297	+	250	210778053	93871
chr1	210684182	210884182	harbor1	chr1	210782298	210782443	LTR/ERVL-MaLR	2136	+	72	210782370	98188
chr1	210684182	210884182	harbor1	chr1	210782753	210782980	LTR/ERVL-MaLR	2136	+	114	210782867	98685
chr1	210684182	210884182	harbor1	chr1	210783403	210783851	LTR/ERVL-MaLR	1223	+	224	210783627	99445
chr1	244605824	244805824	harbor1	chr1	244613763	244614189	LTR/ERVL-MaLR	2489	+	213	244613976	8152
chr1	244605824	244805824	harbor1	chr1	244647360	244647825	LTR/ERVL-MaLR	1599	+	232	244647592	41768
chr1	244605824	244805824	harbor1	chr1	244649357	244649835	LTR/ERVL-MaLR	2036	+	239	244649596	43772
chr1	244605824	244805824	harbor1	chr1	244672179	244672539	LTR/ERVL-MaLR	2308	+	180	244672359	66535
chr1	244605824	244805824	harbor1	chr1	244700970	244701719	LTR/ERVL-MaLR	2607	+	374	244701344	95520
chr1	201325164	201525164	harbor1	chr1	201424338	201424825	LTR/ERVL-MaLR	2451	+	244	201424582	99418
chr1	205330828	205530828	harbor1	chr1	205331922	205332355	LTR/ERVL-MaLR	1827	+	216	205332138	1310
chr1	16544904	16744904	harbor1	chr1	16549687	16549813	LTR/ERVL-MaLR	601	+	63	16549750	4846
chr1	16544904	16744904	harbor1	chr1	16601299	16601923	LTR/ERVL-MaLR	1935	+	312	16601611	56707
chr1	16544904	16744904	harbor1	chr1	16605694	16605874	LTR/ERVL-MaLR	544	+	90	16605784	60880
chr1	145919577	146119577	harbor1	chr1	145953591	145953775	LTR/ERVL-MaLR	2120	+	92	145953683	34106
chr1	145919577	146119577	harbor1	chr1	145954075	145954364	LTR/ERVL-MaLR	2120	+	144	145954219	34642
chr1	52827225	53027225	harbor1	chr1	52880427	52881002	LTR/ERVL-MaLR	1532	+	288	52880715	53490
chr1	52827225	53027225	harbor1	chr1	52915678	52916248	LTR/ERVL-MaLR	1434	+	285	52915963	88738
chr1	2138621	2338621	harbor1	chr1	2199627	2199797	LTR/ERVL-MaLR	761	+	85	2199712	61091
chr1	2138621	2338621	harbor1	chr1	2200424	2200663	LTR/ERVL-MaLR	761	+	120	2200544	61923
chr1	3431299	3631299	harbor1	chr1	3512452	3512820	LTR/ERVL-MaLR	2554	+	184	3512636	81337
chr1	3431299	3631299	harbor1	chr1	3524906	3525098	LTR/ERVL-MaLR	462	+	96	3525002	93703
chr1	3431299	3631299	harbor1	chr1	3528445	3528945	LTR/ERVL-MaLR	2127	+	250	3528695	97396
chr1	16544923	16744923	harbor1	chr1	16549687	16549813	LTR/ERVL-MaLR	601	+	63	16549750	4827
chr1	16544923	16744923	harbor1	chr1	16601299	16601923	LTR/ERVL-MaLR	1935	+	312	16601611	56688
chr1	16544923	16744923	harbor1	chr1	16605694	16605874	LTR/ERVL-MaLR	544	+	90	16605784	60861
chr1	2126800	2326800	harbor1	chr1	2199627	2199797	LTR/ERVL-MaLR	761	+	85	2199712	72912
chr1	2126800	2326800	harbor1	chr1	2200424	2200663	LTR/ERVL-MaLR	761	+	120	2200544	73744
chr1	6685486	6885486	harbor1	chr1	6723372	6723800	LTR/ERVL-MaLR	1341	+	214	6723586	38100
chr1	6685486	6885486	harbor1	chr1	6727933	6728054	LTR/ERVL-MaLR	601	+	60	6727993	42507
chr1	6685486	6885486	harbor1	chr1	6728232	6728264	LTR/ERVL-MaLR	727	+	16	6728248	42762
chr1	6685486	6885486	harbor1	chr1	6728559	6728812	LTR/ERVL-MaLR	727	+	126	6728685	43199
chr1	6685486	6885486	harbor1	chr1	6731368	6731529	LTR/ERVL-MaLR	959	+	80	6731448	45962
chr1	6685486	6885486	harbor1	chr1	6737821	6738131	LTR/ERVL-MaLR	507	+	155	6737976	52490
chr1	6685486	6885486	harbor1	chr1	6748480	6748628	LTR/ERVL-MaLR	570	+	74	6748554	63068
chr1	6685486	6885486	harbor1	chr1	6748792	6749028	LTR/ERVL-MaLR	1494	+	118	6748910	63424
chr1	6685486	6885486	harbor1	chr1	6765629	6766007	LTR/ERVL-MaLR	2323	+	189	6765818	80332
chr1	6685486	6885486	harbor1	chr1	6769039	6769163	LTR/ERVL-MaLR	735	+	62	6769101	83615
chr1	6685486	6885486	harbor1	chr1	6776004	6776116	LTR/ERVL-MaLR	1672	+	56	6776060	90574
chr1	6685486	6885486	harbor1	chr1	6776392	6776760	LTR/ERVL-MaLR	1672	+	184	6776576	91090
chr1	226785705	226985705	harbor1	chr1	226786095	226786317	LTR/ERVL-MaLR	729	+	111	226786206	501
chr1	226785705	226985705	harbor1	chr1	226786629	226786842	LTR/ERVL-MaLR	729	+	106	226786735	1030
chr1	226785705	226985705	harbor1	chr1	226802917	226803214	LTR/ERVL-MaLR	1160	+	148	226803065	17360
chr1	226785705	226985705	harbor1	chr1	226810894	226811286	LTR/ERVL-MaLR	2409	+	196	226811090	25385
chr1	226785705	226985705	harbor1	chr1	226845289	226845481	LTR/ERVL-MaLR	1002	+	96	226845385	59680
chr1	226785705	226985705	harbor1	chr1	226845670	226846139	LTR/ERVL-MaLR	4923	+	234	226845904	60199
chr1	226785705	226985705	harbor1	chr1	226846455	226847365	LTR/ERVL-MaLR	4923	+	455	226846910	61205
chr1	1676052	1876052	harbor1	chr1	1767816	1767894	LTR/ERVL-MaLR	744	+	39	1767855	91803
chr1	1676052	1876052	harbor1	chr1	1768195	1768255	LTR/ERVL-MaLR	744	+	30	1768225	92173
chr1	1676052	1876052	harbor1	chr1	1768567	1768805	LTR/ERVL-MaLR	744	+	119	1768686	92634
chr1	2217905	2417905	harbor1	chr1	2277285	2277630	LTR/ERVL-MaLR	2395	+	172	2277457	59552
chr1	202013163	202213163	harbor1	chr1	202031246	202031349	LTR/ERVL-MaLR	568	+	52	202031298	18135
chr1	202013163	202213163	harbor1	chr1	202037396	202037746	LTR/ERVL-MaLR	2804	+	175	202037571	24408
chr1	161447394	161647394	harbor1	chr1	161493497	161493802	LTR/ERVL-MaLR	798	+	152	161493649	46255
chr1	161447394	161647394	harbor1	chr1	161494999	161495575	LTR/ERVL-MaLR	1382	+	288	161495287	47893
chr1	161447394	161647394	harbor1	chr1	161495790	161496189	LTR/ERVL-MaLR	1556	+	200	161495990	48596
chr1	161447394	161647394	harbor1	chr1	161498997	161499146	LTR/ERVL-MaLR	537	+	74	161499071	51677
chr1	161447394	161647394	harbor1	chr1	161508964	161509313	LTR/ERVL-MaLR	1899	+	174	161509138	61744
chr1	161447394	161647394	harbor1	chr1	161521546	161521889	LTR/ERVL-MaLR	2240	+	172	161521718	74324
chr1	16544980	16744980	harbor1	chr1	16549687	16549813	LTR/ERVL-MaLR	601	+	63	16549750	4770
chr1	16544980	16744980	harbor1	chr1	16601299	16601923	LTR/ERVL-MaLR	1935	+	312	16601611	56631
chr1	16544980	16744980	harbor1	chr1	16605694	16605874	LTR/ERVL-MaLR	544	+	90	16605784	60804
chr1	16544958	16744958	harbor1	chr1	16549687	16549813	LTR/ERVL-MaLR	601	+	63	16549750	4792
chr1	16544958	16744958	harbor1	chr1	16601299	16601923	LTR/ERVL-MaLR	1935	+	312	16601611	56653
chr1	16544958	16744958	harbor1	chr1	16605694	16605874	LTR/ERVL-MaLR	544	+	90	16605784	60826
chr1	3431328	3631328	harbor1	chr1	3512452	3512820	LTR/ERVL-MaLR	2554	+	184	3512636	81308
chr1	3431328	3631328	harbor1	chr1	3524906	3525098	LTR/ERVL-MaLR	462	+	96	3525002	93674
chr1	3431328	3631328	harbor1	chr1	3528445	3528945	LTR/ERVL-MaLR	2127	+	250	3528695	97367
chr1	46294443	46494443	harbor1	chr1	46320101	46320295	LTR/ERVL-MaLR	1420	+	97	46320198	25755
chr1	46294443	46494443	harbor1	chr1	46321264	46321398	LTR/ERVL-MaLR	1420	+	67	46321331	26888
chr1	46294443	46494443	harbor1	chr1	46321554	46321780	LTR/ERVL-MaLR	1242	+	113	46321667	27224
chr1	46294443	46494443	harbor1	chr1	46368262	46368674	LTR/ERVL-MaLR	1104	+	206	46368468	74025
chr1	46294443	46494443	harbor1	chr1	46370397	46370543	LTR/ERVL-MaLR	493	+	73	46370470	76027
chr1	185628149	185828149	harbor1	chr1	185634714	185635065	LTR/ERVL-MaLR	2409	+	176	185634890	6741
chr1	185628149	185828149	harbor1	chr1	185669721	185670071	LTR/ERVL-MaLR	703	+	175	185669896	41747
chr1	2138117	2338117	harbor1	chr1	2199627	2199797	LTR/ERVL-MaLR	761	+	85	2199712	61595
chr1	2138117	2338117	harbor1	chr1	2200424	2200663	LTR/ERVL-MaLR	761	+	120	2200544	62427
chr1	929831	1129831	harbor1	chr1	993731	994041	LTR/ERVL-MaLR	2047	+	155	993886	64055
chr1	929831	1129831	harbor1	chr1	994335	994401	LTR/ERVL-MaLR	2047	+	33	994368	64537
chr1	6351852	6551852	harbor1	chr1	6355989	6356211	LTR/ERVL-MaLR	638	+	111	6356100	4248
chr1	6351852	6551852	harbor1	chr1	6369959	6370366	LTR/ERVL-MaLR	2322	+	204	6370163	18311
chr1	245603537	245803537	harbor1	chr1	245623895	245624203	LTR/ERVL-MaLR	1257	+	154	245624049	20512
chr1	245603537	245803537	harbor1	chr1	245696053	245696551	LTR/ERVL-MaLR	1888	+	249	245696302	92765
chr1	201549188	201749188	harbor1	chr1	201601151	201601199	LTR/ERVL-MaLR	1620	+	24	201601175	51987
chr1	201549188	201749188	harbor1	chr1	201601490	201601810	LTR/ERVL-MaLR	1620	+	160	201601650	52462
chr1	31972901	32172901	harbor1	chr1	31976440	31976759	LTR/ERVL-MaLR	828	+	160	31976600	3699
chr1	31972901	32172901	harbor1	chr1	31977359	31977494	LTR/ERVL-MaLR	828	+	68	31977427	4526
chr1	10857681	11057681	harbor1	chr1	10924354	10924747	LTR/ERVL-MaLR	2505	+	196	10924550	66869
chr1	10857681	11057681	harbor1	chr1	10931194	10931384	LTR/ERVL-MaLR	2509	+	95	10931289	73608
chr1	10857681	11057681	harbor1	chr1	10931999	10932223	LTR/ERVL-MaLR	2509	+	112	10932111	74430
chr1	156191597	156391597	harbor1	chr1	156270157	156270368	LTR/ERVL-MaLR	601	+	106	156270263	78666
chr1	156191597	156391597	harbor1	chr1	156270423	156270554	LTR/ERVL-MaLR	430	+	66	156270489	78892
chr1	53312611	53512611	harbor1	chr1	53341155	53341501	LTR/ERVL-MaLR	2541	+	173	53341328	28717
chr1	53312611	53512611	harbor1	chr1	53350502	53350865	LTR/ERVL-MaLR	1147	+	182	53350684	38073
chr1	53312611	53512611	harbor1	chr1	53357012	53357249	LTR/ERVL-MaLR	884	+	118	53357130	44519
chr1	53312611	53512611	harbor1	chr1	53401320	53401788	LTR/ERVL-MaLR	1352	+	234	53401554	88943
chr1	53312611	53512611	harbor1	chr1	53401817	53402203	LTR/ERVL-MaLR	2332	+	193	53402010	89399
chr1	53312611	53512611	harbor1	chr1	53407571	53407973	LTR/ERVL-MaLR	1922	+	201	53407772	95161
chr1	2138491	2338491	harbor1	chr1	2199627	2199797	LTR/ERVL-MaLR	761	+	85	2199712	61221
chr1	2138491	2338491	harbor1	chr1	2200424	2200663	LTR/ERVL-MaLR	761	+	120	2200544	62053
chr1	2138400	2338400	harbor1	chr1	2199627	2199797	LTR/ERVL-MaLR	761	+	85	2199712	61312
chr1	2138400	2338400	harbor1	chr1	2200424	2200663	LTR/ERVL-MaLR	761	+	120	2200544	62144
chr1	7925872	8125872	harbor1	chr1	7997879	7998134	LTR/ERVL-MaLR	1641	+	128	7998007	72135
chr1	2138451	2338451	harbor1	chr1	2199627	2199797	LTR/ERVL-MaLR	761	+	85	2199712	61261
chr1	2138451	2338451	harbor1	chr1	2200424	2200663	LTR/ERVL-MaLR	761	+	120	2200544	62093
chr1	206972503	207172503	harbor1	chr1	206980838	206981379	LTR/ERVL-MaLR	1672	+	270	206981108	8605
chr1	206972503	207172503	harbor1	chr1	206988495	206988695	LTR/ERVL-MaLR	1068	+	100	206988595	16092
chr1	206972503	207172503	harbor1	chr1	206996277	206996436	LTR/ERVL-MaLR	720	+	80	206996357	23854
chr1	25516631	25716631	harbor1	chr1	25598750	25599217	LTR/ERVL-MaLR	996	+	234	25598984	82353
chr1	65574334	65774334	harbor1	chr1	65590361	65590731	LTR/ERVL-MaLR	2097	+	185	65590546	16212
chr1	65574334	65774334	harbor1	chr1	65648782	65649150	LTR/ERVL-MaLR	2082	+	184	65648966	74632
chr1	65574334	65774334	harbor1	chr1	65650843	65651044	LTR/ERVL-MaLR	1221	+	100	65650943	76609
chr1	16544749	16744749	harbor1	chr1	16549687	16549813	LTR/ERVL-MaLR	601	+	63	16549750	5001
chr1	16544749	16744749	harbor1	chr1	16601299	16601923	LTR/ERVL-MaLR	1935	+	312	16601611	56862
chr1	16544749	16744749	harbor1	chr1	16605694	16605874	LTR/ERVL-MaLR	544	+	90	16605784	61035
chr1	230539098	230739098	harbor1	chr1	230564247	230564592	LTR/ERVL-MaLR	2071	+	172	230564419	25321
chr1	230539098	230739098	harbor1	chr1	230585089	230585583	LTR/ERVL-MaLR	2723	+	247	230585336	46238
chr1	230539098	230739098	harbor1	chr1	230615216	230615584	LTR/ERVL-MaLR	1947	+	184	230615400	76302
chr1	230539098	230739098	harbor1	chr1	230616411	230616541	LTR/ERVL-MaLR	449	+	65	230616476	77378
chr1	230539098	230739098	harbor1	chr1	230618901	230619376	LTR/ERVL-MaLR	1358	+	238	230619139	80041
chr1	230539098	230739098	harbor1	chr1	230621279	230621743	LTR/ERVL-MaLR	1594	+	232	230621511	82413
chr1	230539098	230739098	harbor1	chr1	230623506	230623712	LTR/ERVL-MaLR	851	+	103	230623609	84511
chr1	230539098	230739098	harbor1	chr1	230633029	230633479	LTR/ERVL-MaLR	904	+	225	230633254	94156
chr2	196936108	197136108	harbor1	chr2	196943394	196943937	LTR/ERVL-MaLR	1089	+	272	196943666	7558
chr2	196936108	197136108	harbor1	chr2	196967798	196967912	LTR/ERVL-MaLR	660	+	57	196967855	31747
chr2	196936108	197136108	harbor1	chr2	196967942	196968154	LTR/ERVL-MaLR	1548	+	106	196968048	31940
chr2	196936108	197136108	harbor1	chr2	196978059	196978456	LTR/ERVL-MaLR	2437	+	198	196978257	42149
chr2	196936108	197136108	harbor1	chr2	196984843	196985384	LTR/ERVL-MaLR	2143	+	270	196985113	49005
chr2	231297344	231497344	harbor1	chr2	231348052	231348460	LTR/ERVL-MaLR	2045	+	204	231348256	50912
chr2	231297344	231497344	harbor1	chr2	231350659	231350946	LTR/ERVL-MaLR	787	+	144	231350803	53459
chr2	231297344	231497344	harbor1	chr2	231351253	231351465	LTR/ERVL-MaLR	787	+	106	231351359	54015
chr2	219075964	219275964	harbor1	chr2	219138884	219139079	LTR/ERVL-MaLR	1936	+	98	219138982	63018
chr2	219075964	219275964	harbor1	chr2	219139388	219139669	LTR/ERVL-MaLR	1936	+	140	219139528	63564
chr2	219075964	219275964	harbor1	chr2	219139979	219140039	LTR/ERVL-MaLR	1936	+	30	219140009	64045
chr2	576801	776801	harbor1	chr2	655677	656007	LTR/ERVL-MaLR	801	+	165	655842	79041
chr2	219059508	219259508	harbor1	chr2	219138884	219139079	LTR/ERVL-MaLR	1936	+	98	219138982	79474
chr2	219059508	219259508	harbor1	chr2	219139388	219139669	LTR/ERVL-MaLR	1936	+	140	219139528	80020
chr2	219059508	219259508	harbor1	chr2	219139979	219140039	LTR/ERVL-MaLR	1936	+	30	219140009	80501
chr2	219077783	219277783	harbor1	chr2	219138884	219139079	LTR/ERVL-MaLR	1936	+	98	219138982	61199
chr2	219077783	219277783	harbor1	chr2	219139388	219139669	LTR/ERVL-MaLR	1936	+	140	219139528	61745
chr2	219077783	219277783	harbor1	chr2	219139979	219140039	LTR/ERVL-MaLR	1936	+	30	219140009	62226
chr2	26950260	27150260	harbor1	chr2	26985687	26986056	LTR/ERVL-MaLR	826	+	184	26985871	35611
chr2	26950260	27150260	harbor1	chr2	27028397	27028496	LTR/ERVL-MaLR	1992	+	50	27028447	78187
chr2	26950260	27150260	harbor1	chr2	27028803	27028934	LTR/ERVL-MaLR	1992	+	66	27028869	78609
chr2	26950260	27150260	harbor1	chr2	27029230	27029518	LTR/ERVL-MaLR	1992	+	144	27029374	79114
chr2	26950260	27150260	harbor1	chr2	26968037	26968182	LTR/ERVL-MaLR	476	+	72	26968109	17849
chr2	43053914	43253914	harbor1	chr2	43090689	43091038	LTR/ERVL-MaLR	2316	+	174	43090863	36949
chr2	43053914	43253914	harbor1	chr2	43105264	43105653	LTR/ERVL-MaLR	1774	+	194	43105458	51544
chr2	43053914	43253914	harbor1	chr2	43138639	43138743	LTR/ERVL-MaLR	565	+	52	43138691	84777
chr2	43053914	43253914	harbor1	chr2	43139955	43140080	LTR/ERVL-MaLR	525	+	62	43140017	86103
chr2	202592159	202792159	harbor1	chr2	202675576	202675702	LTR/ERVL-MaLR	2322	+	63	202675639	83480
chr2	202592159	202792159	harbor1	chr2	202676009	202676375	LTR/ERVL-MaLR	2322	+	183	202676192	84033
chr2	202592159	202792159	harbor1	chr2	202676678	202676743	LTR/ERVL-MaLR	2322	+	32	202676710	84551
chr2	202592159	202792159	harbor1	chr2	202676747	202677058	LTR/ERVL-MaLR	1281	+	156	202676903	84744
chr2	202592159	202792159	harbor1	chr2	202677366	202677440	LTR/ERVL-MaLR	1281	+	37	202677403	85244
chr2	53462886	53662886	harbor1	chr2	53487493	53487825	LTR/ERVL-MaLR	1641	+	166	53487659	24773
chr2	53462886	53662886	harbor1	chr2	53492484	53492859	LTR/ERVL-MaLR	2509	+	188	53492672	29786
chr2	53462886	53662886	harbor1	chr2	53493003	53493357	LTR/ERVL-MaLR	1878	+	177	53493180	30294
chr2	53462886	53662886	harbor1	chr2	53547842	53547926	LTR/ERVL-MaLR	562	+	42	53547884	84998
chr2	53462886	53662886	harbor1	chr2	53547922	53548060	LTR/ERVL-MaLR	843	+	69	53547991	85105
chr2	53462886	53662886	harbor1	chr2	53557291	53557775	LTR/ERVL-MaLR	1368	+	242	53557533	94647
chr2	70453138	70653138	harbor1	chr2	70477490	70477890	LTR/ERVL-MaLR	1259	+	200	70477690	24552
chr2	70453138	70653138	harbor1	chr2	70481546	70482042	LTR/ERVL-MaLR	2348	+	248	70481794	28656
chr2	219077871	219277871	harbor1	chr2	219138884	219139079	LTR/ERVL-MaLR	1936	+	98	219138982	61111
chr2	219077871	219277871	harbor1	chr2	219139388	219139669	LTR/ERVL-MaLR	1936	+	140	219139528	61657
chr2	219077871	219277871	harbor1	chr2	219139979	219140039	LTR/ERVL-MaLR	1936	+	30	219140009	62138
chr2	218166674	218366674	harbor1	chr2	218169982	218170226	LTR/ERVL-MaLR	626	+	122	218170104	3430
chr2	218166674	218366674	harbor1	chr2	218201869	218202171	LTR/ERVL-MaLR	1386	+	151	218202020	35346
chr2	219078284	219278284	harbor1	chr2	219138884	219139079	LTR/ERVL-MaLR	1936	+	98	219138982	60698
chr2	219078284	219278284	harbor1	chr2	219139388	219139669	LTR/ERVL-MaLR	1936	+	140	219139528	61244
chr2	219078284	219278284	harbor1	chr2	219139979	219140039	LTR/ERVL-MaLR	1936	+	30	219140009	61725
chr2	219060209	219260209	harbor1	chr2	219138884	219139079	LTR/ERVL-MaLR	1936	+	98	219138982	78773
chr2	219060209	219260209	harbor1	chr2	219139388	219139669	LTR/ERVL-MaLR	1936	+	140	219139528	79319
chr2	219060209	219260209	harbor1	chr2	219139979	219140039	LTR/ERVL-MaLR	1936	+	30	219140009	79800
chr2	26950206	27150206	harbor1	chr2	26985687	26986056	LTR/ERVL-MaLR	826	+	184	26985871	35665
chr2	26950206	27150206	harbor1	chr2	27028397	27028496	LTR/ERVL-MaLR	1992	+	50	27028447	78241
chr2	26950206	27150206	harbor1	chr2	27028803	27028934	LTR/ERVL-MaLR	1992	+	66	27028869	78663
chr2	26950206	27150206	harbor1	chr2	27029230	27029518	LTR/ERVL-MaLR	1992	+	144	27029374	79168
chr2	26950206	27150206	harbor1	chr2	26968037	26968182	LTR/ERVL-MaLR	476	+	72	26968109	17903
chr2	219070304	219270304	harbor1	chr2	219138884	219139079	LTR/ERVL-MaLR	1936	+	98	219138982	68678
chr2	219070304	219270304	harbor1	chr2	219139388	219139669	LTR/ERVL-MaLR	1936	+	140	219139528	69224
chr2	219070304	219270304	harbor1	chr2	219139979	219140039	LTR/ERVL-MaLR	1936	+	30	219140009	69705
chr2	72038963	72238963	harbor1	chr2	72050686	72050943	LTR/ERVL-MaLR	760	+	128	72050814	11851
chr2	72038963	72238963	harbor1	chr2	72053519	72053871	LTR/ERVL-MaLR	895	+	176	72053695	14732
chr2	72038963	72238963	harbor1	chr2	72070457	72070935	LTR/ERVL-MaLR	1847	+	239	72070696	31733
chr2	72038963	72238963	harbor1	chr2	72075494	72075844	LTR/ERVL-MaLR	468	+	175	72075669	36706
chr2	72038963	72238963	harbor1	chr2	72109198	72109763	LTR/ERVL-MaLR	1920	+	282	72109480	70517
chr2	219078190	219278190	harbor1	chr2	219138884	219139079	LTR/ERVL-MaLR	1936	+	98	219138982	60792
chr2	219078190	219278190	harbor1	chr2	219139388	219139669	LTR/ERVL-MaLR	1936	+	140	219139528	61338
chr2	219078190	219278190	harbor1	chr2	219139979	219140039	LTR/ERVL-MaLR	1936	+	30	219140009	61819
chr2	219078189	219278189	harbor1	chr2	219138884	219139079	LTR/ERVL-MaLR	1936	+	98	219138982	60793
chr2	219078189	219278189	harbor1	chr2	219139388	219139669	LTR/ERVL-MaLR	1936	+	140	219139528	61339
chr2	219078189	219278189	harbor1	chr2	219139979	219140039	LTR/ERVL-MaLR	1936	+	30	219140009	61820
chr2	26403793	26603793	harbor1	chr2	26469377	26469620	LTR/ERVL-MaLR	641	+	122	26469499	65706
chr2	219077856	219277856	harbor1	chr2	219138884	219139079	LTR/ERVL-MaLR	1936	+	98	219138982	61126
chr2	219077856	219277856	harbor1	chr2	219139388	219139669	LTR/ERVL-MaLR	1936	+	140	219139528	61672
chr2	219077856	219277856	harbor1	chr2	219139979	219140039	LTR/ERVL-MaLR	1936	+	30	219140009	62153
chr2	219078292	219278292	harbor1	chr2	219138884	219139079	LTR/ERVL-MaLR	1936	+	98	219138982	60690
chr2	219078292	219278292	harbor1	chr2	219139388	219139669	LTR/ERVL-MaLR	1936	+	140	219139528	61236
chr2	219078292	219278292	harbor1	chr2	219139979	219140039	LTR/ERVL-MaLR	1936	+	30	219140009	61717
chr2	219068679	219268679	harbor1	chr2	219138884	219139079	LTR/ERVL-MaLR	1936	+	98	219138982	70303
chr2	219068679	219268679	harbor1	chr2	219139388	219139669	LTR/ERVL-MaLR	1936	+	140	219139528	70849
chr2	219068679	219268679	harbor1	chr2	219139979	219140039	LTR/ERVL-MaLR	1936	+	30	219140009	71330
chr2	171334240	171534240	harbor1	chr2	171414774	171415133	LTR/ERVL-MaLR	2256	+	180	171414954	80714
chr2	171334240	171534240	harbor1	chr2	171422916	171423288	LTR/ERVL-MaLR	2585	+	186	171423102	88862
chr2	171334240	171534240	harbor1	chr2	171423289	171424872	LTR/ERVL-MaLR	10671	+	792	171424081	89841
chr2	171334240	171534240	harbor1	chr2	171424873	171425249	LTR/ERVL-MaLR	3020	+	188	171425061	90821
chr2	171334240	171534240	harbor1	chr2	171425448	171425800	LTR/ERVL-MaLR	1612	+	176	171425624	91384
chr2	69543779	69743779	harbor1	chr2	69546660	69546781	LTR/ERVL-MaLR	854	+	60	69546720	2941
chr2	69543779	69743779	harbor1	chr2	69580215	69580737	LTR/ERVL-MaLR	626	+	261	69580476	36697
chr2	69543779	69743779	harbor1	chr2	69614606	69615067	LTR/ERVL-MaLR	1504	+	230	69614836	71057
chr2	69543779	69743779	harbor1	chr2	69621510	69621666	LTR/ERVL-MaLR	709	+	78	69621588	77809
chr2	69543779	69743779	harbor1	chr2	69633264	69633321	LTR/ERVL-MaLR	831	+	28	69633292	89513
chr2	69543779	69743779	harbor1	chr2	69633618	69633782	LTR/ERVL-MaLR	831	+	82	69633700	89921
chr2	43055566	43255566	harbor1	chr2	43090689	43091038	LTR/ERVL-MaLR	2316	+	174	43090863	35297
chr2	43055566	43255566	harbor1	chr2	43105264	43105653	LTR/ERVL-MaLR	1774	+	194	43105458	49892
chr2	43055566	43255566	harbor1	chr2	43138639	43138743	LTR/ERVL-MaLR	565	+	52	43138691	83125
chr2	43055566	43255566	harbor1	chr2	43139955	43140080	LTR/ERVL-MaLR	525	+	62	43140017	84451
chr2	26950242	27150242	harbor1	chr2	26985687	26986056	LTR/ERVL-MaLR	826	+	184	26985871	35629
chr2	26950242	27150242	harbor1	chr2	27028397	27028496	LTR/ERVL-MaLR	1992	+	50	27028447	78205
chr2	26950242	27150242	harbor1	chr2	27028803	27028934	LTR/ERVL-MaLR	1992	+	66	27028869	78627
chr2	26950242	27150242	harbor1	chr2	27029230	27029518	LTR/ERVL-MaLR	1992	+	144	27029374	79132
chr2	26950242	27150242	harbor1	chr2	26968037	26968182	LTR/ERVL-MaLR	476	+	72	26968109	17867
chr2	26403734	26603734	harbor1	chr2	26469377	26469620	LTR/ERVL-MaLR	641	+	122	26469499	65765
chr2	219077798	219277798	harbor1	chr2	219138884	219139079	LTR/ERVL-MaLR	1936	+	98	219138982	61184
chr2	219077798	219277798	harbor1	chr2	219139388	219139669	LTR/ERVL-MaLR	1936	+	140	219139528	61730
chr2	219077798	219277798	harbor1	chr2	219139979	219140039	LTR/ERVL-MaLR	1936	+	30	219140009	62211
chr2	219077795	219277795	harbor1	chr2	219138884	219139079	LTR/ERVL-MaLR	1936	+	98	219138982	61187
chr2	219077795	219277795	harbor1	chr2	219139388	219139669	LTR/ERVL-MaLR	1936	+	140	219139528	61733
chr2	219077795	219277795	harbor1	chr2	219139979	219140039	LTR/ERVL-MaLR	1936	+	30	219140009	62214
chr2	219075968	219275968	harbor1	chr2	219138884	219139079	LTR/ERVL-MaLR	1936	+	98	219138982	63014
chr2	219075968	219275968	harbor1	chr2	219139388	219139669	LTR/ERVL-MaLR	1936	+	140	219139528	63560
chr2	219075968	219275968	harbor1	chr2	219139979	219140039	LTR/ERVL-MaLR	1936	+	30	219140009	64041
chr2	3475856	3675856	harbor1	chr2	3505702	3506070	LTR/ERVL-MaLR	1668	+	184	3505886	30030
chr2	3475856	3675856	harbor1	chr2	3510972	3511349	LTR/ERVL-MaLR	2120	+	188	3511160	35304
chr2	3475856	3675856	harbor1	chr2	3511363	3511618	LTR/ERVL-MaLR	1286	+	128	3511491	35635
chr2	3475856	3675856	harbor1	chr2	3511621	3513344	LTR/ERVL-MaLR	9038	+	862	3512483	36627
chr2	3475856	3675856	harbor1	chr2	3513345	3513766	LTR/ERVL-MaLR	2448	+	210	3513555	37699
chr2	3475856	3675856	harbor1	chr2	3516086	3516200	LTR/ERVL-MaLR	1487	+	57	3516143	40287
chr2	3475856	3675856	harbor1	chr2	3516499	3516715	LTR/ERVL-MaLR	1487	+	108	3516607	40751
chr2	3475856	3675856	harbor1	chr2	3566632	3567021	LTR/ERVL-MaLR	2090	+	194	3566826	90970
chr2	3475856	3675856	harbor1	chr2	3570340	3570676	LTR/ERVL-MaLR	1374	+	168	3570508	94652
chr2	219077844	219277844	harbor1	chr2	219138884	219139079	LTR/ERVL-MaLR	1936	+	98	219138982	61138
chr2	219077844	219277844	harbor1	chr2	219139388	219139669	LTR/ERVL-MaLR	1936	+	140	219139528	61684
chr2	219077844	219277844	harbor1	chr2	219139979	219140039	LTR/ERVL-MaLR	1936	+	30	219140009	62165
chr2	113484117	113684117	harbor1	chr2	113556719	113556984	LTR/ERVL-MaLR	804	+	132	113556851	72734
chr2	113484117	113684117	harbor1	chr2	113578542	113578898	LTR/ERVL-MaLR	842	+	178	113578720	94603
chr2	219077870	219277870	harbor1	chr2	219138884	219139079	LTR/ERVL-MaLR	1936	+	98	219138982	61112
chr2	219077870	219277870	harbor1	chr2	219139388	219139669	LTR/ERVL-MaLR	1936	+	140	219139528	61658
chr2	219077870	219277870	harbor1	chr2	219139979	219140039	LTR/ERVL-MaLR	1936	+	30	219140009	62139
chr2	219077895	219277895	harbor1	chr2	219138884	219139079	LTR/ERVL-MaLR	1936	+	98	219138982	61087
chr2	219077895	219277895	harbor1	chr2	219139388	219139669	LTR/ERVL-MaLR	1936	+	140	219139528	61633
chr2	219077895	219277895	harbor1	chr2	219139979	219140039	LTR/ERVL-MaLR	1936	+	30	219140009	62114
chr2	219077979	219277979	harbor1	chr2	219138884	219139079	LTR/ERVL-MaLR	1936	+	98	219138982	61003
chr2	219077979	219277979	harbor1	chr2	219139388	219139669	LTR/ERVL-MaLR	1936	+	140	219139528	61549
chr2	219077979	219277979	harbor1	chr2	219139979	219140039	LTR/ERVL-MaLR	1936	+	30	219140009	62030
chr2	70771787	70971787	harbor1	chr2	70772358	70772730	LTR/ERVL-MaLR	1769	+	186	70772544	757
chr2	70771787	70971787	harbor1	chr2	70773543	70773911	LTR/ERVL-MaLR	2404	+	184	70773727	1940
chr2	70771787	70971787	harbor1	chr2	70774347	70774943	LTR/ERVL-MaLR	3990	+	298	70774645	2858
chr2	70771787	70971787	harbor1	chr2	70775243	70776075	LTR/ERVL-MaLR	3990	+	416	70775659	3872
chr2	70771787	70971787	harbor1	chr2	70776087	70776438	LTR/ERVL-MaLR	1597	+	176	70776263	4476
chr2	70771787	70971787	harbor1	chr2	70832579	70832844	LTR/ERVL-MaLR	623	+	132	70832711	60924
chr2	70771787	70971787	harbor1	chr2	70849746	70849968	LTR/ERVL-MaLR	1164	+	111	70849857	78070
chr2	70771787	70971787	harbor1	chr2	70858868	70859280	LTR/ERVL-MaLR	2045	+	206	70859074	87287
chr2	70771787	70971787	harbor1	chr2	70860243	70860449	LTR/ERVL-MaLR	1103	+	103	70860346	88559
chr2	70771787	70971787	harbor1	chr2	70868990	70869317	LTR/ERVL-MaLR	1422	+	164	70869154	97367
chr2	70771787	70971787	harbor1	chr2	70869643	70869691	LTR/ERVL-MaLR	1422	+	24	70869667	97880
chr2	219078278	219278278	harbor1	chr2	219138884	219139079	LTR/ERVL-MaLR	1936	+	98	219138982	60704
chr2	219078278	219278278	harbor1	chr2	219139388	219139669	LTR/ERVL-MaLR	1936	+	140	219139528	61250
chr2	219078278	219278278	harbor1	chr2	219139979	219140039	LTR/ERVL-MaLR	1936	+	30	219140009	61731
chr2	113484023	113684023	harbor1	chr2	113556719	113556984	LTR/ERVL-MaLR	804	+	132	113556851	72828
chr2	113484023	113684023	harbor1	chr2	113578542	113578898	LTR/ERVL-MaLR	842	+	178	113578720	94697
chr2	238807213	239007213	harbor1	chr2	238823163	238823595	LTR/ERVL-MaLR	1232	+	216	238823379	16166
chr2	238807213	239007213	harbor1	chr2	238836329	238836514	LTR/ERVL-MaLR	561	+	92	238836421	29208
chr2	238807213	239007213	harbor1	chr2	238838232	238838343	LTR/ERVL-MaLR	784	+	56	238838288	31075
chr2	238807213	239007213	harbor1	chr2	238838789	238839218	LTR/ERVL-MaLR	530	+	214	238839003	31790
chr2	238807213	239007213	harbor1	chr2	238887589	238887918	LTR/ERVL-MaLR	562	+	164	238887753	80540
chr2	217853705	218053705	harbor1	chr2	217874951	217875314	LTR/ERVL-MaLR	842	+	182	217875133	21428
chr2	217853705	218053705	harbor1	chr2	217876578	217876962	LTR/ERVL-MaLR	2074	+	192	217876770	23065
chr2	217853705	218053705	harbor1	chr2	217888499	217888860	LTR/ERVL-MaLR	2312	+	180	217888679	34974
chr2	217853705	218053705	harbor1	chr2	217896271	217896668	LTR/ERVL-MaLR	1370	+	198	217896469	42764
chr2	217853705	218053705	harbor1	chr2	217897038	217897070	LTR/ERVL-MaLR	1370	+	16	217897054	43349
chr2	217853705	218053705	harbor1	chr2	217925924	217926301	LTR/ERVL-MaLR	2317	+	188	217926112	72407
chr2	3604000	3804000	harbor1	chr2	3622465	3622868	LTR/ERVL-MaLR	2033	+	202	3622667	18667
chr2	3604000	3804000	harbor1	chr2	3660016	3660428	LTR/ERVL-MaLR	2250	+	206	3660222	56222
chr2	113484043	113684043	harbor1	chr2	113556719	113556984	LTR/ERVL-MaLR	804	+	132	113556851	72808
chr2	113484043	113684043	harbor1	chr2	113578542	113578898	LTR/ERVL-MaLR	842	+	178	113578720	94677
chr2	72783861	72983861	harbor1	chr2	72795636	72795821	LTR/ERVL-MaLR	828	+	92	72795728	11867
chr2	72783861	72983861	harbor1	chr2	72834510	72834903	LTR/ERVL-MaLR	452	+	196	72834706	50845
chr2	72783861	72983861	harbor1	chr2	72873445	72873574	LTR/ERVL-MaLR	659	+	64	72873509	89648
chr2	158867991	159067991	harbor1	chr2	158910818	158911107	LTR/ERVL-MaLR	1269	+	144	158910962	42971
chr2	158867991	159067991	harbor1	chr2	158911397	158911419	LTR/ERVL-MaLR	1269	+	11	158911408	43417
chr2	158867991	159067991	harbor1	chr2	158929915	158930303	LTR/ERVL-MaLR	2071	+	194	158930109	62118
chr2	158867991	159067991	harbor1	chr2	158931000	158931455	LTR/ERVL-MaLR	1046	+	228	158931228	63237
chr2	158867991	159067991	harbor1	chr2	158946839	158946936	LTR/ERVL-MaLR	1663	+	48	158946887	78896
chr2	158867991	159067991	harbor1	chr2	158946974	158947353	LTR/ERVL-MaLR	1663	+	190	158947164	79173
chr2	158867991	159067991	harbor1	chr2	158951895	158952261	LTR/ERVL-MaLR	891	+	183	158952078	84087
chr2	158867991	159067991	harbor1	chr2	158957048	158957334	LTR/ERVL-MaLR	994	+	143	158957191	89200
chr2	158867991	159067991	harbor1	chr2	158958534	158958969	LTR/ERVL-MaLR	480	+	218	158958752	90761
chr2	158867991	159067991	harbor1	chr2	158960317	158960696	LTR/ERVL-MaLR	642	+	190	158960507	92516
chr2	43055564	43255564	harbor1	chr2	43090689	43091038	LTR/ERVL-MaLR	2316	+	174	43090863	35299
chr2	43055564	43255564	harbor1	chr2	43105264	43105653	LTR/ERVL-MaLR	1774	+	194	43105458	49894
chr2	43055564	43255564	harbor1	chr2	43138639	43138743	LTR/ERVL-MaLR	565	+	52	43138691	83127
chr2	43055564	43255564	harbor1	chr2	43139955	43140080	LTR/ERVL-MaLR	525	+	62	43140017	84453
chr2	6817111	7017111	harbor1	chr2	6855045	6855091	LTR/ERVL-MaLR	1641	+	23	6855068	37957
chr2	6817111	7017111	harbor1	chr2	6855172	6855532	LTR/ERVL-MaLR	1641	+	180	6855352	38241
chr2	6817111	7017111	harbor1	chr2	6858460	6858801	LTR/ERVL-MaLR	2151	+	170	6858630	41519
chr2	6817111	7017111	harbor1	chr2	6858802	6860364	LTR/ERVL-MaLR	11864	+	781	6859583	42472
chr2	6817111	7017111	harbor1	chr2	6860368	6860709	LTR/ERVL-MaLR	2259	+	170	6860538	43427
chr2	6817111	7017111	harbor1	chr2	6873928	6874360	LTR/ERVL-MaLR	2569	+	216	6874144	57033
chr2	2616616	2816616	harbor1	chr2	2630134	2630183	LTR/ERVL-MaLR	1188	+	24	2630158	13542
chr2	2616616	2816616	harbor1	chr2	2630498	2630832	LTR/ERVL-MaLR	1188	+	167	2630665	14049
chr2	2616616	2816616	harbor1	chr2	2640773	2641006	LTR/ERVL-MaLR	820	+	116	2640889	24273
chr2	2616616	2816616	harbor1	chr2	2661334	2661748	LTR/ERVL-MaLR	652	+	207	2661541	44925
chr2	2616616	2816616	harbor1	chr2	2688005	2688409	LTR/ERVL-MaLR	977	+	202	2688207	71591
chr2	2616616	2816616	harbor1	chr2	2691219	2691577	LTR/ERVL-MaLR	2066	+	179	2691398	74782
chr2	2616616	2816616	harbor1	chr2	2705808	2706114	LTR/ERVL-MaLR	774	+	153	2705961	89345
chr2	43054703	43254703	harbor1	chr2	43090689	43091038	LTR/ERVL-MaLR	2316	+	174	43090863	36160
chr2	43054703	43254703	harbor1	chr2	43105264	43105653	LTR/ERVL-MaLR	1774	+	194	43105458	50755
chr2	43054703	43254703	harbor1	chr2	43138639	43138743	LTR/ERVL-MaLR	565	+	52	43138691	83988
chr2	43054703	43254703	harbor1	chr2	43139955	43140080	LTR/ERVL-MaLR	525	+	62	43140017	85314
chr2	85227775	85427775	harbor1	chr2	85293172	85293598	LTR/ERVL-MaLR	2750	+	213	85293385	65610
chr2	69543869	69743869	harbor1	chr2	69546660	69546781	LTR/ERVL-MaLR	854	+	60	69546720	2851
chr2	69543869	69743869	harbor1	chr2	69580215	69580737	LTR/ERVL-MaLR	626	+	261	69580476	36607
chr2	69543869	69743869	harbor1	chr2	69614606	69615067	LTR/ERVL-MaLR	1504	+	230	69614836	70967
chr2	69543869	69743869	harbor1	chr2	69621510	69621666	LTR/ERVL-MaLR	709	+	78	69621588	77719
chr2	69543869	69743869	harbor1	chr2	69633264	69633321	LTR/ERVL-MaLR	831	+	28	69633292	89423
chr2	69543869	69743869	harbor1	chr2	69633618	69633782	LTR/ERVL-MaLR	831	+	82	69633700	89831
chr2	34909049	35109049	harbor1	chr2	34914482	34914808	LTR/ERVL-MaLR	1105	+	163	34914645	5596
chr2	34909049	35109049	harbor1	chr2	34961871	34962204	LTR/ERVL-MaLR	1570	+	166	34962037	52988
chr2	241851126	242051126	harbor1	chr2	241855880	241856037	LTR/ERVL-MaLR	458	+	78	241855958	4832
chr2	241851126	242051126	harbor1	chr2	241906933	241907165	LTR/ERVL-MaLR	623	+	116	241907049	55923
chr2	241851126	242051126	harbor1	chr2	241945071	241945435	LTR/ERVL-MaLR	1475	+	182	241945253	94127
chr2	232385663	232585663	harbor1	chr2	232421810	232422171	LTR/ERVL-MaLR	2248	+	180	232421990	36327
chr2	219068714	219268714	harbor1	chr2	219138884	219139079	LTR/ERVL-MaLR	1936	+	98	219138982	70268
chr2	219068714	219268714	harbor1	chr2	219139388	219139669	LTR/ERVL-MaLR	1936	+	140	219139528	70814
chr2	219068714	219268714	harbor1	chr2	219139979	219140039	LTR/ERVL-MaLR	1936	+	30	219140009	71295
chr2	86463906	86663906	harbor1	chr2	86494951	86495184	LTR/ERVL-MaLR	1041	+	116	86495067	31161
chr2	86463906	86663906	harbor1	chr2	86512120	86512476	LTR/ERVL-MaLR	1749	+	178	86512298	48392
chr2	86463906	86663906	harbor1	chr2	86553935	86554284	LTR/ERVL-MaLR	1839	+	174	86554109	90203
chr2	46198450	46398450	harbor1	chr2	46206483	46206657	LTR/ERVL-MaLR	910	+	87	46206570	8120
chr2	46198450	46398450	harbor1	chr2	46206807	46207031	LTR/ERVL-MaLR	1070	+	112	46206919	8469
chr2	46198450	46398450	harbor1	chr2	46238753	46239112	LTR/ERVL-MaLR	1907	+	180	46238933	40483
chr2	46198450	46398450	harbor1	chr2	46258830	46259221	LTR/ERVL-MaLR	2496	+	196	46259026	60576
chr2	46198450	46398450	harbor1	chr2	46274651	46274913	LTR/ERVL-MaLR	855	+	131	46274782	76332
chr2	190910082	191110082	harbor1	chr2	191003385	191003791	LTR/ERVL-MaLR	2964	+	203	191003588	93506
chr2	190910082	191110082	harbor1	chr2	190988025	190988378	LTR/ERVL-MaLR	544	+	176	190988201	78119
chr2	237867377	238067377	harbor1	chr2	237915902	237916156	LTR/ERVL-MaLR	556	+	127	237916029	48652
chr2	237867377	238067377	harbor1	chr2	237949210	237949563	LTR/ERVL-MaLR	2080	+	176	237949386	82009
chr2	237867377	238067377	harbor1	chr2	237950477	237950551	LTR/ERVL-MaLR	482	+	37	237950514	83137
chr2	237867377	238067377	harbor1	chr2	237956845	237957216	LTR/ERVL-MaLR	1153	+	186	237957031	89654
chr2	237867377	238067377	harbor1	chr2	237961574	237961950	LTR/ERVL-MaLR	1096	+	188	237961762	94385
chr2	43031592	43231592	harbor1	chr2	43033147	43033606	LTR/ERVL-MaLR	1940	+	230	43033377	1785
chr2	43031592	43231592	harbor1	chr2	43090689	43091038	LTR/ERVL-MaLR	2316	+	174	43090863	59271
chr2	43031592	43231592	harbor1	chr2	43105264	43105653	LTR/ERVL-MaLR	1774	+	194	43105458	73866
chr2	239765621	239965621	harbor1	chr2	239781761	239782211	LTR/ERVL-MaLR	1794	+	225	239781986	16365
chr2	239765621	239965621	harbor1	chr2	239785630	239785992	LTR/ERVL-MaLR	2790	+	181	239785811	20190
chr2	239765621	239965621	harbor1	chr2	239822549	239822925	LTR/ERVL-MaLR	2408	+	188	239822737	57116
chr2	239765621	239965621	harbor1	chr2	239824444	239824857	LTR/ERVL-MaLR	2611	+	206	239824650	59029
chr2	239765621	239965621	harbor1	chr2	239825462	239825901	LTR/ERVL-MaLR	1770	+	220	239825682	60061
chr2	239765621	239965621	harbor1	chr2	239831989	239832323	LTR/ERVL-MaLR	1622	+	167	239832156	66535
chr2	239765621	239965621	harbor1	chr2	239862536	239863017	LTR/ERVL-MaLR	1304	+	240	239862776	97155
chr2	239765621	239965621	harbor1	chr2	239864650	239864914	LTR/ERVL-MaLR	546	+	132	239864782	99161
chr2	219077841	219277841	harbor1	chr2	219138884	219139079	LTR/ERVL-MaLR	1936	+	98	219138982	61141
chr2	219077841	219277841	harbor1	chr2	219139388	219139669	LTR/ERVL-MaLR	1936	+	140	219139528	61687
chr2	219077841	219277841	harbor1	chr2	219139979	219140039	LTR/ERVL-MaLR	1936	+	30	219140009	62168
chr2	26950263	27150263	harbor1	chr2	26985687	26986056	LTR/ERVL-MaLR	826	+	184	26985871	35608
chr2	26950263	27150263	harbor1	chr2	27028397	27028496	LTR/ERVL-MaLR	1992	+	50	27028447	78184
chr2	26950263	27150263	harbor1	chr2	27028803	27028934	LTR/ERVL-MaLR	1992	+	66	27028869	78606
chr2	26950263	27150263	harbor1	chr2	27029230	27029518	LTR/ERVL-MaLR	1992	+	144	27029374	79111
chr2	26950263	27150263	harbor1	chr2	26968037	26968182	LTR/ERVL-MaLR	476	+	72	26968109	17846
chr2	202592156	202792156	harbor1	chr2	202675576	202675702	LTR/ERVL-MaLR	2322	+	63	202675639	83483
chr2	202592156	202792156	harbor1	chr2	202676009	202676375	LTR/ERVL-MaLR	2322	+	183	202676192	84036
chr2	202592156	202792156	harbor1	chr2	202676678	202676743	LTR/ERVL-MaLR	2322	+	32	202676710	84554
chr2	202592156	202792156	harbor1	chr2	202676747	202677058	LTR/ERVL-MaLR	1281	+	156	202676903	84747
chr2	202592156	202792156	harbor1	chr2	202677366	202677440	LTR/ERVL-MaLR	1281	+	37	202677403	85247
chr2	168550531	168750531	harbor1	chr2	168554304	168554710	LTR/ERVL-MaLR	1568	+	203	168554507	3976
chr2	168550531	168750531	harbor1	chr2	168604493	168604910	LTR/ERVL-MaLR	2458	+	208	168604701	54170
chr2	168550531	168750531	harbor1	chr2	168604911	168606680	LTR/ERVL-MaLR	9014	+	884	168605795	55264
chr2	168550531	168750531	harbor1	chr2	168606683	168607096	LTR/ERVL-MaLR	2606	+	206	168606889	56358
chr2	42069545	42269545	harbor1	chr2	42076372	42076838	LTR/ERVL-MaLR	806	+	233	42076605	7060
chr2	42069545	42269545	harbor1	chr2	42091417	42091789	LTR/ERVL-MaLR	1684	+	186	42091603	22058
chr2	42069545	42269545	harbor1	chr2	42099756	42100148	LTR/ERVL-MaLR	2082	+	196	42099952	30407
chr2	42069545	42269545	harbor1	chr2	42129731	42130167	LTR/ERVL-MaLR	2076	+	218	42129949	60404
chr2	42069545	42269545	harbor1	chr2	42137794	42137899	LTR/ERVL-MaLR	1165	+	52	42137846	68301
chr2	42069545	42269545	harbor1	chr2	42138204	42138664	LTR/ERVL-MaLR	1165	+	230	42138434	68889
chr2	42069545	42269545	harbor1	chr2	42150130	42150320	LTR/ERVL-MaLR	723	+	95	42150225	80680
chr2	42069545	42269545	harbor1	chr2	42151675	42152080	LTR/ERVL-MaLR	1282	+	202	42151877	82332
chr2	42069545	42269545	harbor1	chr2	42167626	42167782	LTR/ERVL-MaLR	746	+	78	42167704	98159
chr2	127928490	128128490	harbor1	chr2	127946516	127946607	LTR/ERVL-MaLR	1105	+	46	127946562	18072
chr2	127928490	128128490	harbor1	chr2	127946904	127947323	LTR/ERVL-MaLR	1105	+	210	127947114	18624
chr2	127928490	128128490	harbor1	chr2	127950560	127950952	LTR/ERVL-MaLR	887	+	196	127950756	22266
chr2	127928490	128128490	harbor1	chr2	127963588	127963874	LTR/ERVL-MaLR	1730	+	143	127963731	35241
chr2	127928490	128128490	harbor1	chr2	127978939	127979415	LTR/ERVL-MaLR	1335	+	238	127979177	50687
chr2	87424870	87624870	harbor1	chr2	87442488	87442984	LTR/ERVL-MaLR	604	+	248	87442736	17866
chr2	87424870	87624870	harbor1	chr2	87461612	87461948	LTR/ERVL-MaLR	529	+	168	87461780	36910
chr2	87424870	87624870	harbor1	chr2	87469755	87470169	LTR/ERVL-MaLR	1910	+	207	87469962	45092
chr2	87424870	87624870	harbor1	chr2	87489628	87489804	LTR/ERVL-MaLR	2135	+	88	87489716	64846
chr2	87424870	87624870	harbor1	chr2	87489898	87490116	LTR/ERVL-MaLR	2135	+	109	87490007	65137
chr2	69381601	69581601	harbor1	chr2	69406779	69407151	LTR/ERVL-MaLR	2871	+	186	69406965	25364
chr2	219077944	219277944	harbor1	chr2	219138884	219139079	LTR/ERVL-MaLR	1936	+	98	219138982	61038
chr2	219077944	219277944	harbor1	chr2	219139388	219139669	LTR/ERVL-MaLR	1936	+	140	219139528	61584
chr2	219077944	219277944	harbor1	chr2	219139979	219140039	LTR/ERVL-MaLR	1936	+	30	219140009	62065
chr2	190914213	191114213	harbor1	chr2	191003385	191003791	LTR/ERVL-MaLR	2964	+	203	191003588	89375
chr2	190914213	191114213	harbor1	chr2	191011563	191011889	LTR/ERVL-MaLR	1813	+	163	191011726	97513
chr2	190914213	191114213	harbor1	chr2	190988025	190988378	LTR/ERVL-MaLR	544	+	176	190988201	73988
chr2	110569500	110769500	harbor1	chr2	110619925	110620216	LTR/ERVL-MaLR	924	+	146	110620071	50571
chr2	113484094	113684094	harbor1	chr2	113556719	113556984	LTR/ERVL-MaLR	804	+	132	113556851	72757
chr2	113484094	113684094	harbor1	chr2	113578542	113578898	LTR/ERVL-MaLR	842	+	178	113578720	94626
chr2	85227776	85427776	harbor1	chr2	85293172	85293598	LTR/ERVL-MaLR	2750	+	213	85293385	65609
chr2	86976350	87176350	harbor1	chr2	87002816	87003263	LTR/ERVL-MaLR	1316	+	224	87003040	26690
chr2	86976350	87176350	harbor1	chr2	87009392	87009739	LTR/ERVL-MaLR	1762	+	174	87009566	33216
chr2	63488511	63688511	harbor1	chr2	63516516	63516766	LTR/ERVL-MaLR	916	+	125	63516641	28130
chr2	63488511	63688511	harbor1	chr2	63551265	63551658	LTR/ERVL-MaLR	2236	+	196	63551461	62950
chr2	63488511	63688511	harbor1	chr2	63563660	63563914	LTR/ERVL-MaLR	718	+	127	63563787	75276
chr2	63488511	63688511	harbor1	chr2	63579802	63580165	LTR/ERVL-MaLR	1526	+	182	63579984	91473
chr2	26950257	27150257	harbor1	chr2	26985687	26986056	LTR/ERVL-MaLR	826	+	184	26985871	35614
chr2	26950257	27150257	harbor1	chr2	27028397	27028496	LTR/ERVL-MaLR	1992	+	50	27028447	78190
chr2	26950257	27150257	harbor1	chr2	27028803	27028934	LTR/ERVL-MaLR	1992	+	66	27028869	78612
chr2	26950257	27150257	harbor1	chr2	27029230	27029518	LTR/ERVL-MaLR	1992	+	144	27029374	79117
chr2	26950257	27150257	harbor1	chr2	26968037	26968182	LTR/ERVL-MaLR	476	+	72	26968109	17852
chr2	37132026	37332026	harbor1	chr2	37160770	37160936	LTR/ERVL-MaLR	647	+	83	37160853	28827
chr2	56085054	56285054	harbor1	chr2	56126117	56126543	LTR/ERVL-MaLR	1323	+	213	56126330	41276
chr2	56085054	56285054	harbor1	chr2	56133558	56134023	LTR/ERVL-MaLR	2363	+	232	56133790	48736
chr2	56085054	56285054	harbor1	chr2	56180996	56181102	LTR/ERVL-MaLR	637	+	53	56181049	95995
chr2	56085054	56285054	harbor1	chr2	56181401	56181686	LTR/ERVL-MaLR	637	+	142	56181543	96489
chr2	219343396	219543396	harbor1	chr2	219382439	219382728	LTR/ERVL-MaLR	793	+	144	219382583	39187
chr2	40242754	40442754	harbor1	chr2	40248257	40248621	LTR/ERVL-MaLR	1666	+	182	40248439	5685
chr2	40242754	40442754	harbor1	chr2	40265175	40265277	LTR/ERVL-MaLR	450	+	51	40265226	22472
chr2	26950296	27150296	harbor1	chr2	26985687	26986056	LTR/ERVL-MaLR	826	+	184	26985871	35575
chr2	26950296	27150296	harbor1	chr2	27028397	27028496	LTR/ERVL-MaLR	1992	+	50	27028447	78151
chr2	26950296	27150296	harbor1	chr2	27028803	27028934	LTR/ERVL-MaLR	1992	+	66	27028869	78573
chr2	26950296	27150296	harbor1	chr2	27029230	27029518	LTR/ERVL-MaLR	1992	+	144	27029374	79078
chr2	26950296	27150296	harbor1	chr2	26968037	26968182	LTR/ERVL-MaLR	476	+	72	26968109	17813
chr2	232389018	232589018	harbor1	chr2	232421810	232422171	LTR/ERVL-MaLR	2248	+	180	232421990	32972
chr2	218165589	218365589	harbor1	chr2	218169982	218170226	LTR/ERVL-MaLR	626	+	122	218170104	4515
chr2	218165589	218365589	harbor1	chr2	218201869	218202171	LTR/ERVL-MaLR	1386	+	151	218202020	36431
chr2	240592012	240792012	harbor1	chr2	240616629	240617072	LTR/ERVL-MaLR	1236	+	222	240616851	24839
chr2	240592012	240792012	harbor1	chr2	240617067	240617186	LTR/ERVL-MaLR	549	+	60	240617127	25115
chr2	240592012	240792012	harbor1	chr2	240617181	240617426	LTR/ERVL-MaLR	1072	+	122	240617303	25291
chr2	240592012	240792012	harbor1	chr2	240632830	240633207	LTR/ERVL-MaLR	2409	+	188	240633018	41006
chr2	240592012	240792012	harbor1	chr2	240633210	240634743	LTR/ERVL-MaLR	10395	+	766	240633976	41964
chr2	240592012	240792012	harbor1	chr2	240634744	240635110	LTR/ERVL-MaLR	2263	+	183	240634927	42915
chr2	240592012	240792012	harbor1	chr2	240669858	240670159	LTR/ERVL-MaLR	1103	+	150	240670008	77996
chr2	240592012	240792012	harbor1	chr2	240678266	240678631	LTR/ERVL-MaLR	594	+	182	240678448	86436
chr2	56085032	56285032	harbor1	chr2	56126117	56126543	LTR/ERVL-MaLR	1323	+	213	56126330	41298
chr2	56085032	56285032	harbor1	chr2	56133558	56134023	LTR/ERVL-MaLR	2363	+	232	56133790	48758
chr2	56085032	56285032	harbor1	chr2	56180996	56181102	LTR/ERVL-MaLR	637	+	53	56181049	96017
chr2	56085032	56285032	harbor1	chr2	56181401	56181686	LTR/ERVL-MaLR	637	+	142	56181543	96511
chr2	56085009	56285009	harbor1	chr2	56126117	56126543	LTR/ERVL-MaLR	1323	+	213	56126330	41321
chr2	56085009	56285009	harbor1	chr2	56133558	56134023	LTR/ERVL-MaLR	2363	+	232	56133790	48781
chr2	56085009	56285009	harbor1	chr2	56180996	56181102	LTR/ERVL-MaLR	637	+	53	56181049	96040
chr2	56085009	56285009	harbor1	chr2	56181401	56181686	LTR/ERVL-MaLR	637	+	142	56181543	96534
chr2	6765980	6965980	harbor1	chr2	6784631	6784988	LTR/ERVL-MaLR	2418	+	178	6784809	18829
chr2	6765980	6965980	harbor1	chr2	6785804	6786207	LTR/ERVL-MaLR	2319	+	202	6786006	20026
chr2	6765980	6965980	harbor1	chr2	6788818	6789167	LTR/ERVL-MaLR	1836	+	174	6788992	23012
chr2	6765980	6965980	harbor1	chr2	6804244	6804623	LTR/ERVL-MaLR	2370	+	190	6804434	38454
chr2	6765980	6965980	harbor1	chr2	6855045	6855091	LTR/ERVL-MaLR	1641	+	23	6855068	89088
chr2	6765980	6965980	harbor1	chr2	6855172	6855532	LTR/ERVL-MaLR	1641	+	180	6855352	89372
chr2	6765980	6965980	harbor1	chr2	6858460	6858801	LTR/ERVL-MaLR	2151	+	170	6858630	92650
chr2	6765980	6965980	harbor1	chr2	6858802	6860364	LTR/ERVL-MaLR	11864	+	781	6859583	93603
chr2	6765980	6965980	harbor1	chr2	6860368	6860709	LTR/ERVL-MaLR	2259	+	170	6860538	94558
chr2	70771209	70971209	harbor1	chr2	70771189	70771731	LTR/ERVL-MaLR	1777	+	271	70771460	251
chr2	70771209	70971209	harbor1	chr2	70772358	70772730	LTR/ERVL-MaLR	1769	+	186	70772544	1335
chr2	70771209	70971209	harbor1	chr2	70773543	70773911	LTR/ERVL-MaLR	2404	+	184	70773727	2518
chr2	70771209	70971209	harbor1	chr2	70774347	70774943	LTR/ERVL-MaLR	3990	+	298	70774645	3436
chr2	70771209	70971209	harbor1	chr2	70775243	70776075	LTR/ERVL-MaLR	3990	+	416	70775659	4450
chr2	70771209	70971209	harbor1	chr2	70776087	70776438	LTR/ERVL-MaLR	1597	+	176	70776263	5054
chr2	70771209	70971209	harbor1	chr2	70832579	70832844	LTR/ERVL-MaLR	623	+	132	70832711	61502
chr2	70771209	70971209	harbor1	chr2	70849746	70849968	LTR/ERVL-MaLR	1164	+	111	70849857	78648
chr2	70771209	70971209	harbor1	chr2	70858868	70859280	LTR/ERVL-MaLR	2045	+	206	70859074	87865
chr2	70771209	70971209	harbor1	chr2	70860243	70860449	LTR/ERVL-MaLR	1103	+	103	70860346	89137
chr2	70771209	70971209	harbor1	chr2	70868990	70869317	LTR/ERVL-MaLR	1422	+	164	70869154	97945
chr2	70771209	70971209	harbor1	chr2	70869643	70869691	LTR/ERVL-MaLR	1422	+	24	70869667	98458
chr2	162739522	162939522	harbor1	chr2	162771967	162772187	LTR/ERVL-MaLR	627	+	110	162772077	32555
chr2	162739522	162939522	harbor1	chr2	162830597	162830967	LTR/ERVL-MaLR	1702	+	185	162830782	91260
chr2	26950239	27150239	harbor1	chr2	26985687	26986056	LTR/ERVL-MaLR	826	+	184	26985871	35632
chr2	26950239	27150239	harbor1	chr2	27028397	27028496	LTR/ERVL-MaLR	1992	+	50	27028447	78208
chr2	26950239	27150239	harbor1	chr2	27028803	27028934	LTR/ERVL-MaLR	1992	+	66	27028869	78630
chr2	26950239	27150239	harbor1	chr2	27029230	27029518	LTR/ERVL-MaLR	1992	+	144	27029374	79135
chr2	26950239	27150239	harbor1	chr2	26968037	26968182	LTR/ERVL-MaLR	476	+	72	26968109	17870
chr2	26144160	26344160	harbor1	chr2	26146934	26147014	LTR/ERVL-MaLR	609	+	40	26146974	2814
chr2	26144160	26344160	harbor1	chr2	26199563	26199675	LTR/ERVL-MaLR	605	+	56	26199619	55459
chr2	26144160	26344160	harbor1	chr2	26199782	26199988	LTR/ERVL-MaLR	476	+	103	26199885	55725
chr2	26144160	26344160	harbor1	chr2	26221989	26222380	LTR/ERVL-MaLR	2404	+	196	26222185	78025
chr2	26144160	26344160	harbor1	chr2	26239339	26239520	LTR/ERVL-MaLR	617	+	90	26239429	95269
chr2	26154867	26354867	harbor1	chr2	26199563	26199675	LTR/ERVL-MaLR	605	+	56	26199619	44752
chr2	26154867	26354867	harbor1	chr2	26199782	26199988	LTR/ERVL-MaLR	476	+	103	26199885	45018
chr2	26154867	26354867	harbor1	chr2	26221989	26222380	LTR/ERVL-MaLR	2404	+	196	26222185	67318
chr2	26154867	26354867	harbor1	chr2	26239339	26239520	LTR/ERVL-MaLR	617	+	90	26239429	84562
chr2	74270990	74470990	harbor1	chr2	74276805	74277141	LTR/ERVL-MaLR	519	+	168	74276973	5983
chr2	74270990	74470990	harbor1	chr2	74298923	74299069	LTR/ERVL-MaLR	2604	+	73	74298996	28006
chr2	74270990	74470990	harbor1	chr2	74299366	74299584	LTR/ERVL-MaLR	2604	+	109	74299475	28485
chr2	74270990	74470990	harbor1	chr2	74321703	74322268	LTR/ERVL-MaLR	1027	+	282	74321985	50995
chr2	74270990	74470990	harbor1	chr2	74324756	74325127	LTR/ERVL-MaLR	478	+	186	74324942	53952
chr2	207668717	207868717	harbor1	chr2	207704402	207704589	LTR/ERVL-MaLR	471	+	94	207704496	35779
chr2	207668717	207868717	harbor1	chr2	207708444	207708625	LTR/ERVL-MaLR	717	+	90	207708534	39817
chr2	207668717	207868717	harbor1	chr2	207709245	207709344	LTR/ERVL-MaLR	717	+	50	207709295	40578
chr2	46198509	46398509	harbor1	chr2	46206483	46206657	LTR/ERVL-MaLR	910	+	87	46206570	8061
chr2	46198509	46398509	harbor1	chr2	46206807	46207031	LTR/ERVL-MaLR	1070	+	112	46206919	8410
chr2	46198509	46398509	harbor1	chr2	46238753	46239112	LTR/ERVL-MaLR	1907	+	180	46238933	40424
chr2	46198509	46398509	harbor1	chr2	46258830	46259221	LTR/ERVL-MaLR	2496	+	196	46259026	60517
chr2	46198509	46398509	harbor1	chr2	46274651	46274913	LTR/ERVL-MaLR	855	+	131	46274782	76273
chr2	219077888	219277888	harbor1	chr2	219138884	219139079	LTR/ERVL-MaLR	1936	+	98	219138982	61094
chr2	219077888	219277888	harbor1	chr2	219139388	219139669	LTR/ERVL-MaLR	1936	+	140	219139528	61640
chr2	219077888	219277888	harbor1	chr2	219139979	219140039	LTR/ERVL-MaLR	1936	+	30	219140009	62121
chr2	219078289	219278289	harbor1	chr2	219138884	219139079	LTR/ERVL-MaLR	1936	+	98	219138982	60693
chr2	219078289	219278289	harbor1	chr2	219139388	219139669	LTR/ERVL-MaLR	1936	+	140	219139528	61239
chr2	219078289	219278289	harbor1	chr2	219139979	219140039	LTR/ERVL-MaLR	1936	+	30	219140009	61720
chr2	219077799	219277799	harbor1	chr2	219138884	219139079	LTR/ERVL-MaLR	1936	+	98	219138982	61183
chr2	219077799	219277799	harbor1	chr2	219139388	219139669	LTR/ERVL-MaLR	1936	+	140	219139528	61729
chr2	219077799	219277799	harbor1	chr2	219139979	219140039	LTR/ERVL-MaLR	1936	+	30	219140009	62210
chr2	1483290	1683290	harbor1	chr2	1498156	1498544	LTR/ERVL-MaLR	494	+	194	1498350	15060
chr2	1483290	1683290	harbor1	chr2	1501512	1501937	LTR/ERVL-MaLR	563	+	212	1501724	18434
chr2	1483290	1683290	harbor1	chr2	1518814	1519232	LTR/ERVL-MaLR	1438	+	209	1519023	35733
chr2	53760159	53960159	harbor1	chr2	53828396	53828763	LTR/ERVL-MaLR	1214	+	184	53828580	68421
chr2	53760159	53960159	harbor1	chr2	53832491	53832802	LTR/ERVL-MaLR	592	+	156	53832647	72488
chr2	53760159	53960159	harbor1	chr2	53835893	53836306	LTR/ERVL-MaLR	2593	+	206	53836099	75940
chr2	53760159	53960159	harbor1	chr2	53839379	53839758	LTR/ERVL-MaLR	1841	+	190	53839569	79410
chr2	70771799	70971799	harbor1	chr2	70772358	70772730	LTR/ERVL-MaLR	1769	+	186	70772544	745
chr2	70771799	70971799	harbor1	chr2	70773543	70773911	LTR/ERVL-MaLR	2404	+	184	70773727	1928
chr2	70771799	70971799	harbor1	chr2	70774347	70774943	LTR/ERVL-MaLR	3990	+	298	70774645	2846
chr2	70771799	70971799	harbor1	chr2	70775243	70776075	LTR/ERVL-MaLR	3990	+	416	70775659	3860
chr2	70771799	70971799	harbor1	chr2	70776087	70776438	LTR/ERVL-MaLR	1597	+	176	70776263	4464
chr2	70771799	70971799	harbor1	chr2	70832579	70832844	LTR/ERVL-MaLR	623	+	132	70832711	60912
chr2	70771799	70971799	harbor1	chr2	70849746	70849968	LTR/ERVL-MaLR	1164	+	111	70849857	78058
chr2	70771799	70971799	harbor1	chr2	70858868	70859280	LTR/ERVL-MaLR	2045	+	206	70859074	87275
chr2	70771799	70971799	harbor1	chr2	70860243	70860449	LTR/ERVL-MaLR	1103	+	103	70860346	88547
chr2	70771799	70971799	harbor1	chr2	70868990	70869317	LTR/ERVL-MaLR	1422	+	164	70869154	97355
chr2	70771799	70971799	harbor1	chr2	70869643	70869691	LTR/ERVL-MaLR	1422	+	24	70869667	97868
chr2	219130337	219330337	harbor1	chr2	219138884	219139079	LTR/ERVL-MaLR	1936	+	98	219138982	8645
chr2	219130337	219330337	harbor1	chr2	219139388	219139669	LTR/ERVL-MaLR	1936	+	140	219139528	9191
chr2	219130337	219330337	harbor1	chr2	219139979	219140039	LTR/ERVL-MaLR	1936	+	30	219140009	9672
chr2	219130337	219330337	harbor1	chr2	219186433	219186528	LTR/ERVL-MaLR	2544	+	48	219186481	56144
chr2	219130337	219330337	harbor1	chr2	219186828	219187138	LTR/ERVL-MaLR	2544	+	155	219186983	56646
chr2	219130337	219330337	harbor1	chr2	219190861	219191097	LTR/ERVL-MaLR	1235	+	118	219190979	60642
chr2	219130337	219330337	harbor1	chr2	219204036	219204088	LTR/ERVL-MaLR	2658	+	26	219204062	73725
chr2	219130337	219330337	harbor1	chr2	219204399	219204748	LTR/ERVL-MaLR	2658	+	174	219204573	74236
chr2	219130337	219330337	harbor1	chr2	219205049	219205088	LTR/ERVL-MaLR	2658	+	20	219205069	74732
chr2	72787395	72987395	harbor1	chr2	72795636	72795821	LTR/ERVL-MaLR	828	+	92	72795728	8333
chr2	72787395	72987395	harbor1	chr2	72834510	72834903	LTR/ERVL-MaLR	452	+	196	72834706	47311
chr2	72787395	72987395	harbor1	chr2	72873445	72873574	LTR/ERVL-MaLR	659	+	64	72873509	86114
chr2	240345243	240545243	harbor1	chr2	240344991	240345472	LTR/ERVL-MaLR	795	+	240	240345231	12
chr2	240345243	240545243	harbor1	chr2	240350383	240350820	LTR/ERVL-MaLR	1404	+	218	240350601	5358
chr2	240345243	240545243	harbor1	chr2	240368362	240368692	LTR/ERVL-MaLR	1418	+	165	240368527	23284
chr2	240345243	240545243	harbor1	chr2	240380697	240381065	LTR/ERVL-MaLR	2138	+	184	240380881	35638
chr2	240345243	240545243	harbor1	chr2	240407151	240407527	LTR/ERVL-MaLR	2359	+	188	240407339	62096
chr2	61788838	61988838	harbor1	chr2	61797455	61797830	LTR/ERVL-MaLR	2691	+	188	61797643	8805
chr2	61788838	61988838	harbor1	chr2	61798385	61798761	LTR/ERVL-MaLR	1766	+	188	61798573	9735
chr2	61788838	61988838	harbor1	chr2	61798888	61799229	LTR/ERVL-MaLR	891	+	170	61799058	10220
chr2	61788838	61988838	harbor1	chr2	61809621	61810185	LTR/ERVL-MaLR	1581	+	282	61809903	21065
chr2	61788838	61988838	harbor1	chr2	61862742	61862911	LTR/ERVL-MaLR	602	+	84	61862826	73988
chr2	219068715	219268715	harbor1	chr2	219138884	219139079	LTR/ERVL-MaLR	1936	+	98	219138982	70267
chr2	219068715	219268715	harbor1	chr2	219139388	219139669	LTR/ERVL-MaLR	1936	+	140	219139528	70813
chr2	219068715	219268715	harbor1	chr2	219139979	219140039	LTR/ERVL-MaLR	1936	+	30	219140009	71294
chr2	26834370	27034370	harbor1	chr2	26861749	26862252	LTR/ERVL-MaLR	1495	+	252	26862001	27631
chr2	26403814	26603814	harbor1	chr2	26469377	26469620	LTR/ERVL-MaLR	641	+	122	26469499	65685
chr2	219075962	219275962	harbor1	chr2	219138884	219139079	LTR/ERVL-MaLR	1936	+	98	219138982	63020
chr2	219075962	219275962	harbor1	chr2	219139388	219139669	LTR/ERVL-MaLR	1936	+	140	219139528	63566
chr2	219075962	219275962	harbor1	chr2	219139979	219140039	LTR/ERVL-MaLR	1936	+	30	219140009	64047
chr2	120665083	120865083	harbor1	chr2	120698434	120698872	LTR/ERVL-MaLR	757	+	219	120698653	33570
chr2	120665083	120865083	harbor1	chr2	120731570	120731943	LTR/ERVL-MaLR	1835	+	186	120731756	66673
chr2	120665083	120865083	harbor1	chr2	120732024	120732121	LTR/ERVL-MaLR	1273	+	48	120732072	66989
chr2	120665083	120865083	harbor1	chr2	120732419	120732875	LTR/ERVL-MaLR	1273	+	228	120732647	67564
chr2	70557451	70757451	harbor1	chr2	70561972	70562383	LTR/ERVL-MaLR	926	+	206	70562178	4727
chr2	70557451	70757451	harbor1	chr2	70573414	70573914	LTR/ERVL-MaLR	645	+	250	70573664	16213
chr2	70557451	70757451	harbor1	chr2	70575863	70576180	LTR/ERVL-MaLR	654	+	158	70576021	18570
chr2	70557451	70757451	harbor1	chr2	70648445	70648807	LTR/ERVL-MaLR	1659	+	181	70648626	91175
chr2	70557451	70757451	harbor1	chr2	70653043	70653396	LTR/ERVL-MaLR	1460	+	176	70653219	95768
chr2	217613937	217813937	harbor1	chr2	217627008	217627341	LTR/ERVL-MaLR	866	+	166	217627174	13237
chr2	217613937	217813937	harbor1	chr2	217648541	217648640	LTR/ERVL-MaLR	2220	+	50	217648591	34654
chr2	217613937	217813937	harbor1	chr2	217648950	217649251	LTR/ERVL-MaLR	2220	+	150	217649100	35163
chr2	217613937	217813937	harbor1	chr2	217649253	217649592	LTR/ERVL-MaLR	1122	+	170	217649423	35486
chr2	217613937	217813937	harbor1	chr2	217650328	217650740	LTR/ERVL-MaLR	1128	+	206	217650534	36597
chr2	217613937	217813937	harbor1	chr2	217678514	217679025	LTR/ERVL-MaLR	2302	+	256	217678770	64833
chr2	217613937	217813937	harbor1	chr2	217691032	217691451	LTR/ERVL-MaLR	2611	+	210	217691242	77305
chr2	217613937	217813937	harbor1	chr2	217700429	217700789	LTR/ERVL-MaLR	2257	+	180	217700609	86672
chr2	26939064	27139064	harbor1	chr2	26985687	26986056	LTR/ERVL-MaLR	826	+	184	26985871	46807
chr2	26939064	27139064	harbor1	chr2	27028397	27028496	LTR/ERVL-MaLR	1992	+	50	27028447	89383
chr2	26939064	27139064	harbor1	chr2	27028803	27028934	LTR/ERVL-MaLR	1992	+	66	27028869	89805
chr2	26939064	27139064	harbor1	chr2	27029230	27029518	LTR/ERVL-MaLR	1992	+	144	27029374	90310
chr2	26939064	27139064	harbor1	chr2	26968037	26968182	LTR/ERVL-MaLR	476	+	72	26968109	29045
chr2	43987388	44187388	harbor1	chr2	44002976	44003212	LTR/ERVL-MaLR	593	+	118	44003094	15706
chr2	43987388	44187388	harbor1	chr2	44003768	44004000	LTR/ERVL-MaLR	593	+	116	44003884	16496
chr2	43987388	44187388	harbor1	chr2	44005363	44005592	LTR/ERVL-MaLR	568	+	114	44005477	18089
chr2	43987388	44187388	harbor1	chr2	44005850	44006306	LTR/ERVL-MaLR	841	+	228	44006078	18690
chr2	43987388	44187388	harbor1	chr2	44015536	44015684	LTR/ERVL-MaLR	1352	+	74	44015610	28222
chr2	43987388	44187388	harbor1	chr2	44015991	44016194	LTR/ERVL-MaLR	1352	+	102	44016093	28705
chr2	43987388	44187388	harbor1	chr2	44040453	44040671	LTR/ERVL-MaLR	813	+	109	44040562	53174
chr2	43987388	44187388	harbor1	chr2	44045721	44046121	LTR/ERVL-MaLR	1607	+	200	44045921	58533
chr2	43987388	44187388	harbor1	chr2	44085494	44085847	LTR/ERVL-MaLR	1011	+	176	44085670	98282
chr2	127928563	128128563	harbor1	chr2	127946516	127946607	LTR/ERVL-MaLR	1105	+	46	127946562	17999
chr2	127928563	128128563	harbor1	chr2	127946904	127947323	LTR/ERVL-MaLR	1105	+	210	127947114	18551
chr2	127928563	128128563	harbor1	chr2	127950560	127950952	LTR/ERVL-MaLR	887	+	196	127950756	22193
chr2	127928563	128128563	harbor1	chr2	127963588	127963874	LTR/ERVL-MaLR	1730	+	143	127963731	35168
chr2	127928563	128128563	harbor1	chr2	127978939	127979415	LTR/ERVL-MaLR	1335	+	238	127979177	50614
chr2	26950213	27150213	harbor1	chr2	26985687	26986056	LTR/ERVL-MaLR	826	+	184	26985871	35658
chr2	26950213	27150213	harbor1	chr2	27028397	27028496	LTR/ERVL-MaLR	1992	+	50	27028447	78234
chr2	26950213	27150213	harbor1	chr2	27028803	27028934	LTR/ERVL-MaLR	1992	+	66	27028869	78656
chr2	26950213	27150213	harbor1	chr2	27029230	27029518	LTR/ERVL-MaLR	1992	+	144	27029374	79161
chr2	26950213	27150213	harbor1	chr2	26968037	26968182	LTR/ERVL-MaLR	476	+	72	26968109	17896
chr2	26950376	27150376	harbor1	chr2	26985687	26986056	LTR/ERVL-MaLR	826	+	184	26985871	35495
chr2	26950376	27150376	harbor1	chr2	27028397	27028496	LTR/ERVL-MaLR	1992	+	50	27028447	78071
chr2	26950376	27150376	harbor1	chr2	27028803	27028934	LTR/ERVL-MaLR	1992	+	66	27028869	78493
chr2	26950376	27150376	harbor1	chr2	27029230	27029518	LTR/ERVL-MaLR	1992	+	144	27029374	78998
chr2	26950376	27150376	harbor1	chr2	26968037	26968182	LTR/ERVL-MaLR	476	+	72	26968109	17733
chr2	111955758	112155758	harbor1	chr2	112037085	112037429	LTR/ERVL-MaLR	1212	+	172	112037257	81499
chr2	43055480	43255480	harbor1	chr2	43090689	43091038	LTR/ERVL-MaLR	2316	+	174	43090863	35383
chr2	43055480	43255480	harbor1	chr2	43105264	43105653	LTR/ERVL-MaLR	1774	+	194	43105458	49978
chr2	43055480	43255480	harbor1	chr2	43138639	43138743	LTR/ERVL-MaLR	565	+	52	43138691	83211
chr2	43055480	43255480	harbor1	chr2	43139955	43140080	LTR/ERVL-MaLR	525	+	62	43140017	84537
chr2	32257033	32457033	harbor1	chr2	32263488	32263811	LTR/ERVL-MaLR	918	+	162	32263650	6617
chr2	32257033	32457033	harbor1	chr2	32266689	32267140	LTR/ERVL-MaLR	1531	+	226	32266915	9882
chr2	32257033	32457033	harbor1	chr2	32271955	32272103	LTR/ERVL-MaLR	858	+	74	32272029	14996
chr2	32257033	32457033	harbor1	chr2	32272301	32272504	LTR/ERVL-MaLR	1229	+	102	32272403	15370
chr2	32257033	32457033	harbor1	chr2	32284345	32284712	LTR/ERVL-MaLR	2069	+	184	32284529	27496
chr2	26950221	27150221	harbor1	chr2	26985687	26986056	LTR/ERVL-MaLR	826	+	184	26985871	35650
chr2	26950221	27150221	harbor1	chr2	27028397	27028496	LTR/ERVL-MaLR	1992	+	50	27028447	78226
chr2	26950221	27150221	harbor1	chr2	27028803	27028934	LTR/ERVL-MaLR	1992	+	66	27028869	78648
chr2	26950221	27150221	harbor1	chr2	27029230	27029518	LTR/ERVL-MaLR	1992	+	144	27029374	79153
chr2	26950221	27150221	harbor1	chr2	26968037	26968182	LTR/ERVL-MaLR	476	+	72	26968109	17888
chr2	147920606	148120606	harbor1	chr2	147951328	147951721	LTR/ERVL-MaLR	1532	+	196	147951524	30918
chr2	147920606	148120606	harbor1	chr2	147998270	147998721	LTR/ERVL-MaLR	2286	+	226	147998496	77890
chr2	60966467	61166467	harbor1	chr2	61042950	61043214	LTR/ERVL-MaLR	1269	+	132	61043082	76615
chr2	60966467	61166467	harbor1	chr2	61060811	61060909	LTR/ERVL-MaLR	471	+	49	61060860	94393
chr2	60966467	61166467	harbor1	chr2	61061213	61061325	LTR/ERVL-MaLR	471	+	56	61061269	94802
chr2	113484139	113684139	harbor1	chr2	113556719	113556984	LTR/ERVL-MaLR	804	+	132	113556851	72712
chr2	113484139	113684139	harbor1	chr2	113578542	113578898	LTR/ERVL-MaLR	842	+	178	113578720	94581
chr2	218179133	218379133	harbor1	chr2	218201869	218202171	LTR/ERVL-MaLR	1386	+	151	218202020	22887
chr2	113484029	113684029	harbor1	chr2	113556719	113556984	LTR/ERVL-MaLR	804	+	132	113556851	72822
chr2	113484029	113684029	harbor1	chr2	113578542	113578898	LTR/ERVL-MaLR	842	+	178	113578720	94691
chr2	95817646	96017646	harbor1	chr2	95862677	95863012	LTR/ERVL-MaLR	1495	+	168	95862845	45199
chr2	219076192	219276192	harbor1	chr2	219138884	219139079	LTR/ERVL-MaLR	1936	+	98	219138982	62790
chr2	219076192	219276192	harbor1	chr2	219139388	219139669	LTR/ERVL-MaLR	1936	+	140	219139528	63336
chr2	219076192	219276192	harbor1	chr2	219139979	219140039	LTR/ERVL-MaLR	1936	+	30	219140009	63817
chr2	42000972	42200972	harbor1	chr2	42002563	42002806	LTR/ERVL-MaLR	1360	+	122	42002685	1713
chr2	42000972	42200972	harbor1	chr2	42003102	42003273	LTR/ERVL-MaLR	1360	+	86	42003188	2216
chr2	42000972	42200972	harbor1	chr2	42023016	42023384	LTR/ERVL-MaLR	2422	+	184	42023200	22228
chr2	42000972	42200972	harbor1	chr2	42076372	42076838	LTR/ERVL-MaLR	806	+	233	42076605	75633
chr2	42000972	42200972	harbor1	chr2	42091417	42091789	LTR/ERVL-MaLR	1684	+	186	42091603	90631
chr2	42000972	42200972	harbor1	chr2	42099756	42100148	LTR/ERVL-MaLR	2082	+	196	42099952	98980
chr2	26246137	26446137	harbor1	chr2	26329431	26329700	LTR/ERVL-MaLR	1900	+	134	26329565	83428
chr2	26246137	26446137	harbor1	chr2	26337111	26337331	LTR/ERVL-MaLR	656	+	110	26337221	91084
chr2	26246137	26446137	harbor1	chr2	26337466	26337591	LTR/ERVL-MaLR	633	+	62	26337528	91391
chr2	26246137	26446137	harbor1	chr2	26328902	26329147	LTR/ERVL-MaLR	1900	+	122	26329024	82887
chr2	42069414	42269414	harbor1	chr2	42076372	42076838	LTR/ERVL-MaLR	806	+	233	42076605	7191
chr2	42069414	42269414	harbor1	chr2	42091417	42091789	LTR/ERVL-MaLR	1684	+	186	42091603	22189
chr2	42069414	42269414	harbor1	chr2	42099756	42100148	LTR/ERVL-MaLR	2082	+	196	42099952	30538
chr2	42069414	42269414	harbor1	chr2	42129731	42130167	LTR/ERVL-MaLR	2076	+	218	42129949	60535
chr2	42069414	42269414	harbor1	chr2	42137794	42137899	LTR/ERVL-MaLR	1165	+	52	42137846	68432
chr2	42069414	42269414	harbor1	chr2	42138204	42138664	LTR/ERVL-MaLR	1165	+	230	42138434	69020
chr2	42069414	42269414	harbor1	chr2	42150130	42150320	LTR/ERVL-MaLR	723	+	95	42150225	80811
chr2	42069414	42269414	harbor1	chr2	42151675	42152080	LTR/ERVL-MaLR	1282	+	202	42151877	82463
chr2	42069414	42269414	harbor1	chr2	42167626	42167782	LTR/ERVL-MaLR	746	+	78	42167704	98290
chr2	111023174	111223174	harbor1	chr2	111024206	111024629	LTR/ERVL-MaLR	1635	+	212	111024418	1244
chr2	111023174	111223174	harbor1	chr2	111045407	111045623	LTR/ERVL-MaLR	1582	+	108	111045515	22341
chr2	219078192	219278192	harbor1	chr2	219138884	219139079	LTR/ERVL-MaLR	1936	+	98	219138982	60790
chr2	219078192	219278192	harbor1	chr2	219139388	219139669	LTR/ERVL-MaLR	1936	+	140	219139528	61336
chr2	219078192	219278192	harbor1	chr2	219139979	219140039	LTR/ERVL-MaLR	1936	+	30	219140009	61817
chr2	134566253	134766253	harbor1	chr2	134599299	134599639	LTR/ERVL-MaLR	1533	+	170	134599469	33216
chr2	134566253	134766253	harbor1	chr2	134600539	134600645	LTR/ERVL-MaLR	762	+	53	134600592	34339
chr2	134566253	134766253	harbor1	chr2	134660897	134661374	LTR/ERVL-MaLR	1107	+	238	134661135	94882
chr2	134566253	134766253	harbor1	chr2	134664430	134664855	LTR/ERVL-MaLR	1589	+	212	134664642	98389
chr2	158868018	159068018	harbor1	chr2	158910818	158911107	LTR/ERVL-MaLR	1269	+	144	158910962	42944
chr2	158868018	159068018	harbor1	chr2	158911397	158911419	LTR/ERVL-MaLR	1269	+	11	158911408	43390
chr2	158868018	159068018	harbor1	chr2	158929915	158930303	LTR/ERVL-MaLR	2071	+	194	158930109	62091
chr2	158868018	159068018	harbor1	chr2	158931000	158931455	LTR/ERVL-MaLR	1046	+	228	158931228	63210
chr2	158868018	159068018	harbor1	chr2	158946839	158946936	LTR/ERVL-MaLR	1663	+	48	158946887	78869
chr2	158868018	159068018	harbor1	chr2	158946974	158947353	LTR/ERVL-MaLR	1663	+	190	158947164	79146
chr2	158868018	159068018	harbor1	chr2	158951895	158952261	LTR/ERVL-MaLR	891	+	183	158952078	84060
chr2	158868018	159068018	harbor1	chr2	158957048	158957334	LTR/ERVL-MaLR	994	+	143	158957191	89173
chr2	158868018	159068018	harbor1	chr2	158958534	158958969	LTR/ERVL-MaLR	480	+	218	158958752	90734
chr2	158868018	159068018	harbor1	chr2	158960317	158960696	LTR/ERVL-MaLR	642	+	190	158960507	92489
chr2	96174902	96374902	harbor1	chr2	96174851	96175278	LTR/ERVL-MaLR	2207	+	214	96175065	163
chr2	96174902	96374902	harbor1	chr2	96177659	96177770	LTR/ERVL-MaLR	457	+	56	96177715	2813
chr2	96174902	96374902	harbor1	chr2	96246824	96247058	LTR/ERVL-MaLR	542	+	117	96246941	72039
chr2	113484027	113684027	harbor1	chr2	113556719	113556984	LTR/ERVL-MaLR	804	+	132	113556851	72824
chr2	113484027	113684027	harbor1	chr2	113578542	113578898	LTR/ERVL-MaLR	842	+	178	113578720	94693
chr2	72971175	73171175	harbor1	chr2	72976966	72977344	LTR/ERVL-MaLR	678	+	189	72977155	5980
chr2	72971175	73171175	harbor1	chr2	73005928	73006277	LTR/ERVL-MaLR	447	+	174	73006102	34927
chr2	72971175	73171175	harbor1	chr2	73010117	73010620	LTR/ERVL-MaLR	1121	+	252	73010369	39194
chr2	72971175	73171175	harbor1	chr2	73029009	73029332	LTR/ERVL-MaLR	581	+	162	73029171	57996
chr2	72971175	73171175	harbor1	chr2	73031174	73031541	LTR/ERVL-MaLR	942	+	184	73031358	60183
chr2	72971175	73171175	harbor1	chr2	73047450	73047803	LTR/ERVL-MaLR	2335	+	176	73047626	76451
chr2	72971175	73171175	harbor1	chr2	73057646	73058002	LTR/ERVL-MaLR	2040	+	178	73057824	86649
chr2	26950215	27150215	harbor1	chr2	26985687	26986056	LTR/ERVL-MaLR	826	+	184	26985871	35656
chr2	26950215	27150215	harbor1	chr2	27028397	27028496	LTR/ERVL-MaLR	1992	+	50	27028447	78232
chr2	26950215	27150215	harbor1	chr2	27028803	27028934	LTR/ERVL-MaLR	1992	+	66	27028869	78654
chr2	26950215	27150215	harbor1	chr2	27029230	27029518	LTR/ERVL-MaLR	1992	+	144	27029374	79159
chr2	26950215	27150215	harbor1	chr2	26968037	26968182	LTR/ERVL-MaLR	476	+	72	26968109	17894
chr2	61276617	61476617	harbor1	chr2	61277717	61278101	LTR/ERVL-MaLR	1842	+	192	61277909	1292
chr2	61276617	61476617	harbor1	chr2	61304418	61304770	LTR/ERVL-MaLR	1532	+	176	61304594	27977
chr2	61276617	61476617	harbor1	chr2	61311093	61311407	LTR/ERVL-MaLR	1043	+	157	61311250	34633
chr2	61276617	61476617	harbor1	chr2	61342062	61342097	LTR/ERVL-MaLR	2065	+	18	61342080	65463
chr2	61276617	61476617	harbor1	chr2	61341373	61341751	LTR/ERVL-MaLR	2065	+	189	61341562	64945
chr2	96108492	96308492	harbor1	chr2	96174851	96175278	LTR/ERVL-MaLR	2207	+	214	96175065	66573
chr2	96108492	96308492	harbor1	chr2	96177659	96177770	LTR/ERVL-MaLR	457	+	56	96177715	69223
chr2	111955737	112155737	harbor1	chr2	112037085	112037429	LTR/ERVL-MaLR	1212	+	172	112037257	81520
chr2	72043426	72243426	harbor1	chr2	72050686	72050943	LTR/ERVL-MaLR	760	+	128	72050814	7388
chr2	72043426	72243426	harbor1	chr2	72053519	72053871	LTR/ERVL-MaLR	895	+	176	72053695	10269
chr2	72043426	72243426	harbor1	chr2	72070457	72070935	LTR/ERVL-MaLR	1847	+	239	72070696	27270
chr2	72043426	72243426	harbor1	chr2	72075494	72075844	LTR/ERVL-MaLR	468	+	175	72075669	32243
chr2	72043426	72243426	harbor1	chr2	72109198	72109763	LTR/ERVL-MaLR	1920	+	282	72109480	66054
chr3	107991301	108191301	harbor1	chr3	108023714	108024132	LTR/ERVL-MaLR	1893	+	209	108023923	32622
chr3	107991301	108191301	harbor1	chr3	108042364	108042884	LTR/ERVL-MaLR	769	+	260	108042624	51323
chr3	107991301	108191301	harbor1	chr3	108060167	108060678	LTR/ERVL-MaLR	1047	+	256	108060423	69122
chr3	107991301	108191301	harbor1	chr3	108075592	108076239	LTR/ERVL-MaLR	2398	+	324	108075916	84615
chr3	107991372	108191372	harbor1	chr3	108023714	108024132	LTR/ERVL-MaLR	1893	+	209	108023923	32551
chr3	107991372	108191372	harbor1	chr3	108042364	108042884	LTR/ERVL-MaLR	769	+	260	108042624	51252
chr3	107991372	108191372	harbor1	chr3	108060167	108060678	LTR/ERVL-MaLR	1047	+	256	108060423	69051
chr3	107991372	108191372	harbor1	chr3	108075592	108076239	LTR/ERVL-MaLR	2398	+	324	108075916	84544
chr3	107991276	108191276	harbor1	chr3	108023714	108024132	LTR/ERVL-MaLR	1893	+	209	108023923	32647
chr3	107991276	108191276	harbor1	chr3	108042364	108042884	LTR/ERVL-MaLR	769	+	260	108042624	51348
chr3	107991276	108191276	harbor1	chr3	108060167	108060678	LTR/ERVL-MaLR	1047	+	256	108060423	69147
chr3	107991276	108191276	harbor1	chr3	108075592	108076239	LTR/ERVL-MaLR	2398	+	324	108075916	84640
chr3	46799606	46999606	harbor1	chr3	46804547	46804958	LTR/ERVL-MaLR	953	+	206	46804753	5147
chr3	46799606	46999606	harbor1	chr3	46805890	46805960	LTR/ERVL-MaLR	953	+	35	46805925	6319
chr3	46799606	46999606	harbor1	chr3	46819893	46820255	LTR/ERVL-MaLR	2354	+	181	46820074	20468
chr3	46799606	46999606	harbor1	chr3	46826867	46827051	LTR/ERVL-MaLR	1585	+	92	46826959	27353
chr3	46799606	46999606	harbor1	chr3	46827086	46827251	LTR/ERVL-MaLR	1585	+	82	46827168	27562
chr3	46799606	46999606	harbor1	chr3	46843365	46843674	LTR/ERVL-MaLR	1128	+	154	46843519	43913
chr3	53988061	54188061	harbor1	chr3	53995745	53996102	LTR/ERVL-MaLR	1951	+	178	53995923	7862
chr3	53988061	54188061	harbor1	chr3	54011887	54012199	LTR/ERVL-MaLR	1955	+	156	54012043	23982
chr3	53988061	54188061	harbor1	chr3	54018916	54019206	LTR/ERVL-MaLR	1496	+	145	54019061	31000
chr3	53988061	54188061	harbor1	chr3	54039953	54040176	LTR/ERVL-MaLR	498	+	112	54040065	52004
chr3	53988061	54188061	harbor1	chr3	54046881	54047306	LTR/ERVL-MaLR	530	+	212	54047093	59032
chr3	53988061	54188061	harbor1	chr3	54048960	54049348	LTR/ERVL-MaLR	1074	+	194	54049154	61093
chr3	53988061	54188061	harbor1	chr3	54079869	54080421	LTR/ERVL-MaLR	1075	+	276	54080145	92084
chr3	53988061	54188061	harbor1	chr3	54085495	54085920	LTR/ERVL-MaLR	2767	+	212	54085707	97646
chr3	178972064	179172064	harbor1	chr3	178974189	178974541	LTR/ERVL-MaLR	2290	+	176	178974365	2301
chr3	32470680	32670680	harbor1	chr3	32486695	32487076	LTR/ERVL-MaLR	2030	+	190	32486885	16205
chr3	32470680	32670680	harbor1	chr3	32521465	32521587	LTR/ERVL-MaLR	499	+	61	32521526	50846
chr3	32470680	32670680	harbor1	chr3	32523710	32523903	LTR/ERVL-MaLR	1246	+	96	32523806	53126
chr3	32470680	32670680	harbor1	chr3	32524212	32524402	LTR/ERVL-MaLR	1246	+	95	32524307	53627
chr3	51939471	52139471	harbor1	chr3	52010503	52010999	LTR/ERVL-MaLR	2421	+	248	52010751	71280
chr3	51939531	52139531	harbor1	chr3	52010503	52010999	LTR/ERVL-MaLR	2421	+	248	52010751	71220
chr3	11190614	11390614	harbor1	chr3	11199856	11200365	LTR/ERVL-MaLR	1147	+	254	11200110	9496
chr3	107991344	108191344	harbor1	chr3	108023714	108024132	LTR/ERVL-MaLR	1893	+	209	108023923	32579
chr3	107991344	108191344	harbor1	chr3	108042364	108042884	LTR/ERVL-MaLR	769	+	260	108042624	51280
chr3	107991344	108191344	harbor1	chr3	108060167	108060678	LTR/ERVL-MaLR	1047	+	256	108060423	69079
chr3	107991344	108191344	harbor1	chr3	108075592	108076239	LTR/ERVL-MaLR	2398	+	324	108075916	84572
chr3	107991369	108191369	harbor1	chr3	108023714	108024132	LTR/ERVL-MaLR	1893	+	209	108023923	32554
chr3	107991369	108191369	harbor1	chr3	108042364	108042884	LTR/ERVL-MaLR	769	+	260	108042624	51255
chr3	107991369	108191369	harbor1	chr3	108060167	108060678	LTR/ERVL-MaLR	1047	+	256	108060423	69054
chr3	107991369	108191369	harbor1	chr3	108075592	108076239	LTR/ERVL-MaLR	2398	+	324	108075916	84547
chr3	127490205	127690205	harbor1	chr3	127490064	127490254	LTR/ERVL-MaLR	873	+	95	127490159	46
chr3	127490205	127690205	harbor1	chr3	127510415	127510490	LTR/ERVL-MaLR	531	+	38	127510453	20248
chr3	127490205	127690205	harbor1	chr3	127511016	127511163	LTR/ERVL-MaLR	801	+	74	127511090	20885
chr3	127490205	127690205	harbor1	chr3	127511230	127511457	LTR/ERVL-MaLR	1698	+	114	127511344	21139
chr3	127490205	127690205	harbor1	chr3	127525957	127526130	LTR/ERVL-MaLR	792	+	86	127526043	35838
chr3	127490205	127690205	harbor1	chr3	127527789	127528062	LTR/ERVL-MaLR	1149	+	136	127527925	37720
chr3	127490205	127690205	harbor1	chr3	127569942	127570343	LTR/ERVL-MaLR	1888	+	200	127570142	79937
chr3	127490205	127690205	harbor1	chr3	127577719	127577920	LTR/ERVL-MaLR	471	+	100	127577819	87614
chr3	127490205	127690205	harbor1	chr3	127579393	127579729	LTR/ERVL-MaLR	856	+	168	127579561	89356
chr3	127490205	127690205	harbor1	chr3	127584551	127584714	LTR/ERVL-MaLR	525	+	82	127584633	94428
chr3	127490205	127690205	harbor1	chr3	127584890	127585096	LTR/ERVL-MaLR	528	+	103	127584993	94788
chr3	127490205	127690205	harbor1	chr3	127586917	127587479	LTR/ERVL-MaLR	923	+	281	127587198	96993
chr3	127490205	127690205	harbor1	chr3	127532779	127533195	LTR/ERVL-MaLR	691	+	208	127532987	42782
chr3	51884539	52084539	harbor1	chr3	51888611	51889009	LTR/ERVL-MaLR	670	+	199	51888810	4271
chr3	51884539	52084539	harbor1	chr3	51904644	51904828	LTR/ERVL-MaLR	2370	+	92	51904736	20197
chr3	51884539	52084539	harbor1	chr3	51905125	51905316	LTR/ERVL-MaLR	2370	+	96	51905221	20682
chr3	51884539	52084539	harbor1	chr3	51905317	51906883	LTR/ERVL-MaLR	12306	+	783	51906100	21561
chr3	51884539	52084539	harbor1	chr3	51906884	51907069	LTR/ERVL-MaLR	2396	+	92	51906976	22437
chr3	51884539	52084539	harbor1	chr3	51907365	51907557	LTR/ERVL-MaLR	2396	+	96	51907461	22922
chr3	51884539	52084539	harbor1	chr3	51931102	51931440	LTR/ERVL-MaLR	1059	+	169	51931271	46732
chr3	51884539	52084539	harbor1	chr3	51931756	51931842	LTR/ERVL-MaLR	1059	+	43	51931799	47260
chr3	140272103	140472103	harbor1	chr3	140306915	140307268	LTR/ERVL-MaLR	2330	+	176	140307091	34988
chr3	140272103	140472103	harbor1	chr3	140348946	140349317	LTR/ERVL-MaLR	2089	+	186	140349132	77029
chr3	143020785	143220785	harbor1	chr3	143062934	143063309	LTR/ERVL-MaLR	2033	+	188	143063122	42337
chr3	143020785	143220785	harbor1	chr3	143097331	143097739	LTR/ERVL-MaLR	1543	+	204	143097535	76750
chr3	107991302	108191302	harbor1	chr3	108023714	108024132	LTR/ERVL-MaLR	1893	+	209	108023923	32621
chr3	107991302	108191302	harbor1	chr3	108042364	108042884	LTR/ERVL-MaLR	769	+	260	108042624	51322
chr3	107991302	108191302	harbor1	chr3	108060167	108060678	LTR/ERVL-MaLR	1047	+	256	108060423	69121
chr3	107991302	108191302	harbor1	chr3	108075592	108076239	LTR/ERVL-MaLR	2398	+	324	108075916	84614
chr3	197859562	198059562	harbor1	chr3	197945020	197945545	LTR/ERVL-MaLR	2653	+	262	197945282	85720
chr3	107991335	108191335	harbor1	chr3	108023714	108024132	LTR/ERVL-MaLR	1893	+	209	108023923	32588
chr3	107991335	108191335	harbor1	chr3	108042364	108042884	LTR/ERVL-MaLR	769	+	260	108042624	51289
chr3	107991335	108191335	harbor1	chr3	108060167	108060678	LTR/ERVL-MaLR	1047	+	256	108060423	69088
chr3	107991335	108191335	harbor1	chr3	108075592	108076239	LTR/ERVL-MaLR	2398	+	324	108075916	84581
chr3	7485739	7685739	harbor1	chr3	7486340	7486783	LTR/ERVL-MaLR	1208	+	222	7486562	823
chr3	7485739	7685739	harbor1	chr3	7488340	7488757	LTR/ERVL-MaLR	1123	+	208	7488548	2809
chr3	7485739	7685739	harbor1	chr3	7521295	7521645	LTR/ERVL-MaLR	1810	+	175	7521470	35731
chr3	7485739	7685739	harbor1	chr3	7522744	7523146	LTR/ERVL-MaLR	1052	+	201	7522945	37206
chr3	7485739	7685739	harbor1	chr3	7548077	7548503	LTR/ERVL-MaLR	2248	+	213	7548290	62551
chr3	7485739	7685739	harbor1	chr3	7486784	7488339	LTR/ERVL-MaLR	4441	+	778	7487562	1823
chr3	7485739	7685739	harbor1	chr3	7536443	7536957	LTR/ERVL-MaLR	1508	+	257	7536700	50961
chr3	43898752	44098752	harbor1	chr3	43900602	43900908	LTR/ERVL-MaLR	1851	+	153	43900755	2003
chr3	43898752	44098752	harbor1	chr3	43901330	43901484	LTR/ERVL-MaLR	604	+	77	43901407	2655
chr3	43898752	44098752	harbor1	chr3	43901489	43901662	LTR/ERVL-MaLR	590	+	86	43901575	2823
chr3	43898752	44098752	harbor1	chr3	43903069	43903500	LTR/ERVL-MaLR	1996	+	216	43903285	4533
chr3	43898752	44098752	harbor1	chr3	43913879	43914263	LTR/ERVL-MaLR	2001	+	192	43914071	15319
chr3	43898752	44098752	harbor1	chr3	43916804	43917160	LTR/ERVL-MaLR	1780	+	178	43916982	18230
chr3	43898752	44098752	harbor1	chr3	43985162	43985624	LTR/ERVL-MaLR	2314	+	231	43985393	86641
chr3	126256980	126456980	harbor1	chr3	126261972	126262422	LTR/ERVL-MaLR	1546	+	225	126262197	5217
chr3	126256980	126456980	harbor1	chr3	126299396	126299468	LTR/ERVL-MaLR	1394	+	36	126299432	42452
chr3	126256980	126456980	harbor1	chr3	126299774	126299990	LTR/ERVL-MaLR	1394	+	108	126299882	42902
chr3	126256980	126456980	harbor1	chr3	126304926	126305296	LTR/ERVL-MaLR	936	+	185	126305111	48131
chr3	126256980	126456980	harbor1	chr3	126312979	126313386	LTR/ERVL-MaLR	1644	+	204	126313183	56203
chr3	126256980	126456980	harbor1	chr3	126330005	126330359	LTR/ERVL-MaLR	536	+	177	126330182	73202
chr3	126256980	126456980	harbor1	chr3	126340150	126340338	LTR/ERVL-MaLR	513	+	94	126340244	83264
chr3	126256980	126456980	harbor1	chr3	126340407	126340583	LTR/ERVL-MaLR	446	+	88	126340495	83515
chr3	184086431	184286431	harbor1	chr3	184096325	184096650	LTR/ERVL-MaLR	2156	+	162	184096487	10056
chr3	184086431	184286431	harbor1	chr3	184096948	184097127	LTR/ERVL-MaLR	2156	+	90	184097038	10607
chr3	51939509	52139509	harbor1	chr3	52010503	52010999	LTR/ERVL-MaLR	2421	+	248	52010751	71242
chr3	107991385	108191385	harbor1	chr3	108023714	108024132	LTR/ERVL-MaLR	1893	+	209	108023923	32538
chr3	107991385	108191385	harbor1	chr3	108042364	108042884	LTR/ERVL-MaLR	769	+	260	108042624	51239
chr3	107991385	108191385	harbor1	chr3	108060167	108060678	LTR/ERVL-MaLR	1047	+	256	108060423	69038
chr3	107991385	108191385	harbor1	chr3	108075592	108076239	LTR/ERVL-MaLR	2398	+	324	108075916	84531
chr3	184086603	184286603	harbor1	chr3	184096325	184096650	LTR/ERVL-MaLR	2156	+	162	184096487	9884
chr3	184086603	184286603	harbor1	chr3	184096948	184097127	LTR/ERVL-MaLR	2156	+	90	184097038	10435
chr3	49829599	50029599	harbor1	chr3	49883638	49884012	LTR/ERVL-MaLR	1967	+	187	49883825	54226
chr3	49829599	50029599	harbor1	chr3	49924268	49924396	LTR/ERVL-MaLR	3031	+	64	49924332	94733
chr3	49829599	50029599	harbor1	chr3	49924701	49925088	LTR/ERVL-MaLR	3031	+	194	49924895	95296
chr3	51939455	52139455	harbor1	chr3	52010503	52010999	LTR/ERVL-MaLR	2421	+	248	52010751	71296
chr3	127572813	127772813	harbor1	chr3	127577719	127577920	LTR/ERVL-MaLR	471	+	100	127577819	5006
chr3	127572813	127772813	harbor1	chr3	127579393	127579729	LTR/ERVL-MaLR	856	+	168	127579561	6748
chr3	127572813	127772813	harbor1	chr3	127584551	127584714	LTR/ERVL-MaLR	525	+	82	127584633	11820
chr3	127572813	127772813	harbor1	chr3	127584890	127585096	LTR/ERVL-MaLR	528	+	103	127584993	12180
chr3	127572813	127772813	harbor1	chr3	127586917	127587479	LTR/ERVL-MaLR	923	+	281	127587198	14385
chr3	127572813	127772813	harbor1	chr3	127595618	127596083	LTR/ERVL-MaLR	1603	+	232	127595850	23037
chr3	127572813	127772813	harbor1	chr3	127596379	127596413	LTR/ERVL-MaLR	1603	+	17	127596396	23583
chr3	183820276	184020276	harbor1	chr3	183879245	183879623	LTR/ERVL-MaLR	976	+	189	183879434	59158
chr3	183820276	184020276	harbor1	chr3	183900491	183900590	LTR/ERVL-MaLR	2410	+	50	183900541	80265
chr3	183820276	184020276	harbor1	chr3	183900905	183900930	LTR/ERVL-MaLR	2410	+	12	183900917	80641
chr3	183820276	184020276	harbor1	chr3	183901226	183901652	LTR/ERVL-MaLR	2410	+	213	183901439	81163
chr3	183820276	184020276	harbor1	chr3	183918568	183918869	LTR/ERVL-MaLR	533	+	150	183918718	98442
chr3	107991358	108191358	harbor1	chr3	108023714	108024132	LTR/ERVL-MaLR	1893	+	209	108023923	32565
chr3	107991358	108191358	harbor1	chr3	108042364	108042884	LTR/ERVL-MaLR	769	+	260	108042624	51266
chr3	107991358	108191358	harbor1	chr3	108060167	108060678	LTR/ERVL-MaLR	1047	+	256	108060423	69065
chr3	107991358	108191358	harbor1	chr3	108075592	108076239	LTR/ERVL-MaLR	2398	+	324	108075916	84558
chr3	156989221	157189221	harbor1	chr3	156998874	156999253	LTR/ERVL-MaLR	2677	+	190	156999064	9843
chr3	156989221	157189221	harbor1	chr3	157000778	157001162	LTR/ERVL-MaLR	2174	+	192	157000970	11749
chr3	156989221	157189221	harbor1	chr3	157007272	157007502	LTR/ERVL-MaLR	394	+	115	157007387	18166
chr3	156989221	157189221	harbor1	chr3	157042889	157043304	LTR/ERVL-MaLR	2688	+	208	157043097	53876
chr3	156989221	157189221	harbor1	chr3	157060715	157061091	LTR/ERVL-MaLR	2117	+	188	157060903	71682
chr3	107991326	108191326	harbor1	chr3	108023714	108024132	LTR/ERVL-MaLR	1893	+	209	108023923	32597
chr3	107991326	108191326	harbor1	chr3	108042364	108042884	LTR/ERVL-MaLR	769	+	260	108042624	51298
chr3	107991326	108191326	harbor1	chr3	108060167	108060678	LTR/ERVL-MaLR	1047	+	256	108060423	69097
chr3	107991326	108191326	harbor1	chr3	108075592	108076239	LTR/ERVL-MaLR	2398	+	324	108075916	84590
chr3	126257099	126457099	harbor1	chr3	126261972	126262422	LTR/ERVL-MaLR	1546	+	225	126262197	5098
chr3	126257099	126457099	harbor1	chr3	126299396	126299468	LTR/ERVL-MaLR	1394	+	36	126299432	42333
chr3	126257099	126457099	harbor1	chr3	126299774	126299990	LTR/ERVL-MaLR	1394	+	108	126299882	42783
chr3	126257099	126457099	harbor1	chr3	126304926	126305296	LTR/ERVL-MaLR	936	+	185	126305111	48012
chr3	126257099	126457099	harbor1	chr3	126312979	126313386	LTR/ERVL-MaLR	1644	+	204	126313183	56084
chr3	126257099	126457099	harbor1	chr3	126330005	126330359	LTR/ERVL-MaLR	536	+	177	126330182	73083
chr3	126257099	126457099	harbor1	chr3	126340150	126340338	LTR/ERVL-MaLR	513	+	94	126340244	83145
chr3	126257099	126457099	harbor1	chr3	126340407	126340583	LTR/ERVL-MaLR	446	+	88	126340495	83396
chr3	107991288	108191288	harbor1	chr3	108023714	108024132	LTR/ERVL-MaLR	1893	+	209	108023923	32635
chr3	107991288	108191288	harbor1	chr3	108042364	108042884	LTR/ERVL-MaLR	769	+	260	108042624	51336
chr3	107991288	108191288	harbor1	chr3	108060167	108060678	LTR/ERVL-MaLR	1047	+	256	108060423	69135
chr3	107991288	108191288	harbor1	chr3	108075592	108076239	LTR/ERVL-MaLR	2398	+	324	108075916	84628
chr3	107991382	108191382	harbor1	chr3	108023714	108024132	LTR/ERVL-MaLR	1893	+	209	108023923	32541
chr3	107991382	108191382	harbor1	chr3	108042364	108042884	LTR/ERVL-MaLR	769	+	260	108042624	51242
chr3	107991382	108191382	harbor1	chr3	108060167	108060678	LTR/ERVL-MaLR	1047	+	256	108060423	69041
chr3	107991382	108191382	harbor1	chr3	108075592	108076239	LTR/ERVL-MaLR	2398	+	324	108075916	84534
chr3	107991314	108191314	harbor1	chr3	108023714	108024132	LTR/ERVL-MaLR	1893	+	209	108023923	32609
chr3	107991314	108191314	harbor1	chr3	108042364	108042884	LTR/ERVL-MaLR	769	+	260	108042624	51310
chr3	107991314	108191314	harbor1	chr3	108060167	108060678	LTR/ERVL-MaLR	1047	+	256	108060423	69109
chr3	107991314	108191314	harbor1	chr3	108075592	108076239	LTR/ERVL-MaLR	2398	+	324	108075916	84602
chr3	107991379	108191379	harbor1	chr3	108023714	108024132	LTR/ERVL-MaLR	1893	+	209	108023923	32544
chr3	107991379	108191379	harbor1	chr3	108042364	108042884	LTR/ERVL-MaLR	769	+	260	108042624	51245
chr3	107991379	108191379	harbor1	chr3	108060167	108060678	LTR/ERVL-MaLR	1047	+	256	108060423	69044
chr3	107991379	108191379	harbor1	chr3	108075592	108076239	LTR/ERVL-MaLR	2398	+	324	108075916	84537
chr3	23710865	23910865	harbor1	chr3	23762068	23762305	LTR/ERVL-MaLR	481	+	118	23762186	51321
chr3	23710865	23910865	harbor1	chr3	23765821	23766053	LTR/ERVL-MaLR	843	+	116	23765937	55072
chr3	23710865	23910865	harbor1	chr3	23778377	23778758	LTR/ERVL-MaLR	1694	+	190	23778567	67702
chr3	107991341	108191341	harbor1	chr3	108023714	108024132	LTR/ERVL-MaLR	1893	+	209	108023923	32582
chr3	107991341	108191341	harbor1	chr3	108042364	108042884	LTR/ERVL-MaLR	769	+	260	108042624	51283
chr3	107991341	108191341	harbor1	chr3	108060167	108060678	LTR/ERVL-MaLR	1047	+	256	108060423	69082
chr3	107991341	108191341	harbor1	chr3	108075592	108076239	LTR/ERVL-MaLR	2398	+	324	108075916	84575
chr3	107991400	108191400	harbor1	chr3	108023714	108024132	LTR/ERVL-MaLR	1893	+	209	108023923	32523
chr3	107991400	108191400	harbor1	chr3	108042364	108042884	LTR/ERVL-MaLR	769	+	260	108042624	51224
chr3	107991400	108191400	harbor1	chr3	108060167	108060678	LTR/ERVL-MaLR	1047	+	256	108060423	69023
chr3	107991400	108191400	harbor1	chr3	108075592	108076239	LTR/ERVL-MaLR	2398	+	324	108075916	84516
chr3	129021178	129221178	harbor1	chr3	129051925	129052338	LTR/ERVL-MaLR	1567	+	206	129052131	30953
chr3	129021178	129221178	harbor1	chr3	129052652	129052719	LTR/ERVL-MaLR	1567	+	34	129052686	31508
chr3	129021178	129221178	harbor1	chr3	129078601	129078853	LTR/ERVL-MaLR	687	+	126	129078727	57549
chr3	107991325	108191325	harbor1	chr3	108023714	108024132	LTR/ERVL-MaLR	1893	+	209	108023923	32598
chr3	107991325	108191325	harbor1	chr3	108042364	108042884	LTR/ERVL-MaLR	769	+	260	108042624	51299
chr3	107991325	108191325	harbor1	chr3	108060167	108060678	LTR/ERVL-MaLR	1047	+	256	108060423	69098
chr3	107991325	108191325	harbor1	chr3	108075592	108076239	LTR/ERVL-MaLR	2398	+	324	108075916	84591
chr3	47534446	47734446	harbor1	chr3	47561196	47561588	LTR/ERVL-MaLR	1763	+	196	47561392	26946
chr3	47534446	47734446	harbor1	chr3	47581763	47582164	LTR/ERVL-MaLR	1975	+	200	47581963	47517
chr3	47534446	47734446	harbor1	chr3	47598921	47599104	LTR/ERVL-MaLR	385	+	92	47599013	64567
chr3	47534446	47734446	harbor1	chr3	47599389	47599414	LTR/ERVL-MaLR	385	+	12	47599401	64955
chr3	47534446	47734446	harbor1	chr3	47626646	47627097	LTR/ERVL-MaLR	672	+	226	47626872	92426
chr3	47534446	47734446	harbor1	chr3	47627113	47627726	LTR/ERVL-MaLR	1065	+	306	47627419	92973
chr3	47534446	47734446	harbor1	chr3	47628485	47628581	LTR/ERVL-MaLR	659	+	48	47628533	94087
chr3	47534446	47734446	harbor1	chr3	47628845	47629415	LTR/ERVL-MaLR	659	+	285	47629130	94684
chr3	47534446	47734446	harbor1	chr3	47629430	47629918	LTR/ERVL-MaLR	956	+	244	47629674	95228
chr3	184216377	184416377	harbor1	chr3	184265379	184265446	LTR/ERVL-MaLR	1599	+	34	184265413	49036
chr3	184216377	184416377	harbor1	chr3	184265741	184265798	LTR/ERVL-MaLR	1599	+	28	184265769	49392
chr3	184216377	184416377	harbor1	chr3	184266151	184266492	LTR/ERVL-MaLR	1599	+	170	184266321	49944
chr3	184216377	184416377	harbor1	chr3	184270172	184270330	LTR/ERVL-MaLR	557	+	79	184270251	53874
chr3	184216377	184416377	harbor1	chr3	184270925	184271211	LTR/ERVL-MaLR	557	+	143	184271068	54691
chr3	52830611	53030611	harbor1	chr3	52847656	52848143	LTR/ERVL-MaLR	1651	+	244	52847900	17289
chr3	52830611	53030611	harbor1	chr3	52857800	52858193	LTR/ERVL-MaLR	1881	+	196	52857996	27385
chr3	52830611	53030611	harbor1	chr3	52862729	52863145	LTR/ERVL-MaLR	1107	+	208	52862937	32326
chr3	52830611	53030611	harbor1	chr3	52868266	52868337	LTR/ERVL-MaLR	397	+	36	52868302	37691
chr3	52830611	53030611	harbor1	chr3	52917224	52917561	LTR/ERVL-MaLR	1514	+	168	52917392	86781
chr3	52830611	53030611	harbor1	chr3	52917884	52917937	LTR/ERVL-MaLR	1514	+	26	52917910	87299
chr3	52830611	53030611	harbor1	chr3	52919631	52919854	LTR/ERVL-MaLR	1911	+	112	52919743	89132
chr3	52830611	53030611	harbor1	chr3	52919855	52920214	LTR/ERVL-MaLR	2263	+	180	52920035	89424
chr3	52830611	53030611	harbor1	chr3	52920215	52920430	LTR/ERVL-MaLR	1911	+	108	52920323	89712
chr3	128328776	128528776	harbor1	chr3	128416670	128416931	LTR/ERVL-MaLR	484	+	130	128416800	88024
chr3	123544722	123744722	harbor1	chr3	123548086	123548573	LTR/ERVL-MaLR	1866	+	244	123548330	3608
chr3	123544722	123744722	harbor1	chr3	123565298	123565653	LTR/ERVL-MaLR	2134	+	178	123565476	20754
chr3	123544722	123744722	harbor1	chr3	123571235	123571840	LTR/ERVL-MaLR	2306	+	302	123571537	26815
chr3	123544722	123744722	harbor1	chr3	123581492	123581725	LTR/ERVL-MaLR	470	+	116	123581608	36886
chr3	123544722	123744722	harbor1	chr3	123591996	123592347	LTR/ERVL-MaLR	2436	+	176	123592172	47450
chr3	123544722	123744722	harbor1	chr3	123616563	123616929	LTR/ERVL-MaLR	2052	+	183	123616746	72024
chr3	50488218	50688218	harbor1	chr3	50493232	50493489	LTR/ERVL-MaLR	861	+	128	50493360	5142
chr3	50488218	50688218	harbor1	chr3	50584334	50584805	LTR/ERVL-MaLR	2118	+	236	50584570	96352
chr3	50488218	50688218	harbor1	chr3	50584806	50584921	LTR/ERVL-MaLR	418	+	58	50584864	96646
chr3	51939482	52139482	harbor1	chr3	52010503	52010999	LTR/ERVL-MaLR	2421	+	248	52010751	71269
chr3	50401005	50601005	harbor1	chr3	50493232	50493489	LTR/ERVL-MaLR	861	+	128	50493360	92355
chr3	107991338	108191338	harbor1	chr3	108023714	108024132	LTR/ERVL-MaLR	1893	+	209	108023923	32585
chr3	107991338	108191338	harbor1	chr3	108042364	108042884	LTR/ERVL-MaLR	769	+	260	108042624	51286
chr3	107991338	108191338	harbor1	chr3	108060167	108060678	LTR/ERVL-MaLR	1047	+	256	108060423	69085
chr3	107991338	108191338	harbor1	chr3	108075592	108076239	LTR/ERVL-MaLR	2398	+	324	108075916	84578
chr3	107990780	108190780	harbor1	chr3	108023714	108024132	LTR/ERVL-MaLR	1893	+	209	108023923	33143
chr3	107990780	108190780	harbor1	chr3	108042364	108042884	LTR/ERVL-MaLR	769	+	260	108042624	51844
chr3	107990780	108190780	harbor1	chr3	108060167	108060678	LTR/ERVL-MaLR	1047	+	256	108060423	69643
chr3	107990780	108190780	harbor1	chr3	108075592	108076239	LTR/ERVL-MaLR	2398	+	324	108075916	85136
chr3	107991316	108191316	harbor1	chr3	108023714	108024132	LTR/ERVL-MaLR	1893	+	209	108023923	32607
chr3	107991316	108191316	harbor1	chr3	108042364	108042884	LTR/ERVL-MaLR	769	+	260	108042624	51308
chr3	107991316	108191316	harbor1	chr3	108060167	108060678	LTR/ERVL-MaLR	1047	+	256	108060423	69107
chr3	107991316	108191316	harbor1	chr3	108075592	108076239	LTR/ERVL-MaLR	2398	+	324	108075916	84600
chr3	123544636	123744636	harbor1	chr3	123548086	123548573	LTR/ERVL-MaLR	1866	+	244	123548330	3694
chr3	123544636	123744636	harbor1	chr3	123565298	123565653	LTR/ERVL-MaLR	2134	+	178	123565476	20840
chr3	123544636	123744636	harbor1	chr3	123571235	123571840	LTR/ERVL-MaLR	2306	+	302	123571537	26901
chr3	123544636	123744636	harbor1	chr3	123581492	123581725	LTR/ERVL-MaLR	470	+	116	123581608	36972
chr3	123544636	123744636	harbor1	chr3	123591996	123592347	LTR/ERVL-MaLR	2436	+	176	123592172	47536
chr3	123544636	123744636	harbor1	chr3	123616563	123616929	LTR/ERVL-MaLR	2052	+	183	123616746	72110
chr3	156575295	156775295	harbor1	chr3	156608509	156608912	LTR/ERVL-MaLR	2027	+	202	156608711	33416
chr3	156575295	156775295	harbor1	chr3	156610191	156610410	LTR/ERVL-MaLR	441	+	110	156610301	35006
chr3	156575295	156775295	harbor1	chr3	156632600	156632995	LTR/ERVL-MaLR	2144	+	198	156632798	57503
chr3	156575295	156775295	harbor1	chr3	156646803	156647189	LTR/ERVL-MaLR	1154	+	193	156646996	71701
chr3	156575295	156775295	harbor1	chr3	156672626	156672906	LTR/ERVL-MaLR	1060	+	140	156672766	97471
chr3	156575295	156775295	harbor1	chr3	156673032	156673229	LTR/ERVL-MaLR	702	+	98	156673130	97835
chr3	107991343	108191343	harbor1	chr3	108023714	108024132	LTR/ERVL-MaLR	1893	+	209	108023923	32580
chr3	107991343	108191343	harbor1	chr3	108042364	108042884	LTR/ERVL-MaLR	769	+	260	108042624	51281
chr3	107991343	108191343	harbor1	chr3	108060167	108060678	LTR/ERVL-MaLR	1047	+	256	108060423	69080
chr3	107991343	108191343	harbor1	chr3	108075592	108076239	LTR/ERVL-MaLR	2398	+	324	108075916	84573
chr3	126928935	127128935	harbor1	chr3	126951007	126951348	LTR/ERVL-MaLR	2013	+	170	126951177	22242
chr3	126928935	127128935	harbor1	chr3	126963392	126963568	LTR/ERVL-MaLR	434	+	88	126963480	34545
chr3	126928935	127128935	harbor1	chr3	126973320	126973469	LTR/ERVL-MaLR	409	+	74	126973394	44459
chr3	156989282	157189282	harbor1	chr3	156998874	156999253	LTR/ERVL-MaLR	2677	+	190	156999064	9782
chr3	156989282	157189282	harbor1	chr3	157000778	157001162	LTR/ERVL-MaLR	2174	+	192	157000970	11688
chr3	156989282	157189282	harbor1	chr3	157007272	157007502	LTR/ERVL-MaLR	394	+	115	157007387	18105
chr3	156989282	157189282	harbor1	chr3	157042889	157043304	LTR/ERVL-MaLR	2688	+	208	157043097	53815
chr3	156989282	157189282	harbor1	chr3	157060715	157061091	LTR/ERVL-MaLR	2117	+	188	157060903	71621
chr3	107991392	108191392	harbor1	chr3	108023714	108024132	LTR/ERVL-MaLR	1893	+	209	108023923	32531
chr3	107991392	108191392	harbor1	chr3	108042364	108042884	LTR/ERVL-MaLR	769	+	260	108042624	51232
chr3	107991392	108191392	harbor1	chr3	108060167	108060678	LTR/ERVL-MaLR	1047	+	256	108060423	69031
chr3	107991392	108191392	harbor1	chr3	108075592	108076239	LTR/ERVL-MaLR	2398	+	324	108075916	84524
chr3	128328718	128528718	harbor1	chr3	128416670	128416931	LTR/ERVL-MaLR	484	+	130	128416800	88082
chr3	193971532	194171532	harbor1	chr3	193983863	193984230	LTR/ERVL-MaLR	948	+	184	193984047	12515
chr3	193971532	194171532	harbor1	chr3	194007258	194007589	LTR/ERVL-MaLR	845	+	166	194007424	35892
chr3	193971532	194171532	harbor1	chr3	194008326	194008613	LTR/ERVL-MaLR	907	+	144	194008470	36938
chr3	193971532	194171532	harbor1	chr3	194008912	194009050	LTR/ERVL-MaLR	907	+	69	194008981	37449
chr3	193971532	194171532	harbor1	chr3	194020932	194021292	LTR/ERVL-MaLR	811	+	180	194021112	49580
chr3	193971532	194171532	harbor1	chr3	194021611	194021670	LTR/ERVL-MaLR	811	+	30	194021641	50109
chr3	193971532	194171532	harbor1	chr3	194069491	194069828	LTR/ERVL-MaLR	1305	+	168	194069659	98127
chr3	49355052	49555052	harbor1	chr3	49379948	49380420	LTR/ERVL-MaLR	1049	+	236	49380184	25132
chr3	49355052	49555052	harbor1	chr3	49397539	49397687	LTR/ERVL-MaLR	404	+	74	49397613	42561
chr3	47681953	47881953	harbor1	chr3	47695062	47695184	LTR/ERVL-MaLR	538	+	61	47695123	13170
chr3	107991320	108191320	harbor1	chr3	108023714	108024132	LTR/ERVL-MaLR	1893	+	209	108023923	32603
chr3	107991320	108191320	harbor1	chr3	108042364	108042884	LTR/ERVL-MaLR	769	+	260	108042624	51304
chr3	107991320	108191320	harbor1	chr3	108060167	108060678	LTR/ERVL-MaLR	1047	+	256	108060423	69103
chr3	107991320	108191320	harbor1	chr3	108075592	108076239	LTR/ERVL-MaLR	2398	+	324	108075916	84596
chr3	107991374	108191374	harbor1	chr3	108023714	108024132	LTR/ERVL-MaLR	1893	+	209	108023923	32549
chr3	107991374	108191374	harbor1	chr3	108042364	108042884	LTR/ERVL-MaLR	769	+	260	108042624	51250
chr3	107991374	108191374	harbor1	chr3	108060167	108060678	LTR/ERVL-MaLR	1047	+	256	108060423	69049
chr3	107991374	108191374	harbor1	chr3	108075592	108076239	LTR/ERVL-MaLR	2398	+	324	108075916	84542
chr3	51938202	52138202	harbor1	chr3	52010503	52010999	LTR/ERVL-MaLR	2421	+	248	52010751	72549
chr3	127490203	127690203	harbor1	chr3	127490064	127490254	LTR/ERVL-MaLR	873	+	95	127490159	44
chr3	127490203	127690203	harbor1	chr3	127510415	127510490	LTR/ERVL-MaLR	531	+	38	127510453	20250
chr3	127490203	127690203	harbor1	chr3	127511016	127511163	LTR/ERVL-MaLR	801	+	74	127511090	20887
chr3	127490203	127690203	harbor1	chr3	127511230	127511457	LTR/ERVL-MaLR	1698	+	114	127511344	21141
chr3	127490203	127690203	harbor1	chr3	127525957	127526130	LTR/ERVL-MaLR	792	+	86	127526043	35840
chr3	127490203	127690203	harbor1	chr3	127527789	127528062	LTR/ERVL-MaLR	1149	+	136	127527925	37722
chr3	127490203	127690203	harbor1	chr3	127569942	127570343	LTR/ERVL-MaLR	1888	+	200	127570142	79939
chr3	127490203	127690203	harbor1	chr3	127577719	127577920	LTR/ERVL-MaLR	471	+	100	127577819	87616
chr3	127490203	127690203	harbor1	chr3	127579393	127579729	LTR/ERVL-MaLR	856	+	168	127579561	89358
chr3	127490203	127690203	harbor1	chr3	127584551	127584714	LTR/ERVL-MaLR	525	+	82	127584633	94430
chr3	127490203	127690203	harbor1	chr3	127584890	127585096	LTR/ERVL-MaLR	528	+	103	127584993	94790
chr3	127490203	127690203	harbor1	chr3	127586917	127587479	LTR/ERVL-MaLR	923	+	281	127587198	96995
chr3	127490203	127690203	harbor1	chr3	127532779	127533195	LTR/ERVL-MaLR	691	+	208	127532987	42784
chr3	12958856	13158856	harbor1	chr3	13010227	13010452	LTR/ERVL-MaLR	655	+	112	13010339	51483
chr3	12958856	13158856	harbor1	chr3	13010482	13010727	LTR/ERVL-MaLR	447	+	122	13010604	51748
chr3	12958856	13158856	harbor1	chr3	13012656	13012875	LTR/ERVL-MaLR	696	+	110	13012766	53910
chr3	12958856	13158856	harbor1	chr3	13035637	13036178	LTR/ERVL-MaLR	1430	+	270	13035907	77051
chr3	128328598	128528598	harbor1	chr3	128416670	128416931	LTR/ERVL-MaLR	484	+	130	128416800	88202
chr3	196083882	196283882	harbor1	chr3	196144920	196145024	LTR/ERVL-MaLR	560	+	52	196144972	61090
chr3	196083882	196283882	harbor1	chr3	196148298	196148663	LTR/ERVL-MaLR	2313	+	182	196148480	64598
chr3	196083882	196283882	harbor1	chr3	196177507	196177915	LTR/ERVL-MaLR	1282	+	204	196177711	93829
chr3	64289146	64489146	harbor1	chr3	64306298	64306675	LTR/ERVL-MaLR	1390	+	188	64306486	17340
chr3	64289146	64489146	harbor1	chr3	64308546	64308860	LTR/ERVL-MaLR	829	+	157	64308703	19557
chr3	64289146	64489146	harbor1	chr3	64308861	64309242	LTR/ERVL-MaLR	1972	+	190	64309051	19905
chr3	64289146	64489146	harbor1	chr3	64309243	64309505	LTR/ERVL-MaLR	829	+	131	64309374	20228
chr3	64289146	64489146	harbor1	chr3	64313528	64314016	LTR/ERVL-MaLR	757	+	244	64313772	24626
chr3	64289146	64489146	harbor1	chr3	64317955	64318090	LTR/ERVL-MaLR	578	+	68	64318023	28877
chr3	64289146	64489146	harbor1	chr3	64325818	64326176	LTR/ERVL-MaLR	2041	+	179	64325997	36851
chr3	64289146	64489146	harbor1	chr3	64327509	64327864	LTR/ERVL-MaLR	735	+	178	64327687	38541
chr3	64289146	64489146	harbor1	chr3	64363024	64363596	LTR/ERVL-MaLR	1054	+	286	64363310	74164
chr3	64289146	64489146	harbor1	chr3	64373549	64373933	LTR/ERVL-MaLR	1546	+	192	64373741	84595
chr3	64289146	64489146	harbor1	chr3	64382843	64383199	LTR/ERVL-MaLR	1796	+	178	64383021	93875
chr3	161005344	161205344	harbor1	chr3	161025140	161025282	LTR/ERVL-MaLR	1606	+	71	161025211	19867
chr3	161005344	161205344	harbor1	chr3	161025595	161025790	LTR/ERVL-MaLR	1606	+	98	161025693	20349
chr3	161005344	161205344	harbor1	chr3	161030125	161030555	LTR/ERVL-MaLR	1262	+	215	161030340	24996
chr3	161005344	161205344	harbor1	chr3	161037063	161037412	LTR/ERVL-MaLR	1551	+	174	161037237	31893
chr3	161005344	161205344	harbor1	chr3	161037732	161037871	LTR/ERVL-MaLR	1551	+	70	161037802	32458
chr3	161005344	161205344	harbor1	chr3	161059638	161060050	LTR/ERVL-MaLR	2553	+	206	161059844	54500
chr3	161005344	161205344	harbor1	chr3	161082344	161082502	LTR/ERVL-MaLR	426	+	79	161082423	77079
chr3	197859739	198059739	harbor1	chr3	197945020	197945545	LTR/ERVL-MaLR	2653	+	262	197945282	85543
chr3	107991401	108191401	harbor1	chr3	108023714	108024132	LTR/ERVL-MaLR	1893	+	209	108023923	32522
chr3	107991401	108191401	harbor1	chr3	108042364	108042884	LTR/ERVL-MaLR	769	+	260	108042624	51223
chr3	107991401	108191401	harbor1	chr3	108060167	108060678	LTR/ERVL-MaLR	1047	+	256	108060423	69022
chr3	107991401	108191401	harbor1	chr3	108075592	108076239	LTR/ERVL-MaLR	2398	+	324	108075916	84515
chr3	107991291	108191291	harbor1	chr3	108023714	108024132	LTR/ERVL-MaLR	1893	+	209	108023923	32632
chr3	107991291	108191291	harbor1	chr3	108042364	108042884	LTR/ERVL-MaLR	769	+	260	108042624	51333
chr3	107991291	108191291	harbor1	chr3	108060167	108060678	LTR/ERVL-MaLR	1047	+	256	108060423	69132
chr3	107991291	108191291	harbor1	chr3	108075592	108076239	LTR/ERVL-MaLR	2398	+	324	108075916	84625
chr3	12867501	13067501	harbor1	chr3	12881555	12881732	LTR/ERVL-MaLR	1020	+	88	12881643	14142
chr3	12867501	13067501	harbor1	chr3	12882030	12882271	LTR/ERVL-MaLR	1020	+	120	12882150	14649
chr3	12867501	13067501	harbor1	chr3	12912775	12913279	LTR/ERVL-MaLR	733	+	252	12913027	45526
chr3	12867501	13067501	harbor1	chr3	12930663	12930777	LTR/ERVL-MaLR	410	+	57	12930720	63219
chr3	12867501	13067501	harbor1	chr3	12942697	12943041	LTR/ERVL-MaLR	1150	+	172	12942869	75368
chr3	48890283	49090283	harbor1	chr3	48914223	48914473	LTR/ERVL-MaLR	1771	+	125	48914348	24065
chr3	48890283	49090283	harbor1	chr3	48915409	48915669	LTR/ERVL-MaLR	1771	+	130	48915539	25256
chr3	49770828	49970828	harbor1	chr3	49817983	49818163	LTR/ERVL-MaLR	735	+	90	49818073	47245
chr3	134227277	134427277	harbor1	chr3	134244772	134245117	LTR/ERVL-MaLR	2097	+	172	134244944	17667
chr3	134227277	134427277	harbor1	chr3	134274318	134274684	LTR/ERVL-MaLR	2078	+	183	134274501	47224
chr3	134227277	134427277	harbor1	chr3	134278715	134279095	LTR/ERVL-MaLR	2376	+	190	134278905	51628
chr3	134227277	134427277	harbor1	chr3	134279919	134280239	LTR/ERVL-MaLR	456	+	160	134280079	52802
chr3	134227277	134427277	harbor1	chr3	134281814	134282337	LTR/ERVL-MaLR	2183	+	262	134282076	54799
chr3	134227277	134427277	harbor1	chr3	134291376	134291720	LTR/ERVL-MaLR	767	+	172	134291548	64271
chr3	134227277	134427277	harbor1	chr3	134300821	134300930	LTR/ERVL-MaLR	811	+	54	134300875	73598
chr3	134227277	134427277	harbor1	chr3	134301235	134301534	LTR/ERVL-MaLR	811	+	150	134301385	74108
chr3	134227277	134427277	harbor1	chr3	134318128	134318323	LTR/ERVL-MaLR	788	+	98	134318226	90949
chr3	51859972	52059972	harbor1	chr3	51869006	51869372	LTR/ERVL-MaLR	2284	+	183	51869189	9217
chr3	51859972	52059972	harbor1	chr3	51888611	51889009	LTR/ERVL-MaLR	670	+	199	51888810	28838
chr3	51859972	52059972	harbor1	chr3	51904644	51904828	LTR/ERVL-MaLR	2370	+	92	51904736	44764
chr3	51859972	52059972	harbor1	chr3	51905125	51905316	LTR/ERVL-MaLR	2370	+	96	51905221	45249
chr3	51859972	52059972	harbor1	chr3	51905317	51906883	LTR/ERVL-MaLR	12306	+	783	51906100	46128
chr3	51859972	52059972	harbor1	chr3	51906884	51907069	LTR/ERVL-MaLR	2396	+	92	51906976	47004
chr3	51859972	52059972	harbor1	chr3	51907365	51907557	LTR/ERVL-MaLR	2396	+	96	51907461	47489
chr3	51859972	52059972	harbor1	chr3	51931102	51931440	LTR/ERVL-MaLR	1059	+	169	51931271	71299
chr3	51859972	52059972	harbor1	chr3	51931756	51931842	LTR/ERVL-MaLR	1059	+	43	51931799	71827
chr3	107991415	108191415	harbor1	chr3	108023714	108024132	LTR/ERVL-MaLR	1893	+	209	108023923	32508
chr3	107991415	108191415	harbor1	chr3	108042364	108042884	LTR/ERVL-MaLR	769	+	260	108042624	51209
chr3	107991415	108191415	harbor1	chr3	108060167	108060678	LTR/ERVL-MaLR	1047	+	256	108060423	69008
chr3	107991415	108191415	harbor1	chr3	108075592	108076239	LTR/ERVL-MaLR	2398	+	324	108075916	84501
chr3	49730589	49930589	harbor1	chr3	49769563	49769932	LTR/ERVL-MaLR	1143	+	184	49769747	39158
chr3	49730589	49930589	harbor1	chr3	49770179	49770272	LTR/ERVL-MaLR	575	+	46	49770225	39636
chr3	49730589	49930589	harbor1	chr3	49817983	49818163	LTR/ERVL-MaLR	735	+	90	49818073	87484
chr3	23710941	23910941	harbor1	chr3	23762068	23762305	LTR/ERVL-MaLR	481	+	118	23762186	51245
chr3	23710941	23910941	harbor1	chr3	23765821	23766053	LTR/ERVL-MaLR	843	+	116	23765937	54996
chr3	23710941	23910941	harbor1	chr3	23778377	23778758	LTR/ERVL-MaLR	1694	+	190	23778567	67626
chr3	107991331	108191331	harbor1	chr3	108023714	108024132	LTR/ERVL-MaLR	1893	+	209	108023923	32592
chr3	107991331	108191331	harbor1	chr3	108042364	108042884	LTR/ERVL-MaLR	769	+	260	108042624	51293
chr3	107991331	108191331	harbor1	chr3	108060167	108060678	LTR/ERVL-MaLR	1047	+	256	108060423	69092
chr3	107991331	108191331	harbor1	chr3	108075592	108076239	LTR/ERVL-MaLR	2398	+	324	108075916	84585
chr3	49829614	50029614	harbor1	chr3	49883638	49884012	LTR/ERVL-MaLR	1967	+	187	49883825	54211
chr3	49829614	50029614	harbor1	chr3	49924268	49924396	LTR/ERVL-MaLR	3031	+	64	49924332	94718
chr3	49829614	50029614	harbor1	chr3	49924701	49925088	LTR/ERVL-MaLR	3031	+	194	49924895	95281
chr3	123544621	123744621	harbor1	chr3	123548086	123548573	LTR/ERVL-MaLR	1866	+	244	123548330	3709
chr3	123544621	123744621	harbor1	chr3	123565298	123565653	LTR/ERVL-MaLR	2134	+	178	123565476	20855
chr3	123544621	123744621	harbor1	chr3	123571235	123571840	LTR/ERVL-MaLR	2306	+	302	123571537	26916
chr3	123544621	123744621	harbor1	chr3	123581492	123581725	LTR/ERVL-MaLR	470	+	116	123581608	36987
chr3	123544621	123744621	harbor1	chr3	123591996	123592347	LTR/ERVL-MaLR	2436	+	176	123592172	47551
chr3	123544621	123744621	harbor1	chr3	123616563	123616929	LTR/ERVL-MaLR	2052	+	183	123616746	72125
chr3	107991277	108191277	harbor1	chr3	108023714	108024132	LTR/ERVL-MaLR	1893	+	209	108023923	32646
chr3	107991277	108191277	harbor1	chr3	108042364	108042884	LTR/ERVL-MaLR	769	+	260	108042624	51347
chr3	107991277	108191277	harbor1	chr3	108060167	108060678	LTR/ERVL-MaLR	1047	+	256	108060423	69146
chr3	107991277	108191277	harbor1	chr3	108075592	108076239	LTR/ERVL-MaLR	2398	+	324	108075916	84639
chr3	126902408	127102408	harbor1	chr3	126917636	126918002	LTR/ERVL-MaLR	2174	+	183	126917819	15411
chr3	126902408	127102408	harbor1	chr3	126951007	126951348	LTR/ERVL-MaLR	2013	+	170	126951177	48769
chr3	126902408	127102408	harbor1	chr3	126963392	126963568	LTR/ERVL-MaLR	434	+	88	126963480	61072
chr3	126902408	127102408	harbor1	chr3	126973320	126973469	LTR/ERVL-MaLR	409	+	74	126973394	70986
chr3	107991456	108191456	harbor1	chr3	108023714	108024132	LTR/ERVL-MaLR	1893	+	209	108023923	32467
chr3	107991456	108191456	harbor1	chr3	108042364	108042884	LTR/ERVL-MaLR	769	+	260	108042624	51168
chr3	107991456	108191456	harbor1	chr3	108060167	108060678	LTR/ERVL-MaLR	1047	+	256	108060423	68967
chr3	107991456	108191456	harbor1	chr3	108075592	108076239	LTR/ERVL-MaLR	2398	+	324	108075916	84460
chr3	138334644	138534644	harbor1	chr3	138421825	138422254	LTR/ERVL-MaLR	1902	+	214	138422039	87395
chr3	48890178	49090178	harbor1	chr3	48914223	48914473	LTR/ERVL-MaLR	1771	+	125	48914348	24170
chr3	48890178	49090178	harbor1	chr3	48915409	48915669	LTR/ERVL-MaLR	1771	+	130	48915539	25361
chr3	51939510	52139510	harbor1	chr3	52010503	52010999	LTR/ERVL-MaLR	2421	+	248	52010751	71241
chr3	129021082	129221082	harbor1	chr3	129051925	129052338	LTR/ERVL-MaLR	1567	+	206	129052131	31049
chr3	129021082	129221082	harbor1	chr3	129052652	129052719	LTR/ERVL-MaLR	1567	+	34	129052686	31604
chr3	129021082	129221082	harbor1	chr3	129078601	129078853	LTR/ERVL-MaLR	687	+	126	129078727	57645
chr3	107991375	108191375	harbor1	chr3	108023714	108024132	LTR/ERVL-MaLR	1893	+	209	108023923	32548
chr3	107991375	108191375	harbor1	chr3	108042364	108042884	LTR/ERVL-MaLR	769	+	260	108042624	51249
chr3	107991375	108191375	harbor1	chr3	108060167	108060678	LTR/ERVL-MaLR	1047	+	256	108060423	69048
chr3	107991375	108191375	harbor1	chr3	108075592	108076239	LTR/ERVL-MaLR	2398	+	324	108075916	84541
chr3	126888030	127088030	harbor1	chr3	126887867	126888358	LTR/ERVL-MaLR	715	+	246	126888113	83
chr3	126888030	127088030	harbor1	chr3	126917636	126918002	LTR/ERVL-MaLR	2174	+	183	126917819	29789
chr3	126888030	127088030	harbor1	chr3	126951007	126951348	LTR/ERVL-MaLR	2013	+	170	126951177	63147
chr3	126888030	127088030	harbor1	chr3	126963392	126963568	LTR/ERVL-MaLR	434	+	88	126963480	75450
chr3	126888030	127088030	harbor1	chr3	126973320	126973469	LTR/ERVL-MaLR	409	+	74	126973394	85364
chr3	124955501	125155501	harbor1	chr3	124957996	124958209	LTR/ERVL-MaLR	508	+	106	124958102	2601
chr3	124955501	125155501	harbor1	chr3	124958519	124958767	LTR/ERVL-MaLR	519	+	124	124958643	3142
chr3	124955501	125155501	harbor1	chr3	124976605	124976952	LTR/ERVL-MaLR	1595	+	174	124976779	21278
chr3	124955501	125155501	harbor1	chr3	124977307	124977353	LTR/ERVL-MaLR	1595	+	23	124977330	21829
chr3	124955501	125155501	harbor1	chr3	124976953	124977306	LTR/ERVL-MaLR	2263	+	176	124977129	21628
chr3	23710436	23910436	harbor1	chr3	23762068	23762305	LTR/ERVL-MaLR	481	+	118	23762186	51750
chr3	23710436	23910436	harbor1	chr3	23765821	23766053	LTR/ERVL-MaLR	843	+	116	23765937	55501
chr3	23710436	23910436	harbor1	chr3	23778377	23778758	LTR/ERVL-MaLR	1694	+	190	23778567	68131
chr3	107991447	108191447	harbor1	chr3	108023714	108024132	LTR/ERVL-MaLR	1893	+	209	108023923	32476
chr3	107991447	108191447	harbor1	chr3	108042364	108042884	LTR/ERVL-MaLR	769	+	260	108042624	51177
chr3	107991447	108191447	harbor1	chr3	108060167	108060678	LTR/ERVL-MaLR	1047	+	256	108060423	68976
chr3	107991447	108191447	harbor1	chr3	108075592	108076239	LTR/ERVL-MaLR	2398	+	324	108075916	84469
chr3	52123183	52323183	harbor1	chr3	52132707	52132763	LTR/ERVL-MaLR	1954	+	28	52132735	9552
chr3	52123183	52323183	harbor1	chr3	52133070	52133411	LTR/ERVL-MaLR	1954	+	170	52133240	10057
chr3	156989213	157189213	harbor1	chr3	156998874	156999253	LTR/ERVL-MaLR	2677	+	190	156999064	9851
chr3	156989213	157189213	harbor1	chr3	157000778	157001162	LTR/ERVL-MaLR	2174	+	192	157000970	11757
chr3	156989213	157189213	harbor1	chr3	157007272	157007502	LTR/ERVL-MaLR	394	+	115	157007387	18174
chr3	156989213	157189213	harbor1	chr3	157042889	157043304	LTR/ERVL-MaLR	2688	+	208	157043097	53884
chr3	156989213	157189213	harbor1	chr3	157060715	157061091	LTR/ERVL-MaLR	2117	+	188	157060903	71690
chr3	184085733	184285733	harbor1	chr3	184096325	184096650	LTR/ERVL-MaLR	2156	+	162	184096487	10754
chr3	184085733	184285733	harbor1	chr3	184096948	184097127	LTR/ERVL-MaLR	2156	+	90	184097038	11305
chr3	51939481	52139481	harbor1	chr3	52010503	52010999	LTR/ERVL-MaLR	2421	+	248	52010751	71270
chr3	107991309	108191309	harbor1	chr3	108023714	108024132	LTR/ERVL-MaLR	1893	+	209	108023923	32614
chr3	107991309	108191309	harbor1	chr3	108042364	108042884	LTR/ERVL-MaLR	769	+	260	108042624	51315
chr3	107991309	108191309	harbor1	chr3	108060167	108060678	LTR/ERVL-MaLR	1047	+	256	108060423	69114
chr3	107991309	108191309	harbor1	chr3	108075592	108076239	LTR/ERVL-MaLR	2398	+	324	108075916	84607
chr3	183788274	183988274	harbor1	chr3	183879245	183879623	LTR/ERVL-MaLR	976	+	189	183879434	91160
chr3	51939504	52139504	harbor1	chr3	52010503	52010999	LTR/ERVL-MaLR	2421	+	248	52010751	71247
chr3	51939448	52139448	harbor1	chr3	52010503	52010999	LTR/ERVL-MaLR	2421	+	248	52010751	71303
chr3	129875059	130075059	harbor1	chr3	129947013	129947517	LTR/ERVL-MaLR	1757	+	252	129947265	72206
chr3	129875059	130075059	harbor1	chr3	129954999	129955490	LTR/ERVL-MaLR	1082	+	246	129955245	80186
chr3	129875059	130075059	harbor1	chr3	129968336	129968840	LTR/ERVL-MaLR	1455	+	252	129968588	93529
chr3	129021083	129221083	harbor1	chr3	129051925	129052338	LTR/ERVL-MaLR	1567	+	206	129052131	31048
chr3	129021083	129221083	harbor1	chr3	129052652	129052719	LTR/ERVL-MaLR	1567	+	34	129052686	31603
chr3	129021083	129221083	harbor1	chr3	129078601	129078853	LTR/ERVL-MaLR	687	+	126	129078727	57644
chr3	51939511	52139511	harbor1	chr3	52010503	52010999	LTR/ERVL-MaLR	2421	+	248	52010751	71240
chr3	127489843	127689843	harbor1	chr3	127489704	127489865	LTR/ERVL-MaLR	681	+	80	127489784	59
chr3	127489843	127689843	harbor1	chr3	127490064	127490254	LTR/ERVL-MaLR	873	+	95	127490159	316
chr3	127489843	127689843	harbor1	chr3	127510415	127510490	LTR/ERVL-MaLR	531	+	38	127510453	20610
chr3	127489843	127689843	harbor1	chr3	127511016	127511163	LTR/ERVL-MaLR	801	+	74	127511090	21247
chr3	127489843	127689843	harbor1	chr3	127511230	127511457	LTR/ERVL-MaLR	1698	+	114	127511344	21501
chr3	127489843	127689843	harbor1	chr3	127525957	127526130	LTR/ERVL-MaLR	792	+	86	127526043	36200
chr3	127489843	127689843	harbor1	chr3	127527789	127528062	LTR/ERVL-MaLR	1149	+	136	127527925	38082
chr3	127489843	127689843	harbor1	chr3	127569942	127570343	LTR/ERVL-MaLR	1888	+	200	127570142	80299
chr3	127489843	127689843	harbor1	chr3	127577719	127577920	LTR/ERVL-MaLR	471	+	100	127577819	87976
chr3	127489843	127689843	harbor1	chr3	127579393	127579729	LTR/ERVL-MaLR	856	+	168	127579561	89718
chr3	127489843	127689843	harbor1	chr3	127584551	127584714	LTR/ERVL-MaLR	525	+	82	127584633	94790
chr3	127489843	127689843	harbor1	chr3	127584890	127585096	LTR/ERVL-MaLR	528	+	103	127584993	95150
chr3	127489843	127689843	harbor1	chr3	127586917	127587479	LTR/ERVL-MaLR	923	+	281	127587198	97355
chr3	127489843	127689843	harbor1	chr3	127532779	127533195	LTR/ERVL-MaLR	691	+	208	127532987	43144
chr3	123349837	123549837	harbor1	chr3	123369013	123369382	LTR/ERVL-MaLR	1135	+	184	123369197	19360
chr3	123349837	123549837	harbor1	chr3	123370307	123370740	LTR/ERVL-MaLR	597	+	216	123370523	20686
chr3	123349837	123549837	harbor1	chr3	123416801	123417108	LTR/ERVL-MaLR	1015	+	154	123416955	67118
chr3	195920322	196120322	harbor1	chr3	195923903	195924193	LTR/ERVL-MaLR	446	+	145	195924048	3726
chr3	195920322	196120322	harbor1	chr3	195929588	195929939	LTR/ERVL-MaLR	1785	+	176	195929764	9442
chr3	195920322	196120322	harbor1	chr3	196007785	196007893	LTR/ERVL-MaLR	541	+	54	196007839	87517
chr3	195920322	196120322	harbor1	chr3	196015829	196016020	LTR/ERVL-MaLR	455	+	96	196015925	95603
chr3	127560407	127760407	harbor1	chr3	127569942	127570343	LTR/ERVL-MaLR	1888	+	200	127570142	9735
chr3	127560407	127760407	harbor1	chr3	127577719	127577920	LTR/ERVL-MaLR	471	+	100	127577819	17412
chr3	127560407	127760407	harbor1	chr3	127579393	127579729	LTR/ERVL-MaLR	856	+	168	127579561	19154
chr3	127560407	127760407	harbor1	chr3	127584551	127584714	LTR/ERVL-MaLR	525	+	82	127584633	24226
chr3	127560407	127760407	harbor1	chr3	127584890	127585096	LTR/ERVL-MaLR	528	+	103	127584993	24586
chr3	127560407	127760407	harbor1	chr3	127586917	127587479	LTR/ERVL-MaLR	923	+	281	127587198	26791
chr3	127560407	127760407	harbor1	chr3	127595618	127596083	LTR/ERVL-MaLR	1603	+	232	127595850	35443
chr3	127560407	127760407	harbor1	chr3	127596379	127596413	LTR/ERVL-MaLR	1603	+	17	127596396	35989
chr3	178972096	179172096	harbor1	chr3	178974189	178974541	LTR/ERVL-MaLR	2290	+	176	178974365	2269
chr4	582955	782955	harbor1	chr4	610345	610857	LTR/ERVL-MaLR	1151	+	256	610601	27646
chr4	582955	782955	harbor1	chr4	615274	615651	LTR/ERVL-MaLR	1441	+	188	615462	32507
chr4	38767776	38967776	harbor1	chr4	38793722	38794164	LTR/ERVL-MaLR	1796	+	221	38793943	26167
chr4	38767776	38967776	harbor1	chr4	38799108	38799569	LTR/ERVL-MaLR	1103	+	230	38799338	31562
chr4	38767776	38967776	harbor1	chr4	38801111	38801464	LTR/ERVL-MaLR	1564	+	176	38801287	33511
chr4	38767776	38967776	harbor1	chr4	38812569	38812919	LTR/ERVL-MaLR	1581	+	175	38812744	44968
chr4	38767776	38967776	harbor1	chr4	38820104	38820352	LTR/ERVL-MaLR	498	+	124	38820228	52452
chr4	38767776	38967776	harbor1	chr4	38820603	38820823	LTR/ERVL-MaLR	1234	+	110	38820713	52937
chr4	38767776	38967776	harbor1	chr4	38821656	38821888	LTR/ERVL-MaLR	1159	+	116	38821772	53996
chr4	38767776	38967776	harbor1	chr4	38845300	38845801	LTR/ERVL-MaLR	2216	+	250	38845550	77774
chr4	38767776	38967776	harbor1	chr4	38859315	38859455	LTR/ERVL-MaLR	704	+	70	38859385	91609
chr4	98039583	98239583	harbor1	chr4	98051344	98051713	LTR/ERVL-MaLR	772	+	184	98051528	11945
chr4	98039583	98239583	harbor1	chr4	98056661	98057052	LTR/ERVL-MaLR	1983	+	196	98056857	17274
chr4	98039583	98239583	harbor1	chr4	98127960	98128323	LTR/ERVL-MaLR	894	+	182	98128142	88559
chr4	102218940	102418940	harbor1	chr4	102260258	102260685	LTR/ERVL-MaLR	615	+	214	102260472	41532
chr4	102218940	102418940	harbor1	chr4	102316743	102317114	LTR/ERVL-MaLR	1695	+	186	102316929	97989
chr4	551186	751186	harbor1	chr4	561732	562114	LTR/ERVL-MaLR	835	+	191	561923	10737
chr4	551186	751186	harbor1	chr4	610345	610857	LTR/ERVL-MaLR	1151	+	256	610601	59415
chr4	551186	751186	harbor1	chr4	615274	615651	LTR/ERVL-MaLR	1441	+	188	615462	64276
chr4	3569607	3769607	harbor1	chr4	3570462	3570889	LTR/ERVL-MaLR	1701	+	214	3570676	1069
chr4	3569607	3769607	harbor1	chr4	3621239	3621282	LTR/ERVL-MaLR	612	+	22	3621261	51654
chr4	3569607	3769607	harbor1	chr4	3621557	3621661	LTR/ERVL-MaLR	612	+	52	3621609	52002
chr4	3569607	3769607	harbor1	chr4	3632606	3633025	LTR/ERVL-MaLR	981	+	210	3632816	63209
chr4	3569607	3769607	harbor1	chr4	3643872	3644247	LTR/ERVL-MaLR	571	+	188	3644060	74453
chr4	3569607	3769607	harbor1	chr4	3647008	3647344	LTR/ERVL-MaLR	1184	+	168	3647176	77569
chr4	3569607	3769607	harbor1	chr4	3667075	3667568	LTR/ERVL-MaLR	1181	+	246	3667321	97714
chr4	38573151	38773151	harbor1	chr4	38576966	38577363	LTR/ERVL-MaLR	1658	+	198	38577164	4013
chr4	38573151	38773151	harbor1	chr4	38579662	38579951	LTR/ERVL-MaLR	557	+	144	38579806	6655
chr4	38573151	38773151	harbor1	chr4	38582621	38583007	LTR/ERVL-MaLR	738	+	193	38582814	9663
chr4	38573151	38773151	harbor1	chr4	38583017	38583537	LTR/ERVL-MaLR	1620	+	260	38583277	10126
chr4	38573151	38773151	harbor1	chr4	38588685	38588799	LTR/ERVL-MaLR	600	+	57	38588742	15591
chr4	38573151	38773151	harbor1	chr4	38588976	38589392	LTR/ERVL-MaLR	1527	+	208	38589184	16033
chr4	38573151	38773151	harbor1	chr4	38617277	38617636	LTR/ERVL-MaLR	2134	+	180	38617457	44306
chr4	38573151	38773151	harbor1	chr4	38617693	38617756	LTR/ERVL-MaLR	2134	+	32	38617725	44574
chr4	38573151	38773151	harbor1	chr4	38646476	38646807	LTR/ERVL-MaLR	1568	+	166	38646642	73491
chr4	158571219	158771219	harbor1	chr4	158575441	158575791	LTR/ERVL-MaLR	1534	+	175	158575616	4397
chr4	158571219	158771219	harbor1	chr4	158578935	158579260	LTR/ERVL-MaLR	1379	+	162	158579097	7878
chr4	158571219	158771219	harbor1	chr4	158579564	158579630	LTR/ERVL-MaLR	1379	+	33	158579597	8378
chr4	158571219	158771219	harbor1	chr4	158623631	158624078	LTR/ERVL-MaLR	641	+	224	158623855	52636
chr4	158571219	158771219	harbor1	chr4	158639434	158639590	LTR/ERVL-MaLR	1863	+	78	158639512	68293
chr4	158571219	158771219	harbor1	chr4	158639885	158640097	LTR/ERVL-MaLR	1863	+	106	158639991	68772
chr4	176095649	176295649	harbor1	chr4	176126679	176127059	LTR/ERVL-MaLR	2234	+	190	176126869	31220
chr4	55288238	55488238	harbor1	chr4	55305428	55305920	LTR/ERVL-MaLR	624	+	246	55305674	17436
chr4	55288238	55488238	harbor1	chr4	55306823	55306974	LTR/ERVL-MaLR	510	+	76	55306899	18661
chr4	55288238	55488238	harbor1	chr4	55306975	55307375	LTR/ERVL-MaLR	2102	+	200	55307175	18937
chr4	55288238	55488238	harbor1	chr4	55307376	55307410	LTR/ERVL-MaLR	510	+	17	55307393	19155
chr4	55288238	55488238	harbor1	chr4	55307708	55307906	LTR/ERVL-MaLR	510	+	99	55307807	19569
chr4	55288238	55488238	harbor1	chr4	55311956	55312359	LTR/ERVL-MaLR	767	+	202	55312158	23920
chr4	55288238	55488238	harbor1	chr4	55312823	55312916	LTR/ERVL-MaLR	767	+	46	55312869	24631
chr4	55288238	55488238	harbor1	chr4	55313284	55313646	LTR/ERVL-MaLR	2082	+	181	55313465	25227
chr4	55288238	55488238	harbor1	chr4	55386126	55386583	LTR/ERVL-MaLR	1022	+	228	55386354	98116
chr4	55288238	55488238	harbor1	chr4	55312360	55312822	LTR/ERVL-MaLR	963	+	231	55312591	24353
chr4	910896	1110896	harbor1	chr4	922039	922232	LTR/ERVL-MaLR	1141	+	96	922135	11239
chr4	910896	1110896	harbor1	chr4	922535	922692	LTR/ERVL-MaLR	1141	+	78	922613	11717
chr4	910896	1110896	harbor1	chr4	924597	924732	LTR/ERVL-MaLR	607	+	68	924665	13769
chr4	910896	1110896	harbor1	chr4	925562	925889	LTR/ERVL-MaLR	1338	+	164	925726	14830
chr4	910896	1110896	harbor1	chr4	976872	977217	LTR/ERVL-MaLR	1096	+	172	977044	66148
chr4	120822742	121022742	harbor1	chr4	120823775	120824178	LTR/ERVL-MaLR	2113	+	202	120823977	1235
chr4	120822742	121022742	harbor1	chr4	120830259	120830536	LTR/ERVL-MaLR	629	+	138	120830397	7655
chr4	120822742	121022742	harbor1	chr4	120834218	120834582	LTR/ERVL-MaLR	2040	+	182	120834400	11658
chr4	120822742	121022742	harbor1	chr4	120835432	120835760	LTR/ERVL-MaLR	1829	+	164	120835596	12854
chr4	120822742	121022742	harbor1	chr4	120847153	120847701	LTR/ERVL-MaLR	1370	+	274	120847427	24685
chr4	120822742	121022742	harbor1	chr4	120866750	120867266	LTR/ERVL-MaLR	1497	+	258	120867008	44266
chr4	120822742	121022742	harbor1	chr4	120903609	120903907	LTR/ERVL-MaLR	2133	+	149	120903758	81016
chr4	120822742	121022742	harbor1	chr4	120904214	120904282	LTR/ERVL-MaLR	2133	+	34	120904248	81506
chr4	2361876	2561876	harbor1	chr4	2369494	2369833	LTR/ERVL-MaLR	1037	+	170	2369664	7788
chr4	2361876	2561876	harbor1	chr4	2370148	2370201	LTR/ERVL-MaLR	1037	+	26	2370174	8298
chr4	2361876	2561876	harbor1	chr4	2380576	2380925	LTR/ERVL-MaLR	2531	+	174	2380750	18874
chr4	2361876	2561876	harbor1	chr4	2380926	2381401	LTR/ERVL-MaLR	10807	+	238	2381164	19288
chr4	2361876	2561876	harbor1	chr4	2381706	2382747	LTR/ERVL-MaLR	10807	+	520	2382226	20350
chr4	2361876	2561876	harbor1	chr4	2383174	2383530	LTR/ERVL-MaLR	2404	+	178	2383352	21476
chr4	2361876	2561876	harbor1	chr4	2386128	2386202	LTR/ERVL-MaLR	1515	+	37	2386165	24289
chr4	2361876	2561876	harbor1	chr4	2386497	2386812	LTR/ERVL-MaLR	1515	+	158	2386655	24779
chr4	2361876	2561876	harbor1	chr4	2389973	2390403	LTR/ERVL-MaLR	1183	+	215	2390188	28312
chr4	189957450	190157450	harbor1	chr4	189986586	189986748	LTR/ERVL-MaLR	2548	+	81	189986667	29217
chr4	189957450	190157450	harbor1	chr4	189987028	189987236	LTR/ERVL-MaLR	2548	+	104	189987132	29682
chr4	8023966	8223966	harbor1	chr4	8043405	8043734	LTR/ERVL-MaLR	1428	+	164	8043569	19603
chr4	8023966	8223966	harbor1	chr4	8046685	8047016	LTR/ERVL-MaLR	1309	+	166	8046851	22885
chr4	8023966	8223966	harbor1	chr4	8053650	8053987	LTR/ERVL-MaLR	1125	+	168	8053818	29852
chr4	8023966	8223966	harbor1	chr4	8063724	8063747	LTR/ERVL-MaLR	1368	+	12	8063736	39770
chr4	8023966	8223966	harbor1	chr4	8064255	8064615	LTR/ERVL-MaLR	1368	+	180	8064435	40469
chr4	8023966	8223966	harbor1	chr4	8102822	8103272	LTR/ERVL-MaLR	634	+	225	8103047	79081
chr4	8023966	8223966	harbor1	chr4	8107678	8108156	LTR/ERVL-MaLR	1930	+	239	8107917	83951
chr4	8023966	8223966	harbor1	chr4	8115647	8116236	LTR/ERVL-MaLR	1484	+	294	8115941	91975
chr4	8023966	8223966	harbor1	chr4	8120234	8120679	LTR/ERVL-MaLR	858	+	222	8120456	96490
chr4	120821303	121021303	harbor1	chr4	120823775	120824178	LTR/ERVL-MaLR	2113	+	202	120823977	2674
chr4	120821303	121021303	harbor1	chr4	120830259	120830536	LTR/ERVL-MaLR	629	+	138	120830397	9094
chr4	120821303	121021303	harbor1	chr4	120834218	120834582	LTR/ERVL-MaLR	2040	+	182	120834400	13097
chr4	120821303	121021303	harbor1	chr4	120835432	120835760	LTR/ERVL-MaLR	1829	+	164	120835596	14293
chr4	120821303	121021303	harbor1	chr4	120847153	120847701	LTR/ERVL-MaLR	1370	+	274	120847427	26124
chr4	120821303	121021303	harbor1	chr4	120866750	120867266	LTR/ERVL-MaLR	1497	+	258	120867008	45705
chr4	120821303	121021303	harbor1	chr4	120903609	120903907	LTR/ERVL-MaLR	2133	+	149	120903758	82455
chr4	120821303	121021303	harbor1	chr4	120904214	120904282	LTR/ERVL-MaLR	2133	+	34	120904248	82945
chr4	120822671	121022671	harbor1	chr4	120823775	120824178	LTR/ERVL-MaLR	2113	+	202	120823977	1306
chr4	120822671	121022671	harbor1	chr4	120830259	120830536	LTR/ERVL-MaLR	629	+	138	120830397	7726
chr4	120822671	121022671	harbor1	chr4	120834218	120834582	LTR/ERVL-MaLR	2040	+	182	120834400	11729
chr4	120822671	121022671	harbor1	chr4	120835432	120835760	LTR/ERVL-MaLR	1829	+	164	120835596	12925
chr4	120822671	121022671	harbor1	chr4	120847153	120847701	LTR/ERVL-MaLR	1370	+	274	120847427	24756
chr4	120822671	121022671	harbor1	chr4	120866750	120867266	LTR/ERVL-MaLR	1497	+	258	120867008	44337
chr4	120822671	121022671	harbor1	chr4	120903609	120903907	LTR/ERVL-MaLR	2133	+	149	120903758	81087
chr4	120822671	121022671	harbor1	chr4	120904214	120904282	LTR/ERVL-MaLR	2133	+	34	120904248	81577
chr4	2317159	2517159	harbor1	chr4	2358699	2358809	LTR/ERVL-MaLR	1493	+	55	2358754	41595
chr4	2317159	2517159	harbor1	chr4	2359426	2359719	LTR/ERVL-MaLR	1493	+	146	2359572	42413
chr4	2317159	2517159	harbor1	chr4	2369494	2369833	LTR/ERVL-MaLR	1037	+	170	2369664	52505
chr4	2317159	2517159	harbor1	chr4	2370148	2370201	LTR/ERVL-MaLR	1037	+	26	2370174	53015
chr4	2317159	2517159	harbor1	chr4	2380576	2380925	LTR/ERVL-MaLR	2531	+	174	2380750	63591
chr4	2317159	2517159	harbor1	chr4	2380926	2381401	LTR/ERVL-MaLR	10807	+	238	2381164	64005
chr4	2317159	2517159	harbor1	chr4	2381706	2382747	LTR/ERVL-MaLR	10807	+	520	2382226	65067
chr4	2317159	2517159	harbor1	chr4	2383174	2383530	LTR/ERVL-MaLR	2404	+	178	2383352	66193
chr4	2317159	2517159	harbor1	chr4	2386128	2386202	LTR/ERVL-MaLR	1515	+	37	2386165	69006
chr4	2317159	2517159	harbor1	chr4	2386497	2386812	LTR/ERVL-MaLR	1515	+	158	2386655	69496
chr4	2317159	2517159	harbor1	chr4	2389973	2390403	LTR/ERVL-MaLR	1183	+	215	2390188	73029
chr4	11269110	11469110	harbor1	chr4	11291201	11291560	LTR/ERVL-MaLR	1256	+	180	11291381	22271
chr4	11269110	11469110	harbor1	chr4	11299279	11299647	LTR/ERVL-MaLR	2159	+	184	11299463	30353
chr4	11269110	11469110	harbor1	chr4	11302269	11302730	LTR/ERVL-MaLR	979	+	230	11302499	33389
chr4	11269110	11469110	harbor1	chr4	11308082	11308388	LTR/ERVL-MaLR	1852	+	153	11308235	39125
chr4	11269110	11469110	harbor1	chr4	11308650	11308671	LTR/ERVL-MaLR	1852	+	10	11308660	39550
chr4	11269110	11469110	harbor1	chr4	11308716	11308784	LTR/ERVL-MaLR	1852	+	34	11308750	39640
chr4	11269110	11469110	harbor1	chr4	11317581	11317861	LTR/ERVL-MaLR	1662	+	140	11317721	48611
chr4	11269110	11469110	harbor1	chr4	11318167	11318582	LTR/ERVL-MaLR	3020	+	208	11318375	49265
chr4	11269110	11469110	harbor1	chr4	11320008	11320085	LTR/ERVL-MaLR	484	+	38	11320046	50936
chr4	11269110	11469110	harbor1	chr4	11322908	11323309	LTR/ERVL-MaLR	2077	+	200	11323108	53998
chr4	11269110	11469110	harbor1	chr4	11323310	11324846	LTR/ERVL-MaLR	8417	+	768	11324078	54968
chr4	11269110	11469110	harbor1	chr4	11324847	11325244	LTR/ERVL-MaLR	1723	+	198	11325045	55935
chr4	11269110	11469110	harbor1	chr4	11328327	11328763	LTR/ERVL-MaLR	1062	+	218	11328545	59435
chr4	11269110	11469110	harbor1	chr4	11329036	11329170	LTR/ERVL-MaLR	545	+	67	11329103	59993
chr4	11269110	11469110	harbor1	chr4	11347284	11347665	LTR/ERVL-MaLR	1626	+	190	11347474	78364
chr4	11269110	11469110	harbor1	chr4	11357176	11357531	LTR/ERVL-MaLR	2162	+	178	11357354	88244
chr4	910971	1110971	harbor1	chr4	922039	922232	LTR/ERVL-MaLR	1141	+	96	922135	11164
chr4	910971	1110971	harbor1	chr4	922535	922692	LTR/ERVL-MaLR	1141	+	78	922613	11642
chr4	910971	1110971	harbor1	chr4	924597	924732	LTR/ERVL-MaLR	607	+	68	924665	13694
chr4	910971	1110971	harbor1	chr4	925562	925889	LTR/ERVL-MaLR	1338	+	164	925726	14755
chr4	910971	1110971	harbor1	chr4	976872	977217	LTR/ERVL-MaLR	1096	+	172	977044	66073
chr4	102919713	103119713	harbor1	chr4	102955075	102955414	LTR/ERVL-MaLR	2432	+	170	102955245	35532
chr4	102919713	103119713	harbor1	chr4	102958079	102958475	LTR/ERVL-MaLR	2421	+	198	102958277	38564
chr4	88671609	88871609	harbor1	chr4	88711097	88711448	LTR/ERVL-MaLR	2027	+	176	88711273	39664
chr4	98160943	98360943	harbor1	chr4	98180674	98181014	LTR/ERVL-MaLR	1215	+	170	98180844	19901
chr4	98160943	98360943	harbor1	chr4	98199100	98199311	LTR/ERVL-MaLR	495	+	106	98199206	38263
chr4	98160943	98360943	harbor1	chr4	98199534	98199717	LTR/ERVL-MaLR	521	+	92	98199626	38683
chr4	98160943	98360943	harbor1	chr4	98224273	98224715	LTR/ERVL-MaLR	2066	+	221	98224494	63551
chr4	98160943	98360943	harbor1	chr4	98225170	98225187	LTR/ERVL-MaLR	2066	+	8	98225178	64235
chr4	98160943	98360943	harbor1	chr4	98248480	98249019	LTR/ERVL-MaLR	1139	+	270	98248750	87807
chr4	98160943	98360943	harbor1	chr4	98252308	98252801	LTR/ERVL-MaLR	2402	+	246	98252554	91611
chr4	98160943	98360943	harbor1	chr4	98259436	98259831	LTR/ERVL-MaLR	1162	+	198	98259634	98691
chr4	98160943	98360943	harbor1	chr4	98238330	98238836	LTR/ERVL-MaLR	1242	+	253	98238583	77640
chr4	187835400	188035400	harbor1	chr4	187840802	187841002	LTR/ERVL-MaLR	478	+	100	187840902	5502
chr4	187835400	188035400	harbor1	chr4	187855246	187855723	LTR/ERVL-MaLR	1874	+	238	187855484	20084
chr4	187835400	188035400	harbor1	chr4	187871300	187871688	LTR/ERVL-MaLR	2117	+	194	187871494	36094
chr4	187835400	188035400	harbor1	chr4	187931993	187932441	LTR/ERVL-MaLR	1826	+	224	187932217	96817
chr4	866474	1066474	harbor1	chr4	922039	922232	LTR/ERVL-MaLR	1141	+	96	922135	55661
chr4	866474	1066474	harbor1	chr4	922535	922692	LTR/ERVL-MaLR	1141	+	78	922613	56139
chr4	866474	1066474	harbor1	chr4	924597	924732	LTR/ERVL-MaLR	607	+	68	924665	58191
chr4	866474	1066474	harbor1	chr4	925562	925889	LTR/ERVL-MaLR	1338	+	164	925726	59252
chr4	2363070	2563070	harbor1	chr4	2369494	2369833	LTR/ERVL-MaLR	1037	+	170	2369664	6594
chr4	2363070	2563070	harbor1	chr4	2370148	2370201	LTR/ERVL-MaLR	1037	+	26	2370174	7104
chr4	2363070	2563070	harbor1	chr4	2380576	2380925	LTR/ERVL-MaLR	2531	+	174	2380750	17680
chr4	2363070	2563070	harbor1	chr4	2380926	2381401	LTR/ERVL-MaLR	10807	+	238	2381164	18094
chr4	2363070	2563070	harbor1	chr4	2381706	2382747	LTR/ERVL-MaLR	10807	+	520	2382226	19156
chr4	2363070	2563070	harbor1	chr4	2383174	2383530	LTR/ERVL-MaLR	2404	+	178	2383352	20282
chr4	2363070	2563070	harbor1	chr4	2386128	2386202	LTR/ERVL-MaLR	1515	+	37	2386165	23095
chr4	2363070	2563070	harbor1	chr4	2386497	2386812	LTR/ERVL-MaLR	1515	+	158	2386655	23585
chr4	2363070	2563070	harbor1	chr4	2389973	2390403	LTR/ERVL-MaLR	1183	+	215	2390188	27118
chr4	2151076	2351076	harbor1	chr4	2182184	2182633	LTR/ERVL-MaLR	1697	+	224	2182408	31332
chr4	2151076	2351076	harbor1	chr4	2226997	2227516	LTR/ERVL-MaLR	1184	+	260	2227257	76181
chr4	2363106	2563106	harbor1	chr4	2369494	2369833	LTR/ERVL-MaLR	1037	+	170	2369664	6558
chr4	2363106	2563106	harbor1	chr4	2370148	2370201	LTR/ERVL-MaLR	1037	+	26	2370174	7068
chr4	2363106	2563106	harbor1	chr4	2380576	2380925	LTR/ERVL-MaLR	2531	+	174	2380750	17644
chr4	2363106	2563106	harbor1	chr4	2380926	2381401	LTR/ERVL-MaLR	10807	+	238	2381164	18058
chr4	2363106	2563106	harbor1	chr4	2381706	2382747	LTR/ERVL-MaLR	10807	+	520	2382226	19120
chr4	2363106	2563106	harbor1	chr4	2383174	2383530	LTR/ERVL-MaLR	2404	+	178	2383352	20246
chr4	2363106	2563106	harbor1	chr4	2386128	2386202	LTR/ERVL-MaLR	1515	+	37	2386165	23059
chr4	2363106	2563106	harbor1	chr4	2386497	2386812	LTR/ERVL-MaLR	1515	+	158	2386655	23549
chr4	2363106	2563106	harbor1	chr4	2389973	2390403	LTR/ERVL-MaLR	1183	+	215	2390188	27082
chr4	73128036	73328036	harbor1	chr4	73156443	73156872	LTR/ERVL-MaLR	2038	+	214	73156657	28621
chr4	73128036	73328036	harbor1	chr4	73158583	73159004	LTR/ERVL-MaLR	2478	+	210	73158793	30757
chr4	73128036	73328036	harbor1	chr4	73161650	73161839	LTR/ERVL-MaLR	556	+	94	73161744	33708
chr4	73128036	73328036	harbor1	chr4	73165571	73166119	LTR/ERVL-MaLR	1500	+	274	73165845	37809
chr4	15581887	15781887	harbor1	chr4	15658348	15658759	LTR/ERVL-MaLR	2843	+	206	15658554	76667
chr4	3569499	3769499	harbor1	chr4	3570462	3570889	LTR/ERVL-MaLR	1701	+	214	3570676	1177
chr4	3569499	3769499	harbor1	chr4	3621239	3621282	LTR/ERVL-MaLR	612	+	22	3621261	51762
chr4	3569499	3769499	harbor1	chr4	3621557	3621661	LTR/ERVL-MaLR	612	+	52	3621609	52110
chr4	3569499	3769499	harbor1	chr4	3632606	3633025	LTR/ERVL-MaLR	981	+	210	3632816	63317
chr4	3569499	3769499	harbor1	chr4	3643872	3644247	LTR/ERVL-MaLR	571	+	188	3644060	74561
chr4	3569499	3769499	harbor1	chr4	3647008	3647344	LTR/ERVL-MaLR	1184	+	168	3647176	77677
chr4	3569499	3769499	harbor1	chr4	3667075	3667568	LTR/ERVL-MaLR	1181	+	246	3667321	97822
chr4	144468351	144668351	harbor1	chr4	144503594	144503995	LTR/ERVL-MaLR	924	+	200	144503794	35443
chr4	144468351	144668351	harbor1	chr4	144531939	144532373	LTR/ERVL-MaLR	2518	+	217	144532156	63805
chr4	144468351	144668351	harbor1	chr4	144549648	144549989	LTR/ERVL-MaLR	2031	+	170	144549818	81467
chr4	144468351	144668351	harbor1	chr4	144550212	144550476	LTR/ERVL-MaLR	2031	+	132	144550344	81993
chr4	144468351	144668351	harbor1	chr4	144567156	144567477	LTR/ERVL-MaLR	1691	+	160	144567316	98965
chr4	144468351	144668351	harbor1	chr4	144567478	144567841	LTR/ERVL-MaLR	2782	+	182	144567660	99309
chr4	144468351	144668351	harbor1	chr4	144567842	144567881	LTR/ERVL-MaLR	1691	+	20	144567862	99511
chr4	144468351	144668351	harbor1	chr4	144506527	144506980	LTR/ERVL-MaLR	1285	+	226	144506753	38402
chr4	866602	1066602	harbor1	chr4	922039	922232	LTR/ERVL-MaLR	1141	+	96	922135	55533
chr4	866602	1066602	harbor1	chr4	922535	922692	LTR/ERVL-MaLR	1141	+	78	922613	56011
chr4	866602	1066602	harbor1	chr4	924597	924732	LTR/ERVL-MaLR	607	+	68	924665	58063
chr4	866602	1066602	harbor1	chr4	925562	925889	LTR/ERVL-MaLR	1338	+	164	925726	59124
chr4	69927953	70127953	harbor1	chr4	69949703	69950039	LTR/ERVL-MaLR	1653	+	168	69949871	21918
chr4	120822652	121022652	harbor1	chr4	120823775	120824178	LTR/ERVL-MaLR	2113	+	202	120823977	1325
chr4	120822652	121022652	harbor1	chr4	120830259	120830536	LTR/ERVL-MaLR	629	+	138	120830397	7745
chr4	120822652	121022652	harbor1	chr4	120834218	120834582	LTR/ERVL-MaLR	2040	+	182	120834400	11748
chr4	120822652	121022652	harbor1	chr4	120835432	120835760	LTR/ERVL-MaLR	1829	+	164	120835596	12944
chr4	120822652	121022652	harbor1	chr4	120847153	120847701	LTR/ERVL-MaLR	1370	+	274	120847427	24775
chr4	120822652	121022652	harbor1	chr4	120866750	120867266	LTR/ERVL-MaLR	1497	+	258	120867008	44356
chr4	120822652	121022652	harbor1	chr4	120903609	120903907	LTR/ERVL-MaLR	2133	+	149	120903758	81106
chr4	120822652	121022652	harbor1	chr4	120904214	120904282	LTR/ERVL-MaLR	2133	+	34	120904248	81596
chr4	1349026	1549026	harbor1	chr4	1399539	1399937	LTR/ERVL-MaLR	902	+	199	1399738	50712
chr4	2656061	2856061	harbor1	chr4	2749335	2749769	LTR/ERVL-MaLR	1449	+	217	2749552	93491
chr4	866554	1066554	harbor1	chr4	922039	922232	LTR/ERVL-MaLR	1141	+	96	922135	55581
chr4	866554	1066554	harbor1	chr4	922535	922692	LTR/ERVL-MaLR	1141	+	78	922613	56059
chr4	866554	1066554	harbor1	chr4	924597	924732	LTR/ERVL-MaLR	607	+	68	924665	58111
chr4	866554	1066554	harbor1	chr4	925562	925889	LTR/ERVL-MaLR	1338	+	164	925726	59172
chr4	6810085	7010085	harbor1	chr4	6890313	6890710	LTR/ERVL-MaLR	2463	+	198	6890511	80426
chr4	6810085	7010085	harbor1	chr4	6896091	6896469	LTR/ERVL-MaLR	1996	+	189	6896280	86195
chr4	910985	1110985	harbor1	chr4	922039	922232	LTR/ERVL-MaLR	1141	+	96	922135	11150
chr4	910985	1110985	harbor1	chr4	922535	922692	LTR/ERVL-MaLR	1141	+	78	922613	11628
chr4	910985	1110985	harbor1	chr4	924597	924732	LTR/ERVL-MaLR	607	+	68	924665	13680
chr4	910985	1110985	harbor1	chr4	925562	925889	LTR/ERVL-MaLR	1338	+	164	925726	14741
chr4	910985	1110985	harbor1	chr4	976872	977217	LTR/ERVL-MaLR	1096	+	172	977044	66059
chr4	910965	1110965	harbor1	chr4	922039	922232	LTR/ERVL-MaLR	1141	+	96	922135	11170
chr4	910965	1110965	harbor1	chr4	922535	922692	LTR/ERVL-MaLR	1141	+	78	922613	11648
chr4	910965	1110965	harbor1	chr4	924597	924732	LTR/ERVL-MaLR	607	+	68	924665	13700
chr4	910965	1110965	harbor1	chr4	925562	925889	LTR/ERVL-MaLR	1338	+	164	925726	14761
chr4	910965	1110965	harbor1	chr4	976872	977217	LTR/ERVL-MaLR	1096	+	172	977044	66079
chr4	86404939	86604939	harbor1	chr4	86416017	86416381	LTR/ERVL-MaLR	1591	+	182	86416199	11260
chr4	86404939	86604939	harbor1	chr4	86447080	86447451	LTR/ERVL-MaLR	2136	+	186	86447266	42327
chr4	86404939	86604939	harbor1	chr4	86449794	86450166	LTR/ERVL-MaLR	1485	+	186	86449980	45041
chr4	86404939	86604939	harbor1	chr4	86485655	86486029	LTR/ERVL-MaLR	1489	+	187	86485842	80903
chr4	86404939	86604939	harbor1	chr4	86488893	86489297	LTR/ERVL-MaLR	553	+	202	86489095	84156
chr4	103098519	103298519	harbor1	chr4	103149557	103149972	LTR/ERVL-MaLR	1303	+	208	103149765	51246
chr4	1756089	1956089	harbor1	chr4	1790564	1790986	LTR/ERVL-MaLR	1038	+	211	1790775	34686
chr4	550827	750827	harbor1	chr4	561732	562114	LTR/ERVL-MaLR	835	+	191	561923	11096
chr4	550827	750827	harbor1	chr4	610345	610857	LTR/ERVL-MaLR	1151	+	256	610601	59774
chr4	550827	750827	harbor1	chr4	615274	615651	LTR/ERVL-MaLR	1441	+	188	615462	64635
chr4	8230062	8430062	harbor1	chr4	8245613	8246197	LTR/ERVL-MaLR	1317	+	292	8245905	15843
chr4	8230062	8430062	harbor1	chr4	8257989	8258338	LTR/ERVL-MaLR	2083	+	174	8258163	28101
chr4	8230062	8430062	harbor1	chr4	8309938	8310391	LTR/ERVL-MaLR	1160	+	226	8310164	80102
chr4	866530	1066530	harbor1	chr4	922039	922232	LTR/ERVL-MaLR	1141	+	96	922135	55605
chr4	866530	1066530	harbor1	chr4	922535	922692	LTR/ERVL-MaLR	1141	+	78	922613	56083
chr4	866530	1066530	harbor1	chr4	924597	924732	LTR/ERVL-MaLR	607	+	68	924665	58135
chr4	866530	1066530	harbor1	chr4	925562	925889	LTR/ERVL-MaLR	1338	+	164	925726	59196
chr4	910306	1110306	harbor1	chr4	922039	922232	LTR/ERVL-MaLR	1141	+	96	922135	11829
chr4	910306	1110306	harbor1	chr4	922535	922692	LTR/ERVL-MaLR	1141	+	78	922613	12307
chr4	910306	1110306	harbor1	chr4	924597	924732	LTR/ERVL-MaLR	607	+	68	924665	14359
chr4	910306	1110306	harbor1	chr4	925562	925889	LTR/ERVL-MaLR	1338	+	164	925726	15420
chr4	910306	1110306	harbor1	chr4	976872	977217	LTR/ERVL-MaLR	1096	+	172	977044	66738
chr4	98145495	98345495	harbor1	chr4	98152638	98153209	LTR/ERVL-MaLR	1801	+	286	98152924	7429
chr4	98145495	98345495	harbor1	chr4	98180674	98181014	LTR/ERVL-MaLR	1215	+	170	98180844	35349
chr4	98145495	98345495	harbor1	chr4	98199100	98199311	LTR/ERVL-MaLR	495	+	106	98199206	53711
chr4	98145495	98345495	harbor1	chr4	98199534	98199717	LTR/ERVL-MaLR	521	+	92	98199626	54131
chr4	98145495	98345495	harbor1	chr4	98224273	98224715	LTR/ERVL-MaLR	2066	+	221	98224494	78999
chr4	98145495	98345495	harbor1	chr4	98225170	98225187	LTR/ERVL-MaLR	2066	+	8	98225178	79683
chr4	98145495	98345495	harbor1	chr4	98156476	98156886	LTR/ERVL-MaLR	1945	+	205	98156681	11186
chr4	98145495	98345495	harbor1	chr4	98238330	98238836	LTR/ERVL-MaLR	1242	+	253	98238583	93088
chr4	872772	1072772	harbor1	chr4	922039	922232	LTR/ERVL-MaLR	1141	+	96	922135	49363
chr4	872772	1072772	harbor1	chr4	922535	922692	LTR/ERVL-MaLR	1141	+	78	922613	49841
chr4	872772	1072772	harbor1	chr4	924597	924732	LTR/ERVL-MaLR	607	+	68	924665	51893
chr4	872772	1072772	harbor1	chr4	925562	925889	LTR/ERVL-MaLR	1338	+	164	925726	52954
chr4	67487456	67687456	harbor1	chr4	67495919	67496437	LTR/ERVL-MaLR	873	+	259	67496178	8722
chr4	67487456	67687456	harbor1	chr4	67506202	67506756	LTR/ERVL-MaLR	1904	+	277	67506479	19023
chr4	67487456	67687456	harbor1	chr4	67512934	67513348	LTR/ERVL-MaLR	1399	+	207	67513141	25685
chr4	67487456	67687456	harbor1	chr4	67533080	67533429	LTR/ERVL-MaLR	2512	+	174	67533254	45798
chr4	67487456	67687456	harbor1	chr4	67567620	67567988	LTR/ERVL-MaLR	486	+	184	67567804	80348
chr4	866571	1066571	harbor1	chr4	922039	922232	LTR/ERVL-MaLR	1141	+	96	922135	55564
chr4	866571	1066571	harbor1	chr4	922535	922692	LTR/ERVL-MaLR	1141	+	78	922613	56042
chr4	866571	1066571	harbor1	chr4	924597	924732	LTR/ERVL-MaLR	607	+	68	924665	58094
chr4	866571	1066571	harbor1	chr4	925562	925889	LTR/ERVL-MaLR	1338	+	164	925726	59155
chr4	866652	1066652	harbor1	chr4	922039	922232	LTR/ERVL-MaLR	1141	+	96	922135	55483
chr4	866652	1066652	harbor1	chr4	922535	922692	LTR/ERVL-MaLR	1141	+	78	922613	55961
chr4	866652	1066652	harbor1	chr4	924597	924732	LTR/ERVL-MaLR	607	+	68	924665	58013
chr4	866652	1066652	harbor1	chr4	925562	925889	LTR/ERVL-MaLR	1338	+	164	925726	59074
chr4	76846562	77046562	harbor1	chr4	76849003	76849254	LTR/ERVL-MaLR	1185	+	126	76849129	2567
chr4	76846562	77046562	harbor1	chr4	76849408	76849551	LTR/ERVL-MaLR	716	+	72	76849480	2918
chr4	76846562	77046562	harbor1	chr4	76854502	76854920	LTR/ERVL-MaLR	2711	+	209	76854711	8149
chr4	76846562	77046562	harbor1	chr4	76879861	76880289	LTR/ERVL-MaLR	2036	+	214	76880075	33513
chr4	76846562	77046562	harbor1	chr4	76880584	76880648	LTR/ERVL-MaLR	2036	+	32	76880616	34054
chr4	76846562	77046562	harbor1	chr4	76883226	76883605	LTR/ERVL-MaLR	2228	+	190	76883416	36854
chr4	76846562	77046562	harbor1	chr4	76904208	76904569	LTR/ERVL-MaLR	2030	+	180	76904388	57826
chr4	76846562	77046562	harbor1	chr4	76904756	76905174	LTR/ERVL-MaLR	2524	+	209	76904965	58403
chr4	76846562	77046562	harbor1	chr4	76913366	76913808	LTR/ERVL-MaLR	1582	+	221	76913587	67025
chr4	76846562	77046562	harbor1	chr4	76934016	76934345	LTR/ERVL-MaLR	1293	+	164	76934180	87618
chr4	76846562	77046562	harbor1	chr4	76936300	76936840	LTR/ERVL-MaLR	2424	+	270	76936570	90008
chr4	76846562	77046562	harbor1	chr4	76940449	76940888	LTR/ERVL-MaLR	1704	+	220	76940669	94107
chr4	76846562	77046562	harbor1	chr4	76942537	76942791	LTR/ERVL-MaLR	475	+	127	76942664	96102
chr4	2314181	2514181	harbor1	chr4	2358699	2358809	LTR/ERVL-MaLR	1493	+	55	2358754	44573
chr4	2314181	2514181	harbor1	chr4	2359426	2359719	LTR/ERVL-MaLR	1493	+	146	2359572	45391
chr4	2314181	2514181	harbor1	chr4	2369494	2369833	LTR/ERVL-MaLR	1037	+	170	2369664	55483
chr4	2314181	2514181	harbor1	chr4	2370148	2370201	LTR/ERVL-MaLR	1037	+	26	2370174	55993
chr4	2314181	2514181	harbor1	chr4	2380576	2380925	LTR/ERVL-MaLR	2531	+	174	2380750	66569
chr4	2314181	2514181	harbor1	chr4	2380926	2381401	LTR/ERVL-MaLR	10807	+	238	2381164	66983
chr4	2314181	2514181	harbor1	chr4	2381706	2382747	LTR/ERVL-MaLR	10807	+	520	2382226	68045
chr4	2314181	2514181	harbor1	chr4	2383174	2383530	LTR/ERVL-MaLR	2404	+	178	2383352	69171
chr4	2314181	2514181	harbor1	chr4	2386128	2386202	LTR/ERVL-MaLR	1515	+	37	2386165	71984
chr4	2314181	2514181	harbor1	chr4	2386497	2386812	LTR/ERVL-MaLR	1515	+	158	2386655	72474
chr4	2314181	2514181	harbor1	chr4	2389973	2390403	LTR/ERVL-MaLR	1183	+	215	2390188	76007
chr4	189957491	190157491	harbor1	chr4	189986586	189986748	LTR/ERVL-MaLR	2548	+	81	189986667	29176
chr4	189957491	190157491	harbor1	chr4	189987028	189987236	LTR/ERVL-MaLR	2548	+	104	189987132	29641
chr4	55295888	55495888	harbor1	chr4	55305428	55305920	LTR/ERVL-MaLR	624	+	246	55305674	9786
chr4	55295888	55495888	harbor1	chr4	55306823	55306974	LTR/ERVL-MaLR	510	+	76	55306899	11011
chr4	55295888	55495888	harbor1	chr4	55306975	55307375	LTR/ERVL-MaLR	2102	+	200	55307175	11287
chr4	55295888	55495888	harbor1	chr4	55307376	55307410	LTR/ERVL-MaLR	510	+	17	55307393	11505
chr4	55295888	55495888	harbor1	chr4	55307708	55307906	LTR/ERVL-MaLR	510	+	99	55307807	11919
chr4	55295888	55495888	harbor1	chr4	55311956	55312359	LTR/ERVL-MaLR	767	+	202	55312158	16270
chr4	55295888	55495888	harbor1	chr4	55312823	55312916	LTR/ERVL-MaLR	767	+	46	55312869	16981
chr4	55295888	55495888	harbor1	chr4	55313284	55313646	LTR/ERVL-MaLR	2082	+	181	55313465	17577
chr4	55295888	55495888	harbor1	chr4	55386126	55386583	LTR/ERVL-MaLR	1022	+	228	55386354	90466
chr4	55295888	55495888	harbor1	chr4	55312360	55312822	LTR/ERVL-MaLR	963	+	231	55312591	16703
chr4	189956178	190156178	harbor1	chr4	189986586	189986748	LTR/ERVL-MaLR	2548	+	81	189986667	30489
chr4	189956178	190156178	harbor1	chr4	189987028	189987236	LTR/ERVL-MaLR	2548	+	104	189987132	30954
chr5	113414289	113614289	harbor1	chr5	113429116	113429491	LTR/ERVL-MaLR	1199	+	188	113429304	15015
chr5	113414289	113614289	harbor1	chr5	113452306	113452667	LTR/ERVL-MaLR	2163	+	180	113452486	38197
chr5	113414289	113614289	harbor1	chr5	113489583	113490068	LTR/ERVL-MaLR	1067	+	242	113489825	75536
chr5	113414289	113614289	harbor1	chr5	113490209	113490483	LTR/ERVL-MaLR	1687	+	137	113490346	76057
chr5	113414289	113614289	harbor1	chr5	113490486	113491838	LTR/ERVL-MaLR	5354	+	676	113491162	76873
chr5	113414289	113614289	harbor1	chr5	113492147	113492445	LTR/ERVL-MaLR	5354	+	149	113492296	78007
chr5	113414289	113614289	harbor1	chr5	113492446	113492835	LTR/ERVL-MaLR	2091	+	194	113492640	78351
chr5	113414289	113614289	harbor1	chr5	113508523	113508913	LTR/ERVL-MaLR	1204	+	195	113508718	94429
chr5	75136982	75336982	harbor1	chr5	75140497	75140986	LTR/ERVL-MaLR	1372	+	244	75140741	3759
chr5	75136982	75336982	harbor1	chr5	75151309	75151672	LTR/ERVL-MaLR	2511	+	182	75151491	14509
chr5	75136982	75336982	harbor1	chr5	75152917	75153390	LTR/ERVL-MaLR	1954	+	236	75153153	16171
chr5	75136982	75336982	harbor1	chr5	75156468	75156962	LTR/ERVL-MaLR	1469	+	247	75156715	19733
chr5	75136982	75336982	harbor1	chr5	75156963	75157840	LTR/ERVL-MaLR	3225	+	438	75157401	20419
chr5	75136982	75336982	harbor1	chr5	75160671	75161036	LTR/ERVL-MaLR	1865	+	182	75160853	23871
chr5	75136982	75336982	harbor1	chr5	75161037	75162622	LTR/ERVL-MaLR	12263	+	792	75161829	24847
chr5	75136982	75336982	harbor1	chr5	75162625	75162756	LTR/ERVL-MaLR	875	+	66	75162691	25709
chr5	75136982	75336982	harbor1	chr5	75163891	75164410	LTR/ERVL-MaLR	2489	+	260	75164151	27169
chr5	75136982	75336982	harbor1	chr5	75223677	75224081	LTR/ERVL-MaLR	1666	+	202	75223879	86897
chr5	159190926	159390926	harbor1	chr5	159214733	159215153	LTR/ERVL-MaLR	675	+	210	159214943	24017
chr5	159190926	159390926	harbor1	chr5	159220363	159220698	LTR/ERVL-MaLR	1620	+	168	159220531	29605
chr5	159190926	159390926	harbor1	chr5	159255043	159255417	LTR/ERVL-MaLR	2384	+	187	159255230	64304
chr5	159190926	159390926	harbor1	chr5	159260217	159260580	LTR/ERVL-MaLR	2083	+	182	159260399	69473
chr5	159190926	159390926	harbor1	chr5	159265522	159265848	LTR/ERVL-MaLR	2114	+	163	159265685	74759
chr5	159190926	159390926	harbor1	chr5	159265984	159266020	LTR/ERVL-MaLR	2114	+	18	159266002	75076
chr5	159190926	159390926	harbor1	chr5	159266022	159267600	LTR/ERVL-MaLR	12124	+	789	159266811	75885
chr5	159190926	159390926	harbor1	chr5	159267601	159267956	LTR/ERVL-MaLR	2512	+	178	159267779	76853
chr5	159190926	159390926	harbor1	chr5	159219702	159220047	LTR/ERVL-MaLR	2587	+	172	159219874	28948
chr5	73350908	73550908	harbor1	chr5	73385130	73385611	LTR/ERVL-MaLR	1527	+	240	73385370	34462
chr5	73350908	73550908	harbor1	chr5	73386037	73386532	LTR/ERVL-MaLR	2454	+	248	73386285	35377
chr5	135435228	135635228	harbor1	chr5	135517497	135517914	LTR/ERVL-MaLR	1236	+	208	135517705	82477
chr5	135435228	135635228	harbor1	chr5	135527510	135527943	LTR/ERVL-MaLR	2641	+	216	135527726	92498
chr5	135435228	135635228	harbor1	chr5	135529627	135529965	LTR/ERVL-MaLR	1835	+	169	135529796	94568
chr5	150964868	151164868	harbor1	chr5	150979884	150980284	LTR/ERVL-MaLR	1874	+	200	150980084	15216
chr5	150964868	151164868	harbor1	chr5	150981239	150981379	LTR/ERVL-MaLR	807	+	70	150981309	16441
chr5	150964868	151164868	harbor1	chr5	150981692	150982063	LTR/ERVL-MaLR	807	+	186	150981878	17010
chr5	150964868	151164868	harbor1	chr5	151014088	151014132	LTR/ERVL-MaLR	1558	+	22	151014110	49242
chr5	150964868	151164868	harbor1	chr5	151014421	151014736	LTR/ERVL-MaLR	1558	+	158	151014579	49711
chr5	73350879	73550879	harbor1	chr5	73385130	73385611	LTR/ERVL-MaLR	1527	+	240	73385370	34491
chr5	73350879	73550879	harbor1	chr5	73386037	73386532	LTR/ERVL-MaLR	2454	+	248	73386285	35406
chr5	73351482	73551482	harbor1	chr5	73385130	73385611	LTR/ERVL-MaLR	1527	+	240	73385370	33888
chr5	73351482	73551482	harbor1	chr5	73386037	73386532	LTR/ERVL-MaLR	2454	+	248	73386285	34803
chr5	6723084	6923084	harbor1	chr5	6761481	6761728	LTR/ERVL-MaLR	416	+	124	6761605	38521
chr5	6723084	6923084	harbor1	chr5	6768055	6768458	LTR/ERVL-MaLR	2022	+	202	6768257	45173
chr5	6723084	6923084	harbor1	chr5	6778573	6778699	LTR/ERVL-MaLR	2096	+	63	6778636	55552
chr5	6723084	6923084	harbor1	chr5	6779002	6779243	LTR/ERVL-MaLR	2096	+	120	6779122	56038
chr5	6723084	6923084	harbor1	chr5	6779519	6779983	LTR/ERVL-MaLR	2004	+	232	6779751	56667
chr5	6723084	6923084	harbor1	chr5	6781461	6781841	LTR/ERVL-MaLR	2082	+	190	6781651	58567
chr5	6723084	6923084	harbor1	chr5	6794382	6794539	LTR/ERVL-MaLR	2538	+	78	6794460	71376
chr5	6723084	6923084	harbor1	chr5	6794832	6795054	LTR/ERVL-MaLR	2538	+	111	6794943	71859
chr5	6723084	6923084	harbor1	chr5	6795531	6795865	LTR/ERVL-MaLR	1573	+	167	6795698	72614
chr5	134406378	134606378	harbor1	chr5	134442229	134442357	LTR/ERVL-MaLR	587	+	64	134442293	35915
chr5	134406378	134606378	harbor1	chr5	134442358	134442512	LTR/ERVL-MaLR	1657	+	77	134442435	36057
chr5	134406378	134606378	harbor1	chr5	134442887	134442904	LTR/ERVL-MaLR	1657	+	8	134442895	36517
chr5	134406378	134606378	harbor1	chr5	134443212	134443418	LTR/ERVL-MaLR	1657	+	103	134443315	36937
chr5	134406378	134606378	harbor1	chr5	134443419	134443620	LTR/ERVL-MaLR	587	+	100	134443519	37141
chr5	134406378	134606378	harbor1	chr5	134486544	134486928	LTR/ERVL-MaLR	1871	+	192	134486736	80358
chr5	134406378	134606378	harbor1	chr5	134487242	134487306	LTR/ERVL-MaLR	1871	+	32	134487274	80896
chr5	134406378	134606378	harbor1	chr5	134494581	134495147	LTR/ERVL-MaLR	1153	+	283	134494864	88486
chr5	157644323	157844323	harbor1	chr5	157703357	157703798	LTR/ERVL-MaLR	1776	+	220	157703577	59254
chr5	157644323	157844323	harbor1	chr5	157704138	157704498	LTR/ERVL-MaLR	1304	+	180	157704318	59995
chr5	157644323	157844323	harbor1	chr5	157707460	157707723	LTR/ERVL-MaLR	1212	+	132	157707592	63269
chr5	157644323	157844323	harbor1	chr5	157708327	157708340	LTR/ERVL-MaLR	1212	+	6	157708333	64010
chr5	157644323	157844323	harbor1	chr5	157708653	157708716	LTR/ERVL-MaLR	1212	+	32	157708685	64362
chr5	157644323	157844323	harbor1	chr5	157709474	157709903	LTR/ERVL-MaLR	662	+	214	157709688	65365
chr5	6533035	6733035	harbor1	chr5	6543768	6543949	LTR/ERVL-MaLR	890	+	90	6543858	10823
chr5	6533035	6733035	harbor1	chr5	6544507	6544938	LTR/ERVL-MaLR	1141	+	216	6544723	11688
chr5	6533035	6733035	harbor1	chr5	6548155	6548512	LTR/ERVL-MaLR	2277	+	178	6548333	15298
chr5	6533035	6733035	harbor1	chr5	6558222	6558612	LTR/ERVL-MaLR	858	+	195	6558417	25382
chr5	6533035	6733035	harbor1	chr5	6562308	6562705	LTR/ERVL-MaLR	2479	+	198	6562506	29471
chr5	6533035	6733035	harbor1	chr5	6585012	6585415	LTR/ERVL-MaLR	1318	+	202	6585214	52179
chr5	6533035	6733035	harbor1	chr5	6594916	6595250	LTR/ERVL-MaLR	2383	+	167	6595083	62048
chr5	6533035	6733035	harbor1	chr5	6629665	6630016	LTR/ERVL-MaLR	1544	+	176	6629841	96806
chr5	52688052	52888052	harbor1	chr5	52688798	52689062	LTR/ERVL-MaLR	814	+	132	52688930	878
chr5	52688052	52888052	harbor1	chr5	52729943	52730320	LTR/ERVL-MaLR	2360	+	188	52730131	42079
chr5	52688052	52888052	harbor1	chr5	52730321	52731878	LTR/ERVL-MaLR	10715	+	778	52731099	43047
chr5	52688052	52888052	harbor1	chr5	52731879	52732259	LTR/ERVL-MaLR	2154	+	190	52732069	44017
chr5	52688052	52888052	harbor1	chr5	52761018	52761380	LTR/ERVL-MaLR	2582	+	181	52761199	73147
chr5	52688052	52888052	harbor1	chr5	52761953	52762334	LTR/ERVL-MaLR	1456	+	190	52762143	74091
chr5	52688052	52888052	harbor1	chr5	52763403	52763763	LTR/ERVL-MaLR	2140	+	180	52763583	75531
chr5	135919218	136119218	harbor1	chr5	135925353	135925732	LTR/ERVL-MaLR	1102	+	190	135925543	6325
chr5	135919218	136119218	harbor1	chr5	135955506	135955894	LTR/ERVL-MaLR	2382	+	194	135955700	36482
chr5	135919218	136119218	harbor1	chr5	135968433	135968791	LTR/ERVL-MaLR	2348	+	179	135968612	49394
chr5	135919218	136119218	harbor1	chr5	135980189	135980533	LTR/ERVL-MaLR	784	+	172	135980361	61143
chr5	135919218	136119218	harbor1	chr5	135981456	135981806	LTR/ERVL-MaLR	1566	+	175	135981631	62413
chr5	135919218	136119218	harbor1	chr5	135995298	135995698	LTR/ERVL-MaLR	2213	+	200	135995498	76280
chr5	135919218	136119218	harbor1	chr5	135999535	135999707	LTR/ERVL-MaLR	1382	+	86	135999621	80403
chr5	135919218	136119218	harbor1	chr5	135999750	135999966	LTR/ERVL-MaLR	1382	+	108	135999858	80640
chr5	168407631	168607631	harbor1	chr5	168438231	168438579	LTR/ERVL-MaLR	2555	+	174	168438405	30774
chr5	168407631	168607631	harbor1	chr5	168452264	168452633	LTR/ERVL-MaLR	1616	+	184	168452448	44817
chr5	73351497	73551497	harbor1	chr5	73385130	73385611	LTR/ERVL-MaLR	1527	+	240	73385370	33873
chr5	73351497	73551497	harbor1	chr5	73386037	73386532	LTR/ERVL-MaLR	2454	+	248	73386285	34788
chr5	133502807	133702807	harbor1	chr5	133502447	133502861	LTR/ERVL-MaLR	2598	+	207	133502654	153
chr5	133502807	133702807	harbor1	chr5	133502862	133502901	LTR/ERVL-MaLR	879	+	20	133502882	75
chr5	133502807	133702807	harbor1	chr5	133502907	133503054	LTR/ERVL-MaLR	747	+	74	133502981	174
chr5	133502807	133702807	harbor1	chr5	133511385	133511579	LTR/ERVL-MaLR	673	+	97	133511482	8675
chr5	133502807	133702807	harbor1	chr5	133523001	133523355	LTR/ERVL-MaLR	1555	+	177	133523178	20371
chr5	133502807	133702807	harbor1	chr5	133528852	133529225	LTR/ERVL-MaLR	933	+	186	133529038	26231
chr5	133502807	133702807	harbor1	chr5	133531933	133532262	LTR/ERVL-MaLR	1425	+	164	133532097	29290
chr5	133502807	133702807	harbor1	chr5	133533166	133533241	LTR/ERVL-MaLR	563	+	38	133533204	30397
chr5	133502807	133702807	harbor1	chr5	133533546	133533609	LTR/ERVL-MaLR	563	+	32	133533578	30771
chr5	133502807	133702807	harbor1	chr5	133534932	133535237	LTR/ERVL-MaLR	1557	+	152	133535084	32277
chr5	133502807	133702807	harbor1	chr5	133535729	133535801	LTR/ERVL-MaLR	1557	+	36	133535765	32958
chr5	133502807	133702807	harbor1	chr5	133545200	133545621	LTR/ERVL-MaLR	1336	+	210	133545410	42603
chr5	133502807	133702807	harbor1	chr5	133546532	133547460	LTR/ERVL-MaLR	4580	+	464	133546996	44189
chr5	133502807	133702807	harbor1	chr5	133547464	133547878	LTR/ERVL-MaLR	1100	+	207	133547671	44864
chr5	133502807	133702807	harbor1	chr5	133592533	133592955	LTR/ERVL-MaLR	2381	+	211	133592744	89937
chr5	133502807	133702807	harbor1	chr5	133545624	133546224	LTR/ERVL-MaLR	4580	+	300	133545924	43117
chr5	73351070	73551070	harbor1	chr5	73385130	73385611	LTR/ERVL-MaLR	1527	+	240	73385370	34300
chr5	73351070	73551070	harbor1	chr5	73386037	73386532	LTR/ERVL-MaLR	2454	+	248	73386285	35215
chr5	133905039	134105039	harbor1	chr5	133905761	133906175	LTR/ERVL-MaLR	962	+	207	133905968	929
chr5	133905039	134105039	harbor1	chr5	133939655	133940056	LTR/ERVL-MaLR	2655	+	200	133939855	34816
chr5	133905039	134105039	harbor1	chr5	133940362	133940398	LTR/ERVL-MaLR	2655	+	18	133940380	35341
chr5	133905039	134105039	harbor1	chr5	133954007	133954197	LTR/ERVL-MaLR	2621	+	95	133954102	49063
chr5	133905039	134105039	harbor1	chr5	133954524	133954765	LTR/ERVL-MaLR	2621	+	120	133954644	49605
chr5	133905039	134105039	harbor1	chr5	133971278	133971824	LTR/ERVL-MaLR	2151	+	273	133971551	66512
chr5	133905039	134105039	harbor1	chr5	133983703	133984058	LTR/ERVL-MaLR	1925	+	178	133983881	78842
chr5	133905039	134105039	harbor1	chr5	133984361	133984395	LTR/ERVL-MaLR	1925	+	17	133984378	79339
chr5	154657232	154857232	harbor1	chr5	154673870	154674256	LTR/ERVL-MaLR	1336	+	193	154674063	16831
chr5	154657232	154857232	harbor1	chr5	154676046	154676553	LTR/ERVL-MaLR	2649	+	254	154676300	19068
chr5	154657232	154857232	harbor1	chr5	154701458	154701618	LTR/ERVL-MaLR	711	+	80	154701538	44306
chr5	154657232	154857232	harbor1	chr5	154701921	154702163	LTR/ERVL-MaLR	711	+	121	154702042	44810
chr5	154657232	154857232	harbor1	chr5	154728268	154728608	LTR/ERVL-MaLR	834	+	170	154728438	71206
chr5	154657232	154857232	harbor1	chr5	154729904	154730094	LTR/ERVL-MaLR	467	+	95	154729999	72767
chr5	42324781	42524781	harbor1	chr5	42334009	42334080	LTR/ERVL-MaLR	464	+	36	42334045	9264
chr5	42324781	42524781	harbor1	chr5	42334081	42334455	LTR/ERVL-MaLR	2504	+	187	42334268	9487
chr5	42324781	42524781	harbor1	chr5	42346926	42347278	LTR/ERVL-MaLR	1890	+	176	42347102	22321
chr5	42324781	42524781	harbor1	chr5	42347279	42348883	LTR/ERVL-MaLR	10333	+	802	42348081	23300
chr5	42324781	42524781	harbor1	chr5	42348884	42349245	LTR/ERVL-MaLR	2094	+	180	42349064	24283
chr5	42324781	42524781	harbor1	chr5	42364499	42364759	LTR/ERVL-MaLR	991	+	130	42364629	39848
chr5	42324781	42524781	harbor1	chr5	42375547	42375925	LTR/ERVL-MaLR	1982	+	189	42375736	50955
chr5	82647609	82847609	harbor1	chr5	82688955	82689293	LTR/ERVL-MaLR	713	+	169	82689124	41515
chr5	82647609	82847609	harbor1	chr5	82717784	82718211	LTR/ERVL-MaLR	2679	+	214	82717998	70389
chr5	82647609	82847609	harbor1	chr5	82744833	82745203	LTR/ERVL-MaLR	1768	+	185	82745018	97409
chr5	82647609	82847609	harbor1	chr5	82746337	82746651	LTR/ERVL-MaLR	535	+	157	82746494	98885
chr5	132193610	132393610	harbor1	chr5	132240121	132240525	LTR/ERVL-MaLR	1806	+	202	132240323	46713
chr5	132193610	132393610	harbor1	chr5	132235253	132235565	LTR/ERVL-MaLR	1387	+	156	132235409	41799
chr5	52688976	52888976	harbor1	chr5	52688798	52689062	LTR/ERVL-MaLR	814	+	132	52688930	46
chr5	52688976	52888976	harbor1	chr5	52729943	52730320	LTR/ERVL-MaLR	2360	+	188	52730131	41155
chr5	52688976	52888976	harbor1	chr5	52730321	52731878	LTR/ERVL-MaLR	10715	+	778	52731099	42123
chr5	52688976	52888976	harbor1	chr5	52731879	52732259	LTR/ERVL-MaLR	2154	+	190	52732069	43093
chr5	52688976	52888976	harbor1	chr5	52761018	52761380	LTR/ERVL-MaLR	2582	+	181	52761199	72223
chr5	52688976	52888976	harbor1	chr5	52761953	52762334	LTR/ERVL-MaLR	1456	+	190	52762143	73167
chr5	52688976	52888976	harbor1	chr5	52763403	52763763	LTR/ERVL-MaLR	2140	+	180	52763583	74607
chr5	336002	536002	harbor1	chr5	360003	360402	LTR/ERVL-MaLR	818	+	200	360203	24201
chr5	336002	536002	harbor1	chr5	361254	361974	LTR/ERVL-MaLR	3818	+	360	361614	25612
chr5	336002	536002	harbor1	chr5	361986	362364	LTR/ERVL-MaLR	1535	+	189	362175	26173
chr5	336002	536002	harbor1	chr5	386284	386753	LTR/ERVL-MaLR	1590	+	234	386518	50516
chr5	336002	536002	harbor1	chr5	360401	360969	LTR/ERVL-MaLR	3818	+	284	360685	24683
chr5	79136023	79336023	harbor1	chr5	79140455	79140863	LTR/ERVL-MaLR	1680	+	204	79140659	4636
chr5	79136023	79336023	harbor1	chr5	79166438	79166495	LTR/ERVL-MaLR	2155	+	28	79166466	30443
chr5	79136023	79336023	harbor1	chr5	79166807	79167130	LTR/ERVL-MaLR	2155	+	162	79166969	30946
chr5	79136023	79336023	harbor1	chr5	79167428	79167488	LTR/ERVL-MaLR	2155	+	30	79167458	31435
chr5	79136023	79336023	harbor1	chr5	79210650	79210863	LTR/ERVL-MaLR	537	+	106	79210756	74733
chr5	79136023	79336023	harbor1	chr5	79223224	79223621	LTR/ERVL-MaLR	1480	+	198	79223422	87399
chr5	10151040	10351040	harbor1	chr5	10165003	10165300	LTR/ERVL-MaLR	665	+	148	10165151	14111
chr5	10151040	10351040	harbor1	chr5	10166800	10167211	LTR/ERVL-MaLR	1472	+	206	10167006	15966
chr5	10151040	10351040	harbor1	chr5	10171426	10171588	LTR/ERVL-MaLR	982	+	81	10171507	20467
chr5	10151040	10351040	harbor1	chr5	10193236	10193320	LTR/ERVL-MaLR	1837	+	42	10193278	42238
chr5	10151040	10351040	harbor1	chr5	10193622	10194034	LTR/ERVL-MaLR	1837	+	206	10193828	42788
chr5	10151040	10351040	harbor1	chr5	10211648	10212016	LTR/ERVL-MaLR	2336	+	184	10211832	60792
chr5	10151040	10351040	harbor1	chr5	10218154	10218262	LTR/ERVL-MaLR	720	+	54	10218208	67168
chr5	10151040	10351040	harbor1	chr5	10237389	10237750	LTR/ERVL-MaLR	2257	+	180	10237569	86529
chr5	10205523	10405523	harbor1	chr5	10211648	10212016	LTR/ERVL-MaLR	2336	+	184	10211832	6309
chr5	10205523	10405523	harbor1	chr5	10218154	10218262	LTR/ERVL-MaLR	720	+	54	10218208	12685
chr5	10205523	10405523	harbor1	chr5	10237389	10237750	LTR/ERVL-MaLR	2257	+	180	10237569	32046
chr5	10205523	10405523	harbor1	chr5	10269674	10269904	LTR/ERVL-MaLR	1805	+	115	10269789	64266
chr5	10205523	10405523	harbor1	chr5	10270203	10270558	LTR/ERVL-MaLR	1805	+	178	10270381	64858
chr5	10205523	10405523	harbor1	chr5	10295483	10295797	LTR/ERVL-MaLR	1370	+	157	10295640	90117
chr5	10205523	10405523	harbor1	chr5	10299993	10300444	LTR/ERVL-MaLR	1911	+	226	10300219	94696
chr5	10184091	10384091	harbor1	chr5	10193236	10193320	LTR/ERVL-MaLR	1837	+	42	10193278	9187
chr5	10184091	10384091	harbor1	chr5	10193622	10194034	LTR/ERVL-MaLR	1837	+	206	10193828	9737
chr5	10184091	10384091	harbor1	chr5	10211648	10212016	LTR/ERVL-MaLR	2336	+	184	10211832	27741
chr5	10184091	10384091	harbor1	chr5	10218154	10218262	LTR/ERVL-MaLR	720	+	54	10218208	34117
chr5	10184091	10384091	harbor1	chr5	10237389	10237750	LTR/ERVL-MaLR	2257	+	180	10237569	53478
chr5	10184091	10384091	harbor1	chr5	10269674	10269904	LTR/ERVL-MaLR	1805	+	115	10269789	85698
chr5	10184091	10384091	harbor1	chr5	10270203	10270558	LTR/ERVL-MaLR	1805	+	178	10270381	86290
chr5	10661221	10861221	harbor1	chr5	10678000	10678459	LTR/ERVL-MaLR	1703	+	230	10678230	17009
chr5	10661221	10861221	harbor1	chr5	10711988	10712339	LTR/ERVL-MaLR	2147	+	176	10712164	50943
chr5	10661221	10861221	harbor1	chr5	10714621	10715043	LTR/ERVL-MaLR	2378	+	211	10714832	53611
chr5	10661221	10861221	harbor1	chr5	10731677	10731849	LTR/ERVL-MaLR	545	+	86	10731763	70542
chr5	10661221	10861221	harbor1	chr5	10735865	10736298	LTR/ERVL-MaLR	1949	+	216	10736081	74860
chr5	10661221	10861221	harbor1	chr5	10737747	10738211	LTR/ERVL-MaLR	2173	+	232	10737979	76758
chr5	10661221	10861221	harbor1	chr5	10751569	10751951	LTR/ERVL-MaLR	1721	+	191	10751760	90539
chr5	10661221	10861221	harbor1	chr5	10755039	10755452	LTR/ERVL-MaLR	1954	+	206	10755245	94024
chr5	73021050	73221050	harbor1	chr5	73043897	73044273	LTR/ERVL-MaLR	2107	+	188	73044085	23035
chr5	73021050	73221050	harbor1	chr5	73117360	73117831	LTR/ERVL-MaLR	1858	+	236	73117596	96546
chr5	52700111	52900111	harbor1	chr5	52729943	52730320	LTR/ERVL-MaLR	2360	+	188	52730131	30020
chr5	52700111	52900111	harbor1	chr5	52730321	52731878	LTR/ERVL-MaLR	10715	+	778	52731099	30988
chr5	52700111	52900111	harbor1	chr5	52731879	52732259	LTR/ERVL-MaLR	2154	+	190	52732069	31958
chr5	52700111	52900111	harbor1	chr5	52761018	52761380	LTR/ERVL-MaLR	2582	+	181	52761199	61088
chr5	52700111	52900111	harbor1	chr5	52761953	52762334	LTR/ERVL-MaLR	1456	+	190	52762143	62032
chr5	52700111	52900111	harbor1	chr5	52763403	52763763	LTR/ERVL-MaLR	2140	+	180	52763583	63472
chr5	6533087	6733087	harbor1	chr5	6543768	6543949	LTR/ERVL-MaLR	890	+	90	6543858	10771
chr5	6533087	6733087	harbor1	chr5	6544507	6544938	LTR/ERVL-MaLR	1141	+	216	6544723	11636
chr5	6533087	6733087	harbor1	chr5	6548155	6548512	LTR/ERVL-MaLR	2277	+	178	6548333	15246
chr5	6533087	6733087	harbor1	chr5	6558222	6558612	LTR/ERVL-MaLR	858	+	195	6558417	25330
chr5	6533087	6733087	harbor1	chr5	6562308	6562705	LTR/ERVL-MaLR	2479	+	198	6562506	29419
chr5	6533087	6733087	harbor1	chr5	6585012	6585415	LTR/ERVL-MaLR	1318	+	202	6585214	52127
chr5	6533087	6733087	harbor1	chr5	6594916	6595250	LTR/ERVL-MaLR	2383	+	167	6595083	61996
chr5	6533087	6733087	harbor1	chr5	6629665	6630016	LTR/ERVL-MaLR	1544	+	176	6629841	96754
chr5	10333600	10533600	harbor1	chr5	10334541	10334921	LTR/ERVL-MaLR	1586	+	190	10334731	1131
chr5	73350922	73550922	harbor1	chr5	73385130	73385611	LTR/ERVL-MaLR	1527	+	240	73385370	34448
chr5	73350922	73550922	harbor1	chr5	73386037	73386532	LTR/ERVL-MaLR	2454	+	248	73386285	35363
chr5	10661144	10861144	harbor1	chr5	10678000	10678459	LTR/ERVL-MaLR	1703	+	230	10678230	17086
chr5	10661144	10861144	harbor1	chr5	10711988	10712339	LTR/ERVL-MaLR	2147	+	176	10712164	51020
chr5	10661144	10861144	harbor1	chr5	10714621	10715043	LTR/ERVL-MaLR	2378	+	211	10714832	53688
chr5	10661144	10861144	harbor1	chr5	10731677	10731849	LTR/ERVL-MaLR	545	+	86	10731763	70619
chr5	10661144	10861144	harbor1	chr5	10735865	10736298	LTR/ERVL-MaLR	1949	+	216	10736081	74937
chr5	10661144	10861144	harbor1	chr5	10737747	10738211	LTR/ERVL-MaLR	2173	+	232	10737979	76835
chr5	10661144	10861144	harbor1	chr5	10751569	10751951	LTR/ERVL-MaLR	1721	+	191	10751760	90616
chr5	10661144	10861144	harbor1	chr5	10755039	10755452	LTR/ERVL-MaLR	1954	+	206	10755245	94101
chr5	37740447	37940447	harbor1	chr5	37750545	37750878	LTR/ERVL-MaLR	2185	+	166	37750711	10264
chr5	37740447	37940447	harbor1	chr5	37757285	37757745	LTR/ERVL-MaLR	1595	+	230	37757515	17068
chr5	37740447	37940447	harbor1	chr5	37766238	37766671	LTR/ERVL-MaLR	1655	+	216	37766454	26007
chr5	37740447	37940447	harbor1	chr5	37770149	37770550	LTR/ERVL-MaLR	2047	+	200	37770349	29902
chr5	37740447	37940447	harbor1	chr5	37791863	37792160	LTR/ERVL-MaLR	1567	+	148	37792011	51564
chr5	37740447	37940447	harbor1	chr5	37792430	37792467	LTR/ERVL-MaLR	1567	+	18	37792448	52001
chr5	37740447	37940447	harbor1	chr5	37803293	37803645	LTR/ERVL-MaLR	2282	+	176	37803469	63022
chr5	37740447	37940447	harbor1	chr5	37804632	37805189	LTR/ERVL-MaLR	1686	+	278	37804910	64463
chr5	37740447	37940447	harbor1	chr5	37818206	37818573	LTR/ERVL-MaLR	2545	+	184	37818390	77943
chr5	10186534	10386534	harbor1	chr5	10193236	10193320	LTR/ERVL-MaLR	1837	+	42	10193278	6744
chr5	10186534	10386534	harbor1	chr5	10193622	10194034	LTR/ERVL-MaLR	1837	+	206	10193828	7294
chr5	10186534	10386534	harbor1	chr5	10211648	10212016	LTR/ERVL-MaLR	2336	+	184	10211832	25298
chr5	10186534	10386534	harbor1	chr5	10218154	10218262	LTR/ERVL-MaLR	720	+	54	10218208	31674
chr5	10186534	10386534	harbor1	chr5	10237389	10237750	LTR/ERVL-MaLR	2257	+	180	10237569	51035
chr5	10186534	10386534	harbor1	chr5	10269674	10269904	LTR/ERVL-MaLR	1805	+	115	10269789	83255
chr5	10186534	10386534	harbor1	chr5	10270203	10270558	LTR/ERVL-MaLR	1805	+	178	10270381	83847
chr5	10653254	10853254	harbor1	chr5	10678000	10678459	LTR/ERVL-MaLR	1703	+	230	10678230	24976
chr5	10653254	10853254	harbor1	chr5	10711988	10712339	LTR/ERVL-MaLR	2147	+	176	10712164	58910
chr5	10653254	10853254	harbor1	chr5	10714621	10715043	LTR/ERVL-MaLR	2378	+	211	10714832	61578
chr5	10653254	10853254	harbor1	chr5	10731677	10731849	LTR/ERVL-MaLR	545	+	86	10731763	78509
chr5	10653254	10853254	harbor1	chr5	10735865	10736298	LTR/ERVL-MaLR	1949	+	216	10736081	82827
chr5	10653254	10853254	harbor1	chr5	10737747	10738211	LTR/ERVL-MaLR	2173	+	232	10737979	84725
chr5	10653254	10853254	harbor1	chr5	10751569	10751951	LTR/ERVL-MaLR	1721	+	191	10751760	98506
chr5	128994660	129194660	harbor1	chr5	129010318	129010998	LTR/ERVL-MaLR	1699	+	340	129010658	15998
chr5	128994660	129194660	harbor1	chr5	129039309	129039384	LTR/ERVL-MaLR	455	+	38	129039347	44687
chr5	128994660	129194660	harbor1	chr5	129065682	129066168	LTR/ERVL-MaLR	1946	+	243	129065925	71265
chr5	128994660	129194660	harbor1	chr5	129074058	129074198	LTR/ERVL-MaLR	534	+	70	129074128	79468
chr5	128994660	129194660	harbor1	chr5	129074621	129074645	LTR/ERVL-MaLR	534	+	12	129074633	79973
chr5	128994660	129194660	harbor1	chr5	129077904	129078383	LTR/ERVL-MaLR	1518	+	240	129078144	83484
chr5	128994660	129194660	harbor1	chr5	129079861	129080056	LTR/ERVL-MaLR	429	+	98	129079959	85299
chr5	72733843	72933843	harbor1	chr5	72741821	72742277	LTR/ERVL-MaLR	1844	+	228	72742049	8206
chr5	72733843	72933843	harbor1	chr5	72753119	72753677	LTR/ERVL-MaLR	2341	+	279	72753398	19555
chr5	72733843	72933843	harbor1	chr5	72774889	72775320	LTR/ERVL-MaLR	2422	+	216	72775105	41262
chr5	72733843	72933843	harbor1	chr5	72775323	72775550	LTR/ERVL-MaLR	878	+	114	72775437	41594
chr5	72733843	72933843	harbor1	chr5	72782122	72783635	LTR/ERVL-MaLR	4160	+	756	72782878	49035
chr5	72733843	72933843	harbor1	chr5	72783636	72783782	LTR/ERVL-MaLR	929	+	73	72783709	49866
chr5	72733843	72933843	harbor1	chr5	72809764	72810054	LTR/ERVL-MaLR	897	+	145	72809909	76066
chr5	72733843	72933843	harbor1	chr5	72825290	72825405	LTR/ERVL-MaLR	1381	+	58	72825348	91505
chr5	72733843	72933843	harbor1	chr5	72825701	72825899	LTR/ERVL-MaLR	1381	+	99	72825800	91957
chr5	72733843	72933843	harbor1	chr5	72761163	72761531	LTR/ERVL-MaLR	1494	+	184	72761347	27504
chr5	73307094	73507094	harbor1	chr5	73320052	73320587	LTR/ERVL-MaLR	2033	+	268	73320320	13226
chr5	73307094	73507094	harbor1	chr5	73331226	73331622	LTR/ERVL-MaLR	1359	+	198	73331424	24330
chr5	73307094	73507094	harbor1	chr5	73348533	73348910	LTR/ERVL-MaLR	2007	+	188	73348721	41627
chr5	73307094	73507094	harbor1	chr5	73385130	73385611	LTR/ERVL-MaLR	1527	+	240	73385370	78276
chr5	73307094	73507094	harbor1	chr5	73386037	73386532	LTR/ERVL-MaLR	2454	+	248	73386285	79191
chr5	178132777	178332777	harbor1	chr5	178162637	178162914	LTR/ERVL-MaLR	1013	+	138	178162775	29998
chr5	178132777	178332777	harbor1	chr5	178163224	178163409	LTR/ERVL-MaLR	1013	+	92	178163316	30539
chr5	178132777	178332777	harbor1	chr5	178169425	178169586	LTR/ERVL-MaLR	948	+	80	178169505	36728
chr5	178132777	178332777	harbor1	chr5	178218372	178218716	LTR/ERVL-MaLR	1424	+	172	178218544	85767
chr5	178132777	178332777	harbor1	chr5	178227048	178227434	LTR/ERVL-MaLR	1775	+	193	178227241	94464
chr5	9289591	9489591	harbor1	chr5	9291244	9291522	LTR/ERVL-MaLR	418	+	139	9291383	1792
chr5	9289591	9489591	harbor1	chr5	9291803	9291899	LTR/ERVL-MaLR	423	+	48	9291851	2260
chr5	9289591	9489591	harbor1	chr5	9297299	9297543	LTR/ERVL-MaLR	940	+	122	9297421	7830
chr5	9289591	9489591	harbor1	chr5	9297853	9297950	LTR/ERVL-MaLR	940	+	48	9297901	8310
chr5	9289591	9489591	harbor1	chr5	9298041	9298504	LTR/ERVL-MaLR	1468	+	232	9298273	8682
chr5	9289591	9489591	harbor1	chr5	9300592	9301031	LTR/ERVL-MaLR	1136	+	220	9300812	11221
chr5	9289591	9489591	harbor1	chr5	9309408	9309558	LTR/ERVL-MaLR	440	+	75	9309483	19892
chr5	9289591	9489591	harbor1	chr5	9320944	9321321	LTR/ERVL-MaLR	2311	+	188	9321132	31541
chr5	9289591	9489591	harbor1	chr5	9367699	9368098	LTR/ERVL-MaLR	2128	+	200	9367899	78308
chr5	9289591	9489591	harbor1	chr5	9375202	9375647	LTR/ERVL-MaLR	1614	+	222	9375424	85833
chr5	9289591	9489591	harbor1	chr5	9381352	9381814	LTR/ERVL-MaLR	1183	+	231	9381583	91992
chr5	9114312	9314312	harbor1	chr5	9114488	9115736	LTR/ERVL-MaLR	4018	+	624	9115112	800
chr5	9114312	9314312	harbor1	chr5	9115746	9116306	LTR/ERVL-MaLR	1006	+	280	9116026	1714
chr5	9114312	9314312	harbor1	chr5	9128239	9128504	LTR/ERVL-MaLR	619	+	132	9128371	14059
chr5	9114312	9314312	harbor1	chr5	9132286	9132620	LTR/ERVL-MaLR	1052	+	167	9132453	18141
chr5	9114312	9314312	harbor1	chr5	9133840	9134200	LTR/ERVL-MaLR	2016	+	180	9134020	19708
chr5	9114312	9314312	harbor1	chr5	9163594	9163965	LTR/ERVL-MaLR	2050	+	186	9163780	49468
chr5	9114312	9314312	harbor1	chr5	9170461	9170824	LTR/ERVL-MaLR	1598	+	182	9170643	56331
chr5	9114312	9314312	harbor1	chr5	9175930	9176586	LTR/ERVL-MaLR	2236	+	328	9176258	61946
chr5	9114312	9314312	harbor1	chr5	9188005	9188360	LTR/ERVL-MaLR	1620	+	178	9188183	73871
chr5	9114312	9314312	harbor1	chr5	9196183	9196546	LTR/ERVL-MaLR	1023	+	182	9196365	82053
chr5	79136006	79336006	harbor1	chr5	79140455	79140863	LTR/ERVL-MaLR	1680	+	204	79140659	4653
chr5	79136006	79336006	harbor1	chr5	79166438	79166495	LTR/ERVL-MaLR	2155	+	28	79166466	30460
chr5	79136006	79336006	harbor1	chr5	79166807	79167130	LTR/ERVL-MaLR	2155	+	162	79166969	30963
chr5	79136006	79336006	harbor1	chr5	79167428	79167488	LTR/ERVL-MaLR	2155	+	30	79167458	31452
chr5	79136006	79336006	harbor1	chr5	79210650	79210863	LTR/ERVL-MaLR	537	+	106	79210756	74750
chr5	79136006	79336006	harbor1	chr5	79223224	79223621	LTR/ERVL-MaLR	1480	+	198	79223422	87416
chr5	75136482	75336482	harbor1	chr5	75140497	75140986	LTR/ERVL-MaLR	1372	+	244	75140741	4259
chr5	75136482	75336482	harbor1	chr5	75151309	75151672	LTR/ERVL-MaLR	2511	+	182	75151491	15009
chr5	75136482	75336482	harbor1	chr5	75152917	75153390	LTR/ERVL-MaLR	1954	+	236	75153153	16671
chr5	75136482	75336482	harbor1	chr5	75156468	75156962	LTR/ERVL-MaLR	1469	+	247	75156715	20233
chr5	75136482	75336482	harbor1	chr5	75156963	75157840	LTR/ERVL-MaLR	3225	+	438	75157401	20919
chr5	75136482	75336482	harbor1	chr5	75160671	75161036	LTR/ERVL-MaLR	1865	+	182	75160853	24371
chr5	75136482	75336482	harbor1	chr5	75161037	75162622	LTR/ERVL-MaLR	12263	+	792	75161829	25347
chr5	75136482	75336482	harbor1	chr5	75162625	75162756	LTR/ERVL-MaLR	875	+	66	75162691	26209
chr5	75136482	75336482	harbor1	chr5	75163891	75164410	LTR/ERVL-MaLR	2489	+	260	75164151	27669
chr5	75136482	75336482	harbor1	chr5	75223677	75224081	LTR/ERVL-MaLR	1666	+	202	75223879	87397
chr5	10661132	10861132	harbor1	chr5	10678000	10678459	LTR/ERVL-MaLR	1703	+	230	10678230	17098
chr5	10661132	10861132	harbor1	chr5	10711988	10712339	LTR/ERVL-MaLR	2147	+	176	10712164	51032
chr5	10661132	10861132	harbor1	chr5	10714621	10715043	LTR/ERVL-MaLR	2378	+	211	10714832	53700
chr5	10661132	10861132	harbor1	chr5	10731677	10731849	LTR/ERVL-MaLR	545	+	86	10731763	70631
chr5	10661132	10861132	harbor1	chr5	10735865	10736298	LTR/ERVL-MaLR	1949	+	216	10736081	74949
chr5	10661132	10861132	harbor1	chr5	10737747	10738211	LTR/ERVL-MaLR	2173	+	232	10737979	76847
chr5	10661132	10861132	harbor1	chr5	10751569	10751951	LTR/ERVL-MaLR	1721	+	191	10751760	90628
chr5	10661132	10861132	harbor1	chr5	10755039	10755452	LTR/ERVL-MaLR	1954	+	206	10755245	94113
chr5	89882308	90082308	harbor1	chr5	89888111	89888356	LTR/ERVL-MaLR	1410	+	122	89888233	5925
chr5	89882308	90082308	harbor1	chr5	89888625	89888770	LTR/ERVL-MaLR	1410	+	72	89888697	6389
chr5	89882308	90082308	harbor1	chr5	89932508	89933315	LTR/ERVL-MaLR	1980	+	404	89932912	50604
chr5	89882308	90082308	harbor1	chr5	89949219	89949514	LTR/ERVL-MaLR	1459	+	148	89949367	67059
chr5	10661219	10861219	harbor1	chr5	10678000	10678459	LTR/ERVL-MaLR	1703	+	230	10678230	17011
chr5	10661219	10861219	harbor1	chr5	10711988	10712339	LTR/ERVL-MaLR	2147	+	176	10712164	50945
chr5	10661219	10861219	harbor1	chr5	10714621	10715043	LTR/ERVL-MaLR	2378	+	211	10714832	53613
chr5	10661219	10861219	harbor1	chr5	10731677	10731849	LTR/ERVL-MaLR	545	+	86	10731763	70544
chr5	10661219	10861219	harbor1	chr5	10735865	10736298	LTR/ERVL-MaLR	1949	+	216	10736081	74862
chr5	10661219	10861219	harbor1	chr5	10737747	10738211	LTR/ERVL-MaLR	2173	+	232	10737979	76760
chr5	10661219	10861219	harbor1	chr5	10751569	10751951	LTR/ERVL-MaLR	1721	+	191	10751760	90541
chr5	10661219	10861219	harbor1	chr5	10755039	10755452	LTR/ERVL-MaLR	1954	+	206	10755245	94026
chr5	73338840	73538840	harbor1	chr5	73348533	73348910	LTR/ERVL-MaLR	2007	+	188	73348721	9881
chr5	73338840	73538840	harbor1	chr5	73385130	73385611	LTR/ERVL-MaLR	1527	+	240	73385370	46530
chr5	73338840	73538840	harbor1	chr5	73386037	73386532	LTR/ERVL-MaLR	2454	+	248	73386285	47445
chr5	133511368	133711368	harbor1	chr5	133511385	133511579	LTR/ERVL-MaLR	673	+	97	133511482	114
chr5	133511368	133711368	harbor1	chr5	133523001	133523355	LTR/ERVL-MaLR	1555	+	177	133523178	11810
chr5	133511368	133711368	harbor1	chr5	133528852	133529225	LTR/ERVL-MaLR	933	+	186	133529038	17670
chr5	133511368	133711368	harbor1	chr5	133531933	133532262	LTR/ERVL-MaLR	1425	+	164	133532097	20729
chr5	133511368	133711368	harbor1	chr5	133533166	133533241	LTR/ERVL-MaLR	563	+	38	133533204	21836
chr5	133511368	133711368	harbor1	chr5	133533546	133533609	LTR/ERVL-MaLR	563	+	32	133533578	22210
chr5	133511368	133711368	harbor1	chr5	133534932	133535237	LTR/ERVL-MaLR	1557	+	152	133535084	23716
chr5	133511368	133711368	harbor1	chr5	133535729	133535801	LTR/ERVL-MaLR	1557	+	36	133535765	24397
chr5	133511368	133711368	harbor1	chr5	133545200	133545621	LTR/ERVL-MaLR	1336	+	210	133545410	34042
chr5	133511368	133711368	harbor1	chr5	133546532	133547460	LTR/ERVL-MaLR	4580	+	464	133546996	35628
chr5	133511368	133711368	harbor1	chr5	133547464	133547878	LTR/ERVL-MaLR	1100	+	207	133547671	36303
chr5	133511368	133711368	harbor1	chr5	133592533	133592955	LTR/ERVL-MaLR	2381	+	211	133592744	81376
chr5	133511368	133711368	harbor1	chr5	133545624	133546224	LTR/ERVL-MaLR	4580	+	300	133545924	34556
chr5	596533	796533	harbor1	chr5	686747	687071	LTR/ERVL-MaLR	961	+	162	686909	90376
chr5	135442075	135642075	harbor1	chr5	135517497	135517914	LTR/ERVL-MaLR	1236	+	208	135517705	75630
chr5	135442075	135642075	harbor1	chr5	135527510	135527943	LTR/ERVL-MaLR	2641	+	216	135527726	85651
chr5	135442075	135642075	harbor1	chr5	135529627	135529965	LTR/ERVL-MaLR	1835	+	169	135529796	87721
chr5	41825178	42025178	harbor1	chr5	41825701	41825897	LTR/ERVL-MaLR	575	+	98	41825799	621
chr5	41825178	42025178	harbor1	chr5	41851864	41852191	LTR/ERVL-MaLR	1164	+	164	41852028	26850
chr5	41825178	42025178	harbor1	chr5	41879015	41879307	LTR/ERVL-MaLR	1163	+	146	41879161	53983
chr5	41825178	42025178	harbor1	chr5	41895759	41895864	LTR/ERVL-MaLR	586	+	52	41895811	70633
chr5	41825178	42025178	harbor1	chr5	41899854	41899971	LTR/ERVL-MaLR	507	+	58	41899912	74734
chr5	133482188	133682188	harbor1	chr5	133482959	133483321	LTR/ERVL-MaLR	2546	+	181	133483140	952
chr5	133482188	133682188	harbor1	chr5	133501735	133502203	LTR/ERVL-MaLR	1895	+	234	133501969	19781
chr5	133482188	133682188	harbor1	chr5	133502204	133502446	LTR/ERVL-MaLR	879	+	121	133502325	20137
chr5	133482188	133682188	harbor1	chr5	133502447	133502861	LTR/ERVL-MaLR	2598	+	207	133502654	20466
chr5	133482188	133682188	harbor1	chr5	133502862	133502901	LTR/ERVL-MaLR	879	+	20	133502882	20694
chr5	133482188	133682188	harbor1	chr5	133502907	133503054	LTR/ERVL-MaLR	747	+	74	133502981	20793
chr5	133482188	133682188	harbor1	chr5	133511385	133511579	LTR/ERVL-MaLR	673	+	97	133511482	29294
chr5	133482188	133682188	harbor1	chr5	133523001	133523355	LTR/ERVL-MaLR	1555	+	177	133523178	40990
chr5	133482188	133682188	harbor1	chr5	133528852	133529225	LTR/ERVL-MaLR	933	+	186	133529038	46850
chr5	133482188	133682188	harbor1	chr5	133531933	133532262	LTR/ERVL-MaLR	1425	+	164	133532097	49909
chr5	133482188	133682188	harbor1	chr5	133533166	133533241	LTR/ERVL-MaLR	563	+	38	133533204	51016
chr5	133482188	133682188	harbor1	chr5	133533546	133533609	LTR/ERVL-MaLR	563	+	32	133533578	51390
chr5	133482188	133682188	harbor1	chr5	133534932	133535237	LTR/ERVL-MaLR	1557	+	152	133535084	52896
chr5	133482188	133682188	harbor1	chr5	133535729	133535801	LTR/ERVL-MaLR	1557	+	36	133535765	53577
chr5	133482188	133682188	harbor1	chr5	133545200	133545621	LTR/ERVL-MaLR	1336	+	210	133545410	63222
chr5	133482188	133682188	harbor1	chr5	133546532	133547460	LTR/ERVL-MaLR	4580	+	464	133546996	64808
chr5	133482188	133682188	harbor1	chr5	133547464	133547878	LTR/ERVL-MaLR	1100	+	207	133547671	65483
chr5	133482188	133682188	harbor1	chr5	133545624	133546224	LTR/ERVL-MaLR	4580	+	300	133545924	63736
chr5	9114417	9314417	harbor1	chr5	9114488	9115736	LTR/ERVL-MaLR	4018	+	624	9115112	695
chr5	9114417	9314417	harbor1	chr5	9115746	9116306	LTR/ERVL-MaLR	1006	+	280	9116026	1609
chr5	9114417	9314417	harbor1	chr5	9128239	9128504	LTR/ERVL-MaLR	619	+	132	9128371	13954
chr5	9114417	9314417	harbor1	chr5	9132286	9132620	LTR/ERVL-MaLR	1052	+	167	9132453	18036
chr5	9114417	9314417	harbor1	chr5	9133840	9134200	LTR/ERVL-MaLR	2016	+	180	9134020	19603
chr5	9114417	9314417	harbor1	chr5	9163594	9163965	LTR/ERVL-MaLR	2050	+	186	9163780	49363
chr5	9114417	9314417	harbor1	chr5	9170461	9170824	LTR/ERVL-MaLR	1598	+	182	9170643	56226
chr5	9114417	9314417	harbor1	chr5	9175930	9176586	LTR/ERVL-MaLR	2236	+	328	9176258	61841
chr5	9114417	9314417	harbor1	chr5	9188005	9188360	LTR/ERVL-MaLR	1620	+	178	9188183	73766
chr5	9114417	9314417	harbor1	chr5	9196183	9196546	LTR/ERVL-MaLR	1023	+	182	9196365	81948
chr5	73351520	73551520	harbor1	chr5	73385130	73385611	LTR/ERVL-MaLR	1527	+	240	73385370	33850
chr5	73351520	73551520	harbor1	chr5	73386037	73386532	LTR/ERVL-MaLR	2454	+	248	73386285	34765
chr5	135008381	135208381	harbor1	chr5	135089504	135089870	LTR/ERVL-MaLR	2932	+	183	135089687	81306
chr5	134460977	134660977	harbor1	chr5	134486544	134486928	LTR/ERVL-MaLR	1871	+	192	134486736	25759
chr5	134460977	134660977	harbor1	chr5	134487242	134487306	LTR/ERVL-MaLR	1871	+	32	134487274	26297
chr5	134460977	134660977	harbor1	chr5	134494581	134495147	LTR/ERVL-MaLR	1153	+	283	134494864	33887
chr5	134460977	134660977	harbor1	chr5	134508116	134508259	LTR/ERVL-MaLR	1206	+	72	134508188	47211
chr5	134460977	134660977	harbor1	chr5	134508371	134508405	LTR/ERVL-MaLR	1206	+	17	134508388	47411
chr5	134460977	134660977	harbor1	chr5	134508689	134508934	LTR/ERVL-MaLR	1206	+	122	134508811	47834
chr5	135008344	135208344	harbor1	chr5	135089504	135089870	LTR/ERVL-MaLR	2932	+	183	135089687	81343
chr5	52700146	52900146	harbor1	chr5	52729943	52730320	LTR/ERVL-MaLR	2360	+	188	52730131	29985
chr5	52700146	52900146	harbor1	chr5	52730321	52731878	LTR/ERVL-MaLR	10715	+	778	52731099	30953
chr5	52700146	52900146	harbor1	chr5	52731879	52732259	LTR/ERVL-MaLR	2154	+	190	52732069	31923
chr5	52700146	52900146	harbor1	chr5	52761018	52761380	LTR/ERVL-MaLR	2582	+	181	52761199	61053
chr5	52700146	52900146	harbor1	chr5	52761953	52762334	LTR/ERVL-MaLR	1456	+	190	52762143	61997
chr5	52700146	52900146	harbor1	chr5	52763403	52763763	LTR/ERVL-MaLR	2140	+	180	52763583	63437
chr5	168386457	168586457	harbor1	chr5	168438231	168438579	LTR/ERVL-MaLR	2555	+	174	168438405	51948
chr5	168386457	168586457	harbor1	chr5	168452264	168452633	LTR/ERVL-MaLR	1616	+	184	168452448	65991
chr5	73351488	73551488	harbor1	chr5	73385130	73385611	LTR/ERVL-MaLR	1527	+	240	73385370	33882
chr5	73351488	73551488	harbor1	chr5	73386037	73386532	LTR/ERVL-MaLR	2454	+	248	73386285	34797
chr5	177411621	177611621	harbor1	chr5	177411688	177412063	LTR/ERVL-MaLR	2034	+	188	177411876	255
chr5	177411621	177611621	harbor1	chr5	177412064	177412138	LTR/ERVL-MaLR	1215	+	37	177412101	480
chr5	177411621	177611621	harbor1	chr5	177412440	177412523	LTR/ERVL-MaLR	1215	+	42	177412482	861
chr5	177411621	177611621	harbor1	chr5	177414992	177415213	LTR/ERVL-MaLR	598	+	110	177415102	3481
chr5	177411621	177611621	harbor1	chr5	177415384	177415587	LTR/ERVL-MaLR	978	+	102	177415486	3865
chr5	177411621	177611621	harbor1	chr5	177415889	177415920	LTR/ERVL-MaLR	978	+	16	177415905	4284
chr5	177411621	177611621	harbor1	chr5	177416240	177416365	LTR/ERVL-MaLR	978	+	62	177416302	4681
chr5	177411621	177611621	harbor1	chr5	177421976	177422314	LTR/ERVL-MaLR	1050	+	169	177422145	10524
chr5	177411621	177611621	harbor1	chr5	177445441	177445757	LTR/ERVL-MaLR	548	+	158	177445599	33978
chr5	177411621	177611621	harbor1	chr5	177477044	177477137	LTR/ERVL-MaLR	1202	+	46	177477090	65469
chr5	177411621	177611621	harbor1	chr5	177477447	177477709	LTR/ERVL-MaLR	1202	+	131	177477578	65957
chr5	177411621	177611621	harbor1	chr5	177487229	177487606	LTR/ERVL-MaLR	1101	+	188	177487417	75796
chr5	118403	318403	harbor1	chr5	152717	153070	LTR/ERVL-MaLR	2031	+	176	152893	34490
chr5	91829	291829	harbor1	chr5	102540	102761	LTR/ERVL-MaLR	1102	+	110	102650	10821
chr5	91829	291829	harbor1	chr5	152717	153070	LTR/ERVL-MaLR	2031	+	176	152893	61064
chr5	52700057	52900057	harbor1	chr5	52729943	52730320	LTR/ERVL-MaLR	2360	+	188	52730131	30074
chr5	52700057	52900057	harbor1	chr5	52730321	52731878	LTR/ERVL-MaLR	10715	+	778	52731099	31042
chr5	52700057	52900057	harbor1	chr5	52731879	52732259	LTR/ERVL-MaLR	2154	+	190	52732069	32012
chr5	52700057	52900057	harbor1	chr5	52761018	52761380	LTR/ERVL-MaLR	2582	+	181	52761199	61142
chr5	52700057	52900057	harbor1	chr5	52761953	52762334	LTR/ERVL-MaLR	1456	+	190	52762143	62086
chr5	52700057	52900057	harbor1	chr5	52763403	52763763	LTR/ERVL-MaLR	2140	+	180	52763583	63526
chr5	980578	1180578	harbor1	chr5	1039571	1039685	LTR/ERVL-MaLR	501	+	57	1039628	59050
chr5	980578	1180578	harbor1	chr5	1039677	1039791	LTR/ERVL-MaLR	501	+	57	1039734	59156
chr5	980578	1180578	harbor1	chr5	1039783	1039963	LTR/ERVL-MaLR	2008	+	90	1039873	59295
chr5	980578	1180578	harbor1	chr5	1040295	1040528	LTR/ERVL-MaLR	2008	+	116	1040411	59833
chr5	980578	1180578	harbor1	chr5	1066128	1066495	LTR/ERVL-MaLR	567	+	184	1066312	85734
chr5	73351609	73551609	harbor1	chr5	73385130	73385611	LTR/ERVL-MaLR	1527	+	240	73385370	33761
chr5	73351609	73551609	harbor1	chr5	73386037	73386532	LTR/ERVL-MaLR	2454	+	248	73386285	34676
chr5	137653914	137853914	harbor1	chr5	137739708	137740122	LTR/ERVL-MaLR	2563	+	207	137739915	86001
chr5	4784467	4984467	harbor1	chr5	4796497	4796619	LTR/ERVL-MaLR	421	+	61	4796558	12091
chr5	4784467	4984467	harbor1	chr5	4801280	4801638	LTR/ERVL-MaLR	2072	+	179	4801459	16992
chr5	4784467	4984467	harbor1	chr5	4814059	4814250	LTR/ERVL-MaLR	1690	+	96	4814155	29688
chr5	4784467	4984467	harbor1	chr5	4814289	4814477	LTR/ERVL-MaLR	1690	+	94	4814383	29916
chr5	4784467	4984467	harbor1	chr5	4824751	4825059	LTR/ERVL-MaLR	829	+	154	4824905	40438
chr5	4784467	4984467	harbor1	chr5	4834425	4834885	LTR/ERVL-MaLR	682	+	230	4834655	50188
chr5	4784467	4984467	harbor1	chr5	4863138	4863595	LTR/ERVL-MaLR	2504	+	228	4863366	78899
chr5	4784467	4984467	harbor1	chr5	4870461	4870839	LTR/ERVL-MaLR	2222	+	189	4870650	86183
chr5	132773569	132973569	harbor1	chr5	132786194	132786664	LTR/ERVL-MaLR	2210	+	235	132786429	12860
chr5	132773569	132973569	harbor1	chr5	132802738	132803094	LTR/ERVL-MaLR	2331	+	178	132802916	29347
chr5	132773569	132973569	harbor1	chr5	132835259	132835821	LTR/ERVL-MaLR	835	+	281	132835540	61971
chr5	132773569	132973569	harbor1	chr5	132835920	132836331	LTR/ERVL-MaLR	2623	+	206	132836126	62557
chr5	132773569	132973569	harbor1	chr5	132839870	132839982	LTR/ERVL-MaLR	441	+	56	132839926	66357
chr5	10661192	10861192	harbor1	chr5	10678000	10678459	LTR/ERVL-MaLR	1703	+	230	10678230	17038
chr5	10661192	10861192	harbor1	chr5	10711988	10712339	LTR/ERVL-MaLR	2147	+	176	10712164	50972
chr5	10661192	10861192	harbor1	chr5	10714621	10715043	LTR/ERVL-MaLR	2378	+	211	10714832	53640
chr5	10661192	10861192	harbor1	chr5	10731677	10731849	LTR/ERVL-MaLR	545	+	86	10731763	70571
chr5	10661192	10861192	harbor1	chr5	10735865	10736298	LTR/ERVL-MaLR	1949	+	216	10736081	74889
chr5	10661192	10861192	harbor1	chr5	10737747	10738211	LTR/ERVL-MaLR	2173	+	232	10737979	76787
chr5	10661192	10861192	harbor1	chr5	10751569	10751951	LTR/ERVL-MaLR	1721	+	191	10751760	90568
chr5	10661192	10861192	harbor1	chr5	10755039	10755452	LTR/ERVL-MaLR	1954	+	206	10755245	94053
chr5	73345271	73545271	harbor1	chr5	73348533	73348910	LTR/ERVL-MaLR	2007	+	188	73348721	3450
chr5	73345271	73545271	harbor1	chr5	73385130	73385611	LTR/ERVL-MaLR	1527	+	240	73385370	40099
chr5	73345271	73545271	harbor1	chr5	73386037	73386532	LTR/ERVL-MaLR	2454	+	248	73386285	41014
chr5	133166160	133366160	harbor1	chr5	133191856	133192204	LTR/ERVL-MaLR	1931	+	174	133192030	25870
chr5	73350862	73550862	harbor1	chr5	73385130	73385611	LTR/ERVL-MaLR	1527	+	240	73385370	34508
chr5	73350862	73550862	harbor1	chr5	73386037	73386532	LTR/ERVL-MaLR	2454	+	248	73386285	35423
chr5	133206059	133406059	harbor1	chr5	133279724	133280146	LTR/ERVL-MaLR	1036	+	211	133279935	73876
chr5	133206059	133406059	harbor1	chr5	133293457	133293884	LTR/ERVL-MaLR	1230	+	214	133293671	87612
chr5	135008272	135208272	harbor1	chr5	135089504	135089870	LTR/ERVL-MaLR	2932	+	183	135089687	81415
chr5	380511	580511	harbor1	chr5	386284	386753	LTR/ERVL-MaLR	1590	+	234	386518	6007
chr5	37740476	37940476	harbor1	chr5	37750545	37750878	LTR/ERVL-MaLR	2185	+	166	37750711	10235
chr5	37740476	37940476	harbor1	chr5	37757285	37757745	LTR/ERVL-MaLR	1595	+	230	37757515	17039
chr5	37740476	37940476	harbor1	chr5	37766238	37766671	LTR/ERVL-MaLR	1655	+	216	37766454	25978
chr5	37740476	37940476	harbor1	chr5	37770149	37770550	LTR/ERVL-MaLR	2047	+	200	37770349	29873
chr5	37740476	37940476	harbor1	chr5	37791863	37792160	LTR/ERVL-MaLR	1567	+	148	37792011	51535
chr5	37740476	37940476	harbor1	chr5	37792430	37792467	LTR/ERVL-MaLR	1567	+	18	37792448	51972
chr5	37740476	37940476	harbor1	chr5	37803293	37803645	LTR/ERVL-MaLR	2282	+	176	37803469	62993
chr5	37740476	37940476	harbor1	chr5	37804632	37805189	LTR/ERVL-MaLR	1686	+	278	37804910	64434
chr5	37740476	37940476	harbor1	chr5	37818206	37818573	LTR/ERVL-MaLR	2545	+	184	37818390	77914
chr5	91832	291832	harbor1	chr5	102540	102761	LTR/ERVL-MaLR	1102	+	110	102650	10818
chr5	91832	291832	harbor1	chr5	152717	153070	LTR/ERVL-MaLR	2031	+	176	152893	61061
chr5	73345492	73545492	harbor1	chr5	73348533	73348910	LTR/ERVL-MaLR	2007	+	188	73348721	3229
chr5	73345492	73545492	harbor1	chr5	73385130	73385611	LTR/ERVL-MaLR	1527	+	240	73385370	39878
chr5	73345492	73545492	harbor1	chr5	73386037	73386532	LTR/ERVL-MaLR	2454	+	248	73386285	40793
chr5	73345455	73545455	harbor1	chr5	73348533	73348910	LTR/ERVL-MaLR	2007	+	188	73348721	3266
chr5	73345455	73545455	harbor1	chr5	73385130	73385611	LTR/ERVL-MaLR	1527	+	240	73385370	39915
chr5	73345455	73545455	harbor1	chr5	73386037	73386532	LTR/ERVL-MaLR	2454	+	248	73386285	40830
chr5	9114300	9314300	harbor1	chr5	9114488	9115736	LTR/ERVL-MaLR	4018	+	624	9115112	812
chr5	9114300	9314300	harbor1	chr5	9115746	9116306	LTR/ERVL-MaLR	1006	+	280	9116026	1726
chr5	9114300	9314300	harbor1	chr5	9128239	9128504	LTR/ERVL-MaLR	619	+	132	9128371	14071
chr5	9114300	9314300	harbor1	chr5	9132286	9132620	LTR/ERVL-MaLR	1052	+	167	9132453	18153
chr5	9114300	9314300	harbor1	chr5	9133840	9134200	LTR/ERVL-MaLR	2016	+	180	9134020	19720
chr5	9114300	9314300	harbor1	chr5	9163594	9163965	LTR/ERVL-MaLR	2050	+	186	9163780	49480
chr5	9114300	9314300	harbor1	chr5	9170461	9170824	LTR/ERVL-MaLR	1598	+	182	9170643	56343
chr5	9114300	9314300	harbor1	chr5	9175930	9176586	LTR/ERVL-MaLR	2236	+	328	9176258	61958
chr5	9114300	9314300	harbor1	chr5	9188005	9188360	LTR/ERVL-MaLR	1620	+	178	9188183	73883
chr5	9114300	9314300	harbor1	chr5	9196183	9196546	LTR/ERVL-MaLR	1023	+	182	9196365	82065
chr5	4423791	4623791	harbor1	chr5	4444205	4444355	LTR/ERVL-MaLR	1090	+	75	4444280	20489
chr5	4423791	4623791	harbor1	chr5	4444399	4444512	LTR/ERVL-MaLR	1090	+	56	4444455	20664
chr5	4423791	4623791	harbor1	chr5	4447199	4447696	LTR/ERVL-MaLR	1544	+	248	4447447	23656
chr5	4423791	4623791	harbor1	chr5	4487957	4488184	LTR/ERVL-MaLR	690	+	114	4488071	64280
chr5	4423791	4623791	harbor1	chr5	4506901	4507497	LTR/ERVL-MaLR	1331	+	298	4507199	83408
chr5	4423791	4623791	harbor1	chr5	4472735	4473039	LTR/ERVL-MaLR	1500	+	152	4472887	49096
chr5	91002545	91202545	harbor1	chr5	91078439	91078896	LTR/ERVL-MaLR	531	+	228	91078667	76122
chr5	52700042	52900042	harbor1	chr5	52729943	52730320	LTR/ERVL-MaLR	2360	+	188	52730131	30089
chr5	52700042	52900042	harbor1	chr5	52730321	52731878	LTR/ERVL-MaLR	10715	+	778	52731099	31057
chr5	52700042	52900042	harbor1	chr5	52731879	52732259	LTR/ERVL-MaLR	2154	+	190	52732069	32027
chr5	52700042	52900042	harbor1	chr5	52761018	52761380	LTR/ERVL-MaLR	2582	+	181	52761199	61157
chr5	52700042	52900042	harbor1	chr5	52761953	52762334	LTR/ERVL-MaLR	1456	+	190	52762143	62101
chr5	52700042	52900042	harbor1	chr5	52763403	52763763	LTR/ERVL-MaLR	2140	+	180	52763583	63541
chr6	7626958	7826958	harbor1	chr6	7626949	7627180	LTR/ERVL-MaLR	470	+	116	7627065	107
chr6	7626958	7826958	harbor1	chr6	7627795	7627974	LTR/ERVL-MaLR	480	+	90	7627885	927
chr6	7626958	7826958	harbor1	chr6	7630184	7630393	LTR/ERVL-MaLR	1197	+	104	7630288	3330
chr6	7626958	7826958	harbor1	chr6	7632352	7632875	LTR/ERVL-MaLR	1484	+	262	7632614	5656
chr6	7626958	7826958	harbor1	chr6	7644716	7644877	LTR/ERVL-MaLR	502	+	80	7644796	17838
chr6	7626958	7826958	harbor1	chr6	7644956	7645215	LTR/ERVL-MaLR	449	+	130	7645086	18128
chr6	7626958	7826958	harbor1	chr6	7645245	7645639	LTR/ERVL-MaLR	514	+	197	7645442	18484
chr6	7626958	7826958	harbor1	chr6	7645844	7646205	LTR/ERVL-MaLR	614	+	180	7646024	19066
chr6	7626958	7826958	harbor1	chr6	7667772	7667904	LTR/ERVL-MaLR	459	+	66	7667838	40880
chr6	7626958	7826958	harbor1	chr6	7668682	7668918	LTR/ERVL-MaLR	1409	+	118	7668800	41842
chr6	7626958	7826958	harbor1	chr6	7704487	7704811	LTR/ERVL-MaLR	1610	+	162	7704649	77691
chr6	7626958	7826958	harbor1	chr6	7705132	7705174	LTR/ERVL-MaLR	1610	+	21	7705153	78195
chr6	147103351	147303351	harbor1	chr6	147110389	147110746	LTR/ERVL-MaLR	1325	+	178	147110567	7216
chr6	147103351	147303351	harbor1	chr6	147118786	147119198	LTR/ERVL-MaLR	1328	+	206	147118992	15641
chr6	147103351	147303351	harbor1	chr6	147126605	147127139	LTR/ERVL-MaLR	1546	+	267	147126872	23521
chr6	147103351	147303351	harbor1	chr6	147137791	147138276	LTR/ERVL-MaLR	2242	+	242	147138033	34682
chr6	147103351	147303351	harbor1	chr6	147151743	147151965	LTR/ERVL-MaLR	739	+	111	147151854	48503
chr6	151352847	151552847	harbor1	chr6	151408522	151408938	LTR/ERVL-MaLR	1276	+	208	151408730	55883
chr6	151352847	151552847	harbor1	chr6	151411914	151412020	LTR/ERVL-MaLR	1722	+	53	151411967	59120
chr6	151352847	151552847	harbor1	chr6	151412302	151412317	LTR/ERVL-MaLR	1722	+	8	151412310	59463
chr6	151352847	151552847	harbor1	chr6	151412457	151412570	LTR/ERVL-MaLR	1722	+	56	151412513	59666
chr6	151352847	151552847	harbor1	chr6	151412993	151413248	LTR/ERVL-MaLR	1722	+	128	151413121	60274
chr6	151352847	151552847	harbor1	chr6	151413540	151413599	LTR/ERVL-MaLR	1722	+	30	151413570	60723
chr6	7626630	7826630	harbor1	chr6	7626949	7627180	LTR/ERVL-MaLR	470	+	116	7627065	435
chr6	7626630	7826630	harbor1	chr6	7627795	7627974	LTR/ERVL-MaLR	480	+	90	7627885	1255
chr6	7626630	7826630	harbor1	chr6	7630184	7630393	LTR/ERVL-MaLR	1197	+	104	7630288	3658
chr6	7626630	7826630	harbor1	chr6	7632352	7632875	LTR/ERVL-MaLR	1484	+	262	7632614	5984
chr6	7626630	7826630	harbor1	chr6	7644716	7644877	LTR/ERVL-MaLR	502	+	80	7644796	18166
chr6	7626630	7826630	harbor1	chr6	7644956	7645215	LTR/ERVL-MaLR	449	+	130	7645086	18456
chr6	7626630	7826630	harbor1	chr6	7645245	7645639	LTR/ERVL-MaLR	514	+	197	7645442	18812
chr6	7626630	7826630	harbor1	chr6	7645844	7646205	LTR/ERVL-MaLR	614	+	180	7646024	19394
chr6	7626630	7826630	harbor1	chr6	7667772	7667904	LTR/ERVL-MaLR	459	+	66	7667838	41208
chr6	7626630	7826630	harbor1	chr6	7668682	7668918	LTR/ERVL-MaLR	1409	+	118	7668800	42170
chr6	7626630	7826630	harbor1	chr6	7704487	7704811	LTR/ERVL-MaLR	1610	+	162	7704649	78019
chr6	7626630	7826630	harbor1	chr6	7705132	7705174	LTR/ERVL-MaLR	1610	+	21	7705153	78523
chr6	124862322	125062322	harbor1	chr6	124865521	124865913	LTR/ERVL-MaLR	1643	+	196	124865717	3395
chr6	124862322	125062322	harbor1	chr6	124874004	124874256	LTR/ERVL-MaLR	1299	+	126	124874130	11808
chr6	124862322	125062322	harbor1	chr6	124885690	124886046	LTR/ERVL-MaLR	1502	+	178	124885868	23546
chr6	124862322	125062322	harbor1	chr6	124904073	124904287	LTR/ERVL-MaLR	1437	+	107	124904180	41858
chr6	124862322	125062322	harbor1	chr6	124913773	124914124	LTR/ERVL-MaLR	1294	+	176	124913949	51627
chr6	124862322	125062322	harbor1	chr6	124917132	124917549	LTR/ERVL-MaLR	2159	+	208	124917340	55018
chr6	124862322	125062322	harbor1	chr6	124923462	124923829	LTR/ERVL-MaLR	1450	+	184	124923646	61324
chr6	124862322	125062322	harbor1	chr6	124930528	124930946	LTR/ERVL-MaLR	2520	+	209	124930737	68415
chr6	124862322	125062322	harbor1	chr6	124949751	124950175	LTR/ERVL-MaLR	1763	+	212	124949963	87641
chr6	124862322	125062322	harbor1	chr6	124950465	124950827	LTR/ERVL-MaLR	2375	+	181	124950646	88324
chr6	32869543	33069543	harbor1	chr6	32883201	32883575	LTR/ERVL-MaLR	2056	+	187	32883388	13845
chr6	32869543	33069543	harbor1	chr6	32888606	32888995	LTR/ERVL-MaLR	1398	+	194	32888800	19257
chr6	32869543	33069543	harbor1	chr6	32903192	32903511	LTR/ERVL-MaLR	1154	+	160	32903352	33809
chr6	32869543	33069543	harbor1	chr6	32922472	32922842	LTR/ERVL-MaLR	980	+	185	32922657	53114
chr6	32869543	33069543	harbor1	chr6	32964390	32964561	LTR/ERVL-MaLR	1522	+	86	32964476	94933
chr6	32869543	33069543	harbor1	chr6	32964863	32965066	LTR/ERVL-MaLR	1522	+	102	32964965	95422
chr6	118833199	119033199	harbor1	chr6	118833196	118833393	LTR/ERVL-MaLR	674	+	98	118833294	95
chr6	118833199	119033199	harbor1	chr6	118840209	118840338	LTR/ERVL-MaLR	675	+	64	118840273	7074
chr6	118833199	119033199	harbor1	chr6	118863528	118863918	LTR/ERVL-MaLR	1458	+	195	118863723	30524
chr6	118833199	119033199	harbor1	chr6	118876906	118877337	LTR/ERVL-MaLR	1647	+	216	118877122	43923
chr6	118833199	119033199	harbor1	chr6	118920313	118920459	LTR/ERVL-MaLR	581	+	73	118920386	87187
chr6	118833199	119033199	harbor1	chr6	118920460	118920882	LTR/ERVL-MaLR	2549	+	211	118920671	87472
chr6	118833199	119033199	harbor1	chr6	118920883	118920901	LTR/ERVL-MaLR	581	+	9	118920892	87693
chr6	28999817	29199817	harbor1	chr6	29006914	29007044	LTR/ERVL-MaLR	1377	+	65	29006979	7162
chr6	28999817	29199817	harbor1	chr6	29007360	29007661	LTR/ERVL-MaLR	1377	+	150	29007510	7693
chr6	37002540	37202540	harbor1	chr6	37039524	37039664	LTR/ERVL-MaLR	916	+	70	37039594	37054
chr6	37002540	37202540	harbor1	chr6	37039963	37040251	LTR/ERVL-MaLR	916	+	144	37040107	37567
chr6	37002540	37202540	harbor1	chr6	37041152	37041314	LTR/ERVL-MaLR	1841	+	81	37041233	38693
chr6	37002540	37202540	harbor1	chr6	37041628	37041822	LTR/ERVL-MaLR	1841	+	97	37041725	39185
chr6	37002540	37202540	harbor1	chr6	37042120	37042485	LTR/ERVL-MaLR	1357	+	182	37042302	39762
chr6	37002540	37202540	harbor1	chr6	37042764	37042980	LTR/ERVL-MaLR	872	+	108	37042872	40332
chr6	37002540	37202540	harbor1	chr6	37046605	37046945	LTR/ERVL-MaLR	1774	+	170	37046775	44235
chr6	7626969	7826969	harbor1	chr6	7626949	7627180	LTR/ERVL-MaLR	470	+	116	7627065	96
chr6	7626969	7826969	harbor1	chr6	7627795	7627974	LTR/ERVL-MaLR	480	+	90	7627885	916
chr6	7626969	7826969	harbor1	chr6	7630184	7630393	LTR/ERVL-MaLR	1197	+	104	7630288	3319
chr6	7626969	7826969	harbor1	chr6	7632352	7632875	LTR/ERVL-MaLR	1484	+	262	7632614	5645
chr6	7626969	7826969	harbor1	chr6	7644716	7644877	LTR/ERVL-MaLR	502	+	80	7644796	17827
chr6	7626969	7826969	harbor1	chr6	7644956	7645215	LTR/ERVL-MaLR	449	+	130	7645086	18117
chr6	7626969	7826969	harbor1	chr6	7645245	7645639	LTR/ERVL-MaLR	514	+	197	7645442	18473
chr6	7626969	7826969	harbor1	chr6	7645844	7646205	LTR/ERVL-MaLR	614	+	180	7646024	19055
chr6	7626969	7826969	harbor1	chr6	7667772	7667904	LTR/ERVL-MaLR	459	+	66	7667838	40869
chr6	7626969	7826969	harbor1	chr6	7668682	7668918	LTR/ERVL-MaLR	1409	+	118	7668800	41831
chr6	7626969	7826969	harbor1	chr6	7704487	7704811	LTR/ERVL-MaLR	1610	+	162	7704649	77680
chr6	7626969	7826969	harbor1	chr6	7705132	7705174	LTR/ERVL-MaLR	1610	+	21	7705153	78184
chr6	7332945	7532945	harbor1	chr6	7375931	7376107	LTR/ERVL-MaLR	1617	+	88	7376019	43074
chr6	7332945	7532945	harbor1	chr6	7376442	7376644	LTR/ERVL-MaLR	1617	+	101	7376543	43598
chr6	7332945	7532945	harbor1	chr6	7381112	7381506	LTR/ERVL-MaLR	2282	+	197	7381309	48364
chr6	7332945	7532945	harbor1	chr6	7382956	7383306	LTR/ERVL-MaLR	2092	+	175	7383131	50186
chr6	139275442	139475442	harbor1	chr6	139292930	139293097	LTR/ERVL-MaLR	1843	+	84	139293014	17572
chr6	139275442	139475442	harbor1	chr6	139293390	139293676	LTR/ERVL-MaLR	1843	+	143	139293533	18091
chr6	139275442	139475442	harbor1	chr6	139294408	139294707	LTR/ERVL-MaLR	1885	+	150	139294558	19116
chr6	139275442	139475442	harbor1	chr6	139295002	139295058	LTR/ERVL-MaLR	1885	+	28	139295030	19588
chr6	139275442	139475442	harbor1	chr6	139298726	139299131	LTR/ERVL-MaLR	1974	+	202	139298928	23486
chr6	139275442	139475442	harbor1	chr6	139321167	139321532	LTR/ERVL-MaLR	2142	+	182	139321349	45907
chr6	139275442	139475442	harbor1	chr6	139333162	139333302	LTR/ERVL-MaLR	1348	+	70	139333232	57790
chr6	139275442	139475442	harbor1	chr6	139333595	139333823	LTR/ERVL-MaLR	1348	+	114	139333709	58267
chr6	139275442	139475442	harbor1	chr6	139358600	139358929	LTR/ERVL-MaLR	1756	+	164	139358764	83322
chr6	139275442	139475442	harbor1	chr6	139360830	139361023	LTR/ERVL-MaLR	634	+	96	139360926	85484
chr6	89849514	90049514	harbor1	chr6	89939044	89939501	LTR/ERVL-MaLR	1718	+	228	89939272	89758
chr6	41537009	41737009	harbor1	chr6	41632635	41632816	LTR/ERVL-MaLR	1615	+	90	41632725	95716
chr6	41537009	41737009	harbor1	chr6	41633113	41633413	LTR/ERVL-MaLR	1615	+	150	41633263	96254
chr6	15417264	15617264	harbor1	chr6	15425429	15425779	LTR/ERVL-MaLR	1190	+	175	15425604	8340
chr6	169864030	170064030	harbor1	chr6	169903832	169904031	LTR/ERVL-MaLR	642	+	100	169903932	39902
chr6	169864030	170064030	harbor1	chr6	169904028	169904309	LTR/ERVL-MaLR	599	+	140	169904168	40138
chr6	169864030	170064030	harbor1	chr6	169933845	169934173	LTR/ERVL-MaLR	751	+	164	169934009	69979
chr6	169864030	170064030	harbor1	chr6	169951162	169951692	LTR/ERVL-MaLR	1371	+	265	169951427	87397
chr6	139275115	139475115	harbor1	chr6	139292930	139293097	LTR/ERVL-MaLR	1843	+	84	139293014	17899
chr6	139275115	139475115	harbor1	chr6	139293390	139293676	LTR/ERVL-MaLR	1843	+	143	139293533	18418
chr6	139275115	139475115	harbor1	chr6	139294408	139294707	LTR/ERVL-MaLR	1885	+	150	139294558	19443
chr6	139275115	139475115	harbor1	chr6	139295002	139295058	LTR/ERVL-MaLR	1885	+	28	139295030	19915
chr6	139275115	139475115	harbor1	chr6	139298726	139299131	LTR/ERVL-MaLR	1974	+	202	139298928	23813
chr6	139275115	139475115	harbor1	chr6	139321167	139321532	LTR/ERVL-MaLR	2142	+	182	139321349	46234
chr6	139275115	139475115	harbor1	chr6	139333162	139333302	LTR/ERVL-MaLR	1348	+	70	139333232	58117
chr6	139275115	139475115	harbor1	chr6	139333595	139333823	LTR/ERVL-MaLR	1348	+	114	139333709	58594
chr6	139275115	139475115	harbor1	chr6	139358600	139358929	LTR/ERVL-MaLR	1756	+	164	139358764	83649
chr6	139275115	139475115	harbor1	chr6	139360830	139361023	LTR/ERVL-MaLR	634	+	96	139360926	85811
chr6	43072122	43272122	harbor1	chr6	43105491	43105950	LTR/ERVL-MaLR	1861	+	230	43105721	33599
chr6	149350987	149550987	harbor1	chr6	149445653	149445774	LTR/ERVL-MaLR	513	+	60	149445713	94726
chr6	7626955	7826955	harbor1	chr6	7626949	7627180	LTR/ERVL-MaLR	470	+	116	7627065	110
chr6	7626955	7826955	harbor1	chr6	7627795	7627974	LTR/ERVL-MaLR	480	+	90	7627885	930
chr6	7626955	7826955	harbor1	chr6	7630184	7630393	LTR/ERVL-MaLR	1197	+	104	7630288	3333
chr6	7626955	7826955	harbor1	chr6	7632352	7632875	LTR/ERVL-MaLR	1484	+	262	7632614	5659
chr6	7626955	7826955	harbor1	chr6	7644716	7644877	LTR/ERVL-MaLR	502	+	80	7644796	17841
chr6	7626955	7826955	harbor1	chr6	7644956	7645215	LTR/ERVL-MaLR	449	+	130	7645086	18131
chr6	7626955	7826955	harbor1	chr6	7645245	7645639	LTR/ERVL-MaLR	514	+	197	7645442	18487
chr6	7626955	7826955	harbor1	chr6	7645844	7646205	LTR/ERVL-MaLR	614	+	180	7646024	19069
chr6	7626955	7826955	harbor1	chr6	7667772	7667904	LTR/ERVL-MaLR	459	+	66	7667838	40883
chr6	7626955	7826955	harbor1	chr6	7668682	7668918	LTR/ERVL-MaLR	1409	+	118	7668800	41845
chr6	7626955	7826955	harbor1	chr6	7704487	7704811	LTR/ERVL-MaLR	1610	+	162	7704649	77694
chr6	7626955	7826955	harbor1	chr6	7705132	7705174	LTR/ERVL-MaLR	1610	+	21	7705153	78198
chr6	63473404	63673404	harbor1	chr6	63516692	63517056	LTR/ERVL-MaLR	836	+	182	63516874	43470
chr6	139275101	139475101	harbor1	chr6	139292930	139293097	LTR/ERVL-MaLR	1843	+	84	139293014	17913
chr6	139275101	139475101	harbor1	chr6	139293390	139293676	LTR/ERVL-MaLR	1843	+	143	139293533	18432
chr6	139275101	139475101	harbor1	chr6	139294408	139294707	LTR/ERVL-MaLR	1885	+	150	139294558	19457
chr6	139275101	139475101	harbor1	chr6	139295002	139295058	LTR/ERVL-MaLR	1885	+	28	139295030	19929
chr6	139275101	139475101	harbor1	chr6	139298726	139299131	LTR/ERVL-MaLR	1974	+	202	139298928	23827
chr6	139275101	139475101	harbor1	chr6	139321167	139321532	LTR/ERVL-MaLR	2142	+	182	139321349	46248
chr6	139275101	139475101	harbor1	chr6	139333162	139333302	LTR/ERVL-MaLR	1348	+	70	139333232	58131
chr6	139275101	139475101	harbor1	chr6	139333595	139333823	LTR/ERVL-MaLR	1348	+	114	139333709	58608
chr6	139275101	139475101	harbor1	chr6	139358600	139358929	LTR/ERVL-MaLR	1756	+	164	139358764	83663
chr6	139275101	139475101	harbor1	chr6	139360830	139361023	LTR/ERVL-MaLR	634	+	96	139360926	85825
chr6	169862720	170062720	harbor1	chr6	169903832	169904031	LTR/ERVL-MaLR	642	+	100	169903932	41212
chr6	169862720	170062720	harbor1	chr6	169904028	169904309	LTR/ERVL-MaLR	599	+	140	169904168	41448
chr6	169862720	170062720	harbor1	chr6	169933845	169934173	LTR/ERVL-MaLR	751	+	164	169934009	71289
chr6	169862720	170062720	harbor1	chr6	169951162	169951692	LTR/ERVL-MaLR	1371	+	265	169951427	88707
chr6	41091927	41291927	harbor1	chr6	41176680	41177075	LTR/ERVL-MaLR	1359	+	198	41176878	84951
chr6	41091927	41291927	harbor1	chr6	41182694	41183023	LTR/ERVL-MaLR	596	+	164	41182858	90931
chr6	139274669	139474669	harbor1	chr6	139292930	139293097	LTR/ERVL-MaLR	1843	+	84	139293014	18345
chr6	139274669	139474669	harbor1	chr6	139293390	139293676	LTR/ERVL-MaLR	1843	+	143	139293533	18864
chr6	139274669	139474669	harbor1	chr6	139294408	139294707	LTR/ERVL-MaLR	1885	+	150	139294558	19889
chr6	139274669	139474669	harbor1	chr6	139295002	139295058	LTR/ERVL-MaLR	1885	+	28	139295030	20361
chr6	139274669	139474669	harbor1	chr6	139298726	139299131	LTR/ERVL-MaLR	1974	+	202	139298928	24259
chr6	139274669	139474669	harbor1	chr6	139321167	139321532	LTR/ERVL-MaLR	2142	+	182	139321349	46680
chr6	139274669	139474669	harbor1	chr6	139333162	139333302	LTR/ERVL-MaLR	1348	+	70	139333232	58563
chr6	139274669	139474669	harbor1	chr6	139333595	139333823	LTR/ERVL-MaLR	1348	+	114	139333709	59040
chr6	139274669	139474669	harbor1	chr6	139358600	139358929	LTR/ERVL-MaLR	1756	+	164	139358764	84095
chr6	139274669	139474669	harbor1	chr6	139360830	139361023	LTR/ERVL-MaLR	634	+	96	139360926	86257
chr6	139272471	139472471	harbor1	chr6	139292930	139293097	LTR/ERVL-MaLR	1843	+	84	139293014	20543
chr6	139272471	139472471	harbor1	chr6	139293390	139293676	LTR/ERVL-MaLR	1843	+	143	139293533	21062
chr6	139272471	139472471	harbor1	chr6	139294408	139294707	LTR/ERVL-MaLR	1885	+	150	139294558	22087
chr6	139272471	139472471	harbor1	chr6	139295002	139295058	LTR/ERVL-MaLR	1885	+	28	139295030	22559
chr6	139272471	139472471	harbor1	chr6	139298726	139299131	LTR/ERVL-MaLR	1974	+	202	139298928	26457
chr6	139272471	139472471	harbor1	chr6	139321167	139321532	LTR/ERVL-MaLR	2142	+	182	139321349	48878
chr6	139272471	139472471	harbor1	chr6	139333162	139333302	LTR/ERVL-MaLR	1348	+	70	139333232	60761
chr6	139272471	139472471	harbor1	chr6	139333595	139333823	LTR/ERVL-MaLR	1348	+	114	139333709	61238
chr6	139272471	139472471	harbor1	chr6	139358600	139358929	LTR/ERVL-MaLR	1756	+	164	139358764	86293
chr6	139272471	139472471	harbor1	chr6	139360830	139361023	LTR/ERVL-MaLR	634	+	96	139360926	88455
chr6	35352657	35552657	harbor1	chr6	35357983	35358483	LTR/ERVL-MaLR	2281	+	250	35358233	5576
chr6	2665180	2865180	harbor1	chr6	2696318	2696666	LTR/ERVL-MaLR	1355	+	174	2696492	31312
chr6	89719739	89919739	harbor1	chr6	89768183	89768542	LTR/ERVL-MaLR	2493	+	180	89768363	48624
chr6	89719739	89919739	harbor1	chr6	89773104	89773259	LTR/ERVL-MaLR	1365	+	78	89773182	53443
chr6	89719739	89919739	harbor1	chr6	89773569	89773682	LTR/ERVL-MaLR	1365	+	56	89773625	53886
chr6	89719739	89919739	harbor1	chr6	89773994	89774178	LTR/ERVL-MaLR	1365	+	92	89774086	54347
chr6	167788720	167988720	harbor1	chr6	167789402	167789757	LTR/ERVL-MaLR	676	+	178	167789580	860
chr6	167788720	167988720	harbor1	chr6	167792697	167793051	LTR/ERVL-MaLR	2900	+	177	167792874	4154
chr6	167788720	167988720	harbor1	chr6	167801967	167802339	LTR/ERVL-MaLR	1713	+	186	167802153	13433
chr6	167788720	167988720	harbor1	chr6	167840345	167840647	LTR/ERVL-MaLR	621	+	151	167840496	51776
chr6	7623404	7823404	harbor1	chr6	7626949	7627180	LTR/ERVL-MaLR	470	+	116	7627065	3661
chr6	7623404	7823404	harbor1	chr6	7627795	7627974	LTR/ERVL-MaLR	480	+	90	7627885	4481
chr6	7623404	7823404	harbor1	chr6	7630184	7630393	LTR/ERVL-MaLR	1197	+	104	7630288	6884
chr6	7623404	7823404	harbor1	chr6	7632352	7632875	LTR/ERVL-MaLR	1484	+	262	7632614	9210
chr6	7623404	7823404	harbor1	chr6	7644716	7644877	LTR/ERVL-MaLR	502	+	80	7644796	21392
chr6	7623404	7823404	harbor1	chr6	7644956	7645215	LTR/ERVL-MaLR	449	+	130	7645086	21682
chr6	7623404	7823404	harbor1	chr6	7645245	7645639	LTR/ERVL-MaLR	514	+	197	7645442	22038
chr6	7623404	7823404	harbor1	chr6	7645844	7646205	LTR/ERVL-MaLR	614	+	180	7646024	22620
chr6	7623404	7823404	harbor1	chr6	7667772	7667904	LTR/ERVL-MaLR	459	+	66	7667838	44434
chr6	7623404	7823404	harbor1	chr6	7668682	7668918	LTR/ERVL-MaLR	1409	+	118	7668800	45396
chr6	7623404	7823404	harbor1	chr6	7704487	7704811	LTR/ERVL-MaLR	1610	+	162	7704649	81245
chr6	7623404	7823404	harbor1	chr6	7705132	7705174	LTR/ERVL-MaLR	1610	+	21	7705153	81749
chr6	6446445	6646445	harbor1	chr6	6447475	6447905	LTR/ERVL-MaLR	789	+	215	6447690	1245
chr6	6446445	6646445	harbor1	chr6	6463593	6463958	LTR/ERVL-MaLR	2576	+	182	6463775	17330
chr6	6446445	6646445	harbor1	chr6	6469792	6470298	LTR/ERVL-MaLR	2015	+	253	6470045	23600
chr6	6446445	6646445	harbor1	chr6	6489700	6489900	LTR/ERVL-MaLR	762	+	100	6489800	43355
chr6	6446445	6646445	harbor1	chr6	6490554	6490754	LTR/ERVL-MaLR	661	+	100	6490654	44209
chr6	6446445	6646445	harbor1	chr6	6528915	6529237	LTR/ERVL-MaLR	682	+	161	6529076	82631
chr6	127167321	127367321	harbor1	chr6	127223966	127224335	LTR/ERVL-MaLR	2492	+	184	127224150	56829
chr6	139275457	139475457	harbor1	chr6	139292930	139293097	LTR/ERVL-MaLR	1843	+	84	139293014	17557
chr6	139275457	139475457	harbor1	chr6	139293390	139293676	LTR/ERVL-MaLR	1843	+	143	139293533	18076
chr6	139275457	139475457	harbor1	chr6	139294408	139294707	LTR/ERVL-MaLR	1885	+	150	139294558	19101
chr6	139275457	139475457	harbor1	chr6	139295002	139295058	LTR/ERVL-MaLR	1885	+	28	139295030	19573
chr6	139275457	139475457	harbor1	chr6	139298726	139299131	LTR/ERVL-MaLR	1974	+	202	139298928	23471
chr6	139275457	139475457	harbor1	chr6	139321167	139321532	LTR/ERVL-MaLR	2142	+	182	139321349	45892
chr6	139275457	139475457	harbor1	chr6	139333162	139333302	LTR/ERVL-MaLR	1348	+	70	139333232	57775
chr6	139275457	139475457	harbor1	chr6	139333595	139333823	LTR/ERVL-MaLR	1348	+	114	139333709	58252
chr6	139275457	139475457	harbor1	chr6	139358600	139358929	LTR/ERVL-MaLR	1756	+	164	139358764	83307
chr6	139275457	139475457	harbor1	chr6	139360830	139361023	LTR/ERVL-MaLR	634	+	96	139360926	85469
chr6	63473429	63673429	harbor1	chr6	63516692	63517056	LTR/ERVL-MaLR	836	+	182	63516874	43445
chr6	7626967	7826967	harbor1	chr6	7626949	7627180	LTR/ERVL-MaLR	470	+	116	7627065	98
chr6	7626967	7826967	harbor1	chr6	7627795	7627974	LTR/ERVL-MaLR	480	+	90	7627885	918
chr6	7626967	7826967	harbor1	chr6	7630184	7630393	LTR/ERVL-MaLR	1197	+	104	7630288	3321
chr6	7626967	7826967	harbor1	chr6	7632352	7632875	LTR/ERVL-MaLR	1484	+	262	7632614	5647
chr6	7626967	7826967	harbor1	chr6	7644716	7644877	LTR/ERVL-MaLR	502	+	80	7644796	17829
chr6	7626967	7826967	harbor1	chr6	7644956	7645215	LTR/ERVL-MaLR	449	+	130	7645086	18119
chr6	7626967	7826967	harbor1	chr6	7645245	7645639	LTR/ERVL-MaLR	514	+	197	7645442	18475
chr6	7626967	7826967	harbor1	chr6	7645844	7646205	LTR/ERVL-MaLR	614	+	180	7646024	19057
chr6	7626967	7826967	harbor1	chr6	7667772	7667904	LTR/ERVL-MaLR	459	+	66	7667838	40871
chr6	7626967	7826967	harbor1	chr6	7668682	7668918	LTR/ERVL-MaLR	1409	+	118	7668800	41833
chr6	7626967	7826967	harbor1	chr6	7704487	7704811	LTR/ERVL-MaLR	1610	+	162	7704649	77682
chr6	7626967	7826967	harbor1	chr6	7705132	7705174	LTR/ERVL-MaLR	1610	+	21	7705153	78186
chr6	139275547	139475547	harbor1	chr6	139292930	139293097	LTR/ERVL-MaLR	1843	+	84	139293014	17467
chr6	139275547	139475547	harbor1	chr6	139293390	139293676	LTR/ERVL-MaLR	1843	+	143	139293533	17986
chr6	139275547	139475547	harbor1	chr6	139294408	139294707	LTR/ERVL-MaLR	1885	+	150	139294558	19011
chr6	139275547	139475547	harbor1	chr6	139295002	139295058	LTR/ERVL-MaLR	1885	+	28	139295030	19483
chr6	139275547	139475547	harbor1	chr6	139298726	139299131	LTR/ERVL-MaLR	1974	+	202	139298928	23381
chr6	139275547	139475547	harbor1	chr6	139321167	139321532	LTR/ERVL-MaLR	2142	+	182	139321349	45802
chr6	139275547	139475547	harbor1	chr6	139333162	139333302	LTR/ERVL-MaLR	1348	+	70	139333232	57685
chr6	139275547	139475547	harbor1	chr6	139333595	139333823	LTR/ERVL-MaLR	1348	+	114	139333709	58162
chr6	139275547	139475547	harbor1	chr6	139358600	139358929	LTR/ERVL-MaLR	1756	+	164	139358764	83217
chr6	139275547	139475547	harbor1	chr6	139360830	139361023	LTR/ERVL-MaLR	634	+	96	139360926	85379
chr6	139274614	139474614	harbor1	chr6	139292930	139293097	LTR/ERVL-MaLR	1843	+	84	139293014	18400
chr6	139274614	139474614	harbor1	chr6	139293390	139293676	LTR/ERVL-MaLR	1843	+	143	139293533	18919
chr6	139274614	139474614	harbor1	chr6	139294408	139294707	LTR/ERVL-MaLR	1885	+	150	139294558	19944
chr6	139274614	139474614	harbor1	chr6	139295002	139295058	LTR/ERVL-MaLR	1885	+	28	139295030	20416
chr6	139274614	139474614	harbor1	chr6	139298726	139299131	LTR/ERVL-MaLR	1974	+	202	139298928	24314
chr6	139274614	139474614	harbor1	chr6	139321167	139321532	LTR/ERVL-MaLR	2142	+	182	139321349	46735
chr6	139274614	139474614	harbor1	chr6	139333162	139333302	LTR/ERVL-MaLR	1348	+	70	139333232	58618
chr6	139274614	139474614	harbor1	chr6	139333595	139333823	LTR/ERVL-MaLR	1348	+	114	139333709	59095
chr6	139274614	139474614	harbor1	chr6	139358600	139358929	LTR/ERVL-MaLR	1756	+	164	139358764	84150
chr6	139274614	139474614	harbor1	chr6	139360830	139361023	LTR/ERVL-MaLR	634	+	96	139360926	86312
chr6	166056777	166256777	harbor1	chr6	166063225	166063632	LTR/ERVL-MaLR	2560	+	204	166063429	6652
chr6	166056777	166256777	harbor1	chr6	166069478	166069858	LTR/ERVL-MaLR	2360	+	190	166069668	12891
chr6	166056777	166256777	harbor1	chr6	166143361	166143715	LTR/ERVL-MaLR	2408	+	177	166143538	86761
chr6	43872397	44072397	harbor1	chr6	43881436	43881831	LTR/ERVL-MaLR	2405	+	198	43881634	9237
chr6	43872397	44072397	harbor1	chr6	43898306	43898741	LTR/ERVL-MaLR	1333	+	218	43898524	26127
chr6	43872397	44072397	harbor1	chr6	43898848	43899275	LTR/ERVL-MaLR	1141	+	214	43899062	26665
chr6	139274583	139474583	harbor1	chr6	139292930	139293097	LTR/ERVL-MaLR	1843	+	84	139293014	18431
chr6	139274583	139474583	harbor1	chr6	139293390	139293676	LTR/ERVL-MaLR	1843	+	143	139293533	18950
chr6	139274583	139474583	harbor1	chr6	139294408	139294707	LTR/ERVL-MaLR	1885	+	150	139294558	19975
chr6	139274583	139474583	harbor1	chr6	139295002	139295058	LTR/ERVL-MaLR	1885	+	28	139295030	20447
chr6	139274583	139474583	harbor1	chr6	139298726	139299131	LTR/ERVL-MaLR	1974	+	202	139298928	24345
chr6	139274583	139474583	harbor1	chr6	139321167	139321532	LTR/ERVL-MaLR	2142	+	182	139321349	46766
chr6	139274583	139474583	harbor1	chr6	139333162	139333302	LTR/ERVL-MaLR	1348	+	70	139333232	58649
chr6	139274583	139474583	harbor1	chr6	139333595	139333823	LTR/ERVL-MaLR	1348	+	114	139333709	59126
chr6	139274583	139474583	harbor1	chr6	139358600	139358929	LTR/ERVL-MaLR	1756	+	164	139358764	84181
chr6	139274583	139474583	harbor1	chr6	139360830	139361023	LTR/ERVL-MaLR	634	+	96	139360926	86343
chr6	165559080	165759080	harbor1	chr6	165559660	165560013	LTR/ERVL-MaLR	2208	+	176	165559836	756
chr6	165559080	165759080	harbor1	chr6	165560780	165560937	LTR/ERVL-MaLR	1651	+	78	165560858	1778
chr6	165559080	165759080	harbor1	chr6	165561234	165561444	LTR/ERVL-MaLR	1651	+	105	165561339	2259
chr6	165559080	165759080	harbor1	chr6	165570006	165570165	LTR/ERVL-MaLR	958	+	80	165570086	11006
chr6	165559080	165759080	harbor1	chr6	165581249	165581627	LTR/ERVL-MaLR	1288	+	189	165581438	22358
chr6	165559080	165759080	harbor1	chr6	165583373	165583508	LTR/ERVL-MaLR	540	+	68	165583441	24361
chr6	165559080	165759080	harbor1	chr6	165585385	165585777	LTR/ERVL-MaLR	981	+	196	165585581	26501
chr6	165559080	165759080	harbor1	chr6	165600980	165601328	LTR/ERVL-MaLR	2629	+	174	165601154	42074
chr6	165559080	165759080	harbor1	chr6	165622809	165623144	LTR/ERVL-MaLR	2305	+	168	165622977	63897
chr6	165559080	165759080	harbor1	chr6	165623418	165623458	LTR/ERVL-MaLR	2305	+	20	165623438	64358
chr6	165559080	165759080	harbor1	chr6	165560109	165560578	LTR/ERVL-MaLR	1553	+	234	165560343	1263
chr6	165559080	165759080	harbor1	chr6	165625520	165625871	LTR/ERVL-MaLR	2507	+	176	165625696	66616
chr6	33522113	33722113	harbor1	chr6	33528605	33528805	LTR/ERVL-MaLR	693	+	100	33528705	6592
chr6	33522113	33722113	harbor1	chr6	33558892	33558983	LTR/ERVL-MaLR	1386	+	46	33558938	36825
chr6	33522113	33722113	harbor1	chr6	33559286	33559313	LTR/ERVL-MaLR	1386	+	14	33559300	37187
chr6	33522113	33722113	harbor1	chr6	33559582	33559694	LTR/ERVL-MaLR	1386	+	56	33559638	37525
chr6	33522113	33722113	harbor1	chr6	33559983	33560405	LTR/ERVL-MaLR	1386	+	211	33560194	38081
chr6	33522113	33722113	harbor1	chr6	33560719	33560858	LTR/ERVL-MaLR	672	+	70	33560789	38676
chr6	33522113	33722113	harbor1	chr6	33561164	33561185	LTR/ERVL-MaLR	672	+	10	33561174	39061
chr6	33522113	33722113	harbor1	chr6	33561185	33561263	LTR/ERVL-MaLR	950	+	39	33561224	39111
chr6	33522113	33722113	harbor1	chr6	33561563	33561688	LTR/ERVL-MaLR	950	+	62	33561625	39512
chr6	33522113	33722113	harbor1	chr6	33561993	33562146	LTR/ERVL-MaLR	950	+	76	33562069	39956
chr6	127167375	127367375	harbor1	chr6	127223966	127224335	LTR/ERVL-MaLR	2492	+	184	127224150	56775
chr6	127167314	127367314	harbor1	chr6	127223966	127224335	LTR/ERVL-MaLR	2492	+	184	127224150	56836
chr6	52184772	52384772	harbor1	chr6	52194942	52195309	LTR/ERVL-MaLR	2234	+	184	52195126	10354
chr6	52184772	52384772	harbor1	chr6	52218488	52218829	LTR/ERVL-MaLR	1050	+	170	52218658	33886
chr6	52184772	52384772	harbor1	chr6	52218831	52220495	LTR/ERVL-MaLR	5439	+	832	52219663	34891
chr6	52184772	52384772	harbor1	chr6	52220645	52220857	LTR/ERVL-MaLR	961	+	106	52220751	35979
chr6	52184772	52384772	harbor1	chr6	52250318	52250620	LTR/ERVL-MaLR	1204	+	151	52250469	65697
chr6	169864008	170064008	harbor1	chr6	169903832	169904031	LTR/ERVL-MaLR	642	+	100	169903932	39924
chr6	169864008	170064008	harbor1	chr6	169904028	169904309	LTR/ERVL-MaLR	599	+	140	169904168	40160
chr6	169864008	170064008	harbor1	chr6	169933845	169934173	LTR/ERVL-MaLR	751	+	164	169934009	70001
chr6	169864008	170064008	harbor1	chr6	169951162	169951692	LTR/ERVL-MaLR	1371	+	265	169951427	87419
chr6	139275131	139475131	harbor1	chr6	139292930	139293097	LTR/ERVL-MaLR	1843	+	84	139293014	17883
chr6	139275131	139475131	harbor1	chr6	139293390	139293676	LTR/ERVL-MaLR	1843	+	143	139293533	18402
chr6	139275131	139475131	harbor1	chr6	139294408	139294707	LTR/ERVL-MaLR	1885	+	150	139294558	19427
chr6	139275131	139475131	harbor1	chr6	139295002	139295058	LTR/ERVL-MaLR	1885	+	28	139295030	19899
chr6	139275131	139475131	harbor1	chr6	139298726	139299131	LTR/ERVL-MaLR	1974	+	202	139298928	23797
chr6	139275131	139475131	harbor1	chr6	139321167	139321532	LTR/ERVL-MaLR	2142	+	182	139321349	46218
chr6	139275131	139475131	harbor1	chr6	139333162	139333302	LTR/ERVL-MaLR	1348	+	70	139333232	58101
chr6	139275131	139475131	harbor1	chr6	139333595	139333823	LTR/ERVL-MaLR	1348	+	114	139333709	58578
chr6	139275131	139475131	harbor1	chr6	139358600	139358929	LTR/ERVL-MaLR	1756	+	164	139358764	83633
chr6	139275131	139475131	harbor1	chr6	139360830	139361023	LTR/ERVL-MaLR	634	+	96	139360926	85795
chr6	7212661	7412661	harbor1	chr6	7264698	7265027	LTR/ERVL-MaLR	1253	+	164	7264862	52201
chr6	7212661	7412661	harbor1	chr6	7309501	7309873	LTR/ERVL-MaLR	2636	+	186	7309687	97026
chr6	127167318	127367318	harbor1	chr6	127223966	127224335	LTR/ERVL-MaLR	2492	+	184	127224150	56832
chr6	30386552	30586552	harbor1	chr6	30402588	30402719	LTR/ERVL-MaLR	854	+	66	30402654	16102
chr6	30386552	30586552	harbor1	chr6	30405049	30405386	LTR/ERVL-MaLR	754	+	168	30405217	18665
chr6	30386552	30586552	harbor1	chr6	30407106	30408342	LTR/ERVL-MaLR	9376	+	618	30407724	21172
chr6	30386552	30586552	harbor1	chr6	30408343	30408695	LTR/ERVL-MaLR	2120	+	176	30408519	21967
chr6	139275446	139475446	harbor1	chr6	139292930	139293097	LTR/ERVL-MaLR	1843	+	84	139293014	17568
chr6	139275446	139475446	harbor1	chr6	139293390	139293676	LTR/ERVL-MaLR	1843	+	143	139293533	18087
chr6	139275446	139475446	harbor1	chr6	139294408	139294707	LTR/ERVL-MaLR	1885	+	150	139294558	19112
chr6	139275446	139475446	harbor1	chr6	139295002	139295058	LTR/ERVL-MaLR	1885	+	28	139295030	19584
chr6	139275446	139475446	harbor1	chr6	139298726	139299131	LTR/ERVL-MaLR	1974	+	202	139298928	23482
chr6	139275446	139475446	harbor1	chr6	139321167	139321532	LTR/ERVL-MaLR	2142	+	182	139321349	45903
chr6	139275446	139475446	harbor1	chr6	139333162	139333302	LTR/ERVL-MaLR	1348	+	70	139333232	57786
chr6	139275446	139475446	harbor1	chr6	139333595	139333823	LTR/ERVL-MaLR	1348	+	114	139333709	58263
chr6	139275446	139475446	harbor1	chr6	139358600	139358929	LTR/ERVL-MaLR	1756	+	164	139358764	83318
chr6	139275446	139475446	harbor1	chr6	139360830	139361023	LTR/ERVL-MaLR	634	+	96	139360926	85480
chr6	43738762	43938762	harbor1	chr6	43790673	43790847	LTR/ERVL-MaLR	445	+	87	43790760	51998
chr6	43738762	43938762	harbor1	chr6	43790967	43791221	LTR/ERVL-MaLR	530	+	127	43791094	52332
chr6	52476001	52676001	harbor1	chr6	52485472	52485900	LTR/ERVL-MaLR	2015	+	214	52485686	9685
chr6	52476001	52676001	harbor1	chr6	52525814	52526139	LTR/ERVL-MaLR	1445	+	162	52525976	49975
chr6	52476001	52676001	harbor1	chr6	52530400	52530844	LTR/ERVL-MaLR	1950	+	222	52530622	54621
chr6	52476001	52676001	harbor1	chr6	52569027	52569112	LTR/ERVL-MaLR	457	+	42	52569069	93068
chr6	52476001	52676001	harbor1	chr6	52569416	52569474	LTR/ERVL-MaLR	457	+	29	52569445	93444
chr6	127167369	127367369	harbor1	chr6	127223966	127224335	LTR/ERVL-MaLR	2492	+	184	127224150	56781
chr6	37183201	37383201	harbor1	chr6	37189262	37189430	LTR/ERVL-MaLR	482	+	84	37189346	6145
chr6	37183201	37383201	harbor1	chr6	37209072	37209225	LTR/ERVL-MaLR	746	+	76	37209148	25947
chr6	37183201	37383201	harbor1	chr6	37216674	37217018	LTR/ERVL-MaLR	1682	+	172	37216846	33645
chr6	37183201	37383201	harbor1	chr6	37225670	37225897	LTR/ERVL-MaLR	701	+	114	37225784	42583
chr6	37183201	37383201	harbor1	chr6	37230366	37230755	LTR/ERVL-MaLR	2028	+	194	37230560	47359
chr6	37183201	37383201	harbor1	chr6	37250869	37251190	LTR/ERVL-MaLR	1765	+	160	37251029	67828
chr6	37183201	37383201	harbor1	chr6	37272805	37273219	LTR/ERVL-MaLR	448	+	207	37273012	89811
chr6	37002552	37202552	harbor1	chr6	37039524	37039664	LTR/ERVL-MaLR	916	+	70	37039594	37042
chr6	37002552	37202552	harbor1	chr6	37039963	37040251	LTR/ERVL-MaLR	916	+	144	37040107	37555
chr6	37002552	37202552	harbor1	chr6	37041152	37041314	LTR/ERVL-MaLR	1841	+	81	37041233	38681
chr6	37002552	37202552	harbor1	chr6	37041628	37041822	LTR/ERVL-MaLR	1841	+	97	37041725	39173
chr6	37002552	37202552	harbor1	chr6	37042120	37042485	LTR/ERVL-MaLR	1357	+	182	37042302	39750
chr6	37002552	37202552	harbor1	chr6	37042764	37042980	LTR/ERVL-MaLR	872	+	108	37042872	40320
chr6	37002552	37202552	harbor1	chr6	37046605	37046945	LTR/ERVL-MaLR	1774	+	170	37046775	44223
chr6	30366711	30566711	harbor1	chr6	30402588	30402719	LTR/ERVL-MaLR	854	+	66	30402654	35943
chr6	30366711	30566711	harbor1	chr6	30405049	30405386	LTR/ERVL-MaLR	754	+	168	30405217	38506
chr6	30366711	30566711	harbor1	chr6	30407106	30408342	LTR/ERVL-MaLR	9376	+	618	30407724	41013
chr6	30366711	30566711	harbor1	chr6	30408343	30408695	LTR/ERVL-MaLR	2120	+	176	30408519	41808
chr6	108461047	108661047	harbor1	chr6	108466402	108466867	LTR/ERVL-MaLR	1348	+	232	108466634	5587
chr6	27415396	27615396	harbor1	chr6	27430367	27430783	LTR/ERVL-MaLR	1440	+	208	27430575	15179
chr6	27415396	27615396	harbor1	chr6	27432662	27433234	LTR/ERVL-MaLR	1708	+	286	27432948	17552
chr6	27415396	27615396	harbor1	chr6	27437089	27437672	LTR/ERVL-MaLR	2139	+	292	27437381	21985
chr6	27415396	27615396	harbor1	chr6	27445363	27445742	LTR/ERVL-MaLR	1656	+	190	27445553	30157
chr6	27415396	27615396	harbor1	chr6	27445750	27446862	LTR/ERVL-MaLR	4462	+	556	27446306	30910
chr6	27415396	27615396	harbor1	chr6	27447057	27447334	LTR/ERVL-MaLR	4462	+	138	27447195	31799
chr6	27415396	27615396	harbor1	chr6	27447337	27447430	LTR/ERVL-MaLR	873	+	46	27447383	31987
chr6	27415396	27615396	harbor1	chr6	27447742	27447915	LTR/ERVL-MaLR	873	+	86	27447828	32432
chr6	27415396	27615396	harbor1	chr6	27450286	27450639	LTR/ERVL-MaLR	1536	+	176	27450462	35066
chr6	27415396	27615396	harbor1	chr6	27465043	27465164	LTR/ERVL-MaLR	580	+	60	27465103	49707
chr6	27415396	27615396	harbor1	chr6	27465902	27466136	LTR/ERVL-MaLR	1946	+	117	27466019	50623
chr6	27415396	27615396	harbor1	chr6	27466172	27466408	LTR/ERVL-MaLR	1946	+	118	27466290	50894
chr6	27415396	27615396	harbor1	chr6	27506996	27507425	LTR/ERVL-MaLR	1481	+	214	27507210	91814
chr6	27415396	27615396	harbor1	chr6	27475772	27476091	LTR/ERVL-MaLR	1513	+	160	27475932	60536
chr6	4751953	4951953	harbor1	chr6	4784725	4785081	LTR/ERVL-MaLR	2466	+	178	4784903	32950
chr6	139275475	139475475	harbor1	chr6	139292930	139293097	LTR/ERVL-MaLR	1843	+	84	139293014	17539
chr6	139275475	139475475	harbor1	chr6	139293390	139293676	LTR/ERVL-MaLR	1843	+	143	139293533	18058
chr6	139275475	139475475	harbor1	chr6	139294408	139294707	LTR/ERVL-MaLR	1885	+	150	139294558	19083
chr6	139275475	139475475	harbor1	chr6	139295002	139295058	LTR/ERVL-MaLR	1885	+	28	139295030	19555
chr6	139275475	139475475	harbor1	chr6	139298726	139299131	LTR/ERVL-MaLR	1974	+	202	139298928	23453
chr6	139275475	139475475	harbor1	chr6	139321167	139321532	LTR/ERVL-MaLR	2142	+	182	139321349	45874
chr6	139275475	139475475	harbor1	chr6	139333162	139333302	LTR/ERVL-MaLR	1348	+	70	139333232	57757
chr6	139275475	139475475	harbor1	chr6	139333595	139333823	LTR/ERVL-MaLR	1348	+	114	139333709	58234
chr6	139275475	139475475	harbor1	chr6	139358600	139358929	LTR/ERVL-MaLR	1756	+	164	139358764	83289
chr6	139275475	139475475	harbor1	chr6	139360830	139361023	LTR/ERVL-MaLR	634	+	96	139360926	85451
chr6	30366632	30566632	harbor1	chr6	30402588	30402719	LTR/ERVL-MaLR	854	+	66	30402654	36022
chr6	30366632	30566632	harbor1	chr6	30405049	30405386	LTR/ERVL-MaLR	754	+	168	30405217	38585
chr6	30366632	30566632	harbor1	chr6	30407106	30408342	LTR/ERVL-MaLR	9376	+	618	30407724	41092
chr6	30366632	30566632	harbor1	chr6	30408343	30408695	LTR/ERVL-MaLR	2120	+	176	30408519	41887
chr6	139274465	139474465	harbor1	chr6	139292930	139293097	LTR/ERVL-MaLR	1843	+	84	139293014	18549
chr6	139274465	139474465	harbor1	chr6	139293390	139293676	LTR/ERVL-MaLR	1843	+	143	139293533	19068
chr6	139274465	139474465	harbor1	chr6	139294408	139294707	LTR/ERVL-MaLR	1885	+	150	139294558	20093
chr6	139274465	139474465	harbor1	chr6	139295002	139295058	LTR/ERVL-MaLR	1885	+	28	139295030	20565
chr6	139274465	139474465	harbor1	chr6	139298726	139299131	LTR/ERVL-MaLR	1974	+	202	139298928	24463
chr6	139274465	139474465	harbor1	chr6	139321167	139321532	LTR/ERVL-MaLR	2142	+	182	139321349	46884
chr6	139274465	139474465	harbor1	chr6	139333162	139333302	LTR/ERVL-MaLR	1348	+	70	139333232	58767
chr6	139274465	139474465	harbor1	chr6	139333595	139333823	LTR/ERVL-MaLR	1348	+	114	139333709	59244
chr6	139274465	139474465	harbor1	chr6	139358600	139358929	LTR/ERVL-MaLR	1756	+	164	139358764	84299
chr6	139274465	139474465	harbor1	chr6	139360830	139361023	LTR/ERVL-MaLR	634	+	96	139360926	86461
chr6	52184695	52384695	harbor1	chr6	52194942	52195309	LTR/ERVL-MaLR	2234	+	184	52195126	10431
chr6	52184695	52384695	harbor1	chr6	52218488	52218829	LTR/ERVL-MaLR	1050	+	170	52218658	33963
chr6	52184695	52384695	harbor1	chr6	52218831	52220495	LTR/ERVL-MaLR	5439	+	832	52219663	34968
chr6	52184695	52384695	harbor1	chr6	52220645	52220857	LTR/ERVL-MaLR	961	+	106	52220751	36056
chr6	52184695	52384695	harbor1	chr6	52250318	52250620	LTR/ERVL-MaLR	1204	+	151	52250469	65774
chr6	3749398	3949398	harbor1	chr6	3784913	3785288	LTR/ERVL-MaLR	2307	+	188	3785101	35703
chr6	3749398	3949398	harbor1	chr6	3794628	3794887	LTR/ERVL-MaLR	774	+	130	3794758	45360
chr6	3749398	3949398	harbor1	chr6	3795199	3795318	LTR/ERVL-MaLR	774	+	60	3795259	45861
chr6	3749398	3949398	harbor1	chr6	3795642	3795683	LTR/ERVL-MaLR	774	+	20	3795662	46264
chr6	3749398	3949398	harbor1	chr6	3795686	3796217	LTR/ERVL-MaLR	1147	+	266	3795952	46554
chr6	3749398	3949398	harbor1	chr6	3810957	3811292	LTR/ERVL-MaLR	923	+	168	3811125	61727
chr6	3749398	3949398	harbor1	chr6	3818130	3818516	LTR/ERVL-MaLR	774	+	193	3818323	68925
chr6	3749398	3949398	harbor1	chr6	3818528	3818970	LTR/ERVL-MaLR	1347	+	221	3818749	69351
chr6	3749398	3949398	harbor1	chr6	3818974	3819197	LTR/ERVL-MaLR	827	+	112	3819086	69688
chr6	3749398	3949398	harbor1	chr6	3819640	3820121	LTR/ERVL-MaLR	1111	+	240	3819880	70482
chr6	31907277	32107277	harbor1	chr6	31924796	31925040	LTR/ERVL-MaLR	899	+	122	31924918	17641
chr6	39128541	39328541	harbor1	chr6	39163402	39163855	LTR/ERVL-MaLR	1361	+	226	39163628	35087
chr6	39128541	39328541	harbor1	chr6	39165267	39165420	LTR/ERVL-MaLR	899	+	76	39165343	36802
chr6	39128541	39328541	harbor1	chr6	39165733	39165824	LTR/ERVL-MaLR	899	+	46	39165779	37238
chr6	39128541	39328541	harbor1	chr6	39178897	39179051	LTR/ERVL-MaLR	537	+	77	39178974	50433
chr6	147063104	147263104	harbor1	chr6	147076244	147076592	LTR/ERVL-MaLR	1985	+	174	147076418	13314
chr6	147063104	147263104	harbor1	chr6	147110389	147110746	LTR/ERVL-MaLR	1325	+	178	147110567	47463
chr6	147063104	147263104	harbor1	chr6	147118786	147119198	LTR/ERVL-MaLR	1328	+	206	147118992	55888
chr6	147063104	147263104	harbor1	chr6	147126605	147127139	LTR/ERVL-MaLR	1546	+	267	147126872	63768
chr6	147063104	147263104	harbor1	chr6	147137791	147138276	LTR/ERVL-MaLR	2242	+	242	147138033	74929
chr6	147063104	147263104	harbor1	chr6	147151743	147151965	LTR/ERVL-MaLR	739	+	111	147151854	88750
chr6	124862409	125062409	harbor1	chr6	124865521	124865913	LTR/ERVL-MaLR	1643	+	196	124865717	3308
chr6	124862409	125062409	harbor1	chr6	124874004	124874256	LTR/ERVL-MaLR	1299	+	126	124874130	11721
chr6	124862409	125062409	harbor1	chr6	124885690	124886046	LTR/ERVL-MaLR	1502	+	178	124885868	23459
chr6	124862409	125062409	harbor1	chr6	124904073	124904287	LTR/ERVL-MaLR	1437	+	107	124904180	41771
chr6	124862409	125062409	harbor1	chr6	124913773	124914124	LTR/ERVL-MaLR	1294	+	176	124913949	51540
chr6	124862409	125062409	harbor1	chr6	124917132	124917549	LTR/ERVL-MaLR	2159	+	208	124917340	54931
chr6	124862409	125062409	harbor1	chr6	124923462	124923829	LTR/ERVL-MaLR	1450	+	184	124923646	61237
chr6	124862409	125062409	harbor1	chr6	124930528	124930946	LTR/ERVL-MaLR	2520	+	209	124930737	68328
chr6	124862409	125062409	harbor1	chr6	124949751	124950175	LTR/ERVL-MaLR	1763	+	212	124949963	87554
chr6	124862409	125062409	harbor1	chr6	124950465	124950827	LTR/ERVL-MaLR	2375	+	181	124950646	88237
chr6	169863974	170063974	harbor1	chr6	169903832	169904031	LTR/ERVL-MaLR	642	+	100	169903932	39958
chr6	169863974	170063974	harbor1	chr6	169904028	169904309	LTR/ERVL-MaLR	599	+	140	169904168	40194
chr6	169863974	170063974	harbor1	chr6	169933845	169934173	LTR/ERVL-MaLR	751	+	164	169934009	70035
chr6	169863974	170063974	harbor1	chr6	169951162	169951692	LTR/ERVL-MaLR	1371	+	265	169951427	87453
chr6	135363713	135563713	harbor1	chr6	135446176	135446424	LTR/ERVL-MaLR	981	+	124	135446300	82587
chr6	135363713	135563713	harbor1	chr6	135446426	135446779	LTR/ERVL-MaLR	1564	+	176	135446602	82889
chr6	146813086	147013086	harbor1	chr6	146852649	146853016	LTR/ERVL-MaLR	2052	+	184	146852833	39747
chr6	146813086	147013086	harbor1	chr6	146859366	146859713	LTR/ERVL-MaLR	1765	+	174	146859540	46454
chr6	106529506	106729506	harbor1	chr6	106616871	106617235	LTR/ERVL-MaLR	1996	+	182	106617053	87547
chr6	106529506	106729506	harbor1	chr6	106577575	106578018	LTR/ERVL-MaLR	2398	+	222	106577797	48291
chr6	130963222	131163222	harbor1	chr6	130974057	130974384	LTR/ERVL-MaLR	1098	+	164	130974221	10999
chr6	130963222	131163222	harbor1	chr6	131007121	131007451	LTR/ERVL-MaLR	1581	+	165	131007286	44064
chr6	130963222	131163222	harbor1	chr6	131007454	131009065	LTR/ERVL-MaLR	11363	+	806	131008260	45038
chr6	130963222	131163222	harbor1	chr6	131009074	131009423	LTR/ERVL-MaLR	1963	+	174	131009248	46026
chr6	133853442	134053442	harbor1	chr6	133869072	133869413	LTR/ERVL-MaLR	1761	+	170	133869242	15800
chr6	133853442	134053442	harbor1	chr6	133880746	133881158	LTR/ERVL-MaLR	1241	+	206	133880952	27510
chr6	133853442	134053442	harbor1	chr6	133882742	133883264	LTR/ERVL-MaLR	965	+	261	133883003	29561
chr6	133853442	134053442	harbor1	chr6	133900775	133901252	LTR/ERVL-MaLR	1510	+	238	133901013	47571
chr6	133853442	134053442	harbor1	chr6	133914743	133915086	LTR/ERVL-MaLR	1734	+	172	133914915	61473
chr6	133853442	134053442	harbor1	chr6	133917079	133917407	LTR/ERVL-MaLR	1137	+	164	133917243	63801
chr6	133853442	134053442	harbor1	chr6	133927763	133928083	LTR/ERVL-MaLR	1753	+	160	133927923	74481
chr6	133853442	134053442	harbor1	chr6	133945670	133945773	LTR/ERVL-MaLR	1544	+	52	133945722	92280
chr6	133853442	134053442	harbor1	chr6	133946072	133946431	LTR/ERVL-MaLR	1544	+	180	133946252	92810
chr6	27415400	27615400	harbor1	chr6	27430367	27430783	LTR/ERVL-MaLR	1440	+	208	27430575	15175
chr6	27415400	27615400	harbor1	chr6	27432662	27433234	LTR/ERVL-MaLR	1708	+	286	27432948	17548
chr6	27415400	27615400	harbor1	chr6	27437089	27437672	LTR/ERVL-MaLR	2139	+	292	27437381	21981
chr6	27415400	27615400	harbor1	chr6	27445363	27445742	LTR/ERVL-MaLR	1656	+	190	27445553	30153
chr6	27415400	27615400	harbor1	chr6	27445750	27446862	LTR/ERVL-MaLR	4462	+	556	27446306	30906
chr6	27415400	27615400	harbor1	chr6	27447057	27447334	LTR/ERVL-MaLR	4462	+	138	27447195	31795
chr6	27415400	27615400	harbor1	chr6	27447337	27447430	LTR/ERVL-MaLR	873	+	46	27447383	31983
chr6	27415400	27615400	harbor1	chr6	27447742	27447915	LTR/ERVL-MaLR	873	+	86	27447828	32428
chr6	27415400	27615400	harbor1	chr6	27450286	27450639	LTR/ERVL-MaLR	1536	+	176	27450462	35062
chr6	27415400	27615400	harbor1	chr6	27465043	27465164	LTR/ERVL-MaLR	580	+	60	27465103	49703
chr6	27415400	27615400	harbor1	chr6	27465902	27466136	LTR/ERVL-MaLR	1946	+	117	27466019	50619
chr6	27415400	27615400	harbor1	chr6	27466172	27466408	LTR/ERVL-MaLR	1946	+	118	27466290	50890
chr6	27415400	27615400	harbor1	chr6	27506996	27507425	LTR/ERVL-MaLR	1481	+	214	27507210	91810
chr6	27415400	27615400	harbor1	chr6	27475772	27476091	LTR/ERVL-MaLR	1513	+	160	27475932	60532
chr6	41091934	41291934	harbor1	chr6	41176680	41177075	LTR/ERVL-MaLR	1359	+	198	41176878	84944
chr6	41091934	41291934	harbor1	chr6	41182694	41183023	LTR/ERVL-MaLR	596	+	164	41182858	90924
chr6	139275440	139475440	harbor1	chr6	139292930	139293097	LTR/ERVL-MaLR	1843	+	84	139293014	17574
chr6	139275440	139475440	harbor1	chr6	139293390	139293676	LTR/ERVL-MaLR	1843	+	143	139293533	18093
chr6	139275440	139475440	harbor1	chr6	139294408	139294707	LTR/ERVL-MaLR	1885	+	150	139294558	19118
chr6	139275440	139475440	harbor1	chr6	139295002	139295058	LTR/ERVL-MaLR	1885	+	28	139295030	19590
chr6	139275440	139475440	harbor1	chr6	139298726	139299131	LTR/ERVL-MaLR	1974	+	202	139298928	23488
chr6	139275440	139475440	harbor1	chr6	139321167	139321532	LTR/ERVL-MaLR	2142	+	182	139321349	45909
chr6	139275440	139475440	harbor1	chr6	139333162	139333302	LTR/ERVL-MaLR	1348	+	70	139333232	57792
chr6	139275440	139475440	harbor1	chr6	139333595	139333823	LTR/ERVL-MaLR	1348	+	114	139333709	58269
chr6	139275440	139475440	harbor1	chr6	139358600	139358929	LTR/ERVL-MaLR	1756	+	164	139358764	83324
chr6	139275440	139475440	harbor1	chr6	139360830	139361023	LTR/ERVL-MaLR	634	+	96	139360926	85486
chr6	127167312	127367312	harbor1	chr6	127223966	127224335	LTR/ERVL-MaLR	2492	+	184	127224150	56838
chr6	124862399	125062399	harbor1	chr6	124865521	124865913	LTR/ERVL-MaLR	1643	+	196	124865717	3318
chr6	124862399	125062399	harbor1	chr6	124874004	124874256	LTR/ERVL-MaLR	1299	+	126	124874130	11731
chr6	124862399	125062399	harbor1	chr6	124885690	124886046	LTR/ERVL-MaLR	1502	+	178	124885868	23469
chr6	124862399	125062399	harbor1	chr6	124904073	124904287	LTR/ERVL-MaLR	1437	+	107	124904180	41781
chr6	124862399	125062399	harbor1	chr6	124913773	124914124	LTR/ERVL-MaLR	1294	+	176	124913949	51550
chr6	124862399	125062399	harbor1	chr6	124917132	124917549	LTR/ERVL-MaLR	2159	+	208	124917340	54941
chr6	124862399	125062399	harbor1	chr6	124923462	124923829	LTR/ERVL-MaLR	1450	+	184	124923646	61247
chr6	124862399	125062399	harbor1	chr6	124930528	124930946	LTR/ERVL-MaLR	2520	+	209	124930737	68338
chr6	124862399	125062399	harbor1	chr6	124949751	124950175	LTR/ERVL-MaLR	1763	+	212	124949963	87564
chr6	124862399	125062399	harbor1	chr6	124950465	124950827	LTR/ERVL-MaLR	2375	+	181	124950646	88247
chr6	169864066	170064066	harbor1	chr6	169903832	169904031	LTR/ERVL-MaLR	642	+	100	169903932	39866
chr6	169864066	170064066	harbor1	chr6	169904028	169904309	LTR/ERVL-MaLR	599	+	140	169904168	40102
chr6	169864066	170064066	harbor1	chr6	169933845	169934173	LTR/ERVL-MaLR	751	+	164	169934009	69943
chr6	169864066	170064066	harbor1	chr6	169951162	169951692	LTR/ERVL-MaLR	1371	+	265	169951427	87361
chr6	139275439	139475439	harbor1	chr6	139292930	139293097	LTR/ERVL-MaLR	1843	+	84	139293014	17575
chr6	139275439	139475439	harbor1	chr6	139293390	139293676	LTR/ERVL-MaLR	1843	+	143	139293533	18094
chr6	139275439	139475439	harbor1	chr6	139294408	139294707	LTR/ERVL-MaLR	1885	+	150	139294558	19119
chr6	139275439	139475439	harbor1	chr6	139295002	139295058	LTR/ERVL-MaLR	1885	+	28	139295030	19591
chr6	139275439	139475439	harbor1	chr6	139298726	139299131	LTR/ERVL-MaLR	1974	+	202	139298928	23489
chr6	139275439	139475439	harbor1	chr6	139321167	139321532	LTR/ERVL-MaLR	2142	+	182	139321349	45910
chr6	139275439	139475439	harbor1	chr6	139333162	139333302	LTR/ERVL-MaLR	1348	+	70	139333232	57793
chr6	139275439	139475439	harbor1	chr6	139333595	139333823	LTR/ERVL-MaLR	1348	+	114	139333709	58270
chr6	139275439	139475439	harbor1	chr6	139358600	139358929	LTR/ERVL-MaLR	1756	+	164	139358764	83325
chr6	139275439	139475439	harbor1	chr6	139360830	139361023	LTR/ERVL-MaLR	634	+	96	139360926	85487
chr6	37002937	37202937	harbor1	chr6	37039524	37039664	LTR/ERVL-MaLR	916	+	70	37039594	36657
chr6	37002937	37202937	harbor1	chr6	37039963	37040251	LTR/ERVL-MaLR	916	+	144	37040107	37170
chr6	37002937	37202937	harbor1	chr6	37041152	37041314	LTR/ERVL-MaLR	1841	+	81	37041233	38296
chr6	37002937	37202937	harbor1	chr6	37041628	37041822	LTR/ERVL-MaLR	1841	+	97	37041725	38788
chr6	37002937	37202937	harbor1	chr6	37042120	37042485	LTR/ERVL-MaLR	1357	+	182	37042302	39365
chr6	37002937	37202937	harbor1	chr6	37042764	37042980	LTR/ERVL-MaLR	872	+	108	37042872	39935
chr6	37002937	37202937	harbor1	chr6	37046605	37046945	LTR/ERVL-MaLR	1774	+	170	37046775	43838
chr6	170062470	170262470	harbor1	chr6	170068395	170068766	LTR/ERVL-MaLR	583	+	186	170068581	6111
chr6	170062470	170262470	harbor1	chr6	170100715	170101075	LTR/ERVL-MaLR	2331	+	180	170100895	38425
chr6	170062470	170262470	harbor1	chr6	170122569	170123166	LTR/ERVL-MaLR	2554	+	298	170122867	60397
chr6	170062470	170262470	harbor1	chr6	170143874	170144264	LTR/ERVL-MaLR	2220	+	195	170144069	81599
chr6	170062470	170262470	harbor1	chr6	170082131	170082438	LTR/ERVL-MaLR	545	+	154	170082285	19815
chr6	139275169	139475169	harbor1	chr6	139292930	139293097	LTR/ERVL-MaLR	1843	+	84	139293014	17845
chr6	139275169	139475169	harbor1	chr6	139293390	139293676	LTR/ERVL-MaLR	1843	+	143	139293533	18364
chr6	139275169	139475169	harbor1	chr6	139294408	139294707	LTR/ERVL-MaLR	1885	+	150	139294558	19389
chr6	139275169	139475169	harbor1	chr6	139295002	139295058	LTR/ERVL-MaLR	1885	+	28	139295030	19861
chr6	139275169	139475169	harbor1	chr6	139298726	139299131	LTR/ERVL-MaLR	1974	+	202	139298928	23759
chr6	139275169	139475169	harbor1	chr6	139321167	139321532	LTR/ERVL-MaLR	2142	+	182	139321349	46180
chr6	139275169	139475169	harbor1	chr6	139333162	139333302	LTR/ERVL-MaLR	1348	+	70	139333232	58063
chr6	139275169	139475169	harbor1	chr6	139333595	139333823	LTR/ERVL-MaLR	1348	+	114	139333709	58540
chr6	139275169	139475169	harbor1	chr6	139358600	139358929	LTR/ERVL-MaLR	1756	+	164	139358764	83595
chr6	139275169	139475169	harbor1	chr6	139360830	139361023	LTR/ERVL-MaLR	634	+	96	139360926	85757
chr6	139274579	139474579	harbor1	chr6	139292930	139293097	LTR/ERVL-MaLR	1843	+	84	139293014	18435
chr6	139274579	139474579	harbor1	chr6	139293390	139293676	LTR/ERVL-MaLR	1843	+	143	139293533	18954
chr6	139274579	139474579	harbor1	chr6	139294408	139294707	LTR/ERVL-MaLR	1885	+	150	139294558	19979
chr6	139274579	139474579	harbor1	chr6	139295002	139295058	LTR/ERVL-MaLR	1885	+	28	139295030	20451
chr6	139274579	139474579	harbor1	chr6	139298726	139299131	LTR/ERVL-MaLR	1974	+	202	139298928	24349
chr6	139274579	139474579	harbor1	chr6	139321167	139321532	LTR/ERVL-MaLR	2142	+	182	139321349	46770
chr6	139274579	139474579	harbor1	chr6	139333162	139333302	LTR/ERVL-MaLR	1348	+	70	139333232	58653
chr6	139274579	139474579	harbor1	chr6	139333595	139333823	LTR/ERVL-MaLR	1348	+	114	139333709	59130
chr6	139274579	139474579	harbor1	chr6	139358600	139358929	LTR/ERVL-MaLR	1756	+	164	139358764	84185
chr6	139274579	139474579	harbor1	chr6	139360830	139361023	LTR/ERVL-MaLR	634	+	96	139360926	86347
chr6	11714941	11914941	harbor1	chr6	11726257	11726659	LTR/ERVL-MaLR	2178	+	201	11726458	11517
chr6	11714941	11914941	harbor1	chr6	11743968	11744376	LTR/ERVL-MaLR	2376	+	204	11744172	29231
chr6	11714941	11914941	harbor1	chr6	11757491	11757947	LTR/ERVL-MaLR	1637	+	228	11757719	42778
chr6	11714941	11914941	harbor1	chr6	11759652	11760136	LTR/ERVL-MaLR	2075	+	242	11759894	44953
chr6	11714941	11914941	harbor1	chr6	11771635	11772010	LTR/ERVL-MaLR	2204	+	188	11771823	56882
chr6	11714941	11914941	harbor1	chr6	11807950	11808351	LTR/ERVL-MaLR	2318	+	200	11808150	93209
chr6	33104683	33304683	harbor1	chr6	33153670	33153940	LTR/ERVL-MaLR	1052	+	135	33153805	49122
chr6	41832810	42032810	harbor1	chr6	41834453	41834856	LTR/ERVL-MaLR	2929	+	202	41834655	1845
chr6	18268218	18468218	harbor1	chr6	18340061	18340105	LTR/ERVL-MaLR	1929	+	22	18340083	71865
chr6	18268218	18468218	harbor1	chr6	18340405	18340740	LTR/ERVL-MaLR	1929	+	168	18340573	72355
chr6	18268218	18468218	harbor1	chr6	18346814	18347148	LTR/ERVL-MaLR	619	+	167	18346981	78763
chr6	18268218	18468218	harbor1	chr6	18365475	18365829	LTR/ERVL-MaLR	2506	+	177	18365652	97434
chr6	139275128	139475128	harbor1	chr6	139292930	139293097	LTR/ERVL-MaLR	1843	+	84	139293014	17886
chr6	139275128	139475128	harbor1	chr6	139293390	139293676	LTR/ERVL-MaLR	1843	+	143	139293533	18405
chr6	139275128	139475128	harbor1	chr6	139294408	139294707	LTR/ERVL-MaLR	1885	+	150	139294558	19430
chr6	139275128	139475128	harbor1	chr6	139295002	139295058	LTR/ERVL-MaLR	1885	+	28	139295030	19902
chr6	139275128	139475128	harbor1	chr6	139298726	139299131	LTR/ERVL-MaLR	1974	+	202	139298928	23800
chr6	139275128	139475128	harbor1	chr6	139321167	139321532	LTR/ERVL-MaLR	2142	+	182	139321349	46221
chr6	139275128	139475128	harbor1	chr6	139333162	139333302	LTR/ERVL-MaLR	1348	+	70	139333232	58104
chr6	139275128	139475128	harbor1	chr6	139333595	139333823	LTR/ERVL-MaLR	1348	+	114	139333709	58581
chr6	139275128	139475128	harbor1	chr6	139358600	139358929	LTR/ERVL-MaLR	1756	+	164	139358764	83636
chr6	139275128	139475128	harbor1	chr6	139360830	139361023	LTR/ERVL-MaLR	634	+	96	139360926	85798
chr6	139275156	139475156	harbor1	chr6	139292930	139293097	LTR/ERVL-MaLR	1843	+	84	139293014	17858
chr6	139275156	139475156	harbor1	chr6	139293390	139293676	LTR/ERVL-MaLR	1843	+	143	139293533	18377
chr6	139275156	139475156	harbor1	chr6	139294408	139294707	LTR/ERVL-MaLR	1885	+	150	139294558	19402
chr6	139275156	139475156	harbor1	chr6	139295002	139295058	LTR/ERVL-MaLR	1885	+	28	139295030	19874
chr6	139275156	139475156	harbor1	chr6	139298726	139299131	LTR/ERVL-MaLR	1974	+	202	139298928	23772
chr6	139275156	139475156	harbor1	chr6	139321167	139321532	LTR/ERVL-MaLR	2142	+	182	139321349	46193
chr6	139275156	139475156	harbor1	chr6	139333162	139333302	LTR/ERVL-MaLR	1348	+	70	139333232	58076
chr6	139275156	139475156	harbor1	chr6	139333595	139333823	LTR/ERVL-MaLR	1348	+	114	139333709	58553
chr6	139275156	139475156	harbor1	chr6	139358600	139358929	LTR/ERVL-MaLR	1756	+	164	139358764	83608
chr6	139275156	139475156	harbor1	chr6	139360830	139361023	LTR/ERVL-MaLR	634	+	96	139360926	85770
chr6	42647151	42847151	harbor1	chr6	42711053	42711204	LTR/ERVL-MaLR	870	+	76	42711129	63978
chr6	42647151	42847151	harbor1	chr6	42711230	42711357	LTR/ERVL-MaLR	772	+	64	42711294	64143
chr6	42647151	42847151	harbor1	chr6	42729806	42730000	LTR/ERVL-MaLR	1120	+	97	42729903	82752
chr6	41448352	41648352	harbor1	chr6	41455500	41455875	LTR/ERVL-MaLR	1892	+	188	41455688	7336
chr6	41448352	41648352	harbor1	chr6	41456302	41456369	LTR/ERVL-MaLR	1892	+	34	41456336	7984
chr6	41448352	41648352	harbor1	chr6	41532699	41533108	LTR/ERVL-MaLR	1808	+	204	41532903	84551
chr6	41448352	41648352	harbor1	chr6	41535728	41535912	LTR/ERVL-MaLR	528	+	92	41535820	87468
chr6	36969380	37169380	harbor1	chr6	37039524	37039664	LTR/ERVL-MaLR	916	+	70	37039594	70214
chr6	36969380	37169380	harbor1	chr6	37039963	37040251	LTR/ERVL-MaLR	916	+	144	37040107	70727
chr6	36969380	37169380	harbor1	chr6	37041152	37041314	LTR/ERVL-MaLR	1841	+	81	37041233	71853
chr6	36969380	37169380	harbor1	chr6	37041628	37041822	LTR/ERVL-MaLR	1841	+	97	37041725	72345
chr6	36969380	37169380	harbor1	chr6	37042120	37042485	LTR/ERVL-MaLR	1357	+	182	37042302	72922
chr6	36969380	37169380	harbor1	chr6	37042764	37042980	LTR/ERVL-MaLR	872	+	108	37042872	73492
chr6	36969380	37169380	harbor1	chr6	37046605	37046945	LTR/ERVL-MaLR	1774	+	170	37046775	77395
chr6	52184723	52384723	harbor1	chr6	52194942	52195309	LTR/ERVL-MaLR	2234	+	184	52195126	10403
chr6	52184723	52384723	harbor1	chr6	52218488	52218829	LTR/ERVL-MaLR	1050	+	170	52218658	33935
chr6	52184723	52384723	harbor1	chr6	52218831	52220495	LTR/ERVL-MaLR	5439	+	832	52219663	34940
chr6	52184723	52384723	harbor1	chr6	52220645	52220857	LTR/ERVL-MaLR	961	+	106	52220751	36028
chr6	52184723	52384723	harbor1	chr6	52250318	52250620	LTR/ERVL-MaLR	1204	+	151	52250469	65746
chr6	7626959	7826959	harbor1	chr6	7626949	7627180	LTR/ERVL-MaLR	470	+	116	7627065	106
chr6	7626959	7826959	harbor1	chr6	7627795	7627974	LTR/ERVL-MaLR	480	+	90	7627885	926
chr6	7626959	7826959	harbor1	chr6	7630184	7630393	LTR/ERVL-MaLR	1197	+	104	7630288	3329
chr6	7626959	7826959	harbor1	chr6	7632352	7632875	LTR/ERVL-MaLR	1484	+	262	7632614	5655
chr6	7626959	7826959	harbor1	chr6	7644716	7644877	LTR/ERVL-MaLR	502	+	80	7644796	17837
chr6	7626959	7826959	harbor1	chr6	7644956	7645215	LTR/ERVL-MaLR	449	+	130	7645086	18127
chr6	7626959	7826959	harbor1	chr6	7645245	7645639	LTR/ERVL-MaLR	514	+	197	7645442	18483
chr6	7626959	7826959	harbor1	chr6	7645844	7646205	LTR/ERVL-MaLR	614	+	180	7646024	19065
chr6	7626959	7826959	harbor1	chr6	7667772	7667904	LTR/ERVL-MaLR	459	+	66	7667838	40879
chr6	7626959	7826959	harbor1	chr6	7668682	7668918	LTR/ERVL-MaLR	1409	+	118	7668800	41841
chr6	7626959	7826959	harbor1	chr6	7704487	7704811	LTR/ERVL-MaLR	1610	+	162	7704649	77690
chr6	7626959	7826959	harbor1	chr6	7705132	7705174	LTR/ERVL-MaLR	1610	+	21	7705153	78194
chr6	3682582	3882582	harbor1	chr6	3704189	3704555	LTR/ERVL-MaLR	2311	+	183	3704372	21790
chr6	3682582	3882582	harbor1	chr6	3714698	3715147	LTR/ERVL-MaLR	647	+	224	3714922	32340
chr6	41460705	41660705	harbor1	chr6	41532699	41533108	LTR/ERVL-MaLR	1808	+	204	41532903	72198
chr6	41460705	41660705	harbor1	chr6	41535728	41535912	LTR/ERVL-MaLR	528	+	92	41535820	75115
chr6	34138127	34338127	harbor1	chr6	34167478	34167640	LTR/ERVL-MaLR	2734	+	81	34167559	29432
chr6	34138127	34338127	harbor1	chr6	34167936	34168213	LTR/ERVL-MaLR	2734	+	138	34168074	29947
chr6	34138127	34338127	harbor1	chr6	34205531	34205778	LTR/ERVL-MaLR	634	+	124	34205655	67528
chr6	34138127	34338127	harbor1	chr6	34208005	34208492	LTR/ERVL-MaLR	2121	+	244	34208249	70122
chr6	34138127	34338127	harbor1	chr6	34217088	34217125	LTR/ERVL-MaLR	1847	+	18	34217106	78979
chr6	34138127	34338127	harbor1	chr6	34218392	34218795	LTR/ERVL-MaLR	1847	+	202	34218594	80467
chr6	6446460	6646460	harbor1	chr6	6447475	6447905	LTR/ERVL-MaLR	789	+	215	6447690	1230
chr6	6446460	6646460	harbor1	chr6	6463593	6463958	LTR/ERVL-MaLR	2576	+	182	6463775	17315
chr6	6446460	6646460	harbor1	chr6	6469792	6470298	LTR/ERVL-MaLR	2015	+	253	6470045	23585
chr6	6446460	6646460	harbor1	chr6	6489700	6489900	LTR/ERVL-MaLR	762	+	100	6489800	43340
chr6	6446460	6646460	harbor1	chr6	6490554	6490754	LTR/ERVL-MaLR	661	+	100	6490654	44194
chr6	6446460	6646460	harbor1	chr6	6528915	6529237	LTR/ERVL-MaLR	682	+	161	6529076	82616
chr6	169863372	170063372	harbor1	chr6	169903832	169904031	LTR/ERVL-MaLR	642	+	100	169903932	40560
chr6	169863372	170063372	harbor1	chr6	169904028	169904309	LTR/ERVL-MaLR	599	+	140	169904168	40796
chr6	169863372	170063372	harbor1	chr6	169933845	169934173	LTR/ERVL-MaLR	751	+	164	169934009	70637
chr6	169863372	170063372	harbor1	chr6	169951162	169951692	LTR/ERVL-MaLR	1371	+	265	169951427	88055
chr6	127167326	127367326	harbor1	chr6	127223966	127224335	LTR/ERVL-MaLR	2492	+	184	127224150	56824
chr6	169864117	170064117	harbor1	chr6	169903832	169904031	LTR/ERVL-MaLR	642	+	100	169903932	39815
chr6	169864117	170064117	harbor1	chr6	169904028	169904309	LTR/ERVL-MaLR	599	+	140	169904168	40051
chr6	169864117	170064117	harbor1	chr6	169933845	169934173	LTR/ERVL-MaLR	751	+	164	169934009	69892
chr6	169864117	170064117	harbor1	chr6	169951162	169951692	LTR/ERVL-MaLR	1371	+	265	169951427	87310
chr6	169811811	170011811	harbor1	chr6	169822725	169823101	LTR/ERVL-MaLR	2147	+	188	169822913	11102
chr6	169811811	170011811	harbor1	chr6	169837523	169837900	LTR/ERVL-MaLR	885	+	188	169837711	25900
chr6	169811811	170011811	harbor1	chr6	169847349	169847716	LTR/ERVL-MaLR	2091	+	184	169847533	35722
chr6	169811811	170011811	harbor1	chr6	169847971	169848102	LTR/ERVL-MaLR	483	+	66	169848037	36226
chr6	169811811	170011811	harbor1	chr6	169860637	169860992	LTR/ERVL-MaLR	2213	+	178	169860815	49004
chr6	169811811	170011811	harbor1	chr6	169903832	169904031	LTR/ERVL-MaLR	642	+	100	169903932	92121
chr6	169811811	170011811	harbor1	chr6	169904028	169904309	LTR/ERVL-MaLR	599	+	140	169904168	92357
chr6	99421489	99621489	harbor1	chr6	99421323	99421771	LTR/ERVL-MaLR	1313	+	224	99421547	58
chr6	99421489	99621489	harbor1	chr6	99430337	99430885	LTR/ERVL-MaLR	909	+	274	99430611	9122
chr6	99421489	99621489	harbor1	chr6	99432026	99432368	LTR/ERVL-MaLR	1719	+	171	99432197	10708
chr6	99421489	99621489	harbor1	chr6	99502623	99503044	LTR/ERVL-MaLR	2668	+	210	99502833	81344
chr6	99421489	99621489	harbor1	chr6	99508021	99508172	LTR/ERVL-MaLR	446	+	76	99508097	86608
chr6	99421489	99621489	harbor1	chr6	99510448	99510791	LTR/ERVL-MaLR	1585	+	172	99510620	89131
chr6	99421489	99621489	harbor1	chr6	99520065	99520570	LTR/ERVL-MaLR	2355	+	252	99520317	98828
chr6	139274599	139474599	harbor1	chr6	139292930	139293097	LTR/ERVL-MaLR	1843	+	84	139293014	18415
chr6	139274599	139474599	harbor1	chr6	139293390	139293676	LTR/ERVL-MaLR	1843	+	143	139293533	18934
chr6	139274599	139474599	harbor1	chr6	139294408	139294707	LTR/ERVL-MaLR	1885	+	150	139294558	19959
chr6	139274599	139474599	harbor1	chr6	139295002	139295058	LTR/ERVL-MaLR	1885	+	28	139295030	20431
chr6	139274599	139474599	harbor1	chr6	139298726	139299131	LTR/ERVL-MaLR	1974	+	202	139298928	24329
chr6	139274599	139474599	harbor1	chr6	139321167	139321532	LTR/ERVL-MaLR	2142	+	182	139321349	46750
chr6	139274599	139474599	harbor1	chr6	139333162	139333302	LTR/ERVL-MaLR	1348	+	70	139333232	58633
chr6	139274599	139474599	harbor1	chr6	139333595	139333823	LTR/ERVL-MaLR	1348	+	114	139333709	59110
chr6	139274599	139474599	harbor1	chr6	139358600	139358929	LTR/ERVL-MaLR	1756	+	164	139358764	84165
chr6	139274599	139474599	harbor1	chr6	139360830	139361023	LTR/ERVL-MaLR	634	+	96	139360926	86327
chr6	107718661	107918661	harbor1	chr6	107720114	107720352	LTR/ERVL-MaLR	553	+	119	107720233	1572
chr6	107718661	107918661	harbor1	chr6	107732950	107733251	LTR/ERVL-MaLR	841	+	150	107733100	14439
chr6	107718661	107918661	harbor1	chr6	107758438	107758882	LTR/ERVL-MaLR	1723	+	222	107758660	39999
chr6	107718661	107918661	harbor1	chr6	107762439	107762873	LTR/ERVL-MaLR	1960	+	217	107762656	43995
chr6	107718661	107918661	harbor1	chr6	107763229	107763374	LTR/ERVL-MaLR	1488	+	72	107763301	44640
chr6	107718661	107918661	harbor1	chr6	107763687	107763915	LTR/ERVL-MaLR	1488	+	114	107763801	45140
chr6	107718661	107918661	harbor1	chr6	107764693	107765054	LTR/ERVL-MaLR	2324	+	180	107764873	46212
chr6	107718661	107918661	harbor1	chr6	107767653	107767977	LTR/ERVL-MaLR	889	+	162	107767815	49154
chr6	107718661	107918661	harbor1	chr6	107768237	107768394	LTR/ERVL-MaLR	465	+	78	107768315	49654
chr6	107718661	107918661	harbor1	chr6	107808961	107809349	LTR/ERVL-MaLR	1989	+	194	107809155	90494
chr6	107718661	107918661	harbor1	chr6	107810724	107810811	LTR/ERVL-MaLR	1701	+	44	107810768	92107
chr6	107718661	107918661	harbor1	chr6	107810941	107811253	LTR/ERVL-MaLR	1701	+	156	107811097	92436
chr6	52184760	52384760	harbor1	chr6	52194942	52195309	LTR/ERVL-MaLR	2234	+	184	52195126	10366
chr6	52184760	52384760	harbor1	chr6	52218488	52218829	LTR/ERVL-MaLR	1050	+	170	52218658	33898
chr6	52184760	52384760	harbor1	chr6	52218831	52220495	LTR/ERVL-MaLR	5439	+	832	52219663	34903
chr6	52184760	52384760	harbor1	chr6	52220645	52220857	LTR/ERVL-MaLR	961	+	106	52220751	35991
chr6	52184760	52384760	harbor1	chr6	52250318	52250620	LTR/ERVL-MaLR	1204	+	151	52250469	65709
chr6	7626659	7826659	harbor1	chr6	7626949	7627180	LTR/ERVL-MaLR	470	+	116	7627065	406
chr6	7626659	7826659	harbor1	chr6	7627795	7627974	LTR/ERVL-MaLR	480	+	90	7627885	1226
chr6	7626659	7826659	harbor1	chr6	7630184	7630393	LTR/ERVL-MaLR	1197	+	104	7630288	3629
chr6	7626659	7826659	harbor1	chr6	7632352	7632875	LTR/ERVL-MaLR	1484	+	262	7632614	5955
chr6	7626659	7826659	harbor1	chr6	7644716	7644877	LTR/ERVL-MaLR	502	+	80	7644796	18137
chr6	7626659	7826659	harbor1	chr6	7644956	7645215	LTR/ERVL-MaLR	449	+	130	7645086	18427
chr6	7626659	7826659	harbor1	chr6	7645245	7645639	LTR/ERVL-MaLR	514	+	197	7645442	18783
chr6	7626659	7826659	harbor1	chr6	7645844	7646205	LTR/ERVL-MaLR	614	+	180	7646024	19365
chr6	7626659	7826659	harbor1	chr6	7667772	7667904	LTR/ERVL-MaLR	459	+	66	7667838	41179
chr6	7626659	7826659	harbor1	chr6	7668682	7668918	LTR/ERVL-MaLR	1409	+	118	7668800	42141
chr6	7626659	7826659	harbor1	chr6	7704487	7704811	LTR/ERVL-MaLR	1610	+	162	7704649	77990
chr6	7626659	7826659	harbor1	chr6	7705132	7705174	LTR/ERVL-MaLR	1610	+	21	7705153	78494
chr6	7626996	7826996	harbor1	chr6	7626949	7627180	LTR/ERVL-MaLR	470	+	116	7627065	69
chr6	7626996	7826996	harbor1	chr6	7627795	7627974	LTR/ERVL-MaLR	480	+	90	7627885	889
chr6	7626996	7826996	harbor1	chr6	7630184	7630393	LTR/ERVL-MaLR	1197	+	104	7630288	3292
chr6	7626996	7826996	harbor1	chr6	7632352	7632875	LTR/ERVL-MaLR	1484	+	262	7632614	5618
chr6	7626996	7826996	harbor1	chr6	7644716	7644877	LTR/ERVL-MaLR	502	+	80	7644796	17800
chr6	7626996	7826996	harbor1	chr6	7644956	7645215	LTR/ERVL-MaLR	449	+	130	7645086	18090
chr6	7626996	7826996	harbor1	chr6	7645245	7645639	LTR/ERVL-MaLR	514	+	197	7645442	18446
chr6	7626996	7826996	harbor1	chr6	7645844	7646205	LTR/ERVL-MaLR	614	+	180	7646024	19028
chr6	7626996	7826996	harbor1	chr6	7667772	7667904	LTR/ERVL-MaLR	459	+	66	7667838	40842
chr6	7626996	7826996	harbor1	chr6	7668682	7668918	LTR/ERVL-MaLR	1409	+	118	7668800	41804
chr6	7626996	7826996	harbor1	chr6	7704487	7704811	LTR/ERVL-MaLR	1610	+	162	7704649	77653
chr6	7626996	7826996	harbor1	chr6	7705132	7705174	LTR/ERVL-MaLR	1610	+	21	7705153	78157
chr6	149351042	149551042	harbor1	chr6	149445653	149445774	LTR/ERVL-MaLR	513	+	60	149445713	94671
chr6	169993799	170193799	harbor1	chr6	170041841	170042221	LTR/ERVL-MaLR	1677	+	190	170042031	48232
chr6	169993799	170193799	harbor1	chr6	170047839	170048142	LTR/ERVL-MaLR	905	+	152	170047991	54192
chr6	169993799	170193799	harbor1	chr6	170068395	170068766	LTR/ERVL-MaLR	583	+	186	170068581	74782
chr6	169993799	170193799	harbor1	chr6	170082131	170082438	LTR/ERVL-MaLR	545	+	154	170082285	88486
chr6	146813048	147013048	harbor1	chr6	146852649	146853016	LTR/ERVL-MaLR	2052	+	184	146852833	39785
chr6	146813048	147013048	harbor1	chr6	146859366	146859713	LTR/ERVL-MaLR	1765	+	174	146859540	46492
chr6	157938132	158138132	harbor1	chr6	157951768	157951860	LTR/ERVL-MaLR	570	+	46	157951814	13682
chr6	157938132	158138132	harbor1	chr6	157951882	157952045	LTR/ERVL-MaLR	473	+	82	157951964	13832
chr6	157938132	158138132	harbor1	chr6	157959785	157960121	LTR/ERVL-MaLR	1861	+	168	157959953	21821
chr6	157938132	158138132	harbor1	chr6	157965418	157965760	LTR/ERVL-MaLR	539	+	171	157965589	27457
chr6	157938132	158138132	harbor1	chr6	157966071	157966126	LTR/ERVL-MaLR	539	+	28	157966099	27967
chr6	157938132	158138132	harbor1	chr6	157978423	157978833	LTR/ERVL-MaLR	2442	+	205	157978628	40496
chr6	157938132	158138132	harbor1	chr6	157996571	157996979	LTR/ERVL-MaLR	2405	+	204	157996775	58643
chr6	157938132	158138132	harbor1	chr6	157997217	157997669	LTR/ERVL-MaLR	1686	+	226	157997443	59311
chr6	157938132	158138132	harbor1	chr6	158010591	158010815	LTR/ERVL-MaLR	899	+	112	158010703	72571
chr6	157938132	158138132	harbor1	chr6	158011155	158011377	LTR/ERVL-MaLR	472	+	111	158011266	73134
chr6	157938132	158138132	harbor1	chr6	158012245	158012702	LTR/ERVL-MaLR	1927	+	228	158012473	74341
chr7	44439898	44639898	harbor1	chr7	44447360	44447734	LTR/ERVL-MaLR	1709	+	187	44447547	7649
chr7	44439898	44639898	harbor1	chr7	44476304	44476657	LTR/ERVL-MaLR	1932	+	176	44476480	36582
chr7	44439898	44639898	harbor1	chr7	44481742	44482077	LTR/ERVL-MaLR	1640	+	168	44481910	42012
chr7	44439898	44639898	harbor1	chr7	44493496	44493882	LTR/ERVL-MaLR	1393	+	193	44493689	53791
chr7	44439898	44639898	harbor1	chr7	44505686	44506063	LTR/ERVL-MaLR	2564	+	188	44505874	65976
chr7	6087612	6287612	harbor1	chr7	6180429	6180670	LTR/ERVL-MaLR	801	+	120	6180549	92937
chr7	6087612	6287612	harbor1	chr7	6183714	6184048	LTR/ERVL-MaLR	1389	+	167	6183881	96269
chr7	72825086	73025086	harbor1	chr7	72851645	72851688	LTR/ERVL-MaLR	719	+	22	72851667	26581
chr7	72825086	73025086	harbor1	chr7	72851986	72852054	LTR/ERVL-MaLR	719	+	34	72852020	26934
chr7	72825086	73025086	harbor1	chr7	72852134	72852176	LTR/ERVL-MaLR	719	+	21	72852155	27069
chr7	72825086	73025086	harbor1	chr7	72913866	72914450	LTR/ERVL-MaLR	1311	+	292	72914158	89072
chr7	50203887	50403887	harbor1	chr7	50270321	50270974	LTR/ERVL-MaLR	1870	+	326	50270647	66760
chr7	50203887	50403887	harbor1	chr7	50290315	50290697	LTR/ERVL-MaLR	2452	+	191	50290506	86619
chr7	1801811	2001811	harbor1	chr7	1804877	1805243	LTR/ERVL-MaLR	891	+	183	1805060	3249
chr7	1801811	2001811	harbor1	chr7	1864626	1865004	LTR/ERVL-MaLR	1120	+	189	1864815	63004
chr7	1801811	2001811	harbor1	chr7	1875769	1876102	LTR/ERVL-MaLR	830	+	166	1875935	74124
chr7	1801811	2001811	harbor1	chr7	1890217	1890614	LTR/ERVL-MaLR	1398	+	198	1890415	88604
chr7	100393717	100593717	harbor1	chr7	100395185	100395597	LTR/ERVL-MaLR	990	+	206	100395391	1674
chr7	28080184	28280184	harbor1	chr7	28084793	28085128	LTR/ERVL-MaLR	1651	+	168	28084961	4777
chr7	28080184	28280184	harbor1	chr7	28089154	28089432	LTR/ERVL-MaLR	1020	+	139	28089293	9109
chr7	28080184	28280184	harbor1	chr7	28089450	28089933	LTR/ERVL-MaLR	2061	+	242	28089692	9508
chr7	28080184	28280184	harbor1	chr7	28093145	28093505	LTR/ERVL-MaLR	2049	+	180	28093325	13141
chr7	28080184	28280184	harbor1	chr7	28098040	28098403	LTR/ERVL-MaLR	1557	+	182	28098222	18038
chr7	28080184	28280184	harbor1	chr7	28124022	28124409	LTR/ERVL-MaLR	1797	+	194	28124216	44032
chr7	28080184	28280184	harbor1	chr7	28139300	28139519	LTR/ERVL-MaLR	1061	+	110	28139410	59226
chr7	28080184	28280184	harbor1	chr7	28139532	28139718	LTR/ERVL-MaLR	725	+	93	28139625	59441
chr7	148600313	148800313	harbor1	chr7	148632711	148632925	LTR/ERVL-MaLR	2641	+	107	148632818	32505
chr7	148600313	148800313	harbor1	chr7	148633226	148633434	LTR/ERVL-MaLR	2641	+	104	148633330	33017
chr7	148600313	148800313	harbor1	chr7	148652980	148653339	LTR/ERVL-MaLR	2210	+	180	148653160	52847
chr7	148600313	148800313	harbor1	chr7	148667596	148667794	LTR/ERVL-MaLR	1928	+	99	148667695	67382
chr7	148600313	148800313	harbor1	chr7	148667838	148667997	LTR/ERVL-MaLR	1928	+	80	148667918	67605
chr7	148600313	148800313	harbor1	chr7	148671072	148671511	LTR/ERVL-MaLR	2059	+	220	148671292	70979
chr7	26995062	27195062	harbor1	chr7	27020938	27021301	LTR/ERVL-MaLR	2338	+	182	27021120	26058
chr7	26995062	27195062	harbor1	chr7	27065657	27066169	LTR/ERVL-MaLR	874	+	256	27065913	70851
chr7	88119108	88319108	harbor1	chr7	88204265	88204639	LTR/ERVL-MaLR	1939	+	187	88204452	85344
chr7	1758857	1958857	harbor1	chr7	1760164	1760381	LTR/ERVL-MaLR	983	+	108	1760272	1415
chr7	1758857	1958857	harbor1	chr7	1765428	1765892	LTR/ERVL-MaLR	1879	+	232	1765660	6803
chr7	1758857	1958857	harbor1	chr7	1804877	1805243	LTR/ERVL-MaLR	891	+	183	1805060	46203
chr7	50615319	50815319	harbor1	chr7	50686082	50686441	LTR/ERVL-MaLR	1871	+	180	50686262	70943
chr7	25270019	25470019	harbor1	chr7	25281497	25281975	LTR/ERVL-MaLR	836	+	239	25281736	11717
chr7	25270019	25470019	harbor1	chr7	25288071	25288214	LTR/ERVL-MaLR	659	+	72	25288143	18124
chr7	25270019	25470019	harbor1	chr7	25291238	25291600	LTR/ERVL-MaLR	2892	+	181	25291419	21400
chr7	25270019	25470019	harbor1	chr7	25311804	25312160	LTR/ERVL-MaLR	1886	+	178	25311982	41963
chr7	25270019	25470019	harbor1	chr7	25313627	25314050	LTR/ERVL-MaLR	1619	+	212	25313839	43820
chr7	25270019	25470019	harbor1	chr7	25328219	25328391	LTR/ERVL-MaLR	2242	+	86	25328305	58286
chr7	25270019	25470019	harbor1	chr7	25328708	25328983	LTR/ERVL-MaLR	2242	+	138	25328846	58827
chr7	25270019	25470019	harbor1	chr7	25334734	25335099	LTR/ERVL-MaLR	780	+	182	25334916	64897
chr7	25270019	25470019	harbor1	chr7	25354666	25355014	LTR/ERVL-MaLR	1480	+	174	25354840	84821
chr7	25270019	25470019	harbor1	chr7	25365908	25366486	LTR/ERVL-MaLR	1565	+	289	25366197	96178
chr7	25270019	25470019	harbor1	chr7	25366526	25366775	LTR/ERVL-MaLR	1565	+	124	25366650	96631
chr7	28080267	28280267	harbor1	chr7	28084793	28085128	LTR/ERVL-MaLR	1651	+	168	28084961	4694
chr7	28080267	28280267	harbor1	chr7	28089154	28089432	LTR/ERVL-MaLR	1020	+	139	28089293	9026
chr7	28080267	28280267	harbor1	chr7	28089450	28089933	LTR/ERVL-MaLR	2061	+	242	28089692	9425
chr7	28080267	28280267	harbor1	chr7	28093145	28093505	LTR/ERVL-MaLR	2049	+	180	28093325	13058
chr7	28080267	28280267	harbor1	chr7	28098040	28098403	LTR/ERVL-MaLR	1557	+	182	28098222	17955
chr7	28080267	28280267	harbor1	chr7	28124022	28124409	LTR/ERVL-MaLR	1797	+	194	28124216	43949
chr7	28080267	28280267	harbor1	chr7	28139300	28139519	LTR/ERVL-MaLR	1061	+	110	28139410	59143
chr7	28080267	28280267	harbor1	chr7	28139532	28139718	LTR/ERVL-MaLR	725	+	93	28139625	59358
chr7	148598238	148798238	harbor1	chr7	148632711	148632925	LTR/ERVL-MaLR	2641	+	107	148632818	34580
chr7	148598238	148798238	harbor1	chr7	148633226	148633434	LTR/ERVL-MaLR	2641	+	104	148633330	35092
chr7	148598238	148798238	harbor1	chr7	148652980	148653339	LTR/ERVL-MaLR	2210	+	180	148653160	54922
chr7	148598238	148798238	harbor1	chr7	148667596	148667794	LTR/ERVL-MaLR	1928	+	99	148667695	69457
chr7	148598238	148798238	harbor1	chr7	148667838	148667997	LTR/ERVL-MaLR	1928	+	80	148667918	69680
chr7	148598238	148798238	harbor1	chr7	148671072	148671511	LTR/ERVL-MaLR	2059	+	220	148671292	73054
chr7	123649232	123849232	harbor1	chr7	123709272	123709428	LTR/ERVL-MaLR	728	+	78	123709350	60118
chr7	47228345	47428345	harbor1	chr7	47232663	47233087	LTR/ERVL-MaLR	1646	+	212	47232875	4530
chr7	47228345	47428345	harbor1	chr7	47240726	47241089	LTR/ERVL-MaLR	1619	+	182	47240908	12563
chr7	47228345	47428345	harbor1	chr7	47252669	47253031	LTR/ERVL-MaLR	2167	+	181	47252850	24505
chr7	47228345	47428345	harbor1	chr7	47285285	47285649	LTR/ERVL-MaLR	2792	+	182	47285467	57122
chr7	32628568	32828568	harbor1	chr7	32637732	32638018	LTR/ERVL-MaLR	499	+	143	32637875	9307
chr7	32628568	32828568	harbor1	chr7	32676211	32676764	LTR/ERVL-MaLR	1692	+	276	32676487	47919
chr7	32628568	32828568	harbor1	chr7	32680118	32680554	LTR/ERVL-MaLR	1367	+	218	32680336	51768
chr7	32628568	32828568	harbor1	chr7	32682010	32682387	LTR/ERVL-MaLR	2068	+	188	32682198	53630
chr7	32628568	32828568	harbor1	chr7	32682388	32682678	LTR/ERVL-MaLR	1944	+	145	32682533	53965
chr7	32628568	32828568	harbor1	chr7	32688764	32689116	LTR/ERVL-MaLR	1859	+	176	32688940	60372
chr7	32628568	32828568	harbor1	chr7	32689412	32689452	LTR/ERVL-MaLR	1859	+	20	32689432	60864
chr7	32628568	32828568	harbor1	chr7	32689908	32690019	LTR/ERVL-MaLR	569	+	56	32689964	61396
chr7	32628568	32828568	harbor1	chr7	32692772	32693146	LTR/ERVL-MaLR	2455	+	187	32692959	64391
chr7	28080180	28280180	harbor1	chr7	28084793	28085128	LTR/ERVL-MaLR	1651	+	168	28084961	4781
chr7	28080180	28280180	harbor1	chr7	28089154	28089432	LTR/ERVL-MaLR	1020	+	139	28089293	9113
chr7	28080180	28280180	harbor1	chr7	28089450	28089933	LTR/ERVL-MaLR	2061	+	242	28089692	9512
chr7	28080180	28280180	harbor1	chr7	28093145	28093505	LTR/ERVL-MaLR	2049	+	180	28093325	13145
chr7	28080180	28280180	harbor1	chr7	28098040	28098403	LTR/ERVL-MaLR	1557	+	182	28098222	18042
chr7	28080180	28280180	harbor1	chr7	28124022	28124409	LTR/ERVL-MaLR	1797	+	194	28124216	44036
chr7	28080180	28280180	harbor1	chr7	28139300	28139519	LTR/ERVL-MaLR	1061	+	110	28139410	59230
chr7	28080180	28280180	harbor1	chr7	28139532	28139718	LTR/ERVL-MaLR	725	+	93	28139625	59445
chr7	5468045	5668045	harbor1	chr7	5492522	5492972	LTR/ERVL-MaLR	1201	+	225	5492747	24702
chr7	5468045	5668045	harbor1	chr7	5472241	5472871	LTR/ERVL-MaLR	958	+	315	5472556	4511
chr7	44506780	44706780	harbor1	chr7	44574470	44574570	LTR/ERVL-MaLR	544	+	50	44574520	67740
chr7	44506780	44706780	harbor1	chr7	44587654	44587829	LTR/ERVL-MaLR	618	+	88	44587742	80962
chr7	44506780	44706780	harbor1	chr7	44588785	44588952	LTR/ERVL-MaLR	587	+	84	44588869	82089
chr7	44506780	44706780	harbor1	chr7	44589262	44589319	LTR/ERVL-MaLR	587	+	28	44589290	82510
chr7	44506780	44706780	harbor1	chr7	44590962	44591250	LTR/ERVL-MaLR	695	+	144	44591106	84326
chr7	26995617	27195617	harbor1	chr7	27020938	27021301	LTR/ERVL-MaLR	2338	+	182	27021120	25503
chr7	26995617	27195617	harbor1	chr7	27065657	27066169	LTR/ERVL-MaLR	874	+	256	27065913	70296
chr7	50203852	50403852	harbor1	chr7	50270321	50270974	LTR/ERVL-MaLR	1870	+	326	50270647	66795
chr7	50203852	50403852	harbor1	chr7	50290315	50290697	LTR/ERVL-MaLR	2452	+	191	50290506	86654
chr7	1762067	1962067	harbor1	chr7	1765428	1765892	LTR/ERVL-MaLR	1879	+	232	1765660	3593
chr7	1762067	1962067	harbor1	chr7	1804877	1805243	LTR/ERVL-MaLR	891	+	183	1805060	42993
chr7	1798319	1998319	harbor1	chr7	1804877	1805243	LTR/ERVL-MaLR	891	+	183	1805060	6741
chr7	1798319	1998319	harbor1	chr7	1864626	1865004	LTR/ERVL-MaLR	1120	+	189	1864815	66496
chr7	1798319	1998319	harbor1	chr7	1875769	1876102	LTR/ERVL-MaLR	830	+	166	1875935	77616
chr7	1798319	1998319	harbor1	chr7	1890217	1890614	LTR/ERVL-MaLR	1398	+	198	1890415	92096
chr7	97770965	97970965	harbor1	chr7	97823863	97824213	LTR/ERVL-MaLR	1796	+	175	97824038	53073
chr7	97770965	97970965	harbor1	chr7	97825483	97825856	LTR/ERVL-MaLR	2462	+	186	97825669	54704
chr7	97770965	97970965	harbor1	chr7	97828024	97828381	LTR/ERVL-MaLR	860	+	178	97828202	57237
chr7	97770965	97970965	harbor1	chr7	97846701	97847060	LTR/ERVL-MaLR	538	+	180	97846881	75916
chr7	97770965	97970965	harbor1	chr7	97847065	97847429	LTR/ERVL-MaLR	988	+	182	97847247	76282
chr7	853415	1053415	harbor1	chr7	922932	923220	LTR/ERVL-MaLR	639	+	144	923076	69661
chr7	1801822	2001822	harbor1	chr7	1804877	1805243	LTR/ERVL-MaLR	891	+	183	1805060	3238
chr7	1801822	2001822	harbor1	chr7	1864626	1865004	LTR/ERVL-MaLR	1120	+	189	1864815	62993
chr7	1801822	2001822	harbor1	chr7	1875769	1876102	LTR/ERVL-MaLR	830	+	166	1875935	74113
chr7	1801822	2001822	harbor1	chr7	1890217	1890614	LTR/ERVL-MaLR	1398	+	198	1890415	88593
chr7	50203883	50403883	harbor1	chr7	50270321	50270974	LTR/ERVL-MaLR	1870	+	326	50270647	66764
chr7	50203883	50403883	harbor1	chr7	50290315	50290697	LTR/ERVL-MaLR	2452	+	191	50290506	86623
chr7	32307595	32507595	harbor1	chr7	32347413	32347970	LTR/ERVL-MaLR	1704	+	278	32347691	40096
chr7	32307595	32507595	harbor1	chr7	32374313	32374764	LTR/ERVL-MaLR	961	+	226	32374539	66944
chr7	32307595	32507595	harbor1	chr7	32394328	32394525	LTR/ERVL-MaLR	2054	+	98	32394426	86831
chr7	32307595	32507595	harbor1	chr7	32394821	32395085	LTR/ERVL-MaLR	2054	+	132	32394953	87358
chr7	142715604	142915604	harbor1	chr7	142719884	142720247	LTR/ERVL-MaLR	1796	+	182	142720066	4462
chr7	123649230	123849230	harbor1	chr7	123709272	123709428	LTR/ERVL-MaLR	728	+	78	123709350	60120
chr7	123649229	123849229	harbor1	chr7	123709272	123709428	LTR/ERVL-MaLR	728	+	78	123709350	60121
chr7	100388340	100588340	harbor1	chr7	100395185	100395597	LTR/ERVL-MaLR	990	+	206	100395391	7051
chr7	123649200	123849200	harbor1	chr7	123709272	123709428	LTR/ERVL-MaLR	728	+	78	123709350	60150
chr7	5469741	5669741	harbor1	chr7	5492522	5492972	LTR/ERVL-MaLR	1201	+	225	5492747	23006
chr7	5469741	5669741	harbor1	chr7	5472241	5472871	LTR/ERVL-MaLR	958	+	315	5472556	2815
chr7	44506860	44706860	harbor1	chr7	44574470	44574570	LTR/ERVL-MaLR	544	+	50	44574520	67660
chr7	44506860	44706860	harbor1	chr7	44587654	44587829	LTR/ERVL-MaLR	618	+	88	44587742	80882
chr7	44506860	44706860	harbor1	chr7	44588785	44588952	LTR/ERVL-MaLR	587	+	84	44588869	82009
chr7	44506860	44706860	harbor1	chr7	44589262	44589319	LTR/ERVL-MaLR	587	+	28	44589290	82430
chr7	44506860	44706860	harbor1	chr7	44590962	44591250	LTR/ERVL-MaLR	695	+	144	44591106	84246
chr7	100328345	100528345	harbor1	chr7	100342707	100343204	LTR/ERVL-MaLR	1542	+	248	100342955	14610
chr7	100328345	100528345	harbor1	chr7	100367337	100367673	LTR/ERVL-MaLR	718	+	168	100367505	39160
chr7	100328345	100528345	harbor1	chr7	100395185	100395597	LTR/ERVL-MaLR	990	+	206	100395391	67046
chr7	44439822	44639822	harbor1	chr7	44447360	44447734	LTR/ERVL-MaLR	1709	+	187	44447547	7725
chr7	44439822	44639822	harbor1	chr7	44476304	44476657	LTR/ERVL-MaLR	1932	+	176	44476480	36658
chr7	44439822	44639822	harbor1	chr7	44481742	44482077	LTR/ERVL-MaLR	1640	+	168	44481910	42088
chr7	44439822	44639822	harbor1	chr7	44493496	44493882	LTR/ERVL-MaLR	1393	+	193	44493689	53867
chr7	44439822	44639822	harbor1	chr7	44505686	44506063	LTR/ERVL-MaLR	2564	+	188	44505874	66052
chr7	24657323	24857323	harbor1	chr7	24707524	24707943	LTR/ERVL-MaLR	1148	+	210	24707734	50411
chr7	24657323	24857323	harbor1	chr7	24718723	24718964	LTR/ERVL-MaLR	672	+	120	24718843	61520
chr7	24657323	24857323	harbor1	chr7	24724745	24725161	LTR/ERVL-MaLR	2412	+	208	24724953	67630
chr7	24657323	24857323	harbor1	chr7	24728047	24728250	LTR/ERVL-MaLR	624	+	102	24728149	70826
chr7	28080203	28280203	harbor1	chr7	28084793	28085128	LTR/ERVL-MaLR	1651	+	168	28084961	4758
chr7	28080203	28280203	harbor1	chr7	28089154	28089432	LTR/ERVL-MaLR	1020	+	139	28089293	9090
chr7	28080203	28280203	harbor1	chr7	28089450	28089933	LTR/ERVL-MaLR	2061	+	242	28089692	9489
chr7	28080203	28280203	harbor1	chr7	28093145	28093505	LTR/ERVL-MaLR	2049	+	180	28093325	13122
chr7	28080203	28280203	harbor1	chr7	28098040	28098403	LTR/ERVL-MaLR	1557	+	182	28098222	18019
chr7	28080203	28280203	harbor1	chr7	28124022	28124409	LTR/ERVL-MaLR	1797	+	194	28124216	44013
chr7	28080203	28280203	harbor1	chr7	28139300	28139519	LTR/ERVL-MaLR	1061	+	110	28139410	59207
chr7	28080203	28280203	harbor1	chr7	28139532	28139718	LTR/ERVL-MaLR	725	+	93	28139625	59422
chr7	14798299	14998299	harbor1	chr7	14834366	14834711	LTR/ERVL-MaLR	924	+	172	14834538	36239
chr7	14798299	14998299	harbor1	chr7	14849292	14849631	LTR/ERVL-MaLR	1113	+	170	14849462	51163
chr7	14798299	14998299	harbor1	chr7	14851510	14852101	LTR/ERVL-MaLR	1489	+	296	14851806	53507
chr7	14798299	14998299	harbor1	chr7	14856949	14857192	LTR/ERVL-MaLR	670	+	122	14857071	58772
chr7	14798299	14998299	harbor1	chr7	14857232	14857248	LTR/ERVL-MaLR	670	+	8	14857240	58941
chr7	14798299	14998299	harbor1	chr7	14857280	14857558	LTR/ERVL-MaLR	896	+	139	14857419	59120
chr7	28080247	28280247	harbor1	chr7	28084793	28085128	LTR/ERVL-MaLR	1651	+	168	28084961	4714
chr7	28080247	28280247	harbor1	chr7	28089154	28089432	LTR/ERVL-MaLR	1020	+	139	28089293	9046
chr7	28080247	28280247	harbor1	chr7	28089450	28089933	LTR/ERVL-MaLR	2061	+	242	28089692	9445
chr7	28080247	28280247	harbor1	chr7	28093145	28093505	LTR/ERVL-MaLR	2049	+	180	28093325	13078
chr7	28080247	28280247	harbor1	chr7	28098040	28098403	LTR/ERVL-MaLR	1557	+	182	28098222	17975
chr7	28080247	28280247	harbor1	chr7	28124022	28124409	LTR/ERVL-MaLR	1797	+	194	28124216	43969
chr7	28080247	28280247	harbor1	chr7	28139300	28139519	LTR/ERVL-MaLR	1061	+	110	28139410	59163
chr7	28080247	28280247	harbor1	chr7	28139532	28139718	LTR/ERVL-MaLR	725	+	93	28139625	59378
chr7	149048098	149248098	harbor1	chr7	149048725	149049272	LTR/ERVL-MaLR	1843	+	274	149048999	901
chr7	149048098	149248098	harbor1	chr7	149062339	149062555	LTR/ERVL-MaLR	561	+	108	149062447	14349
chr7	149048098	149248098	harbor1	chr7	149082039	149082287	LTR/ERVL-MaLR	1187	+	124	149082163	34065
chr7	26995486	27195486	harbor1	chr7	27020938	27021301	LTR/ERVL-MaLR	2338	+	182	27021120	25634
chr7	26995486	27195486	harbor1	chr7	27065657	27066169	LTR/ERVL-MaLR	874	+	256	27065913	70427
chr7	100475318	100675318	harbor1	chr7	100521649	100521735	LTR/ERVL-MaLR	718	+	43	100521692	46374
chr7	100475318	100675318	harbor1	chr7	100522042	100522216	LTR/ERVL-MaLR	718	+	87	100522129	46811
chr7	100475318	100675318	harbor1	chr7	100524616	100524768	LTR/ERVL-MaLR	718	+	76	100524692	49374
chr7	100475318	100675318	harbor1	chr7	100525062	100525140	LTR/ERVL-MaLR	718	+	39	100525101	49783
chr7	47228395	47428395	harbor1	chr7	47232663	47233087	LTR/ERVL-MaLR	1646	+	212	47232875	4480
chr7	47228395	47428395	harbor1	chr7	47240726	47241089	LTR/ERVL-MaLR	1619	+	182	47240908	12513
chr7	47228395	47428395	harbor1	chr7	47252669	47253031	LTR/ERVL-MaLR	2167	+	181	47252850	24455
chr7	47228395	47428395	harbor1	chr7	47285285	47285649	LTR/ERVL-MaLR	2792	+	182	47285467	57072
chr7	90496291	90696291	harbor1	chr7	90528863	90529279	LTR/ERVL-MaLR	2423	+	208	90529071	32780
chr7	90496291	90696291	harbor1	chr7	90540296	90540872	LTR/ERVL-MaLR	1958	+	288	90540584	44293
chr7	90496291	90696291	harbor1	chr7	90565869	90566096	LTR/ERVL-MaLR	1943	+	114	90565983	69692
chr7	90496291	90696291	harbor1	chr7	90566375	90566493	LTR/ERVL-MaLR	1943	+	59	90566434	70143
chr7	90496291	90696291	harbor1	chr7	90589050	90589406	LTR/ERVL-MaLR	2064	+	178	90589228	92937
chr7	139380111	139580111	harbor1	chr7	139437839	139438159	LTR/ERVL-MaLR	602	+	160	139437999	57888
chr7	139380111	139580111	harbor1	chr7	139444482	139444746	LTR/ERVL-MaLR	978	+	132	139444614	64503
chr7	139380111	139580111	harbor1	chr7	139450821	139451080	LTR/ERVL-MaLR	672	+	130	139450951	70840
chr7	139380111	139580111	harbor1	chr7	139468746	139469149	LTR/ERVL-MaLR	1537	+	202	139468948	88837
chr7	25244355	25444355	harbor1	chr7	25252848	25253306	LTR/ERVL-MaLR	2461	+	229	25253077	8722
chr7	25244355	25444355	harbor1	chr7	25253307	25254014	LTR/ERVL-MaLR	1742	+	354	25253661	9306
chr7	25244355	25444355	harbor1	chr7	25281497	25281975	LTR/ERVL-MaLR	836	+	239	25281736	37381
chr7	25244355	25444355	harbor1	chr7	25288071	25288214	LTR/ERVL-MaLR	659	+	72	25288143	43788
chr7	25244355	25444355	harbor1	chr7	25291238	25291600	LTR/ERVL-MaLR	2892	+	181	25291419	47064
chr7	25244355	25444355	harbor1	chr7	25311804	25312160	LTR/ERVL-MaLR	1886	+	178	25311982	67627
chr7	25244355	25444355	harbor1	chr7	25313627	25314050	LTR/ERVL-MaLR	1619	+	212	25313839	69484
chr7	25244355	25444355	harbor1	chr7	25328219	25328391	LTR/ERVL-MaLR	2242	+	86	25328305	83950
chr7	25244355	25444355	harbor1	chr7	25328708	25328983	LTR/ERVL-MaLR	2242	+	138	25328846	84491
chr7	25244355	25444355	harbor1	chr7	25334734	25335099	LTR/ERVL-MaLR	780	+	182	25334916	90561
chr7	150296831	150496831	harbor1	chr7	150296649	150297077	LTR/ERVL-MaLR	1057	+	214	150296863	32
chr7	150296831	150496831	harbor1	chr7	150303069	150303489	LTR/ERVL-MaLR	586	+	210	150303279	6448
chr7	150296831	150496831	harbor1	chr7	150318254	150318453	LTR/ERVL-MaLR	942	+	100	150318354	21523
chr7	150296831	150496831	harbor1	chr7	150347559	150347669	LTR/ERVL-MaLR	1089	+	55	150347614	50783
chr7	150296831	150496831	harbor1	chr7	150347991	150348202	LTR/ERVL-MaLR	1089	+	106	150348097	51266
chr7	150296831	150496831	harbor1	chr7	150356132	150356276	LTR/ERVL-MaLR	773	+	72	150356204	59373
chr7	150296831	150496831	harbor1	chr7	150358859	150358968	LTR/ERVL-MaLR	676	+	54	150358913	62082
chr7	150296831	150496831	harbor1	chr7	150361527	150361777	LTR/ERVL-MaLR	1073	+	125	150361652	64821
chr7	28080222	28280222	harbor1	chr7	28084793	28085128	LTR/ERVL-MaLR	1651	+	168	28084961	4739
chr7	28080222	28280222	harbor1	chr7	28089154	28089432	LTR/ERVL-MaLR	1020	+	139	28089293	9071
chr7	28080222	28280222	harbor1	chr7	28089450	28089933	LTR/ERVL-MaLR	2061	+	242	28089692	9470
chr7	28080222	28280222	harbor1	chr7	28093145	28093505	LTR/ERVL-MaLR	2049	+	180	28093325	13103
chr7	28080222	28280222	harbor1	chr7	28098040	28098403	LTR/ERVL-MaLR	1557	+	182	28098222	18000
chr7	28080222	28280222	harbor1	chr7	28124022	28124409	LTR/ERVL-MaLR	1797	+	194	28124216	43994
chr7	28080222	28280222	harbor1	chr7	28139300	28139519	LTR/ERVL-MaLR	1061	+	110	28139410	59188
chr7	28080222	28280222	harbor1	chr7	28139532	28139718	LTR/ERVL-MaLR	725	+	93	28139625	59403
chr7	44439887	44639887	harbor1	chr7	44447360	44447734	LTR/ERVL-MaLR	1709	+	187	44447547	7660
chr7	44439887	44639887	harbor1	chr7	44476304	44476657	LTR/ERVL-MaLR	1932	+	176	44476480	36593
chr7	44439887	44639887	harbor1	chr7	44481742	44482077	LTR/ERVL-MaLR	1640	+	168	44481910	42023
chr7	44439887	44639887	harbor1	chr7	44493496	44493882	LTR/ERVL-MaLR	1393	+	193	44493689	53802
chr7	44439887	44639887	harbor1	chr7	44505686	44506063	LTR/ERVL-MaLR	2564	+	188	44505874	65987
chr7	1801827	2001827	harbor1	chr7	1804877	1805243	LTR/ERVL-MaLR	891	+	183	1805060	3233
chr7	1801827	2001827	harbor1	chr7	1864626	1865004	LTR/ERVL-MaLR	1120	+	189	1864815	62988
chr7	1801827	2001827	harbor1	chr7	1875769	1876102	LTR/ERVL-MaLR	830	+	166	1875935	74108
chr7	1801827	2001827	harbor1	chr7	1890217	1890614	LTR/ERVL-MaLR	1398	+	198	1890415	88588
chr7	858459	1058459	harbor1	chr7	922932	923220	LTR/ERVL-MaLR	639	+	144	923076	64617
chr7	47228348	47428348	harbor1	chr7	47232663	47233087	LTR/ERVL-MaLR	1646	+	212	47232875	4527
chr7	47228348	47428348	harbor1	chr7	47240726	47241089	LTR/ERVL-MaLR	1619	+	182	47240908	12560
chr7	47228348	47428348	harbor1	chr7	47252669	47253031	LTR/ERVL-MaLR	2167	+	181	47252850	24502
chr7	47228348	47428348	harbor1	chr7	47285285	47285649	LTR/ERVL-MaLR	2792	+	182	47285467	57119
chr7	47228354	47428354	harbor1	chr7	47232663	47233087	LTR/ERVL-MaLR	1646	+	212	47232875	4521
chr7	47228354	47428354	harbor1	chr7	47240726	47241089	LTR/ERVL-MaLR	1619	+	182	47240908	12554
chr7	47228354	47428354	harbor1	chr7	47252669	47253031	LTR/ERVL-MaLR	2167	+	181	47252850	24496
chr7	47228354	47428354	harbor1	chr7	47285285	47285649	LTR/ERVL-MaLR	2792	+	182	47285467	57113
chr7	25269481	25469481	harbor1	chr7	25281497	25281975	LTR/ERVL-MaLR	836	+	239	25281736	12255
chr7	25269481	25469481	harbor1	chr7	25288071	25288214	LTR/ERVL-MaLR	659	+	72	25288143	18662
chr7	25269481	25469481	harbor1	chr7	25291238	25291600	LTR/ERVL-MaLR	2892	+	181	25291419	21938
chr7	25269481	25469481	harbor1	chr7	25311804	25312160	LTR/ERVL-MaLR	1886	+	178	25311982	42501
chr7	25269481	25469481	harbor1	chr7	25313627	25314050	LTR/ERVL-MaLR	1619	+	212	25313839	44358
chr7	25269481	25469481	harbor1	chr7	25328219	25328391	LTR/ERVL-MaLR	2242	+	86	25328305	58824
chr7	25269481	25469481	harbor1	chr7	25328708	25328983	LTR/ERVL-MaLR	2242	+	138	25328846	59365
chr7	25269481	25469481	harbor1	chr7	25334734	25335099	LTR/ERVL-MaLR	780	+	182	25334916	65435
chr7	25269481	25469481	harbor1	chr7	25354666	25355014	LTR/ERVL-MaLR	1480	+	174	25354840	85359
chr7	25269481	25469481	harbor1	chr7	25365908	25366486	LTR/ERVL-MaLR	1565	+	289	25366197	96716
chr7	25269481	25469481	harbor1	chr7	25366526	25366775	LTR/ERVL-MaLR	1565	+	124	25366650	97169
chr7	50615284	50815284	harbor1	chr7	50686082	50686441	LTR/ERVL-MaLR	1871	+	180	50686262	70978
chr7	44506775	44706775	harbor1	chr7	44574470	44574570	LTR/ERVL-MaLR	544	+	50	44574520	67745
chr7	44506775	44706775	harbor1	chr7	44587654	44587829	LTR/ERVL-MaLR	618	+	88	44587742	80967
chr7	44506775	44706775	harbor1	chr7	44588785	44588952	LTR/ERVL-MaLR	587	+	84	44588869	82094
chr7	44506775	44706775	harbor1	chr7	44589262	44589319	LTR/ERVL-MaLR	587	+	28	44589290	82515
chr7	44506775	44706775	harbor1	chr7	44590962	44591250	LTR/ERVL-MaLR	695	+	144	44591106	84331
chr7	28080189	28280189	harbor1	chr7	28084793	28085128	LTR/ERVL-MaLR	1651	+	168	28084961	4772
chr7	28080189	28280189	harbor1	chr7	28089154	28089432	LTR/ERVL-MaLR	1020	+	139	28089293	9104
chr7	28080189	28280189	harbor1	chr7	28089450	28089933	LTR/ERVL-MaLR	2061	+	242	28089692	9503
chr7	28080189	28280189	harbor1	chr7	28093145	28093505	LTR/ERVL-MaLR	2049	+	180	28093325	13136
chr7	28080189	28280189	harbor1	chr7	28098040	28098403	LTR/ERVL-MaLR	1557	+	182	28098222	18033
chr7	28080189	28280189	harbor1	chr7	28124022	28124409	LTR/ERVL-MaLR	1797	+	194	28124216	44027
chr7	28080189	28280189	harbor1	chr7	28139300	28139519	LTR/ERVL-MaLR	1061	+	110	28139410	59221
chr7	28080189	28280189	harbor1	chr7	28139532	28139718	LTR/ERVL-MaLR	725	+	93	28139625	59436
chr7	128753811	128953811	harbor1	chr7	128824515	128824730	LTR/ERVL-MaLR	1977	+	108	128824623	70812
chr7	128753811	128953811	harbor1	chr7	128825049	128825212	LTR/ERVL-MaLR	1977	+	82	128825131	71320
chr7	127154041	127354041	harbor1	chr7	127163940	127164363	LTR/ERVL-MaLR	2974	+	212	127164152	10111
chr7	127154041	127354041	harbor1	chr7	127211590	127211900	LTR/ERVL-MaLR	971	+	155	127211745	57704
chr7	127154041	127354041	harbor1	chr7	127230533	127230884	LTR/ERVL-MaLR	1278	+	176	127230709	76668
chr7	26995599	27195599	harbor1	chr7	27020938	27021301	LTR/ERVL-MaLR	2338	+	182	27021120	25521
chr7	26995599	27195599	harbor1	chr7	27065657	27066169	LTR/ERVL-MaLR	874	+	256	27065913	70314
chr7	1801933	2001933	harbor1	chr7	1804877	1805243	LTR/ERVL-MaLR	891	+	183	1805060	3127
chr7	1801933	2001933	harbor1	chr7	1864626	1865004	LTR/ERVL-MaLR	1120	+	189	1864815	62882
chr7	1801933	2001933	harbor1	chr7	1875769	1876102	LTR/ERVL-MaLR	830	+	166	1875935	74002
chr7	1801933	2001933	harbor1	chr7	1890217	1890614	LTR/ERVL-MaLR	1398	+	198	1890415	88482
chr7	104889111	105089111	harbor1	chr7	104927983	104928163	LTR/ERVL-MaLR	2317	+	90	104928073	38962
chr7	104889111	105089111	harbor1	chr7	104928474	104928712	LTR/ERVL-MaLR	2317	+	119	104928593	39482
chr7	104889111	105089111	harbor1	chr7	104929088	104929104	LTR/ERVL-MaLR	2317	+	8	104929096	39985
chr7	104889111	105089111	harbor1	chr7	104936086	104936468	LTR/ERVL-MaLR	1355	+	191	104936277	47166
chr7	104889111	105089111	harbor1	chr7	104950831	104950975	LTR/ERVL-MaLR	518	+	72	104950903	61792
chr7	104889111	105089111	harbor1	chr7	104976457	104976608	LTR/ERVL-MaLR	943	+	76	104976533	87422
chr7	104889111	105089111	harbor1	chr7	104976903	104977061	LTR/ERVL-MaLR	943	+	79	104976982	87871
chr7	104889111	105089111	harbor1	chr7	104923032	104923580	LTR/ERVL-MaLR	1814	+	274	104923306	34195
chr7	6060378	6260378	harbor1	chr7	6063122	6063273	LTR/ERVL-MaLR	1869	+	76	6063198	2820
chr7	6060378	6260378	harbor1	chr7	6063865	6064090	LTR/ERVL-MaLR	1869	+	112	6063977	3599
chr7	6060378	6260378	harbor1	chr7	6064391	6064430	LTR/ERVL-MaLR	1869	+	20	6064411	4033
chr7	102333429	102533429	harbor1	chr7	102341964	102342347	LTR/ERVL-MaLR	2192	+	192	102342156	8727
chr7	155282486	155482486	harbor1	chr7	155289535	155289668	LTR/ERVL-MaLR	569	+	66	155289601	7115
chr7	155282486	155482486	harbor1	chr7	155290020	155290086	LTR/ERVL-MaLR	569	+	33	155290053	7567
chr7	155282486	155482486	harbor1	chr7	155290099	155290305	LTR/ERVL-MaLR	761	+	103	155290202	7716
chr7	155282486	155482486	harbor1	chr7	155315856	155316288	LTR/ERVL-MaLR	1183	+	216	155316072	33586
chr7	155282486	155482486	harbor1	chr7	155323260	155323614	LTR/ERVL-MaLR	1718	+	177	155323437	40951
chr7	155282486	155482486	harbor1	chr7	155329988	155330470	LTR/ERVL-MaLR	1422	+	241	155330229	47743
chr7	155282486	155482486	harbor1	chr7	155331993	155332329	LTR/ERVL-MaLR	1409	+	168	155332161	49675
chr7	155282486	155482486	harbor1	chr7	155337786	155338093	LTR/ERVL-MaLR	621	+	154	155337940	55454
chr7	155282486	155482486	harbor1	chr7	155342462	155342843	LTR/ERVL-MaLR	758	+	190	155342652	60166
chr7	155282486	155482486	harbor1	chr7	155351052	155351301	LTR/ERVL-MaLR	863	+	124	155351176	68690
chr7	31971286	32171286	harbor1	chr7	31977091	31977445	LTR/ERVL-MaLR	1103	+	177	31977268	5982
chr7	31971286	32171286	harbor1	chr7	31986487	31986862	LTR/ERVL-MaLR	1242	+	188	31986675	15389
chr7	31971286	32171286	harbor1	chr7	31990140	31990499	LTR/ERVL-MaLR	2548	+	180	31990320	19034
chr7	31971286	32171286	harbor1	chr7	32014863	32015258	LTR/ERVL-MaLR	1920	+	198	32015061	43775
chr7	31971286	32171286	harbor1	chr7	32048203	32048751	LTR/ERVL-MaLR	695	+	274	32048477	77191
chr7	47520643	47720643	harbor1	chr7	47533626	47533969	LTR/ERVL-MaLR	2307	+	172	47533798	13155
chr7	47520643	47720643	harbor1	chr7	47544367	47544633	LTR/ERVL-MaLR	1381	+	133	47544500	23857
chr7	47520643	47720643	harbor1	chr7	47560088	47560447	LTR/ERVL-MaLR	1849	+	180	47560268	39625
chr7	47520643	47720643	harbor1	chr7	47602332	47602745	LTR/ERVL-MaLR	2018	+	206	47602538	81895
chr7	47520643	47720643	harbor1	chr7	47606888	47606993	LTR/ERVL-MaLR	1714	+	52	47606940	86297
chr7	47520643	47720643	harbor1	chr7	47607300	47607544	LTR/ERVL-MaLR	1714	+	122	47607422	86779
chr7	47520643	47720643	harbor1	chr7	47607850	47607882	LTR/ERVL-MaLR	1714	+	16	47607866	87223
chr7	47520643	47720643	harbor1	chr7	47618123	47618232	LTR/ERVL-MaLR	1671	+	54	47618177	97534
chr7	47520643	47720643	harbor1	chr7	47618544	47618807	LTR/ERVL-MaLR	1671	+	132	47618676	98033
chr7	47520643	47720643	harbor1	chr7	47619711	47620069	LTR/ERVL-MaLR	2133	+	179	47619890	99247
chr7	44439928	44639928	harbor1	chr7	44447360	44447734	LTR/ERVL-MaLR	1709	+	187	44447547	7619
chr7	44439928	44639928	harbor1	chr7	44476304	44476657	LTR/ERVL-MaLR	1932	+	176	44476480	36552
chr7	44439928	44639928	harbor1	chr7	44481742	44482077	LTR/ERVL-MaLR	1640	+	168	44481910	41982
chr7	44439928	44639928	harbor1	chr7	44493496	44493882	LTR/ERVL-MaLR	1393	+	193	44493689	53761
chr7	44439928	44639928	harbor1	chr7	44505686	44506063	LTR/ERVL-MaLR	2564	+	188	44505874	65946
chr7	90142065	90342065	harbor1	chr7	90156282	90156435	LTR/ERVL-MaLR	771	+	76	90156358	14293
chr7	90142065	90342065	harbor1	chr7	90156777	90156969	LTR/ERVL-MaLR	1024	+	96	90156873	14808
chr7	90142065	90342065	harbor1	chr7	90173636	90173816	LTR/ERVL-MaLR	1457	+	90	90173726	31661
chr7	90142065	90342065	harbor1	chr7	90174121	90174209	LTR/ERVL-MaLR	1457	+	44	90174165	32100
chr7	90142065	90342065	harbor1	chr7	90174484	90174674	LTR/ERVL-MaLR	1457	+	95	90174579	32514
chr7	90142065	90342065	harbor1	chr7	90181544	90181650	LTR/ERVL-MaLR	700	+	53	90181597	39532
chr7	90142065	90342065	harbor1	chr7	90181628	90181780	LTR/ERVL-MaLR	831	+	76	90181704	39639
chr7	90142065	90342065	harbor1	chr7	90205740	90206105	LTR/ERVL-MaLR	1948	+	182	90205922	63857
chr7	90142065	90342065	harbor1	chr7	90239078	90239447	LTR/ERVL-MaLR	2190	+	184	90239262	97197
chr7	41380663	41580663	harbor1	chr7	41423116	41423257	LTR/ERVL-MaLR	952	+	70	41423186	42523
chr7	41380663	41580663	harbor1	chr7	41423562	41423796	LTR/ERVL-MaLR	952	+	117	41423679	43016
chr7	41380663	41580663	harbor1	chr7	41453321	41453656	LTR/ERVL-MaLR	1753	+	168	41453489	72826
chr7	41380663	41580663	harbor1	chr7	41474424	41474927	LTR/ERVL-MaLR	1520	+	252	41474676	94013
chr7	155304444	155504444	harbor1	chr7	155315856	155316288	LTR/ERVL-MaLR	1183	+	216	155316072	11628
chr7	155304444	155504444	harbor1	chr7	155323260	155323614	LTR/ERVL-MaLR	1718	+	177	155323437	18993
chr7	155304444	155504444	harbor1	chr7	155329988	155330470	LTR/ERVL-MaLR	1422	+	241	155330229	25785
chr7	155304444	155504444	harbor1	chr7	155331993	155332329	LTR/ERVL-MaLR	1409	+	168	155332161	27717
chr7	155304444	155504444	harbor1	chr7	155337786	155338093	LTR/ERVL-MaLR	621	+	154	155337940	33496
chr7	155304444	155504444	harbor1	chr7	155342462	155342843	LTR/ERVL-MaLR	758	+	190	155342652	38208
chr7	155304444	155504444	harbor1	chr7	155351052	155351301	LTR/ERVL-MaLR	863	+	124	155351176	46732
chr7	155304444	155504444	harbor1	chr7	155397360	155397522	LTR/ERVL-MaLR	1358	+	81	155397441	92997
chr7	155304444	155504444	harbor1	chr7	155398714	155399004	LTR/ERVL-MaLR	1358	+	145	155398859	94415
chr7	37817008	38017008	harbor1	chr7	37856208	37856521	LTR/ERVL-MaLR	893	+	156	37856364	39356
chr7	37817008	38017008	harbor1	chr7	37858756	37859161	LTR/ERVL-MaLR	2085	+	202	37858958	41950
chr7	21261819	21461819	harbor1	chr7	21274508	21274909	LTR/ERVL-MaLR	907	+	200	21274708	12889
chr7	21261819	21461819	harbor1	chr7	21276884	21277259	LTR/ERVL-MaLR	1701	+	188	21277072	15253
chr7	21261819	21461819	harbor1	chr7	21319742	21320133	LTR/ERVL-MaLR	1664	+	196	21319938	58119
chr7	21261819	21461819	harbor1	chr7	21320134	21320356	LTR/ERVL-MaLR	3999	+	111	21320245	58426
chr7	21261819	21461819	harbor1	chr7	21320660	21321412	LTR/ERVL-MaLR	3999	+	376	21321036	59217
chr7	21261819	21461819	harbor1	chr7	21349153	21349486	LTR/ERVL-MaLR	1996	+	166	21349319	87500
chr7	21261819	21461819	harbor1	chr7	21357077	21357538	LTR/ERVL-MaLR	1166	+	230	21357307	95488
chr7	1763585	1963585	harbor1	chr7	1765428	1765892	LTR/ERVL-MaLR	1879	+	232	1765660	2075
chr7	1763585	1963585	harbor1	chr7	1804877	1805243	LTR/ERVL-MaLR	891	+	183	1805060	41475
chr7	90496236	90696236	harbor1	chr7	90528863	90529279	LTR/ERVL-MaLR	2423	+	208	90529071	32835
chr7	90496236	90696236	harbor1	chr7	90540296	90540872	LTR/ERVL-MaLR	1958	+	288	90540584	44348
chr7	90496236	90696236	harbor1	chr7	90565869	90566096	LTR/ERVL-MaLR	1943	+	114	90565983	69747
chr7	90496236	90696236	harbor1	chr7	90566375	90566493	LTR/ERVL-MaLR	1943	+	59	90566434	70198
chr7	90496236	90696236	harbor1	chr7	90589050	90589406	LTR/ERVL-MaLR	2064	+	178	90589228	92992
chr7	50204685	50404685	harbor1	chr7	50270321	50270974	LTR/ERVL-MaLR	1870	+	326	50270647	65962
chr7	50204685	50404685	harbor1	chr7	50290315	50290697	LTR/ERVL-MaLR	2452	+	191	50290506	85821
chr7	150858477	151058477	harbor1	chr7	150862862	150863301	LTR/ERVL-MaLR	1773	+	220	150863082	4605
chr7	150858477	151058477	harbor1	chr7	150886818	150887140	LTR/ERVL-MaLR	1520	+	161	150886979	28502
chr7	150858477	151058477	harbor1	chr7	150887931	150888003	LTR/ERVL-MaLR	526	+	36	150887967	29490
chr7	150858477	151058477	harbor1	chr7	150895671	150896121	LTR/ERVL-MaLR	1766	+	225	150895896	37419
chr7	150858477	151058477	harbor1	chr7	150917181	150917699	LTR/ERVL-MaLR	1697	+	259	150917440	58963
chr7	150858477	151058477	harbor1	chr7	150920284	150920365	LTR/ERVL-MaLR	784	+	40	150920324	61847
chr7	150858477	151058477	harbor1	chr7	150920663	150920980	LTR/ERVL-MaLR	784	+	158	150920821	62344
chr7	150858477	151058477	harbor1	chr7	150923758	150923947	LTR/ERVL-MaLR	650	+	94	150923852	65375
chr7	157236661	157436661	harbor1	chr7	157298027	157298179	LTR/ERVL-MaLR	946	+	76	157298103	61442
chr7	157236661	157436661	harbor1	chr7	157298490	157298759	LTR/ERVL-MaLR	946	+	134	157298624	61963
chr7	90496254	90696254	harbor1	chr7	90528863	90529279	LTR/ERVL-MaLR	2423	+	208	90529071	32817
chr7	90496254	90696254	harbor1	chr7	90540296	90540872	LTR/ERVL-MaLR	1958	+	288	90540584	44330
chr7	90496254	90696254	harbor1	chr7	90565869	90566096	LTR/ERVL-MaLR	1943	+	114	90565983	69729
chr7	90496254	90696254	harbor1	chr7	90566375	90566493	LTR/ERVL-MaLR	1943	+	59	90566434	70180
chr7	90496254	90696254	harbor1	chr7	90589050	90589406	LTR/ERVL-MaLR	2064	+	178	90589228	92974
chr7	47228189	47428189	harbor1	chr7	47232663	47233087	LTR/ERVL-MaLR	1646	+	212	47232875	4686
chr7	47228189	47428189	harbor1	chr7	47240726	47241089	LTR/ERVL-MaLR	1619	+	182	47240908	12719
chr7	47228189	47428189	harbor1	chr7	47252669	47253031	LTR/ERVL-MaLR	2167	+	181	47252850	24661
chr7	47228189	47428189	harbor1	chr7	47285285	47285649	LTR/ERVL-MaLR	2792	+	182	47285467	57278
chr7	100393788	100593788	harbor1	chr7	100395185	100395597	LTR/ERVL-MaLR	990	+	206	100395391	1603
chr7	123639349	123839349	harbor1	chr7	123709272	123709428	LTR/ERVL-MaLR	728	+	78	123709350	70001
chr7	26994913	27194913	harbor1	chr7	27020938	27021301	LTR/ERVL-MaLR	2338	+	182	27021120	26207
chr7	26994913	27194913	harbor1	chr7	27065657	27066169	LTR/ERVL-MaLR	874	+	256	27065913	71000
chr7	45871804	46071804	harbor1	chr7	45875950	45876078	LTR/ERVL-MaLR	621	+	64	45876014	4210
chr7	45871804	46071804	harbor1	chr7	45909102	45909208	LTR/ERVL-MaLR	643	+	53	45909155	37351
chr7	45871804	46071804	harbor1	chr7	45928415	45928857	LTR/ERVL-MaLR	1497	+	221	45928636	56832
chr7	45871804	46071804	harbor1	chr7	45928894	45929301	LTR/ERVL-MaLR	1767	+	204	45929098	57294
chr7	45871804	46071804	harbor1	chr7	45958570	45958730	LTR/ERVL-MaLR	580	+	80	45958650	86846
chr7	50203893	50403893	harbor1	chr7	50270321	50270974	LTR/ERVL-MaLR	1870	+	326	50270647	66754
chr7	50203893	50403893	harbor1	chr7	50290315	50290697	LTR/ERVL-MaLR	2452	+	191	50290506	86613
chr7	28080187	28280187	harbor1	chr7	28084793	28085128	LTR/ERVL-MaLR	1651	+	168	28084961	4774
chr7	28080187	28280187	harbor1	chr7	28089154	28089432	LTR/ERVL-MaLR	1020	+	139	28089293	9106
chr7	28080187	28280187	harbor1	chr7	28089450	28089933	LTR/ERVL-MaLR	2061	+	242	28089692	9505
chr7	28080187	28280187	harbor1	chr7	28093145	28093505	LTR/ERVL-MaLR	2049	+	180	28093325	13138
chr7	28080187	28280187	harbor1	chr7	28098040	28098403	LTR/ERVL-MaLR	1557	+	182	28098222	18035
chr7	28080187	28280187	harbor1	chr7	28124022	28124409	LTR/ERVL-MaLR	1797	+	194	28124216	44029
chr7	28080187	28280187	harbor1	chr7	28139300	28139519	LTR/ERVL-MaLR	1061	+	110	28139410	59223
chr7	28080187	28280187	harbor1	chr7	28139532	28139718	LTR/ERVL-MaLR	725	+	93	28139625	59438
chr7	5469736	5669736	harbor1	chr7	5492522	5492972	LTR/ERVL-MaLR	1201	+	225	5492747	23011
chr7	5469736	5669736	harbor1	chr7	5472241	5472871	LTR/ERVL-MaLR	958	+	315	5472556	2820
chr7	50203935	50403935	harbor1	chr7	50270321	50270974	LTR/ERVL-MaLR	1870	+	326	50270647	66712
chr7	50203935	50403935	harbor1	chr7	50290315	50290697	LTR/ERVL-MaLR	2452	+	191	50290506	86571
chr7	1312770	1512770	harbor1	chr7	1342917	1343226	LTR/ERVL-MaLR	1926	+	154	1343071	30301
chr7	1312770	1512770	harbor1	chr7	1343533	1343603	LTR/ERVL-MaLR	1926	+	35	1343568	30798
chr7	1312770	1512770	harbor1	chr7	1371441	1371600	LTR/ERVL-MaLR	616	+	80	1371521	58751
chr7	1312770	1512770	harbor1	chr7	1371928	1372142	LTR/ERVL-MaLR	616	+	107	1372035	59265
chr7	1312770	1512770	harbor1	chr7	1392193	1392613	LTR/ERVL-MaLR	2457	+	210	1392403	79633
chr7	1312770	1512770	harbor1	chr7	1402066	1402538	LTR/ERVL-MaLR	1051	+	236	1402302	89532
chr7	44439932	44639932	harbor1	chr7	44447360	44447734	LTR/ERVL-MaLR	1709	+	187	44447547	7615
chr7	44439932	44639932	harbor1	chr7	44476304	44476657	LTR/ERVL-MaLR	1932	+	176	44476480	36548
chr7	44439932	44639932	harbor1	chr7	44481742	44482077	LTR/ERVL-MaLR	1640	+	168	44481910	41978
chr7	44439932	44639932	harbor1	chr7	44493496	44493882	LTR/ERVL-MaLR	1393	+	193	44493689	53757
chr7	44439932	44639932	harbor1	chr7	44505686	44506063	LTR/ERVL-MaLR	2564	+	188	44505874	65942
chr7	127283483	127483483	harbor1	chr7	127366697	127366931	LTR/ERVL-MaLR	636	+	117	127366814	83331
chr7	25465106	25665106	harbor1	chr7	25466551	25466923	LTR/ERVL-MaLR	1793	+	186	25466737	1631
chr7	25465106	25665106	harbor1	chr7	25488238	25488415	LTR/ERVL-MaLR	1465	+	88	25488326	23220
chr7	25465106	25665106	harbor1	chr7	25488445	25488675	LTR/ERVL-MaLR	1465	+	115	25488560	23454
chr7	25465106	25665106	harbor1	chr7	25537774	25538294	LTR/ERVL-MaLR	2372	+	260	25538034	72928
chr7	93685527	93885527	harbor1	chr7	93748041	93748409	LTR/ERVL-MaLR	1612	+	184	93748225	62698
chr7	93685527	93885527	harbor1	chr7	93749470	93749681	LTR/ERVL-MaLR	595	+	106	93749576	64049
chr7	152754707	152954707	harbor1	chr7	152755908	152756052	LTR/ERVL-MaLR	504	+	72	152755980	1273
chr7	152754707	152954707	harbor1	chr7	152756218	152756655	LTR/ERVL-MaLR	1978	+	218	152756436	1729
chr7	152754707	152954707	harbor1	chr7	152756665	152756998	LTR/ERVL-MaLR	670	+	166	152756831	2124
chr8	23408871	23608871	harbor1	chr8	23416643	23416988	LTR/ERVL-MaLR	1248	+	172	23416815	7944
chr8	23408871	23608871	harbor1	chr8	23419033	23419377	LTR/ERVL-MaLR	1113	+	172	23419205	10334
chr8	23408871	23608871	harbor1	chr8	23423662	23424033	LTR/ERVL-MaLR	2228	+	186	23423848	14977
chr8	23408871	23608871	harbor1	chr8	23448361	23448695	LTR/ERVL-MaLR	1614	+	167	23448528	39657
chr8	23408871	23608871	harbor1	chr8	23461908	23462142	LTR/ERVL-MaLR	611	+	117	23462025	53154
chr8	23408871	23608871	harbor1	chr8	23462477	23462877	LTR/ERVL-MaLR	1336	+	200	23462677	53806
chr8	23408871	23608871	harbor1	chr8	23475128	23475389	LTR/ERVL-MaLR	724	+	130	23475258	66387
chr8	23408871	23608871	harbor1	chr8	23490403	23490868	LTR/ERVL-MaLR	1585	+	232	23490635	81764
chr8	38169250	38369250	harbor1	chr8	38171294	38171432	LTR/ERVL-MaLR	454	+	69	38171363	2113
chr8	38169250	38369250	harbor1	chr8	38225020	38225390	LTR/ERVL-MaLR	2642	+	185	38225205	55955
chr8	23409382	23609382	harbor1	chr8	23416643	23416988	LTR/ERVL-MaLR	1248	+	172	23416815	7433
chr8	23409382	23609382	harbor1	chr8	23419033	23419377	LTR/ERVL-MaLR	1113	+	172	23419205	9823
chr8	23409382	23609382	harbor1	chr8	23423662	23424033	LTR/ERVL-MaLR	2228	+	186	23423848	14466
chr8	23409382	23609382	harbor1	chr8	23448361	23448695	LTR/ERVL-MaLR	1614	+	167	23448528	39146
chr8	23409382	23609382	harbor1	chr8	23461908	23462142	LTR/ERVL-MaLR	611	+	117	23462025	52643
chr8	23409382	23609382	harbor1	chr8	23462477	23462877	LTR/ERVL-MaLR	1336	+	200	23462677	53295
chr8	23409382	23609382	harbor1	chr8	23475128	23475389	LTR/ERVL-MaLR	724	+	130	23475258	65876
chr8	23409382	23609382	harbor1	chr8	23490403	23490868	LTR/ERVL-MaLR	1585	+	232	23490635	81253
chr8	23428927	23628927	harbor1	chr8	23448361	23448695	LTR/ERVL-MaLR	1614	+	167	23448528	19601
chr8	23428927	23628927	harbor1	chr8	23461908	23462142	LTR/ERVL-MaLR	611	+	117	23462025	33098
chr8	23428927	23628927	harbor1	chr8	23462477	23462877	LTR/ERVL-MaLR	1336	+	200	23462677	33750
chr8	23428927	23628927	harbor1	chr8	23475128	23475389	LTR/ERVL-MaLR	724	+	130	23475258	46331
chr8	23428927	23628927	harbor1	chr8	23490403	23490868	LTR/ERVL-MaLR	1585	+	232	23490635	61708
chr8	23428927	23628927	harbor1	chr8	23522310	23522666	LTR/ERVL-MaLR	1273	+	178	23522488	93561
chr8	23428927	23628927	harbor1	chr8	23510714	23511079	LTR/ERVL-MaLR	2218	+	182	23510896	81969
chr8	124271348	124471348	harbor1	chr8	124271205	124271587	LTR/ERVL-MaLR	1901	+	191	124271396	48
chr8	124271348	124471348	harbor1	chr8	124273941	124274298	LTR/ERVL-MaLR	2038	+	178	124274119	2771
chr8	124271348	124471348	harbor1	chr8	124293600	124293820	LTR/ERVL-MaLR	488	+	110	124293710	22362
chr8	124271348	124471348	harbor1	chr8	124295471	124295720	LTR/ERVL-MaLR	657	+	124	124295595	24247
chr8	124271348	124471348	harbor1	chr8	124303664	124303953	LTR/ERVL-MaLR	588	+	144	124303808	32460
chr8	124271348	124471348	harbor1	chr8	124317602	124317890	LTR/ERVL-MaLR	925	+	144	124317746	46398
chr8	124271348	124471348	harbor1	chr8	124318105	124318363	LTR/ERVL-MaLR	894	+	129	124318234	46886
chr8	124271348	124471348	harbor1	chr8	124318675	124318698	LTR/ERVL-MaLR	894	+	12	124318687	47339
chr8	124271348	124471348	harbor1	chr8	124356113	124356198	LTR/ERVL-MaLR	484	+	42	124356155	84807
chr8	124271348	124471348	harbor1	chr8	124365398	124365504	LTR/ERVL-MaLR	1383	+	53	124365451	94103
chr8	124271348	124471348	harbor1	chr8	124365505	124365938	LTR/ERVL-MaLR	1737	+	216	124365721	94373
chr8	124271348	124471348	harbor1	chr8	124366239	124366521	LTR/ERVL-MaLR	1383	+	141	124366380	95032
chr8	124271348	124471348	harbor1	chr8	124368106	124368247	LTR/ERVL-MaLR	411	+	70	124368176	96828
chr8	124271348	124471348	harbor1	chr8	124368389	124368925	LTR/ERVL-MaLR	1808	+	268	124368657	97309
chr8	23428510	23628510	harbor1	chr8	23448361	23448695	LTR/ERVL-MaLR	1614	+	167	23448528	20018
chr8	23428510	23628510	harbor1	chr8	23461908	23462142	LTR/ERVL-MaLR	611	+	117	23462025	33515
chr8	23428510	23628510	harbor1	chr8	23462477	23462877	LTR/ERVL-MaLR	1336	+	200	23462677	34167
chr8	23428510	23628510	harbor1	chr8	23475128	23475389	LTR/ERVL-MaLR	724	+	130	23475258	46748
chr8	23428510	23628510	harbor1	chr8	23490403	23490868	LTR/ERVL-MaLR	1585	+	232	23490635	62125
chr8	23428510	23628510	harbor1	chr8	23522310	23522666	LTR/ERVL-MaLR	1273	+	178	23522488	93978
chr8	23428510	23628510	harbor1	chr8	23510714	23511079	LTR/ERVL-MaLR	2218	+	182	23510896	82386
chr8	23428925	23628925	harbor1	chr8	23448361	23448695	LTR/ERVL-MaLR	1614	+	167	23448528	19603
chr8	23428925	23628925	harbor1	chr8	23461908	23462142	LTR/ERVL-MaLR	611	+	117	23462025	33100
chr8	23428925	23628925	harbor1	chr8	23462477	23462877	LTR/ERVL-MaLR	1336	+	200	23462677	33752
chr8	23428925	23628925	harbor1	chr8	23475128	23475389	LTR/ERVL-MaLR	724	+	130	23475258	46333
chr8	23428925	23628925	harbor1	chr8	23490403	23490868	LTR/ERVL-MaLR	1585	+	232	23490635	61710
chr8	23428925	23628925	harbor1	chr8	23522310	23522666	LTR/ERVL-MaLR	1273	+	178	23522488	93563
chr8	23428925	23628925	harbor1	chr8	23510714	23511079	LTR/ERVL-MaLR	2218	+	182	23510896	81971
chr8	23428297	23628297	harbor1	chr8	23448361	23448695	LTR/ERVL-MaLR	1614	+	167	23448528	20231
chr8	23428297	23628297	harbor1	chr8	23461908	23462142	LTR/ERVL-MaLR	611	+	117	23462025	33728
chr8	23428297	23628297	harbor1	chr8	23462477	23462877	LTR/ERVL-MaLR	1336	+	200	23462677	34380
chr8	23428297	23628297	harbor1	chr8	23475128	23475389	LTR/ERVL-MaLR	724	+	130	23475258	46961
chr8	23428297	23628297	harbor1	chr8	23490403	23490868	LTR/ERVL-MaLR	1585	+	232	23490635	62338
chr8	23428297	23628297	harbor1	chr8	23522310	23522666	LTR/ERVL-MaLR	1273	+	178	23522488	94191
chr8	23428297	23628297	harbor1	chr8	23510714	23511079	LTR/ERVL-MaLR	2218	+	182	23510896	82599
chr8	138636000	138836000	harbor1	chr8	138646914	138647446	LTR/ERVL-MaLR	1525	+	266	138647180	11180
chr8	138636000	138836000	harbor1	chr8	138683444	138683829	LTR/ERVL-MaLR	980	+	192	138683636	47636
chr8	138636000	138836000	harbor1	chr8	138685474	138685872	LTR/ERVL-MaLR	1373	+	199	138685673	49673
chr8	142524992	142724992	harbor1	chr8	142567776	142567888	LTR/ERVL-MaLR	1180	+	56	142567832	42840
chr8	142524992	142724992	harbor1	chr8	142568187	142568441	LTR/ERVL-MaLR	1180	+	127	142568314	43322
chr8	142524992	142724992	harbor1	chr8	142588525	142588934	LTR/ERVL-MaLR	2166	+	204	142588729	63737
chr8	23408903	23608903	harbor1	chr8	23416643	23416988	LTR/ERVL-MaLR	1248	+	172	23416815	7912
chr8	23408903	23608903	harbor1	chr8	23419033	23419377	LTR/ERVL-MaLR	1113	+	172	23419205	10302
chr8	23408903	23608903	harbor1	chr8	23423662	23424033	LTR/ERVL-MaLR	2228	+	186	23423848	14945
chr8	23408903	23608903	harbor1	chr8	23448361	23448695	LTR/ERVL-MaLR	1614	+	167	23448528	39625
chr8	23408903	23608903	harbor1	chr8	23461908	23462142	LTR/ERVL-MaLR	611	+	117	23462025	53122
chr8	23408903	23608903	harbor1	chr8	23462477	23462877	LTR/ERVL-MaLR	1336	+	200	23462677	53774
chr8	23408903	23608903	harbor1	chr8	23475128	23475389	LTR/ERVL-MaLR	724	+	130	23475258	66355
chr8	23408903	23608903	harbor1	chr8	23490403	23490868	LTR/ERVL-MaLR	1585	+	232	23490635	81732
chr8	23379720	23579720	harbor1	chr8	23399318	23399738	LTR/ERVL-MaLR	2516	+	210	23399528	19808
chr8	23379720	23579720	harbor1	chr8	23416643	23416988	LTR/ERVL-MaLR	1248	+	172	23416815	37095
chr8	23379720	23579720	harbor1	chr8	23419033	23419377	LTR/ERVL-MaLR	1113	+	172	23419205	39485
chr8	23379720	23579720	harbor1	chr8	23423662	23424033	LTR/ERVL-MaLR	2228	+	186	23423848	44128
chr8	23379720	23579720	harbor1	chr8	23448361	23448695	LTR/ERVL-MaLR	1614	+	167	23448528	68808
chr8	23379720	23579720	harbor1	chr8	23461908	23462142	LTR/ERVL-MaLR	611	+	117	23462025	82305
chr8	23379720	23579720	harbor1	chr8	23462477	23462877	LTR/ERVL-MaLR	1336	+	200	23462677	82957
chr8	23379720	23579720	harbor1	chr8	23475128	23475389	LTR/ERVL-MaLR	724	+	130	23475258	95538
chr8	23428962	23628962	harbor1	chr8	23448361	23448695	LTR/ERVL-MaLR	1614	+	167	23448528	19566
chr8	23428962	23628962	harbor1	chr8	23461908	23462142	LTR/ERVL-MaLR	611	+	117	23462025	33063
chr8	23428962	23628962	harbor1	chr8	23462477	23462877	LTR/ERVL-MaLR	1336	+	200	23462677	33715
chr8	23428962	23628962	harbor1	chr8	23475128	23475389	LTR/ERVL-MaLR	724	+	130	23475258	46296
chr8	23428962	23628962	harbor1	chr8	23490403	23490868	LTR/ERVL-MaLR	1585	+	232	23490635	61673
chr8	23428962	23628962	harbor1	chr8	23522310	23522666	LTR/ERVL-MaLR	1273	+	178	23522488	93526
chr8	23428962	23628962	harbor1	chr8	23510714	23511079	LTR/ERVL-MaLR	2218	+	182	23510896	81934
chr8	23428983	23628983	harbor1	chr8	23448361	23448695	LTR/ERVL-MaLR	1614	+	167	23448528	19545
chr8	23428983	23628983	harbor1	chr8	23461908	23462142	LTR/ERVL-MaLR	611	+	117	23462025	33042
chr8	23428983	23628983	harbor1	chr8	23462477	23462877	LTR/ERVL-MaLR	1336	+	200	23462677	33694
chr8	23428983	23628983	harbor1	chr8	23475128	23475389	LTR/ERVL-MaLR	724	+	130	23475258	46275
chr8	23428983	23628983	harbor1	chr8	23490403	23490868	LTR/ERVL-MaLR	1585	+	232	23490635	61652
chr8	23428983	23628983	harbor1	chr8	23522310	23522666	LTR/ERVL-MaLR	1273	+	178	23522488	93505
chr8	23428983	23628983	harbor1	chr8	23510714	23511079	LTR/ERVL-MaLR	2218	+	182	23510896	81913
chr8	23428928	23628928	harbor1	chr8	23448361	23448695	LTR/ERVL-MaLR	1614	+	167	23448528	19600
chr8	23428928	23628928	harbor1	chr8	23461908	23462142	LTR/ERVL-MaLR	611	+	117	23462025	33097
chr8	23428928	23628928	harbor1	chr8	23462477	23462877	LTR/ERVL-MaLR	1336	+	200	23462677	33749
chr8	23428928	23628928	harbor1	chr8	23475128	23475389	LTR/ERVL-MaLR	724	+	130	23475258	46330
chr8	23428928	23628928	harbor1	chr8	23490403	23490868	LTR/ERVL-MaLR	1585	+	232	23490635	61707
chr8	23428928	23628928	harbor1	chr8	23522310	23522666	LTR/ERVL-MaLR	1273	+	178	23522488	93560
chr8	23428928	23628928	harbor1	chr8	23510714	23511079	LTR/ERVL-MaLR	2218	+	182	23510896	81968
chr8	23371923	23571923	harbor1	chr8	23399318	23399738	LTR/ERVL-MaLR	2516	+	210	23399528	27605
chr8	23371923	23571923	harbor1	chr8	23416643	23416988	LTR/ERVL-MaLR	1248	+	172	23416815	44892
chr8	23371923	23571923	harbor1	chr8	23419033	23419377	LTR/ERVL-MaLR	1113	+	172	23419205	47282
chr8	23371923	23571923	harbor1	chr8	23423662	23424033	LTR/ERVL-MaLR	2228	+	186	23423848	51925
chr8	23371923	23571923	harbor1	chr8	23448361	23448695	LTR/ERVL-MaLR	1614	+	167	23448528	76605
chr8	23371923	23571923	harbor1	chr8	23461908	23462142	LTR/ERVL-MaLR	611	+	117	23462025	90102
chr8	23371923	23571923	harbor1	chr8	23462477	23462877	LTR/ERVL-MaLR	1336	+	200	23462677	90754
chr8	10820948	11020948	harbor1	chr8	10847341	10847687	LTR/ERVL-MaLR	1968	+	173	10847514	26566
chr8	10820948	11020948	harbor1	chr8	10853990	10854324	LTR/ERVL-MaLR	1555	+	167	10854157	33209
chr8	10820948	11020948	harbor1	chr8	10903495	10903784	LTR/ERVL-MaLR	1555	+	144	10903639	82691
chr8	10820948	11020948	harbor1	chr8	10908686	10908882	LTR/ERVL-MaLR	1660	+	98	10908784	87836
chr8	10820948	11020948	harbor1	chr8	10909181	10909377	LTR/ERVL-MaLR	1660	+	98	10909279	88331
chr8	23428391	23628391	harbor1	chr8	23448361	23448695	LTR/ERVL-MaLR	1614	+	167	23448528	20137
chr8	23428391	23628391	harbor1	chr8	23461908	23462142	LTR/ERVL-MaLR	611	+	117	23462025	33634
chr8	23428391	23628391	harbor1	chr8	23462477	23462877	LTR/ERVL-MaLR	1336	+	200	23462677	34286
chr8	23428391	23628391	harbor1	chr8	23475128	23475389	LTR/ERVL-MaLR	724	+	130	23475258	46867
chr8	23428391	23628391	harbor1	chr8	23490403	23490868	LTR/ERVL-MaLR	1585	+	232	23490635	62244
chr8	23428391	23628391	harbor1	chr8	23522310	23522666	LTR/ERVL-MaLR	1273	+	178	23522488	94097
chr8	23428391	23628391	harbor1	chr8	23510714	23511079	LTR/ERVL-MaLR	2218	+	182	23510896	82505
chr8	23428850	23628850	harbor1	chr8	23448361	23448695	LTR/ERVL-MaLR	1614	+	167	23448528	19678
chr8	23428850	23628850	harbor1	chr8	23461908	23462142	LTR/ERVL-MaLR	611	+	117	23462025	33175
chr8	23428850	23628850	harbor1	chr8	23462477	23462877	LTR/ERVL-MaLR	1336	+	200	23462677	33827
chr8	23428850	23628850	harbor1	chr8	23475128	23475389	LTR/ERVL-MaLR	724	+	130	23475258	46408
chr8	23428850	23628850	harbor1	chr8	23490403	23490868	LTR/ERVL-MaLR	1585	+	232	23490635	61785
chr8	23428850	23628850	harbor1	chr8	23522310	23522666	LTR/ERVL-MaLR	1273	+	178	23522488	93638
chr8	23428850	23628850	harbor1	chr8	23510714	23511079	LTR/ERVL-MaLR	2218	+	182	23510896	82046
chr8	23371938	23571938	harbor1	chr8	23399318	23399738	LTR/ERVL-MaLR	2516	+	210	23399528	27590
chr8	23371938	23571938	harbor1	chr8	23416643	23416988	LTR/ERVL-MaLR	1248	+	172	23416815	44877
chr8	23371938	23571938	harbor1	chr8	23419033	23419377	LTR/ERVL-MaLR	1113	+	172	23419205	47267
chr8	23371938	23571938	harbor1	chr8	23423662	23424033	LTR/ERVL-MaLR	2228	+	186	23423848	51910
chr8	23371938	23571938	harbor1	chr8	23448361	23448695	LTR/ERVL-MaLR	1614	+	167	23448528	76590
chr8	23371938	23571938	harbor1	chr8	23461908	23462142	LTR/ERVL-MaLR	611	+	117	23462025	90087
chr8	23371938	23571938	harbor1	chr8	23462477	23462877	LTR/ERVL-MaLR	1336	+	200	23462677	90739
chr8	23428493	23628493	harbor1	chr8	23448361	23448695	LTR/ERVL-MaLR	1614	+	167	23448528	20035
chr8	23428493	23628493	harbor1	chr8	23461908	23462142	LTR/ERVL-MaLR	611	+	117	23462025	33532
chr8	23428493	23628493	harbor1	chr8	23462477	23462877	LTR/ERVL-MaLR	1336	+	200	23462677	34184
chr8	23428493	23628493	harbor1	chr8	23475128	23475389	LTR/ERVL-MaLR	724	+	130	23475258	46765
chr8	23428493	23628493	harbor1	chr8	23490403	23490868	LTR/ERVL-MaLR	1585	+	232	23490635	62142
chr8	23428493	23628493	harbor1	chr8	23522310	23522666	LTR/ERVL-MaLR	1273	+	178	23522488	93995
chr8	23428493	23628493	harbor1	chr8	23510714	23511079	LTR/ERVL-MaLR	2218	+	182	23510896	82403
chr8	23428942	23628942	harbor1	chr8	23448361	23448695	LTR/ERVL-MaLR	1614	+	167	23448528	19586
chr8	23428942	23628942	harbor1	chr8	23461908	23462142	LTR/ERVL-MaLR	611	+	117	23462025	33083
chr8	23428942	23628942	harbor1	chr8	23462477	23462877	LTR/ERVL-MaLR	1336	+	200	23462677	33735
chr8	23428942	23628942	harbor1	chr8	23475128	23475389	LTR/ERVL-MaLR	724	+	130	23475258	46316
chr8	23428942	23628942	harbor1	chr8	23490403	23490868	LTR/ERVL-MaLR	1585	+	232	23490635	61693
chr8	23428942	23628942	harbor1	chr8	23522310	23522666	LTR/ERVL-MaLR	1273	+	178	23522488	93546
chr8	23428942	23628942	harbor1	chr8	23510714	23511079	LTR/ERVL-MaLR	2218	+	182	23510896	81954
chr8	23428811	23628811	harbor1	chr8	23448361	23448695	LTR/ERVL-MaLR	1614	+	167	23448528	19717
chr8	23428811	23628811	harbor1	chr8	23461908	23462142	LTR/ERVL-MaLR	611	+	117	23462025	33214
chr8	23428811	23628811	harbor1	chr8	23462477	23462877	LTR/ERVL-MaLR	1336	+	200	23462677	33866
chr8	23428811	23628811	harbor1	chr8	23475128	23475389	LTR/ERVL-MaLR	724	+	130	23475258	46447
chr8	23428811	23628811	harbor1	chr8	23490403	23490868	LTR/ERVL-MaLR	1585	+	232	23490635	61824
chr8	23428811	23628811	harbor1	chr8	23522310	23522666	LTR/ERVL-MaLR	1273	+	178	23522488	93677
chr8	23428811	23628811	harbor1	chr8	23510714	23511079	LTR/ERVL-MaLR	2218	+	182	23510896	82085
chr8	22449326	22649326	harbor1	chr8	22457225	22457289	LTR/ERVL-MaLR	447	+	32	22457257	7931
chr8	22449326	22649326	harbor1	chr8	22459695	22459791	LTR/ERVL-MaLR	624	+	48	22459743	10417
chr8	22449326	22649326	harbor1	chr8	22465298	22465329	LTR/ERVL-MaLR	1373	+	16	22465314	15988
chr8	22449326	22649326	harbor1	chr8	22465441	22465773	LTR/ERVL-MaLR	1373	+	166	22465607	16281
chr8	22449326	22649326	harbor1	chr8	22468791	22468984	LTR/ERVL-MaLR	628	+	96	22468887	19561
chr8	22449326	22649326	harbor1	chr8	22469570	22469915	LTR/ERVL-MaLR	1275	+	172	22469742	20416
chr8	22449326	22649326	harbor1	chr8	22486294	22486714	LTR/ERVL-MaLR	472	+	210	22486504	37178
chr8	23409313	23609313	harbor1	chr8	23416643	23416988	LTR/ERVL-MaLR	1248	+	172	23416815	7502
chr8	23409313	23609313	harbor1	chr8	23419033	23419377	LTR/ERVL-MaLR	1113	+	172	23419205	9892
chr8	23409313	23609313	harbor1	chr8	23423662	23424033	LTR/ERVL-MaLR	2228	+	186	23423848	14535
chr8	23409313	23609313	harbor1	chr8	23448361	23448695	LTR/ERVL-MaLR	1614	+	167	23448528	39215
chr8	23409313	23609313	harbor1	chr8	23461908	23462142	LTR/ERVL-MaLR	611	+	117	23462025	52712
chr8	23409313	23609313	harbor1	chr8	23462477	23462877	LTR/ERVL-MaLR	1336	+	200	23462677	53364
chr8	23409313	23609313	harbor1	chr8	23475128	23475389	LTR/ERVL-MaLR	724	+	130	23475258	65945
chr8	23409313	23609313	harbor1	chr8	23490403	23490868	LTR/ERVL-MaLR	1585	+	232	23490635	81322
chr8	9314880	9514880	harbor1	chr8	9333945	9334326	LTR/ERVL-MaLR	2360	+	190	9334135	19255
chr8	9314880	9514880	harbor1	chr8	9334773	9335129	LTR/ERVL-MaLR	1595	+	178	9334951	20071
chr8	9314880	9514880	harbor1	chr8	9341572	9342051	LTR/ERVL-MaLR	2724	+	240	9341812	26932
chr8	9314880	9514880	harbor1	chr8	9343529	9343983	LTR/ERVL-MaLR	1592	+	227	9343756	28876
chr8	9314880	9514880	harbor1	chr8	9358309	9358663	LTR/ERVL-MaLR	2117	+	177	9358486	43606
chr8	9314880	9514880	harbor1	chr8	9361168	9361542	LTR/ERVL-MaLR	2976	+	187	9361355	46475
chr8	9314880	9514880	harbor1	chr8	9383652	9384090	LTR/ERVL-MaLR	2508	+	219	9383871	68991
chr8	9314880	9514880	harbor1	chr8	9388600	9389001	LTR/ERVL-MaLR	1048	+	200	9388800	73920
chr8	9314880	9514880	harbor1	chr8	9391983	9392395	LTR/ERVL-MaLR	2223	+	206	9392189	77309
chr8	38169200	38369200	harbor1	chr8	38171294	38171432	LTR/ERVL-MaLR	454	+	69	38171363	2163
chr8	38169200	38369200	harbor1	chr8	38225020	38225390	LTR/ERVL-MaLR	2642	+	185	38225205	56005
chr8	23398381	23598381	harbor1	chr8	23399318	23399738	LTR/ERVL-MaLR	2516	+	210	23399528	1147
chr8	23398381	23598381	harbor1	chr8	23416643	23416988	LTR/ERVL-MaLR	1248	+	172	23416815	18434
chr8	23398381	23598381	harbor1	chr8	23419033	23419377	LTR/ERVL-MaLR	1113	+	172	23419205	20824
chr8	23398381	23598381	harbor1	chr8	23423662	23424033	LTR/ERVL-MaLR	2228	+	186	23423848	25467
chr8	23398381	23598381	harbor1	chr8	23448361	23448695	LTR/ERVL-MaLR	1614	+	167	23448528	50147
chr8	23398381	23598381	harbor1	chr8	23461908	23462142	LTR/ERVL-MaLR	611	+	117	23462025	63644
chr8	23398381	23598381	harbor1	chr8	23462477	23462877	LTR/ERVL-MaLR	1336	+	200	23462677	64296
chr8	23398381	23598381	harbor1	chr8	23475128	23475389	LTR/ERVL-MaLR	724	+	130	23475258	76877
chr8	23398381	23598381	harbor1	chr8	23490403	23490868	LTR/ERVL-MaLR	1585	+	232	23490635	92254
chr8	23382036	23582036	harbor1	chr8	23399318	23399738	LTR/ERVL-MaLR	2516	+	210	23399528	17492
chr8	23382036	23582036	harbor1	chr8	23416643	23416988	LTR/ERVL-MaLR	1248	+	172	23416815	34779
chr8	23382036	23582036	harbor1	chr8	23419033	23419377	LTR/ERVL-MaLR	1113	+	172	23419205	37169
chr8	23382036	23582036	harbor1	chr8	23423662	23424033	LTR/ERVL-MaLR	2228	+	186	23423848	41812
chr8	23382036	23582036	harbor1	chr8	23448361	23448695	LTR/ERVL-MaLR	1614	+	167	23448528	66492
chr8	23382036	23582036	harbor1	chr8	23461908	23462142	LTR/ERVL-MaLR	611	+	117	23462025	79989
chr8	23382036	23582036	harbor1	chr8	23462477	23462877	LTR/ERVL-MaLR	1336	+	200	23462677	80641
chr8	23382036	23582036	harbor1	chr8	23475128	23475389	LTR/ERVL-MaLR	724	+	130	23475258	93222
chr8	23409011	23609011	harbor1	chr8	23416643	23416988	LTR/ERVL-MaLR	1248	+	172	23416815	7804
chr8	23409011	23609011	harbor1	chr8	23419033	23419377	LTR/ERVL-MaLR	1113	+	172	23419205	10194
chr8	23409011	23609011	harbor1	chr8	23423662	23424033	LTR/ERVL-MaLR	2228	+	186	23423848	14837
chr8	23409011	23609011	harbor1	chr8	23448361	23448695	LTR/ERVL-MaLR	1614	+	167	23448528	39517
chr8	23409011	23609011	harbor1	chr8	23461908	23462142	LTR/ERVL-MaLR	611	+	117	23462025	53014
chr8	23409011	23609011	harbor1	chr8	23462477	23462877	LTR/ERVL-MaLR	1336	+	200	23462677	53666
chr8	23409011	23609011	harbor1	chr8	23475128	23475389	LTR/ERVL-MaLR	724	+	130	23475258	66247
chr8	23409011	23609011	harbor1	chr8	23490403	23490868	LTR/ERVL-MaLR	1585	+	232	23490635	81624
chr8	23428813	23628813	harbor1	chr8	23448361	23448695	LTR/ERVL-MaLR	1614	+	167	23448528	19715
chr8	23428813	23628813	harbor1	chr8	23461908	23462142	LTR/ERVL-MaLR	611	+	117	23462025	33212
chr8	23428813	23628813	harbor1	chr8	23462477	23462877	LTR/ERVL-MaLR	1336	+	200	23462677	33864
chr8	23428813	23628813	harbor1	chr8	23475128	23475389	LTR/ERVL-MaLR	724	+	130	23475258	46445
chr8	23428813	23628813	harbor1	chr8	23490403	23490868	LTR/ERVL-MaLR	1585	+	232	23490635	61822
chr8	23428813	23628813	harbor1	chr8	23522310	23522666	LTR/ERVL-MaLR	1273	+	178	23522488	93675
chr8	23428813	23628813	harbor1	chr8	23510714	23511079	LTR/ERVL-MaLR	2218	+	182	23510896	82083
chr8	144373098	144573098	harbor1	chr8	144378259	144378597	LTR/ERVL-MaLR	1764	+	169	144378428	5330
chr8	144373098	144573098	harbor1	chr8	144378894	144378932	LTR/ERVL-MaLR	1764	+	19	144378913	5815
chr8	144373098	144573098	harbor1	chr8	144379233	144379272	LTR/ERVL-MaLR	1764	+	20	144379253	6155
chr8	144373098	144573098	harbor1	chr8	144406868	144406926	LTR/ERVL-MaLR	530	+	29	144406897	33799
chr8	144373098	144573098	harbor1	chr8	144407846	144408038	LTR/ERVL-MaLR	530	+	96	144407942	34844
chr8	144373098	144573098	harbor1	chr8	144411767	144412019	LTR/ERVL-MaLR	899	+	126	144411893	38795
chr8	23380145	23580145	harbor1	chr8	23399318	23399738	LTR/ERVL-MaLR	2516	+	210	23399528	19383
chr8	23380145	23580145	harbor1	chr8	23416643	23416988	LTR/ERVL-MaLR	1248	+	172	23416815	36670
chr8	23380145	23580145	harbor1	chr8	23419033	23419377	LTR/ERVL-MaLR	1113	+	172	23419205	39060
chr8	23380145	23580145	harbor1	chr8	23423662	23424033	LTR/ERVL-MaLR	2228	+	186	23423848	43703
chr8	23380145	23580145	harbor1	chr8	23448361	23448695	LTR/ERVL-MaLR	1614	+	167	23448528	68383
chr8	23380145	23580145	harbor1	chr8	23461908	23462142	LTR/ERVL-MaLR	611	+	117	23462025	81880
chr8	23380145	23580145	harbor1	chr8	23462477	23462877	LTR/ERVL-MaLR	1336	+	200	23462677	82532
chr8	23380145	23580145	harbor1	chr8	23475128	23475389	LTR/ERVL-MaLR	724	+	130	23475258	95113
chr8	23043892	23243892	harbor1	chr8	23095733	23096086	LTR/ERVL-MaLR	2134	+	176	23095909	52017
chr8	23043892	23243892	harbor1	chr8	23140648	23140924	LTR/ERVL-MaLR	1758	+	138	23140786	96894
chr8	38168882	38368882	harbor1	chr8	38171294	38171432	LTR/ERVL-MaLR	454	+	69	38171363	2481
chr8	38168882	38368882	harbor1	chr8	38225020	38225390	LTR/ERVL-MaLR	2642	+	185	38225205	56323
chr8	23407361	23607361	harbor1	chr8	23416643	23416988	LTR/ERVL-MaLR	1248	+	172	23416815	9454
chr8	23407361	23607361	harbor1	chr8	23419033	23419377	LTR/ERVL-MaLR	1113	+	172	23419205	11844
chr8	23407361	23607361	harbor1	chr8	23423662	23424033	LTR/ERVL-MaLR	2228	+	186	23423848	16487
chr8	23407361	23607361	harbor1	chr8	23448361	23448695	LTR/ERVL-MaLR	1614	+	167	23448528	41167
chr8	23407361	23607361	harbor1	chr8	23461908	23462142	LTR/ERVL-MaLR	611	+	117	23462025	54664
chr8	23407361	23607361	harbor1	chr8	23462477	23462877	LTR/ERVL-MaLR	1336	+	200	23462677	55316
chr8	23407361	23607361	harbor1	chr8	23475128	23475389	LTR/ERVL-MaLR	724	+	130	23475258	67897
chr8	23407361	23607361	harbor1	chr8	23490403	23490868	LTR/ERVL-MaLR	1585	+	232	23490635	83274
chr8	23428529	23628529	harbor1	chr8	23448361	23448695	LTR/ERVL-MaLR	1614	+	167	23448528	19999
chr8	23428529	23628529	harbor1	chr8	23461908	23462142	LTR/ERVL-MaLR	611	+	117	23462025	33496
chr8	23428529	23628529	harbor1	chr8	23462477	23462877	LTR/ERVL-MaLR	1336	+	200	23462677	34148
chr8	23428529	23628529	harbor1	chr8	23475128	23475389	LTR/ERVL-MaLR	724	+	130	23475258	46729
chr8	23428529	23628529	harbor1	chr8	23490403	23490868	LTR/ERVL-MaLR	1585	+	232	23490635	62106
chr8	23428529	23628529	harbor1	chr8	23522310	23522666	LTR/ERVL-MaLR	1273	+	178	23522488	93959
chr8	23428529	23628529	harbor1	chr8	23510714	23511079	LTR/ERVL-MaLR	2218	+	182	23510896	82367
chr8	23428549	23628549	harbor1	chr8	23448361	23448695	LTR/ERVL-MaLR	1614	+	167	23448528	19979
chr8	23428549	23628549	harbor1	chr8	23461908	23462142	LTR/ERVL-MaLR	611	+	117	23462025	33476
chr8	23428549	23628549	harbor1	chr8	23462477	23462877	LTR/ERVL-MaLR	1336	+	200	23462677	34128
chr8	23428549	23628549	harbor1	chr8	23475128	23475389	LTR/ERVL-MaLR	724	+	130	23475258	46709
chr8	23428549	23628549	harbor1	chr8	23490403	23490868	LTR/ERVL-MaLR	1585	+	232	23490635	62086
chr8	23428549	23628549	harbor1	chr8	23522310	23522666	LTR/ERVL-MaLR	1273	+	178	23522488	93939
chr8	23428549	23628549	harbor1	chr8	23510714	23511079	LTR/ERVL-MaLR	2218	+	182	23510896	82347
chr8	23428888	23628888	harbor1	chr8	23448361	23448695	LTR/ERVL-MaLR	1614	+	167	23448528	19640
chr8	23428888	23628888	harbor1	chr8	23461908	23462142	LTR/ERVL-MaLR	611	+	117	23462025	33137
chr8	23428888	23628888	harbor1	chr8	23462477	23462877	LTR/ERVL-MaLR	1336	+	200	23462677	33789
chr8	23428888	23628888	harbor1	chr8	23475128	23475389	LTR/ERVL-MaLR	724	+	130	23475258	46370
chr8	23428888	23628888	harbor1	chr8	23490403	23490868	LTR/ERVL-MaLR	1585	+	232	23490635	61747
chr8	23428888	23628888	harbor1	chr8	23522310	23522666	LTR/ERVL-MaLR	1273	+	178	23522488	93600
chr8	23428888	23628888	harbor1	chr8	23510714	23511079	LTR/ERVL-MaLR	2218	+	182	23510896	82008
chr8	23428866	23628866	harbor1	chr8	23448361	23448695	LTR/ERVL-MaLR	1614	+	167	23448528	19662
chr8	23428866	23628866	harbor1	chr8	23461908	23462142	LTR/ERVL-MaLR	611	+	117	23462025	33159
chr8	23428866	23628866	harbor1	chr8	23462477	23462877	LTR/ERVL-MaLR	1336	+	200	23462677	33811
chr8	23428866	23628866	harbor1	chr8	23475128	23475389	LTR/ERVL-MaLR	724	+	130	23475258	46392
chr8	23428866	23628866	harbor1	chr8	23490403	23490868	LTR/ERVL-MaLR	1585	+	232	23490635	61769
chr8	23428866	23628866	harbor1	chr8	23522310	23522666	LTR/ERVL-MaLR	1273	+	178	23522488	93622
chr8	23428866	23628866	harbor1	chr8	23510714	23511079	LTR/ERVL-MaLR	2218	+	182	23510896	82030
chr8	23393384	23593384	harbor1	chr8	23399318	23399738	LTR/ERVL-MaLR	2516	+	210	23399528	6144
chr8	23393384	23593384	harbor1	chr8	23416643	23416988	LTR/ERVL-MaLR	1248	+	172	23416815	23431
chr8	23393384	23593384	harbor1	chr8	23419033	23419377	LTR/ERVL-MaLR	1113	+	172	23419205	25821
chr8	23393384	23593384	harbor1	chr8	23423662	23424033	LTR/ERVL-MaLR	2228	+	186	23423848	30464
chr8	23393384	23593384	harbor1	chr8	23448361	23448695	LTR/ERVL-MaLR	1614	+	167	23448528	55144
chr8	23393384	23593384	harbor1	chr8	23461908	23462142	LTR/ERVL-MaLR	611	+	117	23462025	68641
chr8	23393384	23593384	harbor1	chr8	23462477	23462877	LTR/ERVL-MaLR	1336	+	200	23462677	69293
chr8	23393384	23593384	harbor1	chr8	23475128	23475389	LTR/ERVL-MaLR	724	+	130	23475258	81874
chr8	23393384	23593384	harbor1	chr8	23490403	23490868	LTR/ERVL-MaLR	1585	+	232	23490635	97251
chr8	23408040	23608040	harbor1	chr8	23416643	23416988	LTR/ERVL-MaLR	1248	+	172	23416815	8775
chr8	23408040	23608040	harbor1	chr8	23419033	23419377	LTR/ERVL-MaLR	1113	+	172	23419205	11165
chr8	23408040	23608040	harbor1	chr8	23423662	23424033	LTR/ERVL-MaLR	2228	+	186	23423848	15808
chr8	23408040	23608040	harbor1	chr8	23448361	23448695	LTR/ERVL-MaLR	1614	+	167	23448528	40488
chr8	23408040	23608040	harbor1	chr8	23461908	23462142	LTR/ERVL-MaLR	611	+	117	23462025	53985
chr8	23408040	23608040	harbor1	chr8	23462477	23462877	LTR/ERVL-MaLR	1336	+	200	23462677	54637
chr8	23408040	23608040	harbor1	chr8	23475128	23475389	LTR/ERVL-MaLR	724	+	130	23475258	67218
chr8	23408040	23608040	harbor1	chr8	23490403	23490868	LTR/ERVL-MaLR	1585	+	232	23490635	82595
chr8	23428871	23628871	harbor1	chr8	23448361	23448695	LTR/ERVL-MaLR	1614	+	167	23448528	19657
chr8	23428871	23628871	harbor1	chr8	23461908	23462142	LTR/ERVL-MaLR	611	+	117	23462025	33154
chr8	23428871	23628871	harbor1	chr8	23462477	23462877	LTR/ERVL-MaLR	1336	+	200	23462677	33806
chr8	23428871	23628871	harbor1	chr8	23475128	23475389	LTR/ERVL-MaLR	724	+	130	23475258	46387
chr8	23428871	23628871	harbor1	chr8	23490403	23490868	LTR/ERVL-MaLR	1585	+	232	23490635	61764
chr8	23428871	23628871	harbor1	chr8	23522310	23522666	LTR/ERVL-MaLR	1273	+	178	23522488	93617
chr8	23428871	23628871	harbor1	chr8	23510714	23511079	LTR/ERVL-MaLR	2218	+	182	23510896	82025
chr8	23428530	23628530	harbor1	chr8	23448361	23448695	LTR/ERVL-MaLR	1614	+	167	23448528	19998
chr8	23428530	23628530	harbor1	chr8	23461908	23462142	LTR/ERVL-MaLR	611	+	117	23462025	33495
chr8	23428530	23628530	harbor1	chr8	23462477	23462877	LTR/ERVL-MaLR	1336	+	200	23462677	34147
chr8	23428530	23628530	harbor1	chr8	23475128	23475389	LTR/ERVL-MaLR	724	+	130	23475258	46728
chr8	23428530	23628530	harbor1	chr8	23490403	23490868	LTR/ERVL-MaLR	1585	+	232	23490635	62105
chr8	23428530	23628530	harbor1	chr8	23522310	23522666	LTR/ERVL-MaLR	1273	+	178	23522488	93958
chr8	23428530	23628530	harbor1	chr8	23510714	23511079	LTR/ERVL-MaLR	2218	+	182	23510896	82366
chr8	38168620	38368620	harbor1	chr8	38171294	38171432	LTR/ERVL-MaLR	454	+	69	38171363	2743
chr8	38168620	38368620	harbor1	chr8	38225020	38225390	LTR/ERVL-MaLR	2642	+	185	38225205	56585
chr8	29983333	30183333	harbor1	chr8	30009942	30010299	LTR/ERVL-MaLR	2216	+	178	30010120	26787
chr8	29983333	30183333	harbor1	chr8	30017885	30018201	LTR/ERVL-MaLR	843	+	158	30018043	34710
chr8	29983333	30183333	harbor1	chr8	30050486	30050850	LTR/ERVL-MaLR	1273	+	182	30050668	67335
chr8	29983333	30183333	harbor1	chr8	30058467	30058665	LTR/ERVL-MaLR	2472	+	99	30058566	75233
chr8	29983333	30183333	harbor1	chr8	30058956	30059191	LTR/ERVL-MaLR	2472	+	118	30059074	75741
chr8	29983333	30183333	harbor1	chr8	30076571	30076940	LTR/ERVL-MaLR	2185	+	184	30076755	93422
chr8	23428833	23628833	harbor1	chr8	23448361	23448695	LTR/ERVL-MaLR	1614	+	167	23448528	19695
chr8	23428833	23628833	harbor1	chr8	23461908	23462142	LTR/ERVL-MaLR	611	+	117	23462025	33192
chr8	23428833	23628833	harbor1	chr8	23462477	23462877	LTR/ERVL-MaLR	1336	+	200	23462677	33844
chr8	23428833	23628833	harbor1	chr8	23475128	23475389	LTR/ERVL-MaLR	724	+	130	23475258	46425
chr8	23428833	23628833	harbor1	chr8	23490403	23490868	LTR/ERVL-MaLR	1585	+	232	23490635	61802
chr8	23428833	23628833	harbor1	chr8	23522310	23522666	LTR/ERVL-MaLR	1273	+	178	23522488	93655
chr8	23428833	23628833	harbor1	chr8	23510714	23511079	LTR/ERVL-MaLR	2218	+	182	23510896	82063
chr8	102556520	102756520	harbor1	chr8	102574102	102574575	LTR/ERVL-MaLR	1836	+	236	102574338	17818
chr8	102556520	102756520	harbor1	chr8	102579259	102579359	LTR/ERVL-MaLR	2344	+	50	102579309	22789
chr8	102556520	102756520	harbor1	chr8	102579665	102580034	LTR/ERVL-MaLR	2344	+	184	102579849	23329
chr8	102556520	102756520	harbor1	chr8	102581015	102581058	LTR/ERVL-MaLR	2344	+	22	102581037	24517
chr8	102556520	102756520	harbor1	chr8	102581190	102581258	LTR/ERVL-MaLR	2344	+	34	102581224	24704
chr8	102556520	102756520	harbor1	chr8	102608167	102608330	LTR/ERVL-MaLR	651	+	82	102608249	51729
chr8	102556520	102756520	harbor1	chr8	102608639	102608921	LTR/ERVL-MaLR	870	+	141	102608780	52260
chr8	102556520	102756520	harbor1	chr8	102609535	102609598	LTR/ERVL-MaLR	870	+	32	102609567	53047
chr8	102556520	102756520	harbor1	chr8	102616078	102616485	LTR/ERVL-MaLR	634	+	204	102616282	59762
chr8	102556520	102756520	harbor1	chr8	102630904	102631442	LTR/ERVL-MaLR	817	+	269	102631173	74653
chr8	102556520	102756520	harbor1	chr8	102632837	102633001	LTR/ERVL-MaLR	628	+	82	102632919	76399
chr8	102556520	102756520	harbor1	chr8	102633008	102633348	LTR/ERVL-MaLR	951	+	170	102633178	76658
chr8	102556520	102756520	harbor1	chr8	102633641	102633717	LTR/ERVL-MaLR	951	+	38	102633679	77159
chr8	102556520	102756520	harbor1	chr8	102640813	102641173	LTR/ERVL-MaLR	2311	+	180	102640993	84473
chr8	23382024	23582024	harbor1	chr8	23399318	23399738	LTR/ERVL-MaLR	2516	+	210	23399528	17504
chr8	23382024	23582024	harbor1	chr8	23416643	23416988	LTR/ERVL-MaLR	1248	+	172	23416815	34791
chr8	23382024	23582024	harbor1	chr8	23419033	23419377	LTR/ERVL-MaLR	1113	+	172	23419205	37181
chr8	23382024	23582024	harbor1	chr8	23423662	23424033	LTR/ERVL-MaLR	2228	+	186	23423848	41824
chr8	23382024	23582024	harbor1	chr8	23448361	23448695	LTR/ERVL-MaLR	1614	+	167	23448528	66504
chr8	23382024	23582024	harbor1	chr8	23461908	23462142	LTR/ERVL-MaLR	611	+	117	23462025	80001
chr8	23382024	23582024	harbor1	chr8	23462477	23462877	LTR/ERVL-MaLR	1336	+	200	23462677	80653
chr8	23382024	23582024	harbor1	chr8	23475128	23475389	LTR/ERVL-MaLR	724	+	130	23475258	93234
chr8	23382929	23582929	harbor1	chr8	23399318	23399738	LTR/ERVL-MaLR	2516	+	210	23399528	16599
chr8	23382929	23582929	harbor1	chr8	23416643	23416988	LTR/ERVL-MaLR	1248	+	172	23416815	33886
chr8	23382929	23582929	harbor1	chr8	23419033	23419377	LTR/ERVL-MaLR	1113	+	172	23419205	36276
chr8	23382929	23582929	harbor1	chr8	23423662	23424033	LTR/ERVL-MaLR	2228	+	186	23423848	40919
chr8	23382929	23582929	harbor1	chr8	23448361	23448695	LTR/ERVL-MaLR	1614	+	167	23448528	65599
chr8	23382929	23582929	harbor1	chr8	23461908	23462142	LTR/ERVL-MaLR	611	+	117	23462025	79096
chr8	23382929	23582929	harbor1	chr8	23462477	23462877	LTR/ERVL-MaLR	1336	+	200	23462677	79748
chr8	23382929	23582929	harbor1	chr8	23475128	23475389	LTR/ERVL-MaLR	724	+	130	23475258	92329
chr8	38365256	38565256	harbor1	chr8	38418848	38419186	LTR/ERVL-MaLR	2379	+	169	38419017	53761
chr8	23428812	23628812	harbor1	chr8	23448361	23448695	LTR/ERVL-MaLR	1614	+	167	23448528	19716
chr8	23428812	23628812	harbor1	chr8	23461908	23462142	LTR/ERVL-MaLR	611	+	117	23462025	33213
chr8	23428812	23628812	harbor1	chr8	23462477	23462877	LTR/ERVL-MaLR	1336	+	200	23462677	33865
chr8	23428812	23628812	harbor1	chr8	23475128	23475389	LTR/ERVL-MaLR	724	+	130	23475258	46446
chr8	23428812	23628812	harbor1	chr8	23490403	23490868	LTR/ERVL-MaLR	1585	+	232	23490635	61823
chr8	23428812	23628812	harbor1	chr8	23522310	23522666	LTR/ERVL-MaLR	1273	+	178	23522488	93676
chr8	23428812	23628812	harbor1	chr8	23510714	23511079	LTR/ERVL-MaLR	2218	+	182	23510896	82084
chr8	23335731	23535731	harbor1	chr8	23359200	23359722	LTR/ERVL-MaLR	1676	+	261	23359461	23730
chr8	23335731	23535731	harbor1	chr8	23399318	23399738	LTR/ERVL-MaLR	2516	+	210	23399528	63797
chr8	23335731	23535731	harbor1	chr8	23416643	23416988	LTR/ERVL-MaLR	1248	+	172	23416815	81084
chr8	23335731	23535731	harbor1	chr8	23419033	23419377	LTR/ERVL-MaLR	1113	+	172	23419205	83474
chr8	23335731	23535731	harbor1	chr8	23423662	23424033	LTR/ERVL-MaLR	2228	+	186	23423848	88117
chr8	23428407	23628407	harbor1	chr8	23448361	23448695	LTR/ERVL-MaLR	1614	+	167	23448528	20121
chr8	23428407	23628407	harbor1	chr8	23461908	23462142	LTR/ERVL-MaLR	611	+	117	23462025	33618
chr8	23428407	23628407	harbor1	chr8	23462477	23462877	LTR/ERVL-MaLR	1336	+	200	23462677	34270
chr8	23428407	23628407	harbor1	chr8	23475128	23475389	LTR/ERVL-MaLR	724	+	130	23475258	46851
chr8	23428407	23628407	harbor1	chr8	23490403	23490868	LTR/ERVL-MaLR	1585	+	232	23490635	62228
chr8	23428407	23628407	harbor1	chr8	23522310	23522666	LTR/ERVL-MaLR	1273	+	178	23522488	94081
chr8	23428407	23628407	harbor1	chr8	23510714	23511079	LTR/ERVL-MaLR	2218	+	182	23510896	82489
chr8	89802506	90002506	harbor1	chr8	89807053	89807540	LTR/ERVL-MaLR	1611	+	244	89807297	4791
chr8	89802506	90002506	harbor1	chr8	89807874	89808230	LTR/ERVL-MaLR	2089	+	178	89808052	5546
chr8	89802506	90002506	harbor1	chr8	89808232	89809821	LTR/ERVL-MaLR	10532	+	794	89809026	6520
chr8	89802506	90002506	harbor1	chr8	89809822	89810193	LTR/ERVL-MaLR	2539	+	186	89810008	7502
chr8	89802506	90002506	harbor1	chr8	89845183	89845687	LTR/ERVL-MaLR	1327	+	252	89845435	42929
chr8	23428497	23628497	harbor1	chr8	23448361	23448695	LTR/ERVL-MaLR	1614	+	167	23448528	20031
chr8	23428497	23628497	harbor1	chr8	23461908	23462142	LTR/ERVL-MaLR	611	+	117	23462025	33528
chr8	23428497	23628497	harbor1	chr8	23462477	23462877	LTR/ERVL-MaLR	1336	+	200	23462677	34180
chr8	23428497	23628497	harbor1	chr8	23475128	23475389	LTR/ERVL-MaLR	724	+	130	23475258	46761
chr8	23428497	23628497	harbor1	chr8	23490403	23490868	LTR/ERVL-MaLR	1585	+	232	23490635	62138
chr8	23428497	23628497	harbor1	chr8	23522310	23522666	LTR/ERVL-MaLR	1273	+	178	23522488	93991
chr8	23428497	23628497	harbor1	chr8	23510714	23511079	LTR/ERVL-MaLR	2218	+	182	23510896	82399
chr8	23419568	23619568	harbor1	chr8	23423662	23424033	LTR/ERVL-MaLR	2228	+	186	23423848	4280
chr8	23419568	23619568	harbor1	chr8	23448361	23448695	LTR/ERVL-MaLR	1614	+	167	23448528	28960
chr8	23419568	23619568	harbor1	chr8	23461908	23462142	LTR/ERVL-MaLR	611	+	117	23462025	42457
chr8	23419568	23619568	harbor1	chr8	23462477	23462877	LTR/ERVL-MaLR	1336	+	200	23462677	43109
chr8	23419568	23619568	harbor1	chr8	23475128	23475389	LTR/ERVL-MaLR	724	+	130	23475258	55690
chr8	23419568	23619568	harbor1	chr8	23490403	23490868	LTR/ERVL-MaLR	1585	+	232	23490635	71067
chr8	23419568	23619568	harbor1	chr8	23510714	23511079	LTR/ERVL-MaLR	2218	+	182	23510896	91328
chr8	27225680	27425680	harbor1	chr8	27229215	27229310	LTR/ERVL-MaLR	598	+	48	27229263	3583
chr8	27225680	27425680	harbor1	chr8	27235610	27235972	LTR/ERVL-MaLR	1772	+	181	27235791	10111
chr8	27225680	27425680	harbor1	chr8	27288274	27288704	LTR/ERVL-MaLR	1547	+	215	27288489	62809
chr8	27225680	27425680	harbor1	chr8	27290315	27290683	LTR/ERVL-MaLR	1585	+	184	27290499	64819
chr8	27225680	27425680	harbor1	chr8	27299700	27299855	LTR/ERVL-MaLR	899	+	78	27299778	74098
chr8	27225680	27425680	harbor1	chr8	27299860	27300579	LTR/ERVL-MaLR	1894	+	360	27300220	74540
chr8	27225680	27425680	harbor1	chr8	27307834	27308249	LTR/ERVL-MaLR	1152	+	208	27308042	82362
chr8	27225680	27425680	harbor1	chr8	27312990	27313373	LTR/ERVL-MaLR	2649	+	192	27313182	87502
chr8	27225680	27425680	harbor1	chr8	27246492	27246805	LTR/ERVL-MaLR	520	+	156	27246648	20968
chr8	23428434	23628434	harbor1	chr8	23448361	23448695	LTR/ERVL-MaLR	1614	+	167	23448528	20094
chr8	23428434	23628434	harbor1	chr8	23461908	23462142	LTR/ERVL-MaLR	611	+	117	23462025	33591
chr8	23428434	23628434	harbor1	chr8	23462477	23462877	LTR/ERVL-MaLR	1336	+	200	23462677	34243
chr8	23428434	23628434	harbor1	chr8	23475128	23475389	LTR/ERVL-MaLR	724	+	130	23475258	46824
chr8	23428434	23628434	harbor1	chr8	23490403	23490868	LTR/ERVL-MaLR	1585	+	232	23490635	62201
chr8	23428434	23628434	harbor1	chr8	23522310	23522666	LTR/ERVL-MaLR	1273	+	178	23522488	94054
chr8	23428434	23628434	harbor1	chr8	23510714	23511079	LTR/ERVL-MaLR	2218	+	182	23510896	82462
chr8	23428557	23628557	harbor1	chr8	23448361	23448695	LTR/ERVL-MaLR	1614	+	167	23448528	19971
chr8	23428557	23628557	harbor1	chr8	23461908	23462142	LTR/ERVL-MaLR	611	+	117	23462025	33468
chr8	23428557	23628557	harbor1	chr8	23462477	23462877	LTR/ERVL-MaLR	1336	+	200	23462677	34120
chr8	23428557	23628557	harbor1	chr8	23475128	23475389	LTR/ERVL-MaLR	724	+	130	23475258	46701
chr8	23428557	23628557	harbor1	chr8	23490403	23490868	LTR/ERVL-MaLR	1585	+	232	23490635	62078
chr8	23428557	23628557	harbor1	chr8	23522310	23522666	LTR/ERVL-MaLR	1273	+	178	23522488	93931
chr8	23428557	23628557	harbor1	chr8	23510714	23511079	LTR/ERVL-MaLR	2218	+	182	23510896	82339
chr8	23428919	23628919	harbor1	chr8	23448361	23448695	LTR/ERVL-MaLR	1614	+	167	23448528	19609
chr8	23428919	23628919	harbor1	chr8	23461908	23462142	LTR/ERVL-MaLR	611	+	117	23462025	33106
chr8	23428919	23628919	harbor1	chr8	23462477	23462877	LTR/ERVL-MaLR	1336	+	200	23462677	33758
chr8	23428919	23628919	harbor1	chr8	23475128	23475389	LTR/ERVL-MaLR	724	+	130	23475258	46339
chr8	23428919	23628919	harbor1	chr8	23490403	23490868	LTR/ERVL-MaLR	1585	+	232	23490635	61716
chr8	23428919	23628919	harbor1	chr8	23522310	23522666	LTR/ERVL-MaLR	1273	+	178	23522488	93569
chr8	23428919	23628919	harbor1	chr8	23510714	23511079	LTR/ERVL-MaLR	2218	+	182	23510896	81977
chr8	90970524	91170524	harbor1	chr8	90970465	90970893	LTR/ERVL-MaLR	1225	+	214	90970679	155
chr8	90970524	91170524	harbor1	chr8	90974135	90974629	LTR/ERVL-MaLR	912	+	247	90974382	3858
chr8	90970524	91170524	harbor1	chr8	91030910	91031082	LTR/ERVL-MaLR	739	+	86	91030996	60472
chr8	90970524	91170524	harbor1	chr8	91050732	91051100	LTR/ERVL-MaLR	983	+	184	91050916	80392
chr8	90970524	91170524	harbor1	chr8	91052532	91052919	LTR/ERVL-MaLR	1076	+	194	91052726	82202
chr8	90970524	91170524	harbor1	chr8	91054435	91054816	LTR/ERVL-MaLR	1849	+	190	91054625	84101
chr8	90970524	91170524	harbor1	chr8	91059125	91059236	LTR/ERVL-MaLR	542	+	56	91059181	88657
chr8	90970524	91170524	harbor1	chr8	91066296	91066642	LTR/ERVL-MaLR	1880	+	173	91066469	95945
chr8	90970524	91170524	harbor1	chr8	91045506	91046077	LTR/ERVL-MaLR	2091	+	286	91045792	75268
chr8	38169251	38369251	harbor1	chr8	38171294	38171432	LTR/ERVL-MaLR	454	+	69	38171363	2112
chr8	38169251	38369251	harbor1	chr8	38225020	38225390	LTR/ERVL-MaLR	2642	+	185	38225205	55954
chr8	23358013	23558013	harbor1	chr8	23359200	23359722	LTR/ERVL-MaLR	1676	+	261	23359461	1448
chr8	23358013	23558013	harbor1	chr8	23399318	23399738	LTR/ERVL-MaLR	2516	+	210	23399528	41515
chr8	23358013	23558013	harbor1	chr8	23416643	23416988	LTR/ERVL-MaLR	1248	+	172	23416815	58802
chr8	23358013	23558013	harbor1	chr8	23419033	23419377	LTR/ERVL-MaLR	1113	+	172	23419205	61192
chr8	23358013	23558013	harbor1	chr8	23423662	23424033	LTR/ERVL-MaLR	2228	+	186	23423848	65835
chr8	23358013	23558013	harbor1	chr8	23448361	23448695	LTR/ERVL-MaLR	1614	+	167	23448528	90515
chr8	23428835	23628835	harbor1	chr8	23448361	23448695	LTR/ERVL-MaLR	1614	+	167	23448528	19693
chr8	23428835	23628835	harbor1	chr8	23461908	23462142	LTR/ERVL-MaLR	611	+	117	23462025	33190
chr8	23428835	23628835	harbor1	chr8	23462477	23462877	LTR/ERVL-MaLR	1336	+	200	23462677	33842
chr8	23428835	23628835	harbor1	chr8	23475128	23475389	LTR/ERVL-MaLR	724	+	130	23475258	46423
chr8	23428835	23628835	harbor1	chr8	23490403	23490868	LTR/ERVL-MaLR	1585	+	232	23490635	61800
chr8	23428835	23628835	harbor1	chr8	23522310	23522666	LTR/ERVL-MaLR	1273	+	178	23522488	93653
chr8	23428835	23628835	harbor1	chr8	23510714	23511079	LTR/ERVL-MaLR	2218	+	182	23510896	82061
chr8	23428480	23628480	harbor1	chr8	23448361	23448695	LTR/ERVL-MaLR	1614	+	167	23448528	20048
chr8	23428480	23628480	harbor1	chr8	23461908	23462142	LTR/ERVL-MaLR	611	+	117	23462025	33545
chr8	23428480	23628480	harbor1	chr8	23462477	23462877	LTR/ERVL-MaLR	1336	+	200	23462677	34197
chr8	23428480	23628480	harbor1	chr8	23475128	23475389	LTR/ERVL-MaLR	724	+	130	23475258	46778
chr8	23428480	23628480	harbor1	chr8	23490403	23490868	LTR/ERVL-MaLR	1585	+	232	23490635	62155
chr8	23428480	23628480	harbor1	chr8	23522310	23522666	LTR/ERVL-MaLR	1273	+	178	23522488	94008
chr8	23428480	23628480	harbor1	chr8	23510714	23511079	LTR/ERVL-MaLR	2218	+	182	23510896	82416
chr8	2481328	2681328	harbor1	chr8	2553848	2554231	LTR/ERVL-MaLR	2429	+	192	2554040	72712
chr8	2481328	2681328	harbor1	chr8	2566782	2567098	LTR/ERVL-MaLR	707	+	158	2566940	85612
chr8	2481328	2681328	harbor1	chr8	2573725	2574086	LTR/ERVL-MaLR	2258	+	180	2573905	92577
chr8	2481328	2681328	harbor1	chr8	2580406	2580768	LTR/ERVL-MaLR	808	+	181	2580587	99259
chr8	23428515	23628515	harbor1	chr8	23448361	23448695	LTR/ERVL-MaLR	1614	+	167	23448528	20013
chr8	23428515	23628515	harbor1	chr8	23461908	23462142	LTR/ERVL-MaLR	611	+	117	23462025	33510
chr8	23428515	23628515	harbor1	chr8	23462477	23462877	LTR/ERVL-MaLR	1336	+	200	23462677	34162
chr8	23428515	23628515	harbor1	chr8	23475128	23475389	LTR/ERVL-MaLR	724	+	130	23475258	46743
chr8	23428515	23628515	harbor1	chr8	23490403	23490868	LTR/ERVL-MaLR	1585	+	232	23490635	62120
chr8	23428515	23628515	harbor1	chr8	23522310	23522666	LTR/ERVL-MaLR	1273	+	178	23522488	93973
chr8	23428515	23628515	harbor1	chr8	23510714	23511079	LTR/ERVL-MaLR	2218	+	182	23510896	82381
chr8	23393484	23593484	harbor1	chr8	23399318	23399738	LTR/ERVL-MaLR	2516	+	210	23399528	6044
chr8	23393484	23593484	harbor1	chr8	23416643	23416988	LTR/ERVL-MaLR	1248	+	172	23416815	23331
chr8	23393484	23593484	harbor1	chr8	23419033	23419377	LTR/ERVL-MaLR	1113	+	172	23419205	25721
chr8	23393484	23593484	harbor1	chr8	23423662	23424033	LTR/ERVL-MaLR	2228	+	186	23423848	30364
chr8	23393484	23593484	harbor1	chr8	23448361	23448695	LTR/ERVL-MaLR	1614	+	167	23448528	55044
chr8	23393484	23593484	harbor1	chr8	23461908	23462142	LTR/ERVL-MaLR	611	+	117	23462025	68541
chr8	23393484	23593484	harbor1	chr8	23462477	23462877	LTR/ERVL-MaLR	1336	+	200	23462677	69193
chr8	23393484	23593484	harbor1	chr8	23475128	23475389	LTR/ERVL-MaLR	724	+	130	23475258	81774
chr8	23393484	23593484	harbor1	chr8	23490403	23490868	LTR/ERVL-MaLR	1585	+	232	23490635	97151
chr8	23380424	23580424	harbor1	chr8	23399318	23399738	LTR/ERVL-MaLR	2516	+	210	23399528	19104
chr8	23380424	23580424	harbor1	chr8	23416643	23416988	LTR/ERVL-MaLR	1248	+	172	23416815	36391
chr8	23380424	23580424	harbor1	chr8	23419033	23419377	LTR/ERVL-MaLR	1113	+	172	23419205	38781
chr8	23380424	23580424	harbor1	chr8	23423662	23424033	LTR/ERVL-MaLR	2228	+	186	23423848	43424
chr8	23380424	23580424	harbor1	chr8	23448361	23448695	LTR/ERVL-MaLR	1614	+	167	23448528	68104
chr8	23380424	23580424	harbor1	chr8	23461908	23462142	LTR/ERVL-MaLR	611	+	117	23462025	81601
chr8	23380424	23580424	harbor1	chr8	23462477	23462877	LTR/ERVL-MaLR	1336	+	200	23462677	82253
chr8	23380424	23580424	harbor1	chr8	23475128	23475389	LTR/ERVL-MaLR	724	+	130	23475258	94834
chr8	23428487	23628487	harbor1	chr8	23448361	23448695	LTR/ERVL-MaLR	1614	+	167	23448528	20041
chr8	23428487	23628487	harbor1	chr8	23461908	23462142	LTR/ERVL-MaLR	611	+	117	23462025	33538
chr8	23428487	23628487	harbor1	chr8	23462477	23462877	LTR/ERVL-MaLR	1336	+	200	23462677	34190
chr8	23428487	23628487	harbor1	chr8	23475128	23475389	LTR/ERVL-MaLR	724	+	130	23475258	46771
chr8	23428487	23628487	harbor1	chr8	23490403	23490868	LTR/ERVL-MaLR	1585	+	232	23490635	62148
chr8	23428487	23628487	harbor1	chr8	23522310	23522666	LTR/ERVL-MaLR	1273	+	178	23522488	94001
chr8	23428487	23628487	harbor1	chr8	23510714	23511079	LTR/ERVL-MaLR	2218	+	182	23510896	82409
chr8	23393608	23593608	harbor1	chr8	23399318	23399738	LTR/ERVL-MaLR	2516	+	210	23399528	5920
chr8	23393608	23593608	harbor1	chr8	23416643	23416988	LTR/ERVL-MaLR	1248	+	172	23416815	23207
chr8	23393608	23593608	harbor1	chr8	23419033	23419377	LTR/ERVL-MaLR	1113	+	172	23419205	25597
chr8	23393608	23593608	harbor1	chr8	23423662	23424033	LTR/ERVL-MaLR	2228	+	186	23423848	30240
chr8	23393608	23593608	harbor1	chr8	23448361	23448695	LTR/ERVL-MaLR	1614	+	167	23448528	54920
chr8	23393608	23593608	harbor1	chr8	23461908	23462142	LTR/ERVL-MaLR	611	+	117	23462025	68417
chr8	23393608	23593608	harbor1	chr8	23462477	23462877	LTR/ERVL-MaLR	1336	+	200	23462677	69069
chr8	23393608	23593608	harbor1	chr8	23475128	23475389	LTR/ERVL-MaLR	724	+	130	23475258	81650
chr8	23393608	23593608	harbor1	chr8	23490403	23490868	LTR/ERVL-MaLR	1585	+	232	23490635	97027
chr8	23428433	23628433	harbor1	chr8	23448361	23448695	LTR/ERVL-MaLR	1614	+	167	23448528	20095
chr8	23428433	23628433	harbor1	chr8	23461908	23462142	LTR/ERVL-MaLR	611	+	117	23462025	33592
chr8	23428433	23628433	harbor1	chr8	23462477	23462877	LTR/ERVL-MaLR	1336	+	200	23462677	34244
chr8	23428433	23628433	harbor1	chr8	23475128	23475389	LTR/ERVL-MaLR	724	+	130	23475258	46825
chr8	23428433	23628433	harbor1	chr8	23490403	23490868	LTR/ERVL-MaLR	1585	+	232	23490635	62202
chr8	23428433	23628433	harbor1	chr8	23522310	23522666	LTR/ERVL-MaLR	1273	+	178	23522488	94055
chr8	23428433	23628433	harbor1	chr8	23510714	23511079	LTR/ERVL-MaLR	2218	+	182	23510896	82463
chr8	41797946	41997946	harbor1	chr8	41825651	41826013	LTR/ERVL-MaLR	2940	+	181	41825832	27886
chr8	41797946	41997946	harbor1	chr8	41871475	41871774	LTR/ERVL-MaLR	1433	+	150	41871625	73679
chr8	29983365	30183365	harbor1	chr8	30009942	30010299	LTR/ERVL-MaLR	2216	+	178	30010120	26755
chr8	29983365	30183365	harbor1	chr8	30017885	30018201	LTR/ERVL-MaLR	843	+	158	30018043	34678
chr8	29983365	30183365	harbor1	chr8	30050486	30050850	LTR/ERVL-MaLR	1273	+	182	30050668	67303
chr8	29983365	30183365	harbor1	chr8	30058467	30058665	LTR/ERVL-MaLR	2472	+	99	30058566	75201
chr8	29983365	30183365	harbor1	chr8	30058956	30059191	LTR/ERVL-MaLR	2472	+	118	30059074	75709
chr8	29983365	30183365	harbor1	chr8	30076571	30076940	LTR/ERVL-MaLR	2185	+	184	30076755	93390
chr8	23398492	23598492	harbor1	chr8	23399318	23399738	LTR/ERVL-MaLR	2516	+	210	23399528	1036
chr8	23398492	23598492	harbor1	chr8	23416643	23416988	LTR/ERVL-MaLR	1248	+	172	23416815	18323
chr8	23398492	23598492	harbor1	chr8	23419033	23419377	LTR/ERVL-MaLR	1113	+	172	23419205	20713
chr8	23398492	23598492	harbor1	chr8	23423662	23424033	LTR/ERVL-MaLR	2228	+	186	23423848	25356
chr8	23398492	23598492	harbor1	chr8	23448361	23448695	LTR/ERVL-MaLR	1614	+	167	23448528	50036
chr8	23398492	23598492	harbor1	chr8	23461908	23462142	LTR/ERVL-MaLR	611	+	117	23462025	63533
chr8	23398492	23598492	harbor1	chr8	23462477	23462877	LTR/ERVL-MaLR	1336	+	200	23462677	64185
chr8	23398492	23598492	harbor1	chr8	23475128	23475389	LTR/ERVL-MaLR	724	+	130	23475258	76766
chr8	23398492	23598492	harbor1	chr8	23490403	23490868	LTR/ERVL-MaLR	1585	+	232	23490635	92143
chr8	23428524	23628524	harbor1	chr8	23448361	23448695	LTR/ERVL-MaLR	1614	+	167	23448528	20004
chr8	23428524	23628524	harbor1	chr8	23461908	23462142	LTR/ERVL-MaLR	611	+	117	23462025	33501
chr8	23428524	23628524	harbor1	chr8	23462477	23462877	LTR/ERVL-MaLR	1336	+	200	23462677	34153
chr8	23428524	23628524	harbor1	chr8	23475128	23475389	LTR/ERVL-MaLR	724	+	130	23475258	46734
chr8	23428524	23628524	harbor1	chr8	23490403	23490868	LTR/ERVL-MaLR	1585	+	232	23490635	62111
chr8	23428524	23628524	harbor1	chr8	23522310	23522666	LTR/ERVL-MaLR	1273	+	178	23522488	93964
chr8	23428524	23628524	harbor1	chr8	23510714	23511079	LTR/ERVL-MaLR	2218	+	182	23510896	82372
chr8	38368467	38568467	harbor1	chr8	38418848	38419186	LTR/ERVL-MaLR	2379	+	169	38419017	50550
chr8	141299565	141499565	harbor1	chr8	141326817	141327177	LTR/ERVL-MaLR	1213	+	180	141326997	27432
chr8	141299565	141499565	harbor1	chr8	141349118	141349528	LTR/ERVL-MaLR	1083	+	205	141349323	49758
chr8	141299565	141499565	harbor1	chr8	141387747	141388125	LTR/ERVL-MaLR	605	+	189	141387936	88371
chr8	23384163	23584163	harbor1	chr8	23399318	23399738	LTR/ERVL-MaLR	2516	+	210	23399528	15365
chr8	23384163	23584163	harbor1	chr8	23416643	23416988	LTR/ERVL-MaLR	1248	+	172	23416815	32652
chr8	23384163	23584163	harbor1	chr8	23419033	23419377	LTR/ERVL-MaLR	1113	+	172	23419205	35042
chr8	23384163	23584163	harbor1	chr8	23423662	23424033	LTR/ERVL-MaLR	2228	+	186	23423848	39685
chr8	23384163	23584163	harbor1	chr8	23448361	23448695	LTR/ERVL-MaLR	1614	+	167	23448528	64365
chr8	23384163	23584163	harbor1	chr8	23461908	23462142	LTR/ERVL-MaLR	611	+	117	23462025	77862
chr8	23384163	23584163	harbor1	chr8	23462477	23462877	LTR/ERVL-MaLR	1336	+	200	23462677	78514
chr8	23384163	23584163	harbor1	chr8	23475128	23475389	LTR/ERVL-MaLR	724	+	130	23475258	91095
chr8	23428822	23628822	harbor1	chr8	23448361	23448695	LTR/ERVL-MaLR	1614	+	167	23448528	19706
chr8	23428822	23628822	harbor1	chr8	23461908	23462142	LTR/ERVL-MaLR	611	+	117	23462025	33203
chr8	23428822	23628822	harbor1	chr8	23462477	23462877	LTR/ERVL-MaLR	1336	+	200	23462677	33855
chr8	23428822	23628822	harbor1	chr8	23475128	23475389	LTR/ERVL-MaLR	724	+	130	23475258	46436
chr8	23428822	23628822	harbor1	chr8	23490403	23490868	LTR/ERVL-MaLR	1585	+	232	23490635	61813
chr8	23428822	23628822	harbor1	chr8	23522310	23522666	LTR/ERVL-MaLR	1273	+	178	23522488	93666
chr8	23428822	23628822	harbor1	chr8	23510714	23511079	LTR/ERVL-MaLR	2218	+	182	23510896	82074
chr8	143477444	143677444	harbor1	chr8	143501879	143502258	LTR/ERVL-MaLR	1184	+	190	143502069	24625
chr8	143477444	143677444	harbor1	chr8	143544712	143544851	LTR/ERVL-MaLR	725	+	70	143544782	67338
chr8	143477444	143677444	harbor1	chr8	143549313	143549456	LTR/ERVL-MaLR	423	+	72	143549385	71941
chr8	143477444	143677444	harbor1	chr8	143573345	143573697	LTR/ERVL-MaLR	1521	+	176	143573521	96077
chr8	23428849	23628849	harbor1	chr8	23448361	23448695	LTR/ERVL-MaLR	1614	+	167	23448528	19679
chr8	23428849	23628849	harbor1	chr8	23461908	23462142	LTR/ERVL-MaLR	611	+	117	23462025	33176
chr8	23428849	23628849	harbor1	chr8	23462477	23462877	LTR/ERVL-MaLR	1336	+	200	23462677	33828
chr8	23428849	23628849	harbor1	chr8	23475128	23475389	LTR/ERVL-MaLR	724	+	130	23475258	46409
chr8	23428849	23628849	harbor1	chr8	23490403	23490868	LTR/ERVL-MaLR	1585	+	232	23490635	61786
chr8	23428849	23628849	harbor1	chr8	23522310	23522666	LTR/ERVL-MaLR	1273	+	178	23522488	93639
chr8	23428849	23628849	harbor1	chr8	23510714	23511079	LTR/ERVL-MaLR	2218	+	182	23510896	82047
chr8	23373952	23573952	harbor1	chr8	23399318	23399738	LTR/ERVL-MaLR	2516	+	210	23399528	25576
chr8	23373952	23573952	harbor1	chr8	23416643	23416988	LTR/ERVL-MaLR	1248	+	172	23416815	42863
chr8	23373952	23573952	harbor1	chr8	23419033	23419377	LTR/ERVL-MaLR	1113	+	172	23419205	45253
chr8	23373952	23573952	harbor1	chr8	23423662	23424033	LTR/ERVL-MaLR	2228	+	186	23423848	49896
chr8	23373952	23573952	harbor1	chr8	23448361	23448695	LTR/ERVL-MaLR	1614	+	167	23448528	74576
chr8	23373952	23573952	harbor1	chr8	23461908	23462142	LTR/ERVL-MaLR	611	+	117	23462025	88073
chr8	23373952	23573952	harbor1	chr8	23462477	23462877	LTR/ERVL-MaLR	1336	+	200	23462677	88725
chr8	94973525	95173525	harbor1	chr8	94973865	94974004	LTR/ERVL-MaLR	883	+	70	94973935	410
chr8	94973525	95173525	harbor1	chr8	94980810	94981011	LTR/ERVL-MaLR	420	+	100	94980910	7385
chr8	94973525	95173525	harbor1	chr8	94981042	94981436	LTR/ERVL-MaLR	1507	+	197	94981239	7714
chr8	94973525	95173525	harbor1	chr8	94985003	94985415	LTR/ERVL-MaLR	970	+	206	94985209	11684
chr8	94973525	95173525	harbor1	chr8	94992914	94992966	LTR/ERVL-MaLR	1146	+	26	94992940	19415
chr8	94973525	95173525	harbor1	chr8	94993351	94993803	LTR/ERVL-MaLR	1146	+	226	94993577	20052
chr8	94973525	95173525	harbor1	chr8	94996634	94997017	LTR/ERVL-MaLR	2063	+	192	94996826	23301
chr8	94973525	95173525	harbor1	chr8	95013775	95014216	LTR/ERVL-MaLR	2360	+	220	95013995	40470
chr8	140984887	141184887	harbor1	chr8	141003125	141003565	LTR/ERVL-MaLR	1271	+	220	141003345	18458
chr8	140984887	141184887	harbor1	chr8	141028487	141028769	LTR/ERVL-MaLR	727	+	141	141028628	43741
chr8	140984887	141184887	harbor1	chr8	141035014	141035418	LTR/ERVL-MaLR	1459	+	202	141035216	50329
chr8	140984887	141184887	harbor1	chr8	141052167	141052488	LTR/ERVL-MaLR	1655	+	160	141052327	67440
chr8	140984887	141184887	harbor1	chr8	141070615	141070862	LTR/ERVL-MaLR	853	+	124	141070739	85852
chr8	140984887	141184887	harbor1	chr8	141079983	141080322	LTR/ERVL-MaLR	1209	+	170	141080153	95266
chr8	32680029	32880029	harbor1	chr8	32776370	32776742	LTR/ERVL-MaLR	1840	+	186	32776556	96527
chr8	32680029	32880029	harbor1	chr8	32776746	32776932	LTR/ERVL-MaLR	1104	+	93	32776839	96810
chr8	32680029	32880029	harbor1	chr8	32778381	32778738	LTR/ERVL-MaLR	1715	+	178	32778559	98530
chr8	53999312	54199312	harbor1	chr8	54089818	54089876	LTR/ERVL-MaLR	1722	+	29	54089847	90535
chr8	53999312	54199312	harbor1	chr8	54090775	54091057	LTR/ERVL-MaLR	1722	+	141	54090916	91604
chr8	53999312	54199312	harbor1	chr8	54093229	54093645	LTR/ERVL-MaLR	1430	+	208	54093437	94125
chr8	38167799	38367799	harbor1	chr8	38171294	38171432	LTR/ERVL-MaLR	454	+	69	38171363	3564
chr8	38167799	38367799	harbor1	chr8	38225020	38225390	LTR/ERVL-MaLR	2642	+	185	38225205	57406
chr8	143716206	143916206	harbor1	chr8	143763418	143763824	LTR/ERVL-MaLR	2274	+	203	143763621	47415
chr8	143716206	143916206	harbor1	chr8	143784161	143784539	LTR/ERVL-MaLR	2376	+	189	143784350	68144
chr8	23428936	23628936	harbor1	chr8	23448361	23448695	LTR/ERVL-MaLR	1614	+	167	23448528	19592
chr8	23428936	23628936	harbor1	chr8	23461908	23462142	LTR/ERVL-MaLR	611	+	117	23462025	33089
chr8	23428936	23628936	harbor1	chr8	23462477	23462877	LTR/ERVL-MaLR	1336	+	200	23462677	33741
chr8	23428936	23628936	harbor1	chr8	23475128	23475389	LTR/ERVL-MaLR	724	+	130	23475258	46322
chr8	23428936	23628936	harbor1	chr8	23490403	23490868	LTR/ERVL-MaLR	1585	+	232	23490635	61699
chr8	23428936	23628936	harbor1	chr8	23522310	23522666	LTR/ERVL-MaLR	1273	+	178	23522488	93552
chr8	23428936	23628936	harbor1	chr8	23510714	23511079	LTR/ERVL-MaLR	2218	+	182	23510896	81960
chr8	143147120	143347120	harbor1	chr8	143170441	143170934	LTR/ERVL-MaLR	759	+	246	143170687	23567
chr8	143147120	143347120	harbor1	chr8	143171995	143172338	LTR/ERVL-MaLR	674	+	172	143172167	25047
chr8	143147120	143347120	harbor1	chr8	143172639	143172695	LTR/ERVL-MaLR	674	+	28	143172667	25547
chr8	143147120	143347120	harbor1	chr8	143189114	143189430	LTR/ERVL-MaLR	788	+	158	143189272	42152
chr8	143147120	143347120	harbor1	chr8	143203926	143204283	LTR/ERVL-MaLR	2568	+	178	143204104	56984
chr8	143147120	143347120	harbor1	chr8	143216946	143217196	LTR/ERVL-MaLR	627	+	125	143217071	69951
chr8	143147120	143347120	harbor1	chr8	143245688	143245933	LTR/ERVL-MaLR	592	+	122	143245810	98690
chr8	23409024	23609024	harbor1	chr8	23416643	23416988	LTR/ERVL-MaLR	1248	+	172	23416815	7791
chr8	23409024	23609024	harbor1	chr8	23419033	23419377	LTR/ERVL-MaLR	1113	+	172	23419205	10181
chr8	23409024	23609024	harbor1	chr8	23423662	23424033	LTR/ERVL-MaLR	2228	+	186	23423848	14824
chr8	23409024	23609024	harbor1	chr8	23448361	23448695	LTR/ERVL-MaLR	1614	+	167	23448528	39504
chr8	23409024	23609024	harbor1	chr8	23461908	23462142	LTR/ERVL-MaLR	611	+	117	23462025	53001
chr8	23409024	23609024	harbor1	chr8	23462477	23462877	LTR/ERVL-MaLR	1336	+	200	23462677	53653
chr8	23409024	23609024	harbor1	chr8	23475128	23475389	LTR/ERVL-MaLR	724	+	130	23475258	66234
chr8	23409024	23609024	harbor1	chr8	23490403	23490868	LTR/ERVL-MaLR	1585	+	232	23490635	81611
chr8	23428958	23628958	harbor1	chr8	23448361	23448695	LTR/ERVL-MaLR	1614	+	167	23448528	19570
chr8	23428958	23628958	harbor1	chr8	23461908	23462142	LTR/ERVL-MaLR	611	+	117	23462025	33067
chr8	23428958	23628958	harbor1	chr8	23462477	23462877	LTR/ERVL-MaLR	1336	+	200	23462677	33719
chr8	23428958	23628958	harbor1	chr8	23475128	23475389	LTR/ERVL-MaLR	724	+	130	23475258	46300
chr8	23428958	23628958	harbor1	chr8	23490403	23490868	LTR/ERVL-MaLR	1585	+	232	23490635	61677
chr8	23428958	23628958	harbor1	chr8	23522310	23522666	LTR/ERVL-MaLR	1273	+	178	23522488	93530
chr8	23428958	23628958	harbor1	chr8	23510714	23511079	LTR/ERVL-MaLR	2218	+	182	23510896	81938
chr8	26477624	26677624	harbor1	chr8	26477997	26478377	LTR/ERVL-MaLR	2036	+	190	26478187	563
chr8	26477624	26677624	harbor1	chr8	26478500	26478821	LTR/ERVL-MaLR	1111	+	160	26478660	1036
chr8	26477624	26677624	harbor1	chr8	26484808	26485197	LTR/ERVL-MaLR	2577	+	194	26485002	7378
chr8	26477624	26677624	harbor1	chr8	26489659	26489881	LTR/ERVL-MaLR	1030	+	111	26489770	12146
chr8	26477624	26677624	harbor1	chr8	26490998	26491152	LTR/ERVL-MaLR	856	+	77	26491075	13451
chr8	26477624	26677624	harbor1	chr8	26509997	26510409	LTR/ERVL-MaLR	2585	+	206	26510203	32579
chr8	26477624	26677624	harbor1	chr8	26519953	26520304	LTR/ERVL-MaLR	2153	+	176	26520129	42505
chr8	8286401	8486401	harbor1	chr8	8297516	8297928	LTR/ERVL-MaLR	2065	+	206	8297722	11321
chr8	8286401	8486401	harbor1	chr8	8323171	8323321	LTR/ERVL-MaLR	2175	+	75	8323246	36845
chr8	8286401	8486401	harbor1	chr8	8323623	8323811	LTR/ERVL-MaLR	2175	+	94	8323717	37316
chr8	38168860	38368860	harbor1	chr8	38171294	38171432	LTR/ERVL-MaLR	454	+	69	38171363	2503
chr8	38168860	38368860	harbor1	chr8	38225020	38225390	LTR/ERVL-MaLR	2642	+	185	38225205	56345
chr8	54001253	54201253	harbor1	chr8	54089818	54089876	LTR/ERVL-MaLR	1722	+	29	54089847	88594
chr8	54001253	54201253	harbor1	chr8	54090775	54091057	LTR/ERVL-MaLR	1722	+	141	54090916	89663
chr8	54001253	54201253	harbor1	chr8	54093229	54093645	LTR/ERVL-MaLR	1430	+	208	54093437	92184
chr8	23382017	23582017	harbor1	chr8	23399318	23399738	LTR/ERVL-MaLR	2516	+	210	23399528	17511
chr8	23382017	23582017	harbor1	chr8	23416643	23416988	LTR/ERVL-MaLR	1248	+	172	23416815	34798
chr8	23382017	23582017	harbor1	chr8	23419033	23419377	LTR/ERVL-MaLR	1113	+	172	23419205	37188
chr8	23382017	23582017	harbor1	chr8	23423662	23424033	LTR/ERVL-MaLR	2228	+	186	23423848	41831
chr8	23382017	23582017	harbor1	chr8	23448361	23448695	LTR/ERVL-MaLR	1614	+	167	23448528	66511
chr8	23382017	23582017	harbor1	chr8	23461908	23462142	LTR/ERVL-MaLR	611	+	117	23462025	80008
chr8	23382017	23582017	harbor1	chr8	23462477	23462877	LTR/ERVL-MaLR	1336	+	200	23462677	80660
chr8	23382017	23582017	harbor1	chr8	23475128	23475389	LTR/ERVL-MaLR	724	+	130	23475258	93241
chr8	23428526	23628526	harbor1	chr8	23448361	23448695	LTR/ERVL-MaLR	1614	+	167	23448528	20002
chr8	23428526	23628526	harbor1	chr8	23461908	23462142	LTR/ERVL-MaLR	611	+	117	23462025	33499
chr8	23428526	23628526	harbor1	chr8	23462477	23462877	LTR/ERVL-MaLR	1336	+	200	23462677	34151
chr8	23428526	23628526	harbor1	chr8	23475128	23475389	LTR/ERVL-MaLR	724	+	130	23475258	46732
chr8	23428526	23628526	harbor1	chr8	23490403	23490868	LTR/ERVL-MaLR	1585	+	232	23490635	62109
chr8	23428526	23628526	harbor1	chr8	23522310	23522666	LTR/ERVL-MaLR	1273	+	178	23522488	93962
chr8	23428526	23628526	harbor1	chr8	23510714	23511079	LTR/ERVL-MaLR	2218	+	182	23510896	82370
chr8	8790734	8990734	harbor1	chr8	8802445	8802610	LTR/ERVL-MaLR	837	+	82	8802527	11793
chr8	8790734	8990734	harbor1	chr8	8826281	8826450	LTR/ERVL-MaLR	487	+	84	8826365	35631
chr8	8790734	8990734	harbor1	chr8	8826739	8827014	LTR/ERVL-MaLR	487	+	138	8826877	36143
chr8	25084956	25284956	harbor1	chr8	25106499	25106920	LTR/ERVL-MaLR	2418	+	210	25106709	21753
chr8	25084956	25284956	harbor1	chr8	25115533	25115737	LTR/ERVL-MaLR	1008	+	102	25115635	30679
chr8	25084956	25284956	harbor1	chr8	25116047	25116331	LTR/ERVL-MaLR	1008	+	142	25116189	31233
chr8	25084956	25284956	harbor1	chr8	25148198	25148338	LTR/ERVL-MaLR	447	+	70	25148268	63312
chr8	25084956	25284956	harbor1	chr8	25148413	25148859	LTR/ERVL-MaLR	1270	+	223	25148636	63680
chr8	25084956	25284956	harbor1	chr8	25148868	25149028	LTR/ERVL-MaLR	438	+	80	25148948	63992
chr8	25084956	25284956	harbor1	chr8	25158851	25159278	LTR/ERVL-MaLR	2200	+	214	25159065	74109
chr8	25084956	25284956	harbor1	chr8	25166574	25166916	LTR/ERVL-MaLR	1397	+	171	25166745	81789
chr8	25084956	25284956	harbor1	chr8	25167234	25167271	LTR/ERVL-MaLR	1449	+	18	25167252	82296
chr8	23372498	23572498	harbor1	chr8	23399318	23399738	LTR/ERVL-MaLR	2516	+	210	23399528	27030
chr8	23372498	23572498	harbor1	chr8	23416643	23416988	LTR/ERVL-MaLR	1248	+	172	23416815	44317
chr8	23372498	23572498	harbor1	chr8	23419033	23419377	LTR/ERVL-MaLR	1113	+	172	23419205	46707
chr8	23372498	23572498	harbor1	chr8	23423662	23424033	LTR/ERVL-MaLR	2228	+	186	23423848	51350
chr8	23372498	23572498	harbor1	chr8	23448361	23448695	LTR/ERVL-MaLR	1614	+	167	23448528	76030
chr8	23372498	23572498	harbor1	chr8	23461908	23462142	LTR/ERVL-MaLR	611	+	117	23462025	89527
chr8	23372498	23572498	harbor1	chr8	23462477	23462877	LTR/ERVL-MaLR	1336	+	200	23462677	90179
chr8	21328820	21528820	harbor1	chr8	21334163	21334638	LTR/ERVL-MaLR	1775	+	238	21334401	5581
chr8	21328820	21528820	harbor1	chr8	21335006	21335091	LTR/ERVL-MaLR	1775	+	42	21335048	6228
chr8	21328820	21528820	harbor1	chr8	21363932	21364277	LTR/ERVL-MaLR	683	+	172	21364104	35284
chr8	21328820	21528820	harbor1	chr8	21366269	21367076	LTR/ERVL-MaLR	2733	+	404	21366673	37853
chr8	21328820	21528820	harbor1	chr8	21367373	21367671	LTR/ERVL-MaLR	2733	+	149	21367522	38702
chr8	21328820	21528820	harbor1	chr8	21414860	21415056	LTR/ERVL-MaLR	2490	+	98	21414958	86138
chr8	21328820	21528820	harbor1	chr8	21415358	21415596	LTR/ERVL-MaLR	2490	+	119	21415477	86657
chr8	21328820	21528820	harbor1	chr8	21423268	21423455	LTR/ERVL-MaLR	428	+	94	21423362	94542
chr8	141299674	141499674	harbor1	chr8	141326817	141327177	LTR/ERVL-MaLR	1213	+	180	141326997	27323
chr8	141299674	141499674	harbor1	chr8	141349118	141349528	LTR/ERVL-MaLR	1083	+	205	141349323	49649
chr8	141299674	141499674	harbor1	chr8	141387747	141388125	LTR/ERVL-MaLR	605	+	189	141387936	88262
chr8	23382188	23582188	harbor1	chr8	23399318	23399738	LTR/ERVL-MaLR	2516	+	210	23399528	17340
chr8	23382188	23582188	harbor1	chr8	23416643	23416988	LTR/ERVL-MaLR	1248	+	172	23416815	34627
chr8	23382188	23582188	harbor1	chr8	23419033	23419377	LTR/ERVL-MaLR	1113	+	172	23419205	37017
chr8	23382188	23582188	harbor1	chr8	23423662	23424033	LTR/ERVL-MaLR	2228	+	186	23423848	41660
chr8	23382188	23582188	harbor1	chr8	23448361	23448695	LTR/ERVL-MaLR	1614	+	167	23448528	66340
chr8	23382188	23582188	harbor1	chr8	23461908	23462142	LTR/ERVL-MaLR	611	+	117	23462025	79837
chr8	23382188	23582188	harbor1	chr8	23462477	23462877	LTR/ERVL-MaLR	1336	+	200	23462677	80489
chr8	23382188	23582188	harbor1	chr8	23475128	23475389	LTR/ERVL-MaLR	724	+	130	23475258	93070
chr8	20295312	20495312	harbor1	chr8	20324500	20324833	LTR/ERVL-MaLR	1933	+	166	20324666	29354
chr8	20295312	20495312	harbor1	chr8	20357519	20357902	LTR/ERVL-MaLR	2098	+	192	20357711	62399
chr8	20295312	20495312	harbor1	chr8	20358638	20358755	LTR/ERVL-MaLR	700	+	58	20358696	63384
chr8	20295312	20495312	harbor1	chr8	20363534	20363976	LTR/ERVL-MaLR	1746	+	221	20363755	68443
chr8	20295312	20495312	harbor1	chr8	20378190	20378571	LTR/ERVL-MaLR	2211	+	190	20378380	83068
chr8	38162265	38362265	harbor1	chr8	38171294	38171432	LTR/ERVL-MaLR	454	+	69	38171363	9098
chr8	38162265	38362265	harbor1	chr8	38225020	38225390	LTR/ERVL-MaLR	2642	+	185	38225205	62940
chr8	23381183	23581183	harbor1	chr8	23399318	23399738	LTR/ERVL-MaLR	2516	+	210	23399528	18345
chr8	23381183	23581183	harbor1	chr8	23416643	23416988	LTR/ERVL-MaLR	1248	+	172	23416815	35632
chr8	23381183	23581183	harbor1	chr8	23419033	23419377	LTR/ERVL-MaLR	1113	+	172	23419205	38022
chr8	23381183	23581183	harbor1	chr8	23423662	23424033	LTR/ERVL-MaLR	2228	+	186	23423848	42665
chr8	23381183	23581183	harbor1	chr8	23448361	23448695	LTR/ERVL-MaLR	1614	+	167	23448528	67345
chr8	23381183	23581183	harbor1	chr8	23461908	23462142	LTR/ERVL-MaLR	611	+	117	23462025	80842
chr8	23381183	23581183	harbor1	chr8	23462477	23462877	LTR/ERVL-MaLR	1336	+	200	23462677	81494
chr8	23381183	23581183	harbor1	chr8	23475128	23475389	LTR/ERVL-MaLR	724	+	130	23475258	94075
chr8	600183	800183	harbor1	chr8	648168	648316	LTR/ERVL-MaLR	478	+	74	648242	48059
chr8	600183	800183	harbor1	chr8	660258	660659	LTR/ERVL-MaLR	516	+	200	660458	60275
chr8	600183	800183	harbor1	chr8	622252	622613	LTR/ERVL-MaLR	1767	+	180	622432	22249
chr8	23428879	23628879	harbor1	chr8	23448361	23448695	LTR/ERVL-MaLR	1614	+	167	23448528	19649
chr8	23428879	23628879	harbor1	chr8	23461908	23462142	LTR/ERVL-MaLR	611	+	117	23462025	33146
chr8	23428879	23628879	harbor1	chr8	23462477	23462877	LTR/ERVL-MaLR	1336	+	200	23462677	33798
chr8	23428879	23628879	harbor1	chr8	23475128	23475389	LTR/ERVL-MaLR	724	+	130	23475258	46379
chr8	23428879	23628879	harbor1	chr8	23490403	23490868	LTR/ERVL-MaLR	1585	+	232	23490635	61756
chr8	23428879	23628879	harbor1	chr8	23522310	23522666	LTR/ERVL-MaLR	1273	+	178	23522488	93609
chr8	23428879	23628879	harbor1	chr8	23510714	23511079	LTR/ERVL-MaLR	2218	+	182	23510896	82017
chr8	38169230	38369230	harbor1	chr8	38171294	38171432	LTR/ERVL-MaLR	454	+	69	38171363	2133
chr8	38169230	38369230	harbor1	chr8	38225020	38225390	LTR/ERVL-MaLR	2642	+	185	38225205	55975
chr8	8793032	8993032	harbor1	chr8	8802445	8802610	LTR/ERVL-MaLR	837	+	82	8802527	9495
chr8	8793032	8993032	harbor1	chr8	8826281	8826450	LTR/ERVL-MaLR	487	+	84	8826365	33333
chr8	8793032	8993032	harbor1	chr8	8826739	8827014	LTR/ERVL-MaLR	487	+	138	8826877	33845
chr8	143716099	143916099	harbor1	chr8	143763418	143763824	LTR/ERVL-MaLR	2274	+	203	143763621	47522
chr8	143716099	143916099	harbor1	chr8	143784161	143784539	LTR/ERVL-MaLR	2376	+	189	143784350	68251
chr8	144299476	144499476	harbor1	chr8	144344252	144344547	LTR/ERVL-MaLR	568	+	148	144344400	44924
chr8	144299476	144499476	harbor1	chr8	144345459	144345506	LTR/ERVL-MaLR	568	+	24	144345483	46007
chr8	144299476	144499476	harbor1	chr8	144378259	144378597	LTR/ERVL-MaLR	1764	+	169	144378428	78952
chr8	144299476	144499476	harbor1	chr8	144378894	144378932	LTR/ERVL-MaLR	1764	+	19	144378913	79437
chr8	144299476	144499476	harbor1	chr8	144379233	144379272	LTR/ERVL-MaLR	1764	+	20	144379253	79777
chr8	144364372	144564372	harbor1	chr8	144378259	144378597	LTR/ERVL-MaLR	1764	+	169	144378428	14056
chr8	144364372	144564372	harbor1	chr8	144378894	144378932	LTR/ERVL-MaLR	1764	+	19	144378913	14541
chr8	144364372	144564372	harbor1	chr8	144379233	144379272	LTR/ERVL-MaLR	1764	+	20	144379253	14881
chr8	144364372	144564372	harbor1	chr8	144406868	144406926	LTR/ERVL-MaLR	530	+	29	144406897	42525
chr8	144364372	144564372	harbor1	chr8	144407846	144408038	LTR/ERVL-MaLR	530	+	96	144407942	43570
chr8	144364372	144564372	harbor1	chr8	144411767	144412019	LTR/ERVL-MaLR	899	+	126	144411893	47521
chr8	142677225	142877225	harbor1	chr8	142713331	142713703	LTR/ERVL-MaLR	1612	+	186	142713517	36292
chr8	48601680	48801680	harbor1	chr8	48636475	48636852	LTR/ERVL-MaLR	1048	+	188	48636663	34983
chr8	48601680	48801680	harbor1	chr8	48687182	48687542	LTR/ERVL-MaLR	2225	+	180	48687362	85682
chr8	142524934	142724934	harbor1	chr8	142567776	142567888	LTR/ERVL-MaLR	1180	+	56	142567832	42898
chr8	142524934	142724934	harbor1	chr8	142568187	142568441	LTR/ERVL-MaLR	1180	+	127	142568314	43380
chr8	142524934	142724934	harbor1	chr8	142588525	142588934	LTR/ERVL-MaLR	2166	+	204	142588729	63795
chr8	38073888	38273888	harbor1	chr8	38093272	38093581	LTR/ERVL-MaLR	2210	+	154	38093426	19538
chr8	38073888	38273888	harbor1	chr8	38093582	38093995	LTR/ERVL-MaLR	7845	+	206	38093788	19900
chr8	38073888	38273888	harbor1	chr8	38094302	38095118	LTR/ERVL-MaLR	7845	+	408	38094710	20822
chr8	38073888	38273888	harbor1	chr8	38095581	38095939	LTR/ERVL-MaLR	2512	+	179	38095760	21872
chr8	38073888	38273888	harbor1	chr8	38095940	38095976	LTR/ERVL-MaLR	2510	+	18	38095958	22070
chr8	38073888	38273888	harbor1	chr8	38096263	38096615	LTR/ERVL-MaLR	2510	+	176	38096439	22551
chr8	38073888	38273888	harbor1	chr8	38171294	38171432	LTR/ERVL-MaLR	454	+	69	38171363	97475
chr8	142524957	142724957	harbor1	chr8	142567776	142567888	LTR/ERVL-MaLR	1180	+	56	142567832	42875
chr8	142524957	142724957	harbor1	chr8	142568187	142568441	LTR/ERVL-MaLR	1180	+	127	142568314	43357
chr8	142524957	142724957	harbor1	chr8	142588525	142588934	LTR/ERVL-MaLR	2166	+	204	142588729	63772
chr8	141299700	141499700	harbor1	chr8	141326817	141327177	LTR/ERVL-MaLR	1213	+	180	141326997	27297
chr8	141299700	141499700	harbor1	chr8	141349118	141349528	LTR/ERVL-MaLR	1083	+	205	141349323	49623
chr8	141299700	141499700	harbor1	chr8	141387747	141388125	LTR/ERVL-MaLR	605	+	189	141387936	88236
chr8	26283759	26483759	harbor1	chr8	26313500	26313951	LTR/ERVL-MaLR	1089	+	226	26313726	29967
chr8	26283759	26483759	harbor1	chr8	26321374	26321871	LTR/ERVL-MaLR	1634	+	248	26321622	37863
chr8	26283759	26483759	harbor1	chr8	26324426	26325148	LTR/ERVL-MaLR	4193	+	361	26324787	41028
chr8	26283759	26483759	harbor1	chr8	26325155	26325503	LTR/ERVL-MaLR	2591	+	174	26325329	41570
chr8	89802482	90002482	harbor1	chr8	89807053	89807540	LTR/ERVL-MaLR	1611	+	244	89807297	4815
chr8	89802482	90002482	harbor1	chr8	89807874	89808230	LTR/ERVL-MaLR	2089	+	178	89808052	5570
chr8	89802482	90002482	harbor1	chr8	89808232	89809821	LTR/ERVL-MaLR	10532	+	794	89809026	6544
chr8	89802482	90002482	harbor1	chr8	89809822	89810193	LTR/ERVL-MaLR	2539	+	186	89810008	7526
chr8	89802482	90002482	harbor1	chr8	89845183	89845687	LTR/ERVL-MaLR	1327	+	252	89845435	42953
chr8	38169172	38369172	harbor1	chr8	38171294	38171432	LTR/ERVL-MaLR	454	+	69	38171363	2191
chr8	38169172	38369172	harbor1	chr8	38225020	38225390	LTR/ERVL-MaLR	2642	+	185	38225205	56033
chr8	144174289	144374289	harbor1	chr8	144177608	144177957	LTR/ERVL-MaLR	1658	+	174	144177782	3493
chr8	144174289	144374289	harbor1	chr8	144178566	144178611	LTR/ERVL-MaLR	1658	+	22	144178588	4299
chr8	23429068	23629068	harbor1	chr8	23448361	23448695	LTR/ERVL-MaLR	1614	+	167	23448528	19460
chr8	23429068	23629068	harbor1	chr8	23461908	23462142	LTR/ERVL-MaLR	611	+	117	23462025	32957
chr8	23429068	23629068	harbor1	chr8	23462477	23462877	LTR/ERVL-MaLR	1336	+	200	23462677	33609
chr8	23429068	23629068	harbor1	chr8	23475128	23475389	LTR/ERVL-MaLR	724	+	130	23475258	46190
chr8	23429068	23629068	harbor1	chr8	23490403	23490868	LTR/ERVL-MaLR	1585	+	232	23490635	61567
chr8	23429068	23629068	harbor1	chr8	23522310	23522666	LTR/ERVL-MaLR	1273	+	178	23522488	93420
chr8	23429068	23629068	harbor1	chr8	23510714	23511079	LTR/ERVL-MaLR	2218	+	182	23510896	81828
chr8	38169199	38369199	harbor1	chr8	38171294	38171432	LTR/ERVL-MaLR	454	+	69	38171363	2164
chr8	38169199	38369199	harbor1	chr8	38225020	38225390	LTR/ERVL-MaLR	2642	+	185	38225205	56006
chr8	144375112	144575112	harbor1	chr8	144378259	144378597	LTR/ERVL-MaLR	1764	+	169	144378428	3316
chr8	144375112	144575112	harbor1	chr8	144378894	144378932	LTR/ERVL-MaLR	1764	+	19	144378913	3801
chr8	144375112	144575112	harbor1	chr8	144379233	144379272	LTR/ERVL-MaLR	1764	+	20	144379253	4141
chr8	144375112	144575112	harbor1	chr8	144406868	144406926	LTR/ERVL-MaLR	530	+	29	144406897	31785
chr8	144375112	144575112	harbor1	chr8	144407846	144408038	LTR/ERVL-MaLR	530	+	96	144407942	32830
chr8	144375112	144575112	harbor1	chr8	144411767	144412019	LTR/ERVL-MaLR	899	+	126	144411893	36781
chr8	58558195	58758195	harbor1	chr8	58647445	58647861	LTR/ERVL-MaLR	2428	+	208	58647653	89458
chr8	58558195	58758195	harbor1	chr8	58647863	58649499	LTR/ERVL-MaLR	8474	+	818	58648681	90486
chr8	58558195	58758195	harbor1	chr8	58649500	58649875	LTR/ERVL-MaLR	2121	+	188	58649688	91493
chr8	23424122	23624122	harbor1	chr8	23448361	23448695	LTR/ERVL-MaLR	1614	+	167	23448528	24406
chr8	23424122	23624122	harbor1	chr8	23461908	23462142	LTR/ERVL-MaLR	611	+	117	23462025	37903
chr8	23424122	23624122	harbor1	chr8	23462477	23462877	LTR/ERVL-MaLR	1336	+	200	23462677	38555
chr8	23424122	23624122	harbor1	chr8	23475128	23475389	LTR/ERVL-MaLR	724	+	130	23475258	51136
chr8	23424122	23624122	harbor1	chr8	23490403	23490868	LTR/ERVL-MaLR	1585	+	232	23490635	66513
chr8	23424122	23624122	harbor1	chr8	23522310	23522666	LTR/ERVL-MaLR	1273	+	178	23522488	98366
chr8	23424122	23624122	harbor1	chr8	23510714	23511079	LTR/ERVL-MaLR	2218	+	182	23510896	86774
chr8	23381900	23581900	harbor1	chr8	23399318	23399738	LTR/ERVL-MaLR	2516	+	210	23399528	17628
chr8	23381900	23581900	harbor1	chr8	23416643	23416988	LTR/ERVL-MaLR	1248	+	172	23416815	34915
chr8	23381900	23581900	harbor1	chr8	23419033	23419377	LTR/ERVL-MaLR	1113	+	172	23419205	37305
chr8	23381900	23581900	harbor1	chr8	23423662	23424033	LTR/ERVL-MaLR	2228	+	186	23423848	41948
chr8	23381900	23581900	harbor1	chr8	23448361	23448695	LTR/ERVL-MaLR	1614	+	167	23448528	66628
chr8	23381900	23581900	harbor1	chr8	23461908	23462142	LTR/ERVL-MaLR	611	+	117	23462025	80125
chr8	23381900	23581900	harbor1	chr8	23462477	23462877	LTR/ERVL-MaLR	1336	+	200	23462677	80777
chr8	23381900	23581900	harbor1	chr8	23475128	23475389	LTR/ERVL-MaLR	724	+	130	23475258	93358
chr8	22624498	22824498	harbor1	chr8	22650975	22651169	LTR/ERVL-MaLR	650	+	97	22651072	26574
chr8	142524984	142724984	harbor1	chr8	142567776	142567888	LTR/ERVL-MaLR	1180	+	56	142567832	42848
chr8	142524984	142724984	harbor1	chr8	142568187	142568441	LTR/ERVL-MaLR	1180	+	127	142568314	43330
chr8	142524984	142724984	harbor1	chr8	142588525	142588934	LTR/ERVL-MaLR	2166	+	204	142588729	63745
chr8	41761146	41961146	harbor1	chr8	41761401	41761660	LTR/ERVL-MaLR	519	+	130	41761531	385
chr8	41761146	41961146	harbor1	chr8	41825651	41826013	LTR/ERVL-MaLR	2940	+	181	41825832	64686
chr8	142524942	142724942	harbor1	chr8	142567776	142567888	LTR/ERVL-MaLR	1180	+	56	142567832	42890
chr8	142524942	142724942	harbor1	chr8	142568187	142568441	LTR/ERVL-MaLR	1180	+	127	142568314	43372
chr8	142524942	142724942	harbor1	chr8	142588525	142588934	LTR/ERVL-MaLR	2166	+	204	142588729	63787
chr8	141299679	141499679	harbor1	chr8	141326817	141327177	LTR/ERVL-MaLR	1213	+	180	141326997	27318
chr8	141299679	141499679	harbor1	chr8	141349118	141349528	LTR/ERVL-MaLR	1083	+	205	141349323	49644
chr8	141299679	141499679	harbor1	chr8	141387747	141388125	LTR/ERVL-MaLR	605	+	189	141387936	88257
chr8	10959439	11159439	harbor1	chr8	10985138	10985406	LTR/ERVL-MaLR	1683	+	134	10985272	25833
chr8	10959439	11159439	harbor1	chr8	10985700	10985793	LTR/ERVL-MaLR	510	+	46	10985746	26307
chr8	10959439	11159439	harbor1	chr8	11006799	11007180	LTR/ERVL-MaLR	640	+	190	11006989	47550
chr8	10959439	11159439	harbor1	chr8	11029331	11029664	LTR/ERVL-MaLR	969	+	166	11029497	70058
chr8	10959439	11159439	harbor1	chr8	11031057	11031178	LTR/ERVL-MaLR	463	+	60	11031117	71678
chr8	10959439	11159439	harbor1	chr8	11042283	11042646	LTR/ERVL-MaLR	2418	+	182	11042465	83026
chr8	38167906	38367906	harbor1	chr8	38171294	38171432	LTR/ERVL-MaLR	454	+	69	38171363	3457
chr8	38167906	38367906	harbor1	chr8	38225020	38225390	LTR/ERVL-MaLR	2642	+	185	38225205	57299
chr8	38167394	38367394	harbor1	chr8	38171294	38171432	LTR/ERVL-MaLR	454	+	69	38171363	3969
chr8	38167394	38367394	harbor1	chr8	38225020	38225390	LTR/ERVL-MaLR	2642	+	185	38225205	57811
chr8	138710548	138910548	harbor1	chr8	138748863	138749272	LTR/ERVL-MaLR	1962	+	204	138749067	38519
chr8	138710548	138910548	harbor1	chr8	138749892	138750260	LTR/ERVL-MaLR	2554	+	184	138750076	39528
chr8	138710548	138910548	harbor1	chr8	138757867	138758423	LTR/ERVL-MaLR	1302	+	278	138758145	47597
chr8	102556596	102756596	harbor1	chr8	102574102	102574575	LTR/ERVL-MaLR	1836	+	236	102574338	17742
chr8	102556596	102756596	harbor1	chr8	102579259	102579359	LTR/ERVL-MaLR	2344	+	50	102579309	22713
chr8	102556596	102756596	harbor1	chr8	102579665	102580034	LTR/ERVL-MaLR	2344	+	184	102579849	23253
chr8	102556596	102756596	harbor1	chr8	102581015	102581058	LTR/ERVL-MaLR	2344	+	22	102581037	24441
chr8	102556596	102756596	harbor1	chr8	102581190	102581258	LTR/ERVL-MaLR	2344	+	34	102581224	24628
chr8	102556596	102756596	harbor1	chr8	102608167	102608330	LTR/ERVL-MaLR	651	+	82	102608249	51653
chr8	102556596	102756596	harbor1	chr8	102608639	102608921	LTR/ERVL-MaLR	870	+	141	102608780	52184
chr8	102556596	102756596	harbor1	chr8	102609535	102609598	LTR/ERVL-MaLR	870	+	32	102609567	52971
chr8	102556596	102756596	harbor1	chr8	102616078	102616485	LTR/ERVL-MaLR	634	+	204	102616282	59686
chr8	102556596	102756596	harbor1	chr8	102630904	102631442	LTR/ERVL-MaLR	817	+	269	102631173	74577
chr8	102556596	102756596	harbor1	chr8	102632837	102633001	LTR/ERVL-MaLR	628	+	82	102632919	76323
chr8	102556596	102756596	harbor1	chr8	102633008	102633348	LTR/ERVL-MaLR	951	+	170	102633178	76582
chr8	102556596	102756596	harbor1	chr8	102633641	102633717	LTR/ERVL-MaLR	951	+	38	102633679	77083
chr8	102556596	102756596	harbor1	chr8	102640813	102641173	LTR/ERVL-MaLR	2311	+	180	102640993	84397
chr8	23428939	23628939	harbor1	chr8	23448361	23448695	LTR/ERVL-MaLR	1614	+	167	23448528	19589
chr8	23428939	23628939	harbor1	chr8	23461908	23462142	LTR/ERVL-MaLR	611	+	117	23462025	33086
chr8	23428939	23628939	harbor1	chr8	23462477	23462877	LTR/ERVL-MaLR	1336	+	200	23462677	33738
chr8	23428939	23628939	harbor1	chr8	23475128	23475389	LTR/ERVL-MaLR	724	+	130	23475258	46319
chr8	23428939	23628939	harbor1	chr8	23490403	23490868	LTR/ERVL-MaLR	1585	+	232	23490635	61696
chr8	23428939	23628939	harbor1	chr8	23522310	23522666	LTR/ERVL-MaLR	1273	+	178	23522488	93549
chr8	23428939	23628939	harbor1	chr8	23510714	23511079	LTR/ERVL-MaLR	2218	+	182	23510896	81957
chr8	144364844	144564844	harbor1	chr8	144378259	144378597	LTR/ERVL-MaLR	1764	+	169	144378428	13584
chr8	144364844	144564844	harbor1	chr8	144378894	144378932	LTR/ERVL-MaLR	1764	+	19	144378913	14069
chr8	144364844	144564844	harbor1	chr8	144379233	144379272	LTR/ERVL-MaLR	1764	+	20	144379253	14409
chr8	144364844	144564844	harbor1	chr8	144406868	144406926	LTR/ERVL-MaLR	530	+	29	144406897	42053
chr8	144364844	144564844	harbor1	chr8	144407846	144408038	LTR/ERVL-MaLR	530	+	96	144407942	43098
chr8	144364844	144564844	harbor1	chr8	144411767	144412019	LTR/ERVL-MaLR	899	+	126	144411893	47049
chr8	23412882	23612882	harbor1	chr8	23416643	23416988	LTR/ERVL-MaLR	1248	+	172	23416815	3933
chr8	23412882	23612882	harbor1	chr8	23419033	23419377	LTR/ERVL-MaLR	1113	+	172	23419205	6323
chr8	23412882	23612882	harbor1	chr8	23423662	23424033	LTR/ERVL-MaLR	2228	+	186	23423848	10966
chr8	23412882	23612882	harbor1	chr8	23448361	23448695	LTR/ERVL-MaLR	1614	+	167	23448528	35646
chr8	23412882	23612882	harbor1	chr8	23461908	23462142	LTR/ERVL-MaLR	611	+	117	23462025	49143
chr8	23412882	23612882	harbor1	chr8	23462477	23462877	LTR/ERVL-MaLR	1336	+	200	23462677	49795
chr8	23412882	23612882	harbor1	chr8	23475128	23475389	LTR/ERVL-MaLR	724	+	130	23475258	62376
chr8	23412882	23612882	harbor1	chr8	23490403	23490868	LTR/ERVL-MaLR	1585	+	232	23490635	77753
chr8	23412882	23612882	harbor1	chr8	23510714	23511079	LTR/ERVL-MaLR	2218	+	182	23510896	98014
chr8	29983323	30183323	harbor1	chr8	30009942	30010299	LTR/ERVL-MaLR	2216	+	178	30010120	26797
chr8	29983323	30183323	harbor1	chr8	30017885	30018201	LTR/ERVL-MaLR	843	+	158	30018043	34720
chr8	29983323	30183323	harbor1	chr8	30050486	30050850	LTR/ERVL-MaLR	1273	+	182	30050668	67345
chr8	29983323	30183323	harbor1	chr8	30058467	30058665	LTR/ERVL-MaLR	2472	+	99	30058566	75243
chr8	29983323	30183323	harbor1	chr8	30058956	30059191	LTR/ERVL-MaLR	2472	+	118	30059074	75751
chr8	29983323	30183323	harbor1	chr8	30076571	30076940	LTR/ERVL-MaLR	2185	+	184	30076755	93432
chr8	29983355	30183355	harbor1	chr8	30009942	30010299	LTR/ERVL-MaLR	2216	+	178	30010120	26765
chr8	29983355	30183355	harbor1	chr8	30017885	30018201	LTR/ERVL-MaLR	843	+	158	30018043	34688
chr8	29983355	30183355	harbor1	chr8	30050486	30050850	LTR/ERVL-MaLR	1273	+	182	30050668	67313
chr8	29983355	30183355	harbor1	chr8	30058467	30058665	LTR/ERVL-MaLR	2472	+	99	30058566	75211
chr8	29983355	30183355	harbor1	chr8	30058956	30059191	LTR/ERVL-MaLR	2472	+	118	30059074	75719
chr8	29983355	30183355	harbor1	chr8	30076571	30076940	LTR/ERVL-MaLR	2185	+	184	30076755	93400
chr8	104489421	104689421	harbor1	chr8	104529022	104529407	LTR/ERVL-MaLR	2030	+	192	104529214	39793
chr8	104489421	104689421	harbor1	chr8	104530247	104530635	LTR/ERVL-MaLR	1469	+	194	104530441	41020
chr8	104489421	104689421	harbor1	chr8	104540089	104540383	LTR/ERVL-MaLR	1134	+	147	104540236	50815
chr8	104489421	104689421	harbor1	chr8	104563540	104563903	LTR/ERVL-MaLR	2055	+	182	104563722	74301
chr8	104489421	104689421	harbor1	chr8	104571335	104571714	LTR/ERVL-MaLR	2214	+	190	104571525	82104
chr8	23373996	23573996	harbor1	chr8	23399318	23399738	LTR/ERVL-MaLR	2516	+	210	23399528	25532
chr8	23373996	23573996	harbor1	chr8	23416643	23416988	LTR/ERVL-MaLR	1248	+	172	23416815	42819
chr8	23373996	23573996	harbor1	chr8	23419033	23419377	LTR/ERVL-MaLR	1113	+	172	23419205	45209
chr8	23373996	23573996	harbor1	chr8	23423662	23424033	LTR/ERVL-MaLR	2228	+	186	23423848	49852
chr8	23373996	23573996	harbor1	chr8	23448361	23448695	LTR/ERVL-MaLR	1614	+	167	23448528	74532
chr8	23373996	23573996	harbor1	chr8	23461908	23462142	LTR/ERVL-MaLR	611	+	117	23462025	88029
chr8	23373996	23573996	harbor1	chr8	23462477	23462877	LTR/ERVL-MaLR	1336	+	200	23462677	88681
chr8	28286313	28486313	harbor1	chr8	28298571	28298923	LTR/ERVL-MaLR	932	+	176	28298747	12434
chr8	28286313	28486313	harbor1	chr8	28305180	28305501	LTR/ERVL-MaLR	2545	+	160	28305340	19027
chr8	28286313	28486313	harbor1	chr8	28311928	28312318	LTR/ERVL-MaLR	2091	+	195	28312123	25810
chr8	28286313	28486313	harbor1	chr8	28314356	28314791	LTR/ERVL-MaLR	999	+	218	28314574	28261
chr8	23583116	23783116	harbor1	chr8	23609774	23610160	LTR/ERVL-MaLR	2032	+	193	23609967	26851
chr8	23583116	23783116	harbor1	chr8	23631732	23632138	LTR/ERVL-MaLR	1378	+	203	23631935	48819
chr8	23583116	23783116	harbor1	chr8	23637812	23638047	LTR/ERVL-MaLR	1345	+	118	23637930	54814
chr8	23583116	23783116	harbor1	chr8	23638350	23638549	LTR/ERVL-MaLR	1345	+	100	23638450	55334
chr8	23583116	23783116	harbor1	chr8	23674782	23675163	LTR/ERVL-MaLR	1899	+	190	23674972	91856
chr8	138710571	138910571	harbor1	chr8	138748863	138749272	LTR/ERVL-MaLR	1962	+	204	138749067	38496
chr8	138710571	138910571	harbor1	chr8	138749892	138750260	LTR/ERVL-MaLR	2554	+	184	138750076	39505
chr8	138710571	138910571	harbor1	chr8	138757867	138758423	LTR/ERVL-MaLR	1302	+	278	138758145	47574
chr9	4883718	5083718	harbor1	chr9	4906260	4906423	LTR/ERVL-MaLR	1398	+	82	4906342	22624
chr9	4883718	5083718	harbor1	chr9	4906725	4906961	LTR/ERVL-MaLR	1398	+	118	4906843	23125
chr9	4884896	5084896	harbor1	chr9	4906260	4906423	LTR/ERVL-MaLR	1398	+	82	4906342	21446
chr9	4884896	5084896	harbor1	chr9	4906725	4906961	LTR/ERVL-MaLR	1398	+	118	4906843	21947
chr9	4883068	5083068	harbor1	chr9	4906260	4906423	LTR/ERVL-MaLR	1398	+	82	4906342	23274
chr9	4883068	5083068	harbor1	chr9	4906725	4906961	LTR/ERVL-MaLR	1398	+	118	4906843	23775
chr9	4483026	4683026	harbor1	chr9	4526801	4527408	LTR/ERVL-MaLR	2817	+	304	4527105	44079
chr9	137214159	137414159	harbor1	chr9	137294334	137294568	LTR/ERVL-MaLR	918	+	117	137294451	80292
chr9	4884791	5084791	harbor1	chr9	4906260	4906423	LTR/ERVL-MaLR	1398	+	82	4906342	21551
chr9	4884791	5084791	harbor1	chr9	4906725	4906961	LTR/ERVL-MaLR	1398	+	118	4906843	22052
chr9	4879886	5079886	harbor1	chr9	4906260	4906423	LTR/ERVL-MaLR	1398	+	82	4906342	26456
chr9	4879886	5079886	harbor1	chr9	4906725	4906961	LTR/ERVL-MaLR	1398	+	118	4906843	26957
chr9	4692784	4892784	harbor1	chr9	4715795	4716197	LTR/ERVL-MaLR	740	+	201	4715996	23212
chr9	4692784	4892784	harbor1	chr9	4734005	4734371	LTR/ERVL-MaLR	1500	+	183	4734188	41404
chr9	4692784	4892784	harbor1	chr9	4744317	4744746	LTR/ERVL-MaLR	1937	+	214	4744531	51747
chr9	4692784	4892784	harbor1	chr9	4745926	4746431	LTR/ERVL-MaLR	1353	+	252	4746178	53394
chr9	4692784	4892784	harbor1	chr9	4786060	4786364	LTR/ERVL-MaLR	2618	+	152	4786212	93428
chr9	4692784	4892784	harbor1	chr9	4786667	4786739	LTR/ERVL-MaLR	2618	+	36	4786703	93919
chr9	137213401	137413401	harbor1	chr9	137294334	137294568	LTR/ERVL-MaLR	918	+	117	137294451	81050
chr9	4884806	5084806	harbor1	chr9	4906260	4906423	LTR/ERVL-MaLR	1398	+	82	4906342	21536
chr9	4884806	5084806	harbor1	chr9	4906725	4906961	LTR/ERVL-MaLR	1398	+	118	4906843	22037
chr9	136382803	136582803	harbor1	chr9	136437239	136437683	LTR/ERVL-MaLR	1280	+	222	136437461	54658
chr9	4669274	4869274	harbor1	chr9	4715795	4716197	LTR/ERVL-MaLR	740	+	201	4715996	46722
chr9	4669274	4869274	harbor1	chr9	4734005	4734371	LTR/ERVL-MaLR	1500	+	183	4734188	64914
chr9	4669274	4869274	harbor1	chr9	4744317	4744746	LTR/ERVL-MaLR	1937	+	214	4744531	75257
chr9	4669274	4869274	harbor1	chr9	4745926	4746431	LTR/ERVL-MaLR	1353	+	252	4746178	76904
chr9	4692259	4892259	harbor1	chr9	4715795	4716197	LTR/ERVL-MaLR	740	+	201	4715996	23737
chr9	4692259	4892259	harbor1	chr9	4734005	4734371	LTR/ERVL-MaLR	1500	+	183	4734188	41929
chr9	4692259	4892259	harbor1	chr9	4744317	4744746	LTR/ERVL-MaLR	1937	+	214	4744531	52272
chr9	4692259	4892259	harbor1	chr9	4745926	4746431	LTR/ERVL-MaLR	1353	+	252	4746178	53919
chr9	4692259	4892259	harbor1	chr9	4786060	4786364	LTR/ERVL-MaLR	2618	+	152	4786212	93953
chr9	4692259	4892259	harbor1	chr9	4786667	4786739	LTR/ERVL-MaLR	2618	+	36	4786703	94444
chr9	4867341	5067341	harbor1	chr9	4873802	4874157	LTR/ERVL-MaLR	1879	+	178	4873980	6639
chr9	4867341	5067341	harbor1	chr9	4906260	4906423	LTR/ERVL-MaLR	1398	+	82	4906342	39001
chr9	4867341	5067341	harbor1	chr9	4906725	4906961	LTR/ERVL-MaLR	1398	+	118	4906843	39502
chr9	4883408	5083408	harbor1	chr9	4906260	4906423	LTR/ERVL-MaLR	1398	+	82	4906342	22934
chr9	4883408	5083408	harbor1	chr9	4906725	4906961	LTR/ERVL-MaLR	1398	+	118	4906843	23435
chr9	4884822	5084822	harbor1	chr9	4906260	4906423	LTR/ERVL-MaLR	1398	+	82	4906342	21520
chr9	4884822	5084822	harbor1	chr9	4906725	4906961	LTR/ERVL-MaLR	1398	+	118	4906843	22021
chr9	4641119	4841119	harbor1	chr9	4657334	4657531	LTR/ERVL-MaLR	921	+	98	4657432	16313
chr9	4641119	4841119	harbor1	chr9	4657968	4658216	LTR/ERVL-MaLR	907	+	124	4658092	16973
chr9	4641119	4841119	harbor1	chr9	4715795	4716197	LTR/ERVL-MaLR	740	+	201	4715996	74877
chr9	4641119	4841119	harbor1	chr9	4734005	4734371	LTR/ERVL-MaLR	1500	+	183	4734188	93069
chr9	4580286	4780286	harbor1	chr9	4657334	4657531	LTR/ERVL-MaLR	921	+	98	4657432	77146
chr9	4580286	4780286	harbor1	chr9	4657968	4658216	LTR/ERVL-MaLR	907	+	124	4658092	77806
chr9	112387325	112587325	harbor1	chr9	112431491	112431866	LTR/ERVL-MaLR	2647	+	188	112431679	44354
chr9	112387325	112587325	harbor1	chr9	112432182	112432221	LTR/ERVL-MaLR	2647	+	20	112432202	44877
chr9	112387325	112587325	harbor1	chr9	112471253	112471587	LTR/ERVL-MaLR	1438	+	167	112471420	84095
chr9	112387325	112587325	harbor1	chr9	112479312	112479682	LTR/ERVL-MaLR	1865	+	185	112479497	92172
chr9	4692922	4892922	harbor1	chr9	4715795	4716197	LTR/ERVL-MaLR	740	+	201	4715996	23074
chr9	4692922	4892922	harbor1	chr9	4734005	4734371	LTR/ERVL-MaLR	1500	+	183	4734188	41266
chr9	4692922	4892922	harbor1	chr9	4744317	4744746	LTR/ERVL-MaLR	1937	+	214	4744531	51609
chr9	4692922	4892922	harbor1	chr9	4745926	4746431	LTR/ERVL-MaLR	1353	+	252	4746178	53256
chr9	4692922	4892922	harbor1	chr9	4786060	4786364	LTR/ERVL-MaLR	2618	+	152	4786212	93290
chr9	4692922	4892922	harbor1	chr9	4786667	4786739	LTR/ERVL-MaLR	2618	+	36	4786703	93781
chr9	79473193	79673193	harbor1	chr9	79491973	79492413	LTR/ERVL-MaLR	1842	+	220	79492193	19000
chr9	79473193	79673193	harbor1	chr9	79526647	79527028	LTR/ERVL-MaLR	1778	+	190	79526837	53644
chr9	79473193	79673193	harbor1	chr9	79534930	79535269	LTR/ERVL-MaLR	843	+	170	79535100	61907
chr9	79473193	79673193	harbor1	chr9	79536121	79536504	LTR/ERVL-MaLR	1862	+	192	79536313	63120
chr9	79473193	79673193	harbor1	chr9	79537744	79538107	LTR/ERVL-MaLR	2562	+	182	79537926	64733
chr9	79473193	79673193	harbor1	chr9	79542174	79542771	LTR/ERVL-MaLR	846	+	298	79542472	69279
chr9	79473193	79673193	harbor1	chr9	79550629	79551083	LTR/ERVL-MaLR	1527	+	227	79550856	77663
chr9	79473193	79673193	harbor1	chr9	79554700	79555129	LTR/ERVL-MaLR	2293	+	214	79554914	81721
chr9	4694655	4894655	harbor1	chr9	4715795	4716197	LTR/ERVL-MaLR	740	+	201	4715996	21341
chr9	4694655	4894655	harbor1	chr9	4734005	4734371	LTR/ERVL-MaLR	1500	+	183	4734188	39533
chr9	4694655	4894655	harbor1	chr9	4744317	4744746	LTR/ERVL-MaLR	1937	+	214	4744531	49876
chr9	4694655	4894655	harbor1	chr9	4745926	4746431	LTR/ERVL-MaLR	1353	+	252	4746178	51523
chr9	4694655	4894655	harbor1	chr9	4786060	4786364	LTR/ERVL-MaLR	2618	+	152	4786212	91557
chr9	4694655	4894655	harbor1	chr9	4786667	4786739	LTR/ERVL-MaLR	2618	+	36	4786703	92048
chr9	4771292	4971292	harbor1	chr9	4786060	4786364	LTR/ERVL-MaLR	2618	+	152	4786212	14920
chr9	4771292	4971292	harbor1	chr9	4786667	4786739	LTR/ERVL-MaLR	2618	+	36	4786703	15411
chr9	4726841	4926841	harbor1	chr9	4734005	4734371	LTR/ERVL-MaLR	1500	+	183	4734188	7347
chr9	4726841	4926841	harbor1	chr9	4744317	4744746	LTR/ERVL-MaLR	1937	+	214	4744531	17690
chr9	4726841	4926841	harbor1	chr9	4745926	4746431	LTR/ERVL-MaLR	1353	+	252	4746178	19337
chr9	4726841	4926841	harbor1	chr9	4786060	4786364	LTR/ERVL-MaLR	2618	+	152	4786212	59371
chr9	4726841	4926841	harbor1	chr9	4786667	4786739	LTR/ERVL-MaLR	2618	+	36	4786703	59862
chr9	4883803	5083803	harbor1	chr9	4906260	4906423	LTR/ERVL-MaLR	1398	+	82	4906342	22539
chr9	4883803	5083803	harbor1	chr9	4906725	4906961	LTR/ERVL-MaLR	1398	+	118	4906843	23040
chr9	112387187	112587187	harbor1	chr9	112431491	112431866	LTR/ERVL-MaLR	2647	+	188	112431679	44492
chr9	112387187	112587187	harbor1	chr9	112432182	112432221	LTR/ERVL-MaLR	2647	+	20	112432202	45015
chr9	112387187	112587187	harbor1	chr9	112471253	112471587	LTR/ERVL-MaLR	1438	+	167	112471420	84233
chr9	112387187	112587187	harbor1	chr9	112479312	112479682	LTR/ERVL-MaLR	1865	+	185	112479497	92310
chr9	4681965	4881965	harbor1	chr9	4715795	4716197	LTR/ERVL-MaLR	740	+	201	4715996	34031
chr9	4681965	4881965	harbor1	chr9	4734005	4734371	LTR/ERVL-MaLR	1500	+	183	4734188	52223
chr9	4681965	4881965	harbor1	chr9	4744317	4744746	LTR/ERVL-MaLR	1937	+	214	4744531	62566
chr9	4681965	4881965	harbor1	chr9	4745926	4746431	LTR/ERVL-MaLR	1353	+	252	4746178	64213
chr9	4885009	5085009	harbor1	chr9	4906260	4906423	LTR/ERVL-MaLR	1398	+	82	4906342	21333
chr9	4885009	5085009	harbor1	chr9	4906725	4906961	LTR/ERVL-MaLR	1398	+	118	4906843	21834
chr9	4692767	4892767	harbor1	chr9	4715795	4716197	LTR/ERVL-MaLR	740	+	201	4715996	23229
chr9	4692767	4892767	harbor1	chr9	4734005	4734371	LTR/ERVL-MaLR	1500	+	183	4734188	41421
chr9	4692767	4892767	harbor1	chr9	4744317	4744746	LTR/ERVL-MaLR	1937	+	214	4744531	51764
chr9	4692767	4892767	harbor1	chr9	4745926	4746431	LTR/ERVL-MaLR	1353	+	252	4746178	53411
chr9	4692767	4892767	harbor1	chr9	4786060	4786364	LTR/ERVL-MaLR	2618	+	152	4786212	93445
chr9	4692767	4892767	harbor1	chr9	4786667	4786739	LTR/ERVL-MaLR	2618	+	36	4786703	93936
chr9	4697988	4897988	harbor1	chr9	4715795	4716197	LTR/ERVL-MaLR	740	+	201	4715996	18008
chr9	4697988	4897988	harbor1	chr9	4734005	4734371	LTR/ERVL-MaLR	1500	+	183	4734188	36200
chr9	4697988	4897988	harbor1	chr9	4744317	4744746	LTR/ERVL-MaLR	1937	+	214	4744531	46543
chr9	4697988	4897988	harbor1	chr9	4745926	4746431	LTR/ERVL-MaLR	1353	+	252	4746178	48190
chr9	4697988	4897988	harbor1	chr9	4786060	4786364	LTR/ERVL-MaLR	2618	+	152	4786212	88224
chr9	4697988	4897988	harbor1	chr9	4786667	4786739	LTR/ERVL-MaLR	2618	+	36	4786703	88715
chr9	4642306	4842306	harbor1	chr9	4657334	4657531	LTR/ERVL-MaLR	921	+	98	4657432	15126
chr9	4642306	4842306	harbor1	chr9	4657968	4658216	LTR/ERVL-MaLR	907	+	124	4658092	15786
chr9	4642306	4842306	harbor1	chr9	4715795	4716197	LTR/ERVL-MaLR	740	+	201	4715996	73690
chr9	4642306	4842306	harbor1	chr9	4734005	4734371	LTR/ERVL-MaLR	1500	+	183	4734188	91882
chr9	4692228	4892228	harbor1	chr9	4715795	4716197	LTR/ERVL-MaLR	740	+	201	4715996	23768
chr9	4692228	4892228	harbor1	chr9	4734005	4734371	LTR/ERVL-MaLR	1500	+	183	4734188	41960
chr9	4692228	4892228	harbor1	chr9	4744317	4744746	LTR/ERVL-MaLR	1937	+	214	4744531	52303
chr9	4692228	4892228	harbor1	chr9	4745926	4746431	LTR/ERVL-MaLR	1353	+	252	4746178	53950
chr9	4692228	4892228	harbor1	chr9	4786060	4786364	LTR/ERVL-MaLR	2618	+	152	4786212	93984
chr9	4692228	4892228	harbor1	chr9	4786667	4786739	LTR/ERVL-MaLR	2618	+	36	4786703	94475
chr9	4663605	4863605	harbor1	chr9	4715795	4716197	LTR/ERVL-MaLR	740	+	201	4715996	52391
chr9	4663605	4863605	harbor1	chr9	4734005	4734371	LTR/ERVL-MaLR	1500	+	183	4734188	70583
chr9	4663605	4863605	harbor1	chr9	4744317	4744746	LTR/ERVL-MaLR	1937	+	214	4744531	80926
chr9	4663605	4863605	harbor1	chr9	4745926	4746431	LTR/ERVL-MaLR	1353	+	252	4746178	82573
chr9	4692785	4892785	harbor1	chr9	4715795	4716197	LTR/ERVL-MaLR	740	+	201	4715996	23211
chr9	4692785	4892785	harbor1	chr9	4734005	4734371	LTR/ERVL-MaLR	1500	+	183	4734188	41403
chr9	4692785	4892785	harbor1	chr9	4744317	4744746	LTR/ERVL-MaLR	1937	+	214	4744531	51746
chr9	4692785	4892785	harbor1	chr9	4745926	4746431	LTR/ERVL-MaLR	1353	+	252	4746178	53393
chr9	4692785	4892785	harbor1	chr9	4786060	4786364	LTR/ERVL-MaLR	2618	+	152	4786212	93427
chr9	4692785	4892785	harbor1	chr9	4786667	4786739	LTR/ERVL-MaLR	2618	+	36	4786703	93918
chr9	3260153	3460153	harbor1	chr9	3304493	3304842	LTR/ERVL-MaLR	2156	+	174	3304667	44514
chr9	3260153	3460153	harbor1	chr9	3306880	3307248	LTR/ERVL-MaLR	2060	+	184	3307064	46911
chr9	3260153	3460153	harbor1	chr9	3337414	3337854	LTR/ERVL-MaLR	697	+	220	3337634	77481
chr9	4692247	4892247	harbor1	chr9	4715795	4716197	LTR/ERVL-MaLR	740	+	201	4715996	23749
chr9	4692247	4892247	harbor1	chr9	4734005	4734371	LTR/ERVL-MaLR	1500	+	183	4734188	41941
chr9	4692247	4892247	harbor1	chr9	4744317	4744746	LTR/ERVL-MaLR	1937	+	214	4744531	52284
chr9	4692247	4892247	harbor1	chr9	4745926	4746431	LTR/ERVL-MaLR	1353	+	252	4746178	53931
chr9	4692247	4892247	harbor1	chr9	4786060	4786364	LTR/ERVL-MaLR	2618	+	152	4786212	93965
chr9	4692247	4892247	harbor1	chr9	4786667	4786739	LTR/ERVL-MaLR	2618	+	36	4786703	94456
chr9	4692230	4892230	harbor1	chr9	4715795	4716197	LTR/ERVL-MaLR	740	+	201	4715996	23766
chr9	4692230	4892230	harbor1	chr9	4734005	4734371	LTR/ERVL-MaLR	1500	+	183	4734188	41958
chr9	4692230	4892230	harbor1	chr9	4744317	4744746	LTR/ERVL-MaLR	1937	+	214	4744531	52301
chr9	4692230	4892230	harbor1	chr9	4745926	4746431	LTR/ERVL-MaLR	1353	+	252	4746178	53948
chr9	4692230	4892230	harbor1	chr9	4786060	4786364	LTR/ERVL-MaLR	2618	+	152	4786212	93982
chr9	4692230	4892230	harbor1	chr9	4786667	4786739	LTR/ERVL-MaLR	2618	+	36	4786703	94473
chr9	4650540	4850540	harbor1	chr9	4657334	4657531	LTR/ERVL-MaLR	921	+	98	4657432	6892
chr9	4650540	4850540	harbor1	chr9	4657968	4658216	LTR/ERVL-MaLR	907	+	124	4658092	7552
chr9	4650540	4850540	harbor1	chr9	4715795	4716197	LTR/ERVL-MaLR	740	+	201	4715996	65456
chr9	4650540	4850540	harbor1	chr9	4734005	4734371	LTR/ERVL-MaLR	1500	+	183	4734188	83648
chr9	4650540	4850540	harbor1	chr9	4744317	4744746	LTR/ERVL-MaLR	1937	+	214	4744531	93991
chr9	4650540	4850540	harbor1	chr9	4745926	4746431	LTR/ERVL-MaLR	1353	+	252	4746178	95638
chr9	4883789	5083789	harbor1	chr9	4906260	4906423	LTR/ERVL-MaLR	1398	+	82	4906342	22553
chr9	4883789	5083789	harbor1	chr9	4906725	4906961	LTR/ERVL-MaLR	1398	+	118	4906843	23054
chr9	4830192	5030192	harbor1	chr9	4873802	4874157	LTR/ERVL-MaLR	1879	+	178	4873980	43788
chr9	4830192	5030192	harbor1	chr9	4906260	4906423	LTR/ERVL-MaLR	1398	+	82	4906342	76150
chr9	4830192	5030192	harbor1	chr9	4906725	4906961	LTR/ERVL-MaLR	1398	+	118	4906843	76651
chr9	137214640	137414640	harbor1	chr9	137294334	137294568	LTR/ERVL-MaLR	918	+	117	137294451	79811
chr9	4692833	4892833	harbor1	chr9	4715795	4716197	LTR/ERVL-MaLR	740	+	201	4715996	23163
chr9	4692833	4892833	harbor1	chr9	4734005	4734371	LTR/ERVL-MaLR	1500	+	183	4734188	41355
chr9	4692833	4892833	harbor1	chr9	4744317	4744746	LTR/ERVL-MaLR	1937	+	214	4744531	51698
chr9	4692833	4892833	harbor1	chr9	4745926	4746431	LTR/ERVL-MaLR	1353	+	252	4746178	53345
chr9	4692833	4892833	harbor1	chr9	4786060	4786364	LTR/ERVL-MaLR	2618	+	152	4786212	93379
chr9	4692833	4892833	harbor1	chr9	4786667	4786739	LTR/ERVL-MaLR	2618	+	36	4786703	93870
chr9	4866218	5066218	harbor1	chr9	4873802	4874157	LTR/ERVL-MaLR	1879	+	178	4873980	7762
chr9	4866218	5066218	harbor1	chr9	4906260	4906423	LTR/ERVL-MaLR	1398	+	82	4906342	40124
chr9	4866218	5066218	harbor1	chr9	4906725	4906961	LTR/ERVL-MaLR	1398	+	118	4906843	40625
chr9	92958938	93158938	harbor1	chr9	93001827	93002090	LTR/ERVL-MaLR	551	+	132	93001959	43021
chr9	92958938	93158938	harbor1	chr9	93043402	93043463	LTR/ERVL-MaLR	899	+	30	93043432	84494
chr9	92958938	93158938	harbor1	chr9	93043774	93043992	LTR/ERVL-MaLR	899	+	109	93043883	84945
chr9	92958938	93158938	harbor1	chr9	93044020	93044237	LTR/ERVL-MaLR	980	+	108	93044128	85190
chr9	92958938	93158938	harbor1	chr9	93044534	93044574	LTR/ERVL-MaLR	980	+	20	93044554	85616
chr9	92958938	93158938	harbor1	chr9	93045119	93045280	LTR/ERVL-MaLR	2558	+	80	93045199	86261
chr9	92958938	93158938	harbor1	chr9	93045586	93046032	LTR/ERVL-MaLR	2558	+	223	93045809	86871
chr9	92958938	93158938	harbor1	chr9	93046344	93046516	LTR/ERVL-MaLR	2558	+	86	93046430	87492
chr9	92958938	93158938	harbor1	chr9	93046923	93047154	LTR/ERVL-MaLR	696	+	116	93047039	88101
chr9	92958938	93158938	harbor1	chr9	93056398	93056497	LTR/ERVL-MaLR	1549	+	50	93056448	97510
chr9	92958938	93158938	harbor1	chr9	93056803	93057136	LTR/ERVL-MaLR	1549	+	166	93056969	98031
chr9	4883747	5083747	harbor1	chr9	4906260	4906423	LTR/ERVL-MaLR	1398	+	82	4906342	22595
chr9	4883747	5083747	harbor1	chr9	4906725	4906961	LTR/ERVL-MaLR	1398	+	118	4906843	23096
chr9	4883810	5083810	harbor1	chr9	4906260	4906423	LTR/ERVL-MaLR	1398	+	82	4906342	22532
chr9	4883810	5083810	harbor1	chr9	4906725	4906961	LTR/ERVL-MaLR	1398	+	118	4906843	23033
chr9	4883816	5083816	harbor1	chr9	4906260	4906423	LTR/ERVL-MaLR	1398	+	82	4906342	22526
chr9	4883816	5083816	harbor1	chr9	4906725	4906961	LTR/ERVL-MaLR	1398	+	118	4906843	23027
chr9	4884825	5084825	harbor1	chr9	4906260	4906423	LTR/ERVL-MaLR	1398	+	82	4906342	21517
chr9	4884825	5084825	harbor1	chr9	4906725	4906961	LTR/ERVL-MaLR	1398	+	118	4906843	22018
chr9	4884808	5084808	harbor1	chr9	4906260	4906423	LTR/ERVL-MaLR	1398	+	82	4906342	21534
chr9	4884808	5084808	harbor1	chr9	4906725	4906961	LTR/ERVL-MaLR	1398	+	118	4906843	22035
chr9	4663129	4863129	harbor1	chr9	4715795	4716197	LTR/ERVL-MaLR	740	+	201	4715996	52867
chr9	4663129	4863129	harbor1	chr9	4734005	4734371	LTR/ERVL-MaLR	1500	+	183	4734188	71059
chr9	4663129	4863129	harbor1	chr9	4744317	4744746	LTR/ERVL-MaLR	1937	+	214	4744531	81402
chr9	4663129	4863129	harbor1	chr9	4745926	4746431	LTR/ERVL-MaLR	1353	+	252	4746178	83049
chr9	4692827	4892827	harbor1	chr9	4715795	4716197	LTR/ERVL-MaLR	740	+	201	4715996	23169
chr9	4692827	4892827	harbor1	chr9	4734005	4734371	LTR/ERVL-MaLR	1500	+	183	4734188	41361
chr9	4692827	4892827	harbor1	chr9	4744317	4744746	LTR/ERVL-MaLR	1937	+	214	4744531	51704
chr9	4692827	4892827	harbor1	chr9	4745926	4746431	LTR/ERVL-MaLR	1353	+	252	4746178	53351
chr9	4692827	4892827	harbor1	chr9	4786060	4786364	LTR/ERVL-MaLR	2618	+	152	4786212	93385
chr9	4692827	4892827	harbor1	chr9	4786667	4786739	LTR/ERVL-MaLR	2618	+	36	4786703	93876
chr9	111384785	111584785	harbor1	chr9	111404417	111404752	LTR/ERVL-MaLR	1610	+	168	111404585	19800
chr9	4692787	4892787	harbor1	chr9	4715795	4716197	LTR/ERVL-MaLR	740	+	201	4715996	23209
chr9	4692787	4892787	harbor1	chr9	4734005	4734371	LTR/ERVL-MaLR	1500	+	183	4734188	41401
chr9	4692787	4892787	harbor1	chr9	4744317	4744746	LTR/ERVL-MaLR	1937	+	214	4744531	51744
chr9	4692787	4892787	harbor1	chr9	4745926	4746431	LTR/ERVL-MaLR	1353	+	252	4746178	53391
chr9	4692787	4892787	harbor1	chr9	4786060	4786364	LTR/ERVL-MaLR	2618	+	152	4786212	93425
chr9	4692787	4892787	harbor1	chr9	4786667	4786739	LTR/ERVL-MaLR	2618	+	36	4786703	93916
chr9	4883160	5083160	harbor1	chr9	4906260	4906423	LTR/ERVL-MaLR	1398	+	82	4906342	23182
chr9	4883160	5083160	harbor1	chr9	4906725	4906961	LTR/ERVL-MaLR	1398	+	118	4906843	23683
chr9	112387209	112587209	harbor1	chr9	112431491	112431866	LTR/ERVL-MaLR	2647	+	188	112431679	44470
chr9	112387209	112587209	harbor1	chr9	112432182	112432221	LTR/ERVL-MaLR	2647	+	20	112432202	44993
chr9	112387209	112587209	harbor1	chr9	112471253	112471587	LTR/ERVL-MaLR	1438	+	167	112471420	84211
chr9	112387209	112587209	harbor1	chr9	112479312	112479682	LTR/ERVL-MaLR	1865	+	185	112479497	92288
chr9	4776709	4976709	harbor1	chr9	4786060	4786364	LTR/ERVL-MaLR	2618	+	152	4786212	9503
chr9	4776709	4976709	harbor1	chr9	4786667	4786739	LTR/ERVL-MaLR	2618	+	36	4786703	9994
chr9	4776709	4976709	harbor1	chr9	4873802	4874157	LTR/ERVL-MaLR	1879	+	178	4873980	97271
chr9	4692828	4892828	harbor1	chr9	4715795	4716197	LTR/ERVL-MaLR	740	+	201	4715996	23168
chr9	4692828	4892828	harbor1	chr9	4734005	4734371	LTR/ERVL-MaLR	1500	+	183	4734188	41360
chr9	4692828	4892828	harbor1	chr9	4744317	4744746	LTR/ERVL-MaLR	1937	+	214	4744531	51703
chr9	4692828	4892828	harbor1	chr9	4745926	4746431	LTR/ERVL-MaLR	1353	+	252	4746178	53350
chr9	4692828	4892828	harbor1	chr9	4786060	4786364	LTR/ERVL-MaLR	2618	+	152	4786212	93384
chr9	4692828	4892828	harbor1	chr9	4786667	4786739	LTR/ERVL-MaLR	2618	+	36	4786703	93875
chr9	4884936	5084936	harbor1	chr9	4906260	4906423	LTR/ERVL-MaLR	1398	+	82	4906342	21406
chr9	4884936	5084936	harbor1	chr9	4906725	4906961	LTR/ERVL-MaLR	1398	+	118	4906843	21907
chr9	4692847	4892847	harbor1	chr9	4715795	4716197	LTR/ERVL-MaLR	740	+	201	4715996	23149
chr9	4692847	4892847	harbor1	chr9	4734005	4734371	LTR/ERVL-MaLR	1500	+	183	4734188	41341
chr9	4692847	4892847	harbor1	chr9	4744317	4744746	LTR/ERVL-MaLR	1937	+	214	4744531	51684
chr9	4692847	4892847	harbor1	chr9	4745926	4746431	LTR/ERVL-MaLR	1353	+	252	4746178	53331
chr9	4692847	4892847	harbor1	chr9	4786060	4786364	LTR/ERVL-MaLR	2618	+	152	4786212	93365
chr9	4692847	4892847	harbor1	chr9	4786667	4786739	LTR/ERVL-MaLR	2618	+	36	4786703	93856
chr9	4824136	5024136	harbor1	chr9	4873802	4874157	LTR/ERVL-MaLR	1879	+	178	4873980	49844
chr9	4824136	5024136	harbor1	chr9	4906260	4906423	LTR/ERVL-MaLR	1398	+	82	4906342	82206
chr9	4824136	5024136	harbor1	chr9	4906725	4906961	LTR/ERVL-MaLR	1398	+	118	4906843	82707
chr9	4740507	4940507	harbor1	chr9	4744317	4744746	LTR/ERVL-MaLR	1937	+	214	4744531	4024
chr9	4740507	4940507	harbor1	chr9	4745926	4746431	LTR/ERVL-MaLR	1353	+	252	4746178	5671
chr9	4740507	4940507	harbor1	chr9	4786060	4786364	LTR/ERVL-MaLR	2618	+	152	4786212	45705
chr9	4740507	4940507	harbor1	chr9	4786667	4786739	LTR/ERVL-MaLR	2618	+	36	4786703	46196
chr9	112387193	112587193	harbor1	chr9	112431491	112431866	LTR/ERVL-MaLR	2647	+	188	112431679	44486
chr9	112387193	112587193	harbor1	chr9	112432182	112432221	LTR/ERVL-MaLR	2647	+	20	112432202	45009
chr9	112387193	112587193	harbor1	chr9	112471253	112471587	LTR/ERVL-MaLR	1438	+	167	112471420	84227
chr9	112387193	112587193	harbor1	chr9	112479312	112479682	LTR/ERVL-MaLR	1865	+	185	112479497	92304
chr9	4879772	5079772	harbor1	chr9	4906260	4906423	LTR/ERVL-MaLR	1398	+	82	4906342	26570
chr9	4879772	5079772	harbor1	chr9	4906725	4906961	LTR/ERVL-MaLR	1398	+	118	4906843	27071
chr9	4883377	5083377	harbor1	chr9	4906260	4906423	LTR/ERVL-MaLR	1398	+	82	4906342	22965
chr9	4883377	5083377	harbor1	chr9	4906725	4906961	LTR/ERVL-MaLR	1398	+	118	4906843	23466
chr9	3122465	3322465	harbor1	chr9	3171271	3171794	LTR/ERVL-MaLR	1668	+	262	3171533	49068
chr9	3122465	3322465	harbor1	chr9	3176129	3176328	LTR/ERVL-MaLR	771	+	100	3176229	53764
chr9	3122465	3322465	harbor1	chr9	3188990	3189414	LTR/ERVL-MaLR	1626	+	212	3189202	66737
chr9	3122465	3322465	harbor1	chr9	3204467	3204851	LTR/ERVL-MaLR	2092	+	192	3204659	82194
chr9	3122465	3322465	harbor1	chr9	3212559	3212986	LTR/ERVL-MaLR	2442	+	214	3212773	90308
chr9	134035598	134235598	harbor1	chr9	134080893	134081136	LTR/ERVL-MaLR	1501	+	122	134081015	45417
chr9	134035598	134235598	harbor1	chr9	134081433	134081620	LTR/ERVL-MaLR	1347	+	94	134081527	45929
chr9	134035598	134235598	harbor1	chr9	134085385	134085520	LTR/ERVL-MaLR	581	+	68	134085453	49855
chr9	134035598	134235598	harbor1	chr9	134085613	134085982	LTR/ERVL-MaLR	1762	+	184	134085797	50199
chr9	134035598	134235598	harbor1	chr9	134095774	134095856	LTR/ERVL-MaLR	1876	+	41	134095815	60217
chr9	134035598	134235598	harbor1	chr9	134096150	134096428	LTR/ERVL-MaLR	1876	+	139	134096289	60691
chr9	4884878	5084878	harbor1	chr9	4906260	4906423	LTR/ERVL-MaLR	1398	+	82	4906342	21464
chr9	4884878	5084878	harbor1	chr9	4906725	4906961	LTR/ERVL-MaLR	1398	+	118	4906843	21965
chr9	35656192	35856192	harbor1	chr9	35668813	35669254	LTR/ERVL-MaLR	1652	+	220	35669033	12841
chr9	3361464	3561464	harbor1	chr9	3367090	3367588	LTR/ERVL-MaLR	1327	+	249	3367339	5875
chr9	3361464	3561464	harbor1	chr9	3390122	3390234	LTR/ERVL-MaLR	742	+	56	3390178	28714
chr9	3361464	3561464	harbor1	chr9	3390239	3390516	LTR/ERVL-MaLR	1678	+	138	3390377	28913
chr9	3361464	3561464	harbor1	chr9	3390530	3390889	LTR/ERVL-MaLR	2179	+	180	3390710	29246
chr9	3361464	3561464	harbor1	chr9	3435847	3436014	LTR/ERVL-MaLR	481	+	84	3435931	74467
chr9	4883431	5083431	harbor1	chr9	4906260	4906423	LTR/ERVL-MaLR	1398	+	82	4906342	22911
chr9	4883431	5083431	harbor1	chr9	4906725	4906961	LTR/ERVL-MaLR	1398	+	118	4906843	23412
chr9	4738230	4938230	harbor1	chr9	4744317	4744746	LTR/ERVL-MaLR	1937	+	214	4744531	6301
chr9	4738230	4938230	harbor1	chr9	4745926	4746431	LTR/ERVL-MaLR	1353	+	252	4746178	7948
chr9	4738230	4938230	harbor1	chr9	4786060	4786364	LTR/ERVL-MaLR	2618	+	152	4786212	47982
chr9	4738230	4938230	harbor1	chr9	4786667	4786739	LTR/ERVL-MaLR	2618	+	36	4786703	48473
chr9	137214636	137414636	harbor1	chr9	137294334	137294568	LTR/ERVL-MaLR	918	+	117	137294451	79815
chr9	92958964	93158964	harbor1	chr9	93001827	93002090	LTR/ERVL-MaLR	551	+	132	93001959	42995
chr9	92958964	93158964	harbor1	chr9	93043402	93043463	LTR/ERVL-MaLR	899	+	30	93043432	84468
chr9	92958964	93158964	harbor1	chr9	93043774	93043992	LTR/ERVL-MaLR	899	+	109	93043883	84919
chr9	92958964	93158964	harbor1	chr9	93044020	93044237	LTR/ERVL-MaLR	980	+	108	93044128	85164
chr9	92958964	93158964	harbor1	chr9	93044534	93044574	LTR/ERVL-MaLR	980	+	20	93044554	85590
chr9	92958964	93158964	harbor1	chr9	93045119	93045280	LTR/ERVL-MaLR	2558	+	80	93045199	86235
chr9	92958964	93158964	harbor1	chr9	93045586	93046032	LTR/ERVL-MaLR	2558	+	223	93045809	86845
chr9	92958964	93158964	harbor1	chr9	93046344	93046516	LTR/ERVL-MaLR	2558	+	86	93046430	87466
chr9	92958964	93158964	harbor1	chr9	93046923	93047154	LTR/ERVL-MaLR	696	+	116	93047039	88075
chr9	92958964	93158964	harbor1	chr9	93056398	93056497	LTR/ERVL-MaLR	1549	+	50	93056448	97484
chr9	92958964	93158964	harbor1	chr9	93056803	93057136	LTR/ERVL-MaLR	1549	+	166	93056969	98005
chr9	4884856	5084856	harbor1	chr9	4906260	4906423	LTR/ERVL-MaLR	1398	+	82	4906342	21486
chr9	4884856	5084856	harbor1	chr9	4906725	4906961	LTR/ERVL-MaLR	1398	+	118	4906843	21987
chr9	4692837	4892837	harbor1	chr9	4715795	4716197	LTR/ERVL-MaLR	740	+	201	4715996	23159
chr9	4692837	4892837	harbor1	chr9	4734005	4734371	LTR/ERVL-MaLR	1500	+	183	4734188	41351
chr9	4692837	4892837	harbor1	chr9	4744317	4744746	LTR/ERVL-MaLR	1937	+	214	4744531	51694
chr9	4692837	4892837	harbor1	chr9	4745926	4746431	LTR/ERVL-MaLR	1353	+	252	4746178	53341
chr9	4692837	4892837	harbor1	chr9	4786060	4786364	LTR/ERVL-MaLR	2618	+	152	4786212	93375
chr9	4692837	4892837	harbor1	chr9	4786667	4786739	LTR/ERVL-MaLR	2618	+	36	4786703	93866
chr9	4885107	5085107	harbor1	chr9	4906260	4906423	LTR/ERVL-MaLR	1398	+	82	4906342	21235
chr9	4885107	5085107	harbor1	chr9	4906725	4906961	LTR/ERVL-MaLR	1398	+	118	4906843	21736
chr9	112387231	112587231	harbor1	chr9	112431491	112431866	LTR/ERVL-MaLR	2647	+	188	112431679	44448
chr9	112387231	112587231	harbor1	chr9	112432182	112432221	LTR/ERVL-MaLR	2647	+	20	112432202	44971
chr9	112387231	112587231	harbor1	chr9	112471253	112471587	LTR/ERVL-MaLR	1438	+	167	112471420	84189
chr9	112387231	112587231	harbor1	chr9	112479312	112479682	LTR/ERVL-MaLR	1865	+	185	112479497	92266
chr9	4669616	4869616	harbor1	chr9	4715795	4716197	LTR/ERVL-MaLR	740	+	201	4715996	46380
chr9	4669616	4869616	harbor1	chr9	4734005	4734371	LTR/ERVL-MaLR	1500	+	183	4734188	64572
chr9	4669616	4869616	harbor1	chr9	4744317	4744746	LTR/ERVL-MaLR	1937	+	214	4744531	74915
chr9	4669616	4869616	harbor1	chr9	4745926	4746431	LTR/ERVL-MaLR	1353	+	252	4746178	76562
chr9	133966927	134166927	harbor1	chr9	134007139	134007573	LTR/ERVL-MaLR	1007	+	217	134007356	40429
chr9	4776719	4976719	harbor1	chr9	4786060	4786364	LTR/ERVL-MaLR	2618	+	152	4786212	9493
chr9	4776719	4976719	harbor1	chr9	4786667	4786739	LTR/ERVL-MaLR	2618	+	36	4786703	9984
chr9	4776719	4976719	harbor1	chr9	4873802	4874157	LTR/ERVL-MaLR	1879	+	178	4873980	97261
chr9	135508512	135708512	harbor1	chr9	135586265	135586428	LTR/ERVL-MaLR	508	+	82	135586347	77835
chr9	135508512	135708512	harbor1	chr9	135597751	135598127	LTR/ERVL-MaLR	2415	+	188	135597939	89427
chr9	4692923	4892923	harbor1	chr9	4715795	4716197	LTR/ERVL-MaLR	740	+	201	4715996	23073
chr9	4692923	4892923	harbor1	chr9	4734005	4734371	LTR/ERVL-MaLR	1500	+	183	4734188	41265
chr9	4692923	4892923	harbor1	chr9	4744317	4744746	LTR/ERVL-MaLR	1937	+	214	4744531	51608
chr9	4692923	4892923	harbor1	chr9	4745926	4746431	LTR/ERVL-MaLR	1353	+	252	4746178	53255
chr9	4692923	4892923	harbor1	chr9	4786060	4786364	LTR/ERVL-MaLR	2618	+	152	4786212	93289
chr9	4692923	4892923	harbor1	chr9	4786667	4786739	LTR/ERVL-MaLR	2618	+	36	4786703	93780
chr9	135991300	136191300	harbor1	chr9	136086939	136087334	LTR/ERVL-MaLR	935	+	198	136087137	95837
chr9	4692123	4892123	harbor1	chr9	4715795	4716197	LTR/ERVL-MaLR	740	+	201	4715996	23873
chr9	4692123	4892123	harbor1	chr9	4734005	4734371	LTR/ERVL-MaLR	1500	+	183	4734188	42065
chr9	4692123	4892123	harbor1	chr9	4744317	4744746	LTR/ERVL-MaLR	1937	+	214	4744531	52408
chr9	4692123	4892123	harbor1	chr9	4745926	4746431	LTR/ERVL-MaLR	1353	+	252	4746178	54055
chr9	4692123	4892123	harbor1	chr9	4786060	4786364	LTR/ERVL-MaLR	2618	+	152	4786212	94089
chr9	4692123	4892123	harbor1	chr9	4786667	4786739	LTR/ERVL-MaLR	2618	+	36	4786703	94580
chr9	4692181	4892181	harbor1	chr9	4715795	4716197	LTR/ERVL-MaLR	740	+	201	4715996	23815
chr9	4692181	4892181	harbor1	chr9	4734005	4734371	LTR/ERVL-MaLR	1500	+	183	4734188	42007
chr9	4692181	4892181	harbor1	chr9	4744317	4744746	LTR/ERVL-MaLR	1937	+	214	4744531	52350
chr9	4692181	4892181	harbor1	chr9	4745926	4746431	LTR/ERVL-MaLR	1353	+	252	4746178	53997
chr9	4692181	4892181	harbor1	chr9	4786060	4786364	LTR/ERVL-MaLR	2618	+	152	4786212	94031
chr9	4692181	4892181	harbor1	chr9	4786667	4786739	LTR/ERVL-MaLR	2618	+	36	4786703	94522
chr9	4692953	4892953	harbor1	chr9	4715795	4716197	LTR/ERVL-MaLR	740	+	201	4715996	23043
chr9	4692953	4892953	harbor1	chr9	4734005	4734371	LTR/ERVL-MaLR	1500	+	183	4734188	41235
chr9	4692953	4892953	harbor1	chr9	4744317	4744746	LTR/ERVL-MaLR	1937	+	214	4744531	51578
chr9	4692953	4892953	harbor1	chr9	4745926	4746431	LTR/ERVL-MaLR	1353	+	252	4746178	53225
chr9	4692953	4892953	harbor1	chr9	4786060	4786364	LTR/ERVL-MaLR	2618	+	152	4786212	93259
chr9	4692953	4892953	harbor1	chr9	4786667	4786739	LTR/ERVL-MaLR	2618	+	36	4786703	93750
chr9	4867260	5067260	harbor1	chr9	4873802	4874157	LTR/ERVL-MaLR	1879	+	178	4873980	6720
chr9	4867260	5067260	harbor1	chr9	4906260	4906423	LTR/ERVL-MaLR	1398	+	82	4906342	39082
chr9	4867260	5067260	harbor1	chr9	4906725	4906961	LTR/ERVL-MaLR	1398	+	118	4906843	39583
chr9	4737755	4937755	harbor1	chr9	4744317	4744746	LTR/ERVL-MaLR	1937	+	214	4744531	6776
chr9	4737755	4937755	harbor1	chr9	4745926	4746431	LTR/ERVL-MaLR	1353	+	252	4746178	8423
chr9	4737755	4937755	harbor1	chr9	4786060	4786364	LTR/ERVL-MaLR	2618	+	152	4786212	48457
chr9	4737755	4937755	harbor1	chr9	4786667	4786739	LTR/ERVL-MaLR	2618	+	36	4786703	48948
chr9	112387246	112587246	harbor1	chr9	112431491	112431866	LTR/ERVL-MaLR	2647	+	188	112431679	44433
chr9	112387246	112587246	harbor1	chr9	112432182	112432221	LTR/ERVL-MaLR	2647	+	20	112432202	44956
chr9	112387246	112587246	harbor1	chr9	112471253	112471587	LTR/ERVL-MaLR	1438	+	167	112471420	84174
chr9	112387246	112587246	harbor1	chr9	112479312	112479682	LTR/ERVL-MaLR	1865	+	185	112479497	92251
chr9	133063738	133263738	harbor1	chr9	133088944	133089255	LTR/ERVL-MaLR	1667	+	156	133089100	25362
chr9	133063738	133263738	harbor1	chr9	133090108	133090204	LTR/ERVL-MaLR	602	+	48	133090156	26418
chr9	133063738	133263738	harbor1	chr9	133144780	133145210	LTR/ERVL-MaLR	1595	+	215	133144995	81257
chr9	133063738	133263738	harbor1	chr9	133146542	133147078	LTR/ERVL-MaLR	1424	+	268	133146810	83072
chr9	4692921	4892921	harbor1	chr9	4715795	4716197	LTR/ERVL-MaLR	740	+	201	4715996	23075
chr9	4692921	4892921	harbor1	chr9	4734005	4734371	LTR/ERVL-MaLR	1500	+	183	4734188	41267
chr9	4692921	4892921	harbor1	chr9	4744317	4744746	LTR/ERVL-MaLR	1937	+	214	4744531	51610
chr9	4692921	4892921	harbor1	chr9	4745926	4746431	LTR/ERVL-MaLR	1353	+	252	4746178	53257
chr9	4692921	4892921	harbor1	chr9	4786060	4786364	LTR/ERVL-MaLR	2618	+	152	4786212	93291
chr9	4692921	4892921	harbor1	chr9	4786667	4786739	LTR/ERVL-MaLR	2618	+	36	4786703	93782
chr9	92958998	93158998	harbor1	chr9	93001827	93002090	LTR/ERVL-MaLR	551	+	132	93001959	42961
chr9	92958998	93158998	harbor1	chr9	93043402	93043463	LTR/ERVL-MaLR	899	+	30	93043432	84434
chr9	92958998	93158998	harbor1	chr9	93043774	93043992	LTR/ERVL-MaLR	899	+	109	93043883	84885
chr9	92958998	93158998	harbor1	chr9	93044020	93044237	LTR/ERVL-MaLR	980	+	108	93044128	85130
chr9	92958998	93158998	harbor1	chr9	93044534	93044574	LTR/ERVL-MaLR	980	+	20	93044554	85556
chr9	92958998	93158998	harbor1	chr9	93045119	93045280	LTR/ERVL-MaLR	2558	+	80	93045199	86201
chr9	92958998	93158998	harbor1	chr9	93045586	93046032	LTR/ERVL-MaLR	2558	+	223	93045809	86811
chr9	92958998	93158998	harbor1	chr9	93046344	93046516	LTR/ERVL-MaLR	2558	+	86	93046430	87432
chr9	92958998	93158998	harbor1	chr9	93046923	93047154	LTR/ERVL-MaLR	696	+	116	93047039	88041
chr9	92958998	93158998	harbor1	chr9	93056398	93056497	LTR/ERVL-MaLR	1549	+	50	93056448	97450
chr9	92958998	93158998	harbor1	chr9	93056803	93057136	LTR/ERVL-MaLR	1549	+	166	93056969	97971
chr9	131570740	131770740	harbor1	chr9	131617994	131618478	LTR/ERVL-MaLR	1285	+	242	131618236	47496
chr9	112387188	112587188	harbor1	chr9	112431491	112431866	LTR/ERVL-MaLR	2647	+	188	112431679	44491
chr9	112387188	112587188	harbor1	chr9	112432182	112432221	LTR/ERVL-MaLR	2647	+	20	112432202	45014
chr9	112387188	112587188	harbor1	chr9	112471253	112471587	LTR/ERVL-MaLR	1438	+	167	112471420	84232
chr9	112387188	112587188	harbor1	chr9	112479312	112479682	LTR/ERVL-MaLR	1865	+	185	112479497	92309
chr9	4883740	5083740	harbor1	chr9	4906260	4906423	LTR/ERVL-MaLR	1398	+	82	4906342	22602
chr9	4883740	5083740	harbor1	chr9	4906725	4906961	LTR/ERVL-MaLR	1398	+	118	4906843	23103
chr9	4879743	5079743	harbor1	chr9	4906260	4906423	LTR/ERVL-MaLR	1398	+	82	4906342	26599
chr9	4879743	5079743	harbor1	chr9	4906725	4906961	LTR/ERVL-MaLR	1398	+	118	4906843	27100
chr9	4884898	5084898	harbor1	chr9	4906260	4906423	LTR/ERVL-MaLR	1398	+	82	4906342	21444
chr9	4884898	5084898	harbor1	chr9	4906725	4906961	LTR/ERVL-MaLR	1398	+	118	4906843	21945
chr9	35656592	35856592	harbor1	chr9	35668813	35669254	LTR/ERVL-MaLR	1652	+	220	35669033	12441
chr9	4692437	4892437	harbor1	chr9	4715795	4716197	LTR/ERVL-MaLR	740	+	201	4715996	23559
chr9	4692437	4892437	harbor1	chr9	4734005	4734371	LTR/ERVL-MaLR	1500	+	183	4734188	41751
chr9	4692437	4892437	harbor1	chr9	4744317	4744746	LTR/ERVL-MaLR	1937	+	214	4744531	52094
chr9	4692437	4892437	harbor1	chr9	4745926	4746431	LTR/ERVL-MaLR	1353	+	252	4746178	53741
chr9	4692437	4892437	harbor1	chr9	4786060	4786364	LTR/ERVL-MaLR	2618	+	152	4786212	93775
chr9	4692437	4892437	harbor1	chr9	4786667	4786739	LTR/ERVL-MaLR	2618	+	36	4786703	94266
chr9	112387261	112587261	harbor1	chr9	112431491	112431866	LTR/ERVL-MaLR	2647	+	188	112431679	44418
chr9	112387261	112587261	harbor1	chr9	112432182	112432221	LTR/ERVL-MaLR	2647	+	20	112432202	44941
chr9	112387261	112587261	harbor1	chr9	112471253	112471587	LTR/ERVL-MaLR	1438	+	167	112471420	84159
chr9	112387261	112587261	harbor1	chr9	112479312	112479682	LTR/ERVL-MaLR	1865	+	185	112479497	92236
chr9	4884872	5084872	harbor1	chr9	4906260	4906423	LTR/ERVL-MaLR	1398	+	82	4906342	21470
chr9	4884872	5084872	harbor1	chr9	4906725	4906961	LTR/ERVL-MaLR	1398	+	118	4906843	21971
chr9	79473185	79673185	harbor1	chr9	79491973	79492413	LTR/ERVL-MaLR	1842	+	220	79492193	19008
chr9	79473185	79673185	harbor1	chr9	79526647	79527028	LTR/ERVL-MaLR	1778	+	190	79526837	53652
chr9	79473185	79673185	harbor1	chr9	79534930	79535269	LTR/ERVL-MaLR	843	+	170	79535100	61915
chr9	79473185	79673185	harbor1	chr9	79536121	79536504	LTR/ERVL-MaLR	1862	+	192	79536313	63128
chr9	79473185	79673185	harbor1	chr9	79537744	79538107	LTR/ERVL-MaLR	2562	+	182	79537926	64741
chr9	79473185	79673185	harbor1	chr9	79542174	79542771	LTR/ERVL-MaLR	846	+	298	79542472	69287
chr9	79473185	79673185	harbor1	chr9	79550629	79551083	LTR/ERVL-MaLR	1527	+	227	79550856	77671
chr9	79473185	79673185	harbor1	chr9	79554700	79555129	LTR/ERVL-MaLR	2293	+	214	79554914	81729
chr9	4669276	4869276	harbor1	chr9	4715795	4716197	LTR/ERVL-MaLR	740	+	201	4715996	46720
chr9	4669276	4869276	harbor1	chr9	4734005	4734371	LTR/ERVL-MaLR	1500	+	183	4734188	64912
chr9	4669276	4869276	harbor1	chr9	4744317	4744746	LTR/ERVL-MaLR	1937	+	214	4744531	75255
chr9	4669276	4869276	harbor1	chr9	4745926	4746431	LTR/ERVL-MaLR	1353	+	252	4746178	76902
chr9	4663207	4863207	harbor1	chr9	4715795	4716197	LTR/ERVL-MaLR	740	+	201	4715996	52789
chr9	4663207	4863207	harbor1	chr9	4734005	4734371	LTR/ERVL-MaLR	1500	+	183	4734188	70981
chr9	4663207	4863207	harbor1	chr9	4744317	4744746	LTR/ERVL-MaLR	1937	+	214	4744531	81324
chr9	4663207	4863207	harbor1	chr9	4745926	4746431	LTR/ERVL-MaLR	1353	+	252	4746178	82971
chr9	4692939	4892939	harbor1	chr9	4715795	4716197	LTR/ERVL-MaLR	740	+	201	4715996	23057
chr9	4692939	4892939	harbor1	chr9	4734005	4734371	LTR/ERVL-MaLR	1500	+	183	4734188	41249
chr9	4692939	4892939	harbor1	chr9	4744317	4744746	LTR/ERVL-MaLR	1937	+	214	4744531	51592
chr9	4692939	4892939	harbor1	chr9	4745926	4746431	LTR/ERVL-MaLR	1353	+	252	4746178	53239
chr9	4692939	4892939	harbor1	chr9	4786060	4786364	LTR/ERVL-MaLR	2618	+	152	4786212	93273
chr9	4692939	4892939	harbor1	chr9	4786667	4786739	LTR/ERVL-MaLR	2618	+	36	4786703	93764
chr9	4824246	5024246	harbor1	chr9	4873802	4874157	LTR/ERVL-MaLR	1879	+	178	4873980	49734
chr9	4824246	5024246	harbor1	chr9	4906260	4906423	LTR/ERVL-MaLR	1398	+	82	4906342	82096
chr9	4824246	5024246	harbor1	chr9	4906725	4906961	LTR/ERVL-MaLR	1398	+	118	4906843	82597
chr9	4883387	5083387	harbor1	chr9	4906260	4906423	LTR/ERVL-MaLR	1398	+	82	4906342	22955
chr9	4883387	5083387	harbor1	chr9	4906725	4906961	LTR/ERVL-MaLR	1398	+	118	4906843	23456
chr9	136049734	136249734	harbor1	chr9	136086939	136087334	LTR/ERVL-MaLR	935	+	198	136087137	37403
chr9	136049734	136249734	harbor1	chr9	136124127	136124389	LTR/ERVL-MaLR	1361	+	131	136124258	74524
chr9	4883374	5083374	harbor1	chr9	4906260	4906423	LTR/ERVL-MaLR	1398	+	82	4906342	22968
chr9	4883374	5083374	harbor1	chr9	4906725	4906961	LTR/ERVL-MaLR	1398	+	118	4906843	23469
chr9	137212276	137412276	harbor1	chr9	137294334	137294568	LTR/ERVL-MaLR	918	+	117	137294451	82175
chr9	4694199	4894199	harbor1	chr9	4715795	4716197	LTR/ERVL-MaLR	740	+	201	4715996	21797
chr9	4694199	4894199	harbor1	chr9	4734005	4734371	LTR/ERVL-MaLR	1500	+	183	4734188	39989
chr9	4694199	4894199	harbor1	chr9	4744317	4744746	LTR/ERVL-MaLR	1937	+	214	4744531	50332
chr9	4694199	4894199	harbor1	chr9	4745926	4746431	LTR/ERVL-MaLR	1353	+	252	4746178	51979
chr9	4694199	4894199	harbor1	chr9	4786060	4786364	LTR/ERVL-MaLR	2618	+	152	4786212	92013
chr9	4694199	4894199	harbor1	chr9	4786667	4786739	LTR/ERVL-MaLR	2618	+	36	4786703	92504
chr9	4883171	5083171	harbor1	chr9	4906260	4906423	LTR/ERVL-MaLR	1398	+	82	4906342	23171
chr9	4883171	5083171	harbor1	chr9	4906725	4906961	LTR/ERVL-MaLR	1398	+	118	4906843	23672
chr9	135599331	135799331	harbor1	chr9	135669007	135669365	LTR/ERVL-MaLR	2396	+	179	135669186	69855
chr9	135599331	135799331	harbor1	chr9	135689928	135690296	LTR/ERVL-MaLR	2380	+	184	135690112	90781
chr9	135599331	135799331	harbor1	chr9	135691814	135692206	LTR/ERVL-MaLR	2070	+	196	135692010	92679
chr9	112387224	112587224	harbor1	chr9	112431491	112431866	LTR/ERVL-MaLR	2647	+	188	112431679	44455
chr9	112387224	112587224	harbor1	chr9	112432182	112432221	LTR/ERVL-MaLR	2647	+	20	112432202	44978
chr9	112387224	112587224	harbor1	chr9	112471253	112471587	LTR/ERVL-MaLR	1438	+	167	112471420	84196
chr9	112387224	112587224	harbor1	chr9	112479312	112479682	LTR/ERVL-MaLR	1865	+	185	112479497	92273
chr9	92959012	93159012	harbor1	chr9	93001827	93002090	LTR/ERVL-MaLR	551	+	132	93001959	42947
chr9	92959012	93159012	harbor1	chr9	93043402	93043463	LTR/ERVL-MaLR	899	+	30	93043432	84420
chr9	92959012	93159012	harbor1	chr9	93043774	93043992	LTR/ERVL-MaLR	899	+	109	93043883	84871
chr9	92959012	93159012	harbor1	chr9	93044020	93044237	LTR/ERVL-MaLR	980	+	108	93044128	85116
chr9	92959012	93159012	harbor1	chr9	93044534	93044574	LTR/ERVL-MaLR	980	+	20	93044554	85542
chr9	92959012	93159012	harbor1	chr9	93045119	93045280	LTR/ERVL-MaLR	2558	+	80	93045199	86187
chr9	92959012	93159012	harbor1	chr9	93045586	93046032	LTR/ERVL-MaLR	2558	+	223	93045809	86797
chr9	92959012	93159012	harbor1	chr9	93046344	93046516	LTR/ERVL-MaLR	2558	+	86	93046430	87418
chr9	92959012	93159012	harbor1	chr9	93046923	93047154	LTR/ERVL-MaLR	696	+	116	93047039	88027
chr9	92959012	93159012	harbor1	chr9	93056398	93056497	LTR/ERVL-MaLR	1549	+	50	93056448	97436
chr9	92959012	93159012	harbor1	chr9	93056803	93057136	LTR/ERVL-MaLR	1549	+	166	93056969	97957
chr9	137214593	137414593	harbor1	chr9	137294334	137294568	LTR/ERVL-MaLR	918	+	117	137294451	79858
chr9	4692195	4892195	harbor1	chr9	4715795	4716197	LTR/ERVL-MaLR	740	+	201	4715996	23801
chr9	4692195	4892195	harbor1	chr9	4734005	4734371	LTR/ERVL-MaLR	1500	+	183	4734188	41993
chr9	4692195	4892195	harbor1	chr9	4744317	4744746	LTR/ERVL-MaLR	1937	+	214	4744531	52336
chr9	4692195	4892195	harbor1	chr9	4745926	4746431	LTR/ERVL-MaLR	1353	+	252	4746178	53983
chr9	4692195	4892195	harbor1	chr9	4786060	4786364	LTR/ERVL-MaLR	2618	+	152	4786212	94017
chr9	4692195	4892195	harbor1	chr9	4786667	4786739	LTR/ERVL-MaLR	2618	+	36	4786703	94508
chr9	92958991	93158991	harbor1	chr9	93001827	93002090	LTR/ERVL-MaLR	551	+	132	93001959	42968
chr9	92958991	93158991	harbor1	chr9	93043402	93043463	LTR/ERVL-MaLR	899	+	30	93043432	84441
chr9	92958991	93158991	harbor1	chr9	93043774	93043992	LTR/ERVL-MaLR	899	+	109	93043883	84892
chr9	92958991	93158991	harbor1	chr9	93044020	93044237	LTR/ERVL-MaLR	980	+	108	93044128	85137
chr9	92958991	93158991	harbor1	chr9	93044534	93044574	LTR/ERVL-MaLR	980	+	20	93044554	85563
chr9	92958991	93158991	harbor1	chr9	93045119	93045280	LTR/ERVL-MaLR	2558	+	80	93045199	86208
chr9	92958991	93158991	harbor1	chr9	93045586	93046032	LTR/ERVL-MaLR	2558	+	223	93045809	86818
chr9	92958991	93158991	harbor1	chr9	93046344	93046516	LTR/ERVL-MaLR	2558	+	86	93046430	87439
chr9	92958991	93158991	harbor1	chr9	93046923	93047154	LTR/ERVL-MaLR	696	+	116	93047039	88048
chr9	92958991	93158991	harbor1	chr9	93056398	93056497	LTR/ERVL-MaLR	1549	+	50	93056448	97457
chr9	92958991	93158991	harbor1	chr9	93056803	93057136	LTR/ERVL-MaLR	1549	+	166	93056969	97978
chr9	4673229	4873229	harbor1	chr9	4715795	4716197	LTR/ERVL-MaLR	740	+	201	4715996	42767
chr9	4673229	4873229	harbor1	chr9	4734005	4734371	LTR/ERVL-MaLR	1500	+	183	4734188	60959
chr9	4673229	4873229	harbor1	chr9	4744317	4744746	LTR/ERVL-MaLR	1937	+	214	4744531	71302
chr9	4673229	4873229	harbor1	chr9	4745926	4746431	LTR/ERVL-MaLR	1353	+	252	4746178	72949
chr9	4692970	4892970	harbor1	chr9	4715795	4716197	LTR/ERVL-MaLR	740	+	201	4715996	23026
chr9	4692970	4892970	harbor1	chr9	4734005	4734371	LTR/ERVL-MaLR	1500	+	183	4734188	41218
chr9	4692970	4892970	harbor1	chr9	4744317	4744746	LTR/ERVL-MaLR	1937	+	214	4744531	51561
chr9	4692970	4892970	harbor1	chr9	4745926	4746431	LTR/ERVL-MaLR	1353	+	252	4746178	53208
chr9	4692970	4892970	harbor1	chr9	4786060	4786364	LTR/ERVL-MaLR	2618	+	152	4786212	93242
chr9	4692970	4892970	harbor1	chr9	4786667	4786739	LTR/ERVL-MaLR	2618	+	36	4786703	93733
chr9	3146618	3346618	harbor1	chr9	3171271	3171794	LTR/ERVL-MaLR	1668	+	262	3171533	24915
chr9	3146618	3346618	harbor1	chr9	3176129	3176328	LTR/ERVL-MaLR	771	+	100	3176229	29611
chr9	3146618	3346618	harbor1	chr9	3188990	3189414	LTR/ERVL-MaLR	1626	+	212	3189202	42584
chr9	3146618	3346618	harbor1	chr9	3204467	3204851	LTR/ERVL-MaLR	2092	+	192	3204659	58041
chr9	3146618	3346618	harbor1	chr9	3212559	3212986	LTR/ERVL-MaLR	2442	+	214	3212773	66155
chr9	133064057	133264057	harbor1	chr9	133088944	133089255	LTR/ERVL-MaLR	1667	+	156	133089100	25043
chr9	133064057	133264057	harbor1	chr9	133090108	133090204	LTR/ERVL-MaLR	602	+	48	133090156	26099
chr9	133064057	133264057	harbor1	chr9	133144780	133145210	LTR/ERVL-MaLR	1595	+	215	133144995	80938
chr9	133064057	133264057	harbor1	chr9	133146542	133147078	LTR/ERVL-MaLR	1424	+	268	133146810	82753
chr9	4824477	5024477	harbor1	chr9	4873802	4874157	LTR/ERVL-MaLR	1879	+	178	4873980	49503
chr9	4824477	5024477	harbor1	chr9	4906260	4906423	LTR/ERVL-MaLR	1398	+	82	4906342	81865
chr9	4824477	5024477	harbor1	chr9	4906725	4906961	LTR/ERVL-MaLR	1398	+	118	4906843	82366
chr9	4692737	4892737	harbor1	chr9	4715795	4716197	LTR/ERVL-MaLR	740	+	201	4715996	23259
chr9	4692737	4892737	harbor1	chr9	4734005	4734371	LTR/ERVL-MaLR	1500	+	183	4734188	41451
chr9	4692737	4892737	harbor1	chr9	4744317	4744746	LTR/ERVL-MaLR	1937	+	214	4744531	51794
chr9	4692737	4892737	harbor1	chr9	4745926	4746431	LTR/ERVL-MaLR	1353	+	252	4746178	53441
chr9	4692737	4892737	harbor1	chr9	4786060	4786364	LTR/ERVL-MaLR	2618	+	152	4786212	93475
chr9	4692737	4892737	harbor1	chr9	4786667	4786739	LTR/ERVL-MaLR	2618	+	36	4786703	93966
chr9	4692768	4892768	harbor1	chr9	4715795	4716197	LTR/ERVL-MaLR	740	+	201	4715996	23228
chr9	4692768	4892768	harbor1	chr9	4734005	4734371	LTR/ERVL-MaLR	1500	+	183	4734188	41420
chr9	4692768	4892768	harbor1	chr9	4744317	4744746	LTR/ERVL-MaLR	1937	+	214	4744531	51763
chr9	4692768	4892768	harbor1	chr9	4745926	4746431	LTR/ERVL-MaLR	1353	+	252	4746178	53410
chr9	4692768	4892768	harbor1	chr9	4786060	4786364	LTR/ERVL-MaLR	2618	+	152	4786212	93444
chr9	4692768	4892768	harbor1	chr9	4786667	4786739	LTR/ERVL-MaLR	2618	+	36	4786703	93935
chr9	4693017	4893017	harbor1	chr9	4715795	4716197	LTR/ERVL-MaLR	740	+	201	4715996	22979
chr9	4693017	4893017	harbor1	chr9	4734005	4734371	LTR/ERVL-MaLR	1500	+	183	4734188	41171
chr9	4693017	4893017	harbor1	chr9	4744317	4744746	LTR/ERVL-MaLR	1937	+	214	4744531	51514
chr9	4693017	4893017	harbor1	chr9	4745926	4746431	LTR/ERVL-MaLR	1353	+	252	4746178	53161
chr9	4693017	4893017	harbor1	chr9	4786060	4786364	LTR/ERVL-MaLR	2618	+	152	4786212	93195
chr9	4693017	4893017	harbor1	chr9	4786667	4786739	LTR/ERVL-MaLR	2618	+	36	4786703	93686
chr9	137316476	137516476	harbor1	chr9	137333462	137333825	LTR/ERVL-MaLR	1541	+	182	137333644	17168
chr9	137316476	137516476	harbor1	chr9	137409010	137409432	LTR/ERVL-MaLR	1282	+	211	137409221	92745
chr9	4884823	5084823	harbor1	chr9	4906260	4906423	LTR/ERVL-MaLR	1398	+	82	4906342	21519
chr9	4884823	5084823	harbor1	chr9	4906725	4906961	LTR/ERVL-MaLR	1398	+	118	4906843	22020
chr9	4883080	5083080	harbor1	chr9	4906260	4906423	LTR/ERVL-MaLR	1398	+	82	4906342	23262
chr9	4883080	5083080	harbor1	chr9	4906725	4906961	LTR/ERVL-MaLR	1398	+	118	4906843	23763
chr9	130119664	130319664	harbor1	chr9	130149682	130150161	LTR/ERVL-MaLR	885	+	240	130149922	30258
chr9	130119664	130319664	harbor1	chr9	130157119	130157313	LTR/ERVL-MaLR	516	+	97	130157216	37552
chr9	91323378	91523378	harbor1	chr9	91366978	91367098	LTR/ERVL-MaLR	719	+	60	91367038	43660
chr9	91323378	91523378	harbor1	chr9	91378038	91378417	LTR/ERVL-MaLR	2566	+	190	91378228	54850
chr9	91323378	91523378	harbor1	chr9	91394472	91394856	LTR/ERVL-MaLR	2274	+	192	91394664	71286
chr9	137214592	137414592	harbor1	chr9	137294334	137294568	LTR/ERVL-MaLR	918	+	117	137294451	79859
chr9	4884842	5084842	harbor1	chr9	4906260	4906423	LTR/ERVL-MaLR	1398	+	82	4906342	21500
chr9	4884842	5084842	harbor1	chr9	4906725	4906961	LTR/ERVL-MaLR	1398	+	118	4906843	22001
chr9	4692946	4892946	harbor1	chr9	4715795	4716197	LTR/ERVL-MaLR	740	+	201	4715996	23050
chr9	4692946	4892946	harbor1	chr9	4734005	4734371	LTR/ERVL-MaLR	1500	+	183	4734188	41242
chr9	4692946	4892946	harbor1	chr9	4744317	4744746	LTR/ERVL-MaLR	1937	+	214	4744531	51585
chr9	4692946	4892946	harbor1	chr9	4745926	4746431	LTR/ERVL-MaLR	1353	+	252	4746178	53232
chr9	4692946	4892946	harbor1	chr9	4786060	4786364	LTR/ERVL-MaLR	2618	+	152	4786212	93266
chr9	4692946	4892946	harbor1	chr9	4786667	4786739	LTR/ERVL-MaLR	2618	+	36	4786703	93757
chr9	4579427	4779427	harbor1	chr9	4657334	4657531	LTR/ERVL-MaLR	921	+	98	4657432	78005
chr9	4579427	4779427	harbor1	chr9	4657968	4658216	LTR/ERVL-MaLR	907	+	124	4658092	78665
chr9	131575355	131775355	harbor1	chr9	131617994	131618478	LTR/ERVL-MaLR	1285	+	242	131618236	42881
chr9	4659562	4859562	harbor1	chr9	4715795	4716197	LTR/ERVL-MaLR	740	+	201	4715996	56434
chr9	4659562	4859562	harbor1	chr9	4734005	4734371	LTR/ERVL-MaLR	1500	+	183	4734188	74626
chr9	4659562	4859562	harbor1	chr9	4744317	4744746	LTR/ERVL-MaLR	1937	+	214	4744531	84969
chr9	4659562	4859562	harbor1	chr9	4745926	4746431	LTR/ERVL-MaLR	1353	+	252	4746178	86616
chr9	131575427	131775427	harbor1	chr9	131617994	131618478	LTR/ERVL-MaLR	1285	+	242	131618236	42809
chr9	4884794	5084794	harbor1	chr9	4906260	4906423	LTR/ERVL-MaLR	1398	+	82	4906342	21548
chr9	4884794	5084794	harbor1	chr9	4906725	4906961	LTR/ERVL-MaLR	1398	+	118	4906843	22049
chr9	129542143	129742143	harbor1	chr9	129573845	129573933	LTR/ERVL-MaLR	557	+	44	129573889	31746
chr9	129542143	129742143	harbor1	chr9	129573934	129574059	LTR/ERVL-MaLR	1586	+	62	129573996	31853
chr9	129542143	129742143	harbor1	chr9	129574771	129574795	LTR/ERVL-MaLR	1586	+	12	129574783	32640
chr9	129542143	129742143	harbor1	chr9	129575094	129575303	LTR/ERVL-MaLR	1586	+	104	129575198	33055
chr9	129542143	129742143	harbor1	chr9	129575304	129575595	LTR/ERVL-MaLR	1455	+	146	129575450	33307
chr9	129542143	129742143	harbor1	chr9	129584150	129584572	LTR/ERVL-MaLR	1535	+	211	129584361	42218
chr9	133063678	133263678	harbor1	chr9	133088944	133089255	LTR/ERVL-MaLR	1667	+	156	133089100	25422
chr9	133063678	133263678	harbor1	chr9	133090108	133090204	LTR/ERVL-MaLR	602	+	48	133090156	26478
chr9	133063678	133263678	harbor1	chr9	133144780	133145210	LTR/ERVL-MaLR	1595	+	215	133144995	81317
chr9	133063678	133263678	harbor1	chr9	133146542	133147078	LTR/ERVL-MaLR	1424	+	268	133146810	83132
chr9	4883172	5083172	harbor1	chr9	4906260	4906423	LTR/ERVL-MaLR	1398	+	82	4906342	23170
chr9	4883172	5083172	harbor1	chr9	4906725	4906961	LTR/ERVL-MaLR	1398	+	118	4906843	23671
chr9	133007233	133207233	harbor1	chr9	133014791	133014938	LTR/ERVL-MaLR	770	+	74	133014865	7632
chr9	133007233	133207233	harbor1	chr9	133015050	133015267	LTR/ERVL-MaLR	953	+	108	133015158	7925
chr9	133007233	133207233	harbor1	chr9	133088944	133089255	LTR/ERVL-MaLR	1667	+	156	133089100	81867
chr9	133007233	133207233	harbor1	chr9	133090108	133090204	LTR/ERVL-MaLR	602	+	48	133090156	82923
chr9	4692889	4892889	harbor1	chr9	4715795	4716197	LTR/ERVL-MaLR	740	+	201	4715996	23107
chr9	4692889	4892889	harbor1	chr9	4734005	4734371	LTR/ERVL-MaLR	1500	+	183	4734188	41299
chr9	4692889	4892889	harbor1	chr9	4744317	4744746	LTR/ERVL-MaLR	1937	+	214	4744531	51642
chr9	4692889	4892889	harbor1	chr9	4745926	4746431	LTR/ERVL-MaLR	1353	+	252	4746178	53289
chr9	4692889	4892889	harbor1	chr9	4786060	4786364	LTR/ERVL-MaLR	2618	+	152	4786212	93323
chr9	4692889	4892889	harbor1	chr9	4786667	4786739	LTR/ERVL-MaLR	2618	+	36	4786703	93814
chr9	89937233	90137233	harbor1	chr9	89939767	89940319	LTR/ERVL-MaLR	1839	+	276	89940043	2810
chr9	89937233	90137233	harbor1	chr9	89940659	89941139	LTR/ERVL-MaLR	1067	+	240	89940899	3666
chr9	89937233	90137233	harbor1	chr9	89942422	89942778	LTR/ERVL-MaLR	1062	+	178	89942600	5367
chr9	89937233	90137233	harbor1	chr9	89952953	89953359	LTR/ERVL-MaLR	2459	+	203	89953156	15923
chr9	89937233	90137233	harbor1	chr9	89988987	89989376	LTR/ERVL-MaLR	745	+	194	89989181	51948
chr9	89937233	90137233	harbor1	chr9	89989769	89989864	LTR/ERVL-MaLR	745	+	48	89989817	52584
chr9	89937233	90137233	harbor1	chr9	90012477	90012626	LTR/ERVL-MaLR	1697	+	74	90012551	75318
chr9	89937233	90137233	harbor1	chr9	90012930	90013136	LTR/ERVL-MaLR	1697	+	103	90013033	75800
chr9	89937233	90137233	harbor1	chr9	90022275	90022665	LTR/ERVL-MaLR	1458	+	195	90022470	85237
chr9	64278589	64478589	harbor1	chr9	64320087	64320257	LTR/ERVL-MaLR	535	+	85	64320172	41583
chr9	64278589	64478589	harbor1	chr9	64322923	64323291	LTR/ERVL-MaLR	1035	+	184	64323107	44518
chr9	64278589	64478589	harbor1	chr9	64364520	64364881	LTR/ERVL-MaLR	1484	+	180	64364700	86111
chr9	4884884	5084884	harbor1	chr9	4906260	4906423	LTR/ERVL-MaLR	1398	+	82	4906342	21458
chr9	4884884	5084884	harbor1	chr9	4906725	4906961	LTR/ERVL-MaLR	1398	+	118	4906843	21959
chr9	130532874	130732874	harbor1	chr9	130545461	130545671	LTR/ERVL-MaLR	851	+	105	130545566	12692
chr9	130532874	130732874	harbor1	chr9	130546020	130546152	LTR/ERVL-MaLR	702	+	66	130546086	13212
chr9	130532874	130732874	harbor1	chr9	130546394	130546693	LTR/ERVL-MaLR	1573	+	150	130546544	13670
chr9	130532874	130732874	harbor1	chr9	130549160	130549445	LTR/ERVL-MaLR	937	+	142	130549302	16428
chr9	130532874	130732874	harbor1	chr9	130556271	130556829	LTR/ERVL-MaLR	808	+	279	130556550	23676
chr9	130532874	130732874	harbor1	chr9	130563809	130564063	LTR/ERVL-MaLR	800	+	127	130563936	31062
chr9	130532874	130732874	harbor1	chr9	130576041	130576202	LTR/ERVL-MaLR	528	+	80	130576121	43247
chr9	130532874	130732874	harbor1	chr9	130576238	130576516	LTR/ERVL-MaLR	845	+	139	130576377	43503
chr9	130532874	130732874	harbor1	chr9	130564079	130564315	LTR/ERVL-MaLR	1097	+	118	130564197	31323
chr9	4883057	5083057	harbor1	chr9	4906260	4906423	LTR/ERVL-MaLR	1398	+	82	4906342	23285
chr9	4883057	5083057	harbor1	chr9	4906725	4906961	LTR/ERVL-MaLR	1398	+	118	4906843	23786
chr9	4883813	5083813	harbor1	chr9	4906260	4906423	LTR/ERVL-MaLR	1398	+	82	4906342	22529
chr9	4883813	5083813	harbor1	chr9	4906725	4906961	LTR/ERVL-MaLR	1398	+	118	4906843	23030
chr9	4884786	5084786	harbor1	chr9	4906260	4906423	LTR/ERVL-MaLR	1398	+	82	4906342	21556
chr9	4884786	5084786	harbor1	chr9	4906725	4906961	LTR/ERVL-MaLR	1398	+	118	4906843	22057
chr9	4884810	5084810	harbor1	chr9	4906260	4906423	LTR/ERVL-MaLR	1398	+	82	4906342	21532
chr9	4884810	5084810	harbor1	chr9	4906725	4906961	LTR/ERVL-MaLR	1398	+	118	4906843	22033
chr9	4749616	4949616	harbor1	chr9	4786060	4786364	LTR/ERVL-MaLR	2618	+	152	4786212	36596
chr9	4749616	4949616	harbor1	chr9	4786667	4786739	LTR/ERVL-MaLR	2618	+	36	4786703	37087
chr9	4669937	4869937	harbor1	chr9	4715795	4716197	LTR/ERVL-MaLR	740	+	201	4715996	46059
chr9	4669937	4869937	harbor1	chr9	4734005	4734371	LTR/ERVL-MaLR	1500	+	183	4734188	64251
chr9	4669937	4869937	harbor1	chr9	4744317	4744746	LTR/ERVL-MaLR	1937	+	214	4744531	74594
chr9	4669937	4869937	harbor1	chr9	4745926	4746431	LTR/ERVL-MaLR	1353	+	252	4746178	76241
chr9	4694651	4894651	harbor1	chr9	4715795	4716197	LTR/ERVL-MaLR	740	+	201	4715996	21345
chr9	4694651	4894651	harbor1	chr9	4734005	4734371	LTR/ERVL-MaLR	1500	+	183	4734188	39537
chr9	4694651	4894651	harbor1	chr9	4744317	4744746	LTR/ERVL-MaLR	1937	+	214	4744531	49880
chr9	4694651	4894651	harbor1	chr9	4745926	4746431	LTR/ERVL-MaLR	1353	+	252	4746178	51527
chr9	4694651	4894651	harbor1	chr9	4786060	4786364	LTR/ERVL-MaLR	2618	+	152	4786212	91561
chr9	4694651	4894651	harbor1	chr9	4786667	4786739	LTR/ERVL-MaLR	2618	+	36	4786703	92052
chr9	4884784	5084784	harbor1	chr9	4906260	4906423	LTR/ERVL-MaLR	1398	+	82	4906342	21558
chr9	4884784	5084784	harbor1	chr9	4906725	4906961	LTR/ERVL-MaLR	1398	+	118	4906843	22059
chr9	4694865	4894865	harbor1	chr9	4715795	4716197	LTR/ERVL-MaLR	740	+	201	4715996	21131
chr9	4694865	4894865	harbor1	chr9	4734005	4734371	LTR/ERVL-MaLR	1500	+	183	4734188	39323
chr9	4694865	4894865	harbor1	chr9	4744317	4744746	LTR/ERVL-MaLR	1937	+	214	4744531	49666
chr9	4694865	4894865	harbor1	chr9	4745926	4746431	LTR/ERVL-MaLR	1353	+	252	4746178	51313
chr9	4694865	4894865	harbor1	chr9	4786060	4786364	LTR/ERVL-MaLR	2618	+	152	4786212	91347
chr9	4694865	4894865	harbor1	chr9	4786667	4786739	LTR/ERVL-MaLR	2618	+	36	4786703	91838
chr9	196617	396617	harbor1	chr9	200625	201041	LTR/ERVL-MaLR	2187	+	208	200833	4216
chr9	196617	396617	harbor1	chr9	206756	207130	LTR/ERVL-MaLR	501	+	187	206943	10326
chr9	196617	396617	harbor1	chr9	227398	227630	LTR/ERVL-MaLR	571	+	116	227514	30897
chr9	196617	396617	harbor1	chr9	228567	228710	LTR/ERVL-MaLR	601	+	72	228639	32022
chr9	3399943	3599943	harbor1	chr9	3435847	3436014	LTR/ERVL-MaLR	481	+	84	3435931	35988
chr9	4692795	4892795	harbor1	chr9	4715795	4716197	LTR/ERVL-MaLR	740	+	201	4715996	23201
chr9	4692795	4892795	harbor1	chr9	4734005	4734371	LTR/ERVL-MaLR	1500	+	183	4734188	41393
chr9	4692795	4892795	harbor1	chr9	4744317	4744746	LTR/ERVL-MaLR	1937	+	214	4744531	51736
chr9	4692795	4892795	harbor1	chr9	4745926	4746431	LTR/ERVL-MaLR	1353	+	252	4746178	53383
chr9	4692795	4892795	harbor1	chr9	4786060	4786364	LTR/ERVL-MaLR	2618	+	152	4786212	93417
chr9	4692795	4892795	harbor1	chr9	4786667	4786739	LTR/ERVL-MaLR	2618	+	36	4786703	93908
chr9	68605549	68805549	harbor1	chr9	68631273	68631704	LTR/ERVL-MaLR	1203	+	216	68631489	25940
chr9	68605549	68805549	harbor1	chr9	68646588	68647054	LTR/ERVL-MaLR	531	+	233	68646821	41272
chr9	68605549	68805549	harbor1	chr9	68674212	68674715	LTR/ERVL-MaLR	1995	+	252	68674464	68915
chr9	68605549	68805549	harbor1	chr9	68701707	68702050	LTR/ERVL-MaLR	897	+	172	68701879	96330
chr9	68605549	68805549	harbor1	chr9	68702349	68702523	LTR/ERVL-MaLR	897	+	87	68702436	96887
chr9	68605549	68805549	harbor1	chr9	68698096	68698307	LTR/ERVL-MaLR	640	+	106	68698202	92653
chr9	4866377	5066377	harbor1	chr9	4873802	4874157	LTR/ERVL-MaLR	1879	+	178	4873980	7603
chr9	4866377	5066377	harbor1	chr9	4906260	4906423	LTR/ERVL-MaLR	1398	+	82	4906342	39965
chr9	4866377	5066377	harbor1	chr9	4906725	4906961	LTR/ERVL-MaLR	1398	+	118	4906843	40466
chr9	4884847	5084847	harbor1	chr9	4906260	4906423	LTR/ERVL-MaLR	1398	+	82	4906342	21495
chr9	4884847	5084847	harbor1	chr9	4906725	4906961	LTR/ERVL-MaLR	1398	+	118	4906843	21996
chr9	4884951	5084951	harbor1	chr9	4906260	4906423	LTR/ERVL-MaLR	1398	+	82	4906342	21391
chr9	4884951	5084951	harbor1	chr9	4906725	4906961	LTR/ERVL-MaLR	1398	+	118	4906843	21892
chr9	4692232	4892232	harbor1	chr9	4715795	4716197	LTR/ERVL-MaLR	740	+	201	4715996	23764
chr9	4692232	4892232	harbor1	chr9	4734005	4734371	LTR/ERVL-MaLR	1500	+	183	4734188	41956
chr9	4692232	4892232	harbor1	chr9	4744317	4744746	LTR/ERVL-MaLR	1937	+	214	4744531	52299
chr9	4692232	4892232	harbor1	chr9	4745926	4746431	LTR/ERVL-MaLR	1353	+	252	4746178	53946
chr9	4692232	4892232	harbor1	chr9	4786060	4786364	LTR/ERVL-MaLR	2618	+	152	4786212	93980
chr9	4692232	4892232	harbor1	chr9	4786667	4786739	LTR/ERVL-MaLR	2618	+	36	4786703	94471
chr9	108346093	108546093	harbor1	chr9	108353993	108354383	LTR/ERVL-MaLR	1413	+	195	108354188	8095
chr9	108346093	108546093	harbor1	chr9	108360798	108360955	LTR/ERVL-MaLR	819	+	78	108360876	14783
chr9	108346093	108546093	harbor1	chr9	108362296	108362512	LTR/ERVL-MaLR	1067	+	108	108362404	16311
chr9	108346093	108546093	harbor1	chr9	108366910	108367287	LTR/ERVL-MaLR	2126	+	188	108367098	21005
chr9	108346093	108546093	harbor1	chr9	108379217	108379561	LTR/ERVL-MaLR	1800	+	172	108379389	33296
chr9	108346093	108546093	harbor1	chr9	108419741	108420144	LTR/ERVL-MaLR	2094	+	202	108419943	73850
chr9	108346093	108546093	harbor1	chr9	108438811	108439279	LTR/ERVL-MaLR	1988	+	234	108439045	92952
chr9	89509793	89709793	harbor1	chr9	89511811	89512206	LTR/ERVL-MaLR	1822	+	198	89512009	2216
chr9	89509793	89709793	harbor1	chr9	89519160	89519606	LTR/ERVL-MaLR	586	+	223	89519383	9590
chr9	89509793	89709793	harbor1	chr9	89566142	89566614	LTR/ERVL-MaLR	1880	+	236	89566378	56585
chr9	89509793	89709793	harbor1	chr9	89568453	89568820	LTR/ERVL-MaLR	2610	+	184	89568637	58844
chr9	89509793	89709793	harbor1	chr9	89578928	89579197	LTR/ERVL-MaLR	758	+	134	89579062	69269
chr9	4884827	5084827	harbor1	chr9	4906260	4906423	LTR/ERVL-MaLR	1398	+	82	4906342	21515
chr9	4884827	5084827	harbor1	chr9	4906725	4906961	LTR/ERVL-MaLR	1398	+	118	4906843	22016
chr9	134035554	134235554	harbor1	chr9	134080893	134081136	LTR/ERVL-MaLR	1501	+	122	134081015	45461
chr9	134035554	134235554	harbor1	chr9	134081433	134081620	LTR/ERVL-MaLR	1347	+	94	134081527	45973
chr9	134035554	134235554	harbor1	chr9	134085385	134085520	LTR/ERVL-MaLR	581	+	68	134085453	49899
chr9	134035554	134235554	harbor1	chr9	134085613	134085982	LTR/ERVL-MaLR	1762	+	184	134085797	50243
chr9	134035554	134235554	harbor1	chr9	134095774	134095856	LTR/ERVL-MaLR	1876	+	41	134095815	60261
chr9	134035554	134235554	harbor1	chr9	134096150	134096428	LTR/ERVL-MaLR	1876	+	139	134096289	60735
chr9	131575342	131775342	harbor1	chr9	131617994	131618478	LTR/ERVL-MaLR	1285	+	242	131618236	42894
chr9	4648821	4848821	harbor1	chr9	4657334	4657531	LTR/ERVL-MaLR	921	+	98	4657432	8611
chr9	4648821	4848821	harbor1	chr9	4657968	4658216	LTR/ERVL-MaLR	907	+	124	4658092	9271
chr9	4648821	4848821	harbor1	chr9	4715795	4716197	LTR/ERVL-MaLR	740	+	201	4715996	67175
chr9	4648821	4848821	harbor1	chr9	4734005	4734371	LTR/ERVL-MaLR	1500	+	183	4734188	85367
chr9	4648821	4848821	harbor1	chr9	4744317	4744746	LTR/ERVL-MaLR	1937	+	214	4744531	95710
chr9	4648821	4848821	harbor1	chr9	4745926	4746431	LTR/ERVL-MaLR	1353	+	252	4746178	97357
chr9	136294898	136494898	harbor1	chr9	136317221	136317580	LTR/ERVL-MaLR	771	+	180	136317401	22503
chr9	135905941	136105941	harbor1	chr9	135914666	135915084	LTR/ERVL-MaLR	2076	+	209	135914875	8934
chr9	135905941	136105941	harbor1	chr9	135949847	135950288	LTR/ERVL-MaLR	1231	+	220	135950067	44126
chr9	87626432	87826432	harbor1	chr9	87629006	87629492	LTR/ERVL-MaLR	1354	+	243	87629249	2817
chr9	87626432	87826432	harbor1	chr9	87629750	87630236	LTR/ERVL-MaLR	514	+	243	87629993	3561
chr9	87626432	87826432	harbor1	chr9	87723577	87723766	LTR/ERVL-MaLR	2469	+	94	87723671	97239
chr9	87626432	87826432	harbor1	chr9	87724076	87724322	LTR/ERVL-MaLR	2469	+	123	87724199	97767
chr9	4669262	4869262	harbor1	chr9	4715795	4716197	LTR/ERVL-MaLR	740	+	201	4715996	46734
chr9	4669262	4869262	harbor1	chr9	4734005	4734371	LTR/ERVL-MaLR	1500	+	183	4734188	64926
chr9	4669262	4869262	harbor1	chr9	4744317	4744746	LTR/ERVL-MaLR	1937	+	214	4744531	75269
chr9	4669262	4869262	harbor1	chr9	4745926	4746431	LTR/ERVL-MaLR	1353	+	252	4746178	76916
chr9	4812824	5012824	harbor1	chr9	4873802	4874157	LTR/ERVL-MaLR	1879	+	178	4873980	61156
chr9	4812824	5012824	harbor1	chr9	4906260	4906423	LTR/ERVL-MaLR	1398	+	82	4906342	93518
chr9	4812824	5012824	harbor1	chr9	4906725	4906961	LTR/ERVL-MaLR	1398	+	118	4906843	94019
chr9	97885101	98085101	harbor1	chr9	97911096	97911676	LTR/ERVL-MaLR	1347	+	290	97911386	26285
chr9	34027027	34227027	harbor1	chr9	34063361	34063502	LTR/ERVL-MaLR	554	+	70	34063431	36404
chr9	4692222	4892222	harbor1	chr9	4715795	4716197	LTR/ERVL-MaLR	740	+	201	4715996	23774
chr9	4692222	4892222	harbor1	chr9	4734005	4734371	LTR/ERVL-MaLR	1500	+	183	4734188	41966
chr9	4692222	4892222	harbor1	chr9	4744317	4744746	LTR/ERVL-MaLR	1937	+	214	4744531	52309
chr9	4692222	4892222	harbor1	chr9	4745926	4746431	LTR/ERVL-MaLR	1353	+	252	4746178	53956
chr9	4692222	4892222	harbor1	chr9	4786060	4786364	LTR/ERVL-MaLR	2618	+	152	4786212	93990
chr9	4692222	4892222	harbor1	chr9	4786667	4786739	LTR/ERVL-MaLR	2618	+	36	4786703	94481
chr9	68605579	68805579	harbor1	chr9	68631273	68631704	LTR/ERVL-MaLR	1203	+	216	68631489	25910
chr9	68605579	68805579	harbor1	chr9	68646588	68647054	LTR/ERVL-MaLR	531	+	233	68646821	41242
chr9	68605579	68805579	harbor1	chr9	68674212	68674715	LTR/ERVL-MaLR	1995	+	252	68674464	68885
chr9	68605579	68805579	harbor1	chr9	68701707	68702050	LTR/ERVL-MaLR	897	+	172	68701879	96300
chr9	68605579	68805579	harbor1	chr9	68702349	68702523	LTR/ERVL-MaLR	897	+	87	68702436	96857
chr9	68605579	68805579	harbor1	chr9	68698096	68698307	LTR/ERVL-MaLR	640	+	106	68698202	92623
chr9	4879662	5079662	harbor1	chr9	4906260	4906423	LTR/ERVL-MaLR	1398	+	82	4906342	26680
chr9	4879662	5079662	harbor1	chr9	4906725	4906961	LTR/ERVL-MaLR	1398	+	118	4906843	27181
chr9	4579422	4779422	harbor1	chr9	4657334	4657531	LTR/ERVL-MaLR	921	+	98	4657432	78010
chr9	4579422	4779422	harbor1	chr9	4657968	4658216	LTR/ERVL-MaLR	907	+	124	4658092	78670
chr9	85705422	85905422	harbor1	chr9	85717537	85717678	LTR/ERVL-MaLR	805	+	70	85717607	12185
chr9	85705422	85905422	harbor1	chr9	85723827	85724004	LTR/ERVL-MaLR	1158	+	88	85723915	18493
chr9	85705422	85905422	harbor1	chr9	85724314	85724383	LTR/ERVL-MaLR	1158	+	34	85724348	18926
chr9	4883218	5083218	harbor1	chr9	4906260	4906423	LTR/ERVL-MaLR	1398	+	82	4906342	23124
chr9	4883218	5083218	harbor1	chr9	4906725	4906961	LTR/ERVL-MaLR	1398	+	118	4906843	23625
chr9	130119656	130319656	harbor1	chr9	130149682	130150161	LTR/ERVL-MaLR	885	+	240	130149922	30266
chr9	130119656	130319656	harbor1	chr9	130157119	130157313	LTR/ERVL-MaLR	516	+	97	130157216	37560
chr9	4883477	5083477	harbor1	chr9	4906260	4906423	LTR/ERVL-MaLR	1398	+	82	4906342	22865
chr9	4883477	5083477	harbor1	chr9	4906725	4906961	LTR/ERVL-MaLR	1398	+	118	4906843	23366
chr9	4663738	4863738	harbor1	chr9	4715795	4716197	LTR/ERVL-MaLR	740	+	201	4715996	52258
chr9	4663738	4863738	harbor1	chr9	4734005	4734371	LTR/ERVL-MaLR	1500	+	183	4734188	70450
chr9	4663738	4863738	harbor1	chr9	4744317	4744746	LTR/ERVL-MaLR	1937	+	214	4744531	80793
chr9	4663738	4863738	harbor1	chr9	4745926	4746431	LTR/ERVL-MaLR	1353	+	252	4746178	82440
chr9	4885072	5085072	harbor1	chr9	4906260	4906423	LTR/ERVL-MaLR	1398	+	82	4906342	21270
chr9	4885072	5085072	harbor1	chr9	4906725	4906961	LTR/ERVL-MaLR	1398	+	118	4906843	21771
chr9	35655086	35855086	harbor1	chr9	35668813	35669254	LTR/ERVL-MaLR	1652	+	220	35669033	13947
chr9	4824143	5024143	harbor1	chr9	4873802	4874157	LTR/ERVL-MaLR	1879	+	178	4873980	49837
chr9	4824143	5024143	harbor1	chr9	4906260	4906423	LTR/ERVL-MaLR	1398	+	82	4906342	82199
chr9	4824143	5024143	harbor1	chr9	4906725	4906961	LTR/ERVL-MaLR	1398	+	118	4906843	82700
chr9	4663518	4863518	harbor1	chr9	4715795	4716197	LTR/ERVL-MaLR	740	+	201	4715996	52478
chr9	4663518	4863518	harbor1	chr9	4734005	4734371	LTR/ERVL-MaLR	1500	+	183	4734188	70670
chr9	4663518	4863518	harbor1	chr9	4744317	4744746	LTR/ERVL-MaLR	1937	+	214	4744531	81013
chr9	4663518	4863518	harbor1	chr9	4745926	4746431	LTR/ERVL-MaLR	1353	+	252	4746178	82660
chr9	130042390	130242390	harbor1	chr9	130064623	130065057	LTR/ERVL-MaLR	1569	+	217	130064840	22450
chr9	135599704	135799704	harbor1	chr9	135669007	135669365	LTR/ERVL-MaLR	2396	+	179	135669186	69482
chr9	135599704	135799704	harbor1	chr9	135689928	135690296	LTR/ERVL-MaLR	2380	+	184	135690112	90408
chr9	135599704	135799704	harbor1	chr9	135691814	135692206	LTR/ERVL-MaLR	2070	+	196	135692010	92306
chr9	4692806	4892806	harbor1	chr9	4715795	4716197	LTR/ERVL-MaLR	740	+	201	4715996	23190
chr9	4692806	4892806	harbor1	chr9	4734005	4734371	LTR/ERVL-MaLR	1500	+	183	4734188	41382
chr9	4692806	4892806	harbor1	chr9	4744317	4744746	LTR/ERVL-MaLR	1937	+	214	4744531	51725
chr9	4692806	4892806	harbor1	chr9	4745926	4746431	LTR/ERVL-MaLR	1353	+	252	4746178	53372
chr9	4692806	4892806	harbor1	chr9	4786060	4786364	LTR/ERVL-MaLR	2618	+	152	4786212	93406
chr9	4692806	4892806	harbor1	chr9	4786667	4786739	LTR/ERVL-MaLR	2618	+	36	4786703	93897
chr9	4744087	4944087	harbor1	chr9	4744317	4744746	LTR/ERVL-MaLR	1937	+	214	4744531	444
chr9	4744087	4944087	harbor1	chr9	4745926	4746431	LTR/ERVL-MaLR	1353	+	252	4746178	2091
chr9	4744087	4944087	harbor1	chr9	4786060	4786364	LTR/ERVL-MaLR	2618	+	152	4786212	42125
chr9	4744087	4944087	harbor1	chr9	4786667	4786739	LTR/ERVL-MaLR	2618	+	36	4786703	42616
chr9	133762512	133962512	harbor1	chr9	133801641	133802000	LTR/ERVL-MaLR	543	+	180	133801821	39309
chr9	133762512	133962512	harbor1	chr9	133830304	133830641	LTR/ERVL-MaLR	2000	+	168	133830472	67960
chr9	4884871	5084871	harbor1	chr9	4906260	4906423	LTR/ERVL-MaLR	1398	+	82	4906342	21471
chr9	4884871	5084871	harbor1	chr9	4906725	4906961	LTR/ERVL-MaLR	1398	+	118	4906843	21972
chr9	4692558	4892558	harbor1	chr9	4715795	4716197	LTR/ERVL-MaLR	740	+	201	4715996	23438
chr9	4692558	4892558	harbor1	chr9	4734005	4734371	LTR/ERVL-MaLR	1500	+	183	4734188	41630
chr9	4692558	4892558	harbor1	chr9	4744317	4744746	LTR/ERVL-MaLR	1937	+	214	4744531	51973
chr9	4692558	4892558	harbor1	chr9	4745926	4746431	LTR/ERVL-MaLR	1353	+	252	4746178	53620
chr9	4692558	4892558	harbor1	chr9	4786060	4786364	LTR/ERVL-MaLR	2618	+	152	4786212	93654
chr9	4692558	4892558	harbor1	chr9	4786667	4786739	LTR/ERVL-MaLR	2618	+	36	4786703	94145
chr9	4883433	5083433	harbor1	chr9	4906260	4906423	LTR/ERVL-MaLR	1398	+	82	4906342	22909
chr9	4883433	5083433	harbor1	chr9	4906725	4906961	LTR/ERVL-MaLR	1398	+	118	4906843	23410
chr9	87626458	87826458	harbor1	chr9	87629006	87629492	LTR/ERVL-MaLR	1354	+	243	87629249	2791
chr9	87626458	87826458	harbor1	chr9	87629750	87630236	LTR/ERVL-MaLR	514	+	243	87629993	3535
chr9	87626458	87826458	harbor1	chr9	87723577	87723766	LTR/ERVL-MaLR	2469	+	94	87723671	97213
chr9	87626458	87826458	harbor1	chr9	87724076	87724322	LTR/ERVL-MaLR	2469	+	123	87724199	97741
chr9	105145295	105345295	harbor1	chr9	105175706	105175966	LTR/ERVL-MaLR	1084	+	130	105175836	30541
chr9	105145295	105345295	harbor1	chr9	105176270	105176400	LTR/ERVL-MaLR	1084	+	65	105176335	31040
chr9	105145295	105345295	harbor1	chr9	105204253	105204745	LTR/ERVL-MaLR	2540	+	246	105204499	59204
chr9	105145295	105345295	harbor1	chr9	105237537	105237704	LTR/ERVL-MaLR	533	+	84	105237621	92326
chr9	105145295	105345295	harbor1	chr9	105152509	105152856	LTR/ERVL-MaLR	1918	+	174	105152683	7388
chr9	112387255	112587255	harbor1	chr9	112431491	112431866	LTR/ERVL-MaLR	2647	+	188	112431679	44424
chr9	112387255	112587255	harbor1	chr9	112432182	112432221	LTR/ERVL-MaLR	2647	+	20	112432202	44947
chr9	112387255	112587255	harbor1	chr9	112471253	112471587	LTR/ERVL-MaLR	1438	+	167	112471420	84165
chr9	112387255	112587255	harbor1	chr9	112479312	112479682	LTR/ERVL-MaLR	1865	+	185	112479497	92242
chr9	4730514	4930514	harbor1	chr9	4734005	4734371	LTR/ERVL-MaLR	1500	+	183	4734188	3674
chr9	4730514	4930514	harbor1	chr9	4744317	4744746	LTR/ERVL-MaLR	1937	+	214	4744531	14017
chr9	4730514	4930514	harbor1	chr9	4745926	4746431	LTR/ERVL-MaLR	1353	+	252	4746178	15664
chr9	4730514	4930514	harbor1	chr9	4786060	4786364	LTR/ERVL-MaLR	2618	+	152	4786212	55698
chr9	4730514	4930514	harbor1	chr9	4786667	4786739	LTR/ERVL-MaLR	2618	+	36	4786703	56189
chr9	34027056	34227056	harbor1	chr9	34063361	34063502	LTR/ERVL-MaLR	554	+	70	34063431	36375
chr9	4692205	4892205	harbor1	chr9	4715795	4716197	LTR/ERVL-MaLR	740	+	201	4715996	23791
chr9	4692205	4892205	harbor1	chr9	4734005	4734371	LTR/ERVL-MaLR	1500	+	183	4734188	41983
chr9	4692205	4892205	harbor1	chr9	4744317	4744746	LTR/ERVL-MaLR	1937	+	214	4744531	52326
chr9	4692205	4892205	harbor1	chr9	4745926	4746431	LTR/ERVL-MaLR	1353	+	252	4746178	53973
chr9	4692205	4892205	harbor1	chr9	4786060	4786364	LTR/ERVL-MaLR	2618	+	152	4786212	94007
chr9	4692205	4892205	harbor1	chr9	4786667	4786739	LTR/ERVL-MaLR	2618	+	36	4786703	94498
chr9	137176266	137376266	harbor1	chr9	137176073	137176450	LTR/ERVL-MaLR	1150	+	188	137176261	5
chr9	137176266	137376266	harbor1	chr9	137176451	137177199	LTR/ERVL-MaLR	2017	+	374	137176825	559
chr9	137176266	137376266	harbor1	chr9	137177237	137177473	LTR/ERVL-MaLR	566	+	118	137177355	1089
chr9	137176266	137376266	harbor1	chr9	137177670	137178066	LTR/ERVL-MaLR	1177	+	198	137177868	1602
chr9	4692312	4892312	harbor1	chr9	4715795	4716197	LTR/ERVL-MaLR	740	+	201	4715996	23684
chr9	4692312	4892312	harbor1	chr9	4734005	4734371	LTR/ERVL-MaLR	1500	+	183	4734188	41876
chr9	4692312	4892312	harbor1	chr9	4744317	4744746	LTR/ERVL-MaLR	1937	+	214	4744531	52219
chr9	4692312	4892312	harbor1	chr9	4745926	4746431	LTR/ERVL-MaLR	1353	+	252	4746178	53866
chr9	4692312	4892312	harbor1	chr9	4786060	4786364	LTR/ERVL-MaLR	2618	+	152	4786212	93900
chr9	4692312	4892312	harbor1	chr9	4786667	4786739	LTR/ERVL-MaLR	2618	+	36	4786703	94391
chr9	4694469	4894469	harbor1	chr9	4715795	4716197	LTR/ERVL-MaLR	740	+	201	4715996	21527
chr9	4694469	4894469	harbor1	chr9	4734005	4734371	LTR/ERVL-MaLR	1500	+	183	4734188	39719
chr9	4694469	4894469	harbor1	chr9	4744317	4744746	LTR/ERVL-MaLR	1937	+	214	4744531	50062
chr9	4694469	4894469	harbor1	chr9	4745926	4746431	LTR/ERVL-MaLR	1353	+	252	4746178	51709
chr9	4694469	4894469	harbor1	chr9	4786060	4786364	LTR/ERVL-MaLR	2618	+	152	4786212	91743
chr9	4694469	4894469	harbor1	chr9	4786667	4786739	LTR/ERVL-MaLR	2618	+	36	4786703	92234
chr9	136745116	136945116	harbor1	chr9	136753102	136753464	LTR/ERVL-MaLR	1251	+	181	136753283	8167
chr9	136745116	136945116	harbor1	chr9	136760821	136761260	LTR/ERVL-MaLR	1326	+	220	136761041	15925
chr9	136745116	136945116	harbor1	chr9	136761561	136761624	LTR/ERVL-MaLR	1326	+	32	136761593	16477
chr9	136745116	136945116	harbor1	chr9	136773829	136774210	LTR/ERVL-MaLR	866	+	190	136774019	28903
chr9	136745116	136945116	harbor1	chr9	136794995	136795284	LTR/ERVL-MaLR	1201	+	144	136795139	50023
chr9	136745116	136945116	harbor1	chr9	136795597	136795631	LTR/ERVL-MaLR	1201	+	17	136795614	50498
chr9	133819687	134019687	harbor1	chr9	133830304	133830641	LTR/ERVL-MaLR	2000	+	168	133830472	10785
chr9	133819687	134019687	harbor1	chr9	133882401	133882715	LTR/ERVL-MaLR	627	+	157	133882558	62871
chr9	133819687	134019687	harbor1	chr9	133890595	133890820	LTR/ERVL-MaLR	584	+	112	133890707	71020
chr9	133819687	134019687	harbor1	chr9	133902616	133902790	LTR/ERVL-MaLR	1119	+	87	133902703	83016
chr9	133819687	134019687	harbor1	chr9	133903099	133903257	LTR/ERVL-MaLR	1119	+	79	133903178	83491
chr9	133819687	134019687	harbor1	chr9	133910011	133910361	LTR/ERVL-MaLR	598	+	175	133910186	90499
chr9	35625694	35825694	harbor1	chr9	35668813	35669254	LTR/ERVL-MaLR	1652	+	220	35669033	43339
chr9	4884855	5084855	harbor1	chr9	4906260	4906423	LTR/ERVL-MaLR	1398	+	82	4906342	21487
chr9	4884855	5084855	harbor1	chr9	4906725	4906961	LTR/ERVL-MaLR	1398	+	118	4906843	21988
chr9	133678135	133878135	harbor1	chr9	133695008	133695167	LTR/ERVL-MaLR	1365	+	80	133695088	16953
chr9	133678135	133878135	harbor1	chr9	133695469	133695706	LTR/ERVL-MaLR	1365	+	118	133695587	17452
chr9	133678135	133878135	harbor1	chr9	133705729	133706073	LTR/ERVL-MaLR	1019	+	172	133705901	27766
chr9	133678135	133878135	harbor1	chr9	133746992	133747327	LTR/ERVL-MaLR	1455	+	168	133747160	69025
chr9	133678135	133878135	harbor1	chr9	133754587	133755075	LTR/ERVL-MaLR	1657	+	244	133754831	76696
chr9	37551225	37751225	harbor1	chr9	37559554	37559930	LTR/ERVL-MaLR	1044	+	188	37559742	8517
chr9	37551225	37751225	harbor1	chr9	37562959	37563320	LTR/ERVL-MaLR	2273	+	180	37563139	11914
chr9	37551225	37751225	harbor1	chr9	37563321	37564947	LTR/ERVL-MaLR	9938	+	813	37564134	12909
chr9	37551225	37751225	harbor1	chr9	37564948	37565302	LTR/ERVL-MaLR	2306	+	177	37565125	13900
chr9	37551225	37751225	harbor1	chr9	37580433	37580962	LTR/ERVL-MaLR	709	+	264	37580697	29472
chr9	137214581	137414581	harbor1	chr9	137294334	137294568	LTR/ERVL-MaLR	918	+	117	137294451	79870
chr9	4692887	4892887	harbor1	chr9	4715795	4716197	LTR/ERVL-MaLR	740	+	201	4715996	23109
chr9	4692887	4892887	harbor1	chr9	4734005	4734371	LTR/ERVL-MaLR	1500	+	183	4734188	41301
chr9	4692887	4892887	harbor1	chr9	4744317	4744746	LTR/ERVL-MaLR	1937	+	214	4744531	51644
chr9	4692887	4892887	harbor1	chr9	4745926	4746431	LTR/ERVL-MaLR	1353	+	252	4746178	53291
chr9	4692887	4892887	harbor1	chr9	4786060	4786364	LTR/ERVL-MaLR	2618	+	152	4786212	93325
chr9	4692887	4892887	harbor1	chr9	4786667	4786739	LTR/ERVL-MaLR	2618	+	36	4786703	93816
chr9	4884829	5084829	harbor1	chr9	4906260	4906423	LTR/ERVL-MaLR	1398	+	82	4906342	21513
chr9	4884829	5084829	harbor1	chr9	4906725	4906961	LTR/ERVL-MaLR	1398	+	118	4906843	22014
chr9	135829624	136029624	harbor1	chr9	135870112	135870477	LTR/ERVL-MaLR	2043	+	182	135870294	40670
chr9	135829624	136029624	harbor1	chr9	135896751	135897050	LTR/ERVL-MaLR	1444	+	150	135896901	67277
chr9	135829624	136029624	harbor1	chr9	135914666	135915084	LTR/ERVL-MaLR	2076	+	209	135914875	85251
chr9	4885054	5085054	harbor1	chr9	4906260	4906423	LTR/ERVL-MaLR	1398	+	82	4906342	21288
chr9	4885054	5085054	harbor1	chr9	4906725	4906961	LTR/ERVL-MaLR	1398	+	118	4906843	21789
chr9	4692851	4892851	harbor1	chr9	4715795	4716197	LTR/ERVL-MaLR	740	+	201	4715996	23145
chr9	4692851	4892851	harbor1	chr9	4734005	4734371	LTR/ERVL-MaLR	1500	+	183	4734188	41337
chr9	4692851	4892851	harbor1	chr9	4744317	4744746	LTR/ERVL-MaLR	1937	+	214	4744531	51680
chr9	4692851	4892851	harbor1	chr9	4745926	4746431	LTR/ERVL-MaLR	1353	+	252	4746178	53327
chr9	4692851	4892851	harbor1	chr9	4786060	4786364	LTR/ERVL-MaLR	2618	+	152	4786212	93361
chr9	4692851	4892851	harbor1	chr9	4786667	4786739	LTR/ERVL-MaLR	2618	+	36	4786703	93852
chr9	4692854	4892854	harbor1	chr9	4715795	4716197	LTR/ERVL-MaLR	740	+	201	4715996	23142
chr9	4692854	4892854	harbor1	chr9	4734005	4734371	LTR/ERVL-MaLR	1500	+	183	4734188	41334
chr9	4692854	4892854	harbor1	chr9	4744317	4744746	LTR/ERVL-MaLR	1937	+	214	4744531	51677
chr9	4692854	4892854	harbor1	chr9	4745926	4746431	LTR/ERVL-MaLR	1353	+	252	4746178	53324
chr9	4692854	4892854	harbor1	chr9	4786060	4786364	LTR/ERVL-MaLR	2618	+	152	4786212	93358
chr9	4692854	4892854	harbor1	chr9	4786667	4786739	LTR/ERVL-MaLR	2618	+	36	4786703	93849
chr9	136928407	137128407	harbor1	chr9	136932997	136934550	LTR/ERVL-MaLR	6072	+	776	136933773	5366
chr9	136928407	137128407	harbor1	chr9	136934551	136934870	LTR/ERVL-MaLR	1184	+	160	136934711	6304
chr9	136928407	137128407	harbor1	chr9	136934877	136935014	LTR/ERVL-MaLR	578	+	68	136934945	6538
chr9	136928407	137128407	harbor1	chr9	136962067	136962125	LTR/ERVL-MaLR	774	+	29	136962096	33689
chr9	136928407	137128407	harbor1	chr9	136962419	136962683	LTR/ERVL-MaLR	774	+	132	136962551	34144
chr9	136928407	137128407	harbor1	chr9	136998619	136998700	LTR/ERVL-MaLR	654	+	40	136998659	70252
chr9	136928407	137128407	harbor1	chr9	136998999	136999032	LTR/ERVL-MaLR	654	+	16	136999015	70608
chr9	136928407	137128407	harbor1	chr9	136999331	136999495	LTR/ERVL-MaLR	654	+	82	136999413	71006
chr9	136928407	137128407	harbor1	chr9	137001159	137001214	LTR/ERVL-MaLR	1145	+	28	137001187	72780
chr9	136928407	137128407	harbor1	chr9	137001522	137001561	LTR/ERVL-MaLR	1145	+	20	137001542	73135
chr9	136928407	137128407	harbor1	chr9	137001859	137002123	LTR/ERVL-MaLR	1145	+	132	137001991	73584
chr9	137214576	137414576	harbor1	chr9	137294334	137294568	LTR/ERVL-MaLR	918	+	117	137294451	79875
chr9	133933666	134133666	harbor1	chr9	133952201	133952321	LTR/ERVL-MaLR	554	+	60	133952261	18595
chr9	133933666	134133666	harbor1	chr9	133952621	133952846	LTR/ERVL-MaLR	554	+	112	133952733	19067
chr9	133933666	134133666	harbor1	chr9	133959619	133960002	LTR/ERVL-MaLR	769	+	192	133959811	26145
chr9	133933666	134133666	harbor1	chr9	134007139	134007573	LTR/ERVL-MaLR	1007	+	217	134007356	73690
chr9	123912168	124112168	harbor1	chr9	123959346	123959733	LTR/ERVL-MaLR	904	+	194	123959540	47372
chr9	123912168	124112168	harbor1	chr9	123976656	123977142	LTR/ERVL-MaLR	1331	+	243	123976899	64731
chr9	123912168	124112168	harbor1	chr9	123992019	123992340	LTR/ERVL-MaLR	1360	+	160	123992179	80011
chr9	123912168	124112168	harbor1	chr9	123992669	123992816	LTR/ERVL-MaLR	1360	+	74	123992743	80575
chr9	6658127	6858127	harbor1	chr9	6693342	6693364	LTR/ERVL-MaLR	1185	+	11	6693353	35226
chr9	6658127	6858127	harbor1	chr9	6694507	6694763	LTR/ERVL-MaLR	1185	+	128	6694635	36508
chr9	6658127	6858127	harbor1	chr9	6735396	6735758	LTR/ERVL-MaLR	2170	+	181	6735577	77450
chr9	6658127	6858127	harbor1	chr9	6735760	6736623	LTR/ERVL-MaLR	6538	+	432	6736192	78065
chr9	4692645	4892645	harbor1	chr9	4715795	4716197	LTR/ERVL-MaLR	740	+	201	4715996	23351
chr9	4692645	4892645	harbor1	chr9	4734005	4734371	LTR/ERVL-MaLR	1500	+	183	4734188	41543
chr9	4692645	4892645	harbor1	chr9	4744317	4744746	LTR/ERVL-MaLR	1937	+	214	4744531	51886
chr9	4692645	4892645	harbor1	chr9	4745926	4746431	LTR/ERVL-MaLR	1353	+	252	4746178	53533
chr9	4692645	4892645	harbor1	chr9	4786060	4786364	LTR/ERVL-MaLR	2618	+	152	4786212	93567
chr9	4692645	4892645	harbor1	chr9	4786667	4786739	LTR/ERVL-MaLR	2618	+	36	4786703	94058
chr9	4732434	4932434	harbor1	chr9	4734005	4734371	LTR/ERVL-MaLR	1500	+	183	4734188	1754
chr9	4732434	4932434	harbor1	chr9	4744317	4744746	LTR/ERVL-MaLR	1937	+	214	4744531	12097
chr9	4732434	4932434	harbor1	chr9	4745926	4746431	LTR/ERVL-MaLR	1353	+	252	4746178	13744
chr9	4732434	4932434	harbor1	chr9	4786060	4786364	LTR/ERVL-MaLR	2618	+	152	4786212	53778
chr9	4732434	4932434	harbor1	chr9	4786667	4786739	LTR/ERVL-MaLR	2618	+	36	4786703	54269
chr9	13706365	13906365	harbor1	chr9	13741208	13741669	LTR/ERVL-MaLR	1307	+	230	13741438	35073
chr9	13706365	13906365	harbor1	chr9	13760351	13760822	LTR/ERVL-MaLR	2481	+	236	13760587	54222
chr9	13706365	13906365	harbor1	chr9	13791308	13791537	LTR/ERVL-MaLR	1410	+	114	13791422	85057
chr9	13706365	13906365	harbor1	chr9	13798779	13798919	LTR/ERVL-MaLR	821	+	70	13798849	92484
chr9	13706365	13906365	harbor1	chr9	13713067	13713433	LTR/ERVL-MaLR	2088	+	183	13713250	6885
chr9	133781981	133981981	harbor1	chr9	133801641	133802000	LTR/ERVL-MaLR	543	+	180	133801821	19840
chr9	133781981	133981981	harbor1	chr9	133830304	133830641	LTR/ERVL-MaLR	2000	+	168	133830472	48491
chr9	4663234	4863234	harbor1	chr9	4715795	4716197	LTR/ERVL-MaLR	740	+	201	4715996	52762
chr9	4663234	4863234	harbor1	chr9	4734005	4734371	LTR/ERVL-MaLR	1500	+	183	4734188	70954
chr9	4663234	4863234	harbor1	chr9	4744317	4744746	LTR/ERVL-MaLR	1937	+	214	4744531	81297
chr9	4663234	4863234	harbor1	chr9	4745926	4746431	LTR/ERVL-MaLR	1353	+	252	4746178	82944
chr9	3402772	3602772	harbor1	chr9	3435847	3436014	LTR/ERVL-MaLR	481	+	84	3435931	33159
chr9	135515777	135715777	harbor1	chr9	135586265	135586428	LTR/ERVL-MaLR	508	+	82	135586347	70570
chr9	135515777	135715777	harbor1	chr9	135597751	135598127	LTR/ERVL-MaLR	2415	+	188	135597939	82162
chr9	134035491	134235491	harbor1	chr9	134080893	134081136	LTR/ERVL-MaLR	1501	+	122	134081015	45524
chr9	134035491	134235491	harbor1	chr9	134081433	134081620	LTR/ERVL-MaLR	1347	+	94	134081527	46036
chr9	134035491	134235491	harbor1	chr9	134085385	134085520	LTR/ERVL-MaLR	581	+	68	134085453	49962
chr9	134035491	134235491	harbor1	chr9	134085613	134085982	LTR/ERVL-MaLR	1762	+	184	134085797	50306
chr9	134035491	134235491	harbor1	chr9	134095774	134095856	LTR/ERVL-MaLR	1876	+	41	134095815	60324
chr9	134035491	134235491	harbor1	chr9	134096150	134096428	LTR/ERVL-MaLR	1876	+	139	134096289	60798
chr9	4692834	4892834	harbor1	chr9	4715795	4716197	LTR/ERVL-MaLR	740	+	201	4715996	23162
chr9	4692834	4892834	harbor1	chr9	4734005	4734371	LTR/ERVL-MaLR	1500	+	183	4734188	41354
chr9	4692834	4892834	harbor1	chr9	4744317	4744746	LTR/ERVL-MaLR	1937	+	214	4744531	51697
chr9	4692834	4892834	harbor1	chr9	4745926	4746431	LTR/ERVL-MaLR	1353	+	252	4746178	53344
chr9	4692834	4892834	harbor1	chr9	4786060	4786364	LTR/ERVL-MaLR	2618	+	152	4786212	93378
chr9	4692834	4892834	harbor1	chr9	4786667	4786739	LTR/ERVL-MaLR	2618	+	36	4786703	93869
chr9	4579693	4779693	harbor1	chr9	4657334	4657531	LTR/ERVL-MaLR	921	+	98	4657432	77739
chr9	4579693	4779693	harbor1	chr9	4657968	4658216	LTR/ERVL-MaLR	907	+	124	4658092	78399
chr9	126299347	126499347	harbor1	chr9	126300577	126301067	LTR/ERVL-MaLR	1313	+	245	126300822	1475
chr9	126299347	126499347	harbor1	chr9	126301099	126301422	LTR/ERVL-MaLR	939	+	162	126301261	1914
chr9	126299347	126499347	harbor1	chr9	126309848	126310209	LTR/ERVL-MaLR	1693	+	180	126310028	10681
chr9	126299347	126499347	harbor1	chr9	126356609	126357027	LTR/ERVL-MaLR	2240	+	209	126356818	57471
chr9	133242549	133442549	harbor1	chr9	133260155	133260602	LTR/ERVL-MaLR	686	+	224	133260379	17830
chr9	133242549	133442549	harbor1	chr9	133324805	133325185	LTR/ERVL-MaLR	1279	+	190	133324995	82446
chr9	111561637	111761637	harbor1	chr9	111564724	111564841	LTR/ERVL-MaLR	2190	+	58	111564782	3145
chr9	111561637	111761637	harbor1	chr9	111565135	111565414	LTR/ERVL-MaLR	2190	+	140	111565275	3638
chr9	111561637	111761637	harbor1	chr9	111570391	111570493	LTR/ERVL-MaLR	1588	+	51	111570442	8805
chr9	111561637	111761637	harbor1	chr9	111570803	111571130	LTR/ERVL-MaLR	1588	+	164	111570967	9330
chr9	111561637	111761637	harbor1	chr9	111596153	111596333	LTR/ERVL-MaLR	1092	+	90	111596243	34606
chr9	111561637	111761637	harbor1	chr9	111596955	111597278	LTR/ERVL-MaLR	1092	+	162	111597117	35480
chr9	111561637	111761637	harbor1	chr9	111660180	111660587	LTR/ERVL-MaLR	742	+	204	111660384	98747
chr9	4883815	5083815	harbor1	chr9	4906260	4906423	LTR/ERVL-MaLR	1398	+	82	4906342	22527
chr9	4883815	5083815	harbor1	chr9	4906725	4906961	LTR/ERVL-MaLR	1398	+	118	4906843	23028
chr9	136299655	136499655	harbor1	chr9	136317221	136317580	LTR/ERVL-MaLR	771	+	180	136317401	17746
chr9	109066800	109266800	harbor1	chr9	109099753	109100088	LTR/ERVL-MaLR	1333	+	168	109099921	33121
chr9	109066800	109266800	harbor1	chr9	109127792	109128129	LTR/ERVL-MaLR	1802	+	168	109127960	61160
chr9	109066800	109266800	harbor1	chr9	109128440	109128571	LTR/ERVL-MaLR	1802	+	66	109128506	61706
chr9	109066800	109266800	harbor1	chr9	109165195	109165587	LTR/ERVL-MaLR	836	+	196	109165391	98591
chr9	109066800	109266800	harbor1	chr9	109165589	109166049	LTR/ERVL-MaLR	1442	+	230	109165819	99019
chr9	4692441	4892441	harbor1	chr9	4715795	4716197	LTR/ERVL-MaLR	740	+	201	4715996	23555
chr9	4692441	4892441	harbor1	chr9	4734005	4734371	LTR/ERVL-MaLR	1500	+	183	4734188	41747
chr9	4692441	4892441	harbor1	chr9	4744317	4744746	LTR/ERVL-MaLR	1937	+	214	4744531	52090
chr9	4692441	4892441	harbor1	chr9	4745926	4746431	LTR/ERVL-MaLR	1353	+	252	4746178	53737
chr9	4692441	4892441	harbor1	chr9	4786060	4786364	LTR/ERVL-MaLR	2618	+	152	4786212	93771
chr9	4692441	4892441	harbor1	chr9	4786667	4786739	LTR/ERVL-MaLR	2618	+	36	4786703	94262
chr9	404061	604061	harbor1	chr9	472512	472677	LTR/ERVL-MaLR	573	+	82	472594	68533
chr9	404061	604061	harbor1	chr9	485084	485294	LTR/ERVL-MaLR	940	+	105	485189	81128
chr9	404061	604061	harbor1	chr9	485434	485590	LTR/ERVL-MaLR	940	+	78	485512	81451
chr9	404061	604061	harbor1	chr9	485898	486081	LTR/ERVL-MaLR	940	+	92	485990	81929
chr9	404061	604061	harbor1	chr9	491705	492073	LTR/ERVL-MaLR	2433	+	184	491889	87828
chr9	404061	604061	harbor1	chr9	493080	493554	LTR/ERVL-MaLR	1626	+	237	493317	89256
chr9	404061	604061	harbor1	chr9	493847	493875	LTR/ERVL-MaLR	1626	+	14	493861	89800
chr9	404061	604061	harbor1	chr9	494461	494724	LTR/ERVL-MaLR	822	+	132	494593	90532
chr9	4692933	4892933	harbor1	chr9	4715795	4716197	LTR/ERVL-MaLR	740	+	201	4715996	23063
chr9	4692933	4892933	harbor1	chr9	4734005	4734371	LTR/ERVL-MaLR	1500	+	183	4734188	41255
chr9	4692933	4892933	harbor1	chr9	4744317	4744746	LTR/ERVL-MaLR	1937	+	214	4744531	51598
chr9	4692933	4892933	harbor1	chr9	4745926	4746431	LTR/ERVL-MaLR	1353	+	252	4746178	53245
chr9	4692933	4892933	harbor1	chr9	4786060	4786364	LTR/ERVL-MaLR	2618	+	152	4786212	93279
chr9	4692933	4892933	harbor1	chr9	4786667	4786739	LTR/ERVL-MaLR	2618	+	36	4786703	93770
chr9	135400878	135600878	harbor1	chr9	135410216	135410564	LTR/ERVL-MaLR	1560	+	174	135410390	9512
chr9	135400878	135600878	harbor1	chr9	135415480	135415987	LTR/ERVL-MaLR	612	+	254	135415734	14856
chr9	135400878	135600878	harbor1	chr9	135416491	135416857	LTR/ERVL-MaLR	1699	+	183	135416674	15796
chr9	4885087	5085087	harbor1	chr9	4906260	4906423	LTR/ERVL-MaLR	1398	+	82	4906342	21255
chr9	4885087	5085087	harbor1	chr9	4906725	4906961	LTR/ERVL-MaLR	1398	+	118	4906843	21756
chr9	137143208	137343208	harbor1	chr9	137176073	137176450	LTR/ERVL-MaLR	1150	+	188	137176261	33053
chr9	137143208	137343208	harbor1	chr9	137176451	137177199	LTR/ERVL-MaLR	2017	+	374	137176825	33617
chr9	137143208	137343208	harbor1	chr9	137177237	137177473	LTR/ERVL-MaLR	566	+	118	137177355	34147
chr9	137143208	137343208	harbor1	chr9	137177670	137178066	LTR/ERVL-MaLR	1177	+	198	137177868	34660
chr9	4884787	5084787	harbor1	chr9	4906260	4906423	LTR/ERVL-MaLR	1398	+	82	4906342	21555
chr9	4884787	5084787	harbor1	chr9	4906725	4906961	LTR/ERVL-MaLR	1398	+	118	4906843	22056
chr9	134045916	134245916	harbor1	chr9	134080893	134081136	LTR/ERVL-MaLR	1501	+	122	134081015	35099
chr9	134045916	134245916	harbor1	chr9	134081433	134081620	LTR/ERVL-MaLR	1347	+	94	134081527	35611
chr9	134045916	134245916	harbor1	chr9	134085385	134085520	LTR/ERVL-MaLR	581	+	68	134085453	39537
chr9	134045916	134245916	harbor1	chr9	134085613	134085982	LTR/ERVL-MaLR	1762	+	184	134085797	39881
chr9	134045916	134245916	harbor1	chr9	134095774	134095856	LTR/ERVL-MaLR	1876	+	41	134095815	49899
chr9	134045916	134245916	harbor1	chr9	134096150	134096428	LTR/ERVL-MaLR	1876	+	139	134096289	50373
chr9	4884870	5084870	harbor1	chr9	4906260	4906423	LTR/ERVL-MaLR	1398	+	82	4906342	21472
chr9	4884870	5084870	harbor1	chr9	4906725	4906961	LTR/ERVL-MaLR	1398	+	118	4906843	21973
chr9	4692425	4892425	harbor1	chr9	4715795	4716197	LTR/ERVL-MaLR	740	+	201	4715996	23571
chr9	4692425	4892425	harbor1	chr9	4734005	4734371	LTR/ERVL-MaLR	1500	+	183	4734188	41763
chr9	4692425	4892425	harbor1	chr9	4744317	4744746	LTR/ERVL-MaLR	1937	+	214	4744531	52106
chr9	4692425	4892425	harbor1	chr9	4745926	4746431	LTR/ERVL-MaLR	1353	+	252	4746178	53753
chr9	4692425	4892425	harbor1	chr9	4786060	4786364	LTR/ERVL-MaLR	2618	+	152	4786212	93787
chr9	4692425	4892425	harbor1	chr9	4786667	4786739	LTR/ERVL-MaLR	2618	+	36	4786703	94278
chr9	4884906	5084906	harbor1	chr9	4906260	4906423	LTR/ERVL-MaLR	1398	+	82	4906342	21436
chr9	4884906	5084906	harbor1	chr9	4906725	4906961	LTR/ERVL-MaLR	1398	+	118	4906843	21937
chr9	134029647	134229647	harbor1	chr9	134080893	134081136	LTR/ERVL-MaLR	1501	+	122	134081015	51368
chr9	134029647	134229647	harbor1	chr9	134081433	134081620	LTR/ERVL-MaLR	1347	+	94	134081527	51880
chr9	134029647	134229647	harbor1	chr9	134085385	134085520	LTR/ERVL-MaLR	581	+	68	134085453	55806
chr9	134029647	134229647	harbor1	chr9	134085613	134085982	LTR/ERVL-MaLR	1762	+	184	134085797	56150
chr9	134029647	134229647	harbor1	chr9	134095774	134095856	LTR/ERVL-MaLR	1876	+	41	134095815	66168
chr9	134029647	134229647	harbor1	chr9	134096150	134096428	LTR/ERVL-MaLR	1876	+	139	134096289	66642
chr9	4698187	4898187	harbor1	chr9	4715795	4716197	LTR/ERVL-MaLR	740	+	201	4715996	17809
chr9	4698187	4898187	harbor1	chr9	4734005	4734371	LTR/ERVL-MaLR	1500	+	183	4734188	36001
chr9	4698187	4898187	harbor1	chr9	4744317	4744746	LTR/ERVL-MaLR	1937	+	214	4744531	46344
chr9	4698187	4898187	harbor1	chr9	4745926	4746431	LTR/ERVL-MaLR	1353	+	252	4746178	47991
chr9	4698187	4898187	harbor1	chr9	4786060	4786364	LTR/ERVL-MaLR	2618	+	152	4786212	88025
chr9	4698187	4898187	harbor1	chr9	4786667	4786739	LTR/ERVL-MaLR	2618	+	36	4786703	88516
chr9	4729109	4929109	harbor1	chr9	4734005	4734371	LTR/ERVL-MaLR	1500	+	183	4734188	5079
chr9	4729109	4929109	harbor1	chr9	4744317	4744746	LTR/ERVL-MaLR	1937	+	214	4744531	15422
chr9	4729109	4929109	harbor1	chr9	4745926	4746431	LTR/ERVL-MaLR	1353	+	252	4746178	17069
chr9	4729109	4929109	harbor1	chr9	4786060	4786364	LTR/ERVL-MaLR	2618	+	152	4786212	57103
chr9	4729109	4929109	harbor1	chr9	4786667	4786739	LTR/ERVL-MaLR	2618	+	36	4786703	57594
chr9	135593627	135793627	harbor1	chr9	135597751	135598127	LTR/ERVL-MaLR	2415	+	188	135597939	4312
chr9	135593627	135793627	harbor1	chr9	135669007	135669365	LTR/ERVL-MaLR	2396	+	179	135669186	75559
chr9	135593627	135793627	harbor1	chr9	135689928	135690296	LTR/ERVL-MaLR	2380	+	184	135690112	96485
chr9	135593627	135793627	harbor1	chr9	135691814	135692206	LTR/ERVL-MaLR	2070	+	196	135692010	98383
chr9	108349474	108549474	harbor1	chr9	108353993	108354383	LTR/ERVL-MaLR	1413	+	195	108354188	4714
chr9	108349474	108549474	harbor1	chr9	108360798	108360955	LTR/ERVL-MaLR	819	+	78	108360876	11402
chr9	108349474	108549474	harbor1	chr9	108362296	108362512	LTR/ERVL-MaLR	1067	+	108	108362404	12930
chr9	108349474	108549474	harbor1	chr9	108366910	108367287	LTR/ERVL-MaLR	2126	+	188	108367098	17624
chr9	108349474	108549474	harbor1	chr9	108379217	108379561	LTR/ERVL-MaLR	1800	+	172	108379389	29915
chr9	108349474	108549474	harbor1	chr9	108419741	108420144	LTR/ERVL-MaLR	2094	+	202	108419943	70469
chr9	108349474	108549474	harbor1	chr9	108438811	108439279	LTR/ERVL-MaLR	1988	+	234	108439045	89571
chr9	4215856	4415856	harbor1	chr9	4271474	4271723	LTR/ERVL-MaLR	550	+	124	4271598	55742
chr9	4215856	4415856	harbor1	chr9	4307504	4307987	LTR/ERVL-MaLR	1388	+	242	4307746	91890
chr9	4694447	4894447	harbor1	chr9	4715795	4716197	LTR/ERVL-MaLR	740	+	201	4715996	21549
chr9	4694447	4894447	harbor1	chr9	4734005	4734371	LTR/ERVL-MaLR	1500	+	183	4734188	39741
chr9	4694447	4894447	harbor1	chr9	4744317	4744746	LTR/ERVL-MaLR	1937	+	214	4744531	50084
chr9	4694447	4894447	harbor1	chr9	4745926	4746431	LTR/ERVL-MaLR	1353	+	252	4746178	51731
chr9	4694447	4894447	harbor1	chr9	4786060	4786364	LTR/ERVL-MaLR	2618	+	152	4786212	91765
chr9	4694447	4894447	harbor1	chr9	4786667	4786739	LTR/ERVL-MaLR	2618	+	36	4786703	92256
chr9	92958957	93158957	harbor1	chr9	93001827	93002090	LTR/ERVL-MaLR	551	+	132	93001959	43002
chr9	92958957	93158957	harbor1	chr9	93043402	93043463	LTR/ERVL-MaLR	899	+	30	93043432	84475
chr9	92958957	93158957	harbor1	chr9	93043774	93043992	LTR/ERVL-MaLR	899	+	109	93043883	84926
chr9	92958957	93158957	harbor1	chr9	93044020	93044237	LTR/ERVL-MaLR	980	+	108	93044128	85171
chr9	92958957	93158957	harbor1	chr9	93044534	93044574	LTR/ERVL-MaLR	980	+	20	93044554	85597
chr9	92958957	93158957	harbor1	chr9	93045119	93045280	LTR/ERVL-MaLR	2558	+	80	93045199	86242
chr9	92958957	93158957	harbor1	chr9	93045586	93046032	LTR/ERVL-MaLR	2558	+	223	93045809	86852
chr9	92958957	93158957	harbor1	chr9	93046344	93046516	LTR/ERVL-MaLR	2558	+	86	93046430	87473
chr9	92958957	93158957	harbor1	chr9	93046923	93047154	LTR/ERVL-MaLR	696	+	116	93047039	88082
chr9	92958957	93158957	harbor1	chr9	93056398	93056497	LTR/ERVL-MaLR	1549	+	50	93056448	97491
chr9	92958957	93158957	harbor1	chr9	93056803	93057136	LTR/ERVL-MaLR	1549	+	166	93056969	98012
chr10	132232384	132432384	harbor1	chr10	132259308	132259770	LTR/ERVL-MaLR	1925	+	231	132259539	27155
chr10	132232384	132432384	harbor1	chr10	132270159	132270510	LTR/ERVL-MaLR	839	+	176	132270335	37951
chr10	132232384	132432384	harbor1	chr10	132272068	132272391	LTR/ERVL-MaLR	1115	+	162	132272230	39846
chr10	132232384	132432384	harbor1	chr10	132298694	132299003	LTR/ERVL-MaLR	889	+	154	132298848	66464
chr10	132232384	132432384	harbor1	chr10	132299625	132299768	LTR/ERVL-MaLR	469	+	72	132299697	67313
chr10	132232384	132432384	harbor1	chr10	132325101	132325270	LTR/ERVL-MaLR	2074	+	84	132325185	92801
chr10	132232384	132432384	harbor1	chr10	132325565	132325722	LTR/ERVL-MaLR	2074	+	78	132325643	93259
chr10	132232384	132432384	harbor1	chr10	132326015	132326056	LTR/ERVL-MaLR	2074	+	20	132326035	93651
chr10	132232384	132432384	harbor1	chr10	132327070	132327419	LTR/ERVL-MaLR	2287	+	174	132327244	94860
chr10	132232398	132432398	harbor1	chr10	132259308	132259770	LTR/ERVL-MaLR	1925	+	231	132259539	27141
chr10	132232398	132432398	harbor1	chr10	132270159	132270510	LTR/ERVL-MaLR	839	+	176	132270335	37937
chr10	132232398	132432398	harbor1	chr10	132272068	132272391	LTR/ERVL-MaLR	1115	+	162	132272230	39832
chr10	132232398	132432398	harbor1	chr10	132298694	132299003	LTR/ERVL-MaLR	889	+	154	132298848	66450
chr10	132232398	132432398	harbor1	chr10	132299625	132299768	LTR/ERVL-MaLR	469	+	72	132299697	67299
chr10	132232398	132432398	harbor1	chr10	132325101	132325270	LTR/ERVL-MaLR	2074	+	84	132325185	92787
chr10	132232398	132432398	harbor1	chr10	132325565	132325722	LTR/ERVL-MaLR	2074	+	78	132325643	93245
chr10	132232398	132432398	harbor1	chr10	132326015	132326056	LTR/ERVL-MaLR	2074	+	20	132326035	93637
chr10	132232398	132432398	harbor1	chr10	132327070	132327419	LTR/ERVL-MaLR	2287	+	174	132327244	94846
chr10	48449566	48649566	harbor1	chr10	48468207	48468665	LTR/ERVL-MaLR	1453	+	229	48468436	18870
chr10	48449566	48649566	harbor1	chr10	48487267	48487786	LTR/ERVL-MaLR	1877	+	260	48487527	37961
chr10	48449566	48649566	harbor1	chr10	48488066	48488106	LTR/ERVL-MaLR	1877	+	20	48488086	38520
chr10	48449566	48649566	harbor1	chr10	48495604	48496171	LTR/ERVL-MaLR	2287	+	284	48495888	46322
chr10	48449566	48649566	harbor1	chr10	48528603	48529034	LTR/ERVL-MaLR	2254	+	216	48528819	79253
chr10	48449566	48649566	harbor1	chr10	48529302	48529732	LTR/ERVL-MaLR	763	+	215	48529517	79951
chr10	102033038	102233038	harbor1	chr10	102079770	102079912	LTR/ERVL-MaLR	1441	+	71	102079841	46803
chr10	102033038	102233038	harbor1	chr10	102080531	102080837	LTR/ERVL-MaLR	1441	+	153	102080684	47646
chr10	14778680	14978680	harbor1	chr10	14780370	14780606	LTR/ERVL-MaLR	472	+	118	14780488	1808
chr10	14778680	14978680	harbor1	chr10	14792310	14792484	LTR/ERVL-MaLR	795	+	87	14792397	13717
chr10	14778680	14978680	harbor1	chr10	14795758	14795917	LTR/ERVL-MaLR	708	+	80	14795838	17158
chr10	14778680	14978680	harbor1	chr10	14815387	14815585	LTR/ERVL-MaLR	597	+	99	14815486	36806
chr10	14778680	14978680	harbor1	chr10	14820774	14821121	LTR/ERVL-MaLR	2158	+	174	14820948	42268
chr10	14778680	14978680	harbor1	chr10	14821424	14821461	LTR/ERVL-MaLR	2158	+	18	14821442	42762
chr10	14778680	14978680	harbor1	chr10	14863815	14864058	LTR/ERVL-MaLR	470	+	122	14863937	85257
chr10	122404718	122604718	harbor1	chr10	122481667	122482021	LTR/ERVL-MaLR	2327	+	177	122481844	77126
chr10	14778677	14978677	harbor1	chr10	14780370	14780606	LTR/ERVL-MaLR	472	+	118	14780488	1811
chr10	14778677	14978677	harbor1	chr10	14792310	14792484	LTR/ERVL-MaLR	795	+	87	14792397	13720
chr10	14778677	14978677	harbor1	chr10	14795758	14795917	LTR/ERVL-MaLR	708	+	80	14795838	17161
chr10	14778677	14978677	harbor1	chr10	14815387	14815585	LTR/ERVL-MaLR	597	+	99	14815486	36809
chr10	14778677	14978677	harbor1	chr10	14820774	14821121	LTR/ERVL-MaLR	2158	+	174	14820948	42271
chr10	14778677	14978677	harbor1	chr10	14821424	14821461	LTR/ERVL-MaLR	2158	+	18	14821442	42765
chr10	14778677	14978677	harbor1	chr10	14863815	14864058	LTR/ERVL-MaLR	470	+	122	14863937	85260
chr10	75309886	75509886	harbor1	chr10	75311744	75311816	LTR/ERVL-MaLR	599	+	36	75311780	1894
chr10	75309886	75509886	harbor1	chr10	75312801	75313149	LTR/ERVL-MaLR	2297	+	174	75312975	3089
chr10	75309886	75509886	harbor1	chr10	75320941	75321345	LTR/ERVL-MaLR	2440	+	202	75321143	11257
chr10	75309886	75509886	harbor1	chr10	75321347	75321930	LTR/ERVL-MaLR	3358	+	292	75321639	11753
chr10	75309886	75509886	harbor1	chr10	75359525	75359890	LTR/ERVL-MaLR	893	+	182	75359707	49821
chr10	75309886	75509886	harbor1	chr10	75369278	75369650	LTR/ERVL-MaLR	2392	+	186	75369464	59578
chr10	75309886	75509886	harbor1	chr10	75381029	75381209	LTR/ERVL-MaLR	1138	+	90	75381119	71233
chr10	75309886	75509886	harbor1	chr10	75381523	75381717	LTR/ERVL-MaLR	1138	+	97	75381620	71734
chr10	75309886	75509886	harbor1	chr10	75390727	75390777	LTR/ERVL-MaLR	1063	+	25	75390752	80866
chr10	75309886	75509886	harbor1	chr10	75391154	75391579	LTR/ERVL-MaLR	1063	+	212	75391366	81480
chr10	103547893	103747893	harbor1	chr10	103608243	103608415	LTR/ERVL-MaLR	698	+	86	103608329	60436
chr10	14778676	14978676	harbor1	chr10	14780370	14780606	LTR/ERVL-MaLR	472	+	118	14780488	1812
chr10	14778676	14978676	harbor1	chr10	14792310	14792484	LTR/ERVL-MaLR	795	+	87	14792397	13721
chr10	14778676	14978676	harbor1	chr10	14795758	14795917	LTR/ERVL-MaLR	708	+	80	14795838	17162
chr10	14778676	14978676	harbor1	chr10	14815387	14815585	LTR/ERVL-MaLR	597	+	99	14815486	36810
chr10	14778676	14978676	harbor1	chr10	14820774	14821121	LTR/ERVL-MaLR	2158	+	174	14820948	42272
chr10	14778676	14978676	harbor1	chr10	14821424	14821461	LTR/ERVL-MaLR	2158	+	18	14821442	42766
chr10	14778676	14978676	harbor1	chr10	14863815	14864058	LTR/ERVL-MaLR	470	+	122	14863937	85261
chr10	97721885	97921885	harbor1	chr10	97731349	97731799	LTR/ERVL-MaLR	1737	+	225	97731574	9689
chr10	97721885	97921885	harbor1	chr10	97810425	97810964	LTR/ERVL-MaLR	1045	+	270	97810695	88810
chr10	14771563	14971563	harbor1	chr10	14780370	14780606	LTR/ERVL-MaLR	472	+	118	14780488	8925
chr10	14771563	14971563	harbor1	chr10	14792310	14792484	LTR/ERVL-MaLR	795	+	87	14792397	20834
chr10	14771563	14971563	harbor1	chr10	14795758	14795917	LTR/ERVL-MaLR	708	+	80	14795838	24275
chr10	14771563	14971563	harbor1	chr10	14815387	14815585	LTR/ERVL-MaLR	597	+	99	14815486	43923
chr10	14771563	14971563	harbor1	chr10	14820774	14821121	LTR/ERVL-MaLR	2158	+	174	14820948	49385
chr10	14771563	14971563	harbor1	chr10	14821424	14821461	LTR/ERVL-MaLR	2158	+	18	14821442	49879
chr10	14771563	14971563	harbor1	chr10	14863815	14864058	LTR/ERVL-MaLR	470	+	122	14863937	92374
chr10	95979828	96179828	harbor1	chr10	95996782	95997164	LTR/ERVL-MaLR	1559	+	191	95996973	17145
chr10	95979828	96179828	harbor1	chr10	96075995	96076179	LTR/ERVL-MaLR	791	+	92	96076087	96259
chr10	95979828	96179828	harbor1	chr10	96076467	96076841	LTR/ERVL-MaLR	791	+	187	96076654	96826
chr10	22336855	22536855	harbor1	chr10	22376661	22376802	LTR/ERVL-MaLR	1509	+	70	22376731	39876
chr10	22336855	22536855	harbor1	chr10	22377081	22377447	LTR/ERVL-MaLR	1509	+	183	22377264	40409
chr10	22336855	22536855	harbor1	chr10	22379288	22379763	LTR/ERVL-MaLR	1202	+	238	22379526	42671
chr10	22336855	22536855	harbor1	chr10	22396165	22396518	LTR/ERVL-MaLR	2204	+	176	22396341	59486
chr10	14755514	14955514	harbor1	chr10	14780370	14780606	LTR/ERVL-MaLR	472	+	118	14780488	24974
chr10	14755514	14955514	harbor1	chr10	14792310	14792484	LTR/ERVL-MaLR	795	+	87	14792397	36883
chr10	14755514	14955514	harbor1	chr10	14795758	14795917	LTR/ERVL-MaLR	708	+	80	14795838	40324
chr10	14755514	14955514	harbor1	chr10	14815387	14815585	LTR/ERVL-MaLR	597	+	99	14815486	59972
chr10	14755514	14955514	harbor1	chr10	14820774	14821121	LTR/ERVL-MaLR	2158	+	174	14820948	65434
chr10	14755514	14955514	harbor1	chr10	14821424	14821461	LTR/ERVL-MaLR	2158	+	18	14821442	65928
chr10	132202571	132402571	harbor1	chr10	132215327	132215686	LTR/ERVL-MaLR	2681	+	180	132215507	12936
chr10	132202571	132402571	harbor1	chr10	132215687	132216182	LTR/ERVL-MaLR	11945	+	248	132215935	13364
chr10	132202571	132402571	harbor1	chr10	132216498	132217560	LTR/ERVL-MaLR	11945	+	531	132217029	14458
chr10	132202571	132402571	harbor1	chr10	132217561	132217926	LTR/ERVL-MaLR	2519	+	182	132217743	15172
chr10	132202571	132402571	harbor1	chr10	132220035	132220420	LTR/ERVL-MaLR	1076	+	192	132220227	17656
chr10	132202571	132402571	harbor1	chr10	132231586	132232003	LTR/ERVL-MaLR	612	+	208	132231794	29223
chr10	132202571	132402571	harbor1	chr10	132259308	132259770	LTR/ERVL-MaLR	1925	+	231	132259539	56968
chr10	132202571	132402571	harbor1	chr10	132270159	132270510	LTR/ERVL-MaLR	839	+	176	132270335	67764
chr10	132202571	132402571	harbor1	chr10	132272068	132272391	LTR/ERVL-MaLR	1115	+	162	132272230	69659
chr10	132202571	132402571	harbor1	chr10	132298694	132299003	LTR/ERVL-MaLR	889	+	154	132298848	96277
chr10	132202571	132402571	harbor1	chr10	132299625	132299768	LTR/ERVL-MaLR	469	+	72	132299697	97126
chr10	132642062	132842062	harbor1	chr10	132672337	132672692	LTR/ERVL-MaLR	2261	+	178	132672515	30453
chr10	132642062	132842062	harbor1	chr10	132695887	132696220	LTR/ERVL-MaLR	1330	+	166	132696053	53991
chr10	97672098	97872098	harbor1	chr10	97731349	97731799	LTR/ERVL-MaLR	1737	+	225	97731574	59476
chr10	122401188	122601188	harbor1	chr10	122481667	122482021	LTR/ERVL-MaLR	2327	+	177	122481844	80656
chr10	97672148	97872148	harbor1	chr10	97731349	97731799	LTR/ERVL-MaLR	1737	+	225	97731574	59426
chr10	23339297	23539297	harbor1	chr10	23343158	23343521	LTR/ERVL-MaLR	1629	+	182	23343340	4043
chr10	23339297	23539297	harbor1	chr10	23361611	23362035	LTR/ERVL-MaLR	2422	+	212	23361823	22526
chr10	23339297	23539297	harbor1	chr10	23424882	23425395	LTR/ERVL-MaLR	1666	+	256	23425138	85841
chr10	122404812	122604812	harbor1	chr10	122481667	122482021	LTR/ERVL-MaLR	2327	+	177	122481844	77032
chr10	15216571	15416571	harbor1	chr10	15224481	15224839	LTR/ERVL-MaLR	2601	+	179	15224660	8089
chr10	15216571	15416571	harbor1	chr10	15247476	15247662	LTR/ERVL-MaLR	574	+	93	15247569	30998
chr10	15216571	15416571	harbor1	chr10	15247790	15248140	LTR/ERVL-MaLR	1354	+	175	15247965	31394
chr10	15216571	15416571	harbor1	chr10	15280919	15281324	LTR/ERVL-MaLR	2497	+	202	15281121	64550
chr10	130648147	130848147	harbor1	chr10	130670361	130670702	LTR/ERVL-MaLR	1655	+	170	130670531	22384
chr10	130648147	130848147	harbor1	chr10	130679552	130679961	LTR/ERVL-MaLR	2290	+	204	130679756	31609
chr10	130648147	130848147	harbor1	chr10	130688458	130688748	LTR/ERVL-MaLR	764	+	145	130688603	40456
chr10	130648147	130848147	harbor1	chr10	130688881	130689143	LTR/ERVL-MaLR	854	+	131	130689012	40865
chr10	130648147	130848147	harbor1	chr10	130693489	130693874	LTR/ERVL-MaLR	1895	+	192	130693681	45534
chr10	130648147	130848147	harbor1	chr10	130704401	130704792	LTR/ERVL-MaLR	1550	+	196	130704597	56450
chr10	130648147	130848147	harbor1	chr10	130704801	130705229	LTR/ERVL-MaLR	1418	+	214	130705015	56868
chr10	130648147	130848147	harbor1	chr10	130705347	130706483	LTR/ERVL-MaLR	1563	+	568	130705915	57768
chr10	130648147	130848147	harbor1	chr10	130706519	130706869	LTR/ERVL-MaLR	1178	+	175	130706694	58547
chr10	130648147	130848147	harbor1	chr10	130719468	130719716	LTR/ERVL-MaLR	838	+	124	130719592	71445
chr10	130648147	130848147	harbor1	chr10	130733303	130733427	LTR/ERVL-MaLR	476	+	62	130733365	85218
chr10	130648147	130848147	harbor1	chr10	130738662	130739058	LTR/ERVL-MaLR	1945	+	198	130738860	90713
chr10	102033035	102233035	harbor1	chr10	102079770	102079912	LTR/ERVL-MaLR	1441	+	71	102079841	46806
chr10	102033035	102233035	harbor1	chr10	102080531	102080837	LTR/ERVL-MaLR	1441	+	153	102080684	47649
chr10	101115534	101315534	harbor1	chr10	101166767	101166910	LTR/ERVL-MaLR	580	+	72	101166839	51305
chr10	101115534	101315534	harbor1	chr10	101178810	101178936	LTR/ERVL-MaLR	483	+	63	101178873	63339
chr10	101115534	101315534	harbor1	chr10	101201617	101201770	LTR/ERVL-MaLR	2232	+	76	101201693	86159
chr10	101115534	101315534	harbor1	chr10	101202055	101202292	LTR/ERVL-MaLR	2232	+	118	101202173	86639
chr10	101115534	101315534	harbor1	chr10	101209030	101209319	LTR/ERVL-MaLR	939	+	144	101209174	93640
chr10	92431311	92631311	harbor1	chr10	92483684	92484129	LTR/ERVL-MaLR	1822	+	222	92483906	52595
chr10	75111011	75311011	harbor1	chr10	75140502	75140676	LTR/ERVL-MaLR	693	+	87	75140589	29578
chr10	75111011	75311011	harbor1	chr10	75202958	75203281	LTR/ERVL-MaLR	1253	+	162	75203120	92109
chr10	75111011	75311011	harbor1	chr10	75203635	75204152	LTR/ERVL-MaLR	2484	+	258	75203893	92882
chr10	101965759	102165759	harbor1	chr10	101977560	101977988	LTR/ERVL-MaLR	2234	+	214	101977774	12015
chr10	101965759	102165759	harbor1	chr10	101987525	101987858	LTR/ERVL-MaLR	1099	+	166	101987691	21932
chr10	101965759	102165759	harbor1	chr10	101988011	101988156	LTR/ERVL-MaLR	827	+	72	101988083	22324
chr10	4608518	4808518	harbor1	chr10	4676224	4676492	LTR/ERVL-MaLR	881	+	134	4676358	67840
chr10	4608518	4808518	harbor1	chr10	4676523	4676944	LTR/ERVL-MaLR	1034	+	210	4676733	68215
chr10	4608518	4808518	harbor1	chr10	4693867	4694246	LTR/ERVL-MaLR	1021	+	190	4694057	85539
chr10	4608518	4808518	harbor1	chr10	4694561	4694977	LTR/ERVL-MaLR	1841	+	208	4694769	86251
chr10	14701889	14901889	harbor1	chr10	14740804	14740952	LTR/ERVL-MaLR	612	+	74	14740878	38989
chr10	14701889	14901889	harbor1	chr10	14748320	14748813	LTR/ERVL-MaLR	500	+	246	14748566	46677
chr10	14701889	14901889	harbor1	chr10	14780370	14780606	LTR/ERVL-MaLR	472	+	118	14780488	78599
chr10	14701889	14901889	harbor1	chr10	14792310	14792484	LTR/ERVL-MaLR	795	+	87	14792397	90508
chr10	14701889	14901889	harbor1	chr10	14795758	14795917	LTR/ERVL-MaLR	708	+	80	14795838	93949
chr10	132232394	132432394	harbor1	chr10	132259308	132259770	LTR/ERVL-MaLR	1925	+	231	132259539	27145
chr10	132232394	132432394	harbor1	chr10	132270159	132270510	LTR/ERVL-MaLR	839	+	176	132270335	37941
chr10	132232394	132432394	harbor1	chr10	132272068	132272391	LTR/ERVL-MaLR	1115	+	162	132272230	39836
chr10	132232394	132432394	harbor1	chr10	132298694	132299003	LTR/ERVL-MaLR	889	+	154	132298848	66454
chr10	132232394	132432394	harbor1	chr10	132299625	132299768	LTR/ERVL-MaLR	469	+	72	132299697	67303
chr10	132232394	132432394	harbor1	chr10	132325101	132325270	LTR/ERVL-MaLR	2074	+	84	132325185	92791
chr10	132232394	132432394	harbor1	chr10	132325565	132325722	LTR/ERVL-MaLR	2074	+	78	132325643	93249
chr10	132232394	132432394	harbor1	chr10	132326015	132326056	LTR/ERVL-MaLR	2074	+	20	132326035	93641
chr10	132232394	132432394	harbor1	chr10	132327070	132327419	LTR/ERVL-MaLR	2287	+	174	132327244	94850
chr10	130532945	130732945	harbor1	chr10	130549259	130549591	LTR/ERVL-MaLR	1511	+	166	130549425	16480
chr10	130532945	130732945	harbor1	chr10	130556851	130556975	LTR/ERVL-MaLR	1988	+	62	130556913	23968
chr10	130532945	130732945	harbor1	chr10	130557015	130557281	LTR/ERVL-MaLR	1988	+	133	130557148	24203
chr10	22337048	22537048	harbor1	chr10	22376661	22376802	LTR/ERVL-MaLR	1509	+	70	22376731	39683
chr10	22337048	22537048	harbor1	chr10	22377081	22377447	LTR/ERVL-MaLR	1509	+	183	22377264	40216
chr10	22337048	22537048	harbor1	chr10	22379288	22379763	LTR/ERVL-MaLR	1202	+	238	22379526	42478
chr10	22337048	22537048	harbor1	chr10	22396165	22396518	LTR/ERVL-MaLR	2204	+	176	22396341	59293
chr10	69472321	69672321	harbor1	chr10	69541248	69541356	LTR/ERVL-MaLR	642	+	54	69541302	68981
chr10	69472321	69672321	harbor1	chr10	69563577	69563981	LTR/ERVL-MaLR	1663	+	202	69563779	91458
chr10	69472321	69672321	harbor1	chr10	69565614	69565898	LTR/ERVL-MaLR	508	+	142	69565756	93435
chr10	122063803	122263803	harbor1	chr10	122126848	122127220	LTR/ERVL-MaLR	2338	+	186	122127034	63231
chr10	122063803	122263803	harbor1	chr10	122146345	122146761	LTR/ERVL-MaLR	2913	+	208	122146553	82750
chr10	100678605	100878605	harbor1	chr10	100695038	100695510	LTR/ERVL-MaLR	931	+	236	100695274	16669
chr10	100678605	100878605	harbor1	chr10	100696645	100697004	LTR/ERVL-MaLR	1300	+	180	100696825	18220
chr10	100678605	100878605	harbor1	chr10	100699432	100699889	LTR/ERVL-MaLR	1581	+	228	100699660	21055
chr10	100678605	100878605	harbor1	chr10	100717480	100717772	LTR/ERVL-MaLR	1135	+	146	100717626	39021
chr10	100678605	100878605	harbor1	chr10	100718200	100718343	LTR/ERVL-MaLR	816	+	72	100718272	39667
chr10	132206329	132406329	harbor1	chr10	132215327	132215686	LTR/ERVL-MaLR	2681	+	180	132215507	9178
chr10	132206329	132406329	harbor1	chr10	132215687	132216182	LTR/ERVL-MaLR	11945	+	248	132215935	9606
chr10	132206329	132406329	harbor1	chr10	132216498	132217560	LTR/ERVL-MaLR	11945	+	531	132217029	10700
chr10	132206329	132406329	harbor1	chr10	132217561	132217926	LTR/ERVL-MaLR	2519	+	182	132217743	11414
chr10	132206329	132406329	harbor1	chr10	132220035	132220420	LTR/ERVL-MaLR	1076	+	192	132220227	13898
chr10	132206329	132406329	harbor1	chr10	132231586	132232003	LTR/ERVL-MaLR	612	+	208	132231794	25465
chr10	132206329	132406329	harbor1	chr10	132259308	132259770	LTR/ERVL-MaLR	1925	+	231	132259539	53210
chr10	132206329	132406329	harbor1	chr10	132270159	132270510	LTR/ERVL-MaLR	839	+	176	132270335	64006
chr10	132206329	132406329	harbor1	chr10	132272068	132272391	LTR/ERVL-MaLR	1115	+	162	132272230	65901
chr10	132206329	132406329	harbor1	chr10	132298694	132299003	LTR/ERVL-MaLR	889	+	154	132298848	92519
chr10	132206329	132406329	harbor1	chr10	132299625	132299768	LTR/ERVL-MaLR	469	+	72	132299697	93368
chr10	23099346	23299346	harbor1	chr10	23113559	23113966	LTR/ERVL-MaLR	1527	+	204	23113763	14417
chr10	23099346	23299346	harbor1	chr10	23139792	23140167	LTR/ERVL-MaLR	2161	+	188	23139980	40634
chr10	23099346	23299346	harbor1	chr10	23155775	23156300	LTR/ERVL-MaLR	2009	+	262	23156037	56691
chr10	23099346	23299346	harbor1	chr10	23164792	23165212	LTR/ERVL-MaLR	1265	+	210	23165002	65656
chr10	23099346	23299346	harbor1	chr10	23181186	23181369	LTR/ERVL-MaLR	741	+	92	23181278	81932
chr10	23099346	23299346	harbor1	chr10	23181395	23181553	LTR/ERVL-MaLR	741	+	79	23181474	82128
chr10	14778721	14978721	harbor1	chr10	14780370	14780606	LTR/ERVL-MaLR	472	+	118	14780488	1767
chr10	14778721	14978721	harbor1	chr10	14792310	14792484	LTR/ERVL-MaLR	795	+	87	14792397	13676
chr10	14778721	14978721	harbor1	chr10	14795758	14795917	LTR/ERVL-MaLR	708	+	80	14795838	17117
chr10	14778721	14978721	harbor1	chr10	14815387	14815585	LTR/ERVL-MaLR	597	+	99	14815486	36765
chr10	14778721	14978721	harbor1	chr10	14820774	14821121	LTR/ERVL-MaLR	2158	+	174	14820948	42227
chr10	14778721	14978721	harbor1	chr10	14821424	14821461	LTR/ERVL-MaLR	2158	+	18	14821442	42721
chr10	14778721	14978721	harbor1	chr10	14863815	14864058	LTR/ERVL-MaLR	470	+	122	14863937	85216
chr10	75111017	75311017	harbor1	chr10	75140502	75140676	LTR/ERVL-MaLR	693	+	87	75140589	29572
chr10	75111017	75311017	harbor1	chr10	75202958	75203281	LTR/ERVL-MaLR	1253	+	162	75203120	92103
chr10	75111017	75311017	harbor1	chr10	75203635	75204152	LTR/ERVL-MaLR	2484	+	258	75203893	92876
chr10	132232388	132432388	harbor1	chr10	132259308	132259770	LTR/ERVL-MaLR	1925	+	231	132259539	27151
chr10	132232388	132432388	harbor1	chr10	132270159	132270510	LTR/ERVL-MaLR	839	+	176	132270335	37947
chr10	132232388	132432388	harbor1	chr10	132272068	132272391	LTR/ERVL-MaLR	1115	+	162	132272230	39842
chr10	132232388	132432388	harbor1	chr10	132298694	132299003	LTR/ERVL-MaLR	889	+	154	132298848	66460
chr10	132232388	132432388	harbor1	chr10	132299625	132299768	LTR/ERVL-MaLR	469	+	72	132299697	67309
chr10	132232388	132432388	harbor1	chr10	132325101	132325270	LTR/ERVL-MaLR	2074	+	84	132325185	92797
chr10	132232388	132432388	harbor1	chr10	132325565	132325722	LTR/ERVL-MaLR	2074	+	78	132325643	93255
chr10	132232388	132432388	harbor1	chr10	132326015	132326056	LTR/ERVL-MaLR	2074	+	20	132326035	93647
chr10	132232388	132432388	harbor1	chr10	132327070	132327419	LTR/ERVL-MaLR	2287	+	174	132327244	94856
chr10	43005639	43205639	harbor1	chr10	43009719	43011355	LTR/ERVL-MaLR	5176	+	818	43010537	4898
chr10	43005639	43205639	harbor1	chr10	43011433	43011778	LTR/ERVL-MaLR	1861	+	172	43011605	5966
chr10	43005639	43205639	harbor1	chr10	43016091	43016445	LTR/ERVL-MaLR	2502	+	177	43016268	10629
chr10	43005639	43205639	harbor1	chr10	43046224	43046706	LTR/ERVL-MaLR	487	+	241	43046465	40826
chr10	43005639	43205639	harbor1	chr10	43062534	43062798	LTR/ERVL-MaLR	508	+	132	43062666	57027
chr10	43005639	43205639	harbor1	chr10	43024211	43024572	LTR/ERVL-MaLR	1418	+	180	43024391	18752
chr10	4382921	4582921	harbor1	chr10	4400201	4400470	LTR/ERVL-MaLR	1943	+	134	4400335	17414
chr10	4382921	4582921	harbor1	chr10	4426072	4426478	LTR/ERVL-MaLR	2316	+	203	4426275	43354
chr10	4382921	4582921	harbor1	chr10	4444731	4445099	LTR/ERVL-MaLR	2040	+	184	4444915	61994
chr10	4382921	4582921	harbor1	chr10	4454702	4454966	LTR/ERVL-MaLR	1576	+	132	4454834	71913
chr10	4382921	4582921	harbor1	chr10	4468436	4468771	LTR/ERVL-MaLR	1174	+	168	4468604	85683
chr10	4382921	4582921	harbor1	chr10	4472583	4472783	LTR/ERVL-MaLR	670	+	100	4472683	89762
chr10	23339295	23539295	harbor1	chr10	23343158	23343521	LTR/ERVL-MaLR	1629	+	182	23343340	4045
chr10	23339295	23539295	harbor1	chr10	23361611	23362035	LTR/ERVL-MaLR	2422	+	212	23361823	22528
chr10	23339295	23539295	harbor1	chr10	23424882	23425395	LTR/ERVL-MaLR	1666	+	256	23425138	85843
chr10	14778699	14978699	harbor1	chr10	14780370	14780606	LTR/ERVL-MaLR	472	+	118	14780488	1789
chr10	14778699	14978699	harbor1	chr10	14792310	14792484	LTR/ERVL-MaLR	795	+	87	14792397	13698
chr10	14778699	14978699	harbor1	chr10	14795758	14795917	LTR/ERVL-MaLR	708	+	80	14795838	17139
chr10	14778699	14978699	harbor1	chr10	14815387	14815585	LTR/ERVL-MaLR	597	+	99	14815486	36787
chr10	14778699	14978699	harbor1	chr10	14820774	14821121	LTR/ERVL-MaLR	2158	+	174	14820948	42249
chr10	14778699	14978699	harbor1	chr10	14821424	14821461	LTR/ERVL-MaLR	2158	+	18	14821442	42743
chr10	14778699	14978699	harbor1	chr10	14863815	14864058	LTR/ERVL-MaLR	470	+	122	14863937	85238
chr10	43004161	43204161	harbor1	chr10	43009719	43011355	LTR/ERVL-MaLR	5176	+	818	43010537	6376
chr10	43004161	43204161	harbor1	chr10	43011433	43011778	LTR/ERVL-MaLR	1861	+	172	43011605	7444
chr10	43004161	43204161	harbor1	chr10	43016091	43016445	LTR/ERVL-MaLR	2502	+	177	43016268	12107
chr10	43004161	43204161	harbor1	chr10	43046224	43046706	LTR/ERVL-MaLR	487	+	241	43046465	42304
chr10	43004161	43204161	harbor1	chr10	43062534	43062798	LTR/ERVL-MaLR	508	+	132	43062666	58505
chr10	43004161	43204161	harbor1	chr10	43024211	43024572	LTR/ERVL-MaLR	1418	+	180	43024391	20230
chr10	114073688	114273688	harbor1	chr10	114093974	114094326	LTR/ERVL-MaLR	2515	+	176	114094150	20462
chr10	114073688	114273688	harbor1	chr10	114095556	114095854	LTR/ERVL-MaLR	673	+	149	114095705	22017
chr10	114073688	114273688	harbor1	chr10	114097666	114098056	LTR/ERVL-MaLR	2496	+	195	114097861	24173
chr10	114073688	114273688	harbor1	chr10	114120238	114120605	LTR/ERVL-MaLR	2091	+	184	114120422	46734
chr10	101896567	102096567	harbor1	chr10	101977560	101977988	LTR/ERVL-MaLR	2234	+	214	101977774	81207
chr10	101896567	102096567	harbor1	chr10	101987525	101987858	LTR/ERVL-MaLR	1099	+	166	101987691	91124
chr10	101896567	102096567	harbor1	chr10	101988011	101988156	LTR/ERVL-MaLR	827	+	72	101988083	91516
chr10	101115425	101315425	harbor1	chr10	101166767	101166910	LTR/ERVL-MaLR	580	+	72	101166839	51414
chr10	101115425	101315425	harbor1	chr10	101178810	101178936	LTR/ERVL-MaLR	483	+	63	101178873	63448
chr10	101115425	101315425	harbor1	chr10	101201617	101201770	LTR/ERVL-MaLR	2232	+	76	101201693	86268
chr10	101115425	101315425	harbor1	chr10	101202055	101202292	LTR/ERVL-MaLR	2232	+	118	101202173	86748
chr10	101115425	101315425	harbor1	chr10	101209030	101209319	LTR/ERVL-MaLR	939	+	144	101209174	93749
chr10	100614422	100814422	harbor1	chr10	100629178	100629261	LTR/ERVL-MaLR	1238	+	42	100629220	14798
chr10	100614422	100814422	harbor1	chr10	100629570	100629877	LTR/ERVL-MaLR	1238	+	154	100629724	15302
chr10	100614422	100814422	harbor1	chr10	100630193	100630238	LTR/ERVL-MaLR	1238	+	22	100630215	15793
chr10	100614422	100814422	harbor1	chr10	100695038	100695510	LTR/ERVL-MaLR	931	+	236	100695274	80852
chr10	100614422	100814422	harbor1	chr10	100696645	100697004	LTR/ERVL-MaLR	1300	+	180	100696825	82403
chr10	100614422	100814422	harbor1	chr10	100699432	100699889	LTR/ERVL-MaLR	1581	+	228	100699660	85238
chr10	69458778	69658778	harbor1	chr10	69463839	69464262	LTR/ERVL-MaLR	1139	+	212	69464051	5273
chr10	69458778	69658778	harbor1	chr10	69541248	69541356	LTR/ERVL-MaLR	642	+	54	69541302	82524
chr10	46006324	46206324	harbor1	chr10	46060894	46061088	LTR/ERVL-MaLR	1052	+	97	46060991	54667
chr10	46006324	46206324	harbor1	chr10	46068487	46068859	LTR/ERVL-MaLR	484	+	186	46068673	62349
chr10	46006324	46206324	harbor1	chr10	46077919	46078324	LTR/ERVL-MaLR	2291	+	202	46078121	71797
chr10	46006324	46206324	harbor1	chr10	46102626	46103005	LTR/ERVL-MaLR	1542	+	190	46102816	96492
chr10	133556781	133756781	harbor1	chr10	133564064	133564356	LTR/ERVL-MaLR	1550	+	146	133564210	7429
chr10	133556781	133756781	harbor1	chr10	133572950	133573282	LTR/ERVL-MaLR	1440	+	166	133573116	16335
chr10	133556781	133756781	harbor1	chr10	133599128	133599439	LTR/ERVL-MaLR	1413	+	156	133599284	42503
chr10	71360848	71560848	harbor1	chr10	71366232	71366417	LTR/ERVL-MaLR	954	+	92	71366324	5476
chr10	71360848	71560848	harbor1	chr10	71368935	71369298	LTR/ERVL-MaLR	1984	+	182	71369117	8269
chr10	71360848	71560848	harbor1	chr10	71369299	71369604	LTR/ERVL-MaLR	1418	+	152	71369451	8603
chr10	132786515	132986515	harbor1	chr10	132876388	132876560	LTR/ERVL-MaLR	488	+	86	132876474	89959
chr10	68160980	68360980	harbor1	chr10	68224612	68224976	LTR/ERVL-MaLR	2306	+	182	68224794	63814
chr10	68160980	68360980	harbor1	chr10	68254618	68255213	LTR/ERVL-MaLR	1255	+	298	68254916	93936
chr10	100085650	100285650	harbor1	chr10	100086627	100086742	LTR/ERVL-MaLR	505	+	58	100086685	1035
chr10	100085650	100285650	harbor1	chr10	100087024	100087271	LTR/ERVL-MaLR	1289	+	124	100087148	1498
chr10	100085650	100285650	harbor1	chr10	100104246	100104624	LTR/ERVL-MaLR	2576	+	189	100104435	18785
chr10	100085650	100285650	harbor1	chr10	100130637	100131192	LTR/ERVL-MaLR	1212	+	278	100130915	45265
chr10	100085650	100285650	harbor1	chr10	100132719	100133164	LTR/ERVL-MaLR	2597	+	222	100132941	47291
chr10	100085650	100285650	harbor1	chr10	100136426	100136808	LTR/ERVL-MaLR	1476	+	191	100136617	50967
chr10	47239786	47439786	harbor1	chr10	47262217	47262585	LTR/ERVL-MaLR	1540	+	184	47262401	22615
chr10	47239786	47439786	harbor1	chr10	47286321	47286550	LTR/ERVL-MaLR	579	+	114	47286435	46649
chr10	47239786	47439786	harbor1	chr10	47291781	47292191	LTR/ERVL-MaLR	2484	+	205	47291986	52200
chr10	47239786	47439786	harbor1	chr10	47318862	47319266	LTR/ERVL-MaLR	530	+	202	47319064	79278
chr10	7113930	7313930	harbor1	chr10	7113610	7113948	LTR/ERVL-MaLR	1443	+	169	7113779	151
chr10	7113930	7313930	harbor1	chr10	7133884	7134255	LTR/ERVL-MaLR	1772	+	186	7134070	20140
chr10	7113930	7313930	harbor1	chr10	7172873	7173197	LTR/ERVL-MaLR	630	+	162	7173035	59105
chr10	7113930	7313930	harbor1	chr10	7177420	7177586	LTR/ERVL-MaLR	1362	+	83	7177503	63573
chr10	7113930	7313930	harbor1	chr10	7177889	7178109	LTR/ERVL-MaLR	1362	+	110	7177999	64069
chr10	7113930	7313930	harbor1	chr10	7184189	7184551	LTR/ERVL-MaLR	2132	+	181	7184370	70440
chr10	7113930	7313930	harbor1	chr10	7190805	7191164	LTR/ERVL-MaLR	2257	+	180	7190985	77055
chr10	48299632	48499632	harbor1	chr10	48301369	48301548	LTR/ERVL-MaLR	1626	+	90	48301459	1827
chr10	48299632	48499632	harbor1	chr10	48301616	48301805	LTR/ERVL-MaLR	1626	+	94	48301710	2078
chr10	34451528	34651528	harbor1	chr10	34501134	34501526	LTR/ERVL-MaLR	1872	+	196	34501330	49802
chr10	34451528	34651528	harbor1	chr10	34501697	34501841	LTR/ERVL-MaLR	1197	+	72	34501769	50241
chr10	34451528	34651528	harbor1	chr10	34501842	34502182	LTR/ERVL-MaLR	1312	+	170	34502012	50484
chr10	34451528	34651528	harbor1	chr10	34502183	34502556	LTR/ERVL-MaLR	1197	+	186	34502369	50841
chr10	34451528	34651528	harbor1	chr10	34521998	34522436	LTR/ERVL-MaLR	1276	+	219	34522217	70689
chr10	78866368	79066368	harbor1	chr10	78886475	78886961	LTR/ERVL-MaLR	1083	+	243	78886718	20350
chr10	78866368	79066368	harbor1	chr10	78897825	78898207	LTR/ERVL-MaLR	2852	+	191	78898016	31648
chr10	48449569	48649569	harbor1	chr10	48468207	48468665	LTR/ERVL-MaLR	1453	+	229	48468436	18867
chr10	48449569	48649569	harbor1	chr10	48487267	48487786	LTR/ERVL-MaLR	1877	+	260	48487527	37958
chr10	48449569	48649569	harbor1	chr10	48488066	48488106	LTR/ERVL-MaLR	1877	+	20	48488086	38517
chr10	48449569	48649569	harbor1	chr10	48495604	48496171	LTR/ERVL-MaLR	2287	+	284	48495888	46319
chr10	48449569	48649569	harbor1	chr10	48528603	48529034	LTR/ERVL-MaLR	2254	+	216	48528819	79250
chr10	48449569	48649569	harbor1	chr10	48529302	48529732	LTR/ERVL-MaLR	763	+	215	48529517	79948
chr10	132143415	132343415	harbor1	chr10	132215327	132215686	LTR/ERVL-MaLR	2681	+	180	132215507	72092
chr10	132143415	132343415	harbor1	chr10	132215687	132216182	LTR/ERVL-MaLR	11945	+	248	132215935	72520
chr10	132143415	132343415	harbor1	chr10	132216498	132217560	LTR/ERVL-MaLR	11945	+	531	132217029	73614
chr10	132143415	132343415	harbor1	chr10	132217561	132217926	LTR/ERVL-MaLR	2519	+	182	132217743	74328
chr10	132143415	132343415	harbor1	chr10	132220035	132220420	LTR/ERVL-MaLR	1076	+	192	132220227	76812
chr10	132143415	132343415	harbor1	chr10	132231586	132232003	LTR/ERVL-MaLR	612	+	208	132231794	88379
chr10	14778012	14978012	harbor1	chr10	14780370	14780606	LTR/ERVL-MaLR	472	+	118	14780488	2476
chr10	14778012	14978012	harbor1	chr10	14792310	14792484	LTR/ERVL-MaLR	795	+	87	14792397	14385
chr10	14778012	14978012	harbor1	chr10	14795758	14795917	LTR/ERVL-MaLR	708	+	80	14795838	17826
chr10	14778012	14978012	harbor1	chr10	14815387	14815585	LTR/ERVL-MaLR	597	+	99	14815486	37474
chr10	14778012	14978012	harbor1	chr10	14820774	14821121	LTR/ERVL-MaLR	2158	+	174	14820948	42936
chr10	14778012	14978012	harbor1	chr10	14821424	14821461	LTR/ERVL-MaLR	2158	+	18	14821442	43430
chr10	14778012	14978012	harbor1	chr10	14863815	14864058	LTR/ERVL-MaLR	470	+	122	14863937	85925
chr10	132207804	132407804	harbor1	chr10	132215327	132215686	LTR/ERVL-MaLR	2681	+	180	132215507	7703
chr10	132207804	132407804	harbor1	chr10	132215687	132216182	LTR/ERVL-MaLR	11945	+	248	132215935	8131
chr10	132207804	132407804	harbor1	chr10	132216498	132217560	LTR/ERVL-MaLR	11945	+	531	132217029	9225
chr10	132207804	132407804	harbor1	chr10	132217561	132217926	LTR/ERVL-MaLR	2519	+	182	132217743	9939
chr10	132207804	132407804	harbor1	chr10	132220035	132220420	LTR/ERVL-MaLR	1076	+	192	132220227	12423
chr10	132207804	132407804	harbor1	chr10	132231586	132232003	LTR/ERVL-MaLR	612	+	208	132231794	23990
chr10	132207804	132407804	harbor1	chr10	132259308	132259770	LTR/ERVL-MaLR	1925	+	231	132259539	51735
chr10	132207804	132407804	harbor1	chr10	132270159	132270510	LTR/ERVL-MaLR	839	+	176	132270335	62531
chr10	132207804	132407804	harbor1	chr10	132272068	132272391	LTR/ERVL-MaLR	1115	+	162	132272230	64426
chr10	132207804	132407804	harbor1	chr10	132298694	132299003	LTR/ERVL-MaLR	889	+	154	132298848	91044
chr10	132207804	132407804	harbor1	chr10	132299625	132299768	LTR/ERVL-MaLR	469	+	72	132299697	91893
chr10	4452758	4652758	harbor1	chr10	4454702	4454966	LTR/ERVL-MaLR	1576	+	132	4454834	2076
chr10	4452758	4652758	harbor1	chr10	4468436	4468771	LTR/ERVL-MaLR	1174	+	168	4468604	15846
chr10	4452758	4652758	harbor1	chr10	4472583	4472783	LTR/ERVL-MaLR	670	+	100	4472683	19925
chr10	4452758	4652758	harbor1	chr10	4488805	4489092	LTR/ERVL-MaLR	469	+	144	4488949	36191
chr10	4452758	4652758	harbor1	chr10	4541422	4541863	LTR/ERVL-MaLR	554	+	220	4541642	88884
chr10	75111058	75311058	harbor1	chr10	75140502	75140676	LTR/ERVL-MaLR	693	+	87	75140589	29531
chr10	75111058	75311058	harbor1	chr10	75202958	75203281	LTR/ERVL-MaLR	1253	+	162	75203120	92062
chr10	75111058	75311058	harbor1	chr10	75203635	75204152	LTR/ERVL-MaLR	2484	+	258	75203893	92835
chr10	47239777	47439777	harbor1	chr10	47262217	47262585	LTR/ERVL-MaLR	1540	+	184	47262401	22624
chr10	47239777	47439777	harbor1	chr10	47286321	47286550	LTR/ERVL-MaLR	579	+	114	47286435	46658
chr10	47239777	47439777	harbor1	chr10	47291781	47292191	LTR/ERVL-MaLR	2484	+	205	47291986	52209
chr10	47239777	47439777	harbor1	chr10	47318862	47319266	LTR/ERVL-MaLR	530	+	202	47319064	79287
chr10	89132447	89332447	harbor1	chr10	89188751	89189130	LTR/ERVL-MaLR	1490	+	190	89188941	56494
chr10	89132447	89332447	harbor1	chr10	89225697	89226062	LTR/ERVL-MaLR	2174	+	182	89225879	93432
chr10	47239796	47439796	harbor1	chr10	47262217	47262585	LTR/ERVL-MaLR	1540	+	184	47262401	22605
chr10	47239796	47439796	harbor1	chr10	47286321	47286550	LTR/ERVL-MaLR	579	+	114	47286435	46639
chr10	47239796	47439796	harbor1	chr10	47291781	47292191	LTR/ERVL-MaLR	2484	+	205	47291986	52190
chr10	47239796	47439796	harbor1	chr10	47318862	47319266	LTR/ERVL-MaLR	530	+	202	47319064	79268
chr10	132811367	133011367	harbor1	chr10	132876388	132876560	LTR/ERVL-MaLR	488	+	86	132876474	65107
chr10	132811367	133011367	harbor1	chr10	132895712	132895924	LTR/ERVL-MaLR	921	+	106	132895818	84451
chr10	132811367	133011367	harbor1	chr10	132896297	132896469	LTR/ERVL-MaLR	540	+	86	132896383	85016
chr10	132811367	133011367	harbor1	chr10	132907659	132907998	LTR/ERVL-MaLR	1091	+	170	132907829	96462
chr10	131144882	131344882	harbor1	chr10	131148070	131148290	LTR/ERVL-MaLR	944	+	110	131148180	3298
chr10	131144882	131344882	harbor1	chr10	131148612	131148874	LTR/ERVL-MaLR	1002	+	131	131148743	3861
chr10	131144882	131344882	harbor1	chr10	131200365	131200775	LTR/ERVL-MaLR	1874	+	205	131200570	55688
chr10	131144882	131344882	harbor1	chr10	131200784	131201039	LTR/ERVL-MaLR	993	+	128	131200912	56030
chr10	131144882	131344882	harbor1	chr10	131203922	131204329	LTR/ERVL-MaLR	855	+	204	131204126	59244
chr10	131144882	131344882	harbor1	chr10	131217075	131217478	LTR/ERVL-MaLR	2268	+	202	131217277	72395
chr10	131144882	131344882	harbor1	chr10	131233738	131234170	LTR/ERVL-MaLR	2321	+	216	131233954	89072
chr10	131144882	131344882	harbor1	chr10	131243174	131243299	LTR/ERVL-MaLR	466	+	62	131243236	98354
chr10	131144882	131344882	harbor1	chr10	131243592	131243618	LTR/ERVL-MaLR	466	+	13	131243605	98723
chr10	22289372	22489372	harbor1	chr10	22376661	22376802	LTR/ERVL-MaLR	1509	+	70	22376731	87359
chr10	22289372	22489372	harbor1	chr10	22377081	22377447	LTR/ERVL-MaLR	1509	+	183	22377264	87892
chr10	22289372	22489372	harbor1	chr10	22379288	22379763	LTR/ERVL-MaLR	1202	+	238	22379526	90154
chr10	132232409	132432409	harbor1	chr10	132259308	132259770	LTR/ERVL-MaLR	1925	+	231	132259539	27130
chr10	132232409	132432409	harbor1	chr10	132270159	132270510	LTR/ERVL-MaLR	839	+	176	132270335	37926
chr10	132232409	132432409	harbor1	chr10	132272068	132272391	LTR/ERVL-MaLR	1115	+	162	132272230	39821
chr10	132232409	132432409	harbor1	chr10	132298694	132299003	LTR/ERVL-MaLR	889	+	154	132298848	66439
chr10	132232409	132432409	harbor1	chr10	132299625	132299768	LTR/ERVL-MaLR	469	+	72	132299697	67288
chr10	132232409	132432409	harbor1	chr10	132325101	132325270	LTR/ERVL-MaLR	2074	+	84	132325185	92776
chr10	132232409	132432409	harbor1	chr10	132325565	132325722	LTR/ERVL-MaLR	2074	+	78	132325643	93234
chr10	132232409	132432409	harbor1	chr10	132326015	132326056	LTR/ERVL-MaLR	2074	+	20	132326035	93626
chr10	132232409	132432409	harbor1	chr10	132327070	132327419	LTR/ERVL-MaLR	2287	+	174	132327244	94835
chr10	131310814	131510814	harbor1	chr10	131335862	131336152	LTR/ERVL-MaLR	869	+	145	131336007	25193
chr10	131310814	131510814	harbor1	chr10	131341095	131341379	LTR/ERVL-MaLR	951	+	142	131341237	30423
chr10	131310814	131510814	harbor1	chr10	131370674	131371019	LTR/ERVL-MaLR	1387	+	172	131370846	60032
chr10	131310814	131510814	harbor1	chr10	131409526	131409908	LTR/ERVL-MaLR	1221	+	191	131409717	98903
chr10	14752857	14952857	harbor1	chr10	14780370	14780606	LTR/ERVL-MaLR	472	+	118	14780488	27631
chr10	14752857	14952857	harbor1	chr10	14792310	14792484	LTR/ERVL-MaLR	795	+	87	14792397	39540
chr10	14752857	14952857	harbor1	chr10	14795758	14795917	LTR/ERVL-MaLR	708	+	80	14795838	42981
chr10	14752857	14952857	harbor1	chr10	14815387	14815585	LTR/ERVL-MaLR	597	+	99	14815486	62629
chr10	14752857	14952857	harbor1	chr10	14820774	14821121	LTR/ERVL-MaLR	2158	+	174	14820948	68091
chr10	14752857	14952857	harbor1	chr10	14821424	14821461	LTR/ERVL-MaLR	2158	+	18	14821442	68585
chr10	131310770	131510770	harbor1	chr10	131335862	131336152	LTR/ERVL-MaLR	869	+	145	131336007	25237
chr10	131310770	131510770	harbor1	chr10	131341095	131341379	LTR/ERVL-MaLR	951	+	142	131341237	30467
chr10	131310770	131510770	harbor1	chr10	131370674	131371019	LTR/ERVL-MaLR	1387	+	172	131370846	60076
chr10	131310770	131510770	harbor1	chr10	131409526	131409908	LTR/ERVL-MaLR	1221	+	191	131409717	98947
chr10	31828950	32028950	harbor1	chr10	31834232	31834581	LTR/ERVL-MaLR	2004	+	174	31834406	5456
chr10	31828950	32028950	harbor1	chr10	31905902	31906345	LTR/ERVL-MaLR	1095	+	222	31906124	77174
chr10	31828950	32028950	harbor1	chr10	31909435	31909617	LTR/ERVL-MaLR	1785	+	91	31909526	80576
chr10	31828950	32028950	harbor1	chr10	31909914	31910217	LTR/ERVL-MaLR	1785	+	152	31910066	81116
chr10	131310777	131510777	harbor1	chr10	131335862	131336152	LTR/ERVL-MaLR	869	+	145	131336007	25230
chr10	131310777	131510777	harbor1	chr10	131341095	131341379	LTR/ERVL-MaLR	951	+	142	131341237	30460
chr10	131310777	131510777	harbor1	chr10	131370674	131371019	LTR/ERVL-MaLR	1387	+	172	131370846	60069
chr10	131310777	131510777	harbor1	chr10	131409526	131409908	LTR/ERVL-MaLR	1221	+	191	131409717	98940
chr10	14778778	14978778	harbor1	chr10	14780370	14780606	LTR/ERVL-MaLR	472	+	118	14780488	1710
chr10	14778778	14978778	harbor1	chr10	14792310	14792484	LTR/ERVL-MaLR	795	+	87	14792397	13619
chr10	14778778	14978778	harbor1	chr10	14795758	14795917	LTR/ERVL-MaLR	708	+	80	14795838	17060
chr10	14778778	14978778	harbor1	chr10	14815387	14815585	LTR/ERVL-MaLR	597	+	99	14815486	36708
chr10	14778778	14978778	harbor1	chr10	14820774	14821121	LTR/ERVL-MaLR	2158	+	174	14820948	42170
chr10	14778778	14978778	harbor1	chr10	14821424	14821461	LTR/ERVL-MaLR	2158	+	18	14821442	42664
chr10	14778778	14978778	harbor1	chr10	14863815	14864058	LTR/ERVL-MaLR	470	+	122	14863937	85159
chr10	7149143	7349143	harbor1	chr10	7172873	7173197	LTR/ERVL-MaLR	630	+	162	7173035	23892
chr10	7149143	7349143	harbor1	chr10	7177420	7177586	LTR/ERVL-MaLR	1362	+	83	7177503	28360
chr10	7149143	7349143	harbor1	chr10	7177889	7178109	LTR/ERVL-MaLR	1362	+	110	7177999	28856
chr10	7149143	7349143	harbor1	chr10	7184189	7184551	LTR/ERVL-MaLR	2132	+	181	7184370	35227
chr10	7149143	7349143	harbor1	chr10	7190805	7191164	LTR/ERVL-MaLR	2257	+	180	7190985	41842
chr10	7149143	7349143	harbor1	chr10	7216217	7216567	LTR/ERVL-MaLR	2170	+	175	7216392	67249
chr10	7149143	7349143	harbor1	chr10	7240930	7241298	LTR/ERVL-MaLR	2453	+	184	7241114	91971
chr10	46005969	46205969	harbor1	chr10	46060894	46061088	LTR/ERVL-MaLR	1052	+	97	46060991	55022
chr10	46005969	46205969	harbor1	chr10	46068487	46068859	LTR/ERVL-MaLR	484	+	186	46068673	62704
chr10	46005969	46205969	harbor1	chr10	46077919	46078324	LTR/ERVL-MaLR	2291	+	202	46078121	72152
chr10	46005969	46205969	harbor1	chr10	46102626	46103005	LTR/ERVL-MaLR	1542	+	190	46102816	96847
chr10	122063779	122263779	harbor1	chr10	122126848	122127220	LTR/ERVL-MaLR	2338	+	186	122127034	63255
chr10	122063779	122263779	harbor1	chr10	122146345	122146761	LTR/ERVL-MaLR	2913	+	208	122146553	82774
chr10	132614280	132814280	harbor1	chr10	132614660	132615000	LTR/ERVL-MaLR	619	+	170	132614830	550
chr10	132614280	132814280	harbor1	chr10	132626932	132627258	LTR/ERVL-MaLR	899	+	163	132627095	12815
chr10	132614280	132814280	harbor1	chr10	132672337	132672692	LTR/ERVL-MaLR	2261	+	178	132672515	58235
chr10	132614280	132814280	harbor1	chr10	132695887	132696220	LTR/ERVL-MaLR	1330	+	166	132696053	81773
chr10	131310769	131510769	harbor1	chr10	131335862	131336152	LTR/ERVL-MaLR	869	+	145	131336007	25238
chr10	131310769	131510769	harbor1	chr10	131341095	131341379	LTR/ERVL-MaLR	951	+	142	131341237	30468
chr10	131310769	131510769	harbor1	chr10	131370674	131371019	LTR/ERVL-MaLR	1387	+	172	131370846	60077
chr10	131310769	131510769	harbor1	chr10	131409526	131409908	LTR/ERVL-MaLR	1221	+	191	131409717	98948
chr10	129211551	129411551	harbor1	chr10	129218685	129218979	LTR/ERVL-MaLR	1070	+	147	129218832	7281
chr10	129211551	129411551	harbor1	chr10	129228179	129228404	LTR/ERVL-MaLR	622	+	112	129228291	16740
chr10	131310837	131510837	harbor1	chr10	131335862	131336152	LTR/ERVL-MaLR	869	+	145	131336007	25170
chr10	131310837	131510837	harbor1	chr10	131341095	131341379	LTR/ERVL-MaLR	951	+	142	131341237	30400
chr10	131310837	131510837	harbor1	chr10	131370674	131371019	LTR/ERVL-MaLR	1387	+	172	131370846	60009
chr10	131310837	131510837	harbor1	chr10	131409526	131409908	LTR/ERVL-MaLR	1221	+	191	131409717	98880
chr10	14763732	14963732	harbor1	chr10	14780370	14780606	LTR/ERVL-MaLR	472	+	118	14780488	16756
chr10	14763732	14963732	harbor1	chr10	14792310	14792484	LTR/ERVL-MaLR	795	+	87	14792397	28665
chr10	14763732	14963732	harbor1	chr10	14795758	14795917	LTR/ERVL-MaLR	708	+	80	14795838	32106
chr10	14763732	14963732	harbor1	chr10	14815387	14815585	LTR/ERVL-MaLR	597	+	99	14815486	51754
chr10	14763732	14963732	harbor1	chr10	14820774	14821121	LTR/ERVL-MaLR	2158	+	174	14820948	57216
chr10	14763732	14963732	harbor1	chr10	14821424	14821461	LTR/ERVL-MaLR	2158	+	18	14821442	57710
chr10	30655861	30855861	harbor1	chr10	30725141	30725499	LTR/ERVL-MaLR	1919	+	179	30725320	69459
chr10	14778075	14978075	harbor1	chr10	14780370	14780606	LTR/ERVL-MaLR	472	+	118	14780488	2413
chr10	14778075	14978075	harbor1	chr10	14792310	14792484	LTR/ERVL-MaLR	795	+	87	14792397	14322
chr10	14778075	14978075	harbor1	chr10	14795758	14795917	LTR/ERVL-MaLR	708	+	80	14795838	17763
chr10	14778075	14978075	harbor1	chr10	14815387	14815585	LTR/ERVL-MaLR	597	+	99	14815486	37411
chr10	14778075	14978075	harbor1	chr10	14820774	14821121	LTR/ERVL-MaLR	2158	+	174	14820948	42873
chr10	14778075	14978075	harbor1	chr10	14821424	14821461	LTR/ERVL-MaLR	2158	+	18	14821442	43367
chr10	14778075	14978075	harbor1	chr10	14863815	14864058	LTR/ERVL-MaLR	470	+	122	14863937	85862
chr10	132207865	132407865	harbor1	chr10	132215327	132215686	LTR/ERVL-MaLR	2681	+	180	132215507	7642
chr10	132207865	132407865	harbor1	chr10	132215687	132216182	LTR/ERVL-MaLR	11945	+	248	132215935	8070
chr10	132207865	132407865	harbor1	chr10	132216498	132217560	LTR/ERVL-MaLR	11945	+	531	132217029	9164
chr10	132207865	132407865	harbor1	chr10	132217561	132217926	LTR/ERVL-MaLR	2519	+	182	132217743	9878
chr10	132207865	132407865	harbor1	chr10	132220035	132220420	LTR/ERVL-MaLR	1076	+	192	132220227	12362
chr10	132207865	132407865	harbor1	chr10	132231586	132232003	LTR/ERVL-MaLR	612	+	208	132231794	23929
chr10	132207865	132407865	harbor1	chr10	132259308	132259770	LTR/ERVL-MaLR	1925	+	231	132259539	51674
chr10	132207865	132407865	harbor1	chr10	132270159	132270510	LTR/ERVL-MaLR	839	+	176	132270335	62470
chr10	132207865	132407865	harbor1	chr10	132272068	132272391	LTR/ERVL-MaLR	1115	+	162	132272230	64365
chr10	132207865	132407865	harbor1	chr10	132298694	132299003	LTR/ERVL-MaLR	889	+	154	132298848	90983
chr10	132207865	132407865	harbor1	chr10	132299625	132299768	LTR/ERVL-MaLR	469	+	72	132299697	91832
chr10	43456421	43656421	harbor1	chr10	43533869	43534237	LTR/ERVL-MaLR	1831	+	184	43534053	77632
chr10	43456421	43656421	harbor1	chr10	43540640	43541064	LTR/ERVL-MaLR	2378	+	212	43540852	84431
chr10	14778068	14978068	harbor1	chr10	14780370	14780606	LTR/ERVL-MaLR	472	+	118	14780488	2420
chr10	14778068	14978068	harbor1	chr10	14792310	14792484	LTR/ERVL-MaLR	795	+	87	14792397	14329
chr10	14778068	14978068	harbor1	chr10	14795758	14795917	LTR/ERVL-MaLR	708	+	80	14795838	17770
chr10	14778068	14978068	harbor1	chr10	14815387	14815585	LTR/ERVL-MaLR	597	+	99	14815486	37418
chr10	14778068	14978068	harbor1	chr10	14820774	14821121	LTR/ERVL-MaLR	2158	+	174	14820948	42880
chr10	14778068	14978068	harbor1	chr10	14821424	14821461	LTR/ERVL-MaLR	2158	+	18	14821442	43374
chr10	14778068	14978068	harbor1	chr10	14863815	14864058	LTR/ERVL-MaLR	470	+	122	14863937	85869
chr11	3928050	4128050	harbor1	chr11	3931641	3931719	LTR/ERVL-MaLR	541	+	39	3931680	3630
chr11	3928050	4128050	harbor1	chr11	3932301	3932380	LTR/ERVL-MaLR	1699	+	40	3932341	4291
chr11	3928050	4128050	harbor1	chr11	3932692	3932912	LTR/ERVL-MaLR	1699	+	110	3932802	4752
chr11	3928050	4128050	harbor1	chr11	4006022	4006401	LTR/ERVL-MaLR	2590	+	190	4006212	78162
chr11	3928050	4128050	harbor1	chr11	4006714	4006751	LTR/ERVL-MaLR	2590	+	18	4006732	78682
chr11	5127208	5327208	harbor1	chr11	5189162	5189564	LTR/ERVL-MaLR	2124	+	201	5189363	62155
chr11	5127208	5327208	harbor1	chr11	5189565	5190876	LTR/ERVL-MaLR	10022	+	656	5190221	63013
chr11	5127208	5327208	harbor1	chr11	5191240	5191557	LTR/ERVL-MaLR	10022	+	158	5191398	64190
chr11	5127208	5327208	harbor1	chr11	5191559	5191966	LTR/ERVL-MaLR	2382	+	204	5191763	64555
chr11	5126782	5326782	harbor1	chr11	5189162	5189564	LTR/ERVL-MaLR	2124	+	201	5189363	62581
chr11	5126782	5326782	harbor1	chr11	5189565	5190876	LTR/ERVL-MaLR	10022	+	656	5190221	63439
chr11	5126782	5326782	harbor1	chr11	5191240	5191557	LTR/ERVL-MaLR	10022	+	158	5191398	64616
chr11	5126782	5326782	harbor1	chr11	5191559	5191966	LTR/ERVL-MaLR	2382	+	204	5191763	64981
chr11	5125332	5325332	harbor1	chr11	5189162	5189564	LTR/ERVL-MaLR	2124	+	201	5189363	64031
chr11	5125332	5325332	harbor1	chr11	5189565	5190876	LTR/ERVL-MaLR	10022	+	656	5190221	64889
chr11	5125332	5325332	harbor1	chr11	5191240	5191557	LTR/ERVL-MaLR	10022	+	158	5191398	66066
chr11	5125332	5325332	harbor1	chr11	5191559	5191966	LTR/ERVL-MaLR	2382	+	204	5191763	66431
chr11	5127125	5327125	harbor1	chr11	5189162	5189564	LTR/ERVL-MaLR	2124	+	201	5189363	62238
chr11	5127125	5327125	harbor1	chr11	5189565	5190876	LTR/ERVL-MaLR	10022	+	656	5190221	63096
chr11	5127125	5327125	harbor1	chr11	5191240	5191557	LTR/ERVL-MaLR	10022	+	158	5191398	64273
chr11	5127125	5327125	harbor1	chr11	5191559	5191966	LTR/ERVL-MaLR	2382	+	204	5191763	64638
chr11	5126747	5326747	harbor1	chr11	5189162	5189564	LTR/ERVL-MaLR	2124	+	201	5189363	62616
chr11	5126747	5326747	harbor1	chr11	5189565	5190876	LTR/ERVL-MaLR	10022	+	656	5190221	63474
chr11	5126747	5326747	harbor1	chr11	5191240	5191557	LTR/ERVL-MaLR	10022	+	158	5191398	64651
chr11	5126747	5326747	harbor1	chr11	5191559	5191966	LTR/ERVL-MaLR	2382	+	204	5191763	65016
chr11	76580979	76780979	harbor1	chr11	76596508	76596942	LTR/ERVL-MaLR	1760	+	217	76596725	15746
chr11	76580979	76780979	harbor1	chr11	76601030	76601131	LTR/ERVL-MaLR	1424	+	50	76601080	20101
chr11	76580979	76780979	harbor1	chr11	76601436	76601695	LTR/ERVL-MaLR	1424	+	130	76601566	20587
chr11	76580979	76780979	harbor1	chr11	76641037	76641400	LTR/ERVL-MaLR	1804	+	182	76641219	60240
chr11	76580979	76780979	harbor1	chr11	76641690	76641752	LTR/ERVL-MaLR	1804	+	31	76641721	60742
chr11	5126823	5326823	harbor1	chr11	5189162	5189564	LTR/ERVL-MaLR	2124	+	201	5189363	62540
chr11	5126823	5326823	harbor1	chr11	5189565	5190876	LTR/ERVL-MaLR	10022	+	656	5190221	63398
chr11	5126823	5326823	harbor1	chr11	5191240	5191557	LTR/ERVL-MaLR	10022	+	158	5191398	64575
chr11	5126823	5326823	harbor1	chr11	5191559	5191966	LTR/ERVL-MaLR	2382	+	204	5191763	64940
chr11	123412399	123612399	harbor1	chr11	123440794	123441141	LTR/ERVL-MaLR	2268	+	174	123440968	28569
chr11	123412399	123612399	harbor1	chr11	123499076	123499423	LTR/ERVL-MaLR	1186	+	174	123499250	86851
chr11	5134555	5334555	harbor1	chr11	5189162	5189564	LTR/ERVL-MaLR	2124	+	201	5189363	54808
chr11	5134555	5334555	harbor1	chr11	5189565	5190876	LTR/ERVL-MaLR	10022	+	656	5190221	55666
chr11	5134555	5334555	harbor1	chr11	5191240	5191557	LTR/ERVL-MaLR	10022	+	158	5191398	56843
chr11	5134555	5334555	harbor1	chr11	5191559	5191966	LTR/ERVL-MaLR	2382	+	204	5191763	57208
chr11	5126774	5326774	harbor1	chr11	5189162	5189564	LTR/ERVL-MaLR	2124	+	201	5189363	62589
chr11	5126774	5326774	harbor1	chr11	5189565	5190876	LTR/ERVL-MaLR	10022	+	656	5190221	63447
chr11	5126774	5326774	harbor1	chr11	5191240	5191557	LTR/ERVL-MaLR	10022	+	158	5191398	64624
chr11	5126774	5326774	harbor1	chr11	5191559	5191966	LTR/ERVL-MaLR	2382	+	204	5191763	64989
chr11	5127340	5327340	harbor1	chr11	5189162	5189564	LTR/ERVL-MaLR	2124	+	201	5189363	62023
chr11	5127340	5327340	harbor1	chr11	5189565	5190876	LTR/ERVL-MaLR	10022	+	656	5190221	62881
chr11	5127340	5327340	harbor1	chr11	5191240	5191557	LTR/ERVL-MaLR	10022	+	158	5191398	64058
chr11	5127340	5327340	harbor1	chr11	5191559	5191966	LTR/ERVL-MaLR	2382	+	204	5191763	64423
chr11	64110890	64310890	harbor1	chr11	64163336	64163826	LTR/ERVL-MaLR	1388	+	245	64163581	52691
chr11	64110890	64310890	harbor1	chr11	64175743	64175850	LTR/ERVL-MaLR	2099	+	54	64175797	64907
chr11	64110890	64310890	harbor1	chr11	64176157	64176212	LTR/ERVL-MaLR	2099	+	28	64176185	65295
chr11	64110890	64310890	harbor1	chr11	64176509	64176539	LTR/ERVL-MaLR	2099	+	15	64176524	65634
chr11	64110890	64310890	harbor1	chr11	64176821	64177074	LTR/ERVL-MaLR	2099	+	126	64176947	66057
chr11	73038077	73238077	harbor1	chr11	73043599	73044065	LTR/ERVL-MaLR	1159	+	233	73043832	5755
chr11	73038077	73238077	harbor1	chr11	73102537	73102881	LTR/ERVL-MaLR	1622	+	172	73102709	64632
chr11	5124751	5324751	harbor1	chr11	5189162	5189564	LTR/ERVL-MaLR	2124	+	201	5189363	64612
chr11	5124751	5324751	harbor1	chr11	5189565	5190876	LTR/ERVL-MaLR	10022	+	656	5190221	65470
chr11	5124751	5324751	harbor1	chr11	5191240	5191557	LTR/ERVL-MaLR	10022	+	158	5191398	66647
chr11	5124751	5324751	harbor1	chr11	5191559	5191966	LTR/ERVL-MaLR	2382	+	204	5191763	67012
chr11	5134559	5334559	harbor1	chr11	5189162	5189564	LTR/ERVL-MaLR	2124	+	201	5189363	54804
chr11	5134559	5334559	harbor1	chr11	5189565	5190876	LTR/ERVL-MaLR	10022	+	656	5190221	55662
chr11	5134559	5334559	harbor1	chr11	5191240	5191557	LTR/ERVL-MaLR	10022	+	158	5191398	56839
chr11	5134559	5334559	harbor1	chr11	5191559	5191966	LTR/ERVL-MaLR	2382	+	204	5191763	57204
chr11	5134573	5334573	harbor1	chr11	5189162	5189564	LTR/ERVL-MaLR	2124	+	201	5189363	54790
chr11	5134573	5334573	harbor1	chr11	5189565	5190876	LTR/ERVL-MaLR	10022	+	656	5190221	55648
chr11	5134573	5334573	harbor1	chr11	5191240	5191557	LTR/ERVL-MaLR	10022	+	158	5191398	56825
chr11	5134573	5334573	harbor1	chr11	5191559	5191966	LTR/ERVL-MaLR	2382	+	204	5191763	57190
chr11	5127129	5327129	harbor1	chr11	5189162	5189564	LTR/ERVL-MaLR	2124	+	201	5189363	62234
chr11	5127129	5327129	harbor1	chr11	5189565	5190876	LTR/ERVL-MaLR	10022	+	656	5190221	63092
chr11	5127129	5327129	harbor1	chr11	5191240	5191557	LTR/ERVL-MaLR	10022	+	158	5191398	64269
chr11	5127129	5327129	harbor1	chr11	5191559	5191966	LTR/ERVL-MaLR	2382	+	204	5191763	64634
chr11	5127170	5327170	harbor1	chr11	5189162	5189564	LTR/ERVL-MaLR	2124	+	201	5189363	62193
chr11	5127170	5327170	harbor1	chr11	5189565	5190876	LTR/ERVL-MaLR	10022	+	656	5190221	63051
chr11	5127170	5327170	harbor1	chr11	5191240	5191557	LTR/ERVL-MaLR	10022	+	158	5191398	64228
chr11	5127170	5327170	harbor1	chr11	5191559	5191966	LTR/ERVL-MaLR	2382	+	204	5191763	64593
chr11	57399820	57599820	harbor1	chr11	57410705	57411062	LTR/ERVL-MaLR	2835	+	178	57410883	11063
chr11	57399820	57599820	harbor1	chr11	57417136	57417642	LTR/ERVL-MaLR	1555	+	253	57417389	17569
chr11	57399820	57599820	harbor1	chr11	57446230	57446646	LTR/ERVL-MaLR	744	+	208	57446438	46618
chr11	57399820	57599820	harbor1	chr11	57446953	57446999	LTR/ERVL-MaLR	744	+	23	57446976	47156
chr11	57399820	57599820	harbor1	chr11	57490336	57490804	LTR/ERVL-MaLR	1620	+	234	57490570	90750
chr11	5127181	5327181	harbor1	chr11	5189162	5189564	LTR/ERVL-MaLR	2124	+	201	5189363	62182
chr11	5127181	5327181	harbor1	chr11	5189565	5190876	LTR/ERVL-MaLR	10022	+	656	5190221	63040
chr11	5127181	5327181	harbor1	chr11	5191240	5191557	LTR/ERVL-MaLR	10022	+	158	5191398	64217
chr11	5127181	5327181	harbor1	chr11	5191559	5191966	LTR/ERVL-MaLR	2382	+	204	5191763	64582
chr11	5107730	5307730	harbor1	chr11	5189162	5189564	LTR/ERVL-MaLR	2124	+	201	5189363	81633
chr11	5107730	5307730	harbor1	chr11	5189565	5190876	LTR/ERVL-MaLR	10022	+	656	5190221	82491
chr11	5107730	5307730	harbor1	chr11	5191240	5191557	LTR/ERVL-MaLR	10022	+	158	5191398	83668
chr11	5107730	5307730	harbor1	chr11	5191559	5191966	LTR/ERVL-MaLR	2382	+	204	5191763	84033
chr11	5127269	5327269	harbor1	chr11	5189162	5189564	LTR/ERVL-MaLR	2124	+	201	5189363	62094
chr11	5127269	5327269	harbor1	chr11	5189565	5190876	LTR/ERVL-MaLR	10022	+	656	5190221	62952
chr11	5127269	5327269	harbor1	chr11	5191240	5191557	LTR/ERVL-MaLR	10022	+	158	5191398	64129
chr11	5127269	5327269	harbor1	chr11	5191559	5191966	LTR/ERVL-MaLR	2382	+	204	5191763	64494
chr11	76329060	76529060	harbor1	chr11	76334311	76334413	LTR/ERVL-MaLR	788	+	51	76334362	5302
chr11	76329060	76529060	harbor1	chr11	76334414	76335853	LTR/ERVL-MaLR	9351	+	720	76335134	6074
chr11	76329060	76529060	harbor1	chr11	76335854	76336249	LTR/ERVL-MaLR	2128	+	198	76336052	6992
chr11	76329060	76529060	harbor1	chr11	76348858	76349256	LTR/ERVL-MaLR	833	+	199	76349057	19997
chr11	76329060	76529060	harbor1	chr11	76374779	76375088	LTR/ERVL-MaLR	1259	+	154	76374933	45873
chr11	76329060	76529060	harbor1	chr11	76420558	76421122	LTR/ERVL-MaLR	1769	+	282	76420840	91780
chr11	5032610	5232610	harbor1	chr11	5066179	5066467	LTR/ERVL-MaLR	674	+	144	5066323	33713
chr11	5032610	5232610	harbor1	chr11	5099106	5099479	LTR/ERVL-MaLR	2325	+	186	5099292	66682
chr11	108021573	108221573	harbor1	chr11	108114901	108115232	LTR/ERVL-MaLR	1129	+	166	108115067	93494
chr11	108021573	108221573	harbor1	chr11	108116572	108116980	LTR/ERVL-MaLR	1933	+	204	108116776	95203
chr11	108021573	108221573	harbor1	chr11	108116981	108117136	LTR/ERVL-MaLR	678	+	78	108117059	95486
chr11	5132965	5332965	harbor1	chr11	5189162	5189564	LTR/ERVL-MaLR	2124	+	201	5189363	56398
chr11	5132965	5332965	harbor1	chr11	5189565	5190876	LTR/ERVL-MaLR	10022	+	656	5190221	57256
chr11	5132965	5332965	harbor1	chr11	5191240	5191557	LTR/ERVL-MaLR	10022	+	158	5191398	58433
chr11	5132965	5332965	harbor1	chr11	5191559	5191966	LTR/ERVL-MaLR	2382	+	204	5191763	58798
chr11	5127263	5327263	harbor1	chr11	5189162	5189564	LTR/ERVL-MaLR	2124	+	201	5189363	62100
chr11	5127263	5327263	harbor1	chr11	5189565	5190876	LTR/ERVL-MaLR	10022	+	656	5190221	62958
chr11	5127263	5327263	harbor1	chr11	5191240	5191557	LTR/ERVL-MaLR	10022	+	158	5191398	64135
chr11	5127263	5327263	harbor1	chr11	5191559	5191966	LTR/ERVL-MaLR	2382	+	204	5191763	64500
chr11	5129592	5329592	harbor1	chr11	5189162	5189564	LTR/ERVL-MaLR	2124	+	201	5189363	59771
chr11	5129592	5329592	harbor1	chr11	5189565	5190876	LTR/ERVL-MaLR	10022	+	656	5190221	60629
chr11	5129592	5329592	harbor1	chr11	5191240	5191557	LTR/ERVL-MaLR	10022	+	158	5191398	61806
chr11	5129592	5329592	harbor1	chr11	5191559	5191966	LTR/ERVL-MaLR	2382	+	204	5191763	62171
chr11	5124885	5324885	harbor1	chr11	5189162	5189564	LTR/ERVL-MaLR	2124	+	201	5189363	64478
chr11	5124885	5324885	harbor1	chr11	5189565	5190876	LTR/ERVL-MaLR	10022	+	656	5190221	65336
chr11	5124885	5324885	harbor1	chr11	5191240	5191557	LTR/ERVL-MaLR	10022	+	158	5191398	66513
chr11	5124885	5324885	harbor1	chr11	5191559	5191966	LTR/ERVL-MaLR	2382	+	204	5191763	66878
chr11	5127172	5327172	harbor1	chr11	5189162	5189564	LTR/ERVL-MaLR	2124	+	201	5189363	62191
chr11	5127172	5327172	harbor1	chr11	5189565	5190876	LTR/ERVL-MaLR	10022	+	656	5190221	63049
chr11	5127172	5327172	harbor1	chr11	5191240	5191557	LTR/ERVL-MaLR	10022	+	158	5191398	64226
chr11	5127172	5327172	harbor1	chr11	5191559	5191966	LTR/ERVL-MaLR	2382	+	204	5191763	64591
chr11	5127366	5327366	harbor1	chr11	5189162	5189564	LTR/ERVL-MaLR	2124	+	201	5189363	61997
chr11	5127366	5327366	harbor1	chr11	5189565	5190876	LTR/ERVL-MaLR	10022	+	656	5190221	62855
chr11	5127366	5327366	harbor1	chr11	5191240	5191557	LTR/ERVL-MaLR	10022	+	158	5191398	64032
chr11	5127366	5327366	harbor1	chr11	5191559	5191966	LTR/ERVL-MaLR	2382	+	204	5191763	64397
chr11	108021539	108221539	harbor1	chr11	108114901	108115232	LTR/ERVL-MaLR	1129	+	166	108115067	93528
chr11	108021539	108221539	harbor1	chr11	108116572	108116980	LTR/ERVL-MaLR	1933	+	204	108116776	95237
chr11	108021539	108221539	harbor1	chr11	108116981	108117136	LTR/ERVL-MaLR	678	+	78	108117059	95520
chr11	5127203	5327203	harbor1	chr11	5189162	5189564	LTR/ERVL-MaLR	2124	+	201	5189363	62160
chr11	5127203	5327203	harbor1	chr11	5189565	5190876	LTR/ERVL-MaLR	10022	+	656	5190221	63018
chr11	5127203	5327203	harbor1	chr11	5191240	5191557	LTR/ERVL-MaLR	10022	+	158	5191398	64195
chr11	5127203	5327203	harbor1	chr11	5191559	5191966	LTR/ERVL-MaLR	2382	+	204	5191763	64560
chr11	5127266	5327266	harbor1	chr11	5189162	5189564	LTR/ERVL-MaLR	2124	+	201	5189363	62097
chr11	5127266	5327266	harbor1	chr11	5189565	5190876	LTR/ERVL-MaLR	10022	+	656	5190221	62955
chr11	5127266	5327266	harbor1	chr11	5191240	5191557	LTR/ERVL-MaLR	10022	+	158	5191398	64132
chr11	5127266	5327266	harbor1	chr11	5191559	5191966	LTR/ERVL-MaLR	2382	+	204	5191763	64497
chr11	5127192	5327192	harbor1	chr11	5189162	5189564	LTR/ERVL-MaLR	2124	+	201	5189363	62171
chr11	5127192	5327192	harbor1	chr11	5189565	5190876	LTR/ERVL-MaLR	10022	+	656	5190221	63029
chr11	5127192	5327192	harbor1	chr11	5191240	5191557	LTR/ERVL-MaLR	10022	+	158	5191398	64206
chr11	5127192	5327192	harbor1	chr11	5191559	5191966	LTR/ERVL-MaLR	2382	+	204	5191763	64571
chr11	5127243	5327243	harbor1	chr11	5189162	5189564	LTR/ERVL-MaLR	2124	+	201	5189363	62120
chr11	5127243	5327243	harbor1	chr11	5189565	5190876	LTR/ERVL-MaLR	10022	+	656	5190221	62978
chr11	5127243	5327243	harbor1	chr11	5191240	5191557	LTR/ERVL-MaLR	10022	+	158	5191398	64155
chr11	5127243	5327243	harbor1	chr11	5191559	5191966	LTR/ERVL-MaLR	2382	+	204	5191763	64520
chr11	5127199	5327199	harbor1	chr11	5189162	5189564	LTR/ERVL-MaLR	2124	+	201	5189363	62164
chr11	5127199	5327199	harbor1	chr11	5189565	5190876	LTR/ERVL-MaLR	10022	+	656	5190221	63022
chr11	5127199	5327199	harbor1	chr11	5191240	5191557	LTR/ERVL-MaLR	10022	+	158	5191398	64199
chr11	5127199	5327199	harbor1	chr11	5191559	5191966	LTR/ERVL-MaLR	2382	+	204	5191763	64564
chr11	5125100	5325100	harbor1	chr11	5189162	5189564	LTR/ERVL-MaLR	2124	+	201	5189363	64263
chr11	5125100	5325100	harbor1	chr11	5189565	5190876	LTR/ERVL-MaLR	10022	+	656	5190221	65121
chr11	5125100	5325100	harbor1	chr11	5191240	5191557	LTR/ERVL-MaLR	10022	+	158	5191398	66298
chr11	5125100	5325100	harbor1	chr11	5191559	5191966	LTR/ERVL-MaLR	2382	+	204	5191763	66663
chr11	1661043	1861043	harbor1	chr11	1663683	1664080	LTR/ERVL-MaLR	1471	+	198	1663881	2838
chr11	1661043	1861043	harbor1	chr11	1696470	1696897	LTR/ERVL-MaLR	1315	+	214	1696684	35641
chr11	1661043	1861043	harbor1	chr11	1711289	1711375	LTR/ERVL-MaLR	482	+	43	1711332	50289
chr11	1661043	1861043	harbor1	chr11	1740741	1741162	LTR/ERVL-MaLR	2056	+	210	1740951	79908
chr11	1661043	1861043	harbor1	chr11	1741758	1742087	LTR/ERVL-MaLR	1162	+	164	1741922	80879
chr11	1461906	1661906	harbor1	chr11	1477441	1477801	LTR/ERVL-MaLR	583	+	180	1477621	15715
chr11	1461906	1661906	harbor1	chr11	1497293	1497454	LTR/ERVL-MaLR	496	+	80	1497373	35467
chr11	1461906	1661906	harbor1	chr11	1512672	1512790	LTR/ERVL-MaLR	465	+	59	1512731	50825
chr11	1461906	1661906	harbor1	chr11	1512969	1513245	LTR/ERVL-MaLR	619	+	138	1513107	51201
chr11	1461906	1661906	harbor1	chr11	1538165	1538523	LTR/ERVL-MaLR	504	+	179	1538344	76438
chr11	1461906	1661906	harbor1	chr11	1540607	1540693	LTR/ERVL-MaLR	765	+	43	1540650	78744
chr11	1461906	1661906	harbor1	chr11	1540986	1541205	LTR/ERVL-MaLR	765	+	110	1541096	79190
chr11	1461906	1661906	harbor1	chr11	1545362	1545501	LTR/ERVL-MaLR	744	+	70	1545432	83526
chr11	5134601	5334601	harbor1	chr11	5189162	5189564	LTR/ERVL-MaLR	2124	+	201	5189363	54762
chr11	5134601	5334601	harbor1	chr11	5189565	5190876	LTR/ERVL-MaLR	10022	+	656	5190221	55620
chr11	5134601	5334601	harbor1	chr11	5191240	5191557	LTR/ERVL-MaLR	10022	+	158	5191398	56797
chr11	5134601	5334601	harbor1	chr11	5191559	5191966	LTR/ERVL-MaLR	2382	+	204	5191763	57162
chr11	5127217	5327217	harbor1	chr11	5189162	5189564	LTR/ERVL-MaLR	2124	+	201	5189363	62146
chr11	5127217	5327217	harbor1	chr11	5189565	5190876	LTR/ERVL-MaLR	10022	+	656	5190221	63004
chr11	5127217	5327217	harbor1	chr11	5191240	5191557	LTR/ERVL-MaLR	10022	+	158	5191398	64181
chr11	5127217	5327217	harbor1	chr11	5191559	5191966	LTR/ERVL-MaLR	2382	+	204	5191763	64546
chr11	5127264	5327264	harbor1	chr11	5189162	5189564	LTR/ERVL-MaLR	2124	+	201	5189363	62099
chr11	5127264	5327264	harbor1	chr11	5189565	5190876	LTR/ERVL-MaLR	10022	+	656	5190221	62957
chr11	5127264	5327264	harbor1	chr11	5191240	5191557	LTR/ERVL-MaLR	10022	+	158	5191398	64134
chr11	5127264	5327264	harbor1	chr11	5191559	5191966	LTR/ERVL-MaLR	2382	+	204	5191763	64499
chr11	5021552	5221552	harbor1	chr11	5066179	5066467	LTR/ERVL-MaLR	674	+	144	5066323	44771
chr11	5021552	5221552	harbor1	chr11	5099106	5099479	LTR/ERVL-MaLR	2325	+	186	5099292	77740
chr11	2054524	2254524	harbor1	chr11	2087160	2087567	LTR/ERVL-MaLR	2660	+	204	2087364	32840
chr11	2054524	2254524	harbor1	chr11	2089287	2089620	LTR/ERVL-MaLR	439	+	166	2089453	34929
chr11	5125708	5325708	harbor1	chr11	5189162	5189564	LTR/ERVL-MaLR	2124	+	201	5189363	63655
chr11	5125708	5325708	harbor1	chr11	5189565	5190876	LTR/ERVL-MaLR	10022	+	656	5190221	64513
chr11	5125708	5325708	harbor1	chr11	5191240	5191557	LTR/ERVL-MaLR	10022	+	158	5191398	65690
chr11	5125708	5325708	harbor1	chr11	5191559	5191966	LTR/ERVL-MaLR	2382	+	204	5191763	66055
chr11	5127143	5327143	harbor1	chr11	5189162	5189564	LTR/ERVL-MaLR	2124	+	201	5189363	62220
chr11	5127143	5327143	harbor1	chr11	5189565	5190876	LTR/ERVL-MaLR	10022	+	656	5190221	63078
chr11	5127143	5327143	harbor1	chr11	5191240	5191557	LTR/ERVL-MaLR	10022	+	158	5191398	64255
chr11	5127143	5327143	harbor1	chr11	5191559	5191966	LTR/ERVL-MaLR	2382	+	204	5191763	64620
chr11	5115306	5315306	harbor1	chr11	5189162	5189564	LTR/ERVL-MaLR	2124	+	201	5189363	74057
chr11	5115306	5315306	harbor1	chr11	5189565	5190876	LTR/ERVL-MaLR	10022	+	656	5190221	74915
chr11	5115306	5315306	harbor1	chr11	5191240	5191557	LTR/ERVL-MaLR	10022	+	158	5191398	76092
chr11	5115306	5315306	harbor1	chr11	5191559	5191966	LTR/ERVL-MaLR	2382	+	204	5191763	76457
chr11	76580390	76780390	harbor1	chr11	76580211	76580391	LTR/ERVL-MaLR	892	+	90	76580301	89
chr11	76580390	76780390	harbor1	chr11	76596508	76596942	LTR/ERVL-MaLR	1760	+	217	76596725	16335
chr11	76580390	76780390	harbor1	chr11	76601030	76601131	LTR/ERVL-MaLR	1424	+	50	76601080	20690
chr11	76580390	76780390	harbor1	chr11	76601436	76601695	LTR/ERVL-MaLR	1424	+	130	76601566	21176
chr11	76580390	76780390	harbor1	chr11	76641037	76641400	LTR/ERVL-MaLR	1804	+	182	76641219	60829
chr11	76580390	76780390	harbor1	chr11	76641690	76641752	LTR/ERVL-MaLR	1804	+	31	76641721	61331
chr11	5127184	5327184	harbor1	chr11	5189162	5189564	LTR/ERVL-MaLR	2124	+	201	5189363	62179
chr11	5127184	5327184	harbor1	chr11	5189565	5190876	LTR/ERVL-MaLR	10022	+	656	5190221	63037
chr11	5127184	5327184	harbor1	chr11	5191240	5191557	LTR/ERVL-MaLR	10022	+	158	5191398	64214
chr11	5127184	5327184	harbor1	chr11	5191559	5191966	LTR/ERVL-MaLR	2382	+	204	5191763	64579
chr11	5124787	5324787	harbor1	chr11	5189162	5189564	LTR/ERVL-MaLR	2124	+	201	5189363	64576
chr11	5124787	5324787	harbor1	chr11	5189565	5190876	LTR/ERVL-MaLR	10022	+	656	5190221	65434
chr11	5124787	5324787	harbor1	chr11	5191240	5191557	LTR/ERVL-MaLR	10022	+	158	5191398	66611
chr11	5124787	5324787	harbor1	chr11	5191559	5191966	LTR/ERVL-MaLR	2382	+	204	5191763	66976
chr11	5127327	5327327	harbor1	chr11	5189162	5189564	LTR/ERVL-MaLR	2124	+	201	5189363	62036
chr11	5127327	5327327	harbor1	chr11	5189565	5190876	LTR/ERVL-MaLR	10022	+	656	5190221	62894
chr11	5127327	5327327	harbor1	chr11	5191240	5191557	LTR/ERVL-MaLR	10022	+	158	5191398	64071
chr11	5127327	5327327	harbor1	chr11	5191559	5191966	LTR/ERVL-MaLR	2382	+	204	5191763	64436
chr11	76580446	76780446	harbor1	chr11	76596508	76596942	LTR/ERVL-MaLR	1760	+	217	76596725	16279
chr11	76580446	76780446	harbor1	chr11	76601030	76601131	LTR/ERVL-MaLR	1424	+	50	76601080	20634
chr11	76580446	76780446	harbor1	chr11	76601436	76601695	LTR/ERVL-MaLR	1424	+	130	76601566	21120
chr11	76580446	76780446	harbor1	chr11	76641037	76641400	LTR/ERVL-MaLR	1804	+	182	76641219	60773
chr11	76580446	76780446	harbor1	chr11	76641690	76641752	LTR/ERVL-MaLR	1804	+	31	76641721	61275
chr11	27274218	27474218	harbor1	chr11	27276157	27276395	LTR/ERVL-MaLR	887	+	119	27276276	2058
chr11	27274218	27474218	harbor1	chr11	27287307	27287572	LTR/ERVL-MaLR	717	+	132	27287439	13221
chr11	27274218	27474218	harbor1	chr11	27294120	27294539	LTR/ERVL-MaLR	2223	+	210	27294330	20112
chr11	27274218	27474218	harbor1	chr11	27307395	27307795	LTR/ERVL-MaLR	733	+	200	27307595	33377
chr11	27274218	27474218	harbor1	chr11	27341838	27342177	LTR/ERVL-MaLR	2032	+	170	27342008	67790
chr11	27274218	27474218	harbor1	chr11	27346716	27347094	LTR/ERVL-MaLR	1764	+	189	27346905	72687
chr11	19768628	19968628	harbor1	chr11	19851747	19852226	LTR/ERVL-MaLR	2802	+	240	19851987	83359
chr11	5134586	5334586	harbor1	chr11	5189162	5189564	LTR/ERVL-MaLR	2124	+	201	5189363	54777
chr11	5134586	5334586	harbor1	chr11	5189565	5190876	LTR/ERVL-MaLR	10022	+	656	5190221	55635
chr11	5134586	5334586	harbor1	chr11	5191240	5191557	LTR/ERVL-MaLR	10022	+	158	5191398	56812
chr11	5134586	5334586	harbor1	chr11	5191559	5191966	LTR/ERVL-MaLR	2382	+	204	5191763	57177
chr11	126556684	126756684	harbor1	chr11	126567089	126567505	LTR/ERVL-MaLR	1612	+	208	126567297	10613
chr11	126556684	126756684	harbor1	chr11	126598282	126598728	LTR/ERVL-MaLR	639	+	223	126598505	41821
chr11	126556684	126756684	harbor1	chr11	126599886	126600448	LTR/ERVL-MaLR	2102	+	281	126600167	43483
chr11	126556684	126756684	harbor1	chr11	126617916	126618420	LTR/ERVL-MaLR	1981	+	252	126618168	61484
chr11	126556684	126756684	harbor1	chr11	126618725	126618770	LTR/ERVL-MaLR	1981	+	22	126618747	62063
chr11	126556684	126756684	harbor1	chr11	126633136	126633203	LTR/ERVL-MaLR	1110	+	34	126633170	76486
chr11	126556684	126756684	harbor1	chr11	126633363	126633753	LTR/ERVL-MaLR	2099	+	195	126633558	76874
chr11	126556684	126756684	harbor1	chr11	126647943	126648306	LTR/ERVL-MaLR	2004	+	182	126648125	91441
chr11	5127250	5327250	harbor1	chr11	5189162	5189564	LTR/ERVL-MaLR	2124	+	201	5189363	62113
chr11	5127250	5327250	harbor1	chr11	5189565	5190876	LTR/ERVL-MaLR	10022	+	656	5190221	62971
chr11	5127250	5327250	harbor1	chr11	5191240	5191557	LTR/ERVL-MaLR	10022	+	158	5191398	64148
chr11	5127250	5327250	harbor1	chr11	5191559	5191966	LTR/ERVL-MaLR	2382	+	204	5191763	64513
chr11	5134209	5334209	harbor1	chr11	5189162	5189564	LTR/ERVL-MaLR	2124	+	201	5189363	55154
chr11	5134209	5334209	harbor1	chr11	5189565	5190876	LTR/ERVL-MaLR	10022	+	656	5190221	56012
chr11	5134209	5334209	harbor1	chr11	5191240	5191557	LTR/ERVL-MaLR	10022	+	158	5191398	57189
chr11	5134209	5334209	harbor1	chr11	5191559	5191966	LTR/ERVL-MaLR	2382	+	204	5191763	57554
chr11	5134629	5334629	harbor1	chr11	5189162	5189564	LTR/ERVL-MaLR	2124	+	201	5189363	54734
chr11	5134629	5334629	harbor1	chr11	5189565	5190876	LTR/ERVL-MaLR	10022	+	656	5190221	55592
chr11	5134629	5334629	harbor1	chr11	5191240	5191557	LTR/ERVL-MaLR	10022	+	158	5191398	56769
chr11	5134629	5334629	harbor1	chr11	5191559	5191966	LTR/ERVL-MaLR	2382	+	204	5191763	57134
chr11	5127213	5327213	harbor1	chr11	5189162	5189564	LTR/ERVL-MaLR	2124	+	201	5189363	62150
chr11	5127213	5327213	harbor1	chr11	5189565	5190876	LTR/ERVL-MaLR	10022	+	656	5190221	63008
chr11	5127213	5327213	harbor1	chr11	5191240	5191557	LTR/ERVL-MaLR	10022	+	158	5191398	64185
chr11	5127213	5327213	harbor1	chr11	5191559	5191966	LTR/ERVL-MaLR	2382	+	204	5191763	64550
chr11	4538274	4738274	harbor1	chr11	4573042	4573193	LTR/ERVL-MaLR	586	+	76	4573118	34844
chr11	5127232	5327232	harbor1	chr11	5189162	5189564	LTR/ERVL-MaLR	2124	+	201	5189363	62131
chr11	5127232	5327232	harbor1	chr11	5189565	5190876	LTR/ERVL-MaLR	10022	+	656	5190221	62989
chr11	5127232	5327232	harbor1	chr11	5191240	5191557	LTR/ERVL-MaLR	10022	+	158	5191398	64166
chr11	5127232	5327232	harbor1	chr11	5191559	5191966	LTR/ERVL-MaLR	2382	+	204	5191763	64531
chr11	5127319	5327319	harbor1	chr11	5189162	5189564	LTR/ERVL-MaLR	2124	+	201	5189363	62044
chr11	5127319	5327319	harbor1	chr11	5189565	5190876	LTR/ERVL-MaLR	10022	+	656	5190221	62902
chr11	5127319	5327319	harbor1	chr11	5191240	5191557	LTR/ERVL-MaLR	10022	+	158	5191398	64079
chr11	5127319	5327319	harbor1	chr11	5191559	5191966	LTR/ERVL-MaLR	2382	+	204	5191763	64444
chr11	107049890	107249890	harbor1	chr11	107050522	107050871	LTR/ERVL-MaLR	1954	+	174	107050696	806
chr11	107049890	107249890	harbor1	chr11	107050872	107052304	LTR/ERVL-MaLR	9889	+	716	107051588	1698
chr11	107049890	107249890	harbor1	chr11	107052305	107052646	LTR/ERVL-MaLR	2170	+	170	107052475	2585
chr11	107049890	107249890	harbor1	chr11	107060487	107060808	LTR/ERVL-MaLR	1651	+	160	107060647	10757
chr11	107049890	107249890	harbor1	chr11	107060979	107061108	LTR/ERVL-MaLR	684	+	64	107061043	11153
chr11	107049890	107249890	harbor1	chr11	107113256	107113475	LTR/ERVL-MaLR	802	+	110	107113366	63476
chr11	107049890	107249890	harbor1	chr11	107118018	107118407	LTR/ERVL-MaLR	1963	+	194	107118212	68322
chr11	107049890	107249890	harbor1	chr11	107137011	107137337	LTR/ERVL-MaLR	1504	+	163	107137174	87284
chr11	107049890	107249890	harbor1	chr11	107069020	107069448	LTR/ERVL-MaLR	2588	+	214	107069234	19344
chr11	111440849	111640849	harbor1	chr11	111532281	111532722	LTR/ERVL-MaLR	1992	+	220	111532501	91652
chr11	5125172	5325172	harbor1	chr11	5189162	5189564	LTR/ERVL-MaLR	2124	+	201	5189363	64191
chr11	5125172	5325172	harbor1	chr11	5189565	5190876	LTR/ERVL-MaLR	10022	+	656	5190221	65049
chr11	5125172	5325172	harbor1	chr11	5191240	5191557	LTR/ERVL-MaLR	10022	+	158	5191398	66226
chr11	5125172	5325172	harbor1	chr11	5191559	5191966	LTR/ERVL-MaLR	2382	+	204	5191763	66591
chr11	5127224	5327224	harbor1	chr11	5189162	5189564	LTR/ERVL-MaLR	2124	+	201	5189363	62139
chr11	5127224	5327224	harbor1	chr11	5189565	5190876	LTR/ERVL-MaLR	10022	+	656	5190221	62997
chr11	5127224	5327224	harbor1	chr11	5191240	5191557	LTR/ERVL-MaLR	10022	+	158	5191398	64174
chr11	5127224	5327224	harbor1	chr11	5191559	5191966	LTR/ERVL-MaLR	2382	+	204	5191763	64539
chr11	64913893	65113893	harbor1	chr11	64992404	64992572	LTR/ERVL-MaLR	664	+	84	64992488	78595
chr11	64913893	65113893	harbor1	chr11	64993439	64993593	LTR/ERVL-MaLR	864	+	77	64993516	79623
chr11	64913893	65113893	harbor1	chr11	65007835	65008154	LTR/ERVL-MaLR	914	+	160	65007995	94102
chr11	5126003	5326003	harbor1	chr11	5189162	5189564	LTR/ERVL-MaLR	2124	+	201	5189363	63360
chr11	5126003	5326003	harbor1	chr11	5189565	5190876	LTR/ERVL-MaLR	10022	+	656	5190221	64218
chr11	5126003	5326003	harbor1	chr11	5191240	5191557	LTR/ERVL-MaLR	10022	+	158	5191398	65395
chr11	5126003	5326003	harbor1	chr11	5191559	5191966	LTR/ERVL-MaLR	2382	+	204	5191763	65760
chr11	86572156	86772156	harbor1	chr11	86591279	86591579	LTR/ERVL-MaLR	2135	+	150	86591429	19273
chr11	86572156	86772156	harbor1	chr11	86591929	86592025	LTR/ERVL-MaLR	2135	+	48	86591977	19821
chr11	86572156	86772156	harbor1	chr11	86618558	86618719	LTR/ERVL-MaLR	2409	+	80	86618638	46482
chr11	86572156	86772156	harbor1	chr11	86619009	86619262	LTR/ERVL-MaLR	2409	+	126	86619135	46979
chr11	86572156	86772156	harbor1	chr11	86619426	86619787	LTR/ERVL-MaLR	2289	+	180	86619606	47450
chr11	86572156	86772156	harbor1	chr11	86623868	86624133	LTR/ERVL-MaLR	538	+	132	86624000	51844
chr11	86572156	86772156	harbor1	chr11	86635232	86635458	LTR/ERVL-MaLR	741	+	113	86635345	63189
chr11	86572156	86772156	harbor1	chr11	86635459	86635804	LTR/ERVL-MaLR	1423	+	172	86635631	63475
chr11	86572156	86772156	harbor1	chr11	86666088	86666261	LTR/ERVL-MaLR	706	+	86	86666174	94018
chr11	124700607	124900607	harbor1	chr11	124703953	124704348	LTR/ERVL-MaLR	1594	+	198	124704151	3544
chr11	5127146	5327146	harbor1	chr11	5189162	5189564	LTR/ERVL-MaLR	2124	+	201	5189363	62217
chr11	5127146	5327146	harbor1	chr11	5189565	5190876	LTR/ERVL-MaLR	10022	+	656	5190221	63075
chr11	5127146	5327146	harbor1	chr11	5191240	5191557	LTR/ERVL-MaLR	10022	+	158	5191398	64252
chr11	5127146	5327146	harbor1	chr11	5191559	5191966	LTR/ERVL-MaLR	2382	+	204	5191763	64617
chr11	5022390	5222390	harbor1	chr11	5066179	5066467	LTR/ERVL-MaLR	674	+	144	5066323	43933
chr11	5022390	5222390	harbor1	chr11	5099106	5099479	LTR/ERVL-MaLR	2325	+	186	5099292	76902
chr11	69539284	69739284	harbor1	chr11	69543422	69543834	LTR/ERVL-MaLR	1729	+	206	69543628	4344
chr11	69539284	69739284	harbor1	chr11	69545601	69546024	LTR/ERVL-MaLR	1293	+	212	69545813	6529
chr11	69539284	69739284	harbor1	chr11	69564264	69564703	LTR/ERVL-MaLR	1214	+	220	69564484	25200
chr11	69539284	69739284	harbor1	chr11	69579097	69579507	LTR/ERVL-MaLR	1084	+	205	69579302	40018
chr11	69539284	69739284	harbor1	chr11	69581054	69581449	LTR/ERVL-MaLR	1112	+	198	69581252	41968
chr11	69539284	69739284	harbor1	chr11	69591077	69591148	LTR/ERVL-MaLR	412	+	36	69591113	51829
chr11	69539284	69739284	harbor1	chr11	69591418	69591791	LTR/ERVL-MaLR	1530	+	186	69591604	52320
chr11	69539284	69739284	harbor1	chr11	69592087	69592373	LTR/ERVL-MaLR	1263	+	143	69592230	52946
chr11	69539284	69739284	harbor1	chr11	69593970	69594387	LTR/ERVL-MaLR	722	+	208	69594178	54894
chr11	69539284	69739284	harbor1	chr11	69595200	69595543	LTR/ERVL-MaLR	2007	+	172	69595372	56088
chr11	69539284	69739284	harbor1	chr11	69598488	69598761	LTR/ERVL-MaLR	900	+	136	69598624	59340
chr11	69539284	69739284	harbor1	chr11	69602192	69602573	LTR/ERVL-MaLR	1784	+	190	69602382	63098
chr11	5124920	5324920	harbor1	chr11	5189162	5189564	LTR/ERVL-MaLR	2124	+	201	5189363	64443
chr11	5124920	5324920	harbor1	chr11	5189565	5190876	LTR/ERVL-MaLR	10022	+	656	5190221	65301
chr11	5124920	5324920	harbor1	chr11	5191240	5191557	LTR/ERVL-MaLR	10022	+	158	5191398	66478
chr11	5124920	5324920	harbor1	chr11	5191559	5191966	LTR/ERVL-MaLR	2382	+	204	5191763	66843
chr11	76580636	76780636	harbor1	chr11	76596508	76596942	LTR/ERVL-MaLR	1760	+	217	76596725	16089
chr11	76580636	76780636	harbor1	chr11	76601030	76601131	LTR/ERVL-MaLR	1424	+	50	76601080	20444
chr11	76580636	76780636	harbor1	chr11	76601436	76601695	LTR/ERVL-MaLR	1424	+	130	76601566	20930
chr11	76580636	76780636	harbor1	chr11	76641037	76641400	LTR/ERVL-MaLR	1804	+	182	76641219	60583
chr11	76580636	76780636	harbor1	chr11	76641690	76641752	LTR/ERVL-MaLR	1804	+	31	76641721	61085
chr11	5134651	5334651	harbor1	chr11	5189162	5189564	LTR/ERVL-MaLR	2124	+	201	5189363	54712
chr11	5134651	5334651	harbor1	chr11	5189565	5190876	LTR/ERVL-MaLR	10022	+	656	5190221	55570
chr11	5134651	5334651	harbor1	chr11	5191240	5191557	LTR/ERVL-MaLR	10022	+	158	5191398	56747
chr11	5134651	5334651	harbor1	chr11	5191559	5191966	LTR/ERVL-MaLR	2382	+	204	5191763	57112
chr11	5134616	5334616	harbor1	chr11	5189162	5189564	LTR/ERVL-MaLR	2124	+	201	5189363	54747
chr11	5134616	5334616	harbor1	chr11	5189565	5190876	LTR/ERVL-MaLR	10022	+	656	5190221	55605
chr11	5134616	5334616	harbor1	chr11	5191240	5191557	LTR/ERVL-MaLR	10022	+	158	5191398	56782
chr11	5134616	5334616	harbor1	chr11	5191559	5191966	LTR/ERVL-MaLR	2382	+	204	5191763	57147
chr11	5031398	5231398	harbor1	chr11	5066179	5066467	LTR/ERVL-MaLR	674	+	144	5066323	34925
chr11	5031398	5231398	harbor1	chr11	5099106	5099479	LTR/ERVL-MaLR	2325	+	186	5099292	67894
chr11	5127345	5327345	harbor1	chr11	5189162	5189564	LTR/ERVL-MaLR	2124	+	201	5189363	62018
chr11	5127345	5327345	harbor1	chr11	5189565	5190876	LTR/ERVL-MaLR	10022	+	656	5190221	62876
chr11	5127345	5327345	harbor1	chr11	5191240	5191557	LTR/ERVL-MaLR	10022	+	158	5191398	64053
chr11	5127345	5327345	harbor1	chr11	5191559	5191966	LTR/ERVL-MaLR	2382	+	204	5191763	64418
chr11	5134104	5334104	harbor1	chr11	5189162	5189564	LTR/ERVL-MaLR	2124	+	201	5189363	55259
chr11	5134104	5334104	harbor1	chr11	5189565	5190876	LTR/ERVL-MaLR	10022	+	656	5190221	56117
chr11	5134104	5334104	harbor1	chr11	5191240	5191557	LTR/ERVL-MaLR	10022	+	158	5191398	57294
chr11	5134104	5334104	harbor1	chr11	5191559	5191966	LTR/ERVL-MaLR	2382	+	204	5191763	57659
chr11	72123561	72323561	harbor1	chr11	72168208	72168569	LTR/ERVL-MaLR	2299	+	180	72168388	44827
chr11	72123561	72323561	harbor1	chr11	72168570	72168941	LTR/ERVL-MaLR	11927	+	186	72168756	45195
chr11	72123561	72323561	harbor1	chr11	72169258	72170470	LTR/ERVL-MaLR	11927	+	606	72169864	46303
chr11	72123561	72323561	harbor1	chr11	72170471	72170829	LTR/ERVL-MaLR	2205	+	179	72170650	47089
chr11	72123561	72323561	harbor1	chr11	72209124	72209502	LTR/ERVL-MaLR	2249	+	189	72209313	85752
chr11	5124806	5324806	harbor1	chr11	5189162	5189564	LTR/ERVL-MaLR	2124	+	201	5189363	64557
chr11	5124806	5324806	harbor1	chr11	5189565	5190876	LTR/ERVL-MaLR	10022	+	656	5190221	65415
chr11	5124806	5324806	harbor1	chr11	5191240	5191557	LTR/ERVL-MaLR	10022	+	158	5191398	66592
chr11	5124806	5324806	harbor1	chr11	5191559	5191966	LTR/ERVL-MaLR	2382	+	204	5191763	66957
chr11	5125352	5325352	harbor1	chr11	5189162	5189564	LTR/ERVL-MaLR	2124	+	201	5189363	64011
chr11	5125352	5325352	harbor1	chr11	5189565	5190876	LTR/ERVL-MaLR	10022	+	656	5190221	64869
chr11	5125352	5325352	harbor1	chr11	5191240	5191557	LTR/ERVL-MaLR	10022	+	158	5191398	66046
chr11	5125352	5325352	harbor1	chr11	5191559	5191966	LTR/ERVL-MaLR	2382	+	204	5191763	66411
chr11	86572150	86772150	harbor1	chr11	86591279	86591579	LTR/ERVL-MaLR	2135	+	150	86591429	19279
chr11	86572150	86772150	harbor1	chr11	86591929	86592025	LTR/ERVL-MaLR	2135	+	48	86591977	19827
chr11	86572150	86772150	harbor1	chr11	86618558	86618719	LTR/ERVL-MaLR	2409	+	80	86618638	46488
chr11	86572150	86772150	harbor1	chr11	86619009	86619262	LTR/ERVL-MaLR	2409	+	126	86619135	46985
chr11	86572150	86772150	harbor1	chr11	86619426	86619787	LTR/ERVL-MaLR	2289	+	180	86619606	47456
chr11	86572150	86772150	harbor1	chr11	86623868	86624133	LTR/ERVL-MaLR	538	+	132	86624000	51850
chr11	86572150	86772150	harbor1	chr11	86635232	86635458	LTR/ERVL-MaLR	741	+	113	86635345	63195
chr11	86572150	86772150	harbor1	chr11	86635459	86635804	LTR/ERVL-MaLR	1423	+	172	86635631	63481
chr11	86572150	86772150	harbor1	chr11	86666088	86666261	LTR/ERVL-MaLR	706	+	86	86666174	94024
chr11	5127230	5327230	harbor1	chr11	5189162	5189564	LTR/ERVL-MaLR	2124	+	201	5189363	62133
chr11	5127230	5327230	harbor1	chr11	5189565	5190876	LTR/ERVL-MaLR	10022	+	656	5190221	62991
chr11	5127230	5327230	harbor1	chr11	5191240	5191557	LTR/ERVL-MaLR	10022	+	158	5191398	64168
chr11	5127230	5327230	harbor1	chr11	5191559	5191966	LTR/ERVL-MaLR	2382	+	204	5191763	64533
chr11	5125771	5325771	harbor1	chr11	5189162	5189564	LTR/ERVL-MaLR	2124	+	201	5189363	63592
chr11	5125771	5325771	harbor1	chr11	5189565	5190876	LTR/ERVL-MaLR	10022	+	656	5190221	64450
chr11	5125771	5325771	harbor1	chr11	5191240	5191557	LTR/ERVL-MaLR	10022	+	158	5191398	65627
chr11	5125771	5325771	harbor1	chr11	5191559	5191966	LTR/ERVL-MaLR	2382	+	204	5191763	65992
chr11	5127185	5327185	harbor1	chr11	5189162	5189564	LTR/ERVL-MaLR	2124	+	201	5189363	62178
chr11	5127185	5327185	harbor1	chr11	5189565	5190876	LTR/ERVL-MaLR	10022	+	656	5190221	63036
chr11	5127185	5327185	harbor1	chr11	5191240	5191557	LTR/ERVL-MaLR	10022	+	158	5191398	64213
chr11	5127185	5327185	harbor1	chr11	5191559	5191966	LTR/ERVL-MaLR	2382	+	204	5191763	64578
chr11	5134100	5334100	harbor1	chr11	5189162	5189564	LTR/ERVL-MaLR	2124	+	201	5189363	55263
chr11	5134100	5334100	harbor1	chr11	5189565	5190876	LTR/ERVL-MaLR	10022	+	656	5190221	56121
chr11	5134100	5334100	harbor1	chr11	5191240	5191557	LTR/ERVL-MaLR	10022	+	158	5191398	57298
chr11	5134100	5334100	harbor1	chr11	5191559	5191966	LTR/ERVL-MaLR	2382	+	204	5191763	57663
chr11	5134575	5334575	harbor1	chr11	5189162	5189564	LTR/ERVL-MaLR	2124	+	201	5189363	54788
chr11	5134575	5334575	harbor1	chr11	5189565	5190876	LTR/ERVL-MaLR	10022	+	656	5190221	55646
chr11	5134575	5334575	harbor1	chr11	5191240	5191557	LTR/ERVL-MaLR	10022	+	158	5191398	56823
chr11	5134575	5334575	harbor1	chr11	5191559	5191966	LTR/ERVL-MaLR	2382	+	204	5191763	57188
chr11	6140855	6340855	harbor1	chr11	6220022	6220497	LTR/ERVL-MaLR	927	+	238	6220260	79405
chr11	5127304	5327304	harbor1	chr11	5189162	5189564	LTR/ERVL-MaLR	2124	+	201	5189363	62059
chr11	5127304	5327304	harbor1	chr11	5189565	5190876	LTR/ERVL-MaLR	10022	+	656	5190221	62917
chr11	5127304	5327304	harbor1	chr11	5191240	5191557	LTR/ERVL-MaLR	10022	+	158	5191398	64094
chr11	5127304	5327304	harbor1	chr11	5191559	5191966	LTR/ERVL-MaLR	2382	+	204	5191763	64459
chr11	5024680	5224680	harbor1	chr11	5066179	5066467	LTR/ERVL-MaLR	674	+	144	5066323	41643
chr11	5024680	5224680	harbor1	chr11	5099106	5099479	LTR/ERVL-MaLR	2325	+	186	5099292	74612
chr11	20060703	20260703	harbor1	chr11	20126309	20126700	LTR/ERVL-MaLR	963	+	196	20126505	65802
chr11	20060703	20260703	harbor1	chr11	20127087	20127448	LTR/ERVL-MaLR	1767	+	180	20127267	66564
chr11	20060703	20260703	harbor1	chr11	20136300	20136684	LTR/ERVL-MaLR	703	+	192	20136492	75789
chr11	20060703	20260703	harbor1	chr11	20141313	20141659	LTR/ERVL-MaLR	2363	+	173	20141486	80783
chr11	5134650	5334650	harbor1	chr11	5189162	5189564	LTR/ERVL-MaLR	2124	+	201	5189363	54713
chr11	5134650	5334650	harbor1	chr11	5189565	5190876	LTR/ERVL-MaLR	10022	+	656	5190221	55571
chr11	5134650	5334650	harbor1	chr11	5191240	5191557	LTR/ERVL-MaLR	10022	+	158	5191398	56748
chr11	5134650	5334650	harbor1	chr11	5191559	5191966	LTR/ERVL-MaLR	2382	+	204	5191763	57113
chr11	5125398	5325398	harbor1	chr11	5189162	5189564	LTR/ERVL-MaLR	2124	+	201	5189363	63965
chr11	5125398	5325398	harbor1	chr11	5189565	5190876	LTR/ERVL-MaLR	10022	+	656	5190221	64823
chr11	5125398	5325398	harbor1	chr11	5191240	5191557	LTR/ERVL-MaLR	10022	+	158	5191398	66000
chr11	5125398	5325398	harbor1	chr11	5191559	5191966	LTR/ERVL-MaLR	2382	+	204	5191763	66365
chr11	64806660	65006660	harbor1	chr11	64884902	64885231	LTR/ERVL-MaLR	1380	+	164	64885066	78406
chr11	6512331	6712331	harbor1	chr11	6565209	6565380	LTR/ERVL-MaLR	476	+	86	6565295	52964
chr11	46430260	46630260	harbor1	chr11	46479276	46479478	LTR/ERVL-MaLR	612	+	101	46479377	49117
chr11	46430260	46630260	harbor1	chr11	46479695	46479824	LTR/ERVL-MaLR	612	+	64	46479759	49499
chr11	46430260	46630260	harbor1	chr11	46480308	46480475	LTR/ERVL-MaLR	612	+	84	46480392	50132
chr11	46430260	46630260	harbor1	chr11	46526284	46526810	LTR/ERVL-MaLR	463	+	263	46526547	96287
chr11	5127284	5327284	harbor1	chr11	5189162	5189564	LTR/ERVL-MaLR	2124	+	201	5189363	62079
chr11	5127284	5327284	harbor1	chr11	5189565	5190876	LTR/ERVL-MaLR	10022	+	656	5190221	62937
chr11	5127284	5327284	harbor1	chr11	5191240	5191557	LTR/ERVL-MaLR	10022	+	158	5191398	64114
chr11	5127284	5327284	harbor1	chr11	5191559	5191966	LTR/ERVL-MaLR	2382	+	204	5191763	64479
chr11	5124821	5324821	harbor1	chr11	5189162	5189564	LTR/ERVL-MaLR	2124	+	201	5189363	64542
chr11	5124821	5324821	harbor1	chr11	5189565	5190876	LTR/ERVL-MaLR	10022	+	656	5190221	65400
chr11	5124821	5324821	harbor1	chr11	5191240	5191557	LTR/ERVL-MaLR	10022	+	158	5191398	66577
chr11	5124821	5324821	harbor1	chr11	5191559	5191966	LTR/ERVL-MaLR	2382	+	204	5191763	66942
chr11	5127245	5327245	harbor1	chr11	5189162	5189564	LTR/ERVL-MaLR	2124	+	201	5189363	62118
chr11	5127245	5327245	harbor1	chr11	5189565	5190876	LTR/ERVL-MaLR	10022	+	656	5190221	62976
chr11	5127245	5327245	harbor1	chr11	5191240	5191557	LTR/ERVL-MaLR	10022	+	158	5191398	64153
chr11	5127245	5327245	harbor1	chr11	5191559	5191966	LTR/ERVL-MaLR	2382	+	204	5191763	64518
chr11	5126970	5326970	harbor1	chr11	5189162	5189564	LTR/ERVL-MaLR	2124	+	201	5189363	62393
chr11	5126970	5326970	harbor1	chr11	5189565	5190876	LTR/ERVL-MaLR	10022	+	656	5190221	63251
chr11	5126970	5326970	harbor1	chr11	5191240	5191557	LTR/ERVL-MaLR	10022	+	158	5191398	64428
chr11	5126970	5326970	harbor1	chr11	5191559	5191966	LTR/ERVL-MaLR	2382	+	204	5191763	64793
chr11	5052446	5252446	harbor1	chr11	5066179	5066467	LTR/ERVL-MaLR	674	+	144	5066323	13877
chr11	5052446	5252446	harbor1	chr11	5099106	5099479	LTR/ERVL-MaLR	2325	+	186	5099292	46846
chr11	5127167	5327167	harbor1	chr11	5189162	5189564	LTR/ERVL-MaLR	2124	+	201	5189363	62196
chr11	5127167	5327167	harbor1	chr11	5189565	5190876	LTR/ERVL-MaLR	10022	+	656	5190221	63054
chr11	5127167	5327167	harbor1	chr11	5191240	5191557	LTR/ERVL-MaLR	10022	+	158	5191398	64231
chr11	5127167	5327167	harbor1	chr11	5191559	5191966	LTR/ERVL-MaLR	2382	+	204	5191763	64596
chr11	5126888	5326888	harbor1	chr11	5189162	5189564	LTR/ERVL-MaLR	2124	+	201	5189363	62475
chr11	5126888	5326888	harbor1	chr11	5189565	5190876	LTR/ERVL-MaLR	10022	+	656	5190221	63333
chr11	5126888	5326888	harbor1	chr11	5191240	5191557	LTR/ERVL-MaLR	10022	+	158	5191398	64510
chr11	5126888	5326888	harbor1	chr11	5191559	5191966	LTR/ERVL-MaLR	2382	+	204	5191763	64875
chr11	63713415	63913415	harbor1	chr11	63776327	63776682	LTR/ERVL-MaLR	2489	+	178	63776505	63090
chr11	63713415	63913415	harbor1	chr11	63779755	63779879	LTR/ERVL-MaLR	440	+	62	63779817	66402
chr11	63713415	63913415	harbor1	chr11	63779883	63780322	LTR/ERVL-MaLR	1318	+	220	63780103	66688
chr11	5021372	5221372	harbor1	chr11	5066179	5066467	LTR/ERVL-MaLR	674	+	144	5066323	44951
chr11	5021372	5221372	harbor1	chr11	5099106	5099479	LTR/ERVL-MaLR	2325	+	186	5099292	77920
chr11	5125946	5325946	harbor1	chr11	5189162	5189564	LTR/ERVL-MaLR	2124	+	201	5189363	63417
chr11	5125946	5325946	harbor1	chr11	5189565	5190876	LTR/ERVL-MaLR	10022	+	656	5190221	64275
chr11	5125946	5325946	harbor1	chr11	5191240	5191557	LTR/ERVL-MaLR	10022	+	158	5191398	65452
chr11	5125946	5325946	harbor1	chr11	5191559	5191966	LTR/ERVL-MaLR	2382	+	204	5191763	65817
chr11	1470223	1670223	harbor1	chr11	1477441	1477801	LTR/ERVL-MaLR	583	+	180	1477621	7398
chr11	1470223	1670223	harbor1	chr11	1497293	1497454	LTR/ERVL-MaLR	496	+	80	1497373	27150
chr11	1470223	1670223	harbor1	chr11	1512672	1512790	LTR/ERVL-MaLR	465	+	59	1512731	42508
chr11	1470223	1670223	harbor1	chr11	1512969	1513245	LTR/ERVL-MaLR	619	+	138	1513107	42884
chr11	1470223	1670223	harbor1	chr11	1538165	1538523	LTR/ERVL-MaLR	504	+	179	1538344	68121
chr11	1470223	1670223	harbor1	chr11	1540607	1540693	LTR/ERVL-MaLR	765	+	43	1540650	70427
chr11	1470223	1670223	harbor1	chr11	1540986	1541205	LTR/ERVL-MaLR	765	+	110	1541096	70873
chr11	1470223	1670223	harbor1	chr11	1545362	1545501	LTR/ERVL-MaLR	744	+	70	1545432	75209
chr11	86275379	86475379	harbor1	chr11	86296325	86296724	LTR/ERVL-MaLR	1390	+	200	86296525	21146
chr11	86275379	86475379	harbor1	chr11	86336306	86336671	LTR/ERVL-MaLR	1939	+	182	86336488	61109
chr11	86275379	86475379	harbor1	chr11	86369691	86370094	LTR/ERVL-MaLR	2225	+	202	86369893	94514
chr11	86275379	86475379	harbor1	chr11	86370165	86370593	LTR/ERVL-MaLR	2065	+	214	86370379	95000
chr11	5127149	5327149	harbor1	chr11	5189162	5189564	LTR/ERVL-MaLR	2124	+	201	5189363	62214
chr11	5127149	5327149	harbor1	chr11	5189565	5190876	LTR/ERVL-MaLR	10022	+	656	5190221	63072
chr11	5127149	5327149	harbor1	chr11	5191240	5191557	LTR/ERVL-MaLR	10022	+	158	5191398	64249
chr11	5127149	5327149	harbor1	chr11	5191559	5191966	LTR/ERVL-MaLR	2382	+	204	5191763	64614
chr11	64537978	64737978	harbor1	chr11	64585088	64585330	LTR/ERVL-MaLR	483	+	121	64585209	47231
chr11	64537978	64737978	harbor1	chr11	64613559	64613760	LTR/ERVL-MaLR	449	+	100	64613659	75681
chr11	64537978	64737978	harbor1	chr11	64613830	64614368	LTR/ERVL-MaLR	1438	+	269	64614099	76121
chr11	64537978	64737978	harbor1	chr11	64614384	64614992	LTR/ERVL-MaLR	1556	+	304	64614688	76710
chr11	64537978	64737978	harbor1	chr11	64615000	64615402	LTR/ERVL-MaLR	823	+	201	64615201	77223
chr11	4897645	5097645	harbor1	chr11	4932235	4932726	LTR/ERVL-MaLR	617	+	246	4932481	34836
chr11	4897645	5097645	harbor1	chr11	4977890	4978268	LTR/ERVL-MaLR	1857	+	189	4978079	80434
chr11	5126804	5326804	harbor1	chr11	5189162	5189564	LTR/ERVL-MaLR	2124	+	201	5189363	62559
chr11	5126804	5326804	harbor1	chr11	5189565	5190876	LTR/ERVL-MaLR	10022	+	656	5190221	63417
chr11	5126804	5326804	harbor1	chr11	5191240	5191557	LTR/ERVL-MaLR	10022	+	158	5191398	64594
chr11	5126804	5326804	harbor1	chr11	5191559	5191966	LTR/ERVL-MaLR	2382	+	204	5191763	64959
chr11	76580403	76780403	harbor1	chr11	76596508	76596942	LTR/ERVL-MaLR	1760	+	217	76596725	16322
chr11	76580403	76780403	harbor1	chr11	76601030	76601131	LTR/ERVL-MaLR	1424	+	50	76601080	20677
chr11	76580403	76780403	harbor1	chr11	76601436	76601695	LTR/ERVL-MaLR	1424	+	130	76601566	21163
chr11	76580403	76780403	harbor1	chr11	76641037	76641400	LTR/ERVL-MaLR	1804	+	182	76641219	60816
chr11	76580403	76780403	harbor1	chr11	76641690	76641752	LTR/ERVL-MaLR	1804	+	31	76641721	61318
chr11	67117644	67317644	harbor1	chr11	67185327	67185350	LTR/ERVL-MaLR	1352	+	12	67185339	67695
chr11	67117644	67317644	harbor1	chr11	67185653	67185987	LTR/ERVL-MaLR	1352	+	167	67185820	68176
chr11	2054434	2254434	harbor1	chr11	2087160	2087567	LTR/ERVL-MaLR	2660	+	204	2087364	32930
chr11	2054434	2254434	harbor1	chr11	2089287	2089620	LTR/ERVL-MaLR	439	+	166	2089453	35019
chr11	5134605	5334605	harbor1	chr11	5189162	5189564	LTR/ERVL-MaLR	2124	+	201	5189363	54758
chr11	5134605	5334605	harbor1	chr11	5189565	5190876	LTR/ERVL-MaLR	10022	+	656	5190221	55616
chr11	5134605	5334605	harbor1	chr11	5191240	5191557	LTR/ERVL-MaLR	10022	+	158	5191398	56793
chr11	5134605	5334605	harbor1	chr11	5191559	5191966	LTR/ERVL-MaLR	2382	+	204	5191763	57158
chr11	5125064	5325064	harbor1	chr11	5189162	5189564	LTR/ERVL-MaLR	2124	+	201	5189363	64299
chr11	5125064	5325064	harbor1	chr11	5189565	5190876	LTR/ERVL-MaLR	10022	+	656	5190221	65157
chr11	5125064	5325064	harbor1	chr11	5191240	5191557	LTR/ERVL-MaLR	10022	+	158	5191398	66334
chr11	5125064	5325064	harbor1	chr11	5191559	5191966	LTR/ERVL-MaLR	2382	+	204	5191763	66699
chr11	5125194	5325194	harbor1	chr11	5189162	5189564	LTR/ERVL-MaLR	2124	+	201	5189363	64169
chr11	5125194	5325194	harbor1	chr11	5189565	5190876	LTR/ERVL-MaLR	10022	+	656	5190221	65027
chr11	5125194	5325194	harbor1	chr11	5191240	5191557	LTR/ERVL-MaLR	10022	+	158	5191398	66204
chr11	5125194	5325194	harbor1	chr11	5191559	5191966	LTR/ERVL-MaLR	2382	+	204	5191763	66569
chr11	16505296	16705296	harbor1	chr11	16505029	16506610	LTR/ERVL-MaLR	10588	+	790	16505819	523
chr11	16505296	16705296	harbor1	chr11	16506613	16506782	LTR/ERVL-MaLR	1711	+	84	16506697	1401
chr11	16505296	16705296	harbor1	chr11	16507069	16507324	LTR/ERVL-MaLR	1711	+	128	16507197	1901
chr11	16505296	16705296	harbor1	chr11	16527577	16527888	LTR/ERVL-MaLR	466	+	156	16527733	22437
chr11	129769693	129969693	harbor1	chr11	129790945	129791321	LTR/ERVL-MaLR	1936	+	188	129791133	21440
chr11	129769693	129969693	harbor1	chr11	129833316	129833492	LTR/ERVL-MaLR	2232	+	88	129833404	63711
chr11	129769693	129969693	harbor1	chr11	129833786	129834004	LTR/ERVL-MaLR	2232	+	109	129833895	64202
chr11	129769693	129969693	harbor1	chr11	129834005	129834149	LTR/ERVL-MaLR	5235	+	72	129834077	64384
chr11	129769693	129969693	harbor1	chr11	129834447	129834529	LTR/ERVL-MaLR	5235	+	41	129834488	64795
chr11	129769693	129969693	harbor1	chr11	129834841	129835835	LTR/ERVL-MaLR	5235	+	497	129835338	65645
chr11	129769693	129969693	harbor1	chr11	129836137	129836477	LTR/ERVL-MaLR	5235	+	170	129836307	66614
chr11	129769693	129969693	harbor1	chr11	129836480	129836791	LTR/ERVL-MaLR	1498	+	156	129836636	66943
chr11	76580432	76780432	harbor1	chr11	76596508	76596942	LTR/ERVL-MaLR	1760	+	217	76596725	16293
chr11	76580432	76780432	harbor1	chr11	76601030	76601131	LTR/ERVL-MaLR	1424	+	50	76601080	20648
chr11	76580432	76780432	harbor1	chr11	76601436	76601695	LTR/ERVL-MaLR	1424	+	130	76601566	21134
chr11	76580432	76780432	harbor1	chr11	76641037	76641400	LTR/ERVL-MaLR	1804	+	182	76641219	60787
chr11	76580432	76780432	harbor1	chr11	76641690	76641752	LTR/ERVL-MaLR	1804	+	31	76641721	61289
chr11	64538016	64738016	harbor1	chr11	64585088	64585330	LTR/ERVL-MaLR	483	+	121	64585209	47193
chr11	64538016	64738016	harbor1	chr11	64613559	64613760	LTR/ERVL-MaLR	449	+	100	64613659	75643
chr11	64538016	64738016	harbor1	chr11	64613830	64614368	LTR/ERVL-MaLR	1438	+	269	64614099	76083
chr11	64538016	64738016	harbor1	chr11	64614384	64614992	LTR/ERVL-MaLR	1556	+	304	64614688	76672
chr11	64538016	64738016	harbor1	chr11	64615000	64615402	LTR/ERVL-MaLR	823	+	201	64615201	77185
chr11	5126793	5326793	harbor1	chr11	5189162	5189564	LTR/ERVL-MaLR	2124	+	201	5189363	62570
chr11	5126793	5326793	harbor1	chr11	5189565	5190876	LTR/ERVL-MaLR	10022	+	656	5190221	63428
chr11	5126793	5326793	harbor1	chr11	5191240	5191557	LTR/ERVL-MaLR	10022	+	158	5191398	64605
chr11	5126793	5326793	harbor1	chr11	5191559	5191966	LTR/ERVL-MaLR	2382	+	204	5191763	64970
chr11	461137	661137	harbor1	chr11	505269	505590	LTR/ERVL-MaLR	645	+	160	505429	44292
chr11	5134533	5334533	harbor1	chr11	5189162	5189564	LTR/ERVL-MaLR	2124	+	201	5189363	54830
chr11	5134533	5334533	harbor1	chr11	5189565	5190876	LTR/ERVL-MaLR	10022	+	656	5190221	55688
chr11	5134533	5334533	harbor1	chr11	5191240	5191557	LTR/ERVL-MaLR	10022	+	158	5191398	56865
chr11	5134533	5334533	harbor1	chr11	5191559	5191966	LTR/ERVL-MaLR	2382	+	204	5191763	57230
chr11	5127205	5327205	harbor1	chr11	5189162	5189564	LTR/ERVL-MaLR	2124	+	201	5189363	62158
chr11	5127205	5327205	harbor1	chr11	5189565	5190876	LTR/ERVL-MaLR	10022	+	656	5190221	63016
chr11	5127205	5327205	harbor1	chr11	5191240	5191557	LTR/ERVL-MaLR	10022	+	158	5191398	64193
chr11	5127205	5327205	harbor1	chr11	5191559	5191966	LTR/ERVL-MaLR	2382	+	204	5191763	64558
chr11	119001792	119201792	harbor1	chr11	119006714	119007066	LTR/ERVL-MaLR	1952	+	176	119006890	5098
chr11	5127241	5327241	harbor1	chr11	5189162	5189564	LTR/ERVL-MaLR	2124	+	201	5189363	62122
chr11	5127241	5327241	harbor1	chr11	5189565	5190876	LTR/ERVL-MaLR	10022	+	656	5190221	62980
chr11	5127241	5327241	harbor1	chr11	5191240	5191557	LTR/ERVL-MaLR	10022	+	158	5191398	64157
chr11	5127241	5327241	harbor1	chr11	5191559	5191966	LTR/ERVL-MaLR	2382	+	204	5191763	64522
chr11	76580985	76780985	harbor1	chr11	76596508	76596942	LTR/ERVL-MaLR	1760	+	217	76596725	15740
chr11	76580985	76780985	harbor1	chr11	76601030	76601131	LTR/ERVL-MaLR	1424	+	50	76601080	20095
chr11	76580985	76780985	harbor1	chr11	76601436	76601695	LTR/ERVL-MaLR	1424	+	130	76601566	20581
chr11	76580985	76780985	harbor1	chr11	76641037	76641400	LTR/ERVL-MaLR	1804	+	182	76641219	60234
chr11	76580985	76780985	harbor1	chr11	76641690	76641752	LTR/ERVL-MaLR	1804	+	31	76641721	60736
chr11	5127169	5327169	harbor1	chr11	5189162	5189564	LTR/ERVL-MaLR	2124	+	201	5189363	62194
chr11	5127169	5327169	harbor1	chr11	5189565	5190876	LTR/ERVL-MaLR	10022	+	656	5190221	63052
chr11	5127169	5327169	harbor1	chr11	5191240	5191557	LTR/ERVL-MaLR	10022	+	158	5191398	64229
chr11	5127169	5327169	harbor1	chr11	5191559	5191966	LTR/ERVL-MaLR	2382	+	204	5191763	64594
chr11	5134210	5334210	harbor1	chr11	5189162	5189564	LTR/ERVL-MaLR	2124	+	201	5189363	55153
chr11	5134210	5334210	harbor1	chr11	5189565	5190876	LTR/ERVL-MaLR	10022	+	656	5190221	56011
chr11	5134210	5334210	harbor1	chr11	5191240	5191557	LTR/ERVL-MaLR	10022	+	158	5191398	57188
chr11	5134210	5334210	harbor1	chr11	5191559	5191966	LTR/ERVL-MaLR	2382	+	204	5191763	57553
chr11	64348932	64548932	harbor1	chr11	64387976	64388356	LTR/ERVL-MaLR	1337	+	190	64388166	39234
chr11	64348932	64548932	harbor1	chr11	64398526	64398894	LTR/ERVL-MaLR	1649	+	184	64398710	49778
chr11	64348932	64548932	harbor1	chr11	64402763	64403165	LTR/ERVL-MaLR	1638	+	201	64402964	54032
chr11	64348932	64548932	harbor1	chr11	64432105	64432688	LTR/ERVL-MaLR	572	+	292	64432397	83465
chr11	64348932	64548932	harbor1	chr11	64444925	64445284	LTR/ERVL-MaLR	528	+	180	64445105	96173
chr11	64348932	64548932	harbor1	chr11	64445596	64445759	LTR/ERVL-MaLR	422	+	82	64445678	96746
chr11	64348932	64548932	harbor1	chr11	64445795	64445966	LTR/ERVL-MaLR	634	+	86	64445881	96949
chr11	107909152	108109152	harbor1	chr11	107913611	107913890	LTR/ERVL-MaLR	881	+	140	107913751	4599
chr11	107909152	108109152	harbor1	chr11	107922453	107922533	LTR/ERVL-MaLR	2240	+	40	107922493	13341
chr11	107909152	108109152	harbor1	chr11	107922851	107923277	LTR/ERVL-MaLR	2240	+	213	107923064	13912
chr11	107909152	108109152	harbor1	chr11	107974800	107974853	LTR/ERVL-MaLR	1176	+	26	107974826	65674
chr11	107909152	108109152	harbor1	chr11	107975142	107975424	LTR/ERVL-MaLR	1176	+	141	107975283	66131
chr11	107909152	108109152	harbor1	chr11	107975877	107975963	LTR/ERVL-MaLR	503	+	43	107975920	66768
chr11	107909152	108109152	harbor1	chr11	107976281	107976346	LTR/ERVL-MaLR	430	+	32	107976313	67161
chr11	107909152	108109152	harbor1	chr11	107996969	107997428	LTR/ERVL-MaLR	2244	+	230	107997199	88047
chr11	5134609	5334609	harbor1	chr11	5189162	5189564	LTR/ERVL-MaLR	2124	+	201	5189363	54754
chr11	5134609	5334609	harbor1	chr11	5189565	5190876	LTR/ERVL-MaLR	10022	+	656	5190221	55612
chr11	5134609	5334609	harbor1	chr11	5191240	5191557	LTR/ERVL-MaLR	10022	+	158	5191398	56789
chr11	5134609	5334609	harbor1	chr11	5191559	5191966	LTR/ERVL-MaLR	2382	+	204	5191763	57154
chr11	5127154	5327154	harbor1	chr11	5189162	5189564	LTR/ERVL-MaLR	2124	+	201	5189363	62209
chr11	5127154	5327154	harbor1	chr11	5189565	5190876	LTR/ERVL-MaLR	10022	+	656	5190221	63067
chr11	5127154	5327154	harbor1	chr11	5191240	5191557	LTR/ERVL-MaLR	10022	+	158	5191398	64244
chr11	5127154	5327154	harbor1	chr11	5191559	5191966	LTR/ERVL-MaLR	2382	+	204	5191763	64609
chr11	5127316	5327316	harbor1	chr11	5189162	5189564	LTR/ERVL-MaLR	2124	+	201	5189363	62047
chr11	5127316	5327316	harbor1	chr11	5189565	5190876	LTR/ERVL-MaLR	10022	+	656	5190221	62905
chr11	5127316	5327316	harbor1	chr11	5191240	5191557	LTR/ERVL-MaLR	10022	+	158	5191398	64082
chr11	5127316	5327316	harbor1	chr11	5191559	5191966	LTR/ERVL-MaLR	2382	+	204	5191763	64447
chr11	5131436	5331436	harbor1	chr11	5189162	5189564	LTR/ERVL-MaLR	2124	+	201	5189363	57927
chr11	5131436	5331436	harbor1	chr11	5189565	5190876	LTR/ERVL-MaLR	10022	+	656	5190221	58785
chr11	5131436	5331436	harbor1	chr11	5191240	5191557	LTR/ERVL-MaLR	10022	+	158	5191398	59962
chr11	5131436	5331436	harbor1	chr11	5191559	5191966	LTR/ERVL-MaLR	2382	+	204	5191763	60327
chr11	5127298	5327298	harbor1	chr11	5189162	5189564	LTR/ERVL-MaLR	2124	+	201	5189363	62065
chr11	5127298	5327298	harbor1	chr11	5189565	5190876	LTR/ERVL-MaLR	10022	+	656	5190221	62923
chr11	5127298	5327298	harbor1	chr11	5191240	5191557	LTR/ERVL-MaLR	10022	+	158	5191398	64100
chr11	5127298	5327298	harbor1	chr11	5191559	5191966	LTR/ERVL-MaLR	2382	+	204	5191763	64465
chr11	5134612	5334612	harbor1	chr11	5189162	5189564	LTR/ERVL-MaLR	2124	+	201	5189363	54751
chr11	5134612	5334612	harbor1	chr11	5189565	5190876	LTR/ERVL-MaLR	10022	+	656	5190221	55609
chr11	5134612	5334612	harbor1	chr11	5191240	5191557	LTR/ERVL-MaLR	10022	+	158	5191398	56786
chr11	5134612	5334612	harbor1	chr11	5191559	5191966	LTR/ERVL-MaLR	2382	+	204	5191763	57151
chr11	74201768	74401768	harbor1	chr11	74210433	74210853	LTR/ERVL-MaLR	2203	+	210	74210643	8875
chr11	74201768	74401768	harbor1	chr11	74284310	74284484	LTR/ERVL-MaLR	775	+	87	74284397	82629
chr11	5134643	5334643	harbor1	chr11	5189162	5189564	LTR/ERVL-MaLR	2124	+	201	5189363	54720
chr11	5134643	5334643	harbor1	chr11	5189565	5190876	LTR/ERVL-MaLR	10022	+	656	5190221	55578
chr11	5134643	5334643	harbor1	chr11	5191240	5191557	LTR/ERVL-MaLR	10022	+	158	5191398	56755
chr11	5134643	5334643	harbor1	chr11	5191559	5191966	LTR/ERVL-MaLR	2382	+	204	5191763	57120
chr11	43448357	43648357	harbor1	chr11	43462202	43462679	LTR/ERVL-MaLR	1646	+	238	43462440	14083
chr11	43448357	43648357	harbor1	chr11	43475254	43475367	LTR/ERVL-MaLR	891	+	56	43475310	26953
chr11	43448357	43648357	harbor1	chr11	43525586	43525977	LTR/ERVL-MaLR	2149	+	196	43525782	77425
chr11	43448357	43648357	harbor1	chr11	43531564	43532033	LTR/ERVL-MaLR	1638	+	234	43531798	83441
chr11	43448357	43648357	harbor1	chr11	43543159	43543515	LTR/ERVL-MaLR	459	+	178	43543337	94980
chr11	43448357	43648357	harbor1	chr11	43543559	43544100	LTR/ERVL-MaLR	954	+	270	43543829	95472
chr11	43448357	43648357	harbor1	chr11	43544601	43544971	LTR/ERVL-MaLR	2480	+	185	43544786	96429
chr11	43448357	43648357	harbor1	chr11	43545733	43546057	LTR/ERVL-MaLR	757	+	162	43545895	97538
chr11	61485519	61685519	harbor1	chr11	61492358	61492579	LTR/ERVL-MaLR	1093	+	110	61492468	6949
chr11	61485519	61685519	harbor1	chr11	61493063	61493206	LTR/ERVL-MaLR	901	+	72	61493135	7616
chr11	133199713	133399713	harbor1	chr11	133244510	133244901	LTR/ERVL-MaLR	2044	+	196	133244706	44993
chr11	133199713	133399713	harbor1	chr11	133267635	133267996	LTR/ERVL-MaLR	2767	+	180	133267815	68102
chr11	133199713	133399713	harbor1	chr11	133274183	133274635	LTR/ERVL-MaLR	1279	+	226	133274409	74696
chr11	133199713	133399713	harbor1	chr11	133281185	133281572	LTR/ERVL-MaLR	2207	+	194	133281379	81666
chr11	133199713	133399713	harbor1	chr11	133281575	133283162	LTR/ERVL-MaLR	8371	+	794	133282369	82656
chr11	133199713	133399713	harbor1	chr11	133283163	133283605	LTR/ERVL-MaLR	2059	+	221	133283384	83671
chr11	5127228	5327228	harbor1	chr11	5189162	5189564	LTR/ERVL-MaLR	2124	+	201	5189363	62135
chr11	5127228	5327228	harbor1	chr11	5189565	5190876	LTR/ERVL-MaLR	10022	+	656	5190221	62993
chr11	5127228	5327228	harbor1	chr11	5191240	5191557	LTR/ERVL-MaLR	10022	+	158	5191398	64170
chr11	5127228	5327228	harbor1	chr11	5191559	5191966	LTR/ERVL-MaLR	2382	+	204	5191763	64535
chr11	5127118	5327118	harbor1	chr11	5189162	5189564	LTR/ERVL-MaLR	2124	+	201	5189363	62245
chr11	5127118	5327118	harbor1	chr11	5189565	5190876	LTR/ERVL-MaLR	10022	+	656	5190221	63103
chr11	5127118	5327118	harbor1	chr11	5191240	5191557	LTR/ERVL-MaLR	10022	+	158	5191398	64280
chr11	5127118	5327118	harbor1	chr11	5191559	5191966	LTR/ERVL-MaLR	2382	+	204	5191763	64645
chr11	68332235	68532235	harbor1	chr11	68380898	68381338	LTR/ERVL-MaLR	996	+	220	68381118	48883
chr11	69539187	69739187	harbor1	chr11	69543422	69543834	LTR/ERVL-MaLR	1729	+	206	69543628	4441
chr11	69539187	69739187	harbor1	chr11	69545601	69546024	LTR/ERVL-MaLR	1293	+	212	69545813	6626
chr11	69539187	69739187	harbor1	chr11	69564264	69564703	LTR/ERVL-MaLR	1214	+	220	69564484	25297
chr11	69539187	69739187	harbor1	chr11	69579097	69579507	LTR/ERVL-MaLR	1084	+	205	69579302	40115
chr11	69539187	69739187	harbor1	chr11	69581054	69581449	LTR/ERVL-MaLR	1112	+	198	69581252	42065
chr11	69539187	69739187	harbor1	chr11	69591077	69591148	LTR/ERVL-MaLR	412	+	36	69591113	51926
chr11	69539187	69739187	harbor1	chr11	69591418	69591791	LTR/ERVL-MaLR	1530	+	186	69591604	52417
chr11	69539187	69739187	harbor1	chr11	69592087	69592373	LTR/ERVL-MaLR	1263	+	143	69592230	53043
chr11	69539187	69739187	harbor1	chr11	69593970	69594387	LTR/ERVL-MaLR	722	+	208	69594178	54991
chr11	69539187	69739187	harbor1	chr11	69595200	69595543	LTR/ERVL-MaLR	2007	+	172	69595372	56185
chr11	69539187	69739187	harbor1	chr11	69598488	69598761	LTR/ERVL-MaLR	900	+	136	69598624	59437
chr11	69539187	69739187	harbor1	chr11	69602192	69602573	LTR/ERVL-MaLR	1784	+	190	69602382	63195
chr11	106965389	107165389	harbor1	chr11	107030203	107030701	LTR/ERVL-MaLR	2243	+	249	107030452	65063
chr11	106965389	107165389	harbor1	chr11	107050522	107050871	LTR/ERVL-MaLR	1954	+	174	107050696	85307
chr11	106965389	107165389	harbor1	chr11	107050872	107052304	LTR/ERVL-MaLR	9889	+	716	107051588	86199
chr11	106965389	107165389	harbor1	chr11	107052305	107052646	LTR/ERVL-MaLR	2170	+	170	107052475	87086
chr11	106965389	107165389	harbor1	chr11	107060487	107060808	LTR/ERVL-MaLR	1651	+	160	107060647	95258
chr11	106965389	107165389	harbor1	chr11	107060979	107061108	LTR/ERVL-MaLR	684	+	64	107061043	95654
chr11	5127079	5327079	harbor1	chr11	5189162	5189564	LTR/ERVL-MaLR	2124	+	201	5189363	62284
chr11	5127079	5327079	harbor1	chr11	5189565	5190876	LTR/ERVL-MaLR	10022	+	656	5190221	63142
chr11	5127079	5327079	harbor1	chr11	5191240	5191557	LTR/ERVL-MaLR	10022	+	158	5191398	64319
chr11	5127079	5327079	harbor1	chr11	5191559	5191966	LTR/ERVL-MaLR	2382	+	204	5191763	64684
chr11	61385568	61585568	harbor1	chr11	61408637	61408814	LTR/ERVL-MaLR	620	+	88	61408725	23157
chr11	61385568	61585568	harbor1	chr11	61445350	61445476	LTR/ERVL-MaLR	438	+	63	61445413	59845
chr11	61385568	61585568	harbor1	chr11	61452764	61453035	LTR/ERVL-MaLR	725	+	136	61452900	67332
chr11	61385568	61585568	harbor1	chr11	61453733	61454615	LTR/ERVL-MaLR	2330	+	441	61454174	68606
chr11	61385568	61585568	harbor1	chr11	61454630	61454839	LTR/ERVL-MaLR	800	+	104	61454734	69166
chr11	61385568	61585568	harbor1	chr11	61467645	61468003	LTR/ERVL-MaLR	2498	+	179	61467824	82256
chr11	5127261	5327261	harbor1	chr11	5189162	5189564	LTR/ERVL-MaLR	2124	+	201	5189363	62102
chr11	5127261	5327261	harbor1	chr11	5189565	5190876	LTR/ERVL-MaLR	10022	+	656	5190221	62960
chr11	5127261	5327261	harbor1	chr11	5191240	5191557	LTR/ERVL-MaLR	10022	+	158	5191398	64137
chr11	5127261	5327261	harbor1	chr11	5191559	5191966	LTR/ERVL-MaLR	2382	+	204	5191763	64502
chr11	5127282	5327282	harbor1	chr11	5189162	5189564	LTR/ERVL-MaLR	2124	+	201	5189363	62081
chr11	5127282	5327282	harbor1	chr11	5189565	5190876	LTR/ERVL-MaLR	10022	+	656	5190221	62939
chr11	5127282	5327282	harbor1	chr11	5191240	5191557	LTR/ERVL-MaLR	10022	+	158	5191398	64116
chr11	5127282	5327282	harbor1	chr11	5191559	5191966	LTR/ERVL-MaLR	2382	+	204	5191763	64481
chr11	45786319	45986319	harbor1	chr11	45788970	45789267	LTR/ERVL-MaLR	1249	+	148	45789118	2799
chr11	45786319	45986319	harbor1	chr11	45789564	45789676	LTR/ERVL-MaLR	1249	+	56	45789620	3301
chr11	45786319	45986319	harbor1	chr11	45792040	45792193	LTR/ERVL-MaLR	1029	+	76	45792116	5797
chr11	45786319	45986319	harbor1	chr11	45792553	45792754	LTR/ERVL-MaLR	1029	+	100	45792653	6334
chr11	45786319	45986319	harbor1	chr11	45795471	45795797	LTR/ERVL-MaLR	521	+	163	45795634	9315
chr11	45786319	45986319	harbor1	chr11	45801452	45801825	LTR/ERVL-MaLR	1499	+	186	45801638	15319
chr11	45786319	45986319	harbor1	chr11	45820893	45820978	LTR/ERVL-MaLR	740	+	42	45820935	34616
chr11	45786319	45986319	harbor1	chr11	45821286	45821606	LTR/ERVL-MaLR	740	+	160	45821446	35127
chr11	45786319	45986319	harbor1	chr11	45827198	45827351	LTR/ERVL-MaLR	491	+	76	45827274	40955
chr11	10653639	10853639	harbor1	chr11	10664650	10665046	LTR/ERVL-MaLR	635	+	198	10664848	11209
chr11	10653639	10853639	harbor1	chr11	10670580	10670987	LTR/ERVL-MaLR	2163	+	204	10670784	17145
chr11	10653639	10853639	harbor1	chr11	10676412	10676837	LTR/ERVL-MaLR	719	+	212	10676624	22985
chr11	10653639	10853639	harbor1	chr11	10698558	10698724	LTR/ERVL-MaLR	1232	+	83	10698641	45002
chr11	10653639	10853639	harbor1	chr11	10700279	10700445	LTR/ERVL-MaLR	2319	+	83	10700362	46723
chr11	10653639	10853639	harbor1	chr11	10700755	10700973	LTR/ERVL-MaLR	2319	+	109	10700864	47225
chr11	10653639	10853639	harbor1	chr11	10716915	10717168	LTR/ERVL-MaLR	639	+	126	10717041	63402
chr11	10653639	10853639	harbor1	chr11	10721047	10721456	LTR/ERVL-MaLR	1868	+	204	10721251	67612
chr11	10653639	10853639	harbor1	chr11	10731138	10731182	LTR/ERVL-MaLR	476	+	22	10731160	77521
chr11	10653639	10853639	harbor1	chr11	10731918	10731941	LTR/ERVL-MaLR	476	+	12	10731930	78291
chr11	10653639	10853639	harbor1	chr11	10731979	10732072	LTR/ERVL-MaLR	476	+	46	10732025	78386
chr11	10653639	10853639	harbor1	chr11	10746484	10746877	LTR/ERVL-MaLR	2283	+	196	10746680	93041
chr11	10653639	10853639	harbor1	chr11	10698727	10700278	LTR/ERVL-MaLR	11671	+	776	10699503	45864
chr11	103833171	104033171	harbor1	chr11	103890111	103890473	LTR/ERVL-MaLR	1691	+	181	103890292	57121
chr11	103833171	104033171	harbor1	chr11	103900225	103900573	LTR/ERVL-MaLR	2029	+	174	103900399	67228
chr11	5127153	5327153	harbor1	chr11	5189162	5189564	LTR/ERVL-MaLR	2124	+	201	5189363	62210
chr11	5127153	5327153	harbor1	chr11	5189565	5190876	LTR/ERVL-MaLR	10022	+	656	5190221	63068
chr11	5127153	5327153	harbor1	chr11	5191240	5191557	LTR/ERVL-MaLR	10022	+	158	5191398	64245
chr11	5127153	5327153	harbor1	chr11	5191559	5191966	LTR/ERVL-MaLR	2382	+	204	5191763	64610
chr11	47086439	47286439	harbor1	chr11	47091617	47092030	LTR/ERVL-MaLR	1510	+	206	47091823	5384
chr11	5127126	5327126	harbor1	chr11	5189162	5189564	LTR/ERVL-MaLR	2124	+	201	5189363	62237
chr11	5127126	5327126	harbor1	chr11	5189565	5190876	LTR/ERVL-MaLR	10022	+	656	5190221	63095
chr11	5127126	5327126	harbor1	chr11	5191240	5191557	LTR/ERVL-MaLR	10022	+	158	5191398	64272
chr11	5127126	5327126	harbor1	chr11	5191559	5191966	LTR/ERVL-MaLR	2382	+	204	5191763	64637
chr11	69539232	69739232	harbor1	chr11	69543422	69543834	LTR/ERVL-MaLR	1729	+	206	69543628	4396
chr11	69539232	69739232	harbor1	chr11	69545601	69546024	LTR/ERVL-MaLR	1293	+	212	69545813	6581
chr11	69539232	69739232	harbor1	chr11	69564264	69564703	LTR/ERVL-MaLR	1214	+	220	69564484	25252
chr11	69539232	69739232	harbor1	chr11	69579097	69579507	LTR/ERVL-MaLR	1084	+	205	69579302	40070
chr11	69539232	69739232	harbor1	chr11	69581054	69581449	LTR/ERVL-MaLR	1112	+	198	69581252	42020
chr11	69539232	69739232	harbor1	chr11	69591077	69591148	LTR/ERVL-MaLR	412	+	36	69591113	51881
chr11	69539232	69739232	harbor1	chr11	69591418	69591791	LTR/ERVL-MaLR	1530	+	186	69591604	52372
chr11	69539232	69739232	harbor1	chr11	69592087	69592373	LTR/ERVL-MaLR	1263	+	143	69592230	52998
chr11	69539232	69739232	harbor1	chr11	69593970	69594387	LTR/ERVL-MaLR	722	+	208	69594178	54946
chr11	69539232	69739232	harbor1	chr11	69595200	69595543	LTR/ERVL-MaLR	2007	+	172	69595372	56140
chr11	69539232	69739232	harbor1	chr11	69598488	69598761	LTR/ERVL-MaLR	900	+	136	69598624	59392
chr11	69539232	69739232	harbor1	chr11	69602192	69602573	LTR/ERVL-MaLR	1784	+	190	69602382	63150
chr11	5029745	5229745	harbor1	chr11	5066179	5066467	LTR/ERVL-MaLR	674	+	144	5066323	36578
chr11	5029745	5229745	harbor1	chr11	5099106	5099479	LTR/ERVL-MaLR	2325	+	186	5099292	69547
chr11	5127166	5327166	harbor1	chr11	5189162	5189564	LTR/ERVL-MaLR	2124	+	201	5189363	62197
chr11	5127166	5327166	harbor1	chr11	5189565	5190876	LTR/ERVL-MaLR	10022	+	656	5190221	63055
chr11	5127166	5327166	harbor1	chr11	5191240	5191557	LTR/ERVL-MaLR	10022	+	158	5191398	64232
chr11	5127166	5327166	harbor1	chr11	5191559	5191966	LTR/ERVL-MaLR	2382	+	204	5191763	64597
chr11	2054516	2254516	harbor1	chr11	2087160	2087567	LTR/ERVL-MaLR	2660	+	204	2087364	32848
chr11	2054516	2254516	harbor1	chr11	2089287	2089620	LTR/ERVL-MaLR	439	+	166	2089453	34937
chr11	5125272	5325272	harbor1	chr11	5189162	5189564	LTR/ERVL-MaLR	2124	+	201	5189363	64091
chr11	5125272	5325272	harbor1	chr11	5189565	5190876	LTR/ERVL-MaLR	10022	+	656	5190221	64949
chr11	5125272	5325272	harbor1	chr11	5191240	5191557	LTR/ERVL-MaLR	10022	+	158	5191398	66126
chr11	5125272	5325272	harbor1	chr11	5191559	5191966	LTR/ERVL-MaLR	2382	+	204	5191763	66491
chr11	5126765	5326765	harbor1	chr11	5189162	5189564	LTR/ERVL-MaLR	2124	+	201	5189363	62598
chr11	5126765	5326765	harbor1	chr11	5189565	5190876	LTR/ERVL-MaLR	10022	+	656	5190221	63456
chr11	5126765	5326765	harbor1	chr11	5191240	5191557	LTR/ERVL-MaLR	10022	+	158	5191398	64633
chr11	5126765	5326765	harbor1	chr11	5191559	5191966	LTR/ERVL-MaLR	2382	+	204	5191763	64998
chr11	5132426	5332426	harbor1	chr11	5189162	5189564	LTR/ERVL-MaLR	2124	+	201	5189363	56937
chr11	5132426	5332426	harbor1	chr11	5189565	5190876	LTR/ERVL-MaLR	10022	+	656	5190221	57795
chr11	5132426	5332426	harbor1	chr11	5191240	5191557	LTR/ERVL-MaLR	10022	+	158	5191398	58972
chr11	5132426	5332426	harbor1	chr11	5191559	5191966	LTR/ERVL-MaLR	2382	+	204	5191763	59337
chr11	65109998	65309998	harbor1	chr11	65147326	65147587	LTR/ERVL-MaLR	760	+	130	65147456	37458
chr11	65109998	65309998	harbor1	chr11	65147904	65148089	LTR/ERVL-MaLR	693	+	92	65147996	37998
chr11	65109998	65309998	harbor1	chr11	65152459	65152500	LTR/ERVL-MaLR	2177	+	20	65152479	42481
chr11	65109998	65309998	harbor1	chr11	65152843	65153312	LTR/ERVL-MaLR	2177	+	234	65153077	43079
chr11	65109998	65309998	harbor1	chr11	65168192	65168297	LTR/ERVL-MaLR	749	+	52	65168244	58246
chr11	65109998	65309998	harbor1	chr11	65168589	65168668	LTR/ERVL-MaLR	749	+	40	65168629	58631
chr11	5127151	5327151	harbor1	chr11	5189162	5189564	LTR/ERVL-MaLR	2124	+	201	5189363	62212
chr11	5127151	5327151	harbor1	chr11	5189565	5190876	LTR/ERVL-MaLR	10022	+	656	5190221	63070
chr11	5127151	5327151	harbor1	chr11	5191240	5191557	LTR/ERVL-MaLR	10022	+	158	5191398	64247
chr11	5127151	5327151	harbor1	chr11	5191559	5191966	LTR/ERVL-MaLR	2382	+	204	5191763	64612
chr11	5127128	5327128	harbor1	chr11	5189162	5189564	LTR/ERVL-MaLR	2124	+	201	5189363	62235
chr11	5127128	5327128	harbor1	chr11	5189565	5190876	LTR/ERVL-MaLR	10022	+	656	5190221	63093
chr11	5127128	5327128	harbor1	chr11	5191240	5191557	LTR/ERVL-MaLR	10022	+	158	5191398	64270
chr11	5127128	5327128	harbor1	chr11	5191559	5191966	LTR/ERVL-MaLR	2382	+	204	5191763	64635
chr11	69539231	69739231	harbor1	chr11	69543422	69543834	LTR/ERVL-MaLR	1729	+	206	69543628	4397
chr11	69539231	69739231	harbor1	chr11	69545601	69546024	LTR/ERVL-MaLR	1293	+	212	69545813	6582
chr11	69539231	69739231	harbor1	chr11	69564264	69564703	LTR/ERVL-MaLR	1214	+	220	69564484	25253
chr11	69539231	69739231	harbor1	chr11	69579097	69579507	LTR/ERVL-MaLR	1084	+	205	69579302	40071
chr11	69539231	69739231	harbor1	chr11	69581054	69581449	LTR/ERVL-MaLR	1112	+	198	69581252	42021
chr11	69539231	69739231	harbor1	chr11	69591077	69591148	LTR/ERVL-MaLR	412	+	36	69591113	51882
chr11	69539231	69739231	harbor1	chr11	69591418	69591791	LTR/ERVL-MaLR	1530	+	186	69591604	52373
chr11	69539231	69739231	harbor1	chr11	69592087	69592373	LTR/ERVL-MaLR	1263	+	143	69592230	52999
chr11	69539231	69739231	harbor1	chr11	69593970	69594387	LTR/ERVL-MaLR	722	+	208	69594178	54947
chr11	69539231	69739231	harbor1	chr11	69595200	69595543	LTR/ERVL-MaLR	2007	+	172	69595372	56141
chr11	69539231	69739231	harbor1	chr11	69598488	69598761	LTR/ERVL-MaLR	900	+	136	69598624	59393
chr11	69539231	69739231	harbor1	chr11	69602192	69602573	LTR/ERVL-MaLR	1784	+	190	69602382	63151
chr11	19964004	20164004	harbor1	chr11	19989092	19989572	LTR/ERVL-MaLR	1668	+	240	19989332	25328
chr11	682162	882162	harbor1	chr11	732570	732715	LTR/ERVL-MaLR	1005	+	72	732642	50480
chr11	682162	882162	harbor1	chr11	732980	733262	LTR/ERVL-MaLR	1005	+	141	733121	50959
chr11	682162	882162	harbor1	chr11	767613	767848	LTR/ERVL-MaLR	482	+	118	767731	85569
chr11	682162	882162	harbor1	chr11	768151	768193	LTR/ERVL-MaLR	482	+	21	768172	86010
chr11	5134590	5334590	harbor1	chr11	5189162	5189564	LTR/ERVL-MaLR	2124	+	201	5189363	54773
chr11	5134590	5334590	harbor1	chr11	5189565	5190876	LTR/ERVL-MaLR	10022	+	656	5190221	55631
chr11	5134590	5334590	harbor1	chr11	5191240	5191557	LTR/ERVL-MaLR	10022	+	158	5191398	56808
chr11	5134590	5334590	harbor1	chr11	5191559	5191966	LTR/ERVL-MaLR	2382	+	204	5191763	57173
chr11	76580343	76780343	harbor1	chr11	76580211	76580391	LTR/ERVL-MaLR	892	+	90	76580301	42
chr11	76580343	76780343	harbor1	chr11	76596508	76596942	LTR/ERVL-MaLR	1760	+	217	76596725	16382
chr11	76580343	76780343	harbor1	chr11	76601030	76601131	LTR/ERVL-MaLR	1424	+	50	76601080	20737
chr11	76580343	76780343	harbor1	chr11	76601436	76601695	LTR/ERVL-MaLR	1424	+	130	76601566	21223
chr11	76580343	76780343	harbor1	chr11	76641037	76641400	LTR/ERVL-MaLR	1804	+	182	76641219	60876
chr11	76580343	76780343	harbor1	chr11	76641690	76641752	LTR/ERVL-MaLR	1804	+	31	76641721	61378
chr11	5134611	5334611	harbor1	chr11	5189162	5189564	LTR/ERVL-MaLR	2124	+	201	5189363	54752
chr11	5134611	5334611	harbor1	chr11	5189565	5190876	LTR/ERVL-MaLR	10022	+	656	5190221	55610
chr11	5134611	5334611	harbor1	chr11	5191240	5191557	LTR/ERVL-MaLR	10022	+	158	5191398	56787
chr11	5134611	5334611	harbor1	chr11	5191559	5191966	LTR/ERVL-MaLR	2382	+	204	5191763	57152
chr11	108021604	108221604	harbor1	chr11	108114901	108115232	LTR/ERVL-MaLR	1129	+	166	108115067	93463
chr11	108021604	108221604	harbor1	chr11	108116572	108116980	LTR/ERVL-MaLR	1933	+	204	108116776	95172
chr11	108021604	108221604	harbor1	chr11	108116981	108117136	LTR/ERVL-MaLR	678	+	78	108117059	95455
chr11	126625737	126825737	harbor1	chr11	126633136	126633203	LTR/ERVL-MaLR	1110	+	34	126633170	7433
chr11	126625737	126825737	harbor1	chr11	126633363	126633753	LTR/ERVL-MaLR	2099	+	195	126633558	7821
chr11	126625737	126825737	harbor1	chr11	126647943	126648306	LTR/ERVL-MaLR	2004	+	182	126648125	22388
chr11	126625737	126825737	harbor1	chr11	126665401	126665751	LTR/ERVL-MaLR	2065	+	175	126665576	39839
chr11	126625737	126825737	harbor1	chr11	126678977	126679362	LTR/ERVL-MaLR	765	+	192	126679169	53432
chr11	126625737	126825737	harbor1	chr11	126692840	126693128	LTR/ERVL-MaLR	1085	+	144	126692984	67247
chr11	126625737	126825737	harbor1	chr11	126705229	126705652	LTR/ERVL-MaLR	2877	+	212	126705441	79704
chr11	126625737	126825737	harbor1	chr11	126705749	126706248	LTR/ERVL-MaLR	978	+	250	126705999	80262
chr11	126625737	126825737	harbor1	chr11	126709470	126709831	LTR/ERVL-MaLR	2191	+	180	126709650	83913
chr11	63739535	63939535	harbor1	chr11	63776327	63776682	LTR/ERVL-MaLR	2489	+	178	63776505	36970
chr11	63739535	63939535	harbor1	chr11	63779755	63779879	LTR/ERVL-MaLR	440	+	62	63779817	40282
chr11	63739535	63939535	harbor1	chr11	63779883	63780322	LTR/ERVL-MaLR	1318	+	220	63780103	40568
chr11	64537961	64737961	harbor1	chr11	64585088	64585330	LTR/ERVL-MaLR	483	+	121	64585209	47248
chr11	64537961	64737961	harbor1	chr11	64613559	64613760	LTR/ERVL-MaLR	449	+	100	64613659	75698
chr11	64537961	64737961	harbor1	chr11	64613830	64614368	LTR/ERVL-MaLR	1438	+	269	64614099	76138
chr11	64537961	64737961	harbor1	chr11	64614384	64614992	LTR/ERVL-MaLR	1556	+	304	64614688	76727
chr11	64537961	64737961	harbor1	chr11	64615000	64615402	LTR/ERVL-MaLR	823	+	201	64615201	77240
chr11	67166495	67366495	harbor1	chr11	67185327	67185350	LTR/ERVL-MaLR	1352	+	12	67185339	18844
chr11	67166495	67366495	harbor1	chr11	67185653	67185987	LTR/ERVL-MaLR	1352	+	167	67185820	19325
chr11	5127270	5327270	harbor1	chr11	5189162	5189564	LTR/ERVL-MaLR	2124	+	201	5189363	62093
chr11	5127270	5327270	harbor1	chr11	5189565	5190876	LTR/ERVL-MaLR	10022	+	656	5190221	62951
chr11	5127270	5327270	harbor1	chr11	5191240	5191557	LTR/ERVL-MaLR	10022	+	158	5191398	64128
chr11	5127270	5327270	harbor1	chr11	5191559	5191966	LTR/ERVL-MaLR	2382	+	204	5191763	64493
chr11	65948237	66148237	harbor1	chr11	66037265	66037632	LTR/ERVL-MaLR	2382	+	184	66037449	89212
chr11	65948237	66148237	harbor1	chr11	66037928	66037999	LTR/ERVL-MaLR	2382	+	36	66037964	89727
chr11	65948237	66148237	harbor1	chr11	66039894	66040284	LTR/ERVL-MaLR	1992	+	195	66040089	91852
chr11	65948237	66148237	harbor1	chr11	66043812	66044365	LTR/ERVL-MaLR	1778	+	276	66044088	95851
chr11	2054542	2254542	harbor1	chr11	2087160	2087567	LTR/ERVL-MaLR	2660	+	204	2087364	32822
chr11	2054542	2254542	harbor1	chr11	2089287	2089620	LTR/ERVL-MaLR	439	+	166	2089453	34911
chr11	360421	560421	harbor1	chr11	368467	368739	LTR/ERVL-MaLR	481	+	136	368603	8182
chr11	360421	560421	harbor1	chr11	422292	422479	LTR/ERVL-MaLR	516	+	94	422386	61965
chr11	360421	560421	harbor1	chr11	422615	422767	LTR/ERVL-MaLR	733	+	76	422691	62270
chr11	9514217	9714217	harbor1	chr11	9538774	9538837	LTR/ERVL-MaLR	408	+	32	9538806	24589
chr11	9514217	9714217	harbor1	chr11	9597065	9597238	LTR/ERVL-MaLR	442	+	86	9597151	82934
chr11	5134672	5334672	harbor1	chr11	5189162	5189564	LTR/ERVL-MaLR	2124	+	201	5189363	54691
chr11	5134672	5334672	harbor1	chr11	5189565	5190876	LTR/ERVL-MaLR	10022	+	656	5190221	55549
chr11	5134672	5334672	harbor1	chr11	5191240	5191557	LTR/ERVL-MaLR	10022	+	158	5191398	56726
chr11	5134672	5334672	harbor1	chr11	5191559	5191966	LTR/ERVL-MaLR	2382	+	204	5191763	57091
chr11	5134217	5334217	harbor1	chr11	5189162	5189564	LTR/ERVL-MaLR	2124	+	201	5189363	55146
chr11	5134217	5334217	harbor1	chr11	5189565	5190876	LTR/ERVL-MaLR	10022	+	656	5190221	56004
chr11	5134217	5334217	harbor1	chr11	5191240	5191557	LTR/ERVL-MaLR	10022	+	158	5191398	57181
chr11	5134217	5334217	harbor1	chr11	5191559	5191966	LTR/ERVL-MaLR	2382	+	204	5191763	57546
chr11	5134433	5334433	harbor1	chr11	5189162	5189564	LTR/ERVL-MaLR	2124	+	201	5189363	54930
chr11	5134433	5334433	harbor1	chr11	5189565	5190876	LTR/ERVL-MaLR	10022	+	656	5190221	55788
chr11	5134433	5334433	harbor1	chr11	5191240	5191557	LTR/ERVL-MaLR	10022	+	158	5191398	56965
chr11	5134433	5334433	harbor1	chr11	5191559	5191966	LTR/ERVL-MaLR	2382	+	204	5191763	57330
chr11	57399763	57599763	harbor1	chr11	57410705	57411062	LTR/ERVL-MaLR	2835	+	178	57410883	11120
chr11	57399763	57599763	harbor1	chr11	57417136	57417642	LTR/ERVL-MaLR	1555	+	253	57417389	17626
chr11	57399763	57599763	harbor1	chr11	57446230	57446646	LTR/ERVL-MaLR	744	+	208	57446438	46675
chr11	57399763	57599763	harbor1	chr11	57446953	57446999	LTR/ERVL-MaLR	744	+	23	57446976	47213
chr11	57399763	57599763	harbor1	chr11	57490336	57490804	LTR/ERVL-MaLR	1620	+	234	57490570	90807
chr11	3008641	3208641	harbor1	chr11	3059411	3059587	LTR/ERVL-MaLR	789	+	88	3059499	50858
chr11	3008641	3208641	harbor1	chr11	3060091	3060361	LTR/ERVL-MaLR	1243	+	135	3060226	51585
chr11	3008641	3208641	harbor1	chr11	3060895	3060973	LTR/ERVL-MaLR	1237	+	39	3060934	52293
chr11	3008641	3208641	harbor1	chr11	3061286	3061595	LTR/ERVL-MaLR	1237	+	154	3061440	52799
chr11	3008641	3208641	harbor1	chr11	3063251	3063719	LTR/ERVL-MaLR	3314	+	234	3063485	54844
chr11	3008641	3208641	harbor1	chr11	3088628	3088967	LTR/ERVL-MaLR	931	+	170	3088798	80157
chr11	3008641	3208641	harbor1	chr11	3063720	3063949	LTR/ERVL-MaLR	1342	+	114	3063834	55193
chr11	461170	661170	harbor1	chr11	505269	505590	LTR/ERVL-MaLR	645	+	160	505429	44259
chr11	5132683	5332683	harbor1	chr11	5189162	5189564	LTR/ERVL-MaLR	2124	+	201	5189363	56680
chr11	5132683	5332683	harbor1	chr11	5189565	5190876	LTR/ERVL-MaLR	10022	+	656	5190221	57538
chr11	5132683	5332683	harbor1	chr11	5191240	5191557	LTR/ERVL-MaLR	10022	+	158	5191398	58715
chr11	5132683	5332683	harbor1	chr11	5191559	5191966	LTR/ERVL-MaLR	2382	+	204	5191763	59080
chr11	5128063	5328063	harbor1	chr11	5189162	5189564	LTR/ERVL-MaLR	2124	+	201	5189363	61300
chr11	5128063	5328063	harbor1	chr11	5189565	5190876	LTR/ERVL-MaLR	10022	+	656	5190221	62158
chr11	5128063	5328063	harbor1	chr11	5191240	5191557	LTR/ERVL-MaLR	10022	+	158	5191398	63335
chr11	5128063	5328063	harbor1	chr11	5191559	5191966	LTR/ERVL-MaLR	2382	+	204	5191763	63700
chr11	76580230	76780230	harbor1	chr11	76580211	76580391	LTR/ERVL-MaLR	892	+	90	76580301	71
chr11	76580230	76780230	harbor1	chr11	76596508	76596942	LTR/ERVL-MaLR	1760	+	217	76596725	16495
chr11	76580230	76780230	harbor1	chr11	76601030	76601131	LTR/ERVL-MaLR	1424	+	50	76601080	20850
chr11	76580230	76780230	harbor1	chr11	76601436	76601695	LTR/ERVL-MaLR	1424	+	130	76601566	21336
chr11	76580230	76780230	harbor1	chr11	76641037	76641400	LTR/ERVL-MaLR	1804	+	182	76641219	60989
chr11	76580230	76780230	harbor1	chr11	76641690	76641752	LTR/ERVL-MaLR	1804	+	31	76641721	61491
chr11	108021628	108221628	harbor1	chr11	108114901	108115232	LTR/ERVL-MaLR	1129	+	166	108115067	93439
chr11	108021628	108221628	harbor1	chr11	108116572	108116980	LTR/ERVL-MaLR	1933	+	204	108116776	95148
chr11	108021628	108221628	harbor1	chr11	108116981	108117136	LTR/ERVL-MaLR	678	+	78	108117059	95431
chr11	11317231	11517231	harbor1	chr11	11318202	11318621	LTR/ERVL-MaLR	2230	+	210	11318412	1181
chr11	11317231	11517231	harbor1	chr11	11319441	11319533	LTR/ERVL-MaLR	418	+	46	11319487	2256
chr11	11317231	11517231	harbor1	chr11	11323945	11324225	LTR/ERVL-MaLR	1236	+	140	11324085	6854
chr11	11317231	11517231	harbor1	chr11	11335523	11336007	LTR/ERVL-MaLR	1331	+	242	11335765	18534
chr11	11317231	11517231	harbor1	chr11	11355315	11355413	LTR/ERVL-MaLR	440	+	49	11355364	38133
chr11	11317231	11517231	harbor1	chr11	11381510	11381918	LTR/ERVL-MaLR	414	+	204	11381714	64483
chr11	11317231	11517231	harbor1	chr11	11383661	11383816	LTR/ERVL-MaLR	2068	+	78	11383739	66508
chr11	11317231	11517231	harbor1	chr11	11383862	11384031	LTR/ERVL-MaLR	2068	+	84	11383946	66715
chr11	11317231	11517231	harbor1	chr11	11384138	11384262	LTR/ERVL-MaLR	675	+	62	11384200	66969
chr11	11317231	11517231	harbor1	chr11	11384602	11384844	LTR/ERVL-MaLR	1264	+	121	11384723	67492
chr11	11317231	11517231	harbor1	chr11	11385742	11386181	LTR/ERVL-MaLR	2314	+	220	11385962	68731
chr11	11317231	11517231	harbor1	chr11	11399009	11399345	LTR/ERVL-MaLR	1209	+	168	11399177	81946
chr11	11317231	11517231	harbor1	chr11	11399928	11400372	LTR/ERVL-MaLR	849	+	222	11400150	82919
chr11	108021537	108221537	harbor1	chr11	108114901	108115232	LTR/ERVL-MaLR	1129	+	166	108115067	93530
chr11	108021537	108221537	harbor1	chr11	108116572	108116980	LTR/ERVL-MaLR	1933	+	204	108116776	95239
chr11	108021537	108221537	harbor1	chr11	108116981	108117136	LTR/ERVL-MaLR	678	+	78	108117059	95522
chr11	5127315	5327315	harbor1	chr11	5189162	5189564	LTR/ERVL-MaLR	2124	+	201	5189363	62048
chr11	5127315	5327315	harbor1	chr11	5189565	5190876	LTR/ERVL-MaLR	10022	+	656	5190221	62906
chr11	5127315	5327315	harbor1	chr11	5191240	5191557	LTR/ERVL-MaLR	10022	+	158	5191398	64083
chr11	5127315	5327315	harbor1	chr11	5191559	5191966	LTR/ERVL-MaLR	2382	+	204	5191763	64448
chr11	5126814	5326814	harbor1	chr11	5189162	5189564	LTR/ERVL-MaLR	2124	+	201	5189363	62549
chr11	5126814	5326814	harbor1	chr11	5189565	5190876	LTR/ERVL-MaLR	10022	+	656	5190221	63407
chr11	5126814	5326814	harbor1	chr11	5191240	5191557	LTR/ERVL-MaLR	10022	+	158	5191398	64584
chr11	5126814	5326814	harbor1	chr11	5191559	5191966	LTR/ERVL-MaLR	2382	+	204	5191763	64949
chr11	68332149	68532149	harbor1	chr11	68380898	68381338	LTR/ERVL-MaLR	996	+	220	68381118	48969
chr11	3991985	4191985	harbor1	chr11	4006022	4006401	LTR/ERVL-MaLR	2590	+	190	4006212	14227
chr11	3991985	4191985	harbor1	chr11	4006714	4006751	LTR/ERVL-MaLR	2590	+	18	4006732	14747
chr11	2952012	3152012	harbor1	chr11	2999473	2999907	LTR/ERVL-MaLR	594	+	217	2999690	47678
chr11	111440845	111640845	harbor1	chr11	111532281	111532722	LTR/ERVL-MaLR	1992	+	220	111532501	91656
chr11	5127068	5327068	harbor1	chr11	5189162	5189564	LTR/ERVL-MaLR	2124	+	201	5189363	62295
chr11	5127068	5327068	harbor1	chr11	5189565	5190876	LTR/ERVL-MaLR	10022	+	656	5190221	63153
chr11	5127068	5327068	harbor1	chr11	5191240	5191557	LTR/ERVL-MaLR	10022	+	158	5191398	64330
chr11	5127068	5327068	harbor1	chr11	5191559	5191966	LTR/ERVL-MaLR	2382	+	204	5191763	64695
chr11	66158730	66358730	harbor1	chr11	66161990	66162112	LTR/ERVL-MaLR	952	+	61	66162051	3321
chr11	66158730	66358730	harbor1	chr11	66162422	66162722	LTR/ERVL-MaLR	952	+	150	66162572	3842
chr11	66158730	66358730	harbor1	chr11	66172243	66172701	LTR/ERVL-MaLR	1929	+	229	66172472	13742
chr11	3928045	4128045	harbor1	chr11	3931641	3931719	LTR/ERVL-MaLR	541	+	39	3931680	3635
chr11	3928045	4128045	harbor1	chr11	3932301	3932380	LTR/ERVL-MaLR	1699	+	40	3932341	4296
chr11	3928045	4128045	harbor1	chr11	3932692	3932912	LTR/ERVL-MaLR	1699	+	110	3932802	4757
chr11	3928045	4128045	harbor1	chr11	4006022	4006401	LTR/ERVL-MaLR	2590	+	190	4006212	78167
chr11	3928045	4128045	harbor1	chr11	4006714	4006751	LTR/ERVL-MaLR	2590	+	18	4006732	78687
chr11	72122635	72322635	harbor1	chr11	72168208	72168569	LTR/ERVL-MaLR	2299	+	180	72168388	45753
chr11	72122635	72322635	harbor1	chr11	72168570	72168941	LTR/ERVL-MaLR	11927	+	186	72168756	46121
chr11	72122635	72322635	harbor1	chr11	72169258	72170470	LTR/ERVL-MaLR	11927	+	606	72169864	47229
chr11	72122635	72322635	harbor1	chr11	72170471	72170829	LTR/ERVL-MaLR	2205	+	179	72170650	48015
chr11	72122635	72322635	harbor1	chr11	72209124	72209502	LTR/ERVL-MaLR	2249	+	189	72209313	86678
chr11	2055751	2255751	harbor1	chr11	2087160	2087567	LTR/ERVL-MaLR	2660	+	204	2087364	31613
chr11	2055751	2255751	harbor1	chr11	2089287	2089620	LTR/ERVL-MaLR	439	+	166	2089453	33702
chr11	2205456	2405456	harbor1	chr11	2210202	2210325	LTR/ERVL-MaLR	442	+	62	2210264	4808
chr11	2205456	2405456	harbor1	chr11	2221018	2221268	LTR/ERVL-MaLR	1272	+	125	2221143	15687
chr11	2205456	2405456	harbor1	chr11	2225674	2226052	LTR/ERVL-MaLR	2105	+	189	2225863	20407
chr11	2205456	2405456	harbor1	chr11	2262251	2262444	LTR/ERVL-MaLR	1110	+	96	2262347	56891
chr11	2205456	2405456	harbor1	chr11	2281480	2281616	LTR/ERVL-MaLR	663	+	68	2281548	76092
chr11	2205456	2405456	harbor1	chr11	2244385	2244715	LTR/ERVL-MaLR	1040	+	165	2244550	39094
chr11	404117	604117	harbor1	chr11	422292	422479	LTR/ERVL-MaLR	516	+	94	422386	18269
chr11	404117	604117	harbor1	chr11	422615	422767	LTR/ERVL-MaLR	733	+	76	422691	18574
chr11	5127332	5327332	harbor1	chr11	5189162	5189564	LTR/ERVL-MaLR	2124	+	201	5189363	62031
chr11	5127332	5327332	harbor1	chr11	5189565	5190876	LTR/ERVL-MaLR	10022	+	656	5190221	62889
chr11	5127332	5327332	harbor1	chr11	5191240	5191557	LTR/ERVL-MaLR	10022	+	158	5191398	64066
chr11	5127332	5327332	harbor1	chr11	5191559	5191966	LTR/ERVL-MaLR	2382	+	204	5191763	64431
chr11	68332104	68532104	harbor1	chr11	68380898	68381338	LTR/ERVL-MaLR	996	+	220	68381118	49014
chr11	47452681	47652681	harbor1	chr11	47494571	47494797	LTR/ERVL-MaLR	405	+	113	47494684	42003
chr11	64537990	64737990	harbor1	chr11	64585088	64585330	LTR/ERVL-MaLR	483	+	121	64585209	47219
chr11	64537990	64737990	harbor1	chr11	64613559	64613760	LTR/ERVL-MaLR	449	+	100	64613659	75669
chr11	64537990	64737990	harbor1	chr11	64613830	64614368	LTR/ERVL-MaLR	1438	+	269	64614099	76109
chr11	64537990	64737990	harbor1	chr11	64614384	64614992	LTR/ERVL-MaLR	1556	+	304	64614688	76698
chr11	64537990	64737990	harbor1	chr11	64615000	64615402	LTR/ERVL-MaLR	823	+	201	64615201	77211
chr11	61396733	61596733	harbor1	chr11	61408637	61408814	LTR/ERVL-MaLR	620	+	88	61408725	11992
chr11	61396733	61596733	harbor1	chr11	61445350	61445476	LTR/ERVL-MaLR	438	+	63	61445413	48680
chr11	61396733	61596733	harbor1	chr11	61452764	61453035	LTR/ERVL-MaLR	725	+	136	61452900	56167
chr11	61396733	61596733	harbor1	chr11	61453733	61454615	LTR/ERVL-MaLR	2330	+	441	61454174	57441
chr11	61396733	61596733	harbor1	chr11	61454630	61454839	LTR/ERVL-MaLR	800	+	104	61454734	58001
chr11	61396733	61596733	harbor1	chr11	61467645	61468003	LTR/ERVL-MaLR	2498	+	179	61467824	71091
chr11	61396733	61596733	harbor1	chr11	61492358	61492579	LTR/ERVL-MaLR	1093	+	110	61492468	95735
chr11	61396733	61596733	harbor1	chr11	61493063	61493206	LTR/ERVL-MaLR	901	+	72	61493135	96402
chr11	5134553	5334553	harbor1	chr11	5189162	5189564	LTR/ERVL-MaLR	2124	+	201	5189363	54810
chr11	5134553	5334553	harbor1	chr11	5189565	5190876	LTR/ERVL-MaLR	10022	+	656	5190221	55668
chr11	5134553	5334553	harbor1	chr11	5191240	5191557	LTR/ERVL-MaLR	10022	+	158	5191398	56845
chr11	5134553	5334553	harbor1	chr11	5191559	5191966	LTR/ERVL-MaLR	2382	+	204	5191763	57210
chr11	5126802	5326802	harbor1	chr11	5189162	5189564	LTR/ERVL-MaLR	2124	+	201	5189363	62561
chr11	5126802	5326802	harbor1	chr11	5189565	5190876	LTR/ERVL-MaLR	10022	+	656	5190221	63419
chr11	5126802	5326802	harbor1	chr11	5191240	5191557	LTR/ERVL-MaLR	10022	+	158	5191398	64596
chr11	5126802	5326802	harbor1	chr11	5191559	5191966	LTR/ERVL-MaLR	2382	+	204	5191763	64961
chr11	2054500	2254500	harbor1	chr11	2087160	2087567	LTR/ERVL-MaLR	2660	+	204	2087364	32864
chr11	2054500	2254500	harbor1	chr11	2089287	2089620	LTR/ERVL-MaLR	439	+	166	2089453	34953
chr11	6201425	6401425	harbor1	chr11	6220022	6220497	LTR/ERVL-MaLR	927	+	238	6220260	18835
chr11	6201425	6401425	harbor1	chr11	6283373	6283625	LTR/ERVL-MaLR	518	+	126	6283499	82074
chr11	6201425	6401425	harbor1	chr11	6293441	6293796	LTR/ERVL-MaLR	1635	+	178	6293619	92194
chr11	2487118	2687118	harbor1	chr11	2523972	2524192	LTR/ERVL-MaLR	627	+	110	2524082	36964
chr11	106091678	106291678	harbor1	chr11	106159844	106160192	LTR/ERVL-MaLR	1037	+	174	106160018	68340
chr11	106091678	106291678	harbor1	chr11	106102571	106102954	LTR/ERVL-MaLR	2362	+	192	106102763	11085
chr11	117886589	118086589	harbor1	chr11	117956123	117956537	LTR/ERVL-MaLR	2229	+	207	117956330	69741
chr11	117886589	118086589	harbor1	chr11	117971418	117971841	LTR/ERVL-MaLR	864	+	212	117971630	85041
chr11	5134020	5334020	harbor1	chr11	5189162	5189564	LTR/ERVL-MaLR	2124	+	201	5189363	55343
chr11	5134020	5334020	harbor1	chr11	5189565	5190876	LTR/ERVL-MaLR	10022	+	656	5190221	56201
chr11	5134020	5334020	harbor1	chr11	5191240	5191557	LTR/ERVL-MaLR	10022	+	158	5191398	57378
chr11	5134020	5334020	harbor1	chr11	5191559	5191966	LTR/ERVL-MaLR	2382	+	204	5191763	57743
chr11	67891296	68091296	harbor1	chr11	67899389	67899837	LTR/ERVL-MaLR	1574	+	224	67899613	8317
chr11	67891296	68091296	harbor1	chr11	67906926	67907217	LTR/ERVL-MaLR	658	+	146	67907072	15776
chr11	67891296	68091296	harbor1	chr11	67907219	67907320	LTR/ERVL-MaLR	457	+	50	67907269	15973
chr11	67891296	68091296	harbor1	chr11	67964897	67965279	LTR/ERVL-MaLR	588	+	191	67965088	73792
chr11	5127223	5327223	harbor1	chr11	5189162	5189564	LTR/ERVL-MaLR	2124	+	201	5189363	62140
chr11	5127223	5327223	harbor1	chr11	5189565	5190876	LTR/ERVL-MaLR	10022	+	656	5190221	62998
chr11	5127223	5327223	harbor1	chr11	5191240	5191557	LTR/ERVL-MaLR	10022	+	158	5191398	64175
chr11	5127223	5327223	harbor1	chr11	5191559	5191966	LTR/ERVL-MaLR	2382	+	204	5191763	64540
chr11	76517780	76717780	harbor1	chr11	76580211	76580391	LTR/ERVL-MaLR	892	+	90	76580301	62521
chr11	76517780	76717780	harbor1	chr11	76596508	76596942	LTR/ERVL-MaLR	1760	+	217	76596725	78945
chr11	76517780	76717780	harbor1	chr11	76601030	76601131	LTR/ERVL-MaLR	1424	+	50	76601080	83300
chr11	76517780	76717780	harbor1	chr11	76601436	76601695	LTR/ERVL-MaLR	1424	+	130	76601566	83786
chr11	70722515	70922515	harbor1	chr11	70723086	70723299	LTR/ERVL-MaLR	983	+	106	70723192	677
chr11	70722515	70922515	harbor1	chr11	70723330	70723684	LTR/ERVL-MaLR	1081	+	177	70723507	992
chr11	70722515	70922515	harbor1	chr11	70726642	70727118	LTR/ERVL-MaLR	1532	+	238	70726880	4365
chr11	70722515	70922515	harbor1	chr11	70731009	70731401	LTR/ERVL-MaLR	1576	+	196	70731205	8690
chr11	70722515	70922515	harbor1	chr11	70736290	70736710	LTR/ERVL-MaLR	1033	+	210	70736500	13985
chr11	70722515	70922515	harbor1	chr11	70739654	70739879	LTR/ERVL-MaLR	1050	+	112	70739766	17251
chr11	70722515	70922515	harbor1	chr11	70743234	70743541	LTR/ERVL-MaLR	714	+	154	70743388	20873
chr11	70722515	70922515	harbor1	chr11	70761111	70761452	LTR/ERVL-MaLR	1214	+	170	70761281	38766
chr11	70722515	70922515	harbor1	chr11	70765184	70765625	LTR/ERVL-MaLR	956	+	220	70765404	42889
chr11	70722515	70922515	harbor1	chr11	70766111	70766387	LTR/ERVL-MaLR	920	+	138	70766249	43734
chr11	70722515	70922515	harbor1	chr11	70778413	70778789	LTR/ERVL-MaLR	1591	+	188	70778601	56086
chr11	70722515	70922515	harbor1	chr11	70779853	70780204	LTR/ERVL-MaLR	762	+	176	70780029	57514
chr11	70722515	70922515	harbor1	chr11	70782905	70783239	LTR/ERVL-MaLR	860	+	167	70783072	60557
chr11	70722515	70922515	harbor1	chr11	70790888	70791138	LTR/ERVL-MaLR	447	+	125	70791013	68498
chr11	70722515	70922515	harbor1	chr11	70795706	70795926	LTR/ERVL-MaLR	878	+	110	70795816	73301
chr11	70722515	70922515	harbor1	chr11	70821097	70821415	LTR/ERVL-MaLR	1542	+	159	70821256	98741
chr11	70722515	70922515	harbor1	chr11	70821723	70821782	LTR/ERVL-MaLR	1542	+	30	70821753	99238
chr11	70722515	70922515	harbor1	chr11	70795203	70795393	LTR/ERVL-MaLR	878	+	95	70795298	72783
chr11	76581027	76781027	harbor1	chr11	76596508	76596942	LTR/ERVL-MaLR	1760	+	217	76596725	15698
chr11	76581027	76781027	harbor1	chr11	76601030	76601131	LTR/ERVL-MaLR	1424	+	50	76601080	20053
chr11	76581027	76781027	harbor1	chr11	76601436	76601695	LTR/ERVL-MaLR	1424	+	130	76601566	20539
chr11	76581027	76781027	harbor1	chr11	76641037	76641400	LTR/ERVL-MaLR	1804	+	182	76641219	60192
chr11	76581027	76781027	harbor1	chr11	76641690	76641752	LTR/ERVL-MaLR	1804	+	31	76641721	60694
chr11	111440865	111640865	harbor1	chr11	111532281	111532722	LTR/ERVL-MaLR	1992	+	220	111532501	91636
chr11	5129651	5329651	harbor1	chr11	5189162	5189564	LTR/ERVL-MaLR	2124	+	201	5189363	59712
chr11	5129651	5329651	harbor1	chr11	5189565	5190876	LTR/ERVL-MaLR	10022	+	656	5190221	60570
chr11	5129651	5329651	harbor1	chr11	5191240	5191557	LTR/ERVL-MaLR	10022	+	158	5191398	61747
chr11	5129651	5329651	harbor1	chr11	5191559	5191966	LTR/ERVL-MaLR	2382	+	204	5191763	62112
chr11	64141102	64341102	harbor1	chr11	64163336	64163826	LTR/ERVL-MaLR	1388	+	245	64163581	22479
chr11	64141102	64341102	harbor1	chr11	64175743	64175850	LTR/ERVL-MaLR	2099	+	54	64175797	34695
chr11	64141102	64341102	harbor1	chr11	64176157	64176212	LTR/ERVL-MaLR	2099	+	28	64176185	35083
chr11	64141102	64341102	harbor1	chr11	64176509	64176539	LTR/ERVL-MaLR	2099	+	15	64176524	35422
chr11	64141102	64341102	harbor1	chr11	64176821	64177074	LTR/ERVL-MaLR	2099	+	126	64176947	35845
chr11	2054484	2254484	harbor1	chr11	2087160	2087567	LTR/ERVL-MaLR	2660	+	204	2087364	32880
chr11	2054484	2254484	harbor1	chr11	2089287	2089620	LTR/ERVL-MaLR	439	+	166	2089453	34969
chr11	70734542	70934542	harbor1	chr11	70736290	70736710	LTR/ERVL-MaLR	1033	+	210	70736500	1958
chr11	70734542	70934542	harbor1	chr11	70739654	70739879	LTR/ERVL-MaLR	1050	+	112	70739766	5224
chr11	70734542	70934542	harbor1	chr11	70743234	70743541	LTR/ERVL-MaLR	714	+	154	70743388	8846
chr11	70734542	70934542	harbor1	chr11	70761111	70761452	LTR/ERVL-MaLR	1214	+	170	70761281	26739
chr11	70734542	70934542	harbor1	chr11	70765184	70765625	LTR/ERVL-MaLR	956	+	220	70765404	30862
chr11	70734542	70934542	harbor1	chr11	70766111	70766387	LTR/ERVL-MaLR	920	+	138	70766249	31707
chr11	70734542	70934542	harbor1	chr11	70778413	70778789	LTR/ERVL-MaLR	1591	+	188	70778601	44059
chr11	70734542	70934542	harbor1	chr11	70779853	70780204	LTR/ERVL-MaLR	762	+	176	70780029	45487
chr11	70734542	70934542	harbor1	chr11	70782905	70783239	LTR/ERVL-MaLR	860	+	167	70783072	48530
chr11	70734542	70934542	harbor1	chr11	70790888	70791138	LTR/ERVL-MaLR	447	+	125	70791013	56471
chr11	70734542	70934542	harbor1	chr11	70795706	70795926	LTR/ERVL-MaLR	878	+	110	70795816	61274
chr11	70734542	70934542	harbor1	chr11	70821097	70821415	LTR/ERVL-MaLR	1542	+	159	70821256	86714
chr11	70734542	70934542	harbor1	chr11	70821723	70821782	LTR/ERVL-MaLR	1542	+	30	70821753	87211
chr11	70734542	70934542	harbor1	chr11	70795203	70795393	LTR/ERVL-MaLR	878	+	95	70795298	60756
chr11	626794	826794	harbor1	chr11	671909	672003	LTR/ERVL-MaLR	452	+	47	671956	45162
chr11	63953306	64153306	harbor1	chr11	63970577	63970744	LTR/ERVL-MaLR	600	+	84	63970661	17355
chr11	63953306	64153306	harbor1	chr11	63981475	63981912	LTR/ERVL-MaLR	1854	+	218	63981693	28387
chr11	63953306	64153306	harbor1	chr11	63982207	63982287	LTR/ERVL-MaLR	1854	+	40	63982247	28941
chr11	47086441	47286441	harbor1	chr11	47091617	47092030	LTR/ERVL-MaLR	1510	+	206	47091823	5382
chr11	5127218	5327218	harbor1	chr11	5189162	5189564	LTR/ERVL-MaLR	2124	+	201	5189363	62145
chr11	5127218	5327218	harbor1	chr11	5189565	5190876	LTR/ERVL-MaLR	10022	+	656	5190221	63003
chr11	5127218	5327218	harbor1	chr11	5191240	5191557	LTR/ERVL-MaLR	10022	+	158	5191398	64180
chr11	5127218	5327218	harbor1	chr11	5191559	5191966	LTR/ERVL-MaLR	2382	+	204	5191763	64545
chr11	57374327	57574327	harbor1	chr11	57393637	57394061	LTR/ERVL-MaLR	799	+	212	57393849	19522
chr11	57374327	57574327	harbor1	chr11	57395147	57395713	LTR/ERVL-MaLR	2271	+	283	57395430	21103
chr11	57374327	57574327	harbor1	chr11	57410705	57411062	LTR/ERVL-MaLR	2835	+	178	57410883	36556
chr11	57374327	57574327	harbor1	chr11	57417136	57417642	LTR/ERVL-MaLR	1555	+	253	57417389	43062
chr11	57374327	57574327	harbor1	chr11	57446230	57446646	LTR/ERVL-MaLR	744	+	208	57446438	72111
chr11	57374327	57574327	harbor1	chr11	57446953	57446999	LTR/ERVL-MaLR	744	+	23	57446976	72649
chr11	5126735	5326735	harbor1	chr11	5189162	5189564	LTR/ERVL-MaLR	2124	+	201	5189363	62628
chr11	5126735	5326735	harbor1	chr11	5189565	5190876	LTR/ERVL-MaLR	10022	+	656	5190221	63486
chr11	5126735	5326735	harbor1	chr11	5191240	5191557	LTR/ERVL-MaLR	10022	+	158	5191398	64663
chr11	5126735	5326735	harbor1	chr11	5191559	5191966	LTR/ERVL-MaLR	2382	+	204	5191763	65028
chr11	461101	661101	harbor1	chr11	505269	505590	LTR/ERVL-MaLR	645	+	160	505429	44328
chr11	134025232	134225232	harbor1	chr11	134080378	134080725	LTR/ERVL-MaLR	2148	+	174	134080552	55320
chr11	134025232	134225232	harbor1	chr11	134080732	134082397	LTR/ERVL-MaLR	10335	+	832	134081564	56332
chr11	134025232	134225232	harbor1	chr11	134082398	134082750	LTR/ERVL-MaLR	2079	+	176	134082574	57342
chr11	76566217	76766217	harbor1	chr11	76580211	76580391	LTR/ERVL-MaLR	892	+	90	76580301	14084
chr11	76566217	76766217	harbor1	chr11	76596508	76596942	LTR/ERVL-MaLR	1760	+	217	76596725	30508
chr11	76566217	76766217	harbor1	chr11	76601030	76601131	LTR/ERVL-MaLR	1424	+	50	76601080	34863
chr11	76566217	76766217	harbor1	chr11	76601436	76601695	LTR/ERVL-MaLR	1424	+	130	76601566	35349
chr11	76566217	76766217	harbor1	chr11	76641037	76641400	LTR/ERVL-MaLR	1804	+	182	76641219	75002
chr11	76566217	76766217	harbor1	chr11	76641690	76641752	LTR/ERVL-MaLR	1804	+	31	76641721	75504
chr11	61396083	61596083	harbor1	chr11	61408637	61408814	LTR/ERVL-MaLR	620	+	88	61408725	12642
chr11	61396083	61596083	harbor1	chr11	61445350	61445476	LTR/ERVL-MaLR	438	+	63	61445413	49330
chr11	61396083	61596083	harbor1	chr11	61452764	61453035	LTR/ERVL-MaLR	725	+	136	61452900	56817
chr11	61396083	61596083	harbor1	chr11	61453733	61454615	LTR/ERVL-MaLR	2330	+	441	61454174	58091
chr11	61396083	61596083	harbor1	chr11	61454630	61454839	LTR/ERVL-MaLR	800	+	104	61454734	58651
chr11	61396083	61596083	harbor1	chr11	61467645	61468003	LTR/ERVL-MaLR	2498	+	179	61467824	71741
chr11	61396083	61596083	harbor1	chr11	61492358	61492579	LTR/ERVL-MaLR	1093	+	110	61492468	96385
chr11	61396083	61596083	harbor1	chr11	61493063	61493206	LTR/ERVL-MaLR	901	+	72	61493135	97052
chr11	5134206	5334206	harbor1	chr11	5189162	5189564	LTR/ERVL-MaLR	2124	+	201	5189363	55157
chr11	5134206	5334206	harbor1	chr11	5189565	5190876	LTR/ERVL-MaLR	10022	+	656	5190221	56015
chr11	5134206	5334206	harbor1	chr11	5191240	5191557	LTR/ERVL-MaLR	10022	+	158	5191398	57192
chr11	5134206	5334206	harbor1	chr11	5191559	5191966	LTR/ERVL-MaLR	2382	+	204	5191763	57557
chr11	64612771	64812771	harbor1	chr11	64613559	64613760	LTR/ERVL-MaLR	449	+	100	64613659	888
chr11	64612771	64812771	harbor1	chr11	64613830	64614368	LTR/ERVL-MaLR	1438	+	269	64614099	1328
chr11	64612771	64812771	harbor1	chr11	64614384	64614992	LTR/ERVL-MaLR	1556	+	304	64614688	1917
chr11	64612771	64812771	harbor1	chr11	64615000	64615402	LTR/ERVL-MaLR	823	+	201	64615201	2430
chr11	64914628	65114628	harbor1	chr11	64992404	64992572	LTR/ERVL-MaLR	664	+	84	64992488	77860
chr11	64914628	65114628	harbor1	chr11	64993439	64993593	LTR/ERVL-MaLR	864	+	77	64993516	78888
chr11	64914628	65114628	harbor1	chr11	65007835	65008154	LTR/ERVL-MaLR	914	+	160	65007995	93367
chr11	66122791	66322791	harbor1	chr11	66132064	66132434	LTR/ERVL-MaLR	2025	+	185	66132249	9458
chr11	66122791	66322791	harbor1	chr11	66161990	66162112	LTR/ERVL-MaLR	952	+	61	66162051	39260
chr11	66122791	66322791	harbor1	chr11	66162422	66162722	LTR/ERVL-MaLR	952	+	150	66162572	39781
chr11	66122791	66322791	harbor1	chr11	66172243	66172701	LTR/ERVL-MaLR	1929	+	229	66172472	49681
chr11	133733693	133933693	harbor1	chr11	133735692	133735824	LTR/ERVL-MaLR	415	+	66	133735758	2065
chr11	133733693	133933693	harbor1	chr11	133735861	133736020	LTR/ERVL-MaLR	444	+	80	133735941	2248
chr11	133733693	133933693	harbor1	chr11	133736023	133736184	LTR/ERVL-MaLR	437	+	80	133736103	2410
chr11	133733693	133933693	harbor1	chr11	133737079	133737213	LTR/ERVL-MaLR	413	+	67	133737146	3453
chr11	133733693	133933693	harbor1	chr11	133738067	133738601	LTR/ERVL-MaLR	949	+	267	133738334	4641
chr11	133733693	133933693	harbor1	chr11	133739616	133739775	LTR/ERVL-MaLR	768	+	80	133739696	6003
chr11	133733693	133933693	harbor1	chr11	133740584	133740790	LTR/ERVL-MaLR	636	+	103	133740687	6994
chr11	133733693	133933693	harbor1	chr11	133743103	133743448	LTR/ERVL-MaLR	1623	+	172	133743275	9582
chr11	133733693	133933693	harbor1	chr11	133743456	133743851	LTR/ERVL-MaLR	3751	+	198	133743654	9961
chr11	133733693	133933693	harbor1	chr11	133744123	133744693	LTR/ERVL-MaLR	3751	+	285	133744408	10715
chr11	133733693	133933693	harbor1	chr11	133771422	133771801	LTR/ERVL-MaLR	2394	+	190	133771612	37919
chr11	133733693	133933693	harbor1	chr11	133784010	133784444	LTR/ERVL-MaLR	1025	+	217	133784227	50534
chr11	133733693	133933693	harbor1	chr11	133796334	133796834	LTR/ERVL-MaLR	1392	+	250	133796584	62891
chr11	133733693	133933693	harbor1	chr11	133815536	133816081	LTR/ERVL-MaLR	1049	+	272	133815808	82115
chr11	133733693	133933693	harbor1	chr11	133816991	133817447	LTR/ERVL-MaLR	1418	+	228	133817219	83526
chr11	133733693	133933693	harbor1	chr11	133820712	133820824	LTR/ERVL-MaLR	1186	+	56	133820768	87075
chr11	133733693	133933693	harbor1	chr11	133820825	133821287	LTR/ERVL-MaLR	2256	+	231	133821056	87363
chr11	133733693	133933693	harbor1	chr11	133821288	133821509	LTR/ERVL-MaLR	1186	+	110	133821398	87705
chr11	133733693	133933693	harbor1	chr11	133821537	133821765	LTR/ERVL-MaLR	587	+	114	133821651	87958
chr11	133733693	133933693	harbor1	chr11	133821971	133822350	LTR/ERVL-MaLR	438	+	190	133822161	88468
chr11	5127023	5327023	harbor1	chr11	5189162	5189564	LTR/ERVL-MaLR	2124	+	201	5189363	62340
chr11	5127023	5327023	harbor1	chr11	5189565	5190876	LTR/ERVL-MaLR	10022	+	656	5190221	63198
chr11	5127023	5327023	harbor1	chr11	5191240	5191557	LTR/ERVL-MaLR	10022	+	158	5191398	64375
chr11	5127023	5327023	harbor1	chr11	5191559	5191966	LTR/ERVL-MaLR	2382	+	204	5191763	64740
chr11	5132776	5332776	harbor1	chr11	5189162	5189564	LTR/ERVL-MaLR	2124	+	201	5189363	56587
chr11	5132776	5332776	harbor1	chr11	5189565	5190876	LTR/ERVL-MaLR	10022	+	656	5190221	57445
chr11	5132776	5332776	harbor1	chr11	5191240	5191557	LTR/ERVL-MaLR	10022	+	158	5191398	58622
chr11	5132776	5332776	harbor1	chr11	5191559	5191966	LTR/ERVL-MaLR	2382	+	204	5191763	58987
chr11	61396791	61596791	harbor1	chr11	61408637	61408814	LTR/ERVL-MaLR	620	+	88	61408725	11934
chr11	61396791	61596791	harbor1	chr11	61445350	61445476	LTR/ERVL-MaLR	438	+	63	61445413	48622
chr11	61396791	61596791	harbor1	chr11	61452764	61453035	LTR/ERVL-MaLR	725	+	136	61452900	56109
chr11	61396791	61596791	harbor1	chr11	61453733	61454615	LTR/ERVL-MaLR	2330	+	441	61454174	57383
chr11	61396791	61596791	harbor1	chr11	61454630	61454839	LTR/ERVL-MaLR	800	+	104	61454734	57943
chr11	61396791	61596791	harbor1	chr11	61467645	61468003	LTR/ERVL-MaLR	2498	+	179	61467824	71033
chr11	61396791	61596791	harbor1	chr11	61492358	61492579	LTR/ERVL-MaLR	1093	+	110	61492468	95677
chr11	61396791	61596791	harbor1	chr11	61493063	61493206	LTR/ERVL-MaLR	901	+	72	61493135	96344
chr11	69539285	69739285	harbor1	chr11	69543422	69543834	LTR/ERVL-MaLR	1729	+	206	69543628	4343
chr11	69539285	69739285	harbor1	chr11	69545601	69546024	LTR/ERVL-MaLR	1293	+	212	69545813	6528
chr11	69539285	69739285	harbor1	chr11	69564264	69564703	LTR/ERVL-MaLR	1214	+	220	69564484	25199
chr11	69539285	69739285	harbor1	chr11	69579097	69579507	LTR/ERVL-MaLR	1084	+	205	69579302	40017
chr11	69539285	69739285	harbor1	chr11	69581054	69581449	LTR/ERVL-MaLR	1112	+	198	69581252	41967
chr11	69539285	69739285	harbor1	chr11	69591077	69591148	LTR/ERVL-MaLR	412	+	36	69591113	51828
chr11	69539285	69739285	harbor1	chr11	69591418	69591791	LTR/ERVL-MaLR	1530	+	186	69591604	52319
chr11	69539285	69739285	harbor1	chr11	69592087	69592373	LTR/ERVL-MaLR	1263	+	143	69592230	52945
chr11	69539285	69739285	harbor1	chr11	69593970	69594387	LTR/ERVL-MaLR	722	+	208	69594178	54893
chr11	69539285	69739285	harbor1	chr11	69595200	69595543	LTR/ERVL-MaLR	2007	+	172	69595372	56087
chr11	69539285	69739285	harbor1	chr11	69598488	69598761	LTR/ERVL-MaLR	900	+	136	69598624	59339
chr11	69539285	69739285	harbor1	chr11	69602192	69602573	LTR/ERVL-MaLR	1784	+	190	69602382	63097
chr11	5125096	5325096	harbor1	chr11	5189162	5189564	LTR/ERVL-MaLR	2124	+	201	5189363	64267
chr11	5125096	5325096	harbor1	chr11	5189565	5190876	LTR/ERVL-MaLR	10022	+	656	5190221	65125
chr11	5125096	5325096	harbor1	chr11	5191240	5191557	LTR/ERVL-MaLR	10022	+	158	5191398	66302
chr11	5125096	5325096	harbor1	chr11	5191559	5191966	LTR/ERVL-MaLR	2382	+	204	5191763	66667
chr11	66158626	66358626	harbor1	chr11	66161990	66162112	LTR/ERVL-MaLR	952	+	61	66162051	3425
chr11	66158626	66358626	harbor1	chr11	66162422	66162722	LTR/ERVL-MaLR	952	+	150	66162572	3946
chr11	66158626	66358626	harbor1	chr11	66172243	66172701	LTR/ERVL-MaLR	1929	+	229	66172472	13846
chr11	66158676	66358676	harbor1	chr11	66161990	66162112	LTR/ERVL-MaLR	952	+	61	66162051	3375
chr11	66158676	66358676	harbor1	chr11	66162422	66162722	LTR/ERVL-MaLR	952	+	150	66162572	3896
chr11	66158676	66358676	harbor1	chr11	66172243	66172701	LTR/ERVL-MaLR	1929	+	229	66172472	13796
chr11	6201391	6401391	harbor1	chr11	6220022	6220497	LTR/ERVL-MaLR	927	+	238	6220260	18869
chr11	6201391	6401391	harbor1	chr11	6283373	6283625	LTR/ERVL-MaLR	518	+	126	6283499	82108
chr11	6201391	6401391	harbor1	chr11	6293441	6293796	LTR/ERVL-MaLR	1635	+	178	6293619	92228
chr11	76581063	76781063	harbor1	chr11	76596508	76596942	LTR/ERVL-MaLR	1760	+	217	76596725	15662
chr11	76581063	76781063	harbor1	chr11	76601030	76601131	LTR/ERVL-MaLR	1424	+	50	76601080	20017
chr11	76581063	76781063	harbor1	chr11	76601436	76601695	LTR/ERVL-MaLR	1424	+	130	76601566	20503
chr11	76581063	76781063	harbor1	chr11	76641037	76641400	LTR/ERVL-MaLR	1804	+	182	76641219	60156
chr11	76581063	76781063	harbor1	chr11	76641690	76641752	LTR/ERVL-MaLR	1804	+	31	76641721	60658
chr11	124700054	124900054	harbor1	chr11	124703953	124704348	LTR/ERVL-MaLR	1594	+	198	124704151	4097
chr11	76517810	76717810	harbor1	chr11	76580211	76580391	LTR/ERVL-MaLR	892	+	90	76580301	62491
chr11	76517810	76717810	harbor1	chr11	76596508	76596942	LTR/ERVL-MaLR	1760	+	217	76596725	78915
chr11	76517810	76717810	harbor1	chr11	76601030	76601131	LTR/ERVL-MaLR	1424	+	50	76601080	83270
chr11	76517810	76717810	harbor1	chr11	76601436	76601695	LTR/ERVL-MaLR	1424	+	130	76601566	83756
chr11	57399809	57599809	harbor1	chr11	57410705	57411062	LTR/ERVL-MaLR	2835	+	178	57410883	11074
chr11	57399809	57599809	harbor1	chr11	57417136	57417642	LTR/ERVL-MaLR	1555	+	253	57417389	17580
chr11	57399809	57599809	harbor1	chr11	57446230	57446646	LTR/ERVL-MaLR	744	+	208	57446438	46629
chr11	57399809	57599809	harbor1	chr11	57446953	57446999	LTR/ERVL-MaLR	744	+	23	57446976	47167
chr11	57399809	57599809	harbor1	chr11	57490336	57490804	LTR/ERVL-MaLR	1620	+	234	57490570	90761
chr12	121697492	121897492	harbor1	chr12	121710804	121711055	LTR/ERVL-MaLR	718	+	126	121710930	13438
chr12	62962733	63162733	harbor1	chr12	63008488	63008851	LTR/ERVL-MaLR	2681	+	182	63008670	45937
chr12	62962733	63162733	harbor1	chr12	63009439	63009803	LTR/ERVL-MaLR	616	+	182	63009621	46888
chr12	62962733	63162733	harbor1	chr12	63023883	63024279	LTR/ERVL-MaLR	2091	+	198	63024081	61348
chr12	62962733	63162733	harbor1	chr12	63034645	63035027	LTR/ERVL-MaLR	720	+	191	63034836	72103
chr12	62962733	63162733	harbor1	chr12	63035402	63035555	LTR/ERVL-MaLR	649	+	76	63035478	72745
chr12	62962733	63162733	harbor1	chr12	63044707	63045049	LTR/ERVL-MaLR	1493	+	171	63044878	82145
chr12	62962733	63162733	harbor1	chr12	63053206	63053561	LTR/ERVL-MaLR	2437	+	178	63053384	90651
chr12	62962733	63162733	harbor1	chr12	62980010	62980340	LTR/ERVL-MaLR	1867	+	165	62980175	17442
chr12	49267287	49467287	harbor1	chr12	49279706	49280048	LTR/ERVL-MaLR	1563	+	171	49279877	12590
chr12	49267287	49467287	harbor1	chr12	49280083	49280335	LTR/ERVL-MaLR	1563	+	126	49280209	12922
chr12	49267287	49467287	harbor1	chr12	49286171	49286609	LTR/ERVL-MaLR	1464	+	219	49286390	19103
chr12	49223475	49423475	harbor1	chr12	49279706	49280048	LTR/ERVL-MaLR	1563	+	171	49279877	56402
chr12	49223475	49423475	harbor1	chr12	49280083	49280335	LTR/ERVL-MaLR	1563	+	126	49280209	56734
chr12	49223475	49423475	harbor1	chr12	49286171	49286609	LTR/ERVL-MaLR	1464	+	219	49286390	62915
chr12	109780252	109980252	harbor1	chr12	109781969	109782322	LTR/ERVL-MaLR	2652	+	176	109782145	1893
chr12	109780252	109980252	harbor1	chr12	109790531	109790600	LTR/ERVL-MaLR	1352	+	34	109790565	10313
chr12	109780252	109980252	harbor1	chr12	109790732	109791100	LTR/ERVL-MaLR	1352	+	184	109790916	10664
chr12	109780252	109980252	harbor1	chr12	109791401	109791454	LTR/ERVL-MaLR	1352	+	26	109791427	11175
chr12	109780252	109980252	harbor1	chr12	109801264	109801640	LTR/ERVL-MaLR	2777	+	188	109801452	21200
chr12	49267209	49467209	harbor1	chr12	49279706	49280048	LTR/ERVL-MaLR	1563	+	171	49279877	12668
chr12	49267209	49467209	harbor1	chr12	49280083	49280335	LTR/ERVL-MaLR	1563	+	126	49280209	13000
chr12	49267209	49467209	harbor1	chr12	49286171	49286609	LTR/ERVL-MaLR	1464	+	219	49286390	19181
chr12	6862749	7062749	harbor1	chr12	6894316	6894681	LTR/ERVL-MaLR	2131	+	182	6894498	31749
chr12	6862749	7062749	harbor1	chr12	6896753	6897241	LTR/ERVL-MaLR	2606	+	244	6896997	34248
chr12	6863249	7063249	harbor1	chr12	6894316	6894681	LTR/ERVL-MaLR	2131	+	182	6894498	31249
chr12	6863249	7063249	harbor1	chr12	6896753	6897241	LTR/ERVL-MaLR	2606	+	244	6896997	33748
chr12	132661881	132861881	harbor1	chr12	132683107	132683532	LTR/ERVL-MaLR	1344	+	212	132683319	21438
chr12	6863215	7063215	harbor1	chr12	6894316	6894681	LTR/ERVL-MaLR	2131	+	182	6894498	31283
chr12	6863215	7063215	harbor1	chr12	6896753	6897241	LTR/ERVL-MaLR	2606	+	244	6896997	33782
chr12	6862682	7062682	harbor1	chr12	6894316	6894681	LTR/ERVL-MaLR	2131	+	182	6894498	31816
chr12	6862682	7062682	harbor1	chr12	6896753	6897241	LTR/ERVL-MaLR	2606	+	244	6896997	34315
chr12	49267208	49467208	harbor1	chr12	49279706	49280048	LTR/ERVL-MaLR	1563	+	171	49279877	12669
chr12	49267208	49467208	harbor1	chr12	49280083	49280335	LTR/ERVL-MaLR	1563	+	126	49280209	13001
chr12	49267208	49467208	harbor1	chr12	49286171	49286609	LTR/ERVL-MaLR	1464	+	219	49286390	19182
chr12	49267266	49467266	harbor1	chr12	49279706	49280048	LTR/ERVL-MaLR	1563	+	171	49279877	12611
chr12	49267266	49467266	harbor1	chr12	49280083	49280335	LTR/ERVL-MaLR	1563	+	126	49280209	12943
chr12	49267266	49467266	harbor1	chr12	49286171	49286609	LTR/ERVL-MaLR	1464	+	219	49286390	19124
chr12	6842193	7042193	harbor1	chr12	6894316	6894681	LTR/ERVL-MaLR	2131	+	182	6894498	52305
chr12	6842193	7042193	harbor1	chr12	6896753	6897241	LTR/ERVL-MaLR	2606	+	244	6896997	54804
chr12	52906640	53106640	harbor1	chr12	52998204	52998314	LTR/ERVL-MaLR	1626	+	55	52998259	91619
chr12	52906640	53106640	harbor1	chr12	52998609	52998640	LTR/ERVL-MaLR	1626	+	16	52998625	91985
chr12	52906640	53106640	harbor1	chr12	52998939	52999192	LTR/ERVL-MaLR	1626	+	126	52999065	92425
chr12	52906640	53106640	harbor1	chr12	52999504	52999651	LTR/ERVL-MaLR	1626	+	74	52999578	92938
chr12	49267207	49467207	harbor1	chr12	49279706	49280048	LTR/ERVL-MaLR	1563	+	171	49279877	12670
chr12	49267207	49467207	harbor1	chr12	49280083	49280335	LTR/ERVL-MaLR	1563	+	126	49280209	13002
chr12	49267207	49467207	harbor1	chr12	49286171	49286609	LTR/ERVL-MaLR	1464	+	219	49286390	19183
chr12	49267255	49467255	harbor1	chr12	49279706	49280048	LTR/ERVL-MaLR	1563	+	171	49279877	12622
chr12	49267255	49467255	harbor1	chr12	49280083	49280335	LTR/ERVL-MaLR	1563	+	126	49280209	12954
chr12	49267255	49467255	harbor1	chr12	49286171	49286609	LTR/ERVL-MaLR	1464	+	219	49286390	19135
chr12	49267241	49467241	harbor1	chr12	49279706	49280048	LTR/ERVL-MaLR	1563	+	171	49279877	12636
chr12	49267241	49467241	harbor1	chr12	49280083	49280335	LTR/ERVL-MaLR	1563	+	126	49280209	12968
chr12	49267241	49467241	harbor1	chr12	49286171	49286609	LTR/ERVL-MaLR	1464	+	219	49286390	19149
chr12	49267331	49467331	harbor1	chr12	49279706	49280048	LTR/ERVL-MaLR	1563	+	171	49279877	12546
chr12	49267331	49467331	harbor1	chr12	49280083	49280335	LTR/ERVL-MaLR	1563	+	126	49280209	12878
chr12	49267331	49467331	harbor1	chr12	49286171	49286609	LTR/ERVL-MaLR	1464	+	219	49286390	19059
chr12	49267175	49467175	harbor1	chr12	49279706	49280048	LTR/ERVL-MaLR	1563	+	171	49279877	12702
chr12	49267175	49467175	harbor1	chr12	49280083	49280335	LTR/ERVL-MaLR	1563	+	126	49280209	13034
chr12	49267175	49467175	harbor1	chr12	49286171	49286609	LTR/ERVL-MaLR	1464	+	219	49286390	19215
chr12	131246237	131446237	harbor1	chr12	131253616	131254001	LTR/ERVL-MaLR	1925	+	192	131253808	7571
chr12	49235659	49435659	harbor1	chr12	49279706	49280048	LTR/ERVL-MaLR	1563	+	171	49279877	44218
chr12	49235659	49435659	harbor1	chr12	49280083	49280335	LTR/ERVL-MaLR	1563	+	126	49280209	44550
chr12	49235659	49435659	harbor1	chr12	49286171	49286609	LTR/ERVL-MaLR	1464	+	219	49286390	50731
chr12	49267228	49467228	harbor1	chr12	49279706	49280048	LTR/ERVL-MaLR	1563	+	171	49279877	12649
chr12	49267228	49467228	harbor1	chr12	49280083	49280335	LTR/ERVL-MaLR	1563	+	126	49280209	12981
chr12	49267228	49467228	harbor1	chr12	49286171	49286609	LTR/ERVL-MaLR	1464	+	219	49286390	19162
chr12	53132031	53332031	harbor1	chr12	53199535	53199876	LTR/ERVL-MaLR	1590	+	170	53199705	67674
chr12	6862269	7062269	harbor1	chr12	6894316	6894681	LTR/ERVL-MaLR	2131	+	182	6894498	32229
chr12	6862269	7062269	harbor1	chr12	6896753	6897241	LTR/ERVL-MaLR	2606	+	244	6896997	34728
chr12	49267231	49467231	harbor1	chr12	49279706	49280048	LTR/ERVL-MaLR	1563	+	171	49279877	12646
chr12	49267231	49467231	harbor1	chr12	49280083	49280335	LTR/ERVL-MaLR	1563	+	126	49280209	12978
chr12	49267231	49467231	harbor1	chr12	49286171	49286609	LTR/ERVL-MaLR	1464	+	219	49286390	19159
chr12	49267216	49467216	harbor1	chr12	49279706	49280048	LTR/ERVL-MaLR	1563	+	171	49279877	12661
chr12	49267216	49467216	harbor1	chr12	49280083	49280335	LTR/ERVL-MaLR	1563	+	126	49280209	12993
chr12	49267216	49467216	harbor1	chr12	49286171	49286609	LTR/ERVL-MaLR	1464	+	219	49286390	19174
chr12	64356142	64556142	harbor1	chr12	64378133	64378360	LTR/ERVL-MaLR	740	+	114	64378247	22105
chr12	116778966	116978966	harbor1	chr12	116797179	116797277	LTR/ERVL-MaLR	1276	+	49	116797228	18262
chr12	116778966	116978966	harbor1	chr12	116797554	116797580	LTR/ERVL-MaLR	1276	+	13	116797567	18601
chr12	116778966	116978966	harbor1	chr12	116798070	116798205	LTR/ERVL-MaLR	1276	+	68	116798138	19172
chr12	116778966	116978966	harbor1	chr12	116799837	116800215	LTR/ERVL-MaLR	2123	+	189	116800026	21060
chr12	116778966	116978966	harbor1	chr12	116802545	116802803	LTR/ERVL-MaLR	976	+	129	116802674	23708
chr12	116778966	116978966	harbor1	chr12	116874510	116874976	LTR/ERVL-MaLR	1463	+	233	116874743	95777
chr12	116778966	116978966	harbor1	chr12	116875286	116875352	LTR/ERVL-MaLR	1463	+	33	116875319	96353
chr12	119684757	119884757	harbor1	chr12	119714945	119715291	LTR/ERVL-MaLR	2012	+	173	119715118	30361
chr12	21362986	21562986	harbor1	chr12	21386356	21386714	LTR/ERVL-MaLR	2418	+	179	21386535	23549
chr12	21362986	21562986	harbor1	chr12	21386719	21388298	LTR/ERVL-MaLR	10197	+	790	21387509	24523
chr12	21362986	21562986	harbor1	chr12	21388299	21388653	LTR/ERVL-MaLR	2329	+	177	21388476	25490
chr12	49248183	49448183	harbor1	chr12	49279706	49280048	LTR/ERVL-MaLR	1563	+	171	49279877	31694
chr12	49248183	49448183	harbor1	chr12	49280083	49280335	LTR/ERVL-MaLR	1563	+	126	49280209	32026
chr12	49248183	49448183	harbor1	chr12	49286171	49286609	LTR/ERVL-MaLR	1464	+	219	49286390	38207
chr12	30880777	31080777	harbor1	chr12	30901181	30901524	LTR/ERVL-MaLR	1954	+	172	30901353	20576
chr12	92828003	93028003	harbor1	chr12	92840812	92841167	LTR/ERVL-MaLR	2131	+	178	92840990	12987
chr12	92828003	93028003	harbor1	chr12	92863240	92863703	LTR/ERVL-MaLR	1060	+	232	92863472	35469
chr12	92828003	93028003	harbor1	chr12	92876465	92876674	LTR/ERVL-MaLR	1288	+	104	92876569	48566
chr12	92828003	93028003	harbor1	chr12	92909549	92909733	LTR/ERVL-MaLR	862	+	92	92909641	81638
chr12	92828003	93028003	harbor1	chr12	92912248	92912485	LTR/ERVL-MaLR	713	+	118	92912366	84363
chr12	64356143	64556143	harbor1	chr12	64378133	64378360	LTR/ERVL-MaLR	740	+	114	64378247	22104
chr12	49267229	49467229	harbor1	chr12	49279706	49280048	LTR/ERVL-MaLR	1563	+	171	49279877	12648
chr12	49267229	49467229	harbor1	chr12	49280083	49280335	LTR/ERVL-MaLR	1563	+	126	49280209	12980
chr12	49267229	49467229	harbor1	chr12	49286171	49286609	LTR/ERVL-MaLR	1464	+	219	49286390	19161
chr12	102336329	102536329	harbor1	chr12	102335982	102336442	LTR/ERVL-MaLR	1306	+	230	102336212	117
chr12	102336329	102536329	harbor1	chr12	102343221	102343706	LTR/ERVL-MaLR	825	+	242	102343463	7134
chr12	102336329	102536329	harbor1	chr12	102345333	102345715	LTR/ERVL-MaLR	1802	+	191	102345524	9195
chr12	102336329	102536329	harbor1	chr12	102358646	102358972	LTR/ERVL-MaLR	1187	+	163	102358809	22480
chr12	102336329	102536329	harbor1	chr12	102371188	102371548	LTR/ERVL-MaLR	2474	+	180	102371368	35039
chr12	102336329	102536329	harbor1	chr12	102416779	102417185	LTR/ERVL-MaLR	1892	+	203	102416982	80653
chr12	49267285	49467285	harbor1	chr12	49279706	49280048	LTR/ERVL-MaLR	1563	+	171	49279877	12592
chr12	49267285	49467285	harbor1	chr12	49280083	49280335	LTR/ERVL-MaLR	1563	+	126	49280209	12924
chr12	49267285	49467285	harbor1	chr12	49286171	49286609	LTR/ERVL-MaLR	1464	+	219	49286390	19105
chr12	56840310	57040310	harbor1	chr12	56862205	56862598	LTR/ERVL-MaLR	2134	+	196	56862401	22091
chr12	56840310	57040310	harbor1	chr12	56863475	56863638	LTR/ERVL-MaLR	819	+	82	56863557	23247
chr12	56840310	57040310	harbor1	chr12	56863613	56865177	LTR/ERVL-MaLR	10327	+	782	56864395	24085
chr12	56840310	57040310	harbor1	chr12	56865178	56865450	LTR/ERVL-MaLR	1446	+	136	56865314	25004
chr12	56840310	57040310	harbor1	chr12	56885526	56887183	LTR/ERVL-MaLR	11379	+	828	56886354	46044
chr12	56840310	57040310	harbor1	chr12	56887184	56887564	LTR/ERVL-MaLR	2431	+	190	56887374	47064
chr12	56840310	57040310	harbor1	chr12	56908983	56910073	LTR/ERVL-MaLR	6342	+	545	56909528	69218
chr12	56840310	57040310	harbor1	chr12	56910074	56910200	LTR/ERVL-MaLR	962	+	63	56910137	69827
chr12	56840310	57040310	harbor1	chr12	56910201	56910570	LTR/ERVL-MaLR	2285	+	184	56910385	70075
chr12	56840310	57040310	harbor1	chr12	56910573	56910650	LTR/ERVL-MaLR	613	+	38	56910611	70301
chr12	56840310	57040310	harbor1	chr12	56911080	56911492	LTR/ERVL-MaLR	946	+	206	56911286	70976
chr12	56840310	57040310	harbor1	chr12	56927436	56927966	LTR/ERVL-MaLR	809	+	265	56927701	87391
chr12	56840310	57040310	harbor1	chr12	56932050	56932574	LTR/ERVL-MaLR	1829	+	262	56932312	92002
chr12	56840310	57040310	harbor1	chr12	56885156	56885524	LTR/ERVL-MaLR	2221	+	184	56885340	45030
chr12	52267472	52467472	harbor1	chr12	52331022	52331428	LTR/ERVL-MaLR	1062	+	203	52331225	63753
chr12	52267472	52467472	harbor1	chr12	52330305	52330668	LTR/ERVL-MaLR	2374	+	182	52330487	63015
chr12	49267269	49467269	harbor1	chr12	49279706	49280048	LTR/ERVL-MaLR	1563	+	171	49279877	12608
chr12	49267269	49467269	harbor1	chr12	49280083	49280335	LTR/ERVL-MaLR	1563	+	126	49280209	12940
chr12	49267269	49467269	harbor1	chr12	49286171	49286609	LTR/ERVL-MaLR	1464	+	219	49286390	19121
chr12	130250985	130450985	harbor1	chr12	130284260	130284670	LTR/ERVL-MaLR	2253	+	205	130284465	33480
chr12	130250985	130450985	harbor1	chr12	130291977	130292283	LTR/ERVL-MaLR	1540	+	153	130292130	41145
chr12	130250985	130450985	harbor1	chr12	130298372	130298646	LTR/ERVL-MaLR	776	+	137	130298509	47524
chr12	130250985	130450985	harbor1	chr12	130302277	130302672	LTR/ERVL-MaLR	1080	+	198	130302475	51490
chr12	49267302	49467302	harbor1	chr12	49279706	49280048	LTR/ERVL-MaLR	1563	+	171	49279877	12575
chr12	49267302	49467302	harbor1	chr12	49280083	49280335	LTR/ERVL-MaLR	1563	+	126	49280209	12907
chr12	49267302	49467302	harbor1	chr12	49286171	49286609	LTR/ERVL-MaLR	1464	+	219	49286390	19088
chr12	6359134	6559134	harbor1	chr12	6359402	6359760	LTR/ERVL-MaLR	2260	+	179	6359581	447
chr12	6359134	6559134	harbor1	chr12	6360069	6360108	LTR/ERVL-MaLR	2260	+	20	6360089	955
chr12	6863304	7063304	harbor1	chr12	6894316	6894681	LTR/ERVL-MaLR	2131	+	182	6894498	31194
chr12	6863304	7063304	harbor1	chr12	6896753	6897241	LTR/ERVL-MaLR	2606	+	244	6896997	33693
chr12	132625504	132825504	harbor1	chr12	132651556	132651901	LTR/ERVL-MaLR	1311	+	172	132651728	26224
chr12	132625504	132825504	harbor1	chr12	132683107	132683532	LTR/ERVL-MaLR	1344	+	212	132683319	57815
chr12	92010595	92210595	harbor1	chr12	92072365	92072800	LTR/ERVL-MaLR	2062	+	218	92072583	61988
chr12	49266654	49466654	harbor1	chr12	49279706	49280048	LTR/ERVL-MaLR	1563	+	171	49279877	13223
chr12	49266654	49466654	harbor1	chr12	49280083	49280335	LTR/ERVL-MaLR	1563	+	126	49280209	13555
chr12	49266654	49466654	harbor1	chr12	49286171	49286609	LTR/ERVL-MaLR	1464	+	219	49286390	19736
chr12	49266812	49466812	harbor1	chr12	49279706	49280048	LTR/ERVL-MaLR	1563	+	171	49279877	13065
chr12	49266812	49466812	harbor1	chr12	49280083	49280335	LTR/ERVL-MaLR	1563	+	126	49280209	13397
chr12	49266812	49466812	harbor1	chr12	49286171	49286609	LTR/ERVL-MaLR	1464	+	219	49286390	19578
chr12	106993251	107193251	harbor1	chr12	107002672	107003037	LTR/ERVL-MaLR	2418	+	182	107002854	9603
chr12	106993251	107193251	harbor1	chr12	107008674	107009035	LTR/ERVL-MaLR	2559	+	180	107008854	15603
chr12	106993251	107193251	harbor1	chr12	107020376	107020785	LTR/ERVL-MaLR	2254	+	204	107020580	27329
chr12	106993251	107193251	harbor1	chr12	107047413	107047790	LTR/ERVL-MaLR	2476	+	188	107047601	54350
chr12	106993251	107193251	harbor1	chr12	107050299	107050714	LTR/ERVL-MaLR	2045	+	208	107050507	57256
chr12	106993251	107193251	harbor1	chr12	107060187	107060548	LTR/ERVL-MaLR	1719	+	180	107060367	67116
chr12	106993251	107193251	harbor1	chr12	107076682	107077091	LTR/ERVL-MaLR	2300	+	204	107076886	83635
chr12	106993251	107193251	harbor1	chr12	107079218	107079562	LTR/ERVL-MaLR	647	+	172	107079390	86139
chr12	106993251	107193251	harbor1	chr12	107081711	107081846	LTR/ERVL-MaLR	690	+	68	107081779	88528
chr12	106993251	107193251	harbor1	chr12	107085912	107086917	LTR/ERVL-MaLR	3693	+	502	107086414	93163
chr12	106993251	107193251	harbor1	chr12	107087109	107087259	LTR/ERVL-MaLR	850	+	75	107087184	93933
chr12	106993251	107193251	harbor1	chr12	107087312	107087765	LTR/ERVL-MaLR	2202	+	226	107087538	94287
chr12	106993251	107193251	harbor1	chr12	107088100	107088488	LTR/ERVL-MaLR	1961	+	194	107088294	95043
chr12	106993251	107193251	harbor1	chr12	107088492	107088696	LTR/ERVL-MaLR	1032	+	102	107088594	95343
chr12	31860001	32060001	harbor1	chr12	31892145	31892490	LTR/ERVL-MaLR	2261	+	172	31892317	32316
chr12	31860001	32060001	harbor1	chr12	31892785	31892835	LTR/ERVL-MaLR	2261	+	25	31892810	32809
chr12	31860001	32060001	harbor1	chr12	31900536	31900608	LTR/ERVL-MaLR	881	+	36	31900572	40571
chr12	31860001	32060001	harbor1	chr12	31900902	31901166	LTR/ERVL-MaLR	881	+	132	31901034	41033
chr12	31860001	32060001	harbor1	chr12	31901766	31901829	LTR/ERVL-MaLR	881	+	32	31901798	41797
chr12	121697440	121897440	harbor1	chr12	121710804	121711055	LTR/ERVL-MaLR	718	+	126	121710930	13490
chr12	21402089	21602089	harbor1	chr12	21487677	21487995	LTR/ERVL-MaLR	1180	+	159	21487836	85747
chr12	121527252	121727252	harbor1	chr12	121541943	121542317	LTR/ERVL-MaLR	1973	+	187	121542130	14878
chr12	121527252	121727252	harbor1	chr12	121542456	121542616	LTR/ERVL-MaLR	638	+	80	121542536	15284
chr12	121527252	121727252	harbor1	chr12	121555705	121555897	LTR/ERVL-MaLR	734	+	96	121555801	28549
chr12	121527252	121727252	harbor1	chr12	121556369	121556569	LTR/ERVL-MaLR	1278	+	100	121556469	29217
chr12	121527252	121727252	harbor1	chr12	121556869	121556915	LTR/ERVL-MaLR	1278	+	23	121556892	29640
chr12	121527252	121727252	harbor1	chr12	121557102	121557231	LTR/ERVL-MaLR	1376	+	64	121557166	29914
chr12	121527252	121727252	harbor1	chr12	121557540	121557832	LTR/ERVL-MaLR	1376	+	146	121557686	30434
chr12	121527252	121727252	harbor1	chr12	121567242	121567420	LTR/ERVL-MaLR	998	+	89	121567331	40079
chr12	121527252	121727252	harbor1	chr12	121567546	121567702	LTR/ERVL-MaLR	961	+	78	121567624	40372
chr12	121527252	121727252	harbor1	chr12	121568029	121568099	LTR/ERVL-MaLR	961	+	35	121568064	40812
chr12	121527252	121727252	harbor1	chr12	121606950	121607104	LTR/ERVL-MaLR	791	+	77	121607027	79775
chr12	121527252	121727252	harbor1	chr12	121607642	121607771	LTR/ERVL-MaLR	675	+	64	121607706	80454
chr12	121527252	121727252	harbor1	chr12	121608634	121609054	LTR/ERVL-MaLR	1730	+	210	121608844	81592
chr12	6862158	7062158	harbor1	chr12	6894316	6894681	LTR/ERVL-MaLR	2131	+	182	6894498	32340
chr12	6862158	7062158	harbor1	chr12	6896753	6897241	LTR/ERVL-MaLR	2606	+	244	6896997	34839
chr12	6863268	7063268	harbor1	chr12	6894316	6894681	LTR/ERVL-MaLR	2131	+	182	6894498	31230
chr12	6863268	7063268	harbor1	chr12	6896753	6897241	LTR/ERVL-MaLR	2606	+	244	6896997	33729
chr12	94808159	95008159	harbor1	chr12	94841176	94841622	LTR/ERVL-MaLR	1275	+	223	94841399	33240
chr12	94808159	95008159	harbor1	chr12	94842111	94842131	LTR/ERVL-MaLR	1282	+	10	94842121	33962
chr12	94808159	95008159	harbor1	chr12	94842166	94842689	LTR/ERVL-MaLR	1282	+	262	94842428	34269
chr12	94808159	95008159	harbor1	chr12	94867025	94867450	LTR/ERVL-MaLR	764	+	212	94867237	59078
chr12	94808159	95008159	harbor1	chr12	94896750	94897131	LTR/ERVL-MaLR	1271	+	190	94896940	88781
chr12	49267225	49467225	harbor1	chr12	49279706	49280048	LTR/ERVL-MaLR	1563	+	171	49279877	12652
chr12	49267225	49467225	harbor1	chr12	49280083	49280335	LTR/ERVL-MaLR	1563	+	126	49280209	12984
chr12	49267225	49467225	harbor1	chr12	49286171	49286609	LTR/ERVL-MaLR	1464	+	219	49286390	19165
chr12	6862769	7062769	harbor1	chr12	6894316	6894681	LTR/ERVL-MaLR	2131	+	182	6894498	31729
chr12	6862769	7062769	harbor1	chr12	6896753	6897241	LTR/ERVL-MaLR	2606	+	244	6896997	34228
chr13	113725873	113925873	harbor1	chr13	113754500	113754653	LTR/ERVL-MaLR	540	+	76	113754576	28703
chr13	113725873	113925873	harbor1	chr13	113815415	113815766	LTR/ERVL-MaLR	2640	+	176	113815591	89718
chr13	20315161	20515161	harbor1	chr13	20347090	20347450	LTR/ERVL-MaLR	1767	+	180	20347270	32109
chr13	20315161	20515161	harbor1	chr13	20380328	20380784	LTR/ERVL-MaLR	1197	+	228	20380556	65395
chr13	20315161	20515161	harbor1	chr13	20386607	20386970	LTR/ERVL-MaLR	2463	+	182	20386789	71628
chr13	27925914	28125914	harbor1	chr13	27936150	27936622	LTR/ERVL-MaLR	1393	+	236	27936386	10472
chr13	27925914	28125914	harbor1	chr13	27940745	27940906	LTR/ERVL-MaLR	531	+	80	27940825	14911
chr13	27925914	28125914	harbor1	chr13	27941210	27941567	LTR/ERVL-MaLR	551	+	178	27941388	15474
chr13	27925914	28125914	harbor1	chr13	27945588	27945728	LTR/ERVL-MaLR	669	+	70	27945658	19744
chr13	27925914	28125914	harbor1	chr13	27945917	27946721	LTR/ERVL-MaLR	2797	+	402	27946319	20405
chr13	27925914	28125914	harbor1	chr13	27947041	27947504	LTR/ERVL-MaLR	2797	+	232	27947273	21359
chr13	27925914	28125914	harbor1	chr13	27947529	27948050	LTR/ERVL-MaLR	1346	+	260	27947789	21875
chr13	20315121	20515121	harbor1	chr13	20347090	20347450	LTR/ERVL-MaLR	1767	+	180	20347270	32149
chr13	20315121	20515121	harbor1	chr13	20380328	20380784	LTR/ERVL-MaLR	1197	+	228	20380556	65435
chr13	20315121	20515121	harbor1	chr13	20386607	20386970	LTR/ERVL-MaLR	2463	+	182	20386789	71668
chr13	48135005	48335005	harbor1	chr13	48138346	48138726	LTR/ERVL-MaLR	2550	+	190	48138536	3531
chr13	48135005	48335005	harbor1	chr13	48139038	48139077	LTR/ERVL-MaLR	2550	+	20	48139058	4053
chr13	48135005	48335005	harbor1	chr13	48150461	48150780	LTR/ERVL-MaLR	1437	+	160	48150621	15616
chr13	48135005	48335005	harbor1	chr13	48151078	48151089	LTR/ERVL-MaLR	1437	+	6	48151084	16079
chr13	48135005	48335005	harbor1	chr13	48151400	48151599	LTR/ERVL-MaLR	1437	+	100	48151500	16495
chr13	48135005	48335005	harbor1	chr13	48190015	48190390	LTR/ERVL-MaLR	2574	+	188	48190203	55198
chr13	48135005	48335005	harbor1	chr13	48197306	48197383	LTR/ERVL-MaLR	2030	+	38	48197344	62339
chr13	48135005	48335005	harbor1	chr13	48197513	48197849	LTR/ERVL-MaLR	2030	+	168	48197681	62676
chr13	48135005	48335005	harbor1	chr13	48214576	48215091	LTR/ERVL-MaLR	1747	+	258	48214834	79829
chr13	48135005	48335005	harbor1	chr13	48215092	48215427	LTR/ERVL-MaLR	2603	+	168	48215260	80255
chr13	48135005	48335005	harbor1	chr13	48215731	48215772	LTR/ERVL-MaLR	2603	+	20	48215751	80746
chr13	48135005	48335005	harbor1	chr13	48215773	48217504	LTR/ERVL-MaLR	9815	+	866	48216639	81634
chr13	48135005	48335005	harbor1	chr13	48217507	48217879	LTR/ERVL-MaLR	3069	+	186	48217693	82688
chr13	48135005	48335005	harbor1	chr13	48217880	48217902	LTR/ERVL-MaLR	1747	+	11	48217891	82886
chr13	48135005	48335005	harbor1	chr13	48220006	48220195	LTR/ERVL-MaLR	1841	+	94	48220100	85095
chr13	48135005	48335005	harbor1	chr13	48220230	48220563	LTR/ERVL-MaLR	1841	+	166	48220396	85391
chr13	20315155	20515155	harbor1	chr13	20347090	20347450	LTR/ERVL-MaLR	1767	+	180	20347270	32115
chr13	20315155	20515155	harbor1	chr13	20380328	20380784	LTR/ERVL-MaLR	1197	+	228	20380556	65401
chr13	20315155	20515155	harbor1	chr13	20386607	20386970	LTR/ERVL-MaLR	2463	+	182	20386789	71634
chr13	29489259	29689259	harbor1	chr13	29527820	29528085	LTR/ERVL-MaLR	603	+	132	29527952	38693
chr13	29489259	29689259	harbor1	chr13	29550543	29550830	LTR/ERVL-MaLR	913	+	144	29550687	61428
chr13	75381986	75581986	harbor1	chr13	75397788	75398269	LTR/ERVL-MaLR	520	+	240	75398028	16042
chr13	75381986	75581986	harbor1	chr13	75398283	75399062	LTR/ERVL-MaLR	2608	+	390	75398673	16687
chr13	75381986	75581986	harbor1	chr13	75399690	75400184	LTR/ERVL-MaLR	772	+	247	75399937	17951
chr13	75381986	75581986	harbor1	chr13	75435973	75436321	LTR/ERVL-MaLR	2363	+	174	75436147	54161
chr13	75381986	75581986	harbor1	chr13	75399142	75399688	LTR/ERVL-MaLR	2608	+	273	75399415	17429
chr13	20315106	20515106	harbor1	chr13	20347090	20347450	LTR/ERVL-MaLR	1767	+	180	20347270	32164
chr13	20315106	20515106	harbor1	chr13	20380328	20380784	LTR/ERVL-MaLR	1197	+	228	20380556	65450
chr13	20315106	20515106	harbor1	chr13	20386607	20386970	LTR/ERVL-MaLR	2463	+	182	20386789	71683
chr13	113725885	113925885	harbor1	chr13	113754500	113754653	LTR/ERVL-MaLR	540	+	76	113754576	28691
chr13	113725885	113925885	harbor1	chr13	113815415	113815766	LTR/ERVL-MaLR	2640	+	176	113815591	89706
chr13	113726197	113926197	harbor1	chr13	113754500	113754653	LTR/ERVL-MaLR	540	+	76	113754576	28379
chr13	113726197	113926197	harbor1	chr13	113815415	113815766	LTR/ERVL-MaLR	2640	+	176	113815591	89394
chr13	51326437	51526437	harbor1	chr13	51332647	51332925	LTR/ERVL-MaLR	1075	+	139	51332786	6349
chr13	51326437	51526437	harbor1	chr13	51405842	51405925	LTR/ERVL-MaLR	468	+	42	51405884	79447
chr13	51326437	51526437	harbor1	chr13	51415349	51415719	LTR/ERVL-MaLR	2341	+	185	51415534	89097
chr13	113718997	113918997	harbor1	chr13	113754500	113754653	LTR/ERVL-MaLR	540	+	76	113754576	35579
chr13	113718997	113918997	harbor1	chr13	113815415	113815766	LTR/ERVL-MaLR	2640	+	176	113815591	96594
chr13	113725726	113925726	harbor1	chr13	113754500	113754653	LTR/ERVL-MaLR	540	+	76	113754576	28850
chr13	113725726	113925726	harbor1	chr13	113815415	113815766	LTR/ERVL-MaLR	2640	+	176	113815591	89865
chr13	100574944	100774944	harbor1	chr13	100580177	100580614	LTR/ERVL-MaLR	912	+	218	100580395	5451
chr13	100574944	100774944	harbor1	chr13	100582380	100582727	LTR/ERVL-MaLR	1702	+	174	100582554	7610
chr13	100574944	100774944	harbor1	chr13	100597222	100597628	LTR/ERVL-MaLR	1049	+	203	100597425	22481
chr13	100574944	100774944	harbor1	chr13	100622382	100622743	LTR/ERVL-MaLR	2202	+	180	100622562	47618
chr13	100574944	100774944	harbor1	chr13	100626817	100627142	LTR/ERVL-MaLR	1669	+	162	100626979	52035
chr13	100574944	100774944	harbor1	chr13	100629670	100630019	LTR/ERVL-MaLR	1498	+	174	100629844	54900
chr13	100574944	100774944	harbor1	chr13	100630083	100630107	LTR/ERVL-MaLR	1498	+	12	100630095	55151
chr13	100574944	100774944	harbor1	chr13	100638572	100638839	LTR/ERVL-MaLR	681	+	134	100638706	63762
chr13	20315169	20515169	harbor1	chr13	20347090	20347450	LTR/ERVL-MaLR	1767	+	180	20347270	32101
chr13	20315169	20515169	harbor1	chr13	20380328	20380784	LTR/ERVL-MaLR	1197	+	228	20380556	65387
chr13	20315169	20515169	harbor1	chr13	20386607	20386970	LTR/ERVL-MaLR	2463	+	182	20386789	71620
chr13	113725782	113925782	harbor1	chr13	113754500	113754653	LTR/ERVL-MaLR	540	+	76	113754576	28794
chr13	113725782	113925782	harbor1	chr13	113815415	113815766	LTR/ERVL-MaLR	2640	+	176	113815591	89809
chr13	38912775	39112775	harbor1	chr13	38926064	38926285	LTR/ERVL-MaLR	741	+	110	38926174	13399
chr13	38912775	39112775	harbor1	chr13	38939188	38939556	LTR/ERVL-MaLR	1948	+	184	38939372	26597
chr13	38912775	39112775	harbor1	chr13	38942617	38942757	LTR/ERVL-MaLR	714	+	70	38942687	29912
chr13	38912775	39112775	harbor1	chr13	38949526	38949911	LTR/ERVL-MaLR	1498	+	192	38949718	36943
chr13	38912775	39112775	harbor1	chr13	38950647	38950670	LTR/ERVL-MaLR	1498	+	12	38950659	37884
chr13	38912775	39112775	harbor1	chr13	38950685	38951040	LTR/ERVL-MaLR	1907	+	178	38950863	38088
chr13	38912775	39112775	harbor1	chr13	38963709	38964072	LTR/ERVL-MaLR	1908	+	182	38963891	51116
chr13	20315123	20515123	harbor1	chr13	20347090	20347450	LTR/ERVL-MaLR	1767	+	180	20347270	32147
chr13	20315123	20515123	harbor1	chr13	20380328	20380784	LTR/ERVL-MaLR	1197	+	228	20380556	65433
chr13	20315123	20515123	harbor1	chr13	20386607	20386970	LTR/ERVL-MaLR	2463	+	182	20386789	71666
chr13	19764706	19964706	harbor1	chr13	19800949	19801297	LTR/ERVL-MaLR	1523	+	174	19801123	36417
chr13	20315143	20515143	harbor1	chr13	20347090	20347450	LTR/ERVL-MaLR	1767	+	180	20347270	32127
chr13	20315143	20515143	harbor1	chr13	20380328	20380784	LTR/ERVL-MaLR	1197	+	228	20380556	65413
chr13	20315143	20515143	harbor1	chr13	20386607	20386970	LTR/ERVL-MaLR	2463	+	182	20386789	71646
chr13	113726165	113926165	harbor1	chr13	113754500	113754653	LTR/ERVL-MaLR	540	+	76	113754576	28411
chr13	113726165	113926165	harbor1	chr13	113815415	113815766	LTR/ERVL-MaLR	2640	+	176	113815591	89426
chr13	113713157	113913157	harbor1	chr13	113754500	113754653	LTR/ERVL-MaLR	540	+	76	113754576	41419
chr13	24917691	25117691	harbor1	chr13	24998573	24998997	LTR/ERVL-MaLR	1050	+	212	24998785	81094
chr13	100568699	100768699	harbor1	chr13	100570667	100570802	LTR/ERVL-MaLR	987	+	68	100570735	2036
chr13	100568699	100768699	harbor1	chr13	100580177	100580614	LTR/ERVL-MaLR	912	+	218	100580395	11696
chr13	100568699	100768699	harbor1	chr13	100582380	100582727	LTR/ERVL-MaLR	1702	+	174	100582554	13855
chr13	100568699	100768699	harbor1	chr13	100597222	100597628	LTR/ERVL-MaLR	1049	+	203	100597425	28726
chr13	100568699	100768699	harbor1	chr13	100622382	100622743	LTR/ERVL-MaLR	2202	+	180	100622562	53863
chr13	100568699	100768699	harbor1	chr13	100626817	100627142	LTR/ERVL-MaLR	1669	+	162	100626979	58280
chr13	100568699	100768699	harbor1	chr13	100629670	100630019	LTR/ERVL-MaLR	1498	+	174	100629844	61145
chr13	100568699	100768699	harbor1	chr13	100630083	100630107	LTR/ERVL-MaLR	1498	+	12	100630095	61396
chr13	100568699	100768699	harbor1	chr13	100638572	100638839	LTR/ERVL-MaLR	681	+	134	100638706	70007
chr13	20262753	20462753	harbor1	chr13	20272062	20272513	LTR/ERVL-MaLR	1005	+	226	20272288	9535
chr13	20262753	20462753	harbor1	chr13	20347090	20347450	LTR/ERVL-MaLR	1767	+	180	20347270	84517
chr13	36814065	37014065	harbor1	chr13	36829601	36830164	LTR/ERVL-MaLR	1294	+	282	36829883	15818
chr13	36814065	37014065	harbor1	chr13	36830295	36830469	LTR/ERVL-MaLR	582	+	87	36830382	16317
chr13	36814065	37014065	harbor1	chr13	36831370	36831654	LTR/ERVL-MaLR	843	+	142	36831512	17447
chr13	36814065	37014065	harbor1	chr13	36840545	36841067	LTR/ERVL-MaLR	1762	+	261	36840806	26741
chr13	36814065	37014065	harbor1	chr13	36863507	36863904	LTR/ERVL-MaLR	1903	+	198	36863705	49640
chr13	36814065	37014065	harbor1	chr13	36888145	36888509	LTR/ERVL-MaLR	1890	+	182	36888327	74262
chr13	36814065	37014065	harbor1	chr13	36894158	36894515	LTR/ERVL-MaLR	2071	+	178	36894336	80271
chr13	113726286	113926286	harbor1	chr13	113754500	113754653	LTR/ERVL-MaLR	540	+	76	113754576	28290
chr13	113726286	113926286	harbor1	chr13	113815415	113815766	LTR/ERVL-MaLR	2640	+	176	113815591	89305
chr13	113726133	113926133	harbor1	chr13	113754500	113754653	LTR/ERVL-MaLR	540	+	76	113754576	28443
chr13	113726133	113926133	harbor1	chr13	113815415	113815766	LTR/ERVL-MaLR	2640	+	176	113815591	89458
chr13	109947746	110147746	harbor1	chr13	109955289	109955460	LTR/ERVL-MaLR	443	+	86	109955375	7629
chr13	109947746	110147746	harbor1	chr13	109956842	109957858	LTR/ERVL-MaLR	2322	+	508	109957350	9604
chr13	109947746	110147746	harbor1	chr13	109960864	109961098	LTR/ERVL-MaLR	780	+	117	109960981	13235
chr13	109947746	110147746	harbor1	chr13	109964737	109965061	LTR/ERVL-MaLR	2042	+	162	109964899	17153
chr13	109947746	110147746	harbor1	chr13	109974113	109974514	LTR/ERVL-MaLR	1611	+	200	109974313	26567
chr13	109947746	110147746	harbor1	chr13	109989475	109989639	LTR/ERVL-MaLR	582	+	82	109989557	41811
chr13	109947746	110147746	harbor1	chr13	109993254	109993636	LTR/ERVL-MaLR	2582	+	191	109993445	45699
chr13	109947746	110147746	harbor1	chr13	110016363	110016510	LTR/ERVL-MaLR	510	+	74	110016437	68691
chr13	109947746	110147746	harbor1	chr13	110016720	110016786	LTR/ERVL-MaLR	510	+	33	110016753	69007
chr13	109947746	110147746	harbor1	chr13	110033170	110033331	LTR/ERVL-MaLR	572	+	80	110033250	85504
chr13	109947746	110147746	harbor1	chr13	110035329	110035599	LTR/ERVL-MaLR	810	+	135	110035464	87718
chr13	20315206	20515206	harbor1	chr13	20347090	20347450	LTR/ERVL-MaLR	1767	+	180	20347270	32064
chr13	20315206	20515206	harbor1	chr13	20380328	20380784	LTR/ERVL-MaLR	1197	+	228	20380556	65350
chr13	20315206	20515206	harbor1	chr13	20386607	20386970	LTR/ERVL-MaLR	2463	+	182	20386789	71583
chr13	95201275	95401275	harbor1	chr13	95204332	95204699	LTR/ERVL-MaLR	2297	+	184	95204516	3241
chr13	95201275	95401275	harbor1	chr13	95205652	95205889	LTR/ERVL-MaLR	748	+	118	95205770	4495
chr13	95201275	95401275	harbor1	chr13	95266054	95266525	LTR/ERVL-MaLR	1049	+	236	95266290	65015
chr13	95201275	95401275	harbor1	chr13	95266841	95266879	LTR/ERVL-MaLR	2150	+	19	95266860	65585
chr13	95201275	95401275	harbor1	chr13	95267182	95267506	LTR/ERVL-MaLR	2150	+	162	95267344	66069
chr13	95201275	95401275	harbor1	chr13	95273644	95273803	LTR/ERVL-MaLR	1197	+	80	95273724	72449
chr13	95201275	95401275	harbor1	chr13	95273923	95274128	LTR/ERVL-MaLR	1257	+	102	95274025	72750
chr13	36898615	37098615	harbor1	chr13	36933263	36933606	LTR/ERVL-MaLR	1678	+	172	36933435	34820
chr13	36898615	37098615	harbor1	chr13	36943279	36943704	LTR/ERVL-MaLR	1823	+	212	36943491	44876
chr13	36898615	37098615	harbor1	chr13	36987321	36987718	LTR/ERVL-MaLR	2065	+	198	36987519	88904
chr13	36898615	37098615	harbor1	chr13	36988710	36988883	LTR/ERVL-MaLR	611	+	86	36988796	90181
chr13	36893202	37093202	harbor1	chr13	36894158	36894515	LTR/ERVL-MaLR	2071	+	178	36894336	1134
chr13	36893202	37093202	harbor1	chr13	36933263	36933606	LTR/ERVL-MaLR	1678	+	172	36933435	40233
chr13	36893202	37093202	harbor1	chr13	36943279	36943704	LTR/ERVL-MaLR	1823	+	212	36943491	50289
chr13	36893202	37093202	harbor1	chr13	36987321	36987718	LTR/ERVL-MaLR	2065	+	198	36987519	94317
chr13	36893202	37093202	harbor1	chr13	36988710	36988883	LTR/ERVL-MaLR	611	+	86	36988796	95594
chr14	52595151	52795151	harbor1	chr14	52678885	52679243	LTR/ERVL-MaLR	1372	+	179	52679064	83913
chr14	67141304	67341304	harbor1	chr14	67232035	67232514	LTR/ERVL-MaLR	1441	+	240	67232275	90971
chr14	90282069	90482069	harbor1	chr14	90298558	90298706	LTR/ERVL-MaLR	539	+	74	90298632	16563
chr14	90282069	90482069	harbor1	chr14	90311321	90311677	LTR/ERVL-MaLR	2322	+	178	90311499	29430
chr14	90282069	90482069	harbor1	chr14	90380092	90380507	LTR/ERVL-MaLR	2015	+	208	90380300	98231
chr14	95434849	95634849	harbor1	chr14	95436076	95436573	LTR/ERVL-MaLR	1311	+	248	95436324	1475
chr14	67141322	67341322	harbor1	chr14	67232035	67232514	LTR/ERVL-MaLR	1441	+	240	67232275	90953
chr14	75885958	76085958	harbor1	chr14	75933673	75934064	LTR/ERVL-MaLR	1903	+	196	75933869	47911
chr14	75885958	76085958	harbor1	chr14	75961765	75962237	LTR/ERVL-MaLR	655	+	236	75962001	76043
chr14	104603549	104803549	harbor1	chr14	104607411	104607816	LTR/ERVL-MaLR	2558	+	202	104607613	4064
chr14	104603549	104803549	harbor1	chr14	104610042	104610278	LTR/ERVL-MaLR	929	+	118	104610160	6611
chr14	104603549	104803549	harbor1	chr14	104610279	104610657	LTR/ERVL-MaLR	1522	+	189	104610468	6919
chr14	104603549	104803549	harbor1	chr14	104626344	104626744	LTR/ERVL-MaLR	2209	+	200	104626544	22995
chr14	104603549	104803549	harbor1	chr14	104627639	104628061	LTR/ERVL-MaLR	2844	+	211	104627850	24301
chr14	104603549	104803549	harbor1	chr14	104656776	104657115	LTR/ERVL-MaLR	1247	+	170	104656946	53397
chr14	104603549	104803549	harbor1	chr14	104657376	104657519	LTR/ERVL-MaLR	487	+	72	104657448	53899
chr14	104603549	104803549	harbor1	chr14	104658369	104658553	LTR/ERVL-MaLR	628	+	92	104658461	54912
chr14	104603549	104803549	harbor1	chr14	104662724	104662859	LTR/ERVL-MaLR	1020	+	68	104662792	59243
chr14	104603549	104803549	harbor1	chr14	104663156	104663224	LTR/ERVL-MaLR	1020	+	34	104663190	59641
chr14	104603549	104803549	harbor1	chr14	104673894	104674255	LTR/ERVL-MaLR	2438	+	180	104674074	70525
chr14	104785274	104985274	harbor1	chr14	104818581	104818807	LTR/ERVL-MaLR	560	+	113	104818694	33420
chr14	104785274	104985274	harbor1	chr14	104829004	104829324	LTR/ERVL-MaLR	1212	+	160	104829164	43890
chr14	104785274	104985274	harbor1	chr14	104845632	104845955	LTR/ERVL-MaLR	1579	+	162	104845794	60520
chr14	104785274	104985274	harbor1	chr14	104869556	104869908	LTR/ERVL-MaLR	1407	+	176	104869732	84458
chr14	100185498	100385498	harbor1	chr14	100186975	100187025	LTR/ERVL-MaLR	1063	+	25	100187000	1502
chr14	100185498	100385498	harbor1	chr14	100187329	100187786	LTR/ERVL-MaLR	1063	+	228	100187557	2059
chr14	100185498	100385498	harbor1	chr14	100188270	100188971	LTR/ERVL-MaLR	2598	+	350	100188620	3122
chr14	100185498	100385498	harbor1	chr14	100188972	100189013	LTR/ERVL-MaLR	758	+	20	100188992	3494
chr14	100185498	100385498	harbor1	chr14	100189311	100189585	LTR/ERVL-MaLR	1074	+	137	100189448	3950
chr14	100185498	100385498	harbor1	chr14	100251069	100251524	LTR/ERVL-MaLR	1515	+	228	100251297	65799
chr14	100185498	100385498	harbor1	chr14	100257440	100257794	LTR/ERVL-MaLR	1691	+	177	100257617	72119
chr14	67140883	67340883	harbor1	chr14	67232035	67232514	LTR/ERVL-MaLR	1441	+	240	67232275	91392
chr14	69667796	69867796	harbor1	chr14	69668673	69669043	LTR/ERVL-MaLR	2099	+	185	69668858	1062
chr14	69667796	69867796	harbor1	chr14	69669362	69669397	LTR/ERVL-MaLR	2099	+	18	69669380	1584
chr14	69667796	69867796	harbor1	chr14	69724884	69725307	LTR/ERVL-MaLR	1617	+	212	69725096	57300
chr14	69667796	69867796	harbor1	chr14	69754816	69754987	LTR/ERVL-MaLR	986	+	86	69754902	87106
chr14	69667796	69867796	harbor1	chr14	69755292	69755576	LTR/ERVL-MaLR	986	+	142	69755434	87638
chr14	69667796	69867796	harbor1	chr14	69758202	69758360	LTR/ERVL-MaLR	770	+	79	69758281	90485
chr14	69667796	69867796	harbor1	chr14	69758361	69758521	LTR/ERVL-MaLR	1487	+	80	69758441	90645
chr14	69667796	69867796	harbor1	chr14	69758749	69758948	LTR/ERVL-MaLR	1487	+	100	69758849	91053
chr14	69667796	69867796	harbor1	chr14	69758949	69759298	LTR/ERVL-MaLR	770	+	174	69759123	91327
chr14	69667796	69867796	harbor1	chr14	69759596	69759657	LTR/ERVL-MaLR	770	+	30	69759626	91830
chr14	69667796	69867796	harbor1	chr14	69760075	69760461	LTR/ERVL-MaLR	1955	+	193	69760268	92472
chr14	69667796	69867796	harbor1	chr14	69761122	69761312	LTR/ERVL-MaLR	1256	+	95	69761217	93421
chr14	69667796	69867796	harbor1	chr14	69761611	69761654	LTR/ERVL-MaLR	1256	+	22	69761633	93837
chr14	69667796	69867796	harbor1	chr14	69764098	69764481	LTR/ERVL-MaLR	1825	+	192	69764290	96494
chr14	75327880	75527880	harbor1	chr14	75347031	75347428	LTR/ERVL-MaLR	2476	+	198	75347229	19349
chr14	75327880	75527880	harbor1	chr14	75349560	75349975	LTR/ERVL-MaLR	1844	+	208	75349768	21888
chr14	75327880	75527880	harbor1	chr14	75376258	75376605	LTR/ERVL-MaLR	2083	+	174	75376432	48552
chr14	75327880	75527880	harbor1	chr14	75377033	75377096	LTR/ERVL-MaLR	445	+	32	75377065	49185
chr14	75327880	75527880	harbor1	chr14	75377825	75378157	LTR/ERVL-MaLR	1463	+	166	75377991	50111
chr14	75327880	75527880	harbor1	chr14	75378160	75378888	LTR/ERVL-MaLR	3568	+	364	75378524	50644
chr14	75327880	75527880	harbor1	chr14	75379154	75379602	LTR/ERVL-MaLR	989	+	224	75379378	51498
chr14	75327880	75527880	harbor1	chr14	75379604	75379795	LTR/ERVL-MaLR	1265	+	96	75379700	51820
chr14	75327880	75527880	harbor1	chr14	75380236	75380364	LTR/ERVL-MaLR	1265	+	64	75380300	52420
chr14	75327880	75527880	harbor1	chr14	75399397	75399827	LTR/ERVL-MaLR	682	+	215	75399612	71732
chr14	75327880	75527880	harbor1	chr14	75402942	75403245	LTR/ERVL-MaLR	1349	+	152	75403094	75214
chr14	75327880	75527880	harbor1	chr14	75403838	75404080	LTR/ERVL-MaLR	851	+	121	75403959	76079
chr14	75327880	75527880	harbor1	chr14	75412251	75412406	LTR/ERVL-MaLR	2086	+	78	75412329	84449
chr14	75327880	75527880	harbor1	chr14	75412596	75412818	LTR/ERVL-MaLR	2086	+	111	75412707	84827
chr14	75327880	75527880	harbor1	chr14	75424360	75424760	LTR/ERVL-MaLR	906	+	200	75424560	96680
chr14	99474315	99674315	harbor1	chr14	99530846	99531018	LTR/ERVL-MaLR	1049	+	86	99530932	56617
chr14	99474315	99674315	harbor1	chr14	99550105	99550546	LTR/ERVL-MaLR	1629	+	220	99550325	76010
chr14	99474315	99674315	harbor1	chr14	99558265	99558399	LTR/ERVL-MaLR	1145	+	67	99558332	84017
chr14	99474315	99674315	harbor1	chr14	99558647	99558796	LTR/ERVL-MaLR	1145	+	74	99558721	84406
chr14	99474315	99674315	harbor1	chr14	99558797	99559210	LTR/ERVL-MaLR	2378	+	206	99559003	84688
chr14	99474315	99674315	harbor1	chr14	99559211	99559362	LTR/ERVL-MaLR	1145	+	76	99559287	84972
chr14	100185509	100385509	harbor1	chr14	100186975	100187025	LTR/ERVL-MaLR	1063	+	25	100187000	1491
chr14	100185509	100385509	harbor1	chr14	100187329	100187786	LTR/ERVL-MaLR	1063	+	228	100187557	2048
chr14	100185509	100385509	harbor1	chr14	100188270	100188971	LTR/ERVL-MaLR	2598	+	350	100188620	3111
chr14	100185509	100385509	harbor1	chr14	100188972	100189013	LTR/ERVL-MaLR	758	+	20	100188992	3483
chr14	100185509	100385509	harbor1	chr14	100189311	100189585	LTR/ERVL-MaLR	1074	+	137	100189448	3939
chr14	100185509	100385509	harbor1	chr14	100251069	100251524	LTR/ERVL-MaLR	1515	+	228	100251297	65788
chr14	100185509	100385509	harbor1	chr14	100257440	100257794	LTR/ERVL-MaLR	1691	+	177	100257617	72108
chr14	67141305	67341305	harbor1	chr14	67232035	67232514	LTR/ERVL-MaLR	1441	+	240	67232275	90970
chr14	20990648	21190648	harbor1	chr14	21029261	21029318	LTR/ERVL-MaLR	2050	+	28	21029289	38641
chr14	20990648	21190648	harbor1	chr14	21029629	21029946	LTR/ERVL-MaLR	2050	+	158	21029787	39139
chr14	90164299	90364299	harbor1	chr14	90168770	90169104	LTR/ERVL-MaLR	2131	+	167	90168937	4638
chr14	90164299	90364299	harbor1	chr14	90218210	90218372	LTR/ERVL-MaLR	1918	+	81	90218291	53992
chr14	90164299	90364299	harbor1	chr14	90218599	90218632	LTR/ERVL-MaLR	1918	+	16	90218615	54316
chr14	90164299	90364299	harbor1	chr14	90218934	90219223	LTR/ERVL-MaLR	1918	+	144	90219078	54779
chr14	90164299	90364299	harbor1	chr14	90220870	90221287	LTR/ERVL-MaLR	2467	+	208	90221078	56779
chr14	75328395	75528395	harbor1	chr14	75347031	75347428	LTR/ERVL-MaLR	2476	+	198	75347229	18834
chr14	75328395	75528395	harbor1	chr14	75349560	75349975	LTR/ERVL-MaLR	1844	+	208	75349768	21373
chr14	75328395	75528395	harbor1	chr14	75376258	75376605	LTR/ERVL-MaLR	2083	+	174	75376432	48037
chr14	75328395	75528395	harbor1	chr14	75377033	75377096	LTR/ERVL-MaLR	445	+	32	75377065	48670
chr14	75328395	75528395	harbor1	chr14	75377825	75378157	LTR/ERVL-MaLR	1463	+	166	75377991	49596
chr14	75328395	75528395	harbor1	chr14	75378160	75378888	LTR/ERVL-MaLR	3568	+	364	75378524	50129
chr14	75328395	75528395	harbor1	chr14	75379154	75379602	LTR/ERVL-MaLR	989	+	224	75379378	50983
chr14	75328395	75528395	harbor1	chr14	75379604	75379795	LTR/ERVL-MaLR	1265	+	96	75379700	51305
chr14	75328395	75528395	harbor1	chr14	75380236	75380364	LTR/ERVL-MaLR	1265	+	64	75380300	51905
chr14	75328395	75528395	harbor1	chr14	75399397	75399827	LTR/ERVL-MaLR	682	+	215	75399612	71217
chr14	75328395	75528395	harbor1	chr14	75402942	75403245	LTR/ERVL-MaLR	1349	+	152	75403094	74699
chr14	75328395	75528395	harbor1	chr14	75403838	75404080	LTR/ERVL-MaLR	851	+	121	75403959	75564
chr14	75328395	75528395	harbor1	chr14	75412251	75412406	LTR/ERVL-MaLR	2086	+	78	75412329	83934
chr14	75328395	75528395	harbor1	chr14	75412596	75412818	LTR/ERVL-MaLR	2086	+	111	75412707	84312
chr14	75328395	75528395	harbor1	chr14	75424360	75424760	LTR/ERVL-MaLR	906	+	200	75424560	96165
chr14	75328436	75528436	harbor1	chr14	75347031	75347428	LTR/ERVL-MaLR	2476	+	198	75347229	18793
chr14	75328436	75528436	harbor1	chr14	75349560	75349975	LTR/ERVL-MaLR	1844	+	208	75349768	21332
chr14	75328436	75528436	harbor1	chr14	75376258	75376605	LTR/ERVL-MaLR	2083	+	174	75376432	47996
chr14	75328436	75528436	harbor1	chr14	75377033	75377096	LTR/ERVL-MaLR	445	+	32	75377065	48629
chr14	75328436	75528436	harbor1	chr14	75377825	75378157	LTR/ERVL-MaLR	1463	+	166	75377991	49555
chr14	75328436	75528436	harbor1	chr14	75378160	75378888	LTR/ERVL-MaLR	3568	+	364	75378524	50088
chr14	75328436	75528436	harbor1	chr14	75379154	75379602	LTR/ERVL-MaLR	989	+	224	75379378	50942
chr14	75328436	75528436	harbor1	chr14	75379604	75379795	LTR/ERVL-MaLR	1265	+	96	75379700	51264
chr14	75328436	75528436	harbor1	chr14	75380236	75380364	LTR/ERVL-MaLR	1265	+	64	75380300	51864
chr14	75328436	75528436	harbor1	chr14	75399397	75399827	LTR/ERVL-MaLR	682	+	215	75399612	71176
chr14	75328436	75528436	harbor1	chr14	75402942	75403245	LTR/ERVL-MaLR	1349	+	152	75403094	74658
chr14	75328436	75528436	harbor1	chr14	75403838	75404080	LTR/ERVL-MaLR	851	+	121	75403959	75523
chr14	75328436	75528436	harbor1	chr14	75412251	75412406	LTR/ERVL-MaLR	2086	+	78	75412329	83893
chr14	75328436	75528436	harbor1	chr14	75412596	75412818	LTR/ERVL-MaLR	2086	+	111	75412707	84271
chr14	75328436	75528436	harbor1	chr14	75424360	75424760	LTR/ERVL-MaLR	906	+	200	75424560	96124
chr14	95435211	95635211	harbor1	chr14	95436076	95436573	LTR/ERVL-MaLR	1311	+	248	95436324	1113
chr14	99488601	99688601	harbor1	chr14	99530846	99531018	LTR/ERVL-MaLR	1049	+	86	99530932	42331
chr14	99488601	99688601	harbor1	chr14	99550105	99550546	LTR/ERVL-MaLR	1629	+	220	99550325	61724
chr14	99488601	99688601	harbor1	chr14	99558265	99558399	LTR/ERVL-MaLR	1145	+	67	99558332	69731
chr14	99488601	99688601	harbor1	chr14	99558647	99558796	LTR/ERVL-MaLR	1145	+	74	99558721	70120
chr14	99488601	99688601	harbor1	chr14	99558797	99559210	LTR/ERVL-MaLR	2378	+	206	99559003	70402
chr14	99488601	99688601	harbor1	chr14	99559211	99559362	LTR/ERVL-MaLR	1145	+	76	99559287	70686
chr14	90282794	90482794	harbor1	chr14	90298558	90298706	LTR/ERVL-MaLR	539	+	74	90298632	15838
chr14	90282794	90482794	harbor1	chr14	90311321	90311677	LTR/ERVL-MaLR	2322	+	178	90311499	28705
chr14	90282794	90482794	harbor1	chr14	90380092	90380507	LTR/ERVL-MaLR	2015	+	208	90380300	97506
chr14	75328363	75528363	harbor1	chr14	75347031	75347428	LTR/ERVL-MaLR	2476	+	198	75347229	18866
chr14	75328363	75528363	harbor1	chr14	75349560	75349975	LTR/ERVL-MaLR	1844	+	208	75349768	21405
chr14	75328363	75528363	harbor1	chr14	75376258	75376605	LTR/ERVL-MaLR	2083	+	174	75376432	48069
chr14	75328363	75528363	harbor1	chr14	75377033	75377096	LTR/ERVL-MaLR	445	+	32	75377065	48702
chr14	75328363	75528363	harbor1	chr14	75377825	75378157	LTR/ERVL-MaLR	1463	+	166	75377991	49628
chr14	75328363	75528363	harbor1	chr14	75378160	75378888	LTR/ERVL-MaLR	3568	+	364	75378524	50161
chr14	75328363	75528363	harbor1	chr14	75379154	75379602	LTR/ERVL-MaLR	989	+	224	75379378	51015
chr14	75328363	75528363	harbor1	chr14	75379604	75379795	LTR/ERVL-MaLR	1265	+	96	75379700	51337
chr14	75328363	75528363	harbor1	chr14	75380236	75380364	LTR/ERVL-MaLR	1265	+	64	75380300	51937
chr14	75328363	75528363	harbor1	chr14	75399397	75399827	LTR/ERVL-MaLR	682	+	215	75399612	71249
chr14	75328363	75528363	harbor1	chr14	75402942	75403245	LTR/ERVL-MaLR	1349	+	152	75403094	74731
chr14	75328363	75528363	harbor1	chr14	75403838	75404080	LTR/ERVL-MaLR	851	+	121	75403959	75596
chr14	75328363	75528363	harbor1	chr14	75412251	75412406	LTR/ERVL-MaLR	2086	+	78	75412329	83966
chr14	75328363	75528363	harbor1	chr14	75412596	75412818	LTR/ERVL-MaLR	2086	+	111	75412707	84344
chr14	75328363	75528363	harbor1	chr14	75424360	75424760	LTR/ERVL-MaLR	906	+	200	75424560	96197
chr14	67140875	67340875	harbor1	chr14	67232035	67232514	LTR/ERVL-MaLR	1441	+	240	67232275	91400
chr14	66148048	66348048	harbor1	chr14	66166047	66166417	LTR/ERVL-MaLR	2361	+	185	66166232	18184
chr14	66148048	66348048	harbor1	chr14	66199803	66200177	LTR/ERVL-MaLR	2054	+	187	66199990	51942
chr14	66148048	66348048	harbor1	chr14	66200178	66200996	LTR/ERVL-MaLR	4736	+	409	66200587	52539
chr14	66148048	66348048	harbor1	chr14	66206654	66207391	LTR/ERVL-MaLR	4909	+	368	66207022	58974
chr14	66148048	66348048	harbor1	chr14	66238655	66239025	LTR/ERVL-MaLR	590	+	185	66238840	90792
chr14	66148048	66348048	harbor1	chr14	66241496	66241839	LTR/ERVL-MaLR	1498	+	172	66241668	93620
chr14	66148048	66348048	harbor1	chr14	66207392	66207767	LTR/ERVL-MaLR	2460	+	188	66207580	59532
chr14	81174155	81374155	harbor1	chr14	81207193	81207518	LTR/ERVL-MaLR	2249	+	162	81207355	33200
chr14	81174155	81374155	harbor1	chr14	81207519	81209106	LTR/ERVL-MaLR	11347	+	794	81208313	34158
chr14	81174155	81374155	harbor1	chr14	81209107	81209484	LTR/ERVL-MaLR	2463	+	188	81209295	35140
chr14	81174155	81374155	harbor1	chr14	81211567	81211659	LTR/ERVL-MaLR	523	+	46	81211613	37458
chr14	81174155	81374155	harbor1	chr14	81248800	81248955	LTR/ERVL-MaLR	1297	+	78	81248878	74723
chr14	81174155	81374155	harbor1	chr14	81249250	81249582	LTR/ERVL-MaLR	1297	+	166	81249416	75261
chr14	81174155	81374155	harbor1	chr14	81256598	81256961	LTR/ERVL-MaLR	1852	+	182	81256780	82625
chr14	81174155	81374155	harbor1	chr14	81257237	81257273	LTR/ERVL-MaLR	1852	+	18	81257255	83100
chr14	100229889	100429889	harbor1	chr14	100251069	100251524	LTR/ERVL-MaLR	1515	+	228	100251297	21408
chr14	100229889	100429889	harbor1	chr14	100257440	100257794	LTR/ERVL-MaLR	1691	+	177	100257617	27728
chr14	100229889	100429889	harbor1	chr14	100288831	100289265	LTR/ERVL-MaLR	1620	+	217	100289048	59159
chr14	100229889	100429889	harbor1	chr14	100310911	100310960	LTR/ERVL-MaLR	553	+	24	100310935	81046
chr14	100229889	100429889	harbor1	chr14	100311137	100311225	LTR/ERVL-MaLR	553	+	44	100311181	81292
chr14	100229889	100429889	harbor1	chr14	100315134	100315602	LTR/ERVL-MaLR	1690	+	234	100315368	85479
chr14	100229889	100429889	harbor1	chr14	100315909	100315968	LTR/ERVL-MaLR	1690	+	30	100315939	86050
chr14	21337415	21537415	harbor1	chr14	21372468	21372721	LTR/ERVL-MaLR	713	+	126	21372594	35179
chr14	21337415	21537415	harbor1	chr14	21406272	21406640	LTR/ERVL-MaLR	527	+	184	21406456	69041
chr14	21337415	21537415	harbor1	chr14	21421703	21422058	LTR/ERVL-MaLR	1879	+	178	21421881	84466
chr14	21337415	21537415	harbor1	chr14	21422360	21422421	LTR/ERVL-MaLR	1879	+	30	21422390	84975
chr14	99493213	99693213	harbor1	chr14	99530846	99531018	LTR/ERVL-MaLR	1049	+	86	99530932	37719
chr14	99493213	99693213	harbor1	chr14	99550105	99550546	LTR/ERVL-MaLR	1629	+	220	99550325	57112
chr14	99493213	99693213	harbor1	chr14	99558265	99558399	LTR/ERVL-MaLR	1145	+	67	99558332	65119
chr14	99493213	99693213	harbor1	chr14	99558647	99558796	LTR/ERVL-MaLR	1145	+	74	99558721	65508
chr14	99493213	99693213	harbor1	chr14	99558797	99559210	LTR/ERVL-MaLR	2378	+	206	99559003	65790
chr14	99493213	99693213	harbor1	chr14	99559211	99559362	LTR/ERVL-MaLR	1145	+	76	99559287	66074
chr14	100234889	100434889	harbor1	chr14	100251069	100251524	LTR/ERVL-MaLR	1515	+	228	100251297	16408
chr14	100234889	100434889	harbor1	chr14	100257440	100257794	LTR/ERVL-MaLR	1691	+	177	100257617	22728
chr14	100234889	100434889	harbor1	chr14	100288831	100289265	LTR/ERVL-MaLR	1620	+	217	100289048	54159
chr14	100234889	100434889	harbor1	chr14	100310911	100310960	LTR/ERVL-MaLR	553	+	24	100310935	76046
chr14	100234889	100434889	harbor1	chr14	100311137	100311225	LTR/ERVL-MaLR	553	+	44	100311181	76292
chr14	100234889	100434889	harbor1	chr14	100315134	100315602	LTR/ERVL-MaLR	1690	+	234	100315368	80479
chr14	100234889	100434889	harbor1	chr14	100315909	100315968	LTR/ERVL-MaLR	1690	+	30	100315939	81050
chr14	95435221	95635221	harbor1	chr14	95436076	95436573	LTR/ERVL-MaLR	1311	+	248	95436324	1103
chr14	88923334	89123334	harbor1	chr14	88926555	88926912	LTR/ERVL-MaLR	2274	+	178	88926733	3399
chr14	88923334	89123334	harbor1	chr14	88939567	88939932	LTR/ERVL-MaLR	526	+	182	88939749	16415
chr14	88923334	89123334	harbor1	chr14	88945580	88946003	LTR/ERVL-MaLR	2262	+	212	88945792	22458
chr14	88923334	89123334	harbor1	chr14	88951330	88951471	LTR/ERVL-MaLR	588	+	70	88951400	28066
chr14	88923334	89123334	harbor1	chr14	88952012	88952191	LTR/ERVL-MaLR	680	+	90	88952102	28768
chr14	88923334	89123334	harbor1	chr14	88953678	88954055	LTR/ERVL-MaLR	883	+	188	88953866	30532
chr14	88923334	89123334	harbor1	chr14	88964027	88964372	LTR/ERVL-MaLR	761	+	172	88964199	40865
chr14	88923334	89123334	harbor1	chr14	88964462	88964947	LTR/ERVL-MaLR	1123	+	242	88964704	41370
chr14	88923334	89123334	harbor1	chr14	88967315	88967811	LTR/ERVL-MaLR	945	+	248	88967563	44229
chr14	88923334	89123334	harbor1	chr14	88969171	88969646	LTR/ERVL-MaLR	2754	+	238	88969409	46075
chr14	88923334	89123334	harbor1	chr14	88992724	88993103	LTR/ERVL-MaLR	824	+	190	88992914	69580
chr14	88923334	89123334	harbor1	chr14	89000038	89000245	LTR/ERVL-MaLR	514	+	104	89000142	76808
chr14	88923334	89123334	harbor1	chr14	89004361	89004808	LTR/ERVL-MaLR	1378	+	224	89004585	81251
chr14	88923334	89123334	harbor1	chr14	89011859	89012261	LTR/ERVL-MaLR	925	+	201	89012060	88726
chr14	88923334	89123334	harbor1	chr14	89013179	89013668	LTR/ERVL-MaLR	774	+	244	89013423	90089
chr14	95435535	95635535	harbor1	chr14	95436076	95436573	LTR/ERVL-MaLR	1311	+	248	95436324	789
chr14	91224851	91424851	harbor1	chr14	91230494	91230677	LTR/ERVL-MaLR	775	+	92	91230586	5735
chr14	91224851	91424851	harbor1	chr14	91250864	91251371	LTR/ERVL-MaLR	1349	+	254	91251118	26267
chr14	91224851	91424851	harbor1	chr14	91251672	91251724	LTR/ERVL-MaLR	1349	+	26	91251698	26847
chr14	91224851	91424851	harbor1	chr14	91260449	91260491	LTR/ERVL-MaLR	1939	+	21	91260470	35619
chr14	91224851	91424851	harbor1	chr14	91260793	91261239	LTR/ERVL-MaLR	1939	+	223	91261016	36165
chr14	91224851	91424851	harbor1	chr14	91295748	91296128	LTR/ERVL-MaLR	1244	+	190	91295938	71087
chr14	100229897	100429897	harbor1	chr14	100251069	100251524	LTR/ERVL-MaLR	1515	+	228	100251297	21400
chr14	100229897	100429897	harbor1	chr14	100257440	100257794	LTR/ERVL-MaLR	1691	+	177	100257617	27720
chr14	100229897	100429897	harbor1	chr14	100288831	100289265	LTR/ERVL-MaLR	1620	+	217	100289048	59151
chr14	100229897	100429897	harbor1	chr14	100310911	100310960	LTR/ERVL-MaLR	553	+	24	100310935	81038
chr14	100229897	100429897	harbor1	chr14	100311137	100311225	LTR/ERVL-MaLR	553	+	44	100311181	81284
chr14	100229897	100429897	harbor1	chr14	100315134	100315602	LTR/ERVL-MaLR	1690	+	234	100315368	85471
chr14	100229897	100429897	harbor1	chr14	100315909	100315968	LTR/ERVL-MaLR	1690	+	30	100315939	86042
chr14	23252014	23452014	harbor1	chr14	23291361	23291490	LTR/ERVL-MaLR	2072	+	64	23291425	39411
chr14	23252014	23452014	harbor1	chr14	23291789	23292059	LTR/ERVL-MaLR	2072	+	135	23291924	39910
chr14	23252014	23452014	harbor1	chr14	23331352	23331684	LTR/ERVL-MaLR	1642	+	166	23331518	79504
chr14	23252014	23452014	harbor1	chr14	23339849	23340219	LTR/ERVL-MaLR	1928	+	185	23340034	88020
chr14	69667837	69867837	harbor1	chr14	69668673	69669043	LTR/ERVL-MaLR	2099	+	185	69668858	1021
chr14	69667837	69867837	harbor1	chr14	69669362	69669397	LTR/ERVL-MaLR	2099	+	18	69669380	1543
chr14	69667837	69867837	harbor1	chr14	69724884	69725307	LTR/ERVL-MaLR	1617	+	212	69725096	57259
chr14	69667837	69867837	harbor1	chr14	69754816	69754987	LTR/ERVL-MaLR	986	+	86	69754902	87065
chr14	69667837	69867837	harbor1	chr14	69755292	69755576	LTR/ERVL-MaLR	986	+	142	69755434	87597
chr14	69667837	69867837	harbor1	chr14	69758202	69758360	LTR/ERVL-MaLR	770	+	79	69758281	90444
chr14	69667837	69867837	harbor1	chr14	69758361	69758521	LTR/ERVL-MaLR	1487	+	80	69758441	90604
chr14	69667837	69867837	harbor1	chr14	69758749	69758948	LTR/ERVL-MaLR	1487	+	100	69758849	91012
chr14	69667837	69867837	harbor1	chr14	69758949	69759298	LTR/ERVL-MaLR	770	+	174	69759123	91286
chr14	69667837	69867837	harbor1	chr14	69759596	69759657	LTR/ERVL-MaLR	770	+	30	69759626	91789
chr14	69667837	69867837	harbor1	chr14	69760075	69760461	LTR/ERVL-MaLR	1955	+	193	69760268	92431
chr14	69667837	69867837	harbor1	chr14	69761122	69761312	LTR/ERVL-MaLR	1256	+	95	69761217	93380
chr14	69667837	69867837	harbor1	chr14	69761611	69761654	LTR/ERVL-MaLR	1256	+	22	69761633	93796
chr14	69667837	69867837	harbor1	chr14	69764098	69764481	LTR/ERVL-MaLR	1825	+	192	69764290	96453
chr14	100185484	100385484	harbor1	chr14	100186975	100187025	LTR/ERVL-MaLR	1063	+	25	100187000	1516
chr14	100185484	100385484	harbor1	chr14	100187329	100187786	LTR/ERVL-MaLR	1063	+	228	100187557	2073
chr14	100185484	100385484	harbor1	chr14	100188270	100188971	LTR/ERVL-MaLR	2598	+	350	100188620	3136
chr14	100185484	100385484	harbor1	chr14	100188972	100189013	LTR/ERVL-MaLR	758	+	20	100188992	3508
chr14	100185484	100385484	harbor1	chr14	100189311	100189585	LTR/ERVL-MaLR	1074	+	137	100189448	3964
chr14	100185484	100385484	harbor1	chr14	100251069	100251524	LTR/ERVL-MaLR	1515	+	228	100251297	65813
chr14	100185484	100385484	harbor1	chr14	100257440	100257794	LTR/ERVL-MaLR	1691	+	177	100257617	72133
chr14	104590358	104790358	harbor1	chr14	104597492	104597782	LTR/ERVL-MaLR	808	+	145	104597637	7279
chr14	104590358	104790358	harbor1	chr14	104602832	104603062	LTR/ERVL-MaLR	639	+	115	104602947	12589
chr14	104590358	104790358	harbor1	chr14	104607411	104607816	LTR/ERVL-MaLR	2558	+	202	104607613	17255
chr14	104590358	104790358	harbor1	chr14	104610042	104610278	LTR/ERVL-MaLR	929	+	118	104610160	19802
chr14	104590358	104790358	harbor1	chr14	104610279	104610657	LTR/ERVL-MaLR	1522	+	189	104610468	20110
chr14	104590358	104790358	harbor1	chr14	104626344	104626744	LTR/ERVL-MaLR	2209	+	200	104626544	36186
chr14	104590358	104790358	harbor1	chr14	104627639	104628061	LTR/ERVL-MaLR	2844	+	211	104627850	37492
chr14	104590358	104790358	harbor1	chr14	104656776	104657115	LTR/ERVL-MaLR	1247	+	170	104656946	66588
chr14	104590358	104790358	harbor1	chr14	104657376	104657519	LTR/ERVL-MaLR	487	+	72	104657448	67090
chr14	104590358	104790358	harbor1	chr14	104658369	104658553	LTR/ERVL-MaLR	628	+	92	104658461	68103
chr14	104590358	104790358	harbor1	chr14	104662724	104662859	LTR/ERVL-MaLR	1020	+	68	104662792	72434
chr14	104590358	104790358	harbor1	chr14	104663156	104663224	LTR/ERVL-MaLR	1020	+	34	104663190	72832
chr14	104590358	104790358	harbor1	chr14	104673894	104674255	LTR/ERVL-MaLR	2438	+	180	104674074	83716
chr14	100182129	100382129	harbor1	chr14	100186975	100187025	LTR/ERVL-MaLR	1063	+	25	100187000	4871
chr14	100182129	100382129	harbor1	chr14	100187329	100187786	LTR/ERVL-MaLR	1063	+	228	100187557	5428
chr14	100182129	100382129	harbor1	chr14	100188270	100188971	LTR/ERVL-MaLR	2598	+	350	100188620	6491
chr14	100182129	100382129	harbor1	chr14	100188972	100189013	LTR/ERVL-MaLR	758	+	20	100188992	6863
chr14	100182129	100382129	harbor1	chr14	100189311	100189585	LTR/ERVL-MaLR	1074	+	137	100189448	7319
chr14	100182129	100382129	harbor1	chr14	100251069	100251524	LTR/ERVL-MaLR	1515	+	228	100251297	69168
chr14	100182129	100382129	harbor1	chr14	100257440	100257794	LTR/ERVL-MaLR	1691	+	177	100257617	75488
chr14	23452131	23652131	harbor1	chr14	23456958	23457301	LTR/ERVL-MaLR	1821	+	172	23457130	4999
chr14	23452131	23652131	harbor1	chr14	23457607	23457678	LTR/ERVL-MaLR	1821	+	36	23457643	5512
chr14	23452131	23652131	harbor1	chr14	23460785	23461253	LTR/ERVL-MaLR	1836	+	234	23461019	8888
chr14	105059476	105259476	harbor1	chr14	105118100	105118297	LTR/ERVL-MaLR	671	+	98	105118198	58722
chr14	105059476	105259476	harbor1	chr14	105120567	105120916	LTR/ERVL-MaLR	1790	+	174	105120741	61265
chr14	67500240	67700240	harbor1	chr14	67595532	67595677	LTR/ERVL-MaLR	589	+	72	67595604	95364
chr14	104780663	104980663	harbor1	chr14	104818581	104818807	LTR/ERVL-MaLR	560	+	113	104818694	38031
chr14	104780663	104980663	harbor1	chr14	104829004	104829324	LTR/ERVL-MaLR	1212	+	160	104829164	48501
chr14	104780663	104980663	harbor1	chr14	104845632	104845955	LTR/ERVL-MaLR	1579	+	162	104845794	65131
chr14	104780663	104980663	harbor1	chr14	104869556	104869908	LTR/ERVL-MaLR	1407	+	176	104869732	89069
chr14	76928821	77128821	harbor1	chr14	76997661	76997779	LTR/ERVL-MaLR	565	+	59	76997720	68899
chr14	76928821	77128821	harbor1	chr14	76998082	76998400	LTR/ERVL-MaLR	565	+	159	76998241	69420
chr14	69667763	69867763	harbor1	chr14	69668673	69669043	LTR/ERVL-MaLR	2099	+	185	69668858	1095
chr14	69667763	69867763	harbor1	chr14	69669362	69669397	LTR/ERVL-MaLR	2099	+	18	69669380	1617
chr14	69667763	69867763	harbor1	chr14	69724884	69725307	LTR/ERVL-MaLR	1617	+	212	69725096	57333
chr14	69667763	69867763	harbor1	chr14	69754816	69754987	LTR/ERVL-MaLR	986	+	86	69754902	87139
chr14	69667763	69867763	harbor1	chr14	69755292	69755576	LTR/ERVL-MaLR	986	+	142	69755434	87671
chr14	69667763	69867763	harbor1	chr14	69758202	69758360	LTR/ERVL-MaLR	770	+	79	69758281	90518
chr14	69667763	69867763	harbor1	chr14	69758361	69758521	LTR/ERVL-MaLR	1487	+	80	69758441	90678
chr14	69667763	69867763	harbor1	chr14	69758749	69758948	LTR/ERVL-MaLR	1487	+	100	69758849	91086
chr14	69667763	69867763	harbor1	chr14	69758949	69759298	LTR/ERVL-MaLR	770	+	174	69759123	91360
chr14	69667763	69867763	harbor1	chr14	69759596	69759657	LTR/ERVL-MaLR	770	+	30	69759626	91863
chr14	69667763	69867763	harbor1	chr14	69760075	69760461	LTR/ERVL-MaLR	1955	+	193	69760268	92505
chr14	69667763	69867763	harbor1	chr14	69761122	69761312	LTR/ERVL-MaLR	1256	+	95	69761217	93454
chr14	69667763	69867763	harbor1	chr14	69761611	69761654	LTR/ERVL-MaLR	1256	+	22	69761633	93870
chr14	69667763	69867763	harbor1	chr14	69764098	69764481	LTR/ERVL-MaLR	1825	+	192	69764290	96527
chr14	94074221	94274221	harbor1	chr14	94085988	94086413	LTR/ERVL-MaLR	2533	+	212	94086200	11979
chr14	94074221	94274221	harbor1	chr14	94092705	94092905	LTR/ERVL-MaLR	1260	+	100	94092805	18584
chr14	94074221	94274221	harbor1	chr14	94099475	94099706	LTR/ERVL-MaLR	991	+	116	94099591	25370
chr14	94074221	94274221	harbor1	chr14	94103714	94104160	LTR/ERVL-MaLR	1588	+	223	94103937	29716
chr14	94074221	94274221	harbor1	chr14	94118207	94118348	LTR/ERVL-MaLR	1320	+	70	94118277	44056
chr14	94074221	94274221	harbor1	chr14	94118657	94119110	LTR/ERVL-MaLR	1969	+	226	94118883	44662
chr14	94074221	94274221	harbor1	chr14	94119578	94119792	LTR/ERVL-MaLR	435	+	107	94119685	45464
chr14	94074221	94274221	harbor1	chr14	94122867	94123230	LTR/ERVL-MaLR	2691	+	182	94123049	48828
chr14	94074221	94274221	harbor1	chr14	94123743	94124068	LTR/ERVL-MaLR	1169	+	162	94123905	49684
chr14	94074221	94274221	harbor1	chr14	94126811	94127216	LTR/ERVL-MaLR	2277	+	202	94127013	52792
chr14	94074221	94274221	harbor1	chr14	94135062	94135127	LTR/ERVL-MaLR	1968	+	32	94135094	60873
chr14	94074221	94274221	harbor1	chr14	94135493	94135888	LTR/ERVL-MaLR	1968	+	198	94135691	61470
chr14	94074221	94274221	harbor1	chr14	94146528	94146695	LTR/ERVL-MaLR	1145	+	84	94146612	72391
chr14	94074221	94274221	harbor1	chr14	94152281	94152516	LTR/ERVL-MaLR	1378	+	118	94152399	78178
chr14	94074221	94274221	harbor1	chr14	94154412	94154786	LTR/ERVL-MaLR	2754	+	187	94154599	80378
chr14	94074221	94274221	harbor1	chr14	94154790	94156323	LTR/ERVL-MaLR	10643	+	766	94155556	81335
chr14	94074221	94274221	harbor1	chr14	94156329	94156532	LTR/ERVL-MaLR	1200	+	102	94156431	82210
chr14	94074221	94274221	harbor1	chr14	94161110	94161524	LTR/ERVL-MaLR	2585	+	207	94161317	87096
chr14	94074221	94274221	harbor1	chr14	94166628	94166984	LTR/ERVL-MaLR	1836	+	178	94166806	92585
chr14	75327097	75527097	harbor1	chr14	75347031	75347428	LTR/ERVL-MaLR	2476	+	198	75347229	20132
chr14	75327097	75527097	harbor1	chr14	75349560	75349975	LTR/ERVL-MaLR	1844	+	208	75349768	22671
chr14	75327097	75527097	harbor1	chr14	75376258	75376605	LTR/ERVL-MaLR	2083	+	174	75376432	49335
chr14	75327097	75527097	harbor1	chr14	75377033	75377096	LTR/ERVL-MaLR	445	+	32	75377065	49968
chr14	75327097	75527097	harbor1	chr14	75377825	75378157	LTR/ERVL-MaLR	1463	+	166	75377991	50894
chr14	75327097	75527097	harbor1	chr14	75378160	75378888	LTR/ERVL-MaLR	3568	+	364	75378524	51427
chr14	75327097	75527097	harbor1	chr14	75379154	75379602	LTR/ERVL-MaLR	989	+	224	75379378	52281
chr14	75327097	75527097	harbor1	chr14	75379604	75379795	LTR/ERVL-MaLR	1265	+	96	75379700	52603
chr14	75327097	75527097	harbor1	chr14	75380236	75380364	LTR/ERVL-MaLR	1265	+	64	75380300	53203
chr14	75327097	75527097	harbor1	chr14	75399397	75399827	LTR/ERVL-MaLR	682	+	215	75399612	72515
chr14	75327097	75527097	harbor1	chr14	75402942	75403245	LTR/ERVL-MaLR	1349	+	152	75403094	75997
chr14	75327097	75527097	harbor1	chr14	75403838	75404080	LTR/ERVL-MaLR	851	+	121	75403959	76862
chr14	75327097	75527097	harbor1	chr14	75412251	75412406	LTR/ERVL-MaLR	2086	+	78	75412329	85232
chr14	75327097	75527097	harbor1	chr14	75412596	75412818	LTR/ERVL-MaLR	2086	+	111	75412707	85610
chr14	75327097	75527097	harbor1	chr14	75424360	75424760	LTR/ERVL-MaLR	906	+	200	75424560	97463
chr14	76928851	77128851	harbor1	chr14	76997661	76997779	LTR/ERVL-MaLR	565	+	59	76997720	68869
chr14	76928851	77128851	harbor1	chr14	76998082	76998400	LTR/ERVL-MaLR	565	+	159	76998241	69390
chr14	21308274	21508274	harbor1	chr14	21372468	21372721	LTR/ERVL-MaLR	713	+	126	21372594	64320
chr14	21308274	21508274	harbor1	chr14	21406272	21406640	LTR/ERVL-MaLR	527	+	184	21406456	98182
chr14	76928811	77128811	harbor1	chr14	76997661	76997779	LTR/ERVL-MaLR	565	+	59	76997720	68909
chr14	76928811	77128811	harbor1	chr14	76998082	76998400	LTR/ERVL-MaLR	565	+	159	76998241	69430
chr14	100229954	100429954	harbor1	chr14	100251069	100251524	LTR/ERVL-MaLR	1515	+	228	100251297	21343
chr14	100229954	100429954	harbor1	chr14	100257440	100257794	LTR/ERVL-MaLR	1691	+	177	100257617	27663
chr14	100229954	100429954	harbor1	chr14	100288831	100289265	LTR/ERVL-MaLR	1620	+	217	100289048	59094
chr14	100229954	100429954	harbor1	chr14	100310911	100310960	LTR/ERVL-MaLR	553	+	24	100310935	80981
chr14	100229954	100429954	harbor1	chr14	100311137	100311225	LTR/ERVL-MaLR	553	+	44	100311181	81227
chr14	100229954	100429954	harbor1	chr14	100315134	100315602	LTR/ERVL-MaLR	1690	+	234	100315368	85414
chr14	100229954	100429954	harbor1	chr14	100315909	100315968	LTR/ERVL-MaLR	1690	+	30	100315939	85985
chr14	76928796	77128796	harbor1	chr14	76997661	76997779	LTR/ERVL-MaLR	565	+	59	76997720	68924
chr14	76928796	77128796	harbor1	chr14	76998082	76998400	LTR/ERVL-MaLR	565	+	159	76998241	69445
chr14	51140268	51340268	harbor1	chr14	51156456	51156864	LTR/ERVL-MaLR	2269	+	204	51156660	16392
chr14	51140268	51340268	harbor1	chr14	51160946	51161317	LTR/ERVL-MaLR	2012	+	186	51161132	20864
chr14	51140268	51340268	harbor1	chr14	51175110	51175158	LTR/ERVL-MaLR	2103	+	24	51175134	34866
chr14	51140268	51340268	harbor1	chr14	51175462	51175823	LTR/ERVL-MaLR	2103	+	180	51175642	35374
chr14	51140268	51340268	harbor1	chr14	51182929	51183186	LTR/ERVL-MaLR	759	+	128	51183057	42789
chr14	51140268	51340268	harbor1	chr14	51213356	51213606	LTR/ERVL-MaLR	870	+	125	51213481	73213
chr14	51140268	51340268	harbor1	chr14	51216576	51216739	LTR/ERVL-MaLR	476	+	82	51216658	76390
chr14	51140268	51340268	harbor1	chr14	51228223	51228740	LTR/ERVL-MaLR	2029	+	258	51228481	88213
chr14	91224777	91424777	harbor1	chr14	91230494	91230677	LTR/ERVL-MaLR	775	+	92	91230586	5809
chr14	91224777	91424777	harbor1	chr14	91250864	91251371	LTR/ERVL-MaLR	1349	+	254	91251118	26341
chr14	91224777	91424777	harbor1	chr14	91251672	91251724	LTR/ERVL-MaLR	1349	+	26	91251698	26921
chr14	91224777	91424777	harbor1	chr14	91260449	91260491	LTR/ERVL-MaLR	1939	+	21	91260470	35693
chr14	91224777	91424777	harbor1	chr14	91260793	91261239	LTR/ERVL-MaLR	1939	+	223	91261016	36239
chr14	91224777	91424777	harbor1	chr14	91295748	91296128	LTR/ERVL-MaLR	1244	+	190	91295938	71161
chr14	104623497	104823497	harbor1	chr14	104626344	104626744	LTR/ERVL-MaLR	2209	+	200	104626544	3047
chr14	104623497	104823497	harbor1	chr14	104627639	104628061	LTR/ERVL-MaLR	2844	+	211	104627850	4353
chr14	104623497	104823497	harbor1	chr14	104656776	104657115	LTR/ERVL-MaLR	1247	+	170	104656946	33449
chr14	104623497	104823497	harbor1	chr14	104657376	104657519	LTR/ERVL-MaLR	487	+	72	104657448	33951
chr14	104623497	104823497	harbor1	chr14	104658369	104658553	LTR/ERVL-MaLR	628	+	92	104658461	34964
chr14	104623497	104823497	harbor1	chr14	104662724	104662859	LTR/ERVL-MaLR	1020	+	68	104662792	39295
chr14	104623497	104823497	harbor1	chr14	104663156	104663224	LTR/ERVL-MaLR	1020	+	34	104663190	39693
chr14	104623497	104823497	harbor1	chr14	104673894	104674255	LTR/ERVL-MaLR	2438	+	180	104674074	50577
chr14	76928421	77128421	harbor1	chr14	76997661	76997779	LTR/ERVL-MaLR	565	+	59	76997720	69299
chr14	76928421	77128421	harbor1	chr14	76998082	76998400	LTR/ERVL-MaLR	565	+	159	76998241	69820
chr14	23249324	23449324	harbor1	chr14	23291361	23291490	LTR/ERVL-MaLR	2072	+	64	23291425	42101
chr14	23249324	23449324	harbor1	chr14	23291789	23292059	LTR/ERVL-MaLR	2072	+	135	23291924	42600
chr14	23249324	23449324	harbor1	chr14	23331352	23331684	LTR/ERVL-MaLR	1642	+	166	23331518	82194
chr14	23249324	23449324	harbor1	chr14	23339849	23340219	LTR/ERVL-MaLR	1928	+	185	23340034	90710
chr14	23054525	23254525	harbor1	chr14	23148129	23148234	LTR/ERVL-MaLR	2154	+	52	23148181	93656
chr14	23054525	23254525	harbor1	chr14	23148528	23148916	LTR/ERVL-MaLR	2154	+	194	23148722	94197
chr14	100185531	100385531	harbor1	chr14	100186975	100187025	LTR/ERVL-MaLR	1063	+	25	100187000	1469
chr14	100185531	100385531	harbor1	chr14	100187329	100187786	LTR/ERVL-MaLR	1063	+	228	100187557	2026
chr14	100185531	100385531	harbor1	chr14	100188270	100188971	LTR/ERVL-MaLR	2598	+	350	100188620	3089
chr14	100185531	100385531	harbor1	chr14	100188972	100189013	LTR/ERVL-MaLR	758	+	20	100188992	3461
chr14	100185531	100385531	harbor1	chr14	100189311	100189585	LTR/ERVL-MaLR	1074	+	137	100189448	3917
chr14	100185531	100385531	harbor1	chr14	100251069	100251524	LTR/ERVL-MaLR	1515	+	228	100251297	65766
chr14	100185531	100385531	harbor1	chr14	100257440	100257794	LTR/ERVL-MaLR	1691	+	177	100257617	72086
chr14	103421746	103621746	harbor1	chr14	103422847	103423158	LTR/ERVL-MaLR	925	+	156	103423003	1257
chr14	100032741	100232741	harbor1	chr14	100035839	100035976	LTR/ERVL-MaLR	706	+	68	100035907	3166
chr14	100032741	100232741	harbor1	chr14	100036316	100036636	LTR/ERVL-MaLR	706	+	160	100036476	3735
chr14	100032741	100232741	harbor1	chr14	100036792	100037153	LTR/ERVL-MaLR	1567	+	180	100036972	4231
chr14	100032741	100232741	harbor1	chr14	100062744	100062815	LTR/ERVL-MaLR	1326	+	36	100062780	30039
chr14	100032741	100232741	harbor1	chr14	100063119	100063518	LTR/ERVL-MaLR	1326	+	200	100063319	30578
chr14	104588146	104788146	harbor1	chr14	104597492	104597782	LTR/ERVL-MaLR	808	+	145	104597637	9491
chr14	104588146	104788146	harbor1	chr14	104602832	104603062	LTR/ERVL-MaLR	639	+	115	104602947	14801
chr14	104588146	104788146	harbor1	chr14	104607411	104607816	LTR/ERVL-MaLR	2558	+	202	104607613	19467
chr14	104588146	104788146	harbor1	chr14	104610042	104610278	LTR/ERVL-MaLR	929	+	118	104610160	22014
chr14	104588146	104788146	harbor1	chr14	104610279	104610657	LTR/ERVL-MaLR	1522	+	189	104610468	22322
chr14	104588146	104788146	harbor1	chr14	104626344	104626744	LTR/ERVL-MaLR	2209	+	200	104626544	38398
chr14	104588146	104788146	harbor1	chr14	104627639	104628061	LTR/ERVL-MaLR	2844	+	211	104627850	39704
chr14	104588146	104788146	harbor1	chr14	104656776	104657115	LTR/ERVL-MaLR	1247	+	170	104656946	68800
chr14	104588146	104788146	harbor1	chr14	104657376	104657519	LTR/ERVL-MaLR	487	+	72	104657448	69302
chr14	104588146	104788146	harbor1	chr14	104658369	104658553	LTR/ERVL-MaLR	628	+	92	104658461	70315
chr14	104588146	104788146	harbor1	chr14	104662724	104662859	LTR/ERVL-MaLR	1020	+	68	104662792	74646
chr14	104588146	104788146	harbor1	chr14	104663156	104663224	LTR/ERVL-MaLR	1020	+	34	104663190	75044
chr14	104588146	104788146	harbor1	chr14	104673894	104674255	LTR/ERVL-MaLR	2438	+	180	104674074	85928
chr14	99493162	99693162	harbor1	chr14	99530846	99531018	LTR/ERVL-MaLR	1049	+	86	99530932	37770
chr14	99493162	99693162	harbor1	chr14	99550105	99550546	LTR/ERVL-MaLR	1629	+	220	99550325	57163
chr14	99493162	99693162	harbor1	chr14	99558265	99558399	LTR/ERVL-MaLR	1145	+	67	99558332	65170
chr14	99493162	99693162	harbor1	chr14	99558647	99558796	LTR/ERVL-MaLR	1145	+	74	99558721	65559
chr14	99493162	99693162	harbor1	chr14	99558797	99559210	LTR/ERVL-MaLR	2378	+	206	99559003	65841
chr14	99493162	99693162	harbor1	chr14	99559211	99559362	LTR/ERVL-MaLR	1145	+	76	99559287	66125
chr14	76928813	77128813	harbor1	chr14	76997661	76997779	LTR/ERVL-MaLR	565	+	59	76997720	68907
chr14	76928813	77128813	harbor1	chr14	76998082	76998400	LTR/ERVL-MaLR	565	+	159	76998241	69428
chr14	105567427	105767427	harbor1	chr14	105608980	105609423	LTR/ERVL-MaLR	2115	+	222	105609202	41775
chr14	105567427	105767427	harbor1	chr14	105609424	105609897	LTR/ERVL-MaLR	2650	+	236	105609660	42233
chr14	105567427	105767427	harbor1	chr14	105611913	105612323	LTR/ERVL-MaLR	2557	+	205	105612118	44691
chr14	105567427	105767427	harbor1	chr14	105619592	105619772	LTR/ERVL-MaLR	754	+	90	105619682	52255
chr14	105567427	105767427	harbor1	chr14	105619773	105620109	LTR/ERVL-MaLR	1433	+	168	105619941	52514
chr14	105567427	105767427	harbor1	chr14	105638826	105639162	LTR/ERVL-MaLR	1421	+	168	105638994	71567
chr14	105567427	105767427	harbor1	chr14	105654618	105655062	LTR/ERVL-MaLR	2181	+	222	105654840	87413
chr14	105567427	105767427	harbor1	chr14	105655063	105655536	LTR/ERVL-MaLR	2647	+	236	105655299	87872
chr14	105567427	105767427	harbor1	chr14	105656382	105657552	LTR/ERVL-MaLR	6652	+	585	105656967	89540
chr14	105567427	105767427	harbor1	chr14	105657554	105657964	LTR/ERVL-MaLR	2479	+	205	105657759	90332
chr14	105567427	105767427	harbor1	chr14	105662488	105662821	LTR/ERVL-MaLR	1341	+	166	105662654	95227
chr14	105567427	105767427	harbor1	chr14	105610741	105611911	LTR/ERVL-MaLR	6634	+	585	105611326	43899
chr14	99435566	99635566	harbor1	chr14	99459811	99459946	LTR/ERVL-MaLR	567	+	68	99459879	24313
chr14	99435566	99635566	harbor1	chr14	99530846	99531018	LTR/ERVL-MaLR	1049	+	86	99530932	95366
chr14	76928830	77128830	harbor1	chr14	76997661	76997779	LTR/ERVL-MaLR	565	+	59	76997720	68890
chr14	76928830	77128830	harbor1	chr14	76998082	76998400	LTR/ERVL-MaLR	565	+	159	76998241	69411
chr14	20990975	21190975	harbor1	chr14	21029261	21029318	LTR/ERVL-MaLR	2050	+	28	21029289	38314
chr14	20990975	21190975	harbor1	chr14	21029629	21029946	LTR/ERVL-MaLR	2050	+	158	21029787	38812
chr14	69667329	69867329	harbor1	chr14	69668673	69669043	LTR/ERVL-MaLR	2099	+	185	69668858	1529
chr14	69667329	69867329	harbor1	chr14	69669362	69669397	LTR/ERVL-MaLR	2099	+	18	69669380	2051
chr14	69667329	69867329	harbor1	chr14	69724884	69725307	LTR/ERVL-MaLR	1617	+	212	69725096	57767
chr14	69667329	69867329	harbor1	chr14	69754816	69754987	LTR/ERVL-MaLR	986	+	86	69754902	87573
chr14	69667329	69867329	harbor1	chr14	69755292	69755576	LTR/ERVL-MaLR	986	+	142	69755434	88105
chr14	69667329	69867329	harbor1	chr14	69758202	69758360	LTR/ERVL-MaLR	770	+	79	69758281	90952
chr14	69667329	69867329	harbor1	chr14	69758361	69758521	LTR/ERVL-MaLR	1487	+	80	69758441	91112
chr14	69667329	69867329	harbor1	chr14	69758749	69758948	LTR/ERVL-MaLR	1487	+	100	69758849	91520
chr14	69667329	69867329	harbor1	chr14	69758949	69759298	LTR/ERVL-MaLR	770	+	174	69759123	91794
chr14	69667329	69867329	harbor1	chr14	69759596	69759657	LTR/ERVL-MaLR	770	+	30	69759626	92297
chr14	69667329	69867329	harbor1	chr14	69760075	69760461	LTR/ERVL-MaLR	1955	+	193	69760268	92939
chr14	69667329	69867329	harbor1	chr14	69761122	69761312	LTR/ERVL-MaLR	1256	+	95	69761217	93888
chr14	69667329	69867329	harbor1	chr14	69761611	69761654	LTR/ERVL-MaLR	1256	+	22	69761633	94304
chr14	69667329	69867329	harbor1	chr14	69764098	69764481	LTR/ERVL-MaLR	1825	+	192	69764290	96961
chr14	102040503	102240503	harbor1	chr14	102060075	102060519	LTR/ERVL-MaLR	966	+	222	102060297	19794
chr14	102040503	102240503	harbor1	chr14	102060957	102061023	LTR/ERVL-MaLR	714	+	33	102060990	20487
chr14	102040503	102240503	harbor1	chr14	102109306	102109666	LTR/ERVL-MaLR	2293	+	180	102109486	68983
chr14	102040503	102240503	harbor1	chr14	102109667	102109934	LTR/ERVL-MaLR	6229	+	134	102109801	69298
chr14	102040503	102240503	harbor1	chr14	102110232	102110402	LTR/ERVL-MaLR	6229	+	85	102110317	69814
chr14	102040503	102240503	harbor1	chr14	102111018	102111479	LTR/ERVL-MaLR	6229	+	230	102111248	70745
chr14	104416746	104616746	harbor1	chr14	104417577	104417937	LTR/ERVL-MaLR	1948	+	180	104417757	1011
chr14	104416746	104616746	harbor1	chr14	104438480	104438872	LTR/ERVL-MaLR	1892	+	196	104438676	21930
chr14	104416746	104616746	harbor1	chr14	104440990	104441022	LTR/ERVL-MaLR	1892	+	16	104441006	24260
chr14	104416746	104616746	harbor1	chr14	104480221	104480380	LTR/ERVL-MaLR	446	+	80	104480301	63555
chr14	104416746	104616746	harbor1	chr14	104501440	104501801	LTR/ERVL-MaLR	2472	+	180	104501620	84874
chr14	104416746	104616746	harbor1	chr14	104503026	104503450	LTR/ERVL-MaLR	2434	+	212	104503238	86492
chr14	104416746	104616746	harbor1	chr14	104504676	104505077	LTR/ERVL-MaLR	593	+	200	104504876	88130
chr14	67141315	67341315	harbor1	chr14	67232035	67232514	LTR/ERVL-MaLR	1441	+	240	67232275	90960
chr14	104785187	104985187	harbor1	chr14	104818581	104818807	LTR/ERVL-MaLR	560	+	113	104818694	33507
chr14	104785187	104985187	harbor1	chr14	104829004	104829324	LTR/ERVL-MaLR	1212	+	160	104829164	43977
chr14	104785187	104985187	harbor1	chr14	104845632	104845955	LTR/ERVL-MaLR	1579	+	162	104845794	60607
chr14	104785187	104985187	harbor1	chr14	104869556	104869908	LTR/ERVL-MaLR	1407	+	176	104869732	84545
chr14	103423069	103623069	harbor1	chr14	103422847	103423158	LTR/ERVL-MaLR	925	+	156	103423003	66
chr14	69876011	70076011	harbor1	chr14	69893744	69894132	LTR/ERVL-MaLR	2077	+	194	69893938	17927
chr14	69876011	70076011	harbor1	chr14	69899239	69899639	LTR/ERVL-MaLR	2440	+	200	69899439	23428
chr14	69876011	70076011	harbor1	chr14	69901882	69902367	LTR/ERVL-MaLR	1611	+	242	69902124	26113
chr14	69876011	70076011	harbor1	chr14	69902371	69902602	LTR/ERVL-MaLR	762	+	116	69902487	26476
chr14	69876011	70076011	harbor1	chr14	69903918	69904241	LTR/ERVL-MaLR	461	+	162	69904080	28069
chr14	69876011	70076011	harbor1	chr14	69906090	69906655	LTR/ERVL-MaLR	2263	+	282	69906372	30361
chr14	69876011	70076011	harbor1	chr14	69945496	69945677	LTR/ERVL-MaLR	1001	+	90	69945586	69575
chr14	69876011	70076011	harbor1	chr14	69946725	69947083	LTR/ERVL-MaLR	2046	+	179	69946904	70893
chr14	22776770	22976770	harbor1	chr14	22789230	22789336	LTR/ERVL-MaLR	2021	+	53	22789283	12513
chr14	22776770	22976770	harbor1	chr14	22789653	22790042	LTR/ERVL-MaLR	2021	+	194	22789847	13077
chr14	22776770	22976770	harbor1	chr14	22800296	22800652	LTR/ERVL-MaLR	1061	+	178	22800474	23704
chr14	22776770	22976770	harbor1	chr14	22800959	22801162	LTR/ERVL-MaLR	794	+	102	22801061	24291
chr14	22776770	22976770	harbor1	chr14	22856928	22857405	LTR/ERVL-MaLR	2122	+	238	22857166	80396
chr14	22776770	22976770	harbor1	chr14	22857406	22857754	LTR/ERVL-MaLR	4354	+	174	22857580	80810
chr14	22776770	22976770	harbor1	chr14	22858066	22858288	LTR/ERVL-MaLR	4354	+	111	22858177	81407
chr14	22776770	22976770	harbor1	chr14	22858587	22858812	LTR/ERVL-MaLR	4354	+	112	22858699	81929
chr14	22776770	22976770	harbor1	chr14	22859121	22859149	LTR/ERVL-MaLR	4354	+	14	22859135	82365
chr14	22776770	22976770	harbor1	chr14	22860066	22860293	LTR/ERVL-MaLR	4354	+	114	22860180	83410
chr14	22776770	22976770	harbor1	chr14	22860610	22860869	LTR/ERVL-MaLR	4354	+	130	22860740	83970
chr14	22776770	22976770	harbor1	chr14	22861464	22861792	LTR/ERVL-MaLR	4354	+	164	22861628	84858
chr14	22776770	22976770	harbor1	chr14	22861808	22862317	LTR/ERVL-MaLR	2790	+	254	22862062	85292
chr14	100229952	100429952	harbor1	chr14	100251069	100251524	LTR/ERVL-MaLR	1515	+	228	100251297	21345
chr14	100229952	100429952	harbor1	chr14	100257440	100257794	LTR/ERVL-MaLR	1691	+	177	100257617	27665
chr14	100229952	100429952	harbor1	chr14	100288831	100289265	LTR/ERVL-MaLR	1620	+	217	100289048	59096
chr14	100229952	100429952	harbor1	chr14	100310911	100310960	LTR/ERVL-MaLR	553	+	24	100310935	80983
chr14	100229952	100429952	harbor1	chr14	100311137	100311225	LTR/ERVL-MaLR	553	+	44	100311181	81229
chr14	100229952	100429952	harbor1	chr14	100315134	100315602	LTR/ERVL-MaLR	1690	+	234	100315368	85416
chr14	100229952	100429952	harbor1	chr14	100315909	100315968	LTR/ERVL-MaLR	1690	+	30	100315939	85987
chr14	21306992	21506992	harbor1	chr14	21372468	21372721	LTR/ERVL-MaLR	713	+	126	21372594	65602
chr14	21306992	21506992	harbor1	chr14	21406272	21406640	LTR/ERVL-MaLR	527	+	184	21406456	99464
chr14	103423052	103623052	harbor1	chr14	103422847	103423158	LTR/ERVL-MaLR	925	+	156	103423003	49
chr14	104785177	104985177	harbor1	chr14	104818581	104818807	LTR/ERVL-MaLR	560	+	113	104818694	33517
chr14	104785177	104985177	harbor1	chr14	104829004	104829324	LTR/ERVL-MaLR	1212	+	160	104829164	43987
chr14	104785177	104985177	harbor1	chr14	104845632	104845955	LTR/ERVL-MaLR	1579	+	162	104845794	60617
chr14	104785177	104985177	harbor1	chr14	104869556	104869908	LTR/ERVL-MaLR	1407	+	176	104869732	84555
chr14	104000741	104200741	harbor1	chr14	104045609	104045956	LTR/ERVL-MaLR	1294	+	174	104045783	45042
chr14	104000741	104200741	harbor1	chr14	104055119	104055501	LTR/ERVL-MaLR	495	+	191	104055310	54569
chr14	104000741	104200741	harbor1	chr14	104073924	104074299	LTR/ERVL-MaLR	983	+	188	104074112	73371
chr14	104000741	104200741	harbor1	chr14	104083565	104083934	LTR/ERVL-MaLR	1145	+	184	104083749	83008
chr14	21335960	21535960	harbor1	chr14	21372468	21372721	LTR/ERVL-MaLR	713	+	126	21372594	36634
chr14	21335960	21535960	harbor1	chr14	21406272	21406640	LTR/ERVL-MaLR	527	+	184	21406456	70496
chr14	21335960	21535960	harbor1	chr14	21421703	21422058	LTR/ERVL-MaLR	1879	+	178	21421881	85921
chr14	21335960	21535960	harbor1	chr14	21422360	21422421	LTR/ERVL-MaLR	1879	+	30	21422390	86430
chr14	91474368	91674368	harbor1	chr14	91546381	91546786	LTR/ERVL-MaLR	2192	+	202	91546583	72215
chr14	91474368	91674368	harbor1	chr14	91552243	91552414	LTR/ERVL-MaLR	939	+	86	91552329	77961
chr14	91474368	91674368	harbor1	chr14	91521012	91521344	LTR/ERVL-MaLR	1346	+	166	91521178	46810
chr14	90283195	90483195	harbor1	chr14	90298558	90298706	LTR/ERVL-MaLR	539	+	74	90298632	15437
chr14	90283195	90483195	harbor1	chr14	90311321	90311677	LTR/ERVL-MaLR	2322	+	178	90311499	28304
chr14	90283195	90483195	harbor1	chr14	90380092	90380507	LTR/ERVL-MaLR	2015	+	208	90380300	97105
chr14	75328380	75528380	harbor1	chr14	75347031	75347428	LTR/ERVL-MaLR	2476	+	198	75347229	18849
chr14	75328380	75528380	harbor1	chr14	75349560	75349975	LTR/ERVL-MaLR	1844	+	208	75349768	21388
chr14	75328380	75528380	harbor1	chr14	75376258	75376605	LTR/ERVL-MaLR	2083	+	174	75376432	48052
chr14	75328380	75528380	harbor1	chr14	75377033	75377096	LTR/ERVL-MaLR	445	+	32	75377065	48685
chr14	75328380	75528380	harbor1	chr14	75377825	75378157	LTR/ERVL-MaLR	1463	+	166	75377991	49611
chr14	75328380	75528380	harbor1	chr14	75378160	75378888	LTR/ERVL-MaLR	3568	+	364	75378524	50144
chr14	75328380	75528380	harbor1	chr14	75379154	75379602	LTR/ERVL-MaLR	989	+	224	75379378	50998
chr14	75328380	75528380	harbor1	chr14	75379604	75379795	LTR/ERVL-MaLR	1265	+	96	75379700	51320
chr14	75328380	75528380	harbor1	chr14	75380236	75380364	LTR/ERVL-MaLR	1265	+	64	75380300	51920
chr14	75328380	75528380	harbor1	chr14	75399397	75399827	LTR/ERVL-MaLR	682	+	215	75399612	71232
chr14	75328380	75528380	harbor1	chr14	75402942	75403245	LTR/ERVL-MaLR	1349	+	152	75403094	74714
chr14	75328380	75528380	harbor1	chr14	75403838	75404080	LTR/ERVL-MaLR	851	+	121	75403959	75579
chr14	75328380	75528380	harbor1	chr14	75412251	75412406	LTR/ERVL-MaLR	2086	+	78	75412329	83949
chr14	75328380	75528380	harbor1	chr14	75412596	75412818	LTR/ERVL-MaLR	2086	+	111	75412707	84327
chr14	75328380	75528380	harbor1	chr14	75424360	75424760	LTR/ERVL-MaLR	906	+	200	75424560	96180
chr14	102631841	102831841	harbor1	chr14	102649439	102649748	LTR/ERVL-MaLR	442	+	154	102649593	17752
chr14	102631841	102831841	harbor1	chr14	102653548	102653915	LTR/ERVL-MaLR	2473	+	184	102653732	21891
chr14	102631841	102831841	harbor1	chr14	102654287	102654325	LTR/ERVL-MaLR	2473	+	19	102654306	22465
chr14	102631841	102831841	harbor1	chr14	102662962	102663331	LTR/ERVL-MaLR	2003	+	184	102663146	31305
chr14	64194361	64394361	harbor1	chr14	64246175	64246553	LTR/ERVL-MaLR	2440	+	189	64246364	52003
chr14	93926565	94126565	harbor1	chr14	93978119	93978255	LTR/ERVL-MaLR	577	+	68	93978187	51622
chr14	103423043	103623043	harbor1	chr14	103422847	103423158	LTR/ERVL-MaLR	925	+	156	103423003	40
chr14	67499989	67699989	harbor1	chr14	67595532	67595677	LTR/ERVL-MaLR	589	+	72	67595604	95615
chr14	100182018	100382018	harbor1	chr14	100186975	100187025	LTR/ERVL-MaLR	1063	+	25	100187000	4982
chr14	100182018	100382018	harbor1	chr14	100187329	100187786	LTR/ERVL-MaLR	1063	+	228	100187557	5539
chr14	100182018	100382018	harbor1	chr14	100188270	100188971	LTR/ERVL-MaLR	2598	+	350	100188620	6602
chr14	100182018	100382018	harbor1	chr14	100188972	100189013	LTR/ERVL-MaLR	758	+	20	100188992	6974
chr14	100182018	100382018	harbor1	chr14	100189311	100189585	LTR/ERVL-MaLR	1074	+	137	100189448	7430
chr14	100182018	100382018	harbor1	chr14	100251069	100251524	LTR/ERVL-MaLR	1515	+	228	100251297	69279
chr14	100182018	100382018	harbor1	chr14	100257440	100257794	LTR/ERVL-MaLR	1691	+	177	100257617	75599
chr14	104015415	104215415	harbor1	chr14	104045609	104045956	LTR/ERVL-MaLR	1294	+	174	104045783	30368
chr14	104015415	104215415	harbor1	chr14	104055119	104055501	LTR/ERVL-MaLR	495	+	191	104055310	39895
chr14	104015415	104215415	harbor1	chr14	104073924	104074299	LTR/ERVL-MaLR	983	+	188	104074112	58697
chr14	104015415	104215415	harbor1	chr14	104083565	104083934	LTR/ERVL-MaLR	1145	+	184	104083749	68334
chr14	76925476	77125476	harbor1	chr14	76997661	76997779	LTR/ERVL-MaLR	565	+	59	76997720	72244
chr14	76925476	77125476	harbor1	chr14	76998082	76998400	LTR/ERVL-MaLR	565	+	159	76998241	72765
chr14	90283220	90483220	harbor1	chr14	90298558	90298706	LTR/ERVL-MaLR	539	+	74	90298632	15412
chr14	90283220	90483220	harbor1	chr14	90311321	90311677	LTR/ERVL-MaLR	2322	+	178	90311499	28279
chr14	90283220	90483220	harbor1	chr14	90380092	90380507	LTR/ERVL-MaLR	2015	+	208	90380300	97080
chr14	105554090	105754090	harbor1	chr14	105608980	105609423	LTR/ERVL-MaLR	2115	+	222	105609202	55112
chr14	105554090	105754090	harbor1	chr14	105609424	105609897	LTR/ERVL-MaLR	2650	+	236	105609660	55570
chr14	105554090	105754090	harbor1	chr14	105611913	105612323	LTR/ERVL-MaLR	2557	+	205	105612118	58028
chr14	105554090	105754090	harbor1	chr14	105619592	105619772	LTR/ERVL-MaLR	754	+	90	105619682	65592
chr14	105554090	105754090	harbor1	chr14	105619773	105620109	LTR/ERVL-MaLR	1433	+	168	105619941	65851
chr14	105554090	105754090	harbor1	chr14	105638826	105639162	LTR/ERVL-MaLR	1421	+	168	105638994	84904
chr14	105554090	105754090	harbor1	chr14	105610741	105611911	LTR/ERVL-MaLR	6634	+	585	105611326	57236
chr14	105054599	105254599	harbor1	chr14	105118100	105118297	LTR/ERVL-MaLR	671	+	98	105118198	63599
chr14	105054599	105254599	harbor1	chr14	105120567	105120916	LTR/ERVL-MaLR	1790	+	174	105120741	66142
chr14	101439534	101639534	harbor1	chr14	101469263	101469355	LTR/ERVL-MaLR	442	+	46	101469309	29775
chr14	101439534	101639534	harbor1	chr14	101499560	101499859	LTR/ERVL-MaLR	513	+	150	101499710	60176
chr14	101439534	101639534	harbor1	chr14	101500006	101500171	LTR/ERVL-MaLR	530	+	82	101500088	60554
chr14	101439534	101639534	harbor1	chr14	101500237	101500559	LTR/ERVL-MaLR	787	+	161	101500398	60864
chr14	101439534	101639534	harbor1	chr14	101532551	101532933	LTR/ERVL-MaLR	908	+	191	101532742	93208
chr15	29169912	29369912	harbor1	chr15	29170666	29170848	LTR/ERVL-MaLR	825	+	91	29170757	845
chr15	29169912	29369912	harbor1	chr15	29171232	29171252	LTR/ERVL-MaLR	825	+	10	29171242	1330
chr15	29169912	29369912	harbor1	chr15	29240028	29240080	LTR/ERVL-MaLR	1575	+	26	29240054	70142
chr15	29169912	29369912	harbor1	chr15	29240393	29240700	LTR/ERVL-MaLR	1575	+	154	29240547	70635
chr15	67421734	67621734	harbor1	chr15	67428388	67428568	LTR/ERVL-MaLR	2240	+	90	67428478	6744
chr15	67421734	67621734	harbor1	chr15	67428864	67429175	LTR/ERVL-MaLR	2240	+	156	67429020	7286
chr15	67421734	67621734	harbor1	chr15	67480183	67480573	LTR/ERVL-MaLR	984	+	195	67480378	58644
chr15	67421734	67621734	harbor1	chr15	67480587	67481078	LTR/ERVL-MaLR	1293	+	246	67480833	59099
chr15	67421734	67621734	harbor1	chr15	67481657	67481953	LTR/ERVL-MaLR	832	+	148	67481805	60071
chr15	67421734	67621734	harbor1	chr15	67482072	67482477	LTR/ERVL-MaLR	1108	+	202	67482274	60540
chr15	67421734	67621734	harbor1	chr15	67515780	67515989	LTR/ERVL-MaLR	1018	+	104	67515884	94150
chr15	74837985	75037985	harbor1	chr15	74910968	74911140	LTR/ERVL-MaLR	1044	+	86	74911054	73069
chr15	74837985	75037985	harbor1	chr15	74912042	74912239	LTR/ERVL-MaLR	1133	+	98	74912140	74155
chr15	74837985	75037985	harbor1	chr15	74912824	74912851	LTR/ERVL-MaLR	1133	+	14	74912838	74853
chr15	74837985	75037985	harbor1	chr15	74913153	74913188	LTR/ERVL-MaLR	1133	+	18	74913171	75186
chr15	35445552	35645552	harbor1	chr15	35489040	35489325	LTR/ERVL-MaLR	625	+	142	35489182	43630
chr15	35445552	35645552	harbor1	chr15	35495097	35495489	LTR/ERVL-MaLR	1958	+	196	35495293	49741
chr15	35446223	35646223	harbor1	chr15	35489040	35489325	LTR/ERVL-MaLR	625	+	142	35489182	42959
chr15	35446223	35646223	harbor1	chr15	35495097	35495489	LTR/ERVL-MaLR	1958	+	196	35495293	49070
chr15	35446236	35646236	harbor1	chr15	35489040	35489325	LTR/ERVL-MaLR	625	+	142	35489182	42946
chr15	35446236	35646236	harbor1	chr15	35495097	35495489	LTR/ERVL-MaLR	1958	+	196	35495293	49057
chr15	101843670	102043670	harbor1	chr15	101857159	101857540	LTR/ERVL-MaLR	1979	+	190	101857349	13679
chr15	101843670	102043670	harbor1	chr15	101861872	101862231	LTR/ERVL-MaLR	1974	+	180	101862052	18382
chr15	101843670	102043670	harbor1	chr15	101862232	101863803	LTR/ERVL-MaLR	10842	+	786	101863018	19348
chr15	101843670	102043670	harbor1	chr15	101863804	101864161	LTR/ERVL-MaLR	1805	+	178	101863982	20312
chr15	35446435	35646435	harbor1	chr15	35489040	35489325	LTR/ERVL-MaLR	625	+	142	35489182	42747
chr15	35446435	35646435	harbor1	chr15	35495097	35495489	LTR/ERVL-MaLR	1958	+	196	35495293	48858
chr15	35446210	35646210	harbor1	chr15	35489040	35489325	LTR/ERVL-MaLR	625	+	142	35489182	42972
chr15	35446210	35646210	harbor1	chr15	35495097	35495489	LTR/ERVL-MaLR	1958	+	196	35495293	49083
chr15	67421817	67621817	harbor1	chr15	67428388	67428568	LTR/ERVL-MaLR	2240	+	90	67428478	6661
chr15	67421817	67621817	harbor1	chr15	67428864	67429175	LTR/ERVL-MaLR	2240	+	156	67429020	7203
chr15	67421817	67621817	harbor1	chr15	67480183	67480573	LTR/ERVL-MaLR	984	+	195	67480378	58561
chr15	67421817	67621817	harbor1	chr15	67480587	67481078	LTR/ERVL-MaLR	1293	+	246	67480833	59016
chr15	67421817	67621817	harbor1	chr15	67481657	67481953	LTR/ERVL-MaLR	832	+	148	67481805	59988
chr15	67421817	67621817	harbor1	chr15	67482072	67482477	LTR/ERVL-MaLR	1108	+	202	67482274	60457
chr15	67421817	67621817	harbor1	chr15	67515780	67515989	LTR/ERVL-MaLR	1018	+	104	67515884	94067
chr15	35446226	35646226	harbor1	chr15	35489040	35489325	LTR/ERVL-MaLR	625	+	142	35489182	42956
chr15	35446226	35646226	harbor1	chr15	35495097	35495489	LTR/ERVL-MaLR	1958	+	196	35495293	49067
chr15	25243057	25443057	harbor1	chr15	25288212	25288596	LTR/ERVL-MaLR	1988	+	192	25288404	45347
chr15	35446238	35646238	harbor1	chr15	35489040	35489325	LTR/ERVL-MaLR	625	+	142	35489182	42944
chr15	35446238	35646238	harbor1	chr15	35495097	35495489	LTR/ERVL-MaLR	1958	+	196	35495293	49055
chr15	101728928	101928928	harbor1	chr15	101737603	101738150	LTR/ERVL-MaLR	2271	+	274	101737877	8949
chr15	101728928	101928928	harbor1	chr15	101794150	101794386	LTR/ERVL-MaLR	805	+	118	101794268	65340
chr15	101728928	101928928	harbor1	chr15	101801920	101802386	LTR/ERVL-MaLR	1171	+	233	101802153	73225
chr15	101728928	101928928	harbor1	chr15	101807254	101807625	LTR/ERVL-MaLR	2285	+	186	101807440	78512
chr15	101728928	101928928	harbor1	chr15	101816093	101816561	LTR/ERVL-MaLR	1565	+	234	101816327	87399
chr15	31770716	31970716	harbor1	chr15	31781025	31781480	LTR/ERVL-MaLR	1277	+	228	31781253	10537
chr15	31770716	31970716	harbor1	chr15	31785882	31786274	LTR/ERVL-MaLR	2516	+	196	31786078	15362
chr15	31770716	31970716	harbor1	chr15	31799367	31799758	LTR/ERVL-MaLR	1621	+	196	31799563	28847
chr15	31770716	31970716	harbor1	chr15	31810294	31810688	LTR/ERVL-MaLR	1644	+	197	31810491	39775
chr15	31770716	31970716	harbor1	chr15	31817830	31818241	LTR/ERVL-MaLR	1385	+	206	31818036	47320
chr15	31770716	31970716	harbor1	chr15	31818434	31818791	LTR/ERVL-MaLR	715	+	178	31818612	47896
chr15	31770716	31970716	harbor1	chr15	31818983	31819163	LTR/ERVL-MaLR	610	+	90	31819073	48357
chr15	67421798	67621798	harbor1	chr15	67428388	67428568	LTR/ERVL-MaLR	2240	+	90	67428478	6680
chr15	67421798	67621798	harbor1	chr15	67428864	67429175	LTR/ERVL-MaLR	2240	+	156	67429020	7222
chr15	67421798	67621798	harbor1	chr15	67480183	67480573	LTR/ERVL-MaLR	984	+	195	67480378	58580
chr15	67421798	67621798	harbor1	chr15	67480587	67481078	LTR/ERVL-MaLR	1293	+	246	67480833	59035
chr15	67421798	67621798	harbor1	chr15	67481657	67481953	LTR/ERVL-MaLR	832	+	148	67481805	60007
chr15	67421798	67621798	harbor1	chr15	67482072	67482477	LTR/ERVL-MaLR	1108	+	202	67482274	60476
chr15	67421798	67621798	harbor1	chr15	67515780	67515989	LTR/ERVL-MaLR	1018	+	104	67515884	94086
chr15	35446211	35646211	harbor1	chr15	35489040	35489325	LTR/ERVL-MaLR	625	+	142	35489182	42971
chr15	35446211	35646211	harbor1	chr15	35495097	35495489	LTR/ERVL-MaLR	1958	+	196	35495293	49082
chr15	24856071	25056071	harbor1	chr15	24896278	24896482	LTR/ERVL-MaLR	927	+	102	24896380	40309
chr15	24856071	25056071	harbor1	chr15	24896723	24896807	LTR/ERVL-MaLR	927	+	42	24896765	40694
chr15	24856071	25056071	harbor1	chr15	24896808	24896875	LTR/ERVL-MaLR	514	+	34	24896842	40771
chr15	24856071	25056071	harbor1	chr15	24897176	24897304	LTR/ERVL-MaLR	514	+	64	24897240	41169
chr15	24856071	25056071	harbor1	chr15	24897582	24897932	LTR/ERVL-MaLR	2207	+	175	24897757	41686
chr15	24856071	25056071	harbor1	chr15	24897933	24897966	LTR/ERVL-MaLR	514	+	16	24897949	41878
chr15	24856071	25056071	harbor1	chr15	24908093	24908248	LTR/ERVL-MaLR	700	+	78	24908171	52100
chr15	24856071	25056071	harbor1	chr15	24908249	24908589	LTR/ERVL-MaLR	1987	+	170	24908419	52348
chr15	24856071	25056071	harbor1	chr15	24910146	24910333	LTR/ERVL-MaLR	988	+	94	24910240	54169
chr15	24856071	25056071	harbor1	chr15	24911165	24912149	LTR/ERVL-MaLR	2229	+	492	24911657	55586
chr15	24856071	25056071	harbor1	chr15	24912290	24912548	LTR/ERVL-MaLR	1582	+	129	24912419	56348
chr15	24856071	25056071	harbor1	chr15	24912572	24912938	LTR/ERVL-MaLR	1560	+	183	24912755	56684
chr15	24856071	25056071	harbor1	chr15	24913240	24913280	LTR/ERVL-MaLR	1560	+	20	24913260	57189
chr15	32599301	32799301	harbor1	chr15	32655570	32655924	LTR/ERVL-MaLR	1676	+	177	32655747	56446
chr15	67421805	67621805	harbor1	chr15	67428388	67428568	LTR/ERVL-MaLR	2240	+	90	67428478	6673
chr15	67421805	67621805	harbor1	chr15	67428864	67429175	LTR/ERVL-MaLR	2240	+	156	67429020	7215
chr15	67421805	67621805	harbor1	chr15	67480183	67480573	LTR/ERVL-MaLR	984	+	195	67480378	58573
chr15	67421805	67621805	harbor1	chr15	67480587	67481078	LTR/ERVL-MaLR	1293	+	246	67480833	59028
chr15	67421805	67621805	harbor1	chr15	67481657	67481953	LTR/ERVL-MaLR	832	+	148	67481805	60000
chr15	67421805	67621805	harbor1	chr15	67482072	67482477	LTR/ERVL-MaLR	1108	+	202	67482274	60469
chr15	67421805	67621805	harbor1	chr15	67515780	67515989	LTR/ERVL-MaLR	1018	+	104	67515884	94079
chr15	66786957	66986957	harbor1	chr15	66793062	66793460	LTR/ERVL-MaLR	2052	+	199	66793261	6304
chr15	66786957	66986957	harbor1	chr15	66818513	66818789	LTR/ERVL-MaLR	743	+	138	66818651	31694
chr15	66786957	66986957	harbor1	chr15	66824437	66824772	LTR/ERVL-MaLR	490	+	168	66824605	37648
chr15	66786957	66986957	harbor1	chr15	66835366	66835952	LTR/ERVL-MaLR	2255	+	293	66835659	48702
chr15	66786957	66986957	harbor1	chr15	66840036	66840089	LTR/ERVL-MaLR	516	+	26	66840062	53105
chr15	66786957	66986957	harbor1	chr15	66840742	66841080	LTR/ERVL-MaLR	516	+	169	66840911	53954
chr15	66786957	66986957	harbor1	chr15	66873448	66873548	LTR/ERVL-MaLR	728	+	50	66873498	86541
chr15	35446209	35646209	harbor1	chr15	35489040	35489325	LTR/ERVL-MaLR	625	+	142	35489182	42973
chr15	35446209	35646209	harbor1	chr15	35495097	35495489	LTR/ERVL-MaLR	1958	+	196	35495293	49084
chr15	35446262	35646262	harbor1	chr15	35489040	35489325	LTR/ERVL-MaLR	625	+	142	35489182	42920
chr15	35446262	35646262	harbor1	chr15	35495097	35495489	LTR/ERVL-MaLR	1958	+	196	35495293	49031
chr15	25339171	25539171	harbor1	chr15	25379946	25380299	LTR/ERVL-MaLR	2191	+	176	25380122	40951
chr15	25339171	25539171	harbor1	chr15	25418701	25418855	LTR/ERVL-MaLR	570	+	77	25418778	79607
chr15	25339171	25539171	harbor1	chr15	25419062	25419186	LTR/ERVL-MaLR	634	+	62	25419124	79953
chr15	25339171	25539171	harbor1	chr15	25421026	25421426	LTR/ERVL-MaLR	2102	+	200	25421226	82055
chr15	25339171	25539171	harbor1	chr15	25435426	25435774	LTR/ERVL-MaLR	1643	+	174	25435600	96429
chr15	67421688	67621688	harbor1	chr15	67428388	67428568	LTR/ERVL-MaLR	2240	+	90	67428478	6790
chr15	67421688	67621688	harbor1	chr15	67428864	67429175	LTR/ERVL-MaLR	2240	+	156	67429020	7332
chr15	67421688	67621688	harbor1	chr15	67480183	67480573	LTR/ERVL-MaLR	984	+	195	67480378	58690
chr15	67421688	67621688	harbor1	chr15	67480587	67481078	LTR/ERVL-MaLR	1293	+	246	67480833	59145
chr15	67421688	67621688	harbor1	chr15	67481657	67481953	LTR/ERVL-MaLR	832	+	148	67481805	60117
chr15	67421688	67621688	harbor1	chr15	67482072	67482477	LTR/ERVL-MaLR	1108	+	202	67482274	60586
chr15	67421688	67621688	harbor1	chr15	67515780	67515989	LTR/ERVL-MaLR	1018	+	104	67515884	94196
chr15	35446272	35646272	harbor1	chr15	35489040	35489325	LTR/ERVL-MaLR	625	+	142	35489182	42910
chr15	35446272	35646272	harbor1	chr15	35495097	35495489	LTR/ERVL-MaLR	1958	+	196	35495293	49021
chr15	100817738	101017738	harbor1	chr15	100860119	100860503	LTR/ERVL-MaLR	1016	+	192	100860311	42573
chr15	100817738	101017738	harbor1	chr15	100865238	100865504	LTR/ERVL-MaLR	777	+	133	100865371	47633
chr15	100817738	101017738	harbor1	chr15	100859597	100860114	LTR/ERVL-MaLR	2586	+	258	100859855	42117
chr15	67421773	67621773	harbor1	chr15	67428388	67428568	LTR/ERVL-MaLR	2240	+	90	67428478	6705
chr15	67421773	67621773	harbor1	chr15	67428864	67429175	LTR/ERVL-MaLR	2240	+	156	67429020	7247
chr15	67421773	67621773	harbor1	chr15	67480183	67480573	LTR/ERVL-MaLR	984	+	195	67480378	58605
chr15	67421773	67621773	harbor1	chr15	67480587	67481078	LTR/ERVL-MaLR	1293	+	246	67480833	59060
chr15	67421773	67621773	harbor1	chr15	67481657	67481953	LTR/ERVL-MaLR	832	+	148	67481805	60032
chr15	67421773	67621773	harbor1	chr15	67482072	67482477	LTR/ERVL-MaLR	1108	+	202	67482274	60501
chr15	67421773	67621773	harbor1	chr15	67515780	67515989	LTR/ERVL-MaLR	1018	+	104	67515884	94111
chr15	101861558	102061558	harbor1	chr15	101861872	101862231	LTR/ERVL-MaLR	1974	+	180	101862052	494
chr15	101861558	102061558	harbor1	chr15	101862232	101863803	LTR/ERVL-MaLR	10842	+	786	101863018	1460
chr15	101861558	102061558	harbor1	chr15	101863804	101864161	LTR/ERVL-MaLR	1805	+	178	101863982	2424
chr15	101861558	102061558	harbor1	chr15	101956045	101956401	LTR/ERVL-MaLR	826	+	178	101956223	94665
chr15	34109577	34309577	harbor1	chr15	34162151	34162514	LTR/ERVL-MaLR	2126	+	182	34162333	52756
chr15	34109577	34309577	harbor1	chr15	34204041	34204276	LTR/ERVL-MaLR	537	+	118	34204159	94582
chr15	35446227	35646227	harbor1	chr15	35489040	35489325	LTR/ERVL-MaLR	625	+	142	35489182	42955
chr15	35446227	35646227	harbor1	chr15	35495097	35495489	LTR/ERVL-MaLR	1958	+	196	35495293	49066
chr15	29944821	30144821	harbor1	chr15	29947505	29947676	LTR/ERVL-MaLR	445	+	86	29947591	2770
chr15	29944821	30144821	harbor1	chr15	29948580	29948830	LTR/ERVL-MaLR	476	+	125	29948705	3884
chr15	29944821	30144821	harbor1	chr15	29964107	29964229	LTR/ERVL-MaLR	506	+	61	29964168	19347
chr15	29944821	30144821	harbor1	chr15	29964515	29964672	LTR/ERVL-MaLR	712	+	78	29964593	19772
chr15	29944821	30144821	harbor1	chr15	30000488	30000892	LTR/ERVL-MaLR	2644	+	202	30000690	55869
chr15	29944821	30144821	harbor1	chr15	30025597	30025809	LTR/ERVL-MaLR	459	+	106	30025703	80882
chr15	29944821	30144821	harbor1	chr15	30035499	30035744	LTR/ERVL-MaLR	1452	+	122	30035621	90800
chr15	29944821	30144821	harbor1	chr15	30038451	30038593	LTR/ERVL-MaLR	735	+	71	30038522	93701
chr15	65277014	65477014	harbor1	chr15	65323014	65323463	LTR/ERVL-MaLR	1156	+	224	65323238	46224
chr15	101552272	101752272	harbor1	chr15	101565667	101566072	LTR/ERVL-MaLR	510	+	202	101565869	13597
chr15	101552272	101752272	harbor1	chr15	101572724	101573037	LTR/ERVL-MaLR	617	+	156	101572880	20608
chr15	101552272	101752272	harbor1	chr15	101573107	101573224	LTR/ERVL-MaLR	444	+	58	101573165	20893
chr15	101552272	101752272	harbor1	chr15	101604875	101605109	LTR/ERVL-MaLR	1224	+	117	101604992	52720
chr15	101552272	101752272	harbor1	chr15	101607558	101608061	LTR/ERVL-MaLR	2095	+	252	101607810	55538
chr15	101552272	101752272	harbor1	chr15	101620748	101621261	LTR/ERVL-MaLR	793	+	256	101621004	68732
chr15	101552272	101752272	harbor1	chr15	101640153	101640503	LTR/ERVL-MaLR	1740	+	175	101640328	88056
chr15	101861545	102061545	harbor1	chr15	101861872	101862231	LTR/ERVL-MaLR	1974	+	180	101862052	507
chr15	101861545	102061545	harbor1	chr15	101862232	101863803	LTR/ERVL-MaLR	10842	+	786	101863018	1473
chr15	101861545	102061545	harbor1	chr15	101863804	101864161	LTR/ERVL-MaLR	1805	+	178	101863982	2437
chr15	101861545	102061545	harbor1	chr15	101956045	101956401	LTR/ERVL-MaLR	826	+	178	101956223	94678
chr15	101861594	102061594	harbor1	chr15	101861872	101862231	LTR/ERVL-MaLR	1974	+	180	101862052	458
chr15	101861594	102061594	harbor1	chr15	101862232	101863803	LTR/ERVL-MaLR	10842	+	786	101863018	1424
chr15	101861594	102061594	harbor1	chr15	101863804	101864161	LTR/ERVL-MaLR	1805	+	178	101863982	2388
chr15	101861594	102061594	harbor1	chr15	101956045	101956401	LTR/ERVL-MaLR	826	+	178	101956223	94629
chr15	41799530	41999530	harbor1	chr15	41859133	41859161	LTR/ERVL-MaLR	668	+	14	41859147	59617
chr15	41799530	41999530	harbor1	chr15	41859459	41859626	LTR/ERVL-MaLR	668	+	84	41859543	60013
chr15	74734286	74934286	harbor1	chr15	74734087	74734456	LTR/ERVL-MaLR	2068	+	184	74734271	15
chr15	74734286	74934286	harbor1	chr15	74735655	74735864	LTR/ERVL-MaLR	471	+	104	74735759	1473
chr15	74734286	74934286	harbor1	chr15	74736391	74736680	LTR/ERVL-MaLR	770	+	144	74736535	2249
chr15	74734286	74934286	harbor1	chr15	74739505	74739677	LTR/ERVL-MaLR	465	+	86	74739591	5305
chr15	67421706	67621706	harbor1	chr15	67428388	67428568	LTR/ERVL-MaLR	2240	+	90	67428478	6772
chr15	67421706	67621706	harbor1	chr15	67428864	67429175	LTR/ERVL-MaLR	2240	+	156	67429020	7314
chr15	67421706	67621706	harbor1	chr15	67480183	67480573	LTR/ERVL-MaLR	984	+	195	67480378	58672
chr15	67421706	67621706	harbor1	chr15	67480587	67481078	LTR/ERVL-MaLR	1293	+	246	67480833	59127
chr15	67421706	67621706	harbor1	chr15	67481657	67481953	LTR/ERVL-MaLR	832	+	148	67481805	60099
chr15	67421706	67621706	harbor1	chr15	67482072	67482477	LTR/ERVL-MaLR	1108	+	202	67482274	60568
chr15	67421706	67621706	harbor1	chr15	67515780	67515989	LTR/ERVL-MaLR	1018	+	104	67515884	94178
chr15	74946674	75146674	harbor1	chr15	74978797	74979103	LTR/ERVL-MaLR	736	+	153	74978950	32276
chr15	25338738	25538738	harbor1	chr15	25379946	25380299	LTR/ERVL-MaLR	2191	+	176	25380122	41384
chr15	25338738	25538738	harbor1	chr15	25418701	25418855	LTR/ERVL-MaLR	570	+	77	25418778	80040
chr15	25338738	25538738	harbor1	chr15	25419062	25419186	LTR/ERVL-MaLR	634	+	62	25419124	80386
chr15	25338738	25538738	harbor1	chr15	25421026	25421426	LTR/ERVL-MaLR	2102	+	200	25421226	82488
chr15	25338738	25538738	harbor1	chr15	25435426	25435774	LTR/ERVL-MaLR	1643	+	174	25435600	96862
chr15	35446206	35646206	harbor1	chr15	35489040	35489325	LTR/ERVL-MaLR	625	+	142	35489182	42976
chr15	35446206	35646206	harbor1	chr15	35495097	35495489	LTR/ERVL-MaLR	1958	+	196	35495293	49087
chr15	35446358	35646358	harbor1	chr15	35489040	35489325	LTR/ERVL-MaLR	625	+	142	35489182	42824
chr15	35446358	35646358	harbor1	chr15	35495097	35495489	LTR/ERVL-MaLR	1958	+	196	35495293	48935
chr15	24516009	24716009	harbor1	chr15	24518160	24518362	LTR/ERVL-MaLR	460	+	101	24518261	2252
chr15	24516009	24716009	harbor1	chr15	24547331	24547471	LTR/ERVL-MaLR	446	+	70	24547401	31392
chr15	24516009	24716009	harbor1	chr15	24588669	24589039	LTR/ERVL-MaLR	1886	+	185	24588854	72845
chr15	24516009	24716009	harbor1	chr15	24589040	24589209	LTR/ERVL-MaLR	1045	+	84	24589124	73115
chr15	24516009	24716009	harbor1	chr15	24589723	24590047	LTR/ERVL-MaLR	1772	+	162	24589885	73876
chr15	96226959	96426959	harbor1	chr15	96281595	96281948	LTR/ERVL-MaLR	2487	+	176	96281771	54812
chr15	96226959	96426959	harbor1	chr15	96284012	96284152	LTR/ERVL-MaLR	1158	+	70	96284082	57123
chr15	96226959	96426959	harbor1	chr15	96284463	96284845	LTR/ERVL-MaLR	1158	+	191	96284654	57695
chr15	35446299	35646299	harbor1	chr15	35489040	35489325	LTR/ERVL-MaLR	625	+	142	35489182	42883
chr15	35446299	35646299	harbor1	chr15	35495097	35495489	LTR/ERVL-MaLR	1958	+	196	35495293	48994
chr15	78668333	78868333	harbor1	chr15	78674687	78675107	LTR/ERVL-MaLR	1044	+	210	78674897	6564
chr15	78668333	78868333	harbor1	chr15	78693070	78693314	LTR/ERVL-MaLR	814	+	122	78693192	24859
chr15	78668333	78868333	harbor1	chr15	78714812	78715206	LTR/ERVL-MaLR	1434	+	197	78715009	46676
chr15	38153030	38353030	harbor1	chr15	38158853	38159091	LTR/ERVL-MaLR	1322	+	119	38158972	5942
chr15	38153030	38353030	harbor1	chr15	38159159	38159384	LTR/ERVL-MaLR	978	+	112	38159271	6241
chr15	38153030	38353030	harbor1	chr15	38214901	38215103	LTR/ERVL-MaLR	1064	+	101	38215002	61972
chr15	38153030	38353030	harbor1	chr15	38215149	38215302	LTR/ERVL-MaLR	1064	+	76	38215225	62195
chr15	38153030	38353030	harbor1	chr15	38225883	38226249	LTR/ERVL-MaLR	1788	+	183	38226066	73036
chr15	35443658	35643658	harbor1	chr15	35489040	35489325	LTR/ERVL-MaLR	625	+	142	35489182	45524
chr15	35443658	35643658	harbor1	chr15	35495097	35495489	LTR/ERVL-MaLR	1958	+	196	35495293	51635
chr15	35446230	35646230	harbor1	chr15	35489040	35489325	LTR/ERVL-MaLR	625	+	142	35489182	42952
chr15	35446230	35646230	harbor1	chr15	35495097	35495489	LTR/ERVL-MaLR	1958	+	196	35495293	49063
chr15	101854275	102054275	harbor1	chr15	101857159	101857540	LTR/ERVL-MaLR	1979	+	190	101857349	3074
chr15	101854275	102054275	harbor1	chr15	101861872	101862231	LTR/ERVL-MaLR	1974	+	180	101862052	7777
chr15	101854275	102054275	harbor1	chr15	101862232	101863803	LTR/ERVL-MaLR	10842	+	786	101863018	8743
chr15	101854275	102054275	harbor1	chr15	101863804	101864161	LTR/ERVL-MaLR	1805	+	178	101863982	9707
chr15	67421776	67621776	harbor1	chr15	67428388	67428568	LTR/ERVL-MaLR	2240	+	90	67428478	6702
chr15	67421776	67621776	harbor1	chr15	67428864	67429175	LTR/ERVL-MaLR	2240	+	156	67429020	7244
chr15	67421776	67621776	harbor1	chr15	67480183	67480573	LTR/ERVL-MaLR	984	+	195	67480378	58602
chr15	67421776	67621776	harbor1	chr15	67480587	67481078	LTR/ERVL-MaLR	1293	+	246	67480833	59057
chr15	67421776	67621776	harbor1	chr15	67481657	67481953	LTR/ERVL-MaLR	832	+	148	67481805	60029
chr15	67421776	67621776	harbor1	chr15	67482072	67482477	LTR/ERVL-MaLR	1108	+	202	67482274	60498
chr15	67421776	67621776	harbor1	chr15	67515780	67515989	LTR/ERVL-MaLR	1018	+	104	67515884	94108
chr15	29332978	29532978	harbor1	chr15	29333696	29334153	LTR/ERVL-MaLR	2328	+	228	29333924	946
chr15	29332978	29532978	harbor1	chr15	29334653	29335213	LTR/ERVL-MaLR	537	+	280	29334933	1955
chr15	29332978	29532978	harbor1	chr15	29369705	29370104	LTR/ERVL-MaLR	1428	+	200	29369905	36927
chr15	29332978	29532978	harbor1	chr15	29385593	29385678	LTR/ERVL-MaLR	686	+	42	29385635	52657
chr15	29332978	29532978	harbor1	chr15	29386467	29386577	LTR/ERVL-MaLR	686	+	55	29386522	53544
chr15	29332978	29532978	harbor1	chr15	29386581	29386779	LTR/ERVL-MaLR	828	+	99	29386680	53702
chr15	29332978	29532978	harbor1	chr15	29389172	29389321	LTR/ERVL-MaLR	761	+	74	29389246	56268
chr15	29332978	29532978	harbor1	chr15	29398767	29399380	LTR/ERVL-MaLR	2060	+	306	29399073	66095
chr15	69999084	70199084	harbor1	chr15	70003255	70003587	LTR/ERVL-MaLR	1859	+	166	70003421	4337
chr15	69999084	70199084	harbor1	chr15	70021166	70021633	LTR/ERVL-MaLR	1026	+	234	70021400	22316
chr15	101861669	102061669	harbor1	chr15	101861872	101862231	LTR/ERVL-MaLR	1974	+	180	101862052	383
chr15	101861669	102061669	harbor1	chr15	101862232	101863803	LTR/ERVL-MaLR	10842	+	786	101863018	1349
chr15	101861669	102061669	harbor1	chr15	101863804	101864161	LTR/ERVL-MaLR	1805	+	178	101863982	2313
chr15	101861669	102061669	harbor1	chr15	101956045	101956401	LTR/ERVL-MaLR	826	+	178	101956223	94554
chr15	25337980	25537980	harbor1	chr15	25379946	25380299	LTR/ERVL-MaLR	2191	+	176	25380122	42142
chr15	25337980	25537980	harbor1	chr15	25418701	25418855	LTR/ERVL-MaLR	570	+	77	25418778	80798
chr15	25337980	25537980	harbor1	chr15	25419062	25419186	LTR/ERVL-MaLR	634	+	62	25419124	81144
chr15	25337980	25537980	harbor1	chr15	25421026	25421426	LTR/ERVL-MaLR	2102	+	200	25421226	83246
chr15	25337980	25537980	harbor1	chr15	25435426	25435774	LTR/ERVL-MaLR	1643	+	174	25435600	97620
chr15	31770811	31970811	harbor1	chr15	31781025	31781480	LTR/ERVL-MaLR	1277	+	228	31781253	10442
chr15	31770811	31970811	harbor1	chr15	31785882	31786274	LTR/ERVL-MaLR	2516	+	196	31786078	15267
chr15	31770811	31970811	harbor1	chr15	31799367	31799758	LTR/ERVL-MaLR	1621	+	196	31799563	28752
chr15	31770811	31970811	harbor1	chr15	31810294	31810688	LTR/ERVL-MaLR	1644	+	197	31810491	39680
chr15	31770811	31970811	harbor1	chr15	31817830	31818241	LTR/ERVL-MaLR	1385	+	206	31818036	47225
chr15	31770811	31970811	harbor1	chr15	31818434	31818791	LTR/ERVL-MaLR	715	+	178	31818612	47801
chr15	31770811	31970811	harbor1	chr15	31818983	31819163	LTR/ERVL-MaLR	610	+	90	31819073	48262
chr15	29332340	29532340	harbor1	chr15	29333696	29334153	LTR/ERVL-MaLR	2328	+	228	29333924	1584
chr15	29332340	29532340	harbor1	chr15	29334653	29335213	LTR/ERVL-MaLR	537	+	280	29334933	2593
chr15	29332340	29532340	harbor1	chr15	29369705	29370104	LTR/ERVL-MaLR	1428	+	200	29369905	37565
chr15	29332340	29532340	harbor1	chr15	29385593	29385678	LTR/ERVL-MaLR	686	+	42	29385635	53295
chr15	29332340	29532340	harbor1	chr15	29386467	29386577	LTR/ERVL-MaLR	686	+	55	29386522	54182
chr15	29332340	29532340	harbor1	chr15	29386581	29386779	LTR/ERVL-MaLR	828	+	99	29386680	54340
chr15	29332340	29532340	harbor1	chr15	29389172	29389321	LTR/ERVL-MaLR	761	+	74	29389246	56906
chr15	29332340	29532340	harbor1	chr15	29398767	29399380	LTR/ERVL-MaLR	2060	+	306	29399073	66733
chr15	19973464	20173464	harbor1	chr15	19984078	19984486	LTR/ERVL-MaLR	2154	+	204	19984282	10818
chr15	19973464	20173464	harbor1	chr15	20013923	20014286	LTR/ERVL-MaLR	1105	+	182	20014105	40641
chr15	19973464	20173464	harbor1	chr15	20027638	20028022	LTR/ERVL-MaLR	1528	+	192	20027830	54366
chr15	19973464	20173464	harbor1	chr15	20038116	20038170	LTR/ERVL-MaLR	1549	+	27	20038143	64679
chr15	19973464	20173464	harbor1	chr15	20038478	20038632	LTR/ERVL-MaLR	1549	+	77	20038555	65091
chr15	19973464	20173464	harbor1	chr15	20038668	20038834	LTR/ERVL-MaLR	1549	+	83	20038751	65287
chr15	19973464	20173464	harbor1	chr15	20038837	20039062	LTR/ERVL-MaLR	1435	+	112	20038949	65485
chr15	19973464	20173464	harbor1	chr15	20040051	20041309	LTR/ERVL-MaLR	7529	+	629	20040680	67216
chr15	19973464	20173464	harbor1	chr15	20049898	20050285	LTR/ERVL-MaLR	1416	+	194	20050092	76628
chr15	19973464	20173464	harbor1	chr15	20060626	20060820	LTR/ERVL-MaLR	1480	+	97	20060723	87259
chr15	19973464	20173464	harbor1	chr15	20061130	20061409	LTR/ERVL-MaLR	1480	+	140	20061270	87806
chr15	41406104	41606104	harbor1	chr15	41408186	41408660	LTR/ERVL-MaLR	733	+	237	41408423	2319
chr15	22880593	23080593	harbor1	chr15	22899362	22899716	LTR/ERVL-MaLR	2159	+	177	22899539	18946
chr15	22880593	23080593	harbor1	chr15	22899730	22899767	LTR/ERVL-MaLR	1132	+	18	22899748	19155
chr15	22880593	23080593	harbor1	chr15	22900048	22900390	LTR/ERVL-MaLR	1132	+	171	22900219	19626
chr15	22880593	23080593	harbor1	chr15	22940236	22940724	LTR/ERVL-MaLR	827	+	244	22940480	59887
chr15	22880593	23080593	harbor1	chr15	22954183	22954348	LTR/ERVL-MaLR	698	+	82	22954265	73672
chr15	22880593	23080593	harbor1	chr15	22965904	22966066	LTR/ERVL-MaLR	2112	+	81	22965985	85392
chr15	22880593	23080593	harbor1	chr15	22966395	22966610	LTR/ERVL-MaLR	2112	+	108	22966503	85910
chr15	29026774	29226774	harbor1	chr15	29085900	29086436	LTR/ERVL-MaLR	2269	+	268	29086168	59394
chr15	35446252	35646252	harbor1	chr15	35489040	35489325	LTR/ERVL-MaLR	625	+	142	35489182	42930
chr15	35446252	35646252	harbor1	chr15	35495097	35495489	LTR/ERVL-MaLR	1958	+	196	35495293	49041
chr15	63405330	63605330	harbor1	chr15	63415201	63415604	LTR/ERVL-MaLR	2548	+	202	63415403	10073
chr15	63405330	63605330	harbor1	chr15	63420186	63420638	LTR/ERVL-MaLR	1984	+	226	63420412	15082
chr15	63405330	63605330	harbor1	chr15	63468056	63468108	LTR/ERVL-MaLR	671	+	26	63468082	62752
chr15	63405330	63605330	harbor1	chr15	63468396	63468828	LTR/ERVL-MaLR	671	+	216	63468612	63282
chr15	63405330	63605330	harbor1	chr15	63490059	63490465	LTR/ERVL-MaLR	2619	+	203	63490262	84932
chr15	35446212	35646212	harbor1	chr15	35489040	35489325	LTR/ERVL-MaLR	625	+	142	35489182	42970
chr15	35446212	35646212	harbor1	chr15	35495097	35495489	LTR/ERVL-MaLR	1958	+	196	35495293	49081
chr15	29332920	29532920	harbor1	chr15	29333696	29334153	LTR/ERVL-MaLR	2328	+	228	29333924	1004
chr15	29332920	29532920	harbor1	chr15	29334653	29335213	LTR/ERVL-MaLR	537	+	280	29334933	2013
chr15	29332920	29532920	harbor1	chr15	29369705	29370104	LTR/ERVL-MaLR	1428	+	200	29369905	36985
chr15	29332920	29532920	harbor1	chr15	29385593	29385678	LTR/ERVL-MaLR	686	+	42	29385635	52715
chr15	29332920	29532920	harbor1	chr15	29386467	29386577	LTR/ERVL-MaLR	686	+	55	29386522	53602
chr15	29332920	29532920	harbor1	chr15	29386581	29386779	LTR/ERVL-MaLR	828	+	99	29386680	53760
chr15	29332920	29532920	harbor1	chr15	29389172	29389321	LTR/ERVL-MaLR	761	+	74	29389246	56326
chr15	29332920	29532920	harbor1	chr15	29398767	29399380	LTR/ERVL-MaLR	2060	+	306	29399073	66153
chr15	67421829	67621829	harbor1	chr15	67428388	67428568	LTR/ERVL-MaLR	2240	+	90	67428478	6649
chr15	67421829	67621829	harbor1	chr15	67428864	67429175	LTR/ERVL-MaLR	2240	+	156	67429020	7191
chr15	67421829	67621829	harbor1	chr15	67480183	67480573	LTR/ERVL-MaLR	984	+	195	67480378	58549
chr15	67421829	67621829	harbor1	chr15	67480587	67481078	LTR/ERVL-MaLR	1293	+	246	67480833	59004
chr15	67421829	67621829	harbor1	chr15	67481657	67481953	LTR/ERVL-MaLR	832	+	148	67481805	59976
chr15	67421829	67621829	harbor1	chr15	67482072	67482477	LTR/ERVL-MaLR	1108	+	202	67482274	60445
chr15	67421829	67621829	harbor1	chr15	67515780	67515989	LTR/ERVL-MaLR	1018	+	104	67515884	94055
chr15	34237807	34437807	harbor1	chr15	34303560	34303930	LTR/ERVL-MaLR	1862	+	185	34303745	65938
chr15	69999137	70199137	harbor1	chr15	70003255	70003587	LTR/ERVL-MaLR	1859	+	166	70003421	4284
chr15	69999137	70199137	harbor1	chr15	70021166	70021633	LTR/ERVL-MaLR	1026	+	234	70021400	22263
chr15	35446249	35646249	harbor1	chr15	35489040	35489325	LTR/ERVL-MaLR	625	+	142	35489182	42933
chr15	35446249	35646249	harbor1	chr15	35495097	35495489	LTR/ERVL-MaLR	1958	+	196	35495293	49044
chr15	35446296	35646296	harbor1	chr15	35489040	35489325	LTR/ERVL-MaLR	625	+	142	35489182	42886
chr15	35446296	35646296	harbor1	chr15	35495097	35495489	LTR/ERVL-MaLR	1958	+	196	35495293	48997
chr15	100113871	100313871	harbor1	chr15	100118859	100119286	LTR/ERVL-MaLR	2147	+	214	100119073	5202
chr15	100113871	100313871	harbor1	chr15	100127166	100127500	LTR/ERVL-MaLR	963	+	167	100127333	13462
chr15	100113871	100313871	harbor1	chr15	100201149	100201516	LTR/ERVL-MaLR	2269	+	184	100201333	87462
chr15	100113871	100313871	harbor1	chr15	100207017	100207423	LTR/ERVL-MaLR	1171	+	203	100207220	93349
chr15	79822730	80022730	harbor1	chr15	79863500	79863937	LTR/ERVL-MaLR	676	+	218	79863718	40988
chr15	79822730	80022730	harbor1	chr15	79885441	79885981	LTR/ERVL-MaLR	775	+	270	79885711	62981
chr15	74702668	74902668	harbor1	chr15	74731913	74732044	LTR/ERVL-MaLR	505	+	66	74731979	29311
chr15	74702668	74902668	harbor1	chr15	74734087	74734456	LTR/ERVL-MaLR	2068	+	184	74734271	31603
chr15	74702668	74902668	harbor1	chr15	74735655	74735864	LTR/ERVL-MaLR	471	+	104	74735759	33091
chr15	74702668	74902668	harbor1	chr15	74736391	74736680	LTR/ERVL-MaLR	770	+	144	74736535	33867
chr15	74702668	74902668	harbor1	chr15	74739505	74739677	LTR/ERVL-MaLR	465	+	86	74739591	36923
chr15	29169385	29369385	harbor1	chr15	29170666	29170848	LTR/ERVL-MaLR	825	+	91	29170757	1372
chr15	29169385	29369385	harbor1	chr15	29171232	29171252	LTR/ERVL-MaLR	825	+	10	29171242	1857
chr15	29169385	29369385	harbor1	chr15	29240028	29240080	LTR/ERVL-MaLR	1575	+	26	29240054	70669
chr15	29169385	29369385	harbor1	chr15	29240393	29240700	LTR/ERVL-MaLR	1575	+	154	29240547	71162
chr15	71630113	71830113	harbor1	chr15	71690500	71690578	LTR/ERVL-MaLR	2416	+	39	71690539	60426
chr15	71630113	71830113	harbor1	chr15	71690929	71691360	LTR/ERVL-MaLR	2416	+	216	71691145	61032
chr15	71630113	71830113	harbor1	chr15	71693604	71693972	LTR/ERVL-MaLR	2444	+	184	71693788	63675
chr15	71630113	71830113	harbor1	chr15	71704273	71704628	LTR/ERVL-MaLR	2885	+	178	71704451	74338
chr15	32618868	32818868	harbor1	chr15	32655570	32655924	LTR/ERVL-MaLR	1676	+	177	32655747	36879
chr15	73799625	73999625	harbor1	chr15	73836486	73836641	LTR/ERVL-MaLR	567	+	78	73836564	36939
chr15	73799625	73999625	harbor1	chr15	73842235	73842614	LTR/ERVL-MaLR	1827	+	190	73842425	42800
chr15	73799625	73999625	harbor1	chr15	73845827	73846022	LTR/ERVL-MaLR	645	+	98	73845925	46300
chr15	73799625	73999625	harbor1	chr15	73846665	73847151	LTR/ERVL-MaLR	1252	+	243	73846908	47283
chr15	73799625	73999625	harbor1	chr15	73847370	73847749	LTR/ERVL-MaLR	2463	+	190	73847560	47935
chr15	73799625	73999625	harbor1	chr15	73858128	73858350	LTR/ERVL-MaLR	473	+	111	73858239	58614
chr15	73799625	73999625	harbor1	chr15	73858388	73858542	LTR/ERVL-MaLR	620	+	77	73858465	58840
chr15	35446199	35646199	harbor1	chr15	35489040	35489325	LTR/ERVL-MaLR	625	+	142	35489182	42983
chr15	35446199	35646199	harbor1	chr15	35495097	35495489	LTR/ERVL-MaLR	1958	+	196	35495293	49094
chr15	101623861	101823861	harbor1	chr15	101640153	101640503	LTR/ERVL-MaLR	1740	+	175	101640328	16467
chr15	101623861	101823861	harbor1	chr15	101657070	101657522	LTR/ERVL-MaLR	891	+	226	101657296	33435
chr15	101623861	101823861	harbor1	chr15	101659868	101660201	LTR/ERVL-MaLR	548	+	166	101660034	36173
chr15	101623861	101823861	harbor1	chr15	101687688	101688039	LTR/ERVL-MaLR	1839	+	176	101687864	64003
chr15	101623861	101823861	harbor1	chr15	101689353	101689832	LTR/ERVL-MaLR	2172	+	240	101689593	65732
chr15	101623861	101823861	harbor1	chr15	101696584	101696606	LTR/ERVL-MaLR	2324	+	11	101696595	72734
chr15	101623861	101823861	harbor1	chr15	101697264	101698054	LTR/ERVL-MaLR	2324	+	395	101697659	73798
chr15	101623861	101823861	harbor1	chr15	101698357	101698825	LTR/ERVL-MaLR	2324	+	234	101698591	74730
chr15	101623861	101823861	harbor1	chr15	101717436	101717881	LTR/ERVL-MaLR	553	+	222	101717658	93797
chr15	101623861	101823861	harbor1	chr15	101717901	101718086	LTR/ERVL-MaLR	2079	+	92	101717993	94132
chr15	101623861	101823861	harbor1	chr15	101718324	101719467	LTR/ERVL-MaLR	2079	+	572	101718896	95035
chr15	101623861	101823861	harbor1	chr15	101719468	101719829	LTR/ERVL-MaLR	462	+	180	101719648	95787
chr15	101623861	101823861	harbor1	chr15	101720669	101721043	LTR/ERVL-MaLR	2627	+	187	101720856	96995
chr15	35446288	35646288	harbor1	chr15	35489040	35489325	LTR/ERVL-MaLR	625	+	142	35489182	42894
chr15	35446288	35646288	harbor1	chr15	35495097	35495489	LTR/ERVL-MaLR	1958	+	196	35495293	49005
chr15	73768197	73968197	harbor1	chr15	73783687	73783988	LTR/ERVL-MaLR	1897	+	150	73783837	15640
chr15	73768197	73968197	harbor1	chr15	73794633	73795146	LTR/ERVL-MaLR	1205	+	256	73794889	26692
chr15	73768197	73968197	harbor1	chr15	73836486	73836641	LTR/ERVL-MaLR	567	+	78	73836564	68367
chr15	73768197	73968197	harbor1	chr15	73842235	73842614	LTR/ERVL-MaLR	1827	+	190	73842425	74228
chr15	73768197	73968197	harbor1	chr15	73845827	73846022	LTR/ERVL-MaLR	645	+	98	73845925	77728
chr15	73768197	73968197	harbor1	chr15	73846665	73847151	LTR/ERVL-MaLR	1252	+	243	73846908	78711
chr15	73768197	73968197	harbor1	chr15	73847370	73847749	LTR/ERVL-MaLR	2463	+	190	73847560	79363
chr15	73768197	73968197	harbor1	chr15	73858128	73858350	LTR/ERVL-MaLR	473	+	111	73858239	90042
chr15	73768197	73968197	harbor1	chr15	73858388	73858542	LTR/ERVL-MaLR	620	+	77	73858465	90268
chr15	77542617	77742617	harbor1	chr15	77563826	77563970	LTR/ERVL-MaLR	463	+	72	77563898	21281
chr15	77542617	77742617	harbor1	chr15	77583376	77583736	LTR/ERVL-MaLR	2151	+	180	77583556	40939
chr15	77542617	77742617	harbor1	chr15	77592927	77593008	LTR/ERVL-MaLR	430	+	40	77592967	50350
chr15	77542617	77742617	harbor1	chr15	77593007	77593155	LTR/ERVL-MaLR	529	+	74	77593081	50464
chr15	77542617	77742617	harbor1	chr15	77608432	77608930	LTR/ERVL-MaLR	949	+	249	77608681	66064
chr15	77542617	77742617	harbor1	chr15	77638786	77639319	LTR/ERVL-MaLR	2886	+	266	77639052	96435
chr16	2329317	2529317	harbor1	chr16	2401402	2401624	LTR/ERVL-MaLR	1224	+	111	2401513	72196
chr16	2329317	2529317	harbor1	chr16	2416385	2416694	LTR/ERVL-MaLR	840	+	154	2416539	87222
chr16	2374864	2574864	harbor1	chr16	2401402	2401624	LTR/ERVL-MaLR	1224	+	111	2401513	26649
chr16	2374864	2574864	harbor1	chr16	2416385	2416694	LTR/ERVL-MaLR	840	+	154	2416539	41675
chr16	2198372	2398372	harbor1	chr16	2242489	2242754	LTR/ERVL-MaLR	675	+	132	2242621	44249
chr16	67009864	67209864	harbor1	chr16	67071247	67071621	LTR/ERVL-MaLR	1365	+	187	67071434	61570
chr16	2369786	2569786	harbor1	chr16	2401402	2401624	LTR/ERVL-MaLR	1224	+	111	2401513	31727
chr16	2369786	2569786	harbor1	chr16	2416385	2416694	LTR/ERVL-MaLR	840	+	154	2416539	46753
chr16	4016559	4216559	harbor1	chr16	4037918	4037995	LTR/ERVL-MaLR	941	+	38	4037956	21397
chr16	4016559	4216559	harbor1	chr16	4038296	4038599	LTR/ERVL-MaLR	941	+	152	4038448	21889
chr16	4016559	4216559	harbor1	chr16	4082986	4083229	LTR/ERVL-MaLR	744	+	122	4083108	66549
chr16	4016559	4216559	harbor1	chr16	4099979	4100327	LTR/ERVL-MaLR	1907	+	174	4100153	83594
chr16	4016559	4216559	harbor1	chr16	4100630	4100671	LTR/ERVL-MaLR	1907	+	20	4100650	84091
chr16	688340	888340	harbor1	chr16	746988	747264	LTR/ERVL-MaLR	1795	+	138	747126	58786
chr16	688340	888340	harbor1	chr16	747576	747646	LTR/ERVL-MaLR	1795	+	35	747611	59271
chr16	688340	888340	harbor1	chr16	771100	771226	LTR/ERVL-MaLR	1146	+	63	771163	82823
chr16	688340	888340	harbor1	chr16	771675	771910	LTR/ERVL-MaLR	1146	+	118	771793	83453
chr16	28503971	28703971	harbor1	chr16	28534559	28534981	LTR/ERVL-MaLR	976	+	211	28534770	30799
chr16	28503971	28703971	harbor1	chr16	28567326	28567484	LTR/ERVL-MaLR	906	+	79	28567405	63434
chr16	28503971	28703971	harbor1	chr16	28567484	28567844	LTR/ERVL-MaLR	2202	+	180	28567664	63693
chr16	28503971	28703971	harbor1	chr16	28569148	28569377	LTR/ERVL-MaLR	2105	+	114	28569262	65291
chr16	28503971	28703971	harbor1	chr16	28569674	28570544	LTR/ERVL-MaLR	3455	+	435	28570109	66138
chr16	28503971	28703971	harbor1	chr16	28570877	28571020	LTR/ERVL-MaLR	3455	+	72	28570949	66978
chr16	28503971	28703971	harbor1	chr16	28571026	28571311	LTR/ERVL-MaLR	1453	+	142	28571168	67197
chr16	67009917	67209917	harbor1	chr16	67071247	67071621	LTR/ERVL-MaLR	1365	+	187	67071434	61517
chr16	73379	273379	harbor1	chr16	146001	146181	LTR/ERVL-MaLR	1579	+	90	146091	72712
chr16	73379	273379	harbor1	chr16	146489	146677	LTR/ERVL-MaLR	1579	+	94	146583	73204
chr16	2373588	2573588	harbor1	chr16	2401402	2401624	LTR/ERVL-MaLR	1224	+	111	2401513	27925
chr16	2373588	2573588	harbor1	chr16	2416385	2416694	LTR/ERVL-MaLR	840	+	154	2416539	42951
chr16	686536	886536	harbor1	chr16	746988	747264	LTR/ERVL-MaLR	1795	+	138	747126	60590
chr16	686536	886536	harbor1	chr16	747576	747646	LTR/ERVL-MaLR	1795	+	35	747611	61075
chr16	686536	886536	harbor1	chr16	771100	771226	LTR/ERVL-MaLR	1146	+	63	771163	84627
chr16	686536	886536	harbor1	chr16	771675	771910	LTR/ERVL-MaLR	1146	+	118	771793	85257
chr16	2375149	2575149	harbor1	chr16	2401402	2401624	LTR/ERVL-MaLR	1224	+	111	2401513	26364
chr16	2375149	2575149	harbor1	chr16	2416385	2416694	LTR/ERVL-MaLR	840	+	154	2416539	41390
chr16	87292256	87492256	harbor1	chr16	87316714	87317005	LTR/ERVL-MaLR	783	+	146	87316860	24604
chr16	87292256	87492256	harbor1	chr16	87338802	87339158	LTR/ERVL-MaLR	2500	+	178	87338980	46724
chr16	53030875	53230875	harbor1	chr16	53073525	53073869	LTR/ERVL-MaLR	2219	+	172	53073697	42822
chr16	53030875	53230875	harbor1	chr16	53073870	53075436	LTR/ERVL-MaLR	12241	+	783	53074653	43778
chr16	53030875	53230875	harbor1	chr16	53075437	53075799	LTR/ERVL-MaLR	2321	+	181	53075618	44743
chr16	53030875	53230875	harbor1	chr16	53078192	53078574	LTR/ERVL-MaLR	1665	+	191	53078383	47508
chr16	4084076	4284076	harbor1	chr16	4099979	4100327	LTR/ERVL-MaLR	1907	+	174	4100153	16077
chr16	4084076	4284076	harbor1	chr16	4100630	4100671	LTR/ERVL-MaLR	1907	+	20	4100650	16574
chr16	4084076	4284076	harbor1	chr16	4121712	4121870	LTR/ERVL-MaLR	573	+	79	4121791	37715
chr16	4084076	4284076	harbor1	chr16	4127602	4127760	LTR/ERVL-MaLR	1430	+	79	4127681	43605
chr16	4084076	4284076	harbor1	chr16	4127787	4127809	LTR/ERVL-MaLR	1430	+	11	4127798	43722
chr16	4084076	4284076	harbor1	chr16	4127966	4128042	LTR/ERVL-MaLR	1430	+	38	4128004	43928
chr16	4084076	4284076	harbor1	chr16	4128350	4128566	LTR/ERVL-MaLR	1430	+	108	4128458	44382
chr16	4084076	4284076	harbor1	chr16	4138625	4138903	LTR/ERVL-MaLR	1364	+	139	4138764	54688
chr16	4084076	4284076	harbor1	chr16	4140295	4140713	LTR/ERVL-MaLR	2251	+	209	4140504	56428
chr16	4084076	4284076	harbor1	chr16	4155228	4155634	LTR/ERVL-MaLR	1799	+	203	4155431	71355
chr16	4084076	4284076	harbor1	chr16	4155945	4156008	LTR/ERVL-MaLR	1799	+	32	4155977	71901
chr16	4084076	4284076	harbor1	chr16	4168943	4169343	LTR/ERVL-MaLR	1647	+	200	4169143	85067
chr16	700640	900640	harbor1	chr16	746988	747264	LTR/ERVL-MaLR	1795	+	138	747126	46486
chr16	700640	900640	harbor1	chr16	747576	747646	LTR/ERVL-MaLR	1795	+	35	747611	46971
chr16	700640	900640	harbor1	chr16	771100	771226	LTR/ERVL-MaLR	1146	+	63	771163	70523
chr16	700640	900640	harbor1	chr16	771675	771910	LTR/ERVL-MaLR	1146	+	118	771793	71153
chr16	422591	622591	harbor1	chr16	472741	473136	LTR/ERVL-MaLR	973	+	198	472939	50348
chr16	2836774	3036774	harbor1	chr16	2863834	2864231	LTR/ERVL-MaLR	2080	+	198	2864032	27258
chr16	980068	1180068	harbor1	chr16	1026803	1027200	LTR/ERVL-MaLR	603	+	198	1027001	46933
chr16	980068	1180068	harbor1	chr16	1037753	1038044	LTR/ERVL-MaLR	596	+	146	1037899	57831
chr16	980068	1180068	harbor1	chr16	1066737	1067098	LTR/ERVL-MaLR	1488	+	180	1066917	86849
chr16	980068	1180068	harbor1	chr16	1067435	1067467	LTR/ERVL-MaLR	1488	+	16	1067451	87383
chr16	72525	272525	harbor1	chr16	146001	146181	LTR/ERVL-MaLR	1579	+	90	146091	73566
chr16	72525	272525	harbor1	chr16	146489	146677	LTR/ERVL-MaLR	1579	+	94	146583	74058
chr16	4016535	4216535	harbor1	chr16	4037918	4037995	LTR/ERVL-MaLR	941	+	38	4037956	21421
chr16	4016535	4216535	harbor1	chr16	4038296	4038599	LTR/ERVL-MaLR	941	+	152	4038448	21913
chr16	4016535	4216535	harbor1	chr16	4082986	4083229	LTR/ERVL-MaLR	744	+	122	4083108	66573
chr16	4016535	4216535	harbor1	chr16	4099979	4100327	LTR/ERVL-MaLR	1907	+	174	4100153	83618
chr16	4016535	4216535	harbor1	chr16	4100630	4100671	LTR/ERVL-MaLR	1907	+	20	4100650	84115
chr16	1	167641	harbor1	chr16	27259	27445	LTR/ERVL-MaLR	757	+	93	27352	27351
chr16	1	167641	harbor1	chr16	27750	27848	LTR/ERVL-MaLR	757	+	49	27799	27798
chr16	1	167641	harbor1	chr16	28408	28525	LTR/ERVL-MaLR	608	+	58	28466	28465
chr16	2226331	2426331	harbor1	chr16	2242489	2242754	LTR/ERVL-MaLR	675	+	132	2242621	16290
chr16	56533856	56733856	harbor1	chr16	56535903	56536293	LTR/ERVL-MaLR	2166	+	195	56536098	2242
chr16	56533856	56733856	harbor1	chr16	56572567	56572720	LTR/ERVL-MaLR	1935	+	76	56572643	38787
chr16	56533856	56733856	harbor1	chr16	56573026	56573247	LTR/ERVL-MaLR	1935	+	110	56573136	39280
chr16	56533856	56733856	harbor1	chr16	56593477	56593817	LTR/ERVL-MaLR	2070	+	170	56593647	59791
chr16	56533856	56733856	harbor1	chr16	56594039	56594433	LTR/ERVL-MaLR	1124	+	197	56594236	60380
chr16	56533856	56733856	harbor1	chr16	56602226	56602402	LTR/ERVL-MaLR	885	+	88	56602314	68458
chr16	56533856	56733856	harbor1	chr16	56603598	56603969	LTR/ERVL-MaLR	1365	+	186	56603784	69928
chr16	56533856	56733856	harbor1	chr16	56604893	56605415	LTR/ERVL-MaLR	2342	+	261	56605154	71298
chr16	56533856	56733856	harbor1	chr16	56623150	56623508	LTR/ERVL-MaLR	2259	+	179	56623329	89473
chr16	56533856	56733856	harbor1	chr16	56628567	56628902	LTR/ERVL-MaLR	1591	+	168	56628735	94879
chr16	56533856	56733856	harbor1	chr16	56621654	56623148	LTR/ERVL-MaLR	10906	+	747	56622401	88545
chr16	2198417	2398417	harbor1	chr16	2242489	2242754	LTR/ERVL-MaLR	675	+	132	2242621	44204
chr16	87292296	87492296	harbor1	chr16	87316714	87317005	LTR/ERVL-MaLR	783	+	146	87316860	24564
chr16	87292296	87492296	harbor1	chr16	87338802	87339158	LTR/ERVL-MaLR	2500	+	178	87338980	46684
chr16	88283250	88483250	harbor1	chr16	88337149	88337499	LTR/ERVL-MaLR	2484	+	175	88337324	54074
chr16	88283250	88483250	harbor1	chr16	88347236	88347627	LTR/ERVL-MaLR	914	+	196	88347432	64182
chr16	88283250	88483250	harbor1	chr16	88350730	88351020	LTR/ERVL-MaLR	864	+	145	88350875	67625
chr16	88283250	88483250	harbor1	chr16	88326111	88326466	LTR/ERVL-MaLR	2295	+	178	88326289	43039
chr16	71269665	71469665	harbor1	chr16	71274698	71275087	LTR/ERVL-MaLR	1600	+	194	71274892	5227
chr16	71269665	71469665	harbor1	chr16	71303364	71303684	LTR/ERVL-MaLR	890	+	160	71303524	33859
chr16	71269665	71469665	harbor1	chr16	71324755	71325235	LTR/ERVL-MaLR	2363	+	240	71324995	55330
chr16	71269665	71469665	harbor1	chr16	71328341	71328787	LTR/ERVL-MaLR	775	+	223	71328564	58899
chr16	4084117	4284117	harbor1	chr16	4099979	4100327	LTR/ERVL-MaLR	1907	+	174	4100153	16036
chr16	4084117	4284117	harbor1	chr16	4100630	4100671	LTR/ERVL-MaLR	1907	+	20	4100650	16533
chr16	4084117	4284117	harbor1	chr16	4121712	4121870	LTR/ERVL-MaLR	573	+	79	4121791	37674
chr16	4084117	4284117	harbor1	chr16	4127602	4127760	LTR/ERVL-MaLR	1430	+	79	4127681	43564
chr16	4084117	4284117	harbor1	chr16	4127787	4127809	LTR/ERVL-MaLR	1430	+	11	4127798	43681
chr16	4084117	4284117	harbor1	chr16	4127966	4128042	LTR/ERVL-MaLR	1430	+	38	4128004	43887
chr16	4084117	4284117	harbor1	chr16	4128350	4128566	LTR/ERVL-MaLR	1430	+	108	4128458	44341
chr16	4084117	4284117	harbor1	chr16	4138625	4138903	LTR/ERVL-MaLR	1364	+	139	4138764	54647
chr16	4084117	4284117	harbor1	chr16	4140295	4140713	LTR/ERVL-MaLR	2251	+	209	4140504	56387
chr16	4084117	4284117	harbor1	chr16	4155228	4155634	LTR/ERVL-MaLR	1799	+	203	4155431	71314
chr16	4084117	4284117	harbor1	chr16	4155945	4156008	LTR/ERVL-MaLR	1799	+	32	4155977	71860
chr16	4084117	4284117	harbor1	chr16	4168943	4169343	LTR/ERVL-MaLR	1647	+	200	4169143	85026
chr16	870915	1070915	harbor1	chr16	939864	940277	LTR/ERVL-MaLR	610	+	206	940070	69155
chr16	67098316	67298316	harbor1	chr16	67157172	67157686	LTR/ERVL-MaLR	1464	+	257	67157429	59113
chr16	1	167633	harbor1	chr16	27259	27445	LTR/ERVL-MaLR	757	+	93	27352	27351
chr16	1	167633	harbor1	chr16	27750	27848	LTR/ERVL-MaLR	757	+	49	27799	27798
chr16	1	167633	harbor1	chr16	28408	28525	LTR/ERVL-MaLR	608	+	58	28466	28465
chr16	1600271	1800271	harbor1	chr16	1605786	1606195	LTR/ERVL-MaLR	1311	+	204	1605990	5719
chr16	2198460	2398460	harbor1	chr16	2242489	2242754	LTR/ERVL-MaLR	675	+	132	2242621	44161
chr16	67098313	67298313	harbor1	chr16	67157172	67157686	LTR/ERVL-MaLR	1464	+	257	67157429	59116
chr16	1	167676	harbor1	chr16	27259	27445	LTR/ERVL-MaLR	757	+	93	27352	27351
chr16	1	167676	harbor1	chr16	27750	27848	LTR/ERVL-MaLR	757	+	49	27799	27798
chr16	1	167676	harbor1	chr16	28408	28525	LTR/ERVL-MaLR	608	+	58	28466	28465
chr16	2369772	2569772	harbor1	chr16	2401402	2401624	LTR/ERVL-MaLR	1224	+	111	2401513	31741
chr16	2369772	2569772	harbor1	chr16	2416385	2416694	LTR/ERVL-MaLR	840	+	154	2416539	46767
chr16	87292331	87492331	harbor1	chr16	87316714	87317005	LTR/ERVL-MaLR	783	+	146	87316860	24529
chr16	87292331	87492331	harbor1	chr16	87338802	87339158	LTR/ERVL-MaLR	2500	+	178	87338980	46649
chr16	68145542	68345542	harbor1	chr16	68150685	68151057	LTR/ERVL-MaLR	2616	+	186	68150871	5329
chr16	1210306	1410306	harbor1	chr16	1266450	1266791	LTR/ERVL-MaLR	770	+	170	1266620	56314
chr16	700514	900514	harbor1	chr16	746988	747264	LTR/ERVL-MaLR	1795	+	138	747126	46612
chr16	700514	900514	harbor1	chr16	747576	747646	LTR/ERVL-MaLR	1795	+	35	747611	47097
chr16	700514	900514	harbor1	chr16	771100	771226	LTR/ERVL-MaLR	1146	+	63	771163	70649
chr16	700514	900514	harbor1	chr16	771675	771910	LTR/ERVL-MaLR	1146	+	118	771793	71279
chr16	2373217	2573217	harbor1	chr16	2401402	2401624	LTR/ERVL-MaLR	1224	+	111	2401513	28296
chr16	2373217	2573217	harbor1	chr16	2416385	2416694	LTR/ERVL-MaLR	840	+	154	2416539	43322
chr16	30978860	31178860	harbor1	chr16	31020202	31020340	LTR/ERVL-MaLR	1490	+	69	31020271	41411
chr16	30978860	31178860	harbor1	chr16	31020641	31020850	LTR/ERVL-MaLR	1490	+	104	31020745	41885
chr16	30978860	31178860	harbor1	chr16	31022547	31022713	LTR/ERVL-MaLR	577	+	83	31022630	43770
chr16	30978860	31178860	harbor1	chr16	31044355	31044490	LTR/ERVL-MaLR	709	+	68	31044423	65563
chr16	30978860	31178860	harbor1	chr16	31044788	31045032	LTR/ERVL-MaLR	709	+	122	31044910	66050
chr16	30978860	31178860	harbor1	chr16	31045881	31046271	LTR/ERVL-MaLR	1304	+	195	31046076	67216
chr16	30978860	31178860	harbor1	chr16	31046486	31046654	LTR/ERVL-MaLR	1304	+	84	31046570	67710
chr16	30978860	31178860	harbor1	chr16	31046951	31047195	LTR/ERVL-MaLR	1304	+	122	31047073	68213
chr16	30978860	31178860	harbor1	chr16	31048163	31048174	LTR/ERVL-MaLR	1304	+	6	31048169	69309
chr16	30978860	31178860	harbor1	chr16	31048476	31048746	LTR/ERVL-MaLR	1304	+	135	31048611	69751
chr16	30978860	31178860	harbor1	chr16	31049374	31049700	LTR/ERVL-MaLR	1304	+	163	31049537	70677
chr16	30978860	31178860	harbor1	chr16	31050075	31050435	LTR/ERVL-MaLR	1004	+	180	31050255	71395
chr16	30978860	31178860	harbor1	chr16	31055687	31055826	LTR/ERVL-MaLR	630	+	70	31055757	76897
chr16	456244	656244	harbor1	chr16	472741	473136	LTR/ERVL-MaLR	973	+	198	472939	16695
chr16	57884915	58084915	harbor1	chr16	57887315	57887737	LTR/ERVL-MaLR	1442	+	211	57887526	2611
chr16	57884915	58084915	harbor1	chr16	57889303	57889632	LTR/ERVL-MaLR	1051	+	164	57889467	4552
chr16	57884915	58084915	harbor1	chr16	57898830	57899081	LTR/ERVL-MaLR	1103	+	126	57898956	14041
chr16	57884915	58084915	harbor1	chr16	57905562	57905954	LTR/ERVL-MaLR	1522	+	196	57905758	20843
chr16	57884915	58084915	harbor1	chr16	57924639	57924990	LTR/ERVL-MaLR	2183	+	176	57924815	39900
chr16	57884915	58084915	harbor1	chr16	57925303	57925372	LTR/ERVL-MaLR	2183	+	34	57925337	40422
chr16	57884915	58084915	harbor1	chr16	57955517	57955978	LTR/ERVL-MaLR	1541	+	230	57955747	70832
chr16	455849	655849	harbor1	chr16	472741	473136	LTR/ERVL-MaLR	973	+	198	472939	17090
chr16	89474865	89674865	harbor1	chr16	89482490	89482643	LTR/ERVL-MaLR	1205	+	76	89482566	7701
chr16	89474865	89674865	harbor1	chr16	89482796	89483058	LTR/ERVL-MaLR	1205	+	131	89482927	8062
chr16	71269741	71469741	harbor1	chr16	71274698	71275087	LTR/ERVL-MaLR	1600	+	194	71274892	5151
chr16	71269741	71469741	harbor1	chr16	71303364	71303684	LTR/ERVL-MaLR	890	+	160	71303524	33783
chr16	71269741	71469741	harbor1	chr16	71324755	71325235	LTR/ERVL-MaLR	2363	+	240	71324995	55254
chr16	71269741	71469741	harbor1	chr16	71328341	71328787	LTR/ERVL-MaLR	775	+	223	71328564	58823
chr16	1517721	1717721	harbor1	chr16	1579379	1579598	LTR/ERVL-MaLR	842	+	110	1579489	61768
chr16	1517721	1717721	harbor1	chr16	1580285	1580664	LTR/ERVL-MaLR	2184	+	190	1580475	62754
chr16	1517721	1717721	harbor1	chr16	1582132	1582578	LTR/ERVL-MaLR	1317	+	223	1582355	64634
chr16	1517721	1717721	harbor1	chr16	1605786	1606195	LTR/ERVL-MaLR	1311	+	204	1605990	88269
chr16	699537	899537	harbor1	chr16	746988	747264	LTR/ERVL-MaLR	1795	+	138	747126	47589
chr16	699537	899537	harbor1	chr16	747576	747646	LTR/ERVL-MaLR	1795	+	35	747611	48074
chr16	699537	899537	harbor1	chr16	771100	771226	LTR/ERVL-MaLR	1146	+	63	771163	71626
chr16	699537	899537	harbor1	chr16	771675	771910	LTR/ERVL-MaLR	1146	+	118	771793	72256
chr16	700506	900506	harbor1	chr16	746988	747264	LTR/ERVL-MaLR	1795	+	138	747126	46620
chr16	700506	900506	harbor1	chr16	747576	747646	LTR/ERVL-MaLR	1795	+	35	747611	47105
chr16	700506	900506	harbor1	chr16	771100	771226	LTR/ERVL-MaLR	1146	+	63	771163	70657
chr16	700506	900506	harbor1	chr16	771675	771910	LTR/ERVL-MaLR	1146	+	118	771793	71287
chr16	57884963	58084963	harbor1	chr16	57887315	57887737	LTR/ERVL-MaLR	1442	+	211	57887526	2563
chr16	57884963	58084963	harbor1	chr16	57889303	57889632	LTR/ERVL-MaLR	1051	+	164	57889467	4504
chr16	57884963	58084963	harbor1	chr16	57898830	57899081	LTR/ERVL-MaLR	1103	+	126	57898956	13993
chr16	57884963	58084963	harbor1	chr16	57905562	57905954	LTR/ERVL-MaLR	1522	+	196	57905758	20795
chr16	57884963	58084963	harbor1	chr16	57924639	57924990	LTR/ERVL-MaLR	2183	+	176	57924815	39852
chr16	57884963	58084963	harbor1	chr16	57925303	57925372	LTR/ERVL-MaLR	2183	+	34	57925337	40374
chr16	57884963	58084963	harbor1	chr16	57955517	57955978	LTR/ERVL-MaLR	1541	+	230	57955747	70784
chr16	56832289	57032289	harbor1	chr16	56928414	56928714	LTR/ERVL-MaLR	1730	+	150	56928564	96275
chr16	56832289	57032289	harbor1	chr16	56929311	56929448	LTR/ERVL-MaLR	1730	+	68	56929379	97090
chr16	456280	656280	harbor1	chr16	472741	473136	LTR/ERVL-MaLR	973	+	198	472939	16659
chr16	57418274	57618274	harbor1	chr16	57427425	57427796	LTR/ERVL-MaLR	2427	+	186	57427611	9337
chr16	57418274	57618274	harbor1	chr16	57435012	57435418	LTR/ERVL-MaLR	2387	+	203	57435215	16941
chr16	700537	900537	harbor1	chr16	746988	747264	LTR/ERVL-MaLR	1795	+	138	747126	46589
chr16	700537	900537	harbor1	chr16	747576	747646	LTR/ERVL-MaLR	1795	+	35	747611	47074
chr16	700537	900537	harbor1	chr16	771100	771226	LTR/ERVL-MaLR	1146	+	63	771163	70626
chr16	700537	900537	harbor1	chr16	771675	771910	LTR/ERVL-MaLR	1146	+	118	771793	71256
chr16	30087207	30287207	harbor1	chr16	30153988	30154415	LTR/ERVL-MaLR	2449	+	214	30154202	66995
chr16	72962536	73162536	harbor1	chr16	73000955	73001496	LTR/ERVL-MaLR	2150	+	270	73001225	38689
chr16	72962536	73162536	harbor1	chr16	73013870	73014299	LTR/ERVL-MaLR	1579	+	214	73014084	51548
chr16	72962536	73162536	harbor1	chr16	73021410	73021549	LTR/ERVL-MaLR	693	+	70	73021480	58944
chr16	72962536	73162536	harbor1	chr16	73021854	73021968	LTR/ERVL-MaLR	693	+	57	73021911	59375
chr16	57884933	58084933	harbor1	chr16	57887315	57887737	LTR/ERVL-MaLR	1442	+	211	57887526	2593
chr16	57884933	58084933	harbor1	chr16	57889303	57889632	LTR/ERVL-MaLR	1051	+	164	57889467	4534
chr16	57884933	58084933	harbor1	chr16	57898830	57899081	LTR/ERVL-MaLR	1103	+	126	57898956	14023
chr16	57884933	58084933	harbor1	chr16	57905562	57905954	LTR/ERVL-MaLR	1522	+	196	57905758	20825
chr16	57884933	58084933	harbor1	chr16	57924639	57924990	LTR/ERVL-MaLR	2183	+	176	57924815	39882
chr16	57884933	58084933	harbor1	chr16	57925303	57925372	LTR/ERVL-MaLR	2183	+	34	57925337	40404
chr16	57884933	58084933	harbor1	chr16	57955517	57955978	LTR/ERVL-MaLR	1541	+	230	57955747	70814
chr16	47349128	47549128	harbor1	chr16	47416476	47416849	LTR/ERVL-MaLR	1749	+	186	47416662	67534
chr16	47349128	47549128	harbor1	chr16	47420487	47420883	LTR/ERVL-MaLR	1625	+	198	47420685	71557
chr16	47349128	47549128	harbor1	chr16	47445533	47445830	LTR/ERVL-MaLR	777	+	148	47445681	96553
chr16	77459	277459	harbor1	chr16	146001	146181	LTR/ERVL-MaLR	1579	+	90	146091	68632
chr16	77459	277459	harbor1	chr16	146489	146677	LTR/ERVL-MaLR	1579	+	94	146583	69124
chr16	2198397	2398397	harbor1	chr16	2242489	2242754	LTR/ERVL-MaLR	675	+	132	2242621	44224
chr16	89608858	89808858	harbor1	chr16	89626182	89626358	LTR/ERVL-MaLR	1235	+	88	89626270	17412
chr16	89608858	89808858	harbor1	chr16	89626654	89626834	LTR/ERVL-MaLR	1235	+	90	89626744	17886
chr16	89608858	89808858	harbor1	chr16	89661208	89661557	LTR/ERVL-MaLR	2262	+	174	89661382	52524
chr16	89608858	89808858	harbor1	chr16	89664344	89664960	LTR/ERVL-MaLR	782	+	308	89664652	55794
chr16	89608858	89808858	harbor1	chr16	89703439	89703788	LTR/ERVL-MaLR	1842	+	174	89703613	94755
chr16	89608858	89808858	harbor1	chr16	89704247	89704575	LTR/ERVL-MaLR	928	+	164	89704411	95553
chr16	54836870	55036870	harbor1	chr16	54871484	54871627	LTR/ERVL-MaLR	1708	+	72	54871556	34686
chr16	54836870	55036870	harbor1	chr16	54871693	54871989	LTR/ERVL-MaLR	1708	+	148	54871841	34971
chr16	54836870	55036870	harbor1	chr16	54902437	54902827	LTR/ERVL-MaLR	1541	+	195	54902632	65762
chr16	1	167624	harbor1	chr16	27259	27445	LTR/ERVL-MaLR	757	+	93	27352	27351
chr16	1	167624	harbor1	chr16	27750	27848	LTR/ERVL-MaLR	757	+	49	27799	27798
chr16	1	167624	harbor1	chr16	28408	28525	LTR/ERVL-MaLR	608	+	58	28466	28465
chr16	427637	627637	harbor1	chr16	472741	473136	LTR/ERVL-MaLR	973	+	198	472939	45302
chr16	67063130	67263130	harbor1	chr16	67071247	67071621	LTR/ERVL-MaLR	1365	+	187	67071434	8304
chr16	67063130	67263130	harbor1	chr16	67157172	67157686	LTR/ERVL-MaLR	1464	+	257	67157429	94299
chr16	700633	900633	harbor1	chr16	746988	747264	LTR/ERVL-MaLR	1795	+	138	747126	46493
chr16	700633	900633	harbor1	chr16	747576	747646	LTR/ERVL-MaLR	1795	+	35	747611	46978
chr16	700633	900633	harbor1	chr16	771100	771226	LTR/ERVL-MaLR	1146	+	63	771163	70530
chr16	700633	900633	harbor1	chr16	771675	771910	LTR/ERVL-MaLR	1146	+	118	771793	71160
chr16	4016523	4216523	harbor1	chr16	4037918	4037995	LTR/ERVL-MaLR	941	+	38	4037956	21433
chr16	4016523	4216523	harbor1	chr16	4038296	4038599	LTR/ERVL-MaLR	941	+	152	4038448	21925
chr16	4016523	4216523	harbor1	chr16	4082986	4083229	LTR/ERVL-MaLR	744	+	122	4083108	66585
chr16	4016523	4216523	harbor1	chr16	4099979	4100327	LTR/ERVL-MaLR	1907	+	174	4100153	83630
chr16	4016523	4216523	harbor1	chr16	4100630	4100671	LTR/ERVL-MaLR	1907	+	20	4100650	84127
chr16	2330012	2530012	harbor1	chr16	2401402	2401624	LTR/ERVL-MaLR	1224	+	111	2401513	71501
chr16	2330012	2530012	harbor1	chr16	2416385	2416694	LTR/ERVL-MaLR	840	+	154	2416539	86527
chr16	67009907	67209907	harbor1	chr16	67071247	67071621	LTR/ERVL-MaLR	1365	+	187	67071434	61527
chr16	454757	654757	harbor1	chr16	472741	473136	LTR/ERVL-MaLR	973	+	198	472939	18182
chr16	700659	900659	harbor1	chr16	746988	747264	LTR/ERVL-MaLR	1795	+	138	747126	46467
chr16	700659	900659	harbor1	chr16	747576	747646	LTR/ERVL-MaLR	1795	+	35	747611	46952
chr16	700659	900659	harbor1	chr16	771100	771226	LTR/ERVL-MaLR	1146	+	63	771163	70504
chr16	700659	900659	harbor1	chr16	771675	771910	LTR/ERVL-MaLR	1146	+	118	771793	71134
chr16	56464967	56664967	harbor1	chr16	56491168	56491605	LTR/ERVL-MaLR	1986	+	218	56491386	26419
chr16	56464967	56664967	harbor1	chr16	56504796	56505140	LTR/ERVL-MaLR	1909	+	172	56504968	40001
chr16	56464967	56664967	harbor1	chr16	56535903	56536293	LTR/ERVL-MaLR	2166	+	195	56536098	71131
chr16	4081966	4281966	harbor1	chr16	4082986	4083229	LTR/ERVL-MaLR	744	+	122	4083108	1142
chr16	4081966	4281966	harbor1	chr16	4099979	4100327	LTR/ERVL-MaLR	1907	+	174	4100153	18187
chr16	4081966	4281966	harbor1	chr16	4100630	4100671	LTR/ERVL-MaLR	1907	+	20	4100650	18684
chr16	4081966	4281966	harbor1	chr16	4121712	4121870	LTR/ERVL-MaLR	573	+	79	4121791	39825
chr16	4081966	4281966	harbor1	chr16	4127602	4127760	LTR/ERVL-MaLR	1430	+	79	4127681	45715
chr16	4081966	4281966	harbor1	chr16	4127787	4127809	LTR/ERVL-MaLR	1430	+	11	4127798	45832
chr16	4081966	4281966	harbor1	chr16	4127966	4128042	LTR/ERVL-MaLR	1430	+	38	4128004	46038
chr16	4081966	4281966	harbor1	chr16	4128350	4128566	LTR/ERVL-MaLR	1430	+	108	4128458	46492
chr16	4081966	4281966	harbor1	chr16	4138625	4138903	LTR/ERVL-MaLR	1364	+	139	4138764	56798
chr16	4081966	4281966	harbor1	chr16	4140295	4140713	LTR/ERVL-MaLR	2251	+	209	4140504	58538
chr16	4081966	4281966	harbor1	chr16	4155228	4155634	LTR/ERVL-MaLR	1799	+	203	4155431	73465
chr16	4081966	4281966	harbor1	chr16	4155945	4156008	LTR/ERVL-MaLR	1799	+	32	4155977	74011
chr16	4081966	4281966	harbor1	chr16	4168943	4169343	LTR/ERVL-MaLR	1647	+	200	4169143	87177
chr16	31017885	31217885	harbor1	chr16	31020202	31020340	LTR/ERVL-MaLR	1490	+	69	31020271	2386
chr16	31017885	31217885	harbor1	chr16	31020641	31020850	LTR/ERVL-MaLR	1490	+	104	31020745	2860
chr16	31017885	31217885	harbor1	chr16	31022547	31022713	LTR/ERVL-MaLR	577	+	83	31022630	4745
chr16	31017885	31217885	harbor1	chr16	31044355	31044490	LTR/ERVL-MaLR	709	+	68	31044423	26538
chr16	31017885	31217885	harbor1	chr16	31044788	31045032	LTR/ERVL-MaLR	709	+	122	31044910	27025
chr16	31017885	31217885	harbor1	chr16	31045881	31046271	LTR/ERVL-MaLR	1304	+	195	31046076	28191
chr16	31017885	31217885	harbor1	chr16	31046486	31046654	LTR/ERVL-MaLR	1304	+	84	31046570	28685
chr16	31017885	31217885	harbor1	chr16	31046951	31047195	LTR/ERVL-MaLR	1304	+	122	31047073	29188
chr16	31017885	31217885	harbor1	chr16	31048163	31048174	LTR/ERVL-MaLR	1304	+	6	31048169	30284
chr16	31017885	31217885	harbor1	chr16	31048476	31048746	LTR/ERVL-MaLR	1304	+	135	31048611	30726
chr16	31017885	31217885	harbor1	chr16	31049374	31049700	LTR/ERVL-MaLR	1304	+	163	31049537	31652
chr16	31017885	31217885	harbor1	chr16	31050075	31050435	LTR/ERVL-MaLR	1004	+	180	31050255	32370
chr16	31017885	31217885	harbor1	chr16	31055687	31055826	LTR/ERVL-MaLR	630	+	70	31055757	37872
chr16	31017885	31217885	harbor1	chr16	31098364	31098698	LTR/ERVL-MaLR	1164	+	167	31098531	80646
chr16	31017885	31217885	harbor1	chr16	31100087	31100361	LTR/ERVL-MaLR	2044	+	137	31100224	82339
chr16	31017885	31217885	harbor1	chr16	31101265	31101454	LTR/ERVL-MaLR	2044	+	94	31101359	83474
chr16	31017885	31217885	harbor1	chr16	31101767	31101789	LTR/ERVL-MaLR	2044	+	11	31101778	83893
chr16	31017885	31217885	harbor1	chr16	31101924	31101958	LTR/ERVL-MaLR	2044	+	17	31101941	84056
chr16	31017885	31217885	harbor1	chr16	31102208	31102256	LTR/ERVL-MaLR	2044	+	24	31102232	84347
chr16	2863130	3063130	harbor1	chr16	2863834	2864231	LTR/ERVL-MaLR	2080	+	198	2864032	902
chr16	57884908	58084908	harbor1	chr16	57887315	57887737	LTR/ERVL-MaLR	1442	+	211	57887526	2618
chr16	57884908	58084908	harbor1	chr16	57889303	57889632	LTR/ERVL-MaLR	1051	+	164	57889467	4559
chr16	57884908	58084908	harbor1	chr16	57898830	57899081	LTR/ERVL-MaLR	1103	+	126	57898956	14048
chr16	57884908	58084908	harbor1	chr16	57905562	57905954	LTR/ERVL-MaLR	1522	+	196	57905758	20850
chr16	57884908	58084908	harbor1	chr16	57924639	57924990	LTR/ERVL-MaLR	2183	+	176	57924815	39907
chr16	57884908	58084908	harbor1	chr16	57925303	57925372	LTR/ERVL-MaLR	2183	+	34	57925337	40429
chr16	57884908	58084908	harbor1	chr16	57955517	57955978	LTR/ERVL-MaLR	1541	+	230	57955747	70839
chr16	70055	270055	harbor1	chr16	146001	146181	LTR/ERVL-MaLR	1579	+	90	146091	76036
chr16	70055	270055	harbor1	chr16	146489	146677	LTR/ERVL-MaLR	1579	+	94	146583	76528
chr16	1	167578	harbor1	chr16	27259	27445	LTR/ERVL-MaLR	757	+	93	27352	27351
chr16	1	167578	harbor1	chr16	27750	27848	LTR/ERVL-MaLR	757	+	49	27799	27798
chr16	1	167578	harbor1	chr16	28408	28525	LTR/ERVL-MaLR	608	+	58	28466	28465
chr16	4084087	4284087	harbor1	chr16	4099979	4100327	LTR/ERVL-MaLR	1907	+	174	4100153	16066
chr16	4084087	4284087	harbor1	chr16	4100630	4100671	LTR/ERVL-MaLR	1907	+	20	4100650	16563
chr16	4084087	4284087	harbor1	chr16	4121712	4121870	LTR/ERVL-MaLR	573	+	79	4121791	37704
chr16	4084087	4284087	harbor1	chr16	4127602	4127760	LTR/ERVL-MaLR	1430	+	79	4127681	43594
chr16	4084087	4284087	harbor1	chr16	4127787	4127809	LTR/ERVL-MaLR	1430	+	11	4127798	43711
chr16	4084087	4284087	harbor1	chr16	4127966	4128042	LTR/ERVL-MaLR	1430	+	38	4128004	43917
chr16	4084087	4284087	harbor1	chr16	4128350	4128566	LTR/ERVL-MaLR	1430	+	108	4128458	44371
chr16	4084087	4284087	harbor1	chr16	4138625	4138903	LTR/ERVL-MaLR	1364	+	139	4138764	54677
chr16	4084087	4284087	harbor1	chr16	4140295	4140713	LTR/ERVL-MaLR	2251	+	209	4140504	56417
chr16	4084087	4284087	harbor1	chr16	4155228	4155634	LTR/ERVL-MaLR	1799	+	203	4155431	71344
chr16	4084087	4284087	harbor1	chr16	4155945	4156008	LTR/ERVL-MaLR	1799	+	32	4155977	71890
chr16	4084087	4284087	harbor1	chr16	4168943	4169343	LTR/ERVL-MaLR	1647	+	200	4169143	85056
chr16	56535691	56735691	harbor1	chr16	56535903	56536293	LTR/ERVL-MaLR	2166	+	195	56536098	407
chr16	56535691	56735691	harbor1	chr16	56572567	56572720	LTR/ERVL-MaLR	1935	+	76	56572643	36952
chr16	56535691	56735691	harbor1	chr16	56573026	56573247	LTR/ERVL-MaLR	1935	+	110	56573136	37445
chr16	56535691	56735691	harbor1	chr16	56593477	56593817	LTR/ERVL-MaLR	2070	+	170	56593647	57956
chr16	56535691	56735691	harbor1	chr16	56594039	56594433	LTR/ERVL-MaLR	1124	+	197	56594236	58545
chr16	56535691	56735691	harbor1	chr16	56602226	56602402	LTR/ERVL-MaLR	885	+	88	56602314	66623
chr16	56535691	56735691	harbor1	chr16	56603598	56603969	LTR/ERVL-MaLR	1365	+	186	56603784	68093
chr16	56535691	56735691	harbor1	chr16	56604893	56605415	LTR/ERVL-MaLR	2342	+	261	56605154	69463
chr16	56535691	56735691	harbor1	chr16	56623150	56623508	LTR/ERVL-MaLR	2259	+	179	56623329	87638
chr16	56535691	56735691	harbor1	chr16	56628567	56628902	LTR/ERVL-MaLR	1591	+	168	56628735	93044
chr16	56535691	56735691	harbor1	chr16	56634342	56634523	LTR/ERVL-MaLR	805	+	90	56634432	98741
chr16	56535691	56735691	harbor1	chr16	56621654	56623148	LTR/ERVL-MaLR	10906	+	747	56622401	86710
chr16	57884560	58084560	harbor1	chr16	57887315	57887737	LTR/ERVL-MaLR	1442	+	211	57887526	2966
chr16	57884560	58084560	harbor1	chr16	57889303	57889632	LTR/ERVL-MaLR	1051	+	164	57889467	4907
chr16	57884560	58084560	harbor1	chr16	57898830	57899081	LTR/ERVL-MaLR	1103	+	126	57898956	14396
chr16	57884560	58084560	harbor1	chr16	57905562	57905954	LTR/ERVL-MaLR	1522	+	196	57905758	21198
chr16	57884560	58084560	harbor1	chr16	57924639	57924990	LTR/ERVL-MaLR	2183	+	176	57924815	40255
chr16	57884560	58084560	harbor1	chr16	57925303	57925372	LTR/ERVL-MaLR	2183	+	34	57925337	40777
chr16	57884560	58084560	harbor1	chr16	57955517	57955978	LTR/ERVL-MaLR	1541	+	230	57955747	71187
chr16	30850099	31050099	harbor1	chr16	30867816	30868129	LTR/ERVL-MaLR	1445	+	156	30867972	17873
chr16	30850099	31050099	harbor1	chr16	30868437	30868500	LTR/ERVL-MaLR	1445	+	32	30868469	18370
chr16	30850099	31050099	harbor1	chr16	30885045	30885407	LTR/ERVL-MaLR	1632	+	181	30885226	35127
chr16	30850099	31050099	harbor1	chr16	30885703	30885763	LTR/ERVL-MaLR	1632	+	30	30885733	35634
chr16	30850099	31050099	harbor1	chr16	30867341	30867537	LTR/ERVL-MaLR	1445	+	98	30867439	17340
chr16	71269697	71469697	harbor1	chr16	71274698	71275087	LTR/ERVL-MaLR	1600	+	194	71274892	5195
chr16	71269697	71469697	harbor1	chr16	71303364	71303684	LTR/ERVL-MaLR	890	+	160	71303524	33827
chr16	71269697	71469697	harbor1	chr16	71324755	71325235	LTR/ERVL-MaLR	2363	+	240	71324995	55298
chr16	71269697	71469697	harbor1	chr16	71328341	71328787	LTR/ERVL-MaLR	775	+	223	71328564	58867
chr16	4376437	4576437	harbor1	chr16	4466932	4467232	LTR/ERVL-MaLR	955	+	150	4467082	90645
chr16	4376437	4576437	harbor1	chr16	4467534	4467620	LTR/ERVL-MaLR	955	+	43	4467577	91140
chr16	4376437	4576437	harbor1	chr16	4467919	4467979	LTR/ERVL-MaLR	955	+	30	4467949	91512
chr16	2375151	2575151	harbor1	chr16	2401402	2401624	LTR/ERVL-MaLR	1224	+	111	2401513	26362
chr16	2375151	2575151	harbor1	chr16	2416385	2416694	LTR/ERVL-MaLR	840	+	154	2416539	41388
chr16	67009944	67209944	harbor1	chr16	67071247	67071621	LTR/ERVL-MaLR	1365	+	187	67071434	61490
chr16	698263	898263	harbor1	chr16	746988	747264	LTR/ERVL-MaLR	1795	+	138	747126	48863
chr16	698263	898263	harbor1	chr16	747576	747646	LTR/ERVL-MaLR	1795	+	35	747611	49348
chr16	698263	898263	harbor1	chr16	771100	771226	LTR/ERVL-MaLR	1146	+	63	771163	72900
chr16	698263	898263	harbor1	chr16	771675	771910	LTR/ERVL-MaLR	1146	+	118	771793	73530
chr16	870922	1070922	harbor1	chr16	939864	940277	LTR/ERVL-MaLR	610	+	206	940070	69148
chr16	2198396	2398396	harbor1	chr16	2242489	2242754	LTR/ERVL-MaLR	675	+	132	2242621	44225
chr16	465446	665446	harbor1	chr16	472741	473136	LTR/ERVL-MaLR	973	+	198	472939	7493
chr16	56832283	57032283	harbor1	chr16	56928414	56928714	LTR/ERVL-MaLR	1730	+	150	56928564	96281
chr16	56832283	57032283	harbor1	chr16	56929311	56929448	LTR/ERVL-MaLR	1730	+	68	56929379	97096
chr16	870631	1070631	harbor1	chr16	939864	940277	LTR/ERVL-MaLR	610	+	206	940070	69439
chr16	56508557	56708557	harbor1	chr16	56535903	56536293	LTR/ERVL-MaLR	2166	+	195	56536098	27541
chr16	56508557	56708557	harbor1	chr16	56572567	56572720	LTR/ERVL-MaLR	1935	+	76	56572643	64086
chr16	56508557	56708557	harbor1	chr16	56573026	56573247	LTR/ERVL-MaLR	1935	+	110	56573136	64579
chr16	56508557	56708557	harbor1	chr16	56593477	56593817	LTR/ERVL-MaLR	2070	+	170	56593647	85090
chr16	56508557	56708557	harbor1	chr16	56594039	56594433	LTR/ERVL-MaLR	1124	+	197	56594236	85679
chr16	56508557	56708557	harbor1	chr16	56602226	56602402	LTR/ERVL-MaLR	885	+	88	56602314	93757
chr16	56508557	56708557	harbor1	chr16	56603598	56603969	LTR/ERVL-MaLR	1365	+	186	56603784	95227
chr16	56508557	56708557	harbor1	chr16	56604893	56605415	LTR/ERVL-MaLR	2342	+	261	56605154	96597
chr16	29086399	29286399	harbor1	chr16	29135230	29135637	LTR/ERVL-MaLR	1071	+	204	29135434	49035
chr16	29086399	29286399	harbor1	chr16	29136109	29136605	LTR/ERVL-MaLR	1546	+	248	29136357	49958
chr16	29086399	29286399	harbor1	chr16	29175501	29175939	LTR/ERVL-MaLR	1492	+	219	29175720	89321
chr16	29086399	29286399	harbor1	chr16	29181087	29181360	LTR/ERVL-MaLR	648	+	136	29181223	94824
chr16	29086399	29286399	harbor1	chr16	29146951	29147294	LTR/ERVL-MaLR	782	+	172	29147123	60724
chr16	1555539	1755539	harbor1	chr16	1579379	1579598	LTR/ERVL-MaLR	842	+	110	1579489	23950
chr16	1555539	1755539	harbor1	chr16	1580285	1580664	LTR/ERVL-MaLR	2184	+	190	1580475	24936
chr16	1555539	1755539	harbor1	chr16	1582132	1582578	LTR/ERVL-MaLR	1317	+	223	1582355	26816
chr16	1555539	1755539	harbor1	chr16	1605786	1606195	LTR/ERVL-MaLR	1311	+	204	1605990	50451
chr16	67009894	67209894	harbor1	chr16	67071247	67071621	LTR/ERVL-MaLR	1365	+	187	67071434	61540
chr16	2198343	2398343	harbor1	chr16	2242489	2242754	LTR/ERVL-MaLR	675	+	132	2242621	44278
chr16	2501522	2701522	harbor1	chr16	2535558	2535998	LTR/ERVL-MaLR	1512	+	220	2535778	34256
chr16	57884572	58084572	harbor1	chr16	57887315	57887737	LTR/ERVL-MaLR	1442	+	211	57887526	2954
chr16	57884572	58084572	harbor1	chr16	57889303	57889632	LTR/ERVL-MaLR	1051	+	164	57889467	4895
chr16	57884572	58084572	harbor1	chr16	57898830	57899081	LTR/ERVL-MaLR	1103	+	126	57898956	14384
chr16	57884572	58084572	harbor1	chr16	57905562	57905954	LTR/ERVL-MaLR	1522	+	196	57905758	21186
chr16	57884572	58084572	harbor1	chr16	57924639	57924990	LTR/ERVL-MaLR	2183	+	176	57924815	40243
chr16	57884572	58084572	harbor1	chr16	57925303	57925372	LTR/ERVL-MaLR	2183	+	34	57925337	40765
chr16	57884572	58084572	harbor1	chr16	57955517	57955978	LTR/ERVL-MaLR	1541	+	230	57955747	71175
chr16	67009938	67209938	harbor1	chr16	67071247	67071621	LTR/ERVL-MaLR	1365	+	187	67071434	61496
chr16	2687551	2887551	harbor1	chr16	2743964	2744328	LTR/ERVL-MaLR	728	+	182	2744146	56595
chr16	2198431	2398431	harbor1	chr16	2242489	2242754	LTR/ERVL-MaLR	675	+	132	2242621	44190
chr16	1	167688	harbor1	chr16	27259	27445	LTR/ERVL-MaLR	757	+	93	27352	27351
chr16	1	167688	harbor1	chr16	27750	27848	LTR/ERVL-MaLR	757	+	49	27799	27798
chr16	1	167688	harbor1	chr16	28408	28525	LTR/ERVL-MaLR	608	+	58	28466	28465
chr16	30087206	30287206	harbor1	chr16	30153988	30154415	LTR/ERVL-MaLR	2449	+	214	30154202	66996
chr16	49757292	49957292	harbor1	chr16	49771504	49771844	LTR/ERVL-MaLR	1930	+	170	49771674	14382
chr16	49757292	49957292	harbor1	chr16	49830507	49830927	LTR/ERVL-MaLR	813	+	210	49830717	73425
chr16	699137	899137	harbor1	chr16	746988	747264	LTR/ERVL-MaLR	1795	+	138	747126	47989
chr16	699137	899137	harbor1	chr16	747576	747646	LTR/ERVL-MaLR	1795	+	35	747611	48474
chr16	699137	899137	harbor1	chr16	771100	771226	LTR/ERVL-MaLR	1146	+	63	771163	72026
chr16	699137	899137	harbor1	chr16	771675	771910	LTR/ERVL-MaLR	1146	+	118	771793	72656
chr16	1	167634	harbor1	chr16	27259	27445	LTR/ERVL-MaLR	757	+	93	27352	27351
chr16	1	167634	harbor1	chr16	27750	27848	LTR/ERVL-MaLR	757	+	49	27799	27798
chr16	1	167634	harbor1	chr16	28408	28525	LTR/ERVL-MaLR	608	+	58	28466	28465
chr16	2862978	3062978	harbor1	chr16	2863834	2864231	LTR/ERVL-MaLR	2080	+	198	2864032	1054
chr16	897415	1097415	harbor1	chr16	939864	940277	LTR/ERVL-MaLR	610	+	206	940070	42655
chr16	1	167545	harbor1	chr16	27259	27445	LTR/ERVL-MaLR	757	+	93	27352	27351
chr16	1	167545	harbor1	chr16	27750	27848	LTR/ERVL-MaLR	757	+	49	27799	27798
chr16	1	167545	harbor1	chr16	28408	28525	LTR/ERVL-MaLR	608	+	58	28466	28465
chr16	47360500	47560500	harbor1	chr16	47416476	47416849	LTR/ERVL-MaLR	1749	+	186	47416662	56162
chr16	47360500	47560500	harbor1	chr16	47420487	47420883	LTR/ERVL-MaLR	1625	+	198	47420685	60185
chr16	47360500	47560500	harbor1	chr16	47445533	47445830	LTR/ERVL-MaLR	777	+	148	47445681	85181
chr16	88757215	88957215	harbor1	chr16	88843478	88843802	LTR/ERVL-MaLR	617	+	162	88843640	86425
chr16	4084167	4284167	harbor1	chr16	4099979	4100327	LTR/ERVL-MaLR	1907	+	174	4100153	15986
chr16	4084167	4284167	harbor1	chr16	4100630	4100671	LTR/ERVL-MaLR	1907	+	20	4100650	16483
chr16	4084167	4284167	harbor1	chr16	4121712	4121870	LTR/ERVL-MaLR	573	+	79	4121791	37624
chr16	4084167	4284167	harbor1	chr16	4127602	4127760	LTR/ERVL-MaLR	1430	+	79	4127681	43514
chr16	4084167	4284167	harbor1	chr16	4127787	4127809	LTR/ERVL-MaLR	1430	+	11	4127798	43631
chr16	4084167	4284167	harbor1	chr16	4127966	4128042	LTR/ERVL-MaLR	1430	+	38	4128004	43837
chr16	4084167	4284167	harbor1	chr16	4128350	4128566	LTR/ERVL-MaLR	1430	+	108	4128458	44291
chr16	4084167	4284167	harbor1	chr16	4138625	4138903	LTR/ERVL-MaLR	1364	+	139	4138764	54597
chr16	4084167	4284167	harbor1	chr16	4140295	4140713	LTR/ERVL-MaLR	2251	+	209	4140504	56337
chr16	4084167	4284167	harbor1	chr16	4155228	4155634	LTR/ERVL-MaLR	1799	+	203	4155431	71264
chr16	4084167	4284167	harbor1	chr16	4155945	4156008	LTR/ERVL-MaLR	1799	+	32	4155977	71810
chr16	4084167	4284167	harbor1	chr16	4168943	4169343	LTR/ERVL-MaLR	1647	+	200	4169143	84976
chr16	86768401	86968401	harbor1	chr16	86784309	86784769	LTR/ERVL-MaLR	2159	+	230	86784539	16138
chr16	86768401	86968401	harbor1	chr16	86837707	86838134	LTR/ERVL-MaLR	1552	+	214	86837921	69520
chr16	67009935	67209935	harbor1	chr16	67071247	67071621	LTR/ERVL-MaLR	1365	+	187	67071434	61499
chr16	700705	900705	harbor1	chr16	746988	747264	LTR/ERVL-MaLR	1795	+	138	747126	46421
chr16	700705	900705	harbor1	chr16	747576	747646	LTR/ERVL-MaLR	1795	+	35	747611	46906
chr16	700705	900705	harbor1	chr16	771100	771226	LTR/ERVL-MaLR	1146	+	63	771163	70458
chr16	700705	900705	harbor1	chr16	771675	771910	LTR/ERVL-MaLR	1146	+	118	771793	71088
chr16	75363916	75563916	harbor1	chr16	75398313	75398555	LTR/ERVL-MaLR	778	+	121	75398434	34518
chr16	75363916	75563916	harbor1	chr16	75457452	75457619	LTR/ERVL-MaLR	864	+	84	75457536	93620
chr16	75363916	75563916	harbor1	chr16	75458289	75458739	LTR/ERVL-MaLR	1708	+	225	75458514	94598
chr16	2197877	2397877	harbor1	chr16	2242489	2242754	LTR/ERVL-MaLR	675	+	132	2242621	44744
chr16	67397829	67597829	harbor1	chr16	67419704	67420186	LTR/ERVL-MaLR	2371	+	241	67419945	22116
chr16	1	167697	harbor1	chr16	27259	27445	LTR/ERVL-MaLR	757	+	93	27352	27351
chr16	1	167697	harbor1	chr16	27750	27848	LTR/ERVL-MaLR	757	+	49	27799	27798
chr16	1	167697	harbor1	chr16	28408	28525	LTR/ERVL-MaLR	608	+	58	28466	28465
chr16	49563770	49763770	harbor1	chr16	49567910	49568380	LTR/ERVL-MaLR	838	+	235	49568145	4375
chr16	49563770	49763770	harbor1	chr16	49618332	49618707	LTR/ERVL-MaLR	2088	+	188	49618520	54750
chr16	49563770	49763770	harbor1	chr16	49645664	49646042	LTR/ERVL-MaLR	2692	+	189	49645853	82083
chr16	49563770	49763770	harbor1	chr16	49647366	49647863	LTR/ERVL-MaLR	2137	+	248	49647614	83844
chr16	49563770	49763770	harbor1	chr16	49647864	49648360	LTR/ERVL-MaLR	2455	+	248	49648112	84342
chr16	49563770	49763770	harbor1	chr16	49648680	49649228	LTR/ERVL-MaLR	2455	+	274	49648954	85184
chr17	6528464	6728464	harbor1	chr17	6572647	6573009	LTR/ERVL-MaLR	1077	+	181	6572828	44364
chr17	6528464	6728464	harbor1	chr17	6585940	6586345	LTR/ERVL-MaLR	2318	+	202	6586142	57678
chr17	6528464	6728464	harbor1	chr17	6589092	6589460	LTR/ERVL-MaLR	1830	+	184	6589276	60812
chr17	6528464	6728464	harbor1	chr17	6594174	6594350	LTR/ERVL-MaLR	709	+	88	6594262	65798
chr17	79702899	79902899	harbor1	chr17	79713328	79713734	LTR/ERVL-MaLR	1331	+	203	79713531	10632
chr17	79702899	79902899	harbor1	chr17	79719594	79719859	LTR/ERVL-MaLR	645	+	132	79719726	16827
chr17	79702899	79902899	harbor1	chr17	79763879	79764148	LTR/ERVL-MaLR	1429	+	134	79764013	61114
chr17	79702899	79902899	harbor1	chr17	79764470	79764533	LTR/ERVL-MaLR	1429	+	32	79764502	61603
chr17	79702899	79902899	harbor1	chr17	79768343	79768520	LTR/ERVL-MaLR	1726	+	88	79768431	65532
chr17	79702899	79902899	harbor1	chr17	79769115	79769318	LTR/ERVL-MaLR	1726	+	102	79769217	66318
chr17	57532094	57732094	harbor1	chr17	57611515	57611977	LTR/ERVL-MaLR	883	+	231	57611746	79652
chr17	57532094	57732094	harbor1	chr17	57540465	57540888	LTR/ERVL-MaLR	1323	+	212	57540677	8583
chr17	80949175	81149175	harbor1	chr17	80978550	80978914	LTR/ERVL-MaLR	1525	+	182	80978732	29557
chr17	80949175	81149175	harbor1	chr17	80983137	80983310	LTR/ERVL-MaLR	1141	+	86	80983223	34048
chr17	80949175	81149175	harbor1	chr17	80983606	80983788	LTR/ERVL-MaLR	1141	+	91	80983697	34522
chr17	80949175	81149175	harbor1	chr17	81010175	81010517	LTR/ERVL-MaLR	2105	+	171	81010346	61171
chr17	80949175	81149175	harbor1	chr17	81010819	81010860	LTR/ERVL-MaLR	2105	+	20	81010839	61664
chr17	80949175	81149175	harbor1	chr17	81010861	81011385	LTR/ERVL-MaLR	2500	+	262	81011123	61948
chr17	80949175	81149175	harbor1	chr17	81012513	81013656	LTR/ERVL-MaLR	5382	+	572	81013085	63910
chr17	80949175	81149175	harbor1	chr17	81013672	81014065	LTR/ERVL-MaLR	2310	+	196	81013868	64693
chr17	80949175	81149175	harbor1	chr17	80969542	80969863	LTR/ERVL-MaLR	772	+	160	80969702	20527
chr17	79531584	79731584	harbor1	chr17	79551618	79551946	LTR/ERVL-MaLR	1626	+	164	79551782	20198
chr17	79531584	79731584	harbor1	chr17	79586035	79586525	LTR/ERVL-MaLR	1491	+	245	79586280	54696
chr17	79531584	79731584	harbor1	chr17	79623335	79623530	LTR/ERVL-MaLR	1697	+	98	79623433	91849
chr17	79531584	79731584	harbor1	chr17	79623843	79624173	LTR/ERVL-MaLR	1697	+	165	79624008	92424
chr17	68098090	68298090	harbor1	chr17	68190520	68190753	LTR/ERVL-MaLR	1355	+	116	68190636	92546
chr17	79690081	79890081	harbor1	chr17	79694038	79694423	LTR/ERVL-MaLR	663	+	192	79694230	4149
chr17	79690081	79890081	harbor1	chr17	79700652	79701025	LTR/ERVL-MaLR	1434	+	186	79700838	10757
chr17	79690081	79890081	harbor1	chr17	79713328	79713734	LTR/ERVL-MaLR	1331	+	203	79713531	23450
chr17	79690081	79890081	harbor1	chr17	79719594	79719859	LTR/ERVL-MaLR	645	+	132	79719726	29645
chr17	79690081	79890081	harbor1	chr17	79763879	79764148	LTR/ERVL-MaLR	1429	+	134	79764013	73932
chr17	79690081	79890081	harbor1	chr17	79764470	79764533	LTR/ERVL-MaLR	1429	+	32	79764502	74421
chr17	79690081	79890081	harbor1	chr17	79768343	79768520	LTR/ERVL-MaLR	1726	+	88	79768431	78350
chr17	79690081	79890081	harbor1	chr17	79769115	79769318	LTR/ERVL-MaLR	1726	+	102	79769217	79136
chr17	36836264	37036264	harbor1	chr17	36840629	36841015	LTR/ERVL-MaLR	760	+	193	36840822	4558
chr17	36836264	37036264	harbor1	chr17	36867643	36868153	LTR/ERVL-MaLR	2362	+	255	36867898	31634
chr17	36836264	37036264	harbor1	chr17	36872589	36872945	LTR/ERVL-MaLR	1646	+	178	36872767	36503
chr17	44148012	44348012	harbor1	chr17	44242675	44242820	LTR/ERVL-MaLR	826	+	72	44242747	94735
chr17	72946166	73146166	harbor1	chr17	72975093	72975164	LTR/ERVL-MaLR	1652	+	36	72975129	28963
chr17	72946166	73146166	harbor1	chr17	72975456	72975694	LTR/ERVL-MaLR	1652	+	119	72975575	29409
chr17	72946166	73146166	harbor1	chr17	72976953	72977467	LTR/ERVL-MaLR	1026	+	257	72977210	31044
chr17	72946166	73146166	harbor1	chr17	72978989	72979365	LTR/ERVL-MaLR	2348	+	188	72979177	33011
chr17	72946166	73146166	harbor1	chr17	72985777	72986203	LTR/ERVL-MaLR	1363	+	213	72985990	39824
chr17	72946166	73146166	harbor1	chr17	72986946	72987352	LTR/ERVL-MaLR	2169	+	203	72987149	40983
chr17	72946166	73146166	harbor1	chr17	72993859	72994014	LTR/ERVL-MaLR	1114	+	78	72993937	47771
chr17	72946166	73146166	harbor1	chr17	72996797	72997189	LTR/ERVL-MaLR	757	+	196	72996993	50827
chr17	72946166	73146166	harbor1	chr17	73000487	73000684	LTR/ERVL-MaLR	677	+	98	73000585	54419
chr17	72946166	73146166	harbor1	chr17	73020169	73020500	LTR/ERVL-MaLR	1297	+	166	73020335	74169
chr17	72946166	73146166	harbor1	chr17	73023791	73024086	LTR/ERVL-MaLR	1515	+	148	73023939	77773
chr17	72946166	73146166	harbor1	chr17	73035471	73035646	LTR/ERVL-MaLR	2139	+	88	73035559	89393
chr17	72946166	73146166	harbor1	chr17	73035891	73036215	LTR/ERVL-MaLR	2139	+	162	73036053	89887
chr17	33191705	33391705	harbor1	chr17	33204443	33205069	LTR/ERVL-MaLR	1370	+	313	33204756	13051
chr17	33191705	33391705	harbor1	chr17	33212126	33212583	LTR/ERVL-MaLR	2209	+	228	33212354	20649
chr17	33191705	33391705	harbor1	chr17	33232039	33232393	LTR/ERVL-MaLR	1469	+	177	33232216	40511
chr17	33191705	33391705	harbor1	chr17	33232516	33232536	LTR/ERVL-MaLR	1469	+	10	33232526	40821
chr17	33191705	33391705	harbor1	chr17	33236119	33236250	LTR/ERVL-MaLR	700	+	66	33236185	44480
chr17	33191705	33391705	harbor1	chr17	33236256	33236341	LTR/ERVL-MaLR	1243	+	42	33236298	44593
chr17	33191705	33391705	harbor1	chr17	33236640	33237000	LTR/ERVL-MaLR	1243	+	180	33236820	45115
chr17	7822240	8022240	harbor1	chr17	7918637	7919052	LTR/ERVL-MaLR	1049	+	208	7918845	96605
chr17	7822240	8022240	harbor1	chr17	7919967	7920026	LTR/ERVL-MaLR	1049	+	30	7919997	97757
chr17	18020696	18220696	harbor1	chr17	18083538	18083860	LTR/ERVL-MaLR	1068	+	161	18083699	63003
chr17	18020696	18220696	harbor1	chr17	18084134	18084175	LTR/ERVL-MaLR	1068	+	20	18084154	63458
chr17	3624112	3824112	harbor1	chr17	3625225	3625762	LTR/ERVL-MaLR	2134	+	268	3625493	1381
chr17	3624112	3824112	harbor1	chr17	3700622	3700914	LTR/ERVL-MaLR	1522	+	146	3700768	76656
chr17	80933433	81133433	harbor1	chr17	80978550	80978914	LTR/ERVL-MaLR	1525	+	182	80978732	45299
chr17	80933433	81133433	harbor1	chr17	80983137	80983310	LTR/ERVL-MaLR	1141	+	86	80983223	49790
chr17	80933433	81133433	harbor1	chr17	80983606	80983788	LTR/ERVL-MaLR	1141	+	91	80983697	50264
chr17	80933433	81133433	harbor1	chr17	81010175	81010517	LTR/ERVL-MaLR	2105	+	171	81010346	76913
chr17	80933433	81133433	harbor1	chr17	81010819	81010860	LTR/ERVL-MaLR	2105	+	20	81010839	77406
chr17	80933433	81133433	harbor1	chr17	81010861	81011385	LTR/ERVL-MaLR	2500	+	262	81011123	77690
chr17	80933433	81133433	harbor1	chr17	81012513	81013656	LTR/ERVL-MaLR	5382	+	572	81013085	79652
chr17	80933433	81133433	harbor1	chr17	81013672	81014065	LTR/ERVL-MaLR	2310	+	196	81013868	80435
chr17	80933433	81133433	harbor1	chr17	80969542	80969863	LTR/ERVL-MaLR	772	+	160	80969702	36269
chr17	78891091	79091091	harbor1	chr17	78922371	78922535	LTR/ERVL-MaLR	1588	+	82	78922453	31362
chr17	78891091	79091091	harbor1	chr17	78922795	78923077	LTR/ERVL-MaLR	1588	+	141	78922936	31845
chr17	78891091	79091091	harbor1	chr17	78950664	78951185	LTR/ERVL-MaLR	2151	+	260	78950924	59833
chr17	78891091	79091091	harbor1	chr17	78958356	78958528	LTR/ERVL-MaLR	745	+	86	78958442	67351
chr17	79702898	79902898	harbor1	chr17	79713328	79713734	LTR/ERVL-MaLR	1331	+	203	79713531	10633
chr17	79702898	79902898	harbor1	chr17	79719594	79719859	LTR/ERVL-MaLR	645	+	132	79719726	16828
chr17	79702898	79902898	harbor1	chr17	79763879	79764148	LTR/ERVL-MaLR	1429	+	134	79764013	61115
chr17	79702898	79902898	harbor1	chr17	79764470	79764533	LTR/ERVL-MaLR	1429	+	32	79764502	61604
chr17	79702898	79902898	harbor1	chr17	79768343	79768520	LTR/ERVL-MaLR	1726	+	88	79768431	65533
chr17	79702898	79902898	harbor1	chr17	79769115	79769318	LTR/ERVL-MaLR	1726	+	102	79769217	66319
chr17	76637237	76837237	harbor1	chr17	76674610	76675127	LTR/ERVL-MaLR	1160	+	258	76674868	37631
chr17	76637237	76837237	harbor1	chr17	76697038	76697439	LTR/ERVL-MaLR	1908	+	200	76697238	60001
chr17	76637237	76837237	harbor1	chr17	76705510	76705878	LTR/ERVL-MaLR	1710	+	184	76705694	68457
chr17	80932396	81132396	harbor1	chr17	80978550	80978914	LTR/ERVL-MaLR	1525	+	182	80978732	46336
chr17	80932396	81132396	harbor1	chr17	80983137	80983310	LTR/ERVL-MaLR	1141	+	86	80983223	50827
chr17	80932396	81132396	harbor1	chr17	80983606	80983788	LTR/ERVL-MaLR	1141	+	91	80983697	51301
chr17	80932396	81132396	harbor1	chr17	81010175	81010517	LTR/ERVL-MaLR	2105	+	171	81010346	77950
chr17	80932396	81132396	harbor1	chr17	81010819	81010860	LTR/ERVL-MaLR	2105	+	20	81010839	78443
chr17	80932396	81132396	harbor1	chr17	81010861	81011385	LTR/ERVL-MaLR	2500	+	262	81011123	78727
chr17	80932396	81132396	harbor1	chr17	81012513	81013656	LTR/ERVL-MaLR	5382	+	572	81013085	80689
chr17	80932396	81132396	harbor1	chr17	81013672	81014065	LTR/ERVL-MaLR	2310	+	196	81013868	81472
chr17	80932396	81132396	harbor1	chr17	80969542	80969863	LTR/ERVL-MaLR	772	+	160	80969702	37306
chr17	79041540	79241540	harbor1	chr17	79054661	79055039	LTR/ERVL-MaLR	2227	+	189	79054850	13310
chr17	80932315	81132315	harbor1	chr17	80978550	80978914	LTR/ERVL-MaLR	1525	+	182	80978732	46417
chr17	80932315	81132315	harbor1	chr17	80983137	80983310	LTR/ERVL-MaLR	1141	+	86	80983223	50908
chr17	80932315	81132315	harbor1	chr17	80983606	80983788	LTR/ERVL-MaLR	1141	+	91	80983697	51382
chr17	80932315	81132315	harbor1	chr17	81010175	81010517	LTR/ERVL-MaLR	2105	+	171	81010346	78031
chr17	80932315	81132315	harbor1	chr17	81010819	81010860	LTR/ERVL-MaLR	2105	+	20	81010839	78524
chr17	80932315	81132315	harbor1	chr17	81010861	81011385	LTR/ERVL-MaLR	2500	+	262	81011123	78808
chr17	80932315	81132315	harbor1	chr17	81012513	81013656	LTR/ERVL-MaLR	5382	+	572	81013085	80770
chr17	80932315	81132315	harbor1	chr17	81013672	81014065	LTR/ERVL-MaLR	2310	+	196	81013868	81553
chr17	80932315	81132315	harbor1	chr17	80969542	80969863	LTR/ERVL-MaLR	772	+	160	80969702	37387
chr17	79702913	79902913	harbor1	chr17	79713328	79713734	LTR/ERVL-MaLR	1331	+	203	79713531	10618
chr17	79702913	79902913	harbor1	chr17	79719594	79719859	LTR/ERVL-MaLR	645	+	132	79719726	16813
chr17	79702913	79902913	harbor1	chr17	79763879	79764148	LTR/ERVL-MaLR	1429	+	134	79764013	61100
chr17	79702913	79902913	harbor1	chr17	79764470	79764533	LTR/ERVL-MaLR	1429	+	32	79764502	61589
chr17	79702913	79902913	harbor1	chr17	79768343	79768520	LTR/ERVL-MaLR	1726	+	88	79768431	65518
chr17	79702913	79902913	harbor1	chr17	79769115	79769318	LTR/ERVL-MaLR	1726	+	102	79769217	66304
chr17	80992823	81192823	harbor1	chr17	81010175	81010517	LTR/ERVL-MaLR	2105	+	171	81010346	17523
chr17	80992823	81192823	harbor1	chr17	81010819	81010860	LTR/ERVL-MaLR	2105	+	20	81010839	18016
chr17	80992823	81192823	harbor1	chr17	81010861	81011385	LTR/ERVL-MaLR	2500	+	262	81011123	18300
chr17	80992823	81192823	harbor1	chr17	81012513	81013656	LTR/ERVL-MaLR	5382	+	572	81013085	20262
chr17	80992823	81192823	harbor1	chr17	81013672	81014065	LTR/ERVL-MaLR	2310	+	196	81013868	21045
chr17	80931238	81131238	harbor1	chr17	80978550	80978914	LTR/ERVL-MaLR	1525	+	182	80978732	47494
chr17	80931238	81131238	harbor1	chr17	80983137	80983310	LTR/ERVL-MaLR	1141	+	86	80983223	51985
chr17	80931238	81131238	harbor1	chr17	80983606	80983788	LTR/ERVL-MaLR	1141	+	91	80983697	52459
chr17	80931238	81131238	harbor1	chr17	81010175	81010517	LTR/ERVL-MaLR	2105	+	171	81010346	79108
chr17	80931238	81131238	harbor1	chr17	81010819	81010860	LTR/ERVL-MaLR	2105	+	20	81010839	79601
chr17	80931238	81131238	harbor1	chr17	81010861	81011385	LTR/ERVL-MaLR	2500	+	262	81011123	79885
chr17	80931238	81131238	harbor1	chr17	81012513	81013656	LTR/ERVL-MaLR	5382	+	572	81013085	81847
chr17	80931238	81131238	harbor1	chr17	81013672	81014065	LTR/ERVL-MaLR	2310	+	196	81013868	82630
chr17	80931238	81131238	harbor1	chr17	80969542	80969863	LTR/ERVL-MaLR	772	+	160	80969702	38464
chr17	76637265	76837265	harbor1	chr17	76674610	76675127	LTR/ERVL-MaLR	1160	+	258	76674868	37603
chr17	76637265	76837265	harbor1	chr17	76697038	76697439	LTR/ERVL-MaLR	1908	+	200	76697238	59973
chr17	76637265	76837265	harbor1	chr17	76705510	76705878	LTR/ERVL-MaLR	1710	+	184	76705694	68429
chr17	80934936	81134936	harbor1	chr17	80978550	80978914	LTR/ERVL-MaLR	1525	+	182	80978732	43796
chr17	80934936	81134936	harbor1	chr17	80983137	80983310	LTR/ERVL-MaLR	1141	+	86	80983223	48287
chr17	80934936	81134936	harbor1	chr17	80983606	80983788	LTR/ERVL-MaLR	1141	+	91	80983697	48761
chr17	80934936	81134936	harbor1	chr17	81010175	81010517	LTR/ERVL-MaLR	2105	+	171	81010346	75410
chr17	80934936	81134936	harbor1	chr17	81010819	81010860	LTR/ERVL-MaLR	2105	+	20	81010839	75903
chr17	80934936	81134936	harbor1	chr17	81010861	81011385	LTR/ERVL-MaLR	2500	+	262	81011123	76187
chr17	80934936	81134936	harbor1	chr17	81012513	81013656	LTR/ERVL-MaLR	5382	+	572	81013085	78149
chr17	80934936	81134936	harbor1	chr17	81013672	81014065	LTR/ERVL-MaLR	2310	+	196	81013868	78932
chr17	80934936	81134936	harbor1	chr17	80969542	80969863	LTR/ERVL-MaLR	772	+	160	80969702	34766
chr17	76768591	76968591	harbor1	chr17	76792590	76792777	LTR/ERVL-MaLR	1982	+	94	76792684	24093
chr17	76768591	76968591	harbor1	chr17	76793846	76794170	LTR/ERVL-MaLR	1982	+	162	76794008	25417
chr17	76768591	76968591	harbor1	chr17	76812972	76813169	LTR/ERVL-MaLR	891	+	98	76813070	44479
chr17	76768591	76968591	harbor1	chr17	76818747	76818992	LTR/ERVL-MaLR	1654	+	122	76818869	50278
chr17	76768591	76968591	harbor1	chr17	76819298	76819522	LTR/ERVL-MaLR	1654	+	112	76819410	50819
chr17	76768591	76968591	harbor1	chr17	76833798	76834168	LTR/ERVL-MaLR	1627	+	185	76833983	65392
chr17	76768591	76968591	harbor1	chr17	76837586	76837729	LTR/ERVL-MaLR	707	+	72	76837658	69067
chr17	76768591	76968591	harbor1	chr17	76838037	76838088	LTR/ERVL-MaLR	707	+	26	76838063	69472
chr17	76768591	76968591	harbor1	chr17	76842350	76842455	LTR/ERVL-MaLR	1004	+	52	76842402	73811
chr17	76768591	76968591	harbor1	chr17	76843042	76843215	LTR/ERVL-MaLR	1004	+	86	76843128	74537
chr17	76768591	76968591	harbor1	chr17	76843821	76843871	LTR/ERVL-MaLR	1004	+	25	76843846	75255
chr17	76768591	76968591	harbor1	chr17	76849990	76850347	LTR/ERVL-MaLR	993	+	178	76850168	81577
chr17	76768591	76968591	harbor1	chr17	76863367	76863714	LTR/ERVL-MaLR	1106	+	174	76863541	94950
chr17	76637258	76837258	harbor1	chr17	76674610	76675127	LTR/ERVL-MaLR	1160	+	258	76674868	37610
chr17	76637258	76837258	harbor1	chr17	76697038	76697439	LTR/ERVL-MaLR	1908	+	200	76697238	59980
chr17	76637258	76837258	harbor1	chr17	76705510	76705878	LTR/ERVL-MaLR	1710	+	184	76705694	68436
chr17	80934866	81134866	harbor1	chr17	80978550	80978914	LTR/ERVL-MaLR	1525	+	182	80978732	43866
chr17	80934866	81134866	harbor1	chr17	80983137	80983310	LTR/ERVL-MaLR	1141	+	86	80983223	48357
chr17	80934866	81134866	harbor1	chr17	80983606	80983788	LTR/ERVL-MaLR	1141	+	91	80983697	48831
chr17	80934866	81134866	harbor1	chr17	81010175	81010517	LTR/ERVL-MaLR	2105	+	171	81010346	75480
chr17	80934866	81134866	harbor1	chr17	81010819	81010860	LTR/ERVL-MaLR	2105	+	20	81010839	75973
chr17	80934866	81134866	harbor1	chr17	81010861	81011385	LTR/ERVL-MaLR	2500	+	262	81011123	76257
chr17	80934866	81134866	harbor1	chr17	81012513	81013656	LTR/ERVL-MaLR	5382	+	572	81013085	78219
chr17	80934866	81134866	harbor1	chr17	81013672	81014065	LTR/ERVL-MaLR	2310	+	196	81013868	79002
chr17	80934866	81134866	harbor1	chr17	80969542	80969863	LTR/ERVL-MaLR	772	+	160	80969702	34836
chr17	27477770	27677770	harbor1	chr17	27501391	27501623	LTR/ERVL-MaLR	1451	+	116	27501507	23737
chr17	27477770	27677770	harbor1	chr17	27503583	27503967	LTR/ERVL-MaLR	1382	+	192	27503775	26005
chr17	80932802	81132802	harbor1	chr17	80978550	80978914	LTR/ERVL-MaLR	1525	+	182	80978732	45930
chr17	80932802	81132802	harbor1	chr17	80983137	80983310	LTR/ERVL-MaLR	1141	+	86	80983223	50421
chr17	80932802	81132802	harbor1	chr17	80983606	80983788	LTR/ERVL-MaLR	1141	+	91	80983697	50895
chr17	80932802	81132802	harbor1	chr17	81010175	81010517	LTR/ERVL-MaLR	2105	+	171	81010346	77544
chr17	80932802	81132802	harbor1	chr17	81010819	81010860	LTR/ERVL-MaLR	2105	+	20	81010839	78037
chr17	80932802	81132802	harbor1	chr17	81010861	81011385	LTR/ERVL-MaLR	2500	+	262	81011123	78321
chr17	80932802	81132802	harbor1	chr17	81012513	81013656	LTR/ERVL-MaLR	5382	+	572	81013085	80283
chr17	80932802	81132802	harbor1	chr17	81013672	81014065	LTR/ERVL-MaLR	2310	+	196	81013868	81066
chr17	80932802	81132802	harbor1	chr17	80969542	80969863	LTR/ERVL-MaLR	772	+	160	80969702	36900
chr17	78251834	78451834	harbor1	chr17	78296845	78297179	LTR/ERVL-MaLR	1909	+	167	78297012	45178
chr17	78251834	78451834	harbor1	chr17	78297478	78297509	LTR/ERVL-MaLR	1909	+	16	78297494	45660
chr17	78251834	78451834	harbor1	chr17	78305788	78306269	LTR/ERVL-MaLR	2067	+	240	78306028	54194
chr17	78251834	78451834	harbor1	chr17	78309530	78309750	LTR/ERVL-MaLR	1139	+	110	78309640	57806
chr17	78251834	78451834	harbor1	chr17	78311877	78312011	LTR/ERVL-MaLR	2005	+	67	78311944	60110
chr17	78251834	78451834	harbor1	chr17	78312326	78312606	LTR/ERVL-MaLR	2005	+	140	78312466	60632
chr17	78251834	78451834	harbor1	chr17	78345106	78345577	LTR/ERVL-MaLR	1496	+	236	78345342	93508
chr17	49396359	49596359	harbor1	chr17	49449036	49449422	LTR/ERVL-MaLR	755	+	193	49449229	52870
chr17	49396359	49596359	harbor1	chr17	49449735	49449797	LTR/ERVL-MaLR	678	+	31	49449766	53407
chr17	49396359	49596359	harbor1	chr17	49474409	49474909	LTR/ERVL-MaLR	2527	+	250	49474659	78300
chr17	15158736	15358736	harbor1	chr17	15186256	15186615	LTR/ERVL-MaLR	732	+	180	15186436	27700
chr17	15158736	15358736	harbor1	chr17	15186703	15187095	LTR/ERVL-MaLR	1815	+	196	15186899	28163
chr17	15158736	15358736	harbor1	chr17	15197299	15197435	LTR/ERVL-MaLR	601	+	68	15197367	38631
chr17	15158736	15358736	harbor1	chr17	15255355	15255658	LTR/ERVL-MaLR	852	+	152	15255507	96771
chr17	7335900	7535900	harbor1	chr17	7363659	7364091	LTR/ERVL-MaLR	971	+	216	7363875	27975
chr17	7335900	7535900	harbor1	chr17	7364400	7364429	LTR/ERVL-MaLR	971	+	14	7364414	28514
chr17	80934111	81134111	harbor1	chr17	80978550	80978914	LTR/ERVL-MaLR	1525	+	182	80978732	44621
chr17	80934111	81134111	harbor1	chr17	80983137	80983310	LTR/ERVL-MaLR	1141	+	86	80983223	49112
chr17	80934111	81134111	harbor1	chr17	80983606	80983788	LTR/ERVL-MaLR	1141	+	91	80983697	49586
chr17	80934111	81134111	harbor1	chr17	81010175	81010517	LTR/ERVL-MaLR	2105	+	171	81010346	76235
chr17	80934111	81134111	harbor1	chr17	81010819	81010860	LTR/ERVL-MaLR	2105	+	20	81010839	76728
chr17	80934111	81134111	harbor1	chr17	81010861	81011385	LTR/ERVL-MaLR	2500	+	262	81011123	77012
chr17	80934111	81134111	harbor1	chr17	81012513	81013656	LTR/ERVL-MaLR	5382	+	572	81013085	78974
chr17	80934111	81134111	harbor1	chr17	81013672	81014065	LTR/ERVL-MaLR	2310	+	196	81013868	79757
chr17	80934111	81134111	harbor1	chr17	80969542	80969863	LTR/ERVL-MaLR	772	+	160	80969702	35591
chr17	79084610	79284610	harbor1	chr17	79157962	79158291	LTR/ERVL-MaLR	1769	+	164	79158126	73516
chr17	79702928	79902928	harbor1	chr17	79713328	79713734	LTR/ERVL-MaLR	1331	+	203	79713531	10603
chr17	79702928	79902928	harbor1	chr17	79719594	79719859	LTR/ERVL-MaLR	645	+	132	79719726	16798
chr17	79702928	79902928	harbor1	chr17	79763879	79764148	LTR/ERVL-MaLR	1429	+	134	79764013	61085
chr17	79702928	79902928	harbor1	chr17	79764470	79764533	LTR/ERVL-MaLR	1429	+	32	79764502	61574
chr17	79702928	79902928	harbor1	chr17	79768343	79768520	LTR/ERVL-MaLR	1726	+	88	79768431	65503
chr17	79702928	79902928	harbor1	chr17	79769115	79769318	LTR/ERVL-MaLR	1726	+	102	79769217	66289
chr17	80934868	81134868	harbor1	chr17	80978550	80978914	LTR/ERVL-MaLR	1525	+	182	80978732	43864
chr17	80934868	81134868	harbor1	chr17	80983137	80983310	LTR/ERVL-MaLR	1141	+	86	80983223	48355
chr17	80934868	81134868	harbor1	chr17	80983606	80983788	LTR/ERVL-MaLR	1141	+	91	80983697	48829
chr17	80934868	81134868	harbor1	chr17	81010175	81010517	LTR/ERVL-MaLR	2105	+	171	81010346	75478
chr17	80934868	81134868	harbor1	chr17	81010819	81010860	LTR/ERVL-MaLR	2105	+	20	81010839	75971
chr17	80934868	81134868	harbor1	chr17	81010861	81011385	LTR/ERVL-MaLR	2500	+	262	81011123	76255
chr17	80934868	81134868	harbor1	chr17	81012513	81013656	LTR/ERVL-MaLR	5382	+	572	81013085	78217
chr17	80934868	81134868	harbor1	chr17	81013672	81014065	LTR/ERVL-MaLR	2310	+	196	81013868	79000
chr17	80934868	81134868	harbor1	chr17	80969542	80969863	LTR/ERVL-MaLR	772	+	160	80969702	34834
chr17	77288251	77488251	harbor1	chr17	77295899	77296287	LTR/ERVL-MaLR	1360	+	194	77296093	7842
chr17	77288251	77488251	harbor1	chr17	77310943	77311377	LTR/ERVL-MaLR	1317	+	217	77311160	22909
chr17	77288251	77488251	harbor1	chr17	77346758	77347070	LTR/ERVL-MaLR	1436	+	156	77346914	58663
chr17	33191625	33391625	harbor1	chr17	33204443	33205069	LTR/ERVL-MaLR	1370	+	313	33204756	13131
chr17	33191625	33391625	harbor1	chr17	33212126	33212583	LTR/ERVL-MaLR	2209	+	228	33212354	20729
chr17	33191625	33391625	harbor1	chr17	33232039	33232393	LTR/ERVL-MaLR	1469	+	177	33232216	40591
chr17	33191625	33391625	harbor1	chr17	33232516	33232536	LTR/ERVL-MaLR	1469	+	10	33232526	40901
chr17	33191625	33391625	harbor1	chr17	33236119	33236250	LTR/ERVL-MaLR	700	+	66	33236185	44560
chr17	33191625	33391625	harbor1	chr17	33236256	33236341	LTR/ERVL-MaLR	1243	+	42	33236298	44673
chr17	33191625	33391625	harbor1	chr17	33236640	33237000	LTR/ERVL-MaLR	1243	+	180	33236820	45195
chr17	76637275	76837275	harbor1	chr17	76674610	76675127	LTR/ERVL-MaLR	1160	+	258	76674868	37593
chr17	76637275	76837275	harbor1	chr17	76697038	76697439	LTR/ERVL-MaLR	1908	+	200	76697238	59963
chr17	76637275	76837275	harbor1	chr17	76705510	76705878	LTR/ERVL-MaLR	1710	+	184	76705694	68419
chr17	79702893	79902893	harbor1	chr17	79713328	79713734	LTR/ERVL-MaLR	1331	+	203	79713531	10638
chr17	79702893	79902893	harbor1	chr17	79719594	79719859	LTR/ERVL-MaLR	645	+	132	79719726	16833
chr17	79702893	79902893	harbor1	chr17	79763879	79764148	LTR/ERVL-MaLR	1429	+	134	79764013	61120
chr17	79702893	79902893	harbor1	chr17	79764470	79764533	LTR/ERVL-MaLR	1429	+	32	79764502	61609
chr17	79702893	79902893	harbor1	chr17	79768343	79768520	LTR/ERVL-MaLR	1726	+	88	79768431	65538
chr17	79702893	79902893	harbor1	chr17	79769115	79769318	LTR/ERVL-MaLR	1726	+	102	79769217	66324
chr17	38628428	38828428	harbor1	chr17	38628434	38628716	LTR/ERVL-MaLR	789	+	141	38628575	147
chr17	38628428	38828428	harbor1	chr17	38670296	38670686	LTR/ERVL-MaLR	1018	+	195	38670491	42063
chr17	38628428	38828428	harbor1	chr17	38670984	38671049	LTR/ERVL-MaLR	1018	+	32	38671016	42588
chr17	49765460	49965460	harbor1	chr17	49833561	49833865	LTR/ERVL-MaLR	735	+	152	49833713	68253
chr17	28855314	29055314	harbor1	chr17	28927556	28927828	LTR/ERVL-MaLR	1179	+	136	28927692	72378
chr17	28855314	29055314	harbor1	chr17	28928125	28928367	LTR/ERVL-MaLR	1179	+	121	28928246	72932
chr17	59793066	59993066	harbor1	chr17	59867831	59867980	LTR/ERVL-MaLR	760	+	74	59867905	74839
chr17	59793066	59993066	harbor1	chr17	59868305	59868339	LTR/ERVL-MaLR	760	+	17	59868322	75256
chr17	64955047	65155047	harbor1	chr17	64983711	64984067	LTR/ERVL-MaLR	1903	+	178	64983889	28842
chr17	64955047	65155047	harbor1	chr17	64991015	64991213	LTR/ERVL-MaLR	726	+	99	64991114	36067
chr17	64955047	65155047	harbor1	chr17	64995938	64996080	LTR/ERVL-MaLR	640	+	71	64996009	40962
chr17	64955047	65155047	harbor1	chr17	64996226	64996520	LTR/ERVL-MaLR	881	+	147	64996373	41326
chr17	76636920	76836920	harbor1	chr17	76674610	76675127	LTR/ERVL-MaLR	1160	+	258	76674868	37948
chr17	76636920	76836920	harbor1	chr17	76697038	76697439	LTR/ERVL-MaLR	1908	+	200	76697238	60318
chr17	76636920	76836920	harbor1	chr17	76705510	76705878	LTR/ERVL-MaLR	1710	+	184	76705694	68774
chr17	74965179	75165179	harbor1	chr17	74984416	74984895	LTR/ERVL-MaLR	2180	+	240	74984656	19477
chr17	7336816	7536816	harbor1	chr17	7363659	7364091	LTR/ERVL-MaLR	971	+	216	7363875	27059
chr17	7336816	7536816	harbor1	chr17	7364400	7364429	LTR/ERVL-MaLR	971	+	14	7364414	27598
chr17	76637277	76837277	harbor1	chr17	76674610	76675127	LTR/ERVL-MaLR	1160	+	258	76674868	37591
chr17	76637277	76837277	harbor1	chr17	76697038	76697439	LTR/ERVL-MaLR	1908	+	200	76697238	59961
chr17	76637277	76837277	harbor1	chr17	76705510	76705878	LTR/ERVL-MaLR	1710	+	184	76705694	68417
chr17	33191684	33391684	harbor1	chr17	33204443	33205069	LTR/ERVL-MaLR	1370	+	313	33204756	13072
chr17	33191684	33391684	harbor1	chr17	33212126	33212583	LTR/ERVL-MaLR	2209	+	228	33212354	20670
chr17	33191684	33391684	harbor1	chr17	33232039	33232393	LTR/ERVL-MaLR	1469	+	177	33232216	40532
chr17	33191684	33391684	harbor1	chr17	33232516	33232536	LTR/ERVL-MaLR	1469	+	10	33232526	40842
chr17	33191684	33391684	harbor1	chr17	33236119	33236250	LTR/ERVL-MaLR	700	+	66	33236185	44501
chr17	33191684	33391684	harbor1	chr17	33236256	33236341	LTR/ERVL-MaLR	1243	+	42	33236298	44614
chr17	33191684	33391684	harbor1	chr17	33236640	33237000	LTR/ERVL-MaLR	1243	+	180	33236820	45136
chr17	76298820	76498820	harbor1	chr17	76302393	76302821	LTR/ERVL-MaLR	1391	+	214	76302607	3787
chr17	76298820	76498820	harbor1	chr17	76357629	76357984	LTR/ERVL-MaLR	1677	+	178	76357807	58987
chr17	76298820	76498820	harbor1	chr17	76369681	76370120	LTR/ERVL-MaLR	793	+	220	76369901	71081
chr17	76298820	76498820	harbor1	chr17	76377507	76377840	LTR/ERVL-MaLR	1517	+	166	76377673	78853
chr17	76298820	76498820	harbor1	chr17	76379384	76379591	LTR/ERVL-MaLR	902	+	104	76379488	80668
chr17	78923444	79123444	harbor1	chr17	78950664	78951185	LTR/ERVL-MaLR	2151	+	260	78950924	27480
chr17	78923444	79123444	harbor1	chr17	78958356	78958528	LTR/ERVL-MaLR	745	+	86	78958442	34998
chr17	28306337	28506337	harbor1	chr17	28402783	28403274	LTR/ERVL-MaLR	1292	+	246	28403029	96692
chr17	9856240	10056240	harbor1	chr17	9895051	9895604	LTR/ERVL-MaLR	1643	+	276	9895327	39087
chr17	9856240	10056240	harbor1	chr17	9938058	9938224	LTR/ERVL-MaLR	1665	+	83	9938141	81901
chr17	9856240	10056240	harbor1	chr17	9938494	9938731	LTR/ERVL-MaLR	1665	+	118	9938612	82372
chr17	58057205	58257205	harbor1	chr17	58108266	58108507	LTR/ERVL-MaLR	1128	+	120	58108386	51181
chr17	58057205	58257205	harbor1	chr17	58108658	58108764	LTR/ERVL-MaLR	1228	+	53	58108711	51506
chr17	58057205	58257205	harbor1	chr17	58109378	58109544	LTR/ERVL-MaLR	1228	+	83	58109461	52256
chr17	58057205	58257205	harbor1	chr17	58137605	58137940	LTR/ERVL-MaLR	1498	+	168	58137773	80568
chr17	74979148	75179148	harbor1	chr17	74984416	74984895	LTR/ERVL-MaLR	2180	+	240	74984656	5508
chr17	79282552	79482552	harbor1	chr17	79299657	79299831	LTR/ERVL-MaLR	776	+	87	79299744	17192
chr17	79282552	79482552	harbor1	chr17	79308577	79308836	LTR/ERVL-MaLR	1039	+	130	79308707	26155
chr17	79282552	79482552	harbor1	chr17	79309121	79309189	LTR/ERVL-MaLR	1039	+	34	79309155	26603
chr17	79282552	79482552	harbor1	chr17	79309622	79309959	LTR/ERVL-MaLR	1588	+	168	79309790	27238
chr17	79282552	79482552	harbor1	chr17	79352123	79352509	LTR/ERVL-MaLR	2339	+	193	79352316	69764
chr17	79689674	79889674	harbor1	chr17	79694038	79694423	LTR/ERVL-MaLR	663	+	192	79694230	4556
chr17	79689674	79889674	harbor1	chr17	79700652	79701025	LTR/ERVL-MaLR	1434	+	186	79700838	11164
chr17	79689674	79889674	harbor1	chr17	79713328	79713734	LTR/ERVL-MaLR	1331	+	203	79713531	23857
chr17	79689674	79889674	harbor1	chr17	79719594	79719859	LTR/ERVL-MaLR	645	+	132	79719726	30052
chr17	79689674	79889674	harbor1	chr17	79763879	79764148	LTR/ERVL-MaLR	1429	+	134	79764013	74339
chr17	79689674	79889674	harbor1	chr17	79764470	79764533	LTR/ERVL-MaLR	1429	+	32	79764502	74828
chr17	79689674	79889674	harbor1	chr17	79768343	79768520	LTR/ERVL-MaLR	1726	+	88	79768431	78757
chr17	79689674	79889674	harbor1	chr17	79769115	79769318	LTR/ERVL-MaLR	1726	+	102	79769217	79543
chr17	76637325	76837325	harbor1	chr17	76674610	76675127	LTR/ERVL-MaLR	1160	+	258	76674868	37543
chr17	76637325	76837325	harbor1	chr17	76697038	76697439	LTR/ERVL-MaLR	1908	+	200	76697238	59913
chr17	76637325	76837325	harbor1	chr17	76705510	76705878	LTR/ERVL-MaLR	1710	+	184	76705694	68369
chr17	79701303	79901303	harbor1	chr17	79713328	79713734	LTR/ERVL-MaLR	1331	+	203	79713531	12228
chr17	79701303	79901303	harbor1	chr17	79719594	79719859	LTR/ERVL-MaLR	645	+	132	79719726	18423
chr17	79701303	79901303	harbor1	chr17	79763879	79764148	LTR/ERVL-MaLR	1429	+	134	79764013	62710
chr17	79701303	79901303	harbor1	chr17	79764470	79764533	LTR/ERVL-MaLR	1429	+	32	79764502	63199
chr17	79701303	79901303	harbor1	chr17	79768343	79768520	LTR/ERVL-MaLR	1726	+	88	79768431	67128
chr17	79701303	79901303	harbor1	chr17	79769115	79769318	LTR/ERVL-MaLR	1726	+	102	79769217	67914
chr17	79702912	79902912	harbor1	chr17	79713328	79713734	LTR/ERVL-MaLR	1331	+	203	79713531	10619
chr17	79702912	79902912	harbor1	chr17	79719594	79719859	LTR/ERVL-MaLR	645	+	132	79719726	16814
chr17	79702912	79902912	harbor1	chr17	79763879	79764148	LTR/ERVL-MaLR	1429	+	134	79764013	61101
chr17	79702912	79902912	harbor1	chr17	79764470	79764533	LTR/ERVL-MaLR	1429	+	32	79764502	61590
chr17	79702912	79902912	harbor1	chr17	79768343	79768520	LTR/ERVL-MaLR	1726	+	88	79768431	65519
chr17	79702912	79902912	harbor1	chr17	79769115	79769318	LTR/ERVL-MaLR	1726	+	102	79769217	66305
chr17	76637321	76837321	harbor1	chr17	76674610	76675127	LTR/ERVL-MaLR	1160	+	258	76674868	37547
chr17	76637321	76837321	harbor1	chr17	76697038	76697439	LTR/ERVL-MaLR	1908	+	200	76697238	59917
chr17	76637321	76837321	harbor1	chr17	76705510	76705878	LTR/ERVL-MaLR	1710	+	184	76705694	68373
chr17	32776002	32976002	harbor1	chr17	32789536	32789967	LTR/ERVL-MaLR	1174	+	216	32789752	13750
chr17	32776002	32976002	harbor1	chr17	32805016	32805311	LTR/ERVL-MaLR	1516	+	148	32805164	29162
chr17	32776002	32976002	harbor1	chr17	32808545	32808919	LTR/ERVL-MaLR	1535	+	187	32808732	32730
chr17	32776002	32976002	harbor1	chr17	32811874	32812090	LTR/ERVL-MaLR	698	+	108	32811982	35980
chr17	32776002	32976002	harbor1	chr17	32859806	32860058	LTR/ERVL-MaLR	755	+	126	32859932	83930
chr17	82980527	83180527	harbor1	chr17	82982496	82982718	LTR/ERVL-MaLR	953	+	111	82982607	2080
chr17	82980527	83180527	harbor1	chr17	82983778	82984004	LTR/ERVL-MaLR	635	+	113	82983891	3364
chr17	82980527	83180527	harbor1	chr17	82984548	82984753	LTR/ERVL-MaLR	656	+	102	82984650	4123
chr17	82980527	83180527	harbor1	chr17	82990724	82991054	LTR/ERVL-MaLR	1295	+	165	82990889	10362
chr17	82980527	83180527	harbor1	chr17	82991238	82991519	LTR/ERVL-MaLR	1598	+	140	82991378	10851
chr17	82980527	83180527	harbor1	chr17	83034576	83034913	LTR/ERVL-MaLR	1930	+	168	83034744	54217
chr17	82980527	83180527	harbor1	chr17	83054605	83054956	LTR/ERVL-MaLR	1703	+	176	83054781	74254
chr17	82980527	83180527	harbor1	chr17	83060465	83060830	LTR/ERVL-MaLR	2175	+	182	83060647	80120
chr17	82980527	83180527	harbor1	chr17	83061166	83061215	LTR/ERVL-MaLR	2175	+	24	83061190	80663
chr17	28628787	28828787	harbor1	chr17	28631057	28631432	LTR/ERVL-MaLR	1582	+	188	28631245	2458
chr17	28628787	28828787	harbor1	chr17	28632421	28632776	LTR/ERVL-MaLR	1938	+	178	28632599	3812
chr17	76637272	76837272	harbor1	chr17	76674610	76675127	LTR/ERVL-MaLR	1160	+	258	76674868	37596
chr17	76637272	76837272	harbor1	chr17	76697038	76697439	LTR/ERVL-MaLR	1908	+	200	76697238	59966
chr17	76637272	76837272	harbor1	chr17	76705510	76705878	LTR/ERVL-MaLR	1710	+	184	76705694	68422
chr17	80934861	81134861	harbor1	chr17	80978550	80978914	LTR/ERVL-MaLR	1525	+	182	80978732	43871
chr17	80934861	81134861	harbor1	chr17	80983137	80983310	LTR/ERVL-MaLR	1141	+	86	80983223	48362
chr17	80934861	81134861	harbor1	chr17	80983606	80983788	LTR/ERVL-MaLR	1141	+	91	80983697	48836
chr17	80934861	81134861	harbor1	chr17	81010175	81010517	LTR/ERVL-MaLR	2105	+	171	81010346	75485
chr17	80934861	81134861	harbor1	chr17	81010819	81010860	LTR/ERVL-MaLR	2105	+	20	81010839	75978
chr17	80934861	81134861	harbor1	chr17	81010861	81011385	LTR/ERVL-MaLR	2500	+	262	81011123	76262
chr17	80934861	81134861	harbor1	chr17	81012513	81013656	LTR/ERVL-MaLR	5382	+	572	81013085	78224
chr17	80934861	81134861	harbor1	chr17	81013672	81014065	LTR/ERVL-MaLR	2310	+	196	81013868	79007
chr17	80934861	81134861	harbor1	chr17	80969542	80969863	LTR/ERVL-MaLR	772	+	160	80969702	34841
chr17	80928150	81128150	harbor1	chr17	80978550	80978914	LTR/ERVL-MaLR	1525	+	182	80978732	50582
chr17	80928150	81128150	harbor1	chr17	80983137	80983310	LTR/ERVL-MaLR	1141	+	86	80983223	55073
chr17	80928150	81128150	harbor1	chr17	80983606	80983788	LTR/ERVL-MaLR	1141	+	91	80983697	55547
chr17	80928150	81128150	harbor1	chr17	81010175	81010517	LTR/ERVL-MaLR	2105	+	171	81010346	82196
chr17	80928150	81128150	harbor1	chr17	81010819	81010860	LTR/ERVL-MaLR	2105	+	20	81010839	82689
chr17	80928150	81128150	harbor1	chr17	81010861	81011385	LTR/ERVL-MaLR	2500	+	262	81011123	82973
chr17	80928150	81128150	harbor1	chr17	81012513	81013656	LTR/ERVL-MaLR	5382	+	572	81013085	84935
chr17	80928150	81128150	harbor1	chr17	81013672	81014065	LTR/ERVL-MaLR	2310	+	196	81013868	85718
chr17	80928150	81128150	harbor1	chr17	80969542	80969863	LTR/ERVL-MaLR	772	+	160	80969702	41552
chr17	38619970	38819970	harbor1	chr17	38628434	38628716	LTR/ERVL-MaLR	789	+	141	38628575	8605
chr17	38619970	38819970	harbor1	chr17	38670296	38670686	LTR/ERVL-MaLR	1018	+	195	38670491	50521
chr17	38619970	38819970	harbor1	chr17	38670984	38671049	LTR/ERVL-MaLR	1018	+	32	38671016	51046
chr17	81133715	81333715	harbor1	chr17	81140420	81140644	LTR/ERVL-MaLR	645	+	112	81140532	6817
chr17	80992764	81192764	harbor1	chr17	81010175	81010517	LTR/ERVL-MaLR	2105	+	171	81010346	17582
chr17	80992764	81192764	harbor1	chr17	81010819	81010860	LTR/ERVL-MaLR	2105	+	20	81010839	18075
chr17	80992764	81192764	harbor1	chr17	81010861	81011385	LTR/ERVL-MaLR	2500	+	262	81011123	18359
chr17	80992764	81192764	harbor1	chr17	81012513	81013656	LTR/ERVL-MaLR	5382	+	572	81013085	20321
chr17	80992764	81192764	harbor1	chr17	81013672	81014065	LTR/ERVL-MaLR	2310	+	196	81013868	21104
chr17	60048761	60248761	harbor1	chr17	60050043	60050403	LTR/ERVL-MaLR	1870	+	180	60050223	1462
chr17	60048761	60248761	harbor1	chr17	60051863	60052410	LTR/ERVL-MaLR	2711	+	274	60052137	3376
chr17	60048761	60248761	harbor1	chr17	60053010	60053414	LTR/ERVL-MaLR	2355	+	202	60053212	4451
chr17	60048761	60248761	harbor1	chr17	60053415	60054894	LTR/ERVL-MaLR	7074	+	740	60054155	5394
chr17	60048761	60248761	harbor1	chr17	60054895	60055244	LTR/ERVL-MaLR	2023	+	174	60055069	6308
chr17	60048761	60248761	harbor1	chr17	60062736	60063073	LTR/ERVL-MaLR	2579	+	168	60062904	14143
chr17	60048761	60248761	harbor1	chr17	60092297	60092621	LTR/ERVL-MaLR	971	+	162	60092459	43698
chr17	60048761	60248761	harbor1	chr17	60113932	60114437	LTR/ERVL-MaLR	2206	+	252	60114184	65423
chr17	60048761	60248761	harbor1	chr17	60121948	60122152	LTR/ERVL-MaLR	823	+	102	60122050	73289
chr17	60048761	60248761	harbor1	chr17	60125502	60125841	LTR/ERVL-MaLR	1570	+	170	60125672	76911
chr17	75814935	76014935	harbor1	chr17	75861910	75862310	LTR/ERVL-MaLR	2247	+	200	75862110	47175
chr17	75814935	76014935	harbor1	chr17	75862622	75862686	LTR/ERVL-MaLR	2247	+	32	75862654	47719
chr17	75814935	76014935	harbor1	chr17	75885931	75886240	LTR/ERVL-MaLR	2680	+	154	75886085	71150
chr17	75814935	76014935	harbor1	chr17	75886550	75886617	LTR/ERVL-MaLR	2680	+	34	75886584	71649
chr17	79702897	79902897	harbor1	chr17	79713328	79713734	LTR/ERVL-MaLR	1331	+	203	79713531	10634
chr17	79702897	79902897	harbor1	chr17	79719594	79719859	LTR/ERVL-MaLR	645	+	132	79719726	16829
chr17	79702897	79902897	harbor1	chr17	79763879	79764148	LTR/ERVL-MaLR	1429	+	134	79764013	61116
chr17	79702897	79902897	harbor1	chr17	79764470	79764533	LTR/ERVL-MaLR	1429	+	32	79764502	61605
chr17	79702897	79902897	harbor1	chr17	79768343	79768520	LTR/ERVL-MaLR	1726	+	88	79768431	65534
chr17	79702897	79902897	harbor1	chr17	79769115	79769318	LTR/ERVL-MaLR	1726	+	102	79769217	66320
chr17	7339761	7539761	harbor1	chr17	7363659	7364091	LTR/ERVL-MaLR	971	+	216	7363875	24114
chr17	7339761	7539761	harbor1	chr17	7364400	7364429	LTR/ERVL-MaLR	971	+	14	7364414	24653
chr17	2201393	2401393	harbor1	chr17	2221156	2221549	LTR/ERVL-MaLR	2277	+	196	2221352	19959
chr17	76637283	76837283	harbor1	chr17	76674610	76675127	LTR/ERVL-MaLR	1160	+	258	76674868	37585
chr17	76637283	76837283	harbor1	chr17	76697038	76697439	LTR/ERVL-MaLR	1908	+	200	76697238	59955
chr17	76637283	76837283	harbor1	chr17	76705510	76705878	LTR/ERVL-MaLR	1710	+	184	76705694	68411
chr17	79702896	79902896	harbor1	chr17	79713328	79713734	LTR/ERVL-MaLR	1331	+	203	79713531	10635
chr17	79702896	79902896	harbor1	chr17	79719594	79719859	LTR/ERVL-MaLR	645	+	132	79719726	16830
chr17	79702896	79902896	harbor1	chr17	79763879	79764148	LTR/ERVL-MaLR	1429	+	134	79764013	61117
chr17	79702896	79902896	harbor1	chr17	79764470	79764533	LTR/ERVL-MaLR	1429	+	32	79764502	61606
chr17	79702896	79902896	harbor1	chr17	79768343	79768520	LTR/ERVL-MaLR	1726	+	88	79768431	65535
chr17	79702896	79902896	harbor1	chr17	79769115	79769318	LTR/ERVL-MaLR	1726	+	102	79769217	66321
chr17	80934979	81134979	harbor1	chr17	80978550	80978914	LTR/ERVL-MaLR	1525	+	182	80978732	43753
chr17	80934979	81134979	harbor1	chr17	80983137	80983310	LTR/ERVL-MaLR	1141	+	86	80983223	48244
chr17	80934979	81134979	harbor1	chr17	80983606	80983788	LTR/ERVL-MaLR	1141	+	91	80983697	48718
chr17	80934979	81134979	harbor1	chr17	81010175	81010517	LTR/ERVL-MaLR	2105	+	171	81010346	75367
chr17	80934979	81134979	harbor1	chr17	81010819	81010860	LTR/ERVL-MaLR	2105	+	20	81010839	75860
chr17	80934979	81134979	harbor1	chr17	81010861	81011385	LTR/ERVL-MaLR	2500	+	262	81011123	76144
chr17	80934979	81134979	harbor1	chr17	81012513	81013656	LTR/ERVL-MaLR	5382	+	572	81013085	78106
chr17	80934979	81134979	harbor1	chr17	81013672	81014065	LTR/ERVL-MaLR	2310	+	196	81013868	78889
chr17	80934979	81134979	harbor1	chr17	80969542	80969863	LTR/ERVL-MaLR	772	+	160	80969702	34723
chr17	79282553	79482553	harbor1	chr17	79299657	79299831	LTR/ERVL-MaLR	776	+	87	79299744	17191
chr17	79282553	79482553	harbor1	chr17	79308577	79308836	LTR/ERVL-MaLR	1039	+	130	79308707	26154
chr17	79282553	79482553	harbor1	chr17	79309121	79309189	LTR/ERVL-MaLR	1039	+	34	79309155	26602
chr17	79282553	79482553	harbor1	chr17	79309622	79309959	LTR/ERVL-MaLR	1588	+	168	79309790	27237
chr17	79282553	79482553	harbor1	chr17	79352123	79352509	LTR/ERVL-MaLR	2339	+	193	79352316	69763
chr17	81088226	81288226	harbor1	chr17	81140420	81140644	LTR/ERVL-MaLR	645	+	112	81140532	52306
chr17	78900634	79100634	harbor1	chr17	78922371	78922535	LTR/ERVL-MaLR	1588	+	82	78922453	21819
chr17	78900634	79100634	harbor1	chr17	78922795	78923077	LTR/ERVL-MaLR	1588	+	141	78922936	22302
chr17	78900634	79100634	harbor1	chr17	78950664	78951185	LTR/ERVL-MaLR	2151	+	260	78950924	50290
chr17	78900634	79100634	harbor1	chr17	78958356	78958528	LTR/ERVL-MaLR	745	+	86	78958442	57808
chr17	80989373	81189373	harbor1	chr17	81010175	81010517	LTR/ERVL-MaLR	2105	+	171	81010346	20973
chr17	80989373	81189373	harbor1	chr17	81010819	81010860	LTR/ERVL-MaLR	2105	+	20	81010839	21466
chr17	80989373	81189373	harbor1	chr17	81010861	81011385	LTR/ERVL-MaLR	2500	+	262	81011123	21750
chr17	80989373	81189373	harbor1	chr17	81012513	81013656	LTR/ERVL-MaLR	5382	+	572	81013085	23712
chr17	80989373	81189373	harbor1	chr17	81013672	81014065	LTR/ERVL-MaLR	2310	+	196	81013868	24495
chr17	47912428	48112428	harbor1	chr17	47962942	47963272	LTR/ERVL-MaLR	1261	+	165	47963107	50679
chr17	47912428	48112428	harbor1	chr17	47963574	47963648	LTR/ERVL-MaLR	1261	+	37	47963611	51183
chr17	76637257	76837257	harbor1	chr17	76674610	76675127	LTR/ERVL-MaLR	1160	+	258	76674868	37611
chr17	76637257	76837257	harbor1	chr17	76697038	76697439	LTR/ERVL-MaLR	1908	+	200	76697238	59981
chr17	76637257	76837257	harbor1	chr17	76705510	76705878	LTR/ERVL-MaLR	1710	+	184	76705694	68437
chr17	81133780	81333780	harbor1	chr17	81140420	81140644	LTR/ERVL-MaLR	645	+	112	81140532	6752
chr17	48647753	48847753	harbor1	chr17	48659118	48659480	LTR/ERVL-MaLR	2339	+	181	48659299	11546
chr17	48647753	48847753	harbor1	chr17	48669308	48669657	LTR/ERVL-MaLR	1775	+	174	48669482	21729
chr17	76637285	76837285	harbor1	chr17	76674610	76675127	LTR/ERVL-MaLR	1160	+	258	76674868	37583
chr17	76637285	76837285	harbor1	chr17	76697038	76697439	LTR/ERVL-MaLR	1908	+	200	76697238	59953
chr17	76637285	76837285	harbor1	chr17	76705510	76705878	LTR/ERVL-MaLR	1710	+	184	76705694	68409
chr17	63346008	63546008	harbor1	chr17	63376332	63376501	LTR/ERVL-MaLR	721	+	84	63376416	30408
chr17	79282788	79482788	harbor1	chr17	79299657	79299831	LTR/ERVL-MaLR	776	+	87	79299744	16956
chr17	79282788	79482788	harbor1	chr17	79308577	79308836	LTR/ERVL-MaLR	1039	+	130	79308707	25919
chr17	79282788	79482788	harbor1	chr17	79309121	79309189	LTR/ERVL-MaLR	1039	+	34	79309155	26367
chr17	79282788	79482788	harbor1	chr17	79309622	79309959	LTR/ERVL-MaLR	1588	+	168	79309790	27002
chr17	79282788	79482788	harbor1	chr17	79352123	79352509	LTR/ERVL-MaLR	2339	+	193	79352316	69528
chr17	63600297	63800297	harbor1	chr17	63692839	63693298	LTR/ERVL-MaLR	2230	+	230	63693069	92772
chr17	80934871	81134871	harbor1	chr17	80978550	80978914	LTR/ERVL-MaLR	1525	+	182	80978732	43861
chr17	80934871	81134871	harbor1	chr17	80983137	80983310	LTR/ERVL-MaLR	1141	+	86	80983223	48352
chr17	80934871	81134871	harbor1	chr17	80983606	80983788	LTR/ERVL-MaLR	1141	+	91	80983697	48826
chr17	80934871	81134871	harbor1	chr17	81010175	81010517	LTR/ERVL-MaLR	2105	+	171	81010346	75475
chr17	80934871	81134871	harbor1	chr17	81010819	81010860	LTR/ERVL-MaLR	2105	+	20	81010839	75968
chr17	80934871	81134871	harbor1	chr17	81010861	81011385	LTR/ERVL-MaLR	2500	+	262	81011123	76252
chr17	80934871	81134871	harbor1	chr17	81012513	81013656	LTR/ERVL-MaLR	5382	+	572	81013085	78214
chr17	80934871	81134871	harbor1	chr17	81013672	81014065	LTR/ERVL-MaLR	2310	+	196	81013868	78997
chr17	80934871	81134871	harbor1	chr17	80969542	80969863	LTR/ERVL-MaLR	772	+	160	80969702	34831
chr17	76767812	76967812	harbor1	chr17	76792590	76792777	LTR/ERVL-MaLR	1982	+	94	76792684	24872
chr17	76767812	76967812	harbor1	chr17	76793846	76794170	LTR/ERVL-MaLR	1982	+	162	76794008	26196
chr17	76767812	76967812	harbor1	chr17	76812972	76813169	LTR/ERVL-MaLR	891	+	98	76813070	45258
chr17	76767812	76967812	harbor1	chr17	76818747	76818992	LTR/ERVL-MaLR	1654	+	122	76818869	51057
chr17	76767812	76967812	harbor1	chr17	76819298	76819522	LTR/ERVL-MaLR	1654	+	112	76819410	51598
chr17	76767812	76967812	harbor1	chr17	76833798	76834168	LTR/ERVL-MaLR	1627	+	185	76833983	66171
chr17	76767812	76967812	harbor1	chr17	76837586	76837729	LTR/ERVL-MaLR	707	+	72	76837658	69846
chr17	76767812	76967812	harbor1	chr17	76838037	76838088	LTR/ERVL-MaLR	707	+	26	76838063	70251
chr17	76767812	76967812	harbor1	chr17	76842350	76842455	LTR/ERVL-MaLR	1004	+	52	76842402	74590
chr17	76767812	76967812	harbor1	chr17	76843042	76843215	LTR/ERVL-MaLR	1004	+	86	76843128	75316
chr17	76767812	76967812	harbor1	chr17	76843821	76843871	LTR/ERVL-MaLR	1004	+	25	76843846	76034
chr17	76767812	76967812	harbor1	chr17	76849990	76850347	LTR/ERVL-MaLR	993	+	178	76850168	82356
chr17	76767812	76967812	harbor1	chr17	76863367	76863714	LTR/ERVL-MaLR	1106	+	174	76863541	95729
chr17	76637313	76837313	harbor1	chr17	76674610	76675127	LTR/ERVL-MaLR	1160	+	258	76674868	37555
chr17	76637313	76837313	harbor1	chr17	76697038	76697439	LTR/ERVL-MaLR	1908	+	200	76697238	59925
chr17	76637313	76837313	harbor1	chr17	76705510	76705878	LTR/ERVL-MaLR	1710	+	184	76705694	68381
chr17	80992800	81192800	harbor1	chr17	81010175	81010517	LTR/ERVL-MaLR	2105	+	171	81010346	17546
chr17	80992800	81192800	harbor1	chr17	81010819	81010860	LTR/ERVL-MaLR	2105	+	20	81010839	18039
chr17	80992800	81192800	harbor1	chr17	81010861	81011385	LTR/ERVL-MaLR	2500	+	262	81011123	18323
chr17	80992800	81192800	harbor1	chr17	81012513	81013656	LTR/ERVL-MaLR	5382	+	572	81013085	20285
chr17	80992800	81192800	harbor1	chr17	81013672	81014065	LTR/ERVL-MaLR	2310	+	196	81013868	21068
chr17	78988152	79188152	harbor1	chr17	79054661	79055039	LTR/ERVL-MaLR	2227	+	189	79054850	66698
chr17	79702953	79902953	harbor1	chr17	79713328	79713734	LTR/ERVL-MaLR	1331	+	203	79713531	10578
chr17	79702953	79902953	harbor1	chr17	79719594	79719859	LTR/ERVL-MaLR	645	+	132	79719726	16773
chr17	79702953	79902953	harbor1	chr17	79763879	79764148	LTR/ERVL-MaLR	1429	+	134	79764013	61060
chr17	79702953	79902953	harbor1	chr17	79764470	79764533	LTR/ERVL-MaLR	1429	+	32	79764502	61549
chr17	79702953	79902953	harbor1	chr17	79768343	79768520	LTR/ERVL-MaLR	1726	+	88	79768431	65478
chr17	79702953	79902953	harbor1	chr17	79769115	79769318	LTR/ERVL-MaLR	1726	+	102	79769217	66264
chr17	79702900	79902900	harbor1	chr17	79713328	79713734	LTR/ERVL-MaLR	1331	+	203	79713531	10631
chr17	79702900	79902900	harbor1	chr17	79719594	79719859	LTR/ERVL-MaLR	645	+	132	79719726	16826
chr17	79702900	79902900	harbor1	chr17	79763879	79764148	LTR/ERVL-MaLR	1429	+	134	79764013	61113
chr17	79702900	79902900	harbor1	chr17	79764470	79764533	LTR/ERVL-MaLR	1429	+	32	79764502	61602
chr17	79702900	79902900	harbor1	chr17	79768343	79768520	LTR/ERVL-MaLR	1726	+	88	79768431	65531
chr17	79702900	79902900	harbor1	chr17	79769115	79769318	LTR/ERVL-MaLR	1726	+	102	79769217	66317
chr17	80926830	81126830	harbor1	chr17	80978550	80978914	LTR/ERVL-MaLR	1525	+	182	80978732	51902
chr17	80926830	81126830	harbor1	chr17	80983137	80983310	LTR/ERVL-MaLR	1141	+	86	80983223	56393
chr17	80926830	81126830	harbor1	chr17	80983606	80983788	LTR/ERVL-MaLR	1141	+	91	80983697	56867
chr17	80926830	81126830	harbor1	chr17	81010175	81010517	LTR/ERVL-MaLR	2105	+	171	81010346	83516
chr17	80926830	81126830	harbor1	chr17	81010819	81010860	LTR/ERVL-MaLR	2105	+	20	81010839	84009
chr17	80926830	81126830	harbor1	chr17	81010861	81011385	LTR/ERVL-MaLR	2500	+	262	81011123	84293
chr17	80926830	81126830	harbor1	chr17	81012513	81013656	LTR/ERVL-MaLR	5382	+	572	81013085	86255
chr17	80926830	81126830	harbor1	chr17	81013672	81014065	LTR/ERVL-MaLR	2310	+	196	81013868	87038
chr17	80926830	81126830	harbor1	chr17	80969542	80969863	LTR/ERVL-MaLR	772	+	160	80969702	42872
chr17	59909729	60109729	harbor1	chr17	59972704	59973147	LTR/ERVL-MaLR	1548	+	222	59972926	63197
chr17	80901662	81101662	harbor1	chr17	80978550	80978914	LTR/ERVL-MaLR	1525	+	182	80978732	77070
chr17	80901662	81101662	harbor1	chr17	80983137	80983310	LTR/ERVL-MaLR	1141	+	86	80983223	81561
chr17	80901662	81101662	harbor1	chr17	80983606	80983788	LTR/ERVL-MaLR	1141	+	91	80983697	82035
chr17	80901662	81101662	harbor1	chr17	80969542	80969863	LTR/ERVL-MaLR	772	+	160	80969702	68040
chr17	76637274	76837274	harbor1	chr17	76674610	76675127	LTR/ERVL-MaLR	1160	+	258	76674868	37594
chr17	76637274	76837274	harbor1	chr17	76697038	76697439	LTR/ERVL-MaLR	1908	+	200	76697238	59964
chr17	76637274	76837274	harbor1	chr17	76705510	76705878	LTR/ERVL-MaLR	1710	+	184	76705694	68420
chr17	76768641	76968641	harbor1	chr17	76792590	76792777	LTR/ERVL-MaLR	1982	+	94	76792684	24043
chr17	76768641	76968641	harbor1	chr17	76793846	76794170	LTR/ERVL-MaLR	1982	+	162	76794008	25367
chr17	76768641	76968641	harbor1	chr17	76812972	76813169	LTR/ERVL-MaLR	891	+	98	76813070	44429
chr17	76768641	76968641	harbor1	chr17	76818747	76818992	LTR/ERVL-MaLR	1654	+	122	76818869	50228
chr17	76768641	76968641	harbor1	chr17	76819298	76819522	LTR/ERVL-MaLR	1654	+	112	76819410	50769
chr17	76768641	76968641	harbor1	chr17	76833798	76834168	LTR/ERVL-MaLR	1627	+	185	76833983	65342
chr17	76768641	76968641	harbor1	chr17	76837586	76837729	LTR/ERVL-MaLR	707	+	72	76837658	69017
chr17	76768641	76968641	harbor1	chr17	76838037	76838088	LTR/ERVL-MaLR	707	+	26	76838063	69422
chr17	76768641	76968641	harbor1	chr17	76842350	76842455	LTR/ERVL-MaLR	1004	+	52	76842402	73761
chr17	76768641	76968641	harbor1	chr17	76843042	76843215	LTR/ERVL-MaLR	1004	+	86	76843128	74487
chr17	76768641	76968641	harbor1	chr17	76843821	76843871	LTR/ERVL-MaLR	1004	+	25	76843846	75205
chr17	76768641	76968641	harbor1	chr17	76849990	76850347	LTR/ERVL-MaLR	993	+	178	76850168	81527
chr17	76768641	76968641	harbor1	chr17	76863367	76863714	LTR/ERVL-MaLR	1106	+	174	76863541	94900
chr17	76637097	76837097	harbor1	chr17	76674610	76675127	LTR/ERVL-MaLR	1160	+	258	76674868	37771
chr17	76637097	76837097	harbor1	chr17	76697038	76697439	LTR/ERVL-MaLR	1908	+	200	76697238	60141
chr17	76637097	76837097	harbor1	chr17	76705510	76705878	LTR/ERVL-MaLR	1710	+	184	76705694	68597
chr17	57767551	57967551	harbor1	chr17	57775041	57775213	LTR/ERVL-MaLR	595	+	86	57775127	7576
chr17	57767551	57967551	harbor1	chr17	57779846	57780170	LTR/ERVL-MaLR	1983	+	162	57780008	12457
chr17	57767551	57967551	harbor1	chr17	57800402	57800828	LTR/ERVL-MaLR	2496	+	213	57800615	33064
chr17	57767551	57967551	harbor1	chr17	57800829	57801523	LTR/ERVL-MaLR	4041	+	347	57801176	33625
chr17	57767551	57967551	harbor1	chr17	57801519	57801793	LTR/ERVL-MaLR	1891	+	137	57801656	34105
chr17	57767551	57967551	harbor1	chr17	57807305	57807577	LTR/ERVL-MaLR	1901	+	136	57807441	39890
chr17	57767551	57967551	harbor1	chr17	57807879	57808066	LTR/ERVL-MaLR	1901	+	94	57807973	40422
chr17	57767551	57967551	harbor1	chr17	57808409	57808464	LTR/ERVL-MaLR	1901	+	28	57808437	40886
chr17	57767551	57967551	harbor1	chr17	57843480	57843797	LTR/ERVL-MaLR	1345	+	158	57843638	76087
chr17	27460460	27660460	harbor1	chr17	27501391	27501623	LTR/ERVL-MaLR	1451	+	116	27501507	41047
chr17	27460460	27660460	harbor1	chr17	27503583	27503967	LTR/ERVL-MaLR	1382	+	192	27503775	43315
chr17	594307	794307	harbor1	chr17	652295	652787	LTR/ERVL-MaLR	1854	+	246	652541	58234
chr17	594307	794307	harbor1	chr17	665020	665473	LTR/ERVL-MaLR	1347	+	226	665246	70939
chr17	594307	794307	harbor1	chr17	665474	665723	LTR/ERVL-MaLR	1165	+	124	665598	71291
chr17	594307	794307	harbor1	chr17	666018	666088	LTR/ERVL-MaLR	761	+	35	666053	71746
chr17	594307	794307	harbor1	chr17	688142	688488	LTR/ERVL-MaLR	2028	+	173	688315	94008
chr17	48647749	48847749	harbor1	chr17	48659118	48659480	LTR/ERVL-MaLR	2339	+	181	48659299	11550
chr17	48647749	48847749	harbor1	chr17	48669308	48669657	LTR/ERVL-MaLR	1775	+	174	48669482	21733
chr17	76429510	76629510	harbor1	chr17	76513973	76514036	LTR/ERVL-MaLR	1167	+	32	76514005	84495
chr17	76429510	76629510	harbor1	chr17	76518115	76518479	LTR/ERVL-MaLR	1737	+	182	76518297	88787
chr17	76429510	76629510	harbor1	chr17	76513265	76513661	LTR/ERVL-MaLR	1167	+	198	76513463	83953
chr17	8283703	8483703	harbor1	chr17	8331985	8332382	LTR/ERVL-MaLR	1447	+	198	8332183	48480
chr17	8283703	8483703	harbor1	chr17	8353731	8354123	LTR/ERVL-MaLR	1458	+	196	8353927	70224
chr17	8283703	8483703	harbor1	chr17	8368413	8368636	LTR/ERVL-MaLR	1045	+	112	8368525	84822
chr17	8283703	8483703	harbor1	chr17	8368936	8368977	LTR/ERVL-MaLR	1045	+	20	8368956	85253
chr17	76767813	76967813	harbor1	chr17	76792590	76792777	LTR/ERVL-MaLR	1982	+	94	76792684	24871
chr17	76767813	76967813	harbor1	chr17	76793846	76794170	LTR/ERVL-MaLR	1982	+	162	76794008	26195
chr17	76767813	76967813	harbor1	chr17	76812972	76813169	LTR/ERVL-MaLR	891	+	98	76813070	45257
chr17	76767813	76967813	harbor1	chr17	76818747	76818992	LTR/ERVL-MaLR	1654	+	122	76818869	51056
chr17	76767813	76967813	harbor1	chr17	76819298	76819522	LTR/ERVL-MaLR	1654	+	112	76819410	51597
chr17	76767813	76967813	harbor1	chr17	76833798	76834168	LTR/ERVL-MaLR	1627	+	185	76833983	66170
chr17	76767813	76967813	harbor1	chr17	76837586	76837729	LTR/ERVL-MaLR	707	+	72	76837658	69845
chr17	76767813	76967813	harbor1	chr17	76838037	76838088	LTR/ERVL-MaLR	707	+	26	76838063	70250
chr17	76767813	76967813	harbor1	chr17	76842350	76842455	LTR/ERVL-MaLR	1004	+	52	76842402	74589
chr17	76767813	76967813	harbor1	chr17	76843042	76843215	LTR/ERVL-MaLR	1004	+	86	76843128	75315
chr17	76767813	76967813	harbor1	chr17	76843821	76843871	LTR/ERVL-MaLR	1004	+	25	76843846	76033
chr17	76767813	76967813	harbor1	chr17	76849990	76850347	LTR/ERVL-MaLR	993	+	178	76850168	82355
chr17	76767813	76967813	harbor1	chr17	76863367	76863714	LTR/ERVL-MaLR	1106	+	174	76863541	95728
chr17	8922459	9122459	harbor1	chr17	8927707	8928115	LTR/ERVL-MaLR	1843	+	204	8927911	5452
chr17	8922459	9122459	harbor1	chr17	8951795	8952237	LTR/ERVL-MaLR	1588	+	221	8952016	29557
chr17	8922459	9122459	harbor1	chr17	8971025	8971204	LTR/ERVL-MaLR	2496	+	90	8971115	48656
chr17	8922459	9122459	harbor1	chr17	8971497	8971730	LTR/ERVL-MaLR	2496	+	116	8971613	49154
chr17	8922459	9122459	harbor1	chr17	8972949	8973110	LTR/ERVL-MaLR	1860	+	80	8973029	50570
chr17	8922459	9122459	harbor1	chr17	8973407	8973621	LTR/ERVL-MaLR	1860	+	107	8973514	51055
chr17	8922459	9122459	harbor1	chr17	8988576	8988947	LTR/ERVL-MaLR	2836	+	186	8988762	66303
chr17	8922459	9122459	harbor1	chr17	8945650	8946186	LTR/ERVL-MaLR	1552	+	268	8945918	23459
chr17	81329309	81529309	harbor1	chr17	81362041	81362404	LTR/ERVL-MaLR	2803	+	182	81362223	32914
chr17	81329309	81529309	harbor1	chr17	81370613	81370693	LTR/ERVL-MaLR	590	+	40	81370653	41344
chr17	81329309	81529309	harbor1	chr17	81371003	81371105	LTR/ERVL-MaLR	590	+	51	81371054	41745
chr17	47154294	47354294	harbor1	chr17	47196046	47196428	LTR/ERVL-MaLR	1374	+	191	47196237	41943
chr17	80934867	81134867	harbor1	chr17	80978550	80978914	LTR/ERVL-MaLR	1525	+	182	80978732	43865
chr17	80934867	81134867	harbor1	chr17	80983137	80983310	LTR/ERVL-MaLR	1141	+	86	80983223	48356
chr17	80934867	81134867	harbor1	chr17	80983606	80983788	LTR/ERVL-MaLR	1141	+	91	80983697	48830
chr17	80934867	81134867	harbor1	chr17	81010175	81010517	LTR/ERVL-MaLR	2105	+	171	81010346	75479
chr17	80934867	81134867	harbor1	chr17	81010819	81010860	LTR/ERVL-MaLR	2105	+	20	81010839	75972
chr17	80934867	81134867	harbor1	chr17	81010861	81011385	LTR/ERVL-MaLR	2500	+	262	81011123	76256
chr17	80934867	81134867	harbor1	chr17	81012513	81013656	LTR/ERVL-MaLR	5382	+	572	81013085	78218
chr17	80934867	81134867	harbor1	chr17	81013672	81014065	LTR/ERVL-MaLR	2310	+	196	81013868	79001
chr17	80934867	81134867	harbor1	chr17	80969542	80969863	LTR/ERVL-MaLR	772	+	160	80969702	34835
chr17	76635280	76835280	harbor1	chr17	76674610	76675127	LTR/ERVL-MaLR	1160	+	258	76674868	39588
chr17	76635280	76835280	harbor1	chr17	76697038	76697439	LTR/ERVL-MaLR	1908	+	200	76697238	61958
chr17	76635280	76835280	harbor1	chr17	76705510	76705878	LTR/ERVL-MaLR	1710	+	184	76705694	70414
chr17	17065632	17265632	harbor1	chr17	17109947	17110376	LTR/ERVL-MaLR	2295	+	214	17110161	44529
chr17	39087119	39287119	harbor1	chr17	39099825	39100119	LTR/ERVL-MaLR	1748	+	147	39099972	12853
chr17	39087119	39287119	harbor1	chr17	39100151	39100236	LTR/ERVL-MaLR	1748	+	42	39100193	13074
chr17	39087119	39287119	harbor1	chr17	39100555	39100718	LTR/ERVL-MaLR	1748	+	82	39100637	13518
chr17	39087119	39287119	harbor1	chr17	39112914	39113382	LTR/ERVL-MaLR	1853	+	234	39113148	26029
chr17	39087119	39287119	harbor1	chr17	39113935	39114162	LTR/ERVL-MaLR	650	+	114	39114049	26930
chr17	39087119	39287119	harbor1	chr17	39121632	39121850	LTR/ERVL-MaLR	1061	+	109	39121741	34622
chr17	39087119	39287119	harbor1	chr17	39122407	39122538	LTR/ERVL-MaLR	1061	+	66	39122473	35354
chr17	8283709	8483709	harbor1	chr17	8331985	8332382	LTR/ERVL-MaLR	1447	+	198	8332183	48474
chr17	8283709	8483709	harbor1	chr17	8353731	8354123	LTR/ERVL-MaLR	1458	+	196	8353927	70218
chr17	8283709	8483709	harbor1	chr17	8368413	8368636	LTR/ERVL-MaLR	1045	+	112	8368525	84816
chr17	8283709	8483709	harbor1	chr17	8368936	8368977	LTR/ERVL-MaLR	1045	+	20	8368956	85247
chr17	80934894	81134894	harbor1	chr17	80978550	80978914	LTR/ERVL-MaLR	1525	+	182	80978732	43838
chr17	80934894	81134894	harbor1	chr17	80983137	80983310	LTR/ERVL-MaLR	1141	+	86	80983223	48329
chr17	80934894	81134894	harbor1	chr17	80983606	80983788	LTR/ERVL-MaLR	1141	+	91	80983697	48803
chr17	80934894	81134894	harbor1	chr17	81010175	81010517	LTR/ERVL-MaLR	2105	+	171	81010346	75452
chr17	80934894	81134894	harbor1	chr17	81010819	81010860	LTR/ERVL-MaLR	2105	+	20	81010839	75945
chr17	80934894	81134894	harbor1	chr17	81010861	81011385	LTR/ERVL-MaLR	2500	+	262	81011123	76229
chr17	80934894	81134894	harbor1	chr17	81012513	81013656	LTR/ERVL-MaLR	5382	+	572	81013085	78191
chr17	80934894	81134894	harbor1	chr17	81013672	81014065	LTR/ERVL-MaLR	2310	+	196	81013868	78974
chr17	80934894	81134894	harbor1	chr17	80969542	80969863	LTR/ERVL-MaLR	772	+	160	80969702	34808
chr17	79703308	79903308	harbor1	chr17	79713328	79713734	LTR/ERVL-MaLR	1331	+	203	79713531	10223
chr17	79703308	79903308	harbor1	chr17	79719594	79719859	LTR/ERVL-MaLR	645	+	132	79719726	16418
chr17	79703308	79903308	harbor1	chr17	79763879	79764148	LTR/ERVL-MaLR	1429	+	134	79764013	60705
chr17	79703308	79903308	harbor1	chr17	79764470	79764533	LTR/ERVL-MaLR	1429	+	32	79764502	61194
chr17	79703308	79903308	harbor1	chr17	79768343	79768520	LTR/ERVL-MaLR	1726	+	88	79768431	65123
chr17	79703308	79903308	harbor1	chr17	79769115	79769318	LTR/ERVL-MaLR	1726	+	102	79769217	65909
chr17	27194779	27394779	harbor1	chr17	27214846	27215209	LTR/ERVL-MaLR	1045	+	182	27215028	20249
chr17	27194779	27394779	harbor1	chr17	27270542	27270894	LTR/ERVL-MaLR	2804	+	176	27270718	75939
chr17	80949209	81149209	harbor1	chr17	80978550	80978914	LTR/ERVL-MaLR	1525	+	182	80978732	29523
chr17	80949209	81149209	harbor1	chr17	80983137	80983310	LTR/ERVL-MaLR	1141	+	86	80983223	34014
chr17	80949209	81149209	harbor1	chr17	80983606	80983788	LTR/ERVL-MaLR	1141	+	91	80983697	34488
chr17	80949209	81149209	harbor1	chr17	81010175	81010517	LTR/ERVL-MaLR	2105	+	171	81010346	61137
chr17	80949209	81149209	harbor1	chr17	81010819	81010860	LTR/ERVL-MaLR	2105	+	20	81010839	61630
chr17	80949209	81149209	harbor1	chr17	81010861	81011385	LTR/ERVL-MaLR	2500	+	262	81011123	61914
chr17	80949209	81149209	harbor1	chr17	81012513	81013656	LTR/ERVL-MaLR	5382	+	572	81013085	63876
chr17	80949209	81149209	harbor1	chr17	81013672	81014065	LTR/ERVL-MaLR	2310	+	196	81013868	64659
chr17	80949209	81149209	harbor1	chr17	80969542	80969863	LTR/ERVL-MaLR	772	+	160	80969702	20493
chr18	26126451	26326451	harbor1	chr18	26127858	26128163	LTR/ERVL-MaLR	2274	+	152	26128010	1559
chr18	26126451	26326451	harbor1	chr18	26128682	26128778	LTR/ERVL-MaLR	2274	+	48	26128730	2279
chr18	26126451	26326451	harbor1	chr18	26138992	26139500	LTR/ERVL-MaLR	2203	+	254	26139246	12795
chr18	26126451	26326451	harbor1	chr18	26152650	26153027	LTR/ERVL-MaLR	1370	+	188	26152838	26387
chr18	26126451	26326451	harbor1	chr18	26167484	26167852	LTR/ERVL-MaLR	1331	+	184	26167668	41217
chr18	78969159	79169159	harbor1	chr18	79055885	79056260	LTR/ERVL-MaLR	1238	+	188	79056073	86914
chr18	78969159	79169159	harbor1	chr18	79065410	79065675	LTR/ERVL-MaLR	1574	+	132	79065542	96383
chr18	78969159	79169159	harbor1	chr18	79019679	79020033	LTR/ERVL-MaLR	1464	+	177	79019856	50697
chr18	25990886	26190886	harbor1	chr18	26004994	26005544	LTR/ERVL-MaLR	2680	+	275	26005269	14383
chr18	25990886	26190886	harbor1	chr18	26005546	26005896	LTR/ERVL-MaLR	1851	+	175	26005721	14835
chr18	75105235	75305235	harbor1	chr18	75115133	75115494	LTR/ERVL-MaLR	1964	+	180	75115313	10078
chr18	75105235	75305235	harbor1	chr18	75140977	75141418	LTR/ERVL-MaLR	1743	+	220	75141197	35962
chr18	75105235	75305235	harbor1	chr18	75154566	75155006	LTR/ERVL-MaLR	1379	+	220	75154786	49551
chr18	75105235	75305235	harbor1	chr18	75157394	75157784	LTR/ERVL-MaLR	1400	+	195	75157589	52354
chr18	75105235	75305235	harbor1	chr18	75170051	75170427	LTR/ERVL-MaLR	879	+	188	75170239	65004
chr18	75105235	75305235	harbor1	chr18	75177110	75177487	LTR/ERVL-MaLR	1339	+	188	75177298	72063
chr18	75105235	75305235	harbor1	chr18	75187687	75188056	LTR/ERVL-MaLR	2477	+	184	75187871	82636
chr18	26126452	26326452	harbor1	chr18	26127858	26128163	LTR/ERVL-MaLR	2274	+	152	26128010	1558
chr18	26126452	26326452	harbor1	chr18	26128682	26128778	LTR/ERVL-MaLR	2274	+	48	26128730	2278
chr18	26126452	26326452	harbor1	chr18	26138992	26139500	LTR/ERVL-MaLR	2203	+	254	26139246	12794
chr18	26126452	26326452	harbor1	chr18	26152650	26153027	LTR/ERVL-MaLR	1370	+	188	26152838	26386
chr18	26126452	26326452	harbor1	chr18	26167484	26167852	LTR/ERVL-MaLR	1331	+	184	26167668	41216
chr18	26126169	26326169	harbor1	chr18	26127858	26128163	LTR/ERVL-MaLR	2274	+	152	26128010	1841
chr18	26126169	26326169	harbor1	chr18	26128682	26128778	LTR/ERVL-MaLR	2274	+	48	26128730	2561
chr18	26126169	26326169	harbor1	chr18	26138992	26139500	LTR/ERVL-MaLR	2203	+	254	26139246	13077
chr18	26126169	26326169	harbor1	chr18	26152650	26153027	LTR/ERVL-MaLR	1370	+	188	26152838	26669
chr18	26126169	26326169	harbor1	chr18	26167484	26167852	LTR/ERVL-MaLR	1331	+	184	26167668	41499
chr18	26126503	26326503	harbor1	chr18	26127858	26128163	LTR/ERVL-MaLR	2274	+	152	26128010	1507
chr18	26126503	26326503	harbor1	chr18	26128682	26128778	LTR/ERVL-MaLR	2274	+	48	26128730	2227
chr18	26126503	26326503	harbor1	chr18	26138992	26139500	LTR/ERVL-MaLR	2203	+	254	26139246	12743
chr18	26126503	26326503	harbor1	chr18	26152650	26153027	LTR/ERVL-MaLR	1370	+	188	26152838	26335
chr18	26126503	26326503	harbor1	chr18	26167484	26167852	LTR/ERVL-MaLR	1331	+	184	26167668	41165
chr18	26126493	26326493	harbor1	chr18	26127858	26128163	LTR/ERVL-MaLR	2274	+	152	26128010	1517
chr18	26126493	26326493	harbor1	chr18	26128682	26128778	LTR/ERVL-MaLR	2274	+	48	26128730	2237
chr18	26126493	26326493	harbor1	chr18	26138992	26139500	LTR/ERVL-MaLR	2203	+	254	26139246	12753
chr18	26126493	26326493	harbor1	chr18	26152650	26153027	LTR/ERVL-MaLR	1370	+	188	26152838	26345
chr18	26126493	26326493	harbor1	chr18	26167484	26167852	LTR/ERVL-MaLR	1331	+	184	26167668	41175
chr18	26126535	26326535	harbor1	chr18	26127858	26128163	LTR/ERVL-MaLR	2274	+	152	26128010	1475
chr18	26126535	26326535	harbor1	chr18	26128682	26128778	LTR/ERVL-MaLR	2274	+	48	26128730	2195
chr18	26126535	26326535	harbor1	chr18	26138992	26139500	LTR/ERVL-MaLR	2203	+	254	26139246	12711
chr18	26126535	26326535	harbor1	chr18	26152650	26153027	LTR/ERVL-MaLR	1370	+	188	26152838	26303
chr18	26126535	26326535	harbor1	chr18	26167484	26167852	LTR/ERVL-MaLR	1331	+	184	26167668	41133
chr18	37465339	37665339	harbor1	chr18	37479732	37480159	LTR/ERVL-MaLR	2134	+	214	37479946	14607
chr18	12847445	13047445	harbor1	chr18	12848344	12848829	LTR/ERVL-MaLR	1178	+	242	12848586	1141
chr18	12847445	13047445	harbor1	chr18	12886538	12886896	LTR/ERVL-MaLR	1743	+	179	12886717	39272
chr18	12847445	13047445	harbor1	chr18	12890874	12891285	LTR/ERVL-MaLR	987	+	206	12891080	43635
chr18	12847445	13047445	harbor1	chr18	12938487	12938822	LTR/ERVL-MaLR	1639	+	168	12938655	91210
chr18	12847445	13047445	harbor1	chr18	12939121	12939186	LTR/ERVL-MaLR	1639	+	32	12939153	91708
chr18	57346563	57546563	harbor1	chr18	57375274	57375639	LTR/ERVL-MaLR	2185	+	182	57375456	28893
chr18	57346563	57546563	harbor1	chr18	57416001	57416260	LTR/ERVL-MaLR	870	+	130	57416131	69568
chr18	57346563	57546563	harbor1	chr18	57420161	57420485	LTR/ERVL-MaLR	1482	+	162	57420323	73760
chr18	57346563	57546563	harbor1	chr18	57420801	57420840	LTR/ERVL-MaLR	1482	+	20	57420821	74258
chr18	37465426	37665426	harbor1	chr18	37479732	37480159	LTR/ERVL-MaLR	2134	+	214	37479946	14520
chr18	78209657	78409657	harbor1	chr18	78209636	78209676	LTR/ERVL-MaLR	2258	+	20	78209656	1
chr18	78209657	78409657	harbor1	chr18	78266596	78266917	LTR/ERVL-MaLR	837	+	160	78266756	57099
chr18	8509901	8709901	harbor1	chr18	8520349	8520565	LTR/ERVL-MaLR	783	+	108	8520457	10556
chr18	8509901	8709901	harbor1	chr18	8520578	8520855	LTR/ERVL-MaLR	963	+	138	8520716	10815
chr18	8509901	8709901	harbor1	chr18	8521365	8521684	LTR/ERVL-MaLR	1415	+	160	8521525	11624
chr18	8509901	8709901	harbor1	chr18	8564210	8564589	LTR/ERVL-MaLR	2130	+	190	8564400	54499
chr18	74356659	74556659	harbor1	chr18	74399993	74400491	LTR/ERVL-MaLR	1673	+	249	74400242	43583
chr18	74356659	74556659	harbor1	chr18	74417268	74417687	LTR/ERVL-MaLR	1399	+	210	74417478	60819
chr18	74356659	74556659	harbor1	chr18	74421301	74421656	LTR/ERVL-MaLR	1540	+	178	74421479	64820
chr18	65651276	65851276	harbor1	chr18	65676110	65676429	LTR/ERVL-MaLR	715	+	160	65676270	24994
chr18	65651276	65851276	harbor1	chr18	65720745	65721106	LTR/ERVL-MaLR	1371	+	180	65720925	69649
chr18	26126455	26326455	harbor1	chr18	26127858	26128163	LTR/ERVL-MaLR	2274	+	152	26128010	1555
chr18	26126455	26326455	harbor1	chr18	26128682	26128778	LTR/ERVL-MaLR	2274	+	48	26128730	2275
chr18	26126455	26326455	harbor1	chr18	26138992	26139500	LTR/ERVL-MaLR	2203	+	254	26139246	12791
chr18	26126455	26326455	harbor1	chr18	26152650	26153027	LTR/ERVL-MaLR	1370	+	188	26152838	26383
chr18	26126455	26326455	harbor1	chr18	26167484	26167852	LTR/ERVL-MaLR	1331	+	184	26167668	41213
chr18	26126495	26326495	harbor1	chr18	26127858	26128163	LTR/ERVL-MaLR	2274	+	152	26128010	1515
chr18	26126495	26326495	harbor1	chr18	26128682	26128778	LTR/ERVL-MaLR	2274	+	48	26128730	2235
chr18	26126495	26326495	harbor1	chr18	26138992	26139500	LTR/ERVL-MaLR	2203	+	254	26139246	12751
chr18	26126495	26326495	harbor1	chr18	26152650	26153027	LTR/ERVL-MaLR	1370	+	188	26152838	26343
chr18	26126495	26326495	harbor1	chr18	26167484	26167852	LTR/ERVL-MaLR	1331	+	184	26167668	41173
chr18	65651379	65851379	harbor1	chr18	65676110	65676429	LTR/ERVL-MaLR	715	+	160	65676270	24891
chr18	65651379	65851379	harbor1	chr18	65720745	65721106	LTR/ERVL-MaLR	1371	+	180	65720925	69546
chr18	79295927	79495927	harbor1	chr18	79295661	79295976	LTR/ERVL-MaLR	1237	+	158	79295819	108
chr18	21921090	22121090	harbor1	chr18	21944177	21944521	LTR/ERVL-MaLR	1450	+	172	21944349	23259
chr18	21921090	22121090	harbor1	chr18	21946900	21947047	LTR/ERVL-MaLR	1762	+	74	21946974	25884
chr18	21921090	22121090	harbor1	chr18	21947343	21947560	LTR/ERVL-MaLR	1762	+	108	21947451	26361
chr18	21921090	22121090	harbor1	chr18	21949415	21949820	LTR/ERVL-MaLR	1958	+	202	21949617	28527
chr18	79580317	79780317	harbor1	chr18	79670652	79671011	LTR/ERVL-MaLR	2807	+	180	79670832	90515
chr18	26126454	26326454	harbor1	chr18	26127858	26128163	LTR/ERVL-MaLR	2274	+	152	26128010	1556
chr18	26126454	26326454	harbor1	chr18	26128682	26128778	LTR/ERVL-MaLR	2274	+	48	26128730	2276
chr18	26126454	26326454	harbor1	chr18	26138992	26139500	LTR/ERVL-MaLR	2203	+	254	26139246	12792
chr18	26126454	26326454	harbor1	chr18	26152650	26153027	LTR/ERVL-MaLR	1370	+	188	26152838	26384
chr18	26126454	26326454	harbor1	chr18	26167484	26167852	LTR/ERVL-MaLR	1331	+	184	26167668	41214
chr18	14237384	14437384	harbor1	chr18	14254668	14255004	LTR/ERVL-MaLR	1339	+	168	14254836	17452
chr18	14237384	14437384	harbor1	chr18	14255034	14255270	LTR/ERVL-MaLR	1299	+	118	14255152	17768
chr18	14237384	14437384	harbor1	chr18	14255268	14255519	LTR/ERVL-MaLR	1379	+	126	14255394	18010
chr18	14237384	14437384	harbor1	chr18	14255520	14255903	LTR/ERVL-MaLR	1308	+	192	14255712	18328
chr18	14237384	14437384	harbor1	chr18	14256575	14256858	LTR/ERVL-MaLR	1249	+	142	14256717	19333
chr18	14237384	14437384	harbor1	chr18	14257023	14258583	LTR/ERVL-MaLR	5593	+	780	14257803	20419
chr18	14237384	14437384	harbor1	chr18	14258855	14259199	LTR/ERVL-MaLR	1429	+	172	14259027	21643
chr18	14237384	14437384	harbor1	chr18	14259202	14259298	LTR/ERVL-MaLR	562	+	48	14259250	21866
chr18	14237384	14437384	harbor1	chr18	14259683	14259845	LTR/ERVL-MaLR	626	+	81	14259764	22380
chr18	14237384	14437384	harbor1	chr18	14259989	14261514	LTR/ERVL-MaLR	5688	+	762	14260751	23367
chr18	14237384	14437384	harbor1	chr18	14261980	14262326	LTR/ERVL-MaLR	1365	+	173	14262153	24769
chr18	14237384	14437384	harbor1	chr18	14262327	14262422	LTR/ERVL-MaLR	555	+	48	14262375	24991
chr18	14237384	14437384	harbor1	chr18	14262791	14263088	LTR/ERVL-MaLR	1073	+	148	14262939	25555
chr18	14237384	14437384	harbor1	chr18	14263255	14264830	LTR/ERVL-MaLR	6011	+	788	14264043	26659
chr18	14237384	14437384	harbor1	chr18	14265053	14265162	LTR/ERVL-MaLR	588	+	54	14265107	27723
chr18	14237384	14437384	harbor1	chr18	14265411	14265727	LTR/ERVL-MaLR	1175	+	158	14265569	28185
chr18	14237384	14437384	harbor1	chr18	14266220	14266507	LTR/ERVL-MaLR	764	+	144	14266364	28980
chr18	14237384	14437384	harbor1	chr18	14266663	14266866	LTR/ERVL-MaLR	840	+	102	14266765	29381
chr18	14237384	14437384	harbor1	chr18	14266874	14268026	LTR/ERVL-MaLR	4628	+	576	14267450	30066
chr18	14237384	14437384	harbor1	chr18	14268027	14268123	LTR/ERVL-MaLR	523	+	48	14268075	30691
chr18	14237384	14437384	harbor1	chr18	14268270	14268605	LTR/ERVL-MaLR	1294	+	168	14268438	31054
chr18	14237384	14437384	harbor1	chr18	14269093	14269361	LTR/ERVL-MaLR	1032	+	134	14269227	31843
chr18	14237384	14437384	harbor1	chr18	14270830	14270945	LTR/ERVL-MaLR	535	+	58	14270888	33504
chr18	14237384	14437384	harbor1	chr18	14270946	14271043	LTR/ERVL-MaLR	511	+	48	14270994	33610
chr18	14237384	14437384	harbor1	chr18	14271187	14271523	LTR/ERVL-MaLR	1300	+	168	14271355	33971
chr18	14237384	14437384	harbor1	chr18	14272579	14272854	LTR/ERVL-MaLR	972	+	138	14272717	35333
chr18	14237384	14437384	harbor1	chr18	14273010	14273752	LTR/ERVL-MaLR	5482	+	371	14273381	35997
chr18	14237384	14437384	harbor1	chr18	14273781	14274601	LTR/ERVL-MaLR	5482	+	410	14274191	36807
chr18	14237384	14437384	harbor1	chr18	14274846	14275192	LTR/ERVL-MaLR	1308	+	173	14275019	37635
chr18	14237384	14437384	harbor1	chr18	14275193	14275287	LTR/ERVL-MaLR	517	+	47	14275240	37856
chr18	14237384	14437384	harbor1	chr18	14275674	14275928	LTR/ERVL-MaLR	818	+	127	14275801	38417
chr18	14237384	14437384	harbor1	chr18	14276111	14277723	LTR/ERVL-MaLR	6083	+	806	14276917	39533
chr18	14237384	14437384	harbor1	chr18	14278056	14278397	LTR/ERVL-MaLR	1287	+	170	14278226	40842
chr18	14237384	14437384	harbor1	chr18	14278909	14279177	LTR/ERVL-MaLR	933	+	134	14279043	41659
chr18	14237384	14437384	harbor1	chr18	14279342	14280871	LTR/ERVL-MaLR	5267	+	764	14280106	42722
chr18	14237384	14437384	harbor1	chr18	14281329	14281676	LTR/ERVL-MaLR	1301	+	174	14281503	44119
chr18	14237384	14437384	harbor1	chr18	14281677	14281772	LTR/ERVL-MaLR	491	+	48	14281725	44341
chr18	14237384	14437384	harbor1	chr18	14282142	14282430	LTR/ERVL-MaLR	972	+	144	14282286	44902
chr18	14237384	14437384	harbor1	chr18	14282599	14284165	LTR/ERVL-MaLR	5967	+	783	14283382	45998
chr18	14237384	14437384	harbor1	chr18	14284438	14284549	LTR/ERVL-MaLR	589	+	56	14284494	47110
chr18	14237384	14437384	harbor1	chr18	14284799	14285115	LTR/ERVL-MaLR	983	+	158	14284957	47573
chr18	14237384	14437384	harbor1	chr18	14285602	14285908	LTR/ERVL-MaLR	783	+	153	14285755	48371
chr18	14237384	14437384	harbor1	chr18	14287858	14288192	LTR/ERVL-MaLR	1085	+	167	14288025	50641
chr18	14237384	14437384	harbor1	chr18	14288679	14288947	LTR/ERVL-MaLR	873	+	134	14288813	51429
chr18	14237384	14437384	harbor1	chr18	14289119	14290426	LTR/ERVL-MaLR	4617	+	654	14289773	52389
chr18	14237384	14437384	harbor1	chr18	14290423	14290538	LTR/ERVL-MaLR	529	+	58	14290481	53097
chr18	14237384	14437384	harbor1	chr18	14290785	14291117	LTR/ERVL-MaLR	1216	+	166	14290951	53567
chr18	14237384	14437384	harbor1	chr18	14292155	14292438	LTR/ERVL-MaLR	904	+	142	14292297	54913
chr18	14237384	14437384	harbor1	chr18	14292594	14293336	LTR/ERVL-MaLR	5275	+	371	14292965	55581
chr18	14237384	14437384	harbor1	chr18	14293371	14294188	LTR/ERVL-MaLR	5275	+	408	14293779	56395
chr18	14237384	14437384	harbor1	chr18	14294432	14294777	LTR/ERVL-MaLR	1255	+	172	14294604	57220
chr18	14237384	14437384	harbor1	chr18	14294778	14294872	LTR/ERVL-MaLR	502	+	47	14294825	57441
chr18	14237384	14437384	harbor1	chr18	14295269	14295524	LTR/ERVL-MaLR	857	+	128	14295397	58013
chr18	14237384	14437384	harbor1	chr18	14295700	14297315	LTR/ERVL-MaLR	5814	+	808	14296508	59124
chr18	14237384	14437384	harbor1	chr18	14297589	14297924	LTR/ERVL-MaLR	1375	+	168	14297757	60373
chr18	14237384	14437384	harbor1	chr18	14298442	14298708	LTR/ERVL-MaLR	1052	+	133	14298575	61191
chr18	14237384	14437384	harbor1	chr18	14298874	14300405	LTR/ERVL-MaLR	5004	+	766	14299640	62256
chr18	14237384	14437384	harbor1	chr18	14300864	14301211	LTR/ERVL-MaLR	1365	+	174	14301038	63654
chr18	14237384	14437384	harbor1	chr18	14301212	14301307	LTR/ERVL-MaLR	491	+	48	14301260	63876
chr18	14237384	14437384	harbor1	chr18	14301678	14301965	LTR/ERVL-MaLR	857	+	144	14301822	64438
chr18	14237384	14437384	harbor1	chr18	14303950	14304060	LTR/ERVL-MaLR	529	+	55	14304005	66621
chr18	14237384	14437384	harbor1	chr18	14304310	14304627	LTR/ERVL-MaLR	1060	+	158	14304468	67084
chr18	14237384	14437384	harbor1	chr18	14305135	14305410	LTR/ERVL-MaLR	832	+	138	14305273	67889
chr18	14237384	14437384	harbor1	chr18	14305579	14306849	LTR/ERVL-MaLR	4390	+	635	14306214	68830
chr18	14237384	14437384	harbor1	chr18	14307208	14307429	LTR/ERVL-MaLR	601	+	110	14307318	69934
chr18	14237384	14437384	harbor1	chr18	14308508	14308783	LTR/ERVL-MaLR	849	+	138	14308646	71262
chr18	14237384	14437384	harbor1	chr18	14308939	14309681	LTR/ERVL-MaLR	5217	+	371	14309310	71926
chr18	14237384	14437384	harbor1	chr18	14309709	14310530	LTR/ERVL-MaLR	5217	+	410	14310119	72735
chr18	14237384	14437384	harbor1	chr18	14310775	14311121	LTR/ERVL-MaLR	1335	+	173	14310948	73564
chr18	14237384	14437384	harbor1	chr18	14311614	14311869	LTR/ERVL-MaLR	788	+	128	14311742	74358
chr18	14237384	14437384	harbor1	chr18	14312049	14313663	LTR/ERVL-MaLR	5748	+	807	14312856	75472
chr18	14237384	14437384	harbor1	chr18	14313937	14314277	LTR/ERVL-MaLR	1323	+	170	14314107	76723
chr18	14237384	14437384	harbor1	chr18	14314284	14314380	LTR/ERVL-MaLR	488	+	48	14314332	76948
chr18	14237384	14437384	harbor1	chr18	14314788	14315054	LTR/ERVL-MaLR	1033	+	133	14314921	77537
chr18	14237384	14437384	harbor1	chr18	14315219	14316748	LTR/ERVL-MaLR	5267	+	764	14315983	78599
chr18	14237384	14437384	harbor1	chr18	14317206	14317553	LTR/ERVL-MaLR	1296	+	174	14317380	79996
chr18	14237384	14437384	harbor1	chr18	14318028	14318311	LTR/ERVL-MaLR	808	+	142	14318170	80786
chr18	14237384	14437384	harbor1	chr18	14320637	14320954	LTR/ERVL-MaLR	1131	+	158	14320795	83411
chr18	14237384	14437384	harbor1	chr18	14321460	14321734	LTR/ERVL-MaLR	737	+	137	14321597	84213
chr18	14237384	14437384	harbor1	chr18	14321915	14322105	LTR/ERVL-MaLR	785	+	95	14322010	84626
chr18	14237384	14437384	harbor1	chr18	14322113	14323269	LTR/ERVL-MaLR	4291	+	578	14322691	85307
chr18	14237384	14437384	harbor1	chr18	14323513	14323849	LTR/ERVL-MaLR	1149	+	168	14323681	86297
chr18	14237384	14437384	harbor1	chr18	14324318	14324602	LTR/ERVL-MaLR	874	+	142	14324460	87076
chr18	14237384	14437384	harbor1	chr18	14324768	14326074	LTR/ERVL-MaLR	4521	+	653	14325421	88037
chr18	14237384	14437384	harbor1	chr18	14326071	14326186	LTR/ERVL-MaLR	487	+	58	14326129	88745
chr18	14237384	14437384	harbor1	chr18	14326433	14326765	LTR/ERVL-MaLR	1199	+	166	14326599	89215
chr18	14237384	14437384	harbor1	chr18	14327811	14328092	LTR/ERVL-MaLR	914	+	140	14327951	90567
chr18	14237384	14437384	harbor1	chr18	14328248	14328986	LTR/ERVL-MaLR	5289	+	369	14328617	91233
chr18	14237384	14437384	harbor1	chr18	14329015	14329837	LTR/ERVL-MaLR	5289	+	411	14329426	92042
chr18	14237384	14437384	harbor1	chr18	14330081	14330427	LTR/ERVL-MaLR	1345	+	173	14330254	92870
chr18	14237384	14437384	harbor1	chr18	14330907	14331173	LTR/ERVL-MaLR	815	+	133	14331040	93656
chr18	14237384	14437384	harbor1	chr18	14331352	14332117	LTR/ERVL-MaLR	5560	+	382	14331734	94350
chr18	14237384	14437384	harbor1	chr18	14332146	14332967	LTR/ERVL-MaLR	5560	+	410	14332556	95172
chr18	14237384	14437384	harbor1	chr18	14333210	14333522	LTR/ERVL-MaLR	1093	+	156	14333366	95982
chr18	14237384	14437384	harbor1	chr18	14269532	14270833	LTR/ERVL-MaLR	4774	+	650	14270182	32798
chr18	14237384	14437384	harbor1	chr18	14302134	14303704	LTR/ERVL-MaLR	6027	+	785	14302919	65535
chr18	14237384	14437384	harbor1	chr18	14318484	14320054	LTR/ERVL-MaLR	5532	+	785	14319269	81885
chr18	14237384	14437384	harbor1	chr18	14286065	14287607	LTR/ERVL-MaLR	5610	+	771	14286836	49452
chr18	26126376	26326376	harbor1	chr18	26127858	26128163	LTR/ERVL-MaLR	2274	+	152	26128010	1634
chr18	26126376	26326376	harbor1	chr18	26128682	26128778	LTR/ERVL-MaLR	2274	+	48	26128730	2354
chr18	26126376	26326376	harbor1	chr18	26138992	26139500	LTR/ERVL-MaLR	2203	+	254	26139246	12870
chr18	26126376	26326376	harbor1	chr18	26152650	26153027	LTR/ERVL-MaLR	1370	+	188	26152838	26462
chr18	26126376	26326376	harbor1	chr18	26167484	26167852	LTR/ERVL-MaLR	1331	+	184	26167668	41292
chr18	59165767	59365767	harbor1	chr18	59192103	59192238	LTR/ERVL-MaLR	685	+	68	59192171	26404
chr18	59165767	59365767	harbor1	chr18	59192289	59192658	LTR/ERVL-MaLR	1669	+	184	59192473	26706
chr18	78209693	78409693	harbor1	chr18	78266596	78266917	LTR/ERVL-MaLR	837	+	160	78266756	57063
chr19	43523586	43723586	harbor1	chr19	43538664	43539103	LTR/ERVL-MaLR	2028	+	220	43538884	15298
chr19	43523586	43723586	harbor1	chr19	43541218	43541270	LTR/ERVL-MaLR	1513	+	26	43541244	17658
chr19	43523586	43723586	harbor1	chr19	43541535	43541863	LTR/ERVL-MaLR	1513	+	164	43541699	18113
chr19	43523586	43723586	harbor1	chr19	43559627	43559797	LTR/ERVL-MaLR	2217	+	85	43559712	36126
chr19	43523586	43723586	harbor1	chr19	43560430	43560697	LTR/ERVL-MaLR	2217	+	134	43560564	36978
chr19	43523586	43723586	harbor1	chr19	43600872	43601115	LTR/ERVL-MaLR	689	+	122	43600994	77408
chr19	43523586	43723586	harbor1	chr19	43602771	43603192	LTR/ERVL-MaLR	2005	+	210	43602981	79395
chr19	10171339	10371339	harbor1	chr19	10188545	10189074	LTR/ERVL-MaLR	1788	+	264	10188809	17470
chr19	10171339	10371339	harbor1	chr19	10207088	10207548	LTR/ERVL-MaLR	1487	+	230	10207318	35979
chr19	49751331	49951331	harbor1	chr19	49752406	49752605	LTR/ERVL-MaLR	867	+	100	49752506	1175
chr19	49751331	49951331	harbor1	chr19	49756657	49756777	LTR/ERVL-MaLR	1088	+	60	49756717	5386
chr19	49751331	49951331	harbor1	chr19	49757079	49757413	LTR/ERVL-MaLR	1088	+	167	49757246	5915
chr19	5521747	5721747	harbor1	chr19	5585185	5585442	LTR/ERVL-MaLR	789	+	128	5585313	63566
chr19	10503315	10703315	harbor1	chr19	10507437	10507624	LTR/ERVL-MaLR	1387	+	94	10507531	4216
chr19	10503315	10703315	harbor1	chr19	10507923	10508021	LTR/ERVL-MaLR	1387	+	49	10507972	4657
chr19	10503315	10703315	harbor1	chr19	10508630	10508744	LTR/ERVL-MaLR	1387	+	57	10508687	5372
chr19	10503315	10703315	harbor1	chr19	10532363	10532718	LTR/ERVL-MaLR	711	+	178	10532541	29226
chr19	9986281	10186281	harbor1	chr19	10083197	10083550	LTR/ERVL-MaLR	1198	+	176	10083373	97092
chr19	2663306	2863306	harbor1	chr19	2663180	2663556	LTR/ERVL-MaLR	1207	+	188	2663368	62
chr19	2663306	2863306	harbor1	chr19	2675895	2676290	LTR/ERVL-MaLR	1392	+	198	2676093	12787
chr19	2663306	2863306	harbor1	chr19	2691889	2692142	LTR/ERVL-MaLR	701	+	126	2692015	28709
chr19	2663306	2863306	harbor1	chr19	2712103	2712455	LTR/ERVL-MaLR	1621	+	176	2712279	48973
chr19	2663306	2863306	harbor1	chr19	2715362	2715715	LTR/ERVL-MaLR	1174	+	176	2715538	52232
chr19	2663306	2863306	harbor1	chr19	2736180	2736725	LTR/ERVL-MaLR	1371	+	272	2736452	73146
chr19	2663306	2863306	harbor1	chr19	2741026	2741374	LTR/ERVL-MaLR	979	+	174	2741200	77894
chr19	2663306	2863306	harbor1	chr19	2741687	2741792	LTR/ERVL-MaLR	979	+	52	2741739	78433
chr19	2663306	2863306	harbor1	chr19	2742069	2742121	LTR/ERVL-MaLR	979	+	26	2742095	78789
chr19	5521868	5721868	harbor1	chr19	5585185	5585442	LTR/ERVL-MaLR	789	+	128	5585313	63445
chr19	5521752	5721752	harbor1	chr19	5585185	5585442	LTR/ERVL-MaLR	789	+	128	5585313	63561
chr19	5523072	5723072	harbor1	chr19	5585185	5585442	LTR/ERVL-MaLR	789	+	128	5585313	62241
chr19	5522548	5722548	harbor1	chr19	5585185	5585442	LTR/ERVL-MaLR	789	+	128	5585313	62765
chr19	5522869	5722869	harbor1	chr19	5585185	5585442	LTR/ERVL-MaLR	789	+	128	5585313	62444
chr19	5521916	5721916	harbor1	chr19	5585185	5585442	LTR/ERVL-MaLR	789	+	128	5585313	63397
chr19	5522558	5722558	harbor1	chr19	5585185	5585442	LTR/ERVL-MaLR	789	+	128	5585313	62755
chr19	5523054	5723054	harbor1	chr19	5585185	5585442	LTR/ERVL-MaLR	789	+	128	5585313	62259
chr19	49751338	49951338	harbor1	chr19	49752406	49752605	LTR/ERVL-MaLR	867	+	100	49752506	1168
chr19	49751338	49951338	harbor1	chr19	49756657	49756777	LTR/ERVL-MaLR	1088	+	60	49756717	5379
chr19	49751338	49951338	harbor1	chr19	49757079	49757413	LTR/ERVL-MaLR	1088	+	167	49757246	5908
chr19	34913533	35113533	harbor1	chr19	34948361	34948773	LTR/ERVL-MaLR	996	+	206	34948567	35034
chr19	34913533	35113533	harbor1	chr19	34983822	34984203	LTR/ERVL-MaLR	1109	+	190	34984012	70479
chr19	34913533	35113533	harbor1	chr19	34987241	34987343	LTR/ERVL-MaLR	1354	+	51	34987292	73759
chr19	34913533	35113533	harbor1	chr19	34987665	34988008	LTR/ERVL-MaLR	1354	+	172	34987837	74304
chr19	393525	593525	harbor1	chr19	419289	419714	LTR/ERVL-MaLR	832	+	212	419501	25976
chr19	393525	593525	harbor1	chr19	445164	445450	LTR/ERVL-MaLR	1334	+	143	445307	51782
chr19	5521188	5721188	harbor1	chr19	5585185	5585442	LTR/ERVL-MaLR	789	+	128	5585313	64125
chr19	58287222	58487222	harbor1	chr19	58293598	58293843	LTR/ERVL-MaLR	923	+	122	58293720	6498
chr19	58287222	58487222	harbor1	chr19	58323557	58323888	LTR/ERVL-MaLR	2348	+	166	58323723	36501
chr19	58287222	58487222	harbor1	chr19	58324206	58324284	LTR/ERVL-MaLR	2348	+	39	58324245	37023
chr19	58287222	58487222	harbor1	chr19	58365165	58365396	LTR/ERVL-MaLR	689	+	116	58365281	78059
chr19	58287222	58487222	harbor1	chr19	58378659	58379068	LTR/ERVL-MaLR	1296	+	204	58378863	91641
chr19	46920081	47120081	harbor1	chr19	46954031	46954258	LTR/ERVL-MaLR	931	+	114	46954145	34064
chr19	58378212	58578212	harbor1	chr19	58378659	58379068	LTR/ERVL-MaLR	1296	+	204	58378863	651
chr19	58378212	58578212	harbor1	chr19	58429888	58430426	LTR/ERVL-MaLR	2297	+	269	58430157	51945
chr19	58378212	58578212	harbor1	chr19	58447732	58448091	LTR/ERVL-MaLR	2225	+	180	58447912	69700
chr19	58378212	58578212	harbor1	chr19	58448092	58448444	LTR/ERVL-MaLR	11447	+	176	58448268	70056
chr19	58378212	58578212	harbor1	chr19	58448751	58449956	LTR/ERVL-MaLR	11447	+	602	58449353	71141
chr19	58378212	58578212	harbor1	chr19	58449957	58450319	LTR/ERVL-MaLR	2232	+	181	58450138	71926
chr19	58378212	58578212	harbor1	chr19	58459523	58459919	LTR/ERVL-MaLR	2407	+	198	58459721	81509
chr19	36428193	36628193	harbor1	chr19	36430591	36430752	LTR/ERVL-MaLR	1759	+	80	36430671	2478
chr19	36428193	36628193	harbor1	chr19	36431055	36431310	LTR/ERVL-MaLR	1759	+	128	36431183	2990
chr19	3444890	3644890	harbor1	chr19	3487384	3487529	LTR/ERVL-MaLR	704	+	72	3487456	42566
chr19	3444890	3644890	harbor1	chr19	3497209	3497626	LTR/ERVL-MaLR	1278	+	208	3497417	52527
chr19	3444890	3644890	harbor1	chr19	3497931	3497971	LTR/ERVL-MaLR	1278	+	20	3497951	53061
chr19	45368712	45568712	harbor1	chr19	45391471	45391813	LTR/ERVL-MaLR	813	+	171	45391642	22930
chr19	5518790	5718790	harbor1	chr19	5585185	5585442	LTR/ERVL-MaLR	789	+	128	5585313	66523
chr19	4570336	4770336	harbor1	chr19	4652842	4653023	LTR/ERVL-MaLR	777	+	90	4652932	82596
chr19	49746065	49946065	harbor1	chr19	49749461	49749615	LTR/ERVL-MaLR	724	+	77	49749538	3473
chr19	49746065	49946065	harbor1	chr19	49752406	49752605	LTR/ERVL-MaLR	867	+	100	49752506	6441
chr19	49746065	49946065	harbor1	chr19	49756657	49756777	LTR/ERVL-MaLR	1088	+	60	49756717	10652
chr19	49746065	49946065	harbor1	chr19	49757079	49757413	LTR/ERVL-MaLR	1088	+	167	49757246	11181
chr19	49751511	49951511	harbor1	chr19	49752406	49752605	LTR/ERVL-MaLR	867	+	100	49752506	995
chr19	49751511	49951511	harbor1	chr19	49756657	49756777	LTR/ERVL-MaLR	1088	+	60	49756717	5206
chr19	49751511	49951511	harbor1	chr19	49757079	49757413	LTR/ERVL-MaLR	1088	+	167	49757246	5735
chr19	5482378	5682378	harbor1	chr19	5486595	5486812	LTR/ERVL-MaLR	762	+	108	5486703	4325
chr19	5482378	5682378	harbor1	chr19	5501454	5501694	LTR/ERVL-MaLR	944	+	120	5501574	19196
chr19	5482378	5682378	harbor1	chr19	5502203	5502439	LTR/ERVL-MaLR	1202	+	118	5502321	19943
chr19	5482378	5682378	harbor1	chr19	5513852	5514075	LTR/ERVL-MaLR	1249	+	112	5513964	31586
chr19	5482378	5682378	harbor1	chr19	5504873	5505178	LTR/ERVL-MaLR	1099	+	152	5505025	22647
chr19	5522544	5722544	harbor1	chr19	5585185	5585442	LTR/ERVL-MaLR	789	+	128	5585313	62769
chr19	5521887	5721887	harbor1	chr19	5585185	5585442	LTR/ERVL-MaLR	789	+	128	5585313	63426
chr19	5521182	5721182	harbor1	chr19	5585185	5585442	LTR/ERVL-MaLR	789	+	128	5585313	64131
chr19	49751471	49951471	harbor1	chr19	49752406	49752605	LTR/ERVL-MaLR	867	+	100	49752506	1035
chr19	49751471	49951471	harbor1	chr19	49756657	49756777	LTR/ERVL-MaLR	1088	+	60	49756717	5246
chr19	49751471	49951471	harbor1	chr19	49757079	49757413	LTR/ERVL-MaLR	1088	+	167	49757246	5775
chr19	51494378	51694378	harbor1	chr19	51503819	51504242	LTR/ERVL-MaLR	2582	+	212	51504031	9653
chr19	51494378	51694378	harbor1	chr19	51504243	51504814	LTR/ERVL-MaLR	3419	+	286	51504529	10151
chr19	51494378	51694378	harbor1	chr19	51506078	51506576	LTR/ERVL-MaLR	2785	+	249	51506327	11949
chr19	51494378	51694378	harbor1	chr19	51506578	51506958	LTR/ERVL-MaLR	2004	+	190	51506768	12390
chr19	51494378	51694378	harbor1	chr19	51507167	51507417	LTR/ERVL-MaLR	1024	+	125	51507292	12914
chr19	51494378	51694378	harbor1	chr19	51519649	51520030	LTR/ERVL-MaLR	2234	+	190	51519839	25461
chr19	51494378	51694378	harbor1	chr19	51528517	51528700	LTR/ERVL-MaLR	2496	+	92	51528609	34231
chr19	51494378	51694378	harbor1	chr19	51529026	51529312	LTR/ERVL-MaLR	2496	+	143	51529169	34791
chr19	3434558	3634558	harbor1	chr19	3487384	3487529	LTR/ERVL-MaLR	704	+	72	3487456	52898
chr19	3434558	3634558	harbor1	chr19	3497209	3497626	LTR/ERVL-MaLR	1278	+	208	3497417	62859
chr19	3434558	3634558	harbor1	chr19	3497931	3497971	LTR/ERVL-MaLR	1278	+	20	3497951	63393
chr19	49288352	49488352	harbor1	chr19	49287766	49289334	LTR/ERVL-MaLR	11924	+	784	49288550	198
chr19	49288352	49488352	harbor1	chr19	49289335	49289688	LTR/ERVL-MaLR	2569	+	176	49289511	1159
chr19	49288352	49488352	harbor1	chr19	49304991	49305309	LTR/ERVL-MaLR	759	+	159	49305150	16798
chr19	49288352	49488352	harbor1	chr19	49305620	49305810	LTR/ERVL-MaLR	759	+	95	49305715	17363
chr19	49288352	49488352	harbor1	chr19	49328630	49329100	LTR/ERVL-MaLR	2136	+	235	49328865	40513
chr19	49288352	49488352	harbor1	chr19	49329384	49329451	LTR/ERVL-MaLR	2136	+	34	49329418	41066
chr19	49288352	49488352	harbor1	chr19	49347878	49348278	LTR/ERVL-MaLR	1457	+	200	49348078	59726
chr19	49288352	49488352	harbor1	chr19	49348918	49349127	LTR/ERVL-MaLR	727	+	104	49349022	60670
chr19	49288352	49488352	harbor1	chr19	49349128	49349182	LTR/ERVL-MaLR	2449	+	27	49349155	60803
chr19	49288352	49488352	harbor1	chr19	49349479	49349841	LTR/ERVL-MaLR	2449	+	181	49349660	61308
chr19	49288352	49488352	harbor1	chr19	49349842	49350059	LTR/ERVL-MaLR	727	+	108	49349950	61598
chr19	49288352	49488352	harbor1	chr19	49350060	49350309	LTR/ERVL-MaLR	847	+	124	49350184	61832
chr19	49288352	49488352	harbor1	chr19	49350632	49350713	LTR/ERVL-MaLR	847	+	40	49350672	62320
chr19	49288352	49488352	harbor1	chr19	49357636	49357815	LTR/ERVL-MaLR	2345	+	90	49357726	69374
chr19	49288352	49488352	harbor1	chr19	49358436	49358621	LTR/ERVL-MaLR	2345	+	92	49358528	70176
chr19	49288352	49488352	harbor1	chr19	49358921	49358948	LTR/ERVL-MaLR	2345	+	14	49358935	70583
chr19	49288352	49488352	harbor1	chr19	49359252	49359308	LTR/ERVL-MaLR	2345	+	28	49359280	70928
chr19	19564047	19764047	harbor1	chr19	19579357	19579405	LTR/ERVL-MaLR	1634	+	24	19579381	15334
chr19	19564047	19764047	harbor1	chr19	19601454	19601865	LTR/ERVL-MaLR	1386	+	206	19601660	37613
chr19	19564047	19764047	harbor1	chr19	19606089	19606607	LTR/ERVL-MaLR	1612	+	259	19606348	42301
chr19	19564047	19764047	harbor1	chr19	19578730	19579068	LTR/ERVL-MaLR	1634	+	169	19578899	14852
chr19	5522872	5722872	harbor1	chr19	5585185	5585442	LTR/ERVL-MaLR	789	+	128	5585313	62441
chr19	7816850	8016850	harbor1	chr19	7819202	7819827	LTR/ERVL-MaLR	2302	+	312	7819514	2664
chr19	48773840	48973840	harbor1	chr19	48777848	48777985	LTR/ERVL-MaLR	1359	+	68	48777916	4076
chr19	48773840	48973840	harbor1	chr19	48778574	48778773	LTR/ERVL-MaLR	1359	+	100	48778674	4834
chr19	48773840	48973840	harbor1	chr19	48779085	48779211	LTR/ERVL-MaLR	1359	+	63	48779148	5308
chr19	48773840	48973840	harbor1	chr19	48857009	48857297	LTR/ERVL-MaLR	770	+	144	48857153	83313
chr19	18646400	18846400	harbor1	chr19	18722324	18722608	LTR/ERVL-MaLR	782	+	142	18722466	76066
chr19	18646400	18846400	harbor1	chr19	18726484	18726645	LTR/ERVL-MaLR	925	+	80	18726564	80164
chr19	18646400	18846400	harbor1	chr19	18727267	18727299	LTR/ERVL-MaLR	925	+	16	18727283	80883
chr19	18646400	18846400	harbor1	chr19	18727608	18727717	LTR/ERVL-MaLR	925	+	54	18727662	81262
chr19	18646400	18846400	harbor1	chr19	18728026	18728128	LTR/ERVL-MaLR	925	+	51	18728077	81677
chr19	18646400	18846400	harbor1	chr19	18732156	18732549	LTR/ERVL-MaLR	1049	+	196	18732352	85952
chr19	5523021	5723021	harbor1	chr19	5585185	5585442	LTR/ERVL-MaLR	789	+	128	5585313	62292
chr19	49751494	49951494	harbor1	chr19	49752406	49752605	LTR/ERVL-MaLR	867	+	100	49752506	1012
chr19	49751494	49951494	harbor1	chr19	49756657	49756777	LTR/ERVL-MaLR	1088	+	60	49756717	5223
chr19	49751494	49951494	harbor1	chr19	49757079	49757413	LTR/ERVL-MaLR	1088	+	167	49757246	5752
chr19	32305870	32505870	harbor1	chr19	32338666	32339047	LTR/ERVL-MaLR	2073	+	190	32338856	32986
chr19	10579276	10779276	harbor1	chr19	10613676	10613953	LTR/ERVL-MaLR	1537	+	138	10613814	34538
chr19	10579276	10779276	harbor1	chr19	10614267	10614335	LTR/ERVL-MaLR	1537	+	34	10614301	35025
chr19	5522534	5722534	harbor1	chr19	5585185	5585442	LTR/ERVL-MaLR	789	+	128	5585313	62779
chr19	18959517	19159517	harbor1	chr19	19008498	19008880	LTR/ERVL-MaLR	900	+	191	19008689	49172
chr19	49751348	49951348	harbor1	chr19	49752406	49752605	LTR/ERVL-MaLR	867	+	100	49752506	1158
chr19	49751348	49951348	harbor1	chr19	49756657	49756777	LTR/ERVL-MaLR	1088	+	60	49756717	5369
chr19	49751348	49951348	harbor1	chr19	49757079	49757413	LTR/ERVL-MaLR	1088	+	167	49757246	5898
chr19	16427350	16627350	harbor1	chr19	16523553	16523896	LTR/ERVL-MaLR	1244	+	172	16523725	96375
chr19	3456907	3656907	harbor1	chr19	3487384	3487529	LTR/ERVL-MaLR	704	+	72	3487456	30549
chr19	3456907	3656907	harbor1	chr19	3497209	3497626	LTR/ERVL-MaLR	1278	+	208	3497417	40510
chr19	3456907	3656907	harbor1	chr19	3497931	3497971	LTR/ERVL-MaLR	1278	+	20	3497951	41044
chr19	19534101	19734101	harbor1	chr19	19579357	19579405	LTR/ERVL-MaLR	1634	+	24	19579381	45280
chr19	19534101	19734101	harbor1	chr19	19601454	19601865	LTR/ERVL-MaLR	1386	+	206	19601660	67559
chr19	19534101	19734101	harbor1	chr19	19606089	19606607	LTR/ERVL-MaLR	1612	+	259	19606348	72247
chr19	19534101	19734101	harbor1	chr19	19578730	19579068	LTR/ERVL-MaLR	1634	+	169	19578899	44798
chr19	10601630	10801630	harbor1	chr19	10613676	10613953	LTR/ERVL-MaLR	1537	+	138	10613814	12184
chr19	10601630	10801630	harbor1	chr19	10614267	10614335	LTR/ERVL-MaLR	1537	+	34	10614301	12671
chr19	5521937	5721937	harbor1	chr19	5585185	5585442	LTR/ERVL-MaLR	789	+	128	5585313	63376
chr19	19563666	19763666	harbor1	chr19	19579357	19579405	LTR/ERVL-MaLR	1634	+	24	19579381	15715
chr19	19563666	19763666	harbor1	chr19	19601454	19601865	LTR/ERVL-MaLR	1386	+	206	19601660	37994
chr19	19563666	19763666	harbor1	chr19	19606089	19606607	LTR/ERVL-MaLR	1612	+	259	19606348	42682
chr19	19563666	19763666	harbor1	chr19	19578730	19579068	LTR/ERVL-MaLR	1634	+	169	19578899	15233
chr19	55244734	55444734	harbor1	chr19	55274656	55275042	LTR/ERVL-MaLR	2222	+	193	55274849	30115
chr19	55244734	55444734	harbor1	chr19	55334658	55334817	LTR/ERVL-MaLR	877	+	80	55334738	90004
chr19	49751354	49951354	harbor1	chr19	49752406	49752605	LTR/ERVL-MaLR	867	+	100	49752506	1152
chr19	49751354	49951354	harbor1	chr19	49756657	49756777	LTR/ERVL-MaLR	1088	+	60	49756717	5363
chr19	49751354	49951354	harbor1	chr19	49757079	49757413	LTR/ERVL-MaLR	1088	+	167	49757246	5892
chr19	5516398	5716398	harbor1	chr19	5585185	5585442	LTR/ERVL-MaLR	789	+	128	5585313	68915
chr19	15192050	15392050	harbor1	chr19	15194301	15194524	LTR/ERVL-MaLR	779	+	112	15194413	2363
chr19	57140991	57340991	harbor1	chr19	57179740	57180097	LTR/ERVL-MaLR	1974	+	178	57179918	38927
chr19	57140991	57340991	harbor1	chr19	57204348	57204683	LTR/ERVL-MaLR	2272	+	168	57204516	63525
chr19	2877622	3077622	harbor1	chr19	2949207	2949353	LTR/ERVL-MaLR	666	+	73	2949280	71658
chr19	2877622	3077622	harbor1	chr19	2969098	2969410	LTR/ERVL-MaLR	1053	+	156	2969254	91632
chr19	5521960	5721960	harbor1	chr19	5585185	5585442	LTR/ERVL-MaLR	789	+	128	5585313	63353
chr19	10192832	10392832	harbor1	chr19	10207088	10207548	LTR/ERVL-MaLR	1487	+	230	10207318	14486
chr19	5523053	5723053	harbor1	chr19	5585185	5585442	LTR/ERVL-MaLR	789	+	128	5585313	62260
chr19	19563642	19763642	harbor1	chr19	19579357	19579405	LTR/ERVL-MaLR	1634	+	24	19579381	15739
chr19	19563642	19763642	harbor1	chr19	19601454	19601865	LTR/ERVL-MaLR	1386	+	206	19601660	38018
chr19	19563642	19763642	harbor1	chr19	19606089	19606607	LTR/ERVL-MaLR	1612	+	259	19606348	42706
chr19	19563642	19763642	harbor1	chr19	19578730	19579068	LTR/ERVL-MaLR	1634	+	169	19578899	15257
chr19	5521766	5721766	harbor1	chr19	5585185	5585442	LTR/ERVL-MaLR	789	+	128	5585313	63547
chr19	2663252	2863252	harbor1	chr19	2663180	2663556	LTR/ERVL-MaLR	1207	+	188	2663368	116
chr19	2663252	2863252	harbor1	chr19	2675895	2676290	LTR/ERVL-MaLR	1392	+	198	2676093	12841
chr19	2663252	2863252	harbor1	chr19	2691889	2692142	LTR/ERVL-MaLR	701	+	126	2692015	28763
chr19	2663252	2863252	harbor1	chr19	2712103	2712455	LTR/ERVL-MaLR	1621	+	176	2712279	49027
chr19	2663252	2863252	harbor1	chr19	2715362	2715715	LTR/ERVL-MaLR	1174	+	176	2715538	52286
chr19	2663252	2863252	harbor1	chr19	2736180	2736725	LTR/ERVL-MaLR	1371	+	272	2736452	73200
chr19	2663252	2863252	harbor1	chr19	2741026	2741374	LTR/ERVL-MaLR	979	+	174	2741200	77948
chr19	2663252	2863252	harbor1	chr19	2741687	2741792	LTR/ERVL-MaLR	979	+	52	2741739	78487
chr19	2663252	2863252	harbor1	chr19	2742069	2742121	LTR/ERVL-MaLR	979	+	26	2742095	78843
chr19	12569674	12769674	harbor1	chr19	12574041	12574311	LTR/ERVL-MaLR	894	+	135	12574176	4502
chr19	12569674	12769674	harbor1	chr19	12651190	12651553	LTR/ERVL-MaLR	952	+	182	12651372	81698
chr19	12569674	12769674	harbor1	chr19	12660078	12660230	LTR/ERVL-MaLR	1615	+	76	12660154	90480
chr19	12569674	12769674	harbor1	chr19	12660519	12660752	LTR/ERVL-MaLR	1615	+	116	12660635	90961
chr19	12569674	12769674	harbor1	chr19	12661057	12661175	LTR/ERVL-MaLR	1615	+	59	12661116	91442
chr19	316480	516480	harbor1	chr19	330598	330858	LTR/ERVL-MaLR	791	+	130	330728	14248
chr19	316480	516480	harbor1	chr19	358825	359184	LTR/ERVL-MaLR	1274	+	180	359005	42525
chr19	316480	516480	harbor1	chr19	359491	359541	LTR/ERVL-MaLR	1274	+	25	359516	43036
chr19	316480	516480	harbor1	chr19	391593	392017	LTR/ERVL-MaLR	1186	+	212	391805	75325
chr19	5522885	5722885	harbor1	chr19	5585185	5585442	LTR/ERVL-MaLR	789	+	128	5585313	62428
chr19	16976180	17176180	harbor1	chr19	16982818	16983120	LTR/ERVL-MaLR	2144	+	151	16982969	6789
chr19	16976180	17176180	harbor1	chr19	16983430	16983506	LTR/ERVL-MaLR	2144	+	38	16983468	7288
chr19	16976180	17176180	harbor1	chr19	17053492	17053652	LTR/ERVL-MaLR	1082	+	80	17053572	77392
chr19	16976180	17176180	harbor1	chr19	17053957	17054258	LTR/ERVL-MaLR	1082	+	150	17054107	77927
chr19	16976180	17176180	harbor1	chr19	17057701	17058103	LTR/ERVL-MaLR	1395	+	201	17057902	81722
chr19	8046178	8246178	harbor1	chr19	8075899	8076234	LTR/ERVL-MaLR	1651	+	168	8076067	29889
chr19	8046178	8246178	harbor1	chr19	8101904	8102204	LTR/ERVL-MaLR	2518	+	150	8102054	55876
chr19	8046178	8246178	harbor1	chr19	8102518	8102587	LTR/ERVL-MaLR	2518	+	34	8102552	56374
chr19	8046178	8246178	harbor1	chr19	8112970	8113144	LTR/ERVL-MaLR	714	+	87	8113057	66879
chr19	8046178	8246178	harbor1	chr19	8113530	8113552	LTR/ERVL-MaLR	714	+	11	8113541	67363
chr19	8046178	8246178	harbor1	chr19	8114018	8114242	LTR/ERVL-MaLR	714	+	112	8114130	67952
chr19	8046178	8246178	harbor1	chr19	8130869	8131159	LTR/ERVL-MaLR	1436	+	145	8131014	84836
chr19	19563826	19763826	harbor1	chr19	19579357	19579405	LTR/ERVL-MaLR	1634	+	24	19579381	15555
chr19	19563826	19763826	harbor1	chr19	19601454	19601865	LTR/ERVL-MaLR	1386	+	206	19601660	37834
chr19	19563826	19763826	harbor1	chr19	19606089	19606607	LTR/ERVL-MaLR	1612	+	259	19606348	42522
chr19	19563826	19763826	harbor1	chr19	19578730	19579068	LTR/ERVL-MaLR	1634	+	169	19578899	15073
chr19	49751516	49951516	harbor1	chr19	49752406	49752605	LTR/ERVL-MaLR	867	+	100	49752506	990
chr19	49751516	49951516	harbor1	chr19	49756657	49756777	LTR/ERVL-MaLR	1088	+	60	49756717	5201
chr19	49751516	49951516	harbor1	chr19	49757079	49757413	LTR/ERVL-MaLR	1088	+	167	49757246	5730
chr19	57140995	57340995	harbor1	chr19	57179740	57180097	LTR/ERVL-MaLR	1974	+	178	57179918	38923
chr19	57140995	57340995	harbor1	chr19	57204348	57204683	LTR/ERVL-MaLR	2272	+	168	57204516	63521
chr19	7769829	7969829	harbor1	chr19	7775567	7775726	LTR/ERVL-MaLR	1647	+	80	7775647	5818
chr19	7769829	7969829	harbor1	chr19	7776007	7776265	LTR/ERVL-MaLR	1647	+	129	7776136	6307
chr19	7769829	7969829	harbor1	chr19	7811550	7811801	LTR/ERVL-MaLR	1284	+	126	7811676	41847
chr19	7769829	7969829	harbor1	chr19	7819202	7819827	LTR/ERVL-MaLR	2302	+	312	7819514	49685
chr19	19563766	19763766	harbor1	chr19	19579357	19579405	LTR/ERVL-MaLR	1634	+	24	19579381	15615
chr19	19563766	19763766	harbor1	chr19	19601454	19601865	LTR/ERVL-MaLR	1386	+	206	19601660	37894
chr19	19563766	19763766	harbor1	chr19	19606089	19606607	LTR/ERVL-MaLR	1612	+	259	19606348	42582
chr19	19563766	19763766	harbor1	chr19	19578730	19579068	LTR/ERVL-MaLR	1634	+	169	19578899	15133
chr19	1505446	1705446	harbor1	chr19	1597356	1597872	LTR/ERVL-MaLR	1480	+	258	1597614	92168
chr19	1505446	1705446	harbor1	chr19	1600132	1600206	LTR/ERVL-MaLR	1123	+	37	1600169	94723
chr19	1505446	1705446	harbor1	chr19	1600513	1600592	LTR/ERVL-MaLR	1123	+	40	1600553	95107
chr19	1505446	1705446	harbor1	chr19	1601185	1601320	LTR/ERVL-MaLR	1123	+	68	1601253	95807
chr19	1505446	1705446	harbor1	chr19	1601629	1601832	LTR/ERVL-MaLR	1123	+	102	1601731	96285
chr19	5522875	5722875	harbor1	chr19	5585185	5585442	LTR/ERVL-MaLR	789	+	128	5585313	62438
chr19	57091928	57291928	harbor1	chr19	57179740	57180097	LTR/ERVL-MaLR	1974	+	178	57179918	87990
chr19	2356877	2556877	harbor1	chr19	2380636	2380819	LTR/ERVL-MaLR	922	+	92	2380728	23851
chr19	2356877	2556877	harbor1	chr19	2388446	2388624	LTR/ERVL-MaLR	649	+	89	2388535	31658
chr19	2356877	2556877	harbor1	chr19	2388924	2388985	LTR/ERVL-MaLR	649	+	30	2388954	32077
chr19	49667530	49867530	harbor1	chr19	49716246	49716624	LTR/ERVL-MaLR	1951	+	189	49716435	48905
chr19	49667530	49867530	harbor1	chr19	49722335	49722638	LTR/ERVL-MaLR	1718	+	152	49722487	54957
chr19	49667530	49867530	harbor1	chr19	49749461	49749615	LTR/ERVL-MaLR	724	+	77	49749538	82008
chr19	49667530	49867530	harbor1	chr19	49752406	49752605	LTR/ERVL-MaLR	867	+	100	49752506	84976
chr19	49667530	49867530	harbor1	chr19	49756657	49756777	LTR/ERVL-MaLR	1088	+	60	49756717	89187
chr19	49667530	49867530	harbor1	chr19	49757079	49757413	LTR/ERVL-MaLR	1088	+	167	49757246	89716
chr19	19161220	19361220	harbor1	chr19	19186379	19186745	LTR/ERVL-MaLR	2408	+	183	19186562	25342
chr19	19161220	19361220	harbor1	chr19	19259855	19260143	LTR/ERVL-MaLR	698	+	144	19259999	98779
chr19	5486689	5686689	harbor1	chr19	5486595	5486812	LTR/ERVL-MaLR	762	+	108	5486703	14
chr19	5486689	5686689	harbor1	chr19	5501454	5501694	LTR/ERVL-MaLR	944	+	120	5501574	14885
chr19	5486689	5686689	harbor1	chr19	5502203	5502439	LTR/ERVL-MaLR	1202	+	118	5502321	15632
chr19	5486689	5686689	harbor1	chr19	5513852	5514075	LTR/ERVL-MaLR	1249	+	112	5513964	27275
chr19	5486689	5686689	harbor1	chr19	5585185	5585442	LTR/ERVL-MaLR	789	+	128	5585313	98624
chr19	5486689	5686689	harbor1	chr19	5504873	5505178	LTR/ERVL-MaLR	1099	+	152	5505025	18336
chr19	48094850	48294850	harbor1	chr19	48109199	48109266	LTR/ERVL-MaLR	942	+	34	48109233	14383
chr19	48094850	48294850	harbor1	chr19	48109572	48109644	LTR/ERVL-MaLR	942	+	36	48109608	14758
chr19	48094850	48294850	harbor1	chr19	48109949	48110066	LTR/ERVL-MaLR	942	+	58	48110007	15157
chr19	48094850	48294850	harbor1	chr19	48110376	48110462	LTR/ERVL-MaLR	942	+	43	48110419	15569
chr19	48094850	48294850	harbor1	chr19	48114367	48114770	LTR/ERVL-MaLR	1656	+	202	48114569	19719
chr19	48094850	48294850	harbor1	chr19	48118235	48118534	LTR/ERVL-MaLR	2106	+	150	48118385	23535
chr19	48094850	48294850	harbor1	chr19	48157855	48158237	LTR/ERVL-MaLR	2142	+	191	48158046	63196
chr19	48094850	48294850	harbor1	chr19	48159470	48159706	LTR/ERVL-MaLR	1652	+	118	48159588	64738
chr19	48094850	48294850	harbor1	chr19	48160017	48160247	LTR/ERVL-MaLR	1652	+	115	48160132	65282
chr19	48094850	48294850	harbor1	chr19	48164361	48164805	LTR/ERVL-MaLR	968	+	222	48164583	69733
chr19	48094850	48294850	harbor1	chr19	48165331	48165376	LTR/ERVL-MaLR	968	+	22	48165353	70503
chr19	49751358	49951358	harbor1	chr19	49752406	49752605	LTR/ERVL-MaLR	867	+	100	49752506	1148
chr19	49751358	49951358	harbor1	chr19	49756657	49756777	LTR/ERVL-MaLR	1088	+	60	49756717	5359
chr19	49751358	49951358	harbor1	chr19	49757079	49757413	LTR/ERVL-MaLR	1088	+	167	49757246	5888
chr19	5522557	5722557	harbor1	chr19	5585185	5585442	LTR/ERVL-MaLR	789	+	128	5585313	62756
chr19	41650420	41850420	harbor1	chr19	41673011	41673228	LTR/ERVL-MaLR	1043	+	108	41673119	22699
chr19	41650420	41850420	harbor1	chr19	41706122	41706519	LTR/ERVL-MaLR	2368	+	198	41706320	55900
chr19	3400978	3600978	harbor1	chr19	3487384	3487529	LTR/ERVL-MaLR	704	+	72	3487456	86478
chr19	3400978	3600978	harbor1	chr19	3497209	3497626	LTR/ERVL-MaLR	1278	+	208	3497417	96439
chr19	3400978	3600978	harbor1	chr19	3497931	3497971	LTR/ERVL-MaLR	1278	+	20	3497951	96973
chr19	2356934	2556934	harbor1	chr19	2380636	2380819	LTR/ERVL-MaLR	922	+	92	2380728	23794
chr19	2356934	2556934	harbor1	chr19	2388446	2388624	LTR/ERVL-MaLR	649	+	89	2388535	31601
chr19	2356934	2556934	harbor1	chr19	2388924	2388985	LTR/ERVL-MaLR	649	+	30	2388954	32020
chr19	5522878	5722878	harbor1	chr19	5585185	5585442	LTR/ERVL-MaLR	789	+	128	5585313	62435
chr19	9986298	10186298	harbor1	chr19	10083197	10083550	LTR/ERVL-MaLR	1198	+	176	10083373	97075
chr19	1505429	1705429	harbor1	chr19	1597356	1597872	LTR/ERVL-MaLR	1480	+	258	1597614	92185
chr19	1505429	1705429	harbor1	chr19	1600132	1600206	LTR/ERVL-MaLR	1123	+	37	1600169	94740
chr19	1505429	1705429	harbor1	chr19	1600513	1600592	LTR/ERVL-MaLR	1123	+	40	1600553	95124
chr19	1505429	1705429	harbor1	chr19	1601185	1601320	LTR/ERVL-MaLR	1123	+	68	1601253	95824
chr19	1505429	1705429	harbor1	chr19	1601629	1601832	LTR/ERVL-MaLR	1123	+	102	1601731	96302
chr19	49751409	49951409	harbor1	chr19	49752406	49752605	LTR/ERVL-MaLR	867	+	100	49752506	1097
chr19	49751409	49951409	harbor1	chr19	49756657	49756777	LTR/ERVL-MaLR	1088	+	60	49756717	5308
chr19	49751409	49951409	harbor1	chr19	49757079	49757413	LTR/ERVL-MaLR	1088	+	167	49757246	5837
chr19	2170342	2370342	harbor1	chr19	2234326	2234429	LTR/ERVL-MaLR	894	+	52	2234378	64036
chr19	2170342	2370342	harbor1	chr19	2235026	2235319	LTR/ERVL-MaLR	894	+	146	2235172	64830
chr19	44518410	44718410	harbor1	chr19	44531781	44532131	LTR/ERVL-MaLR	1281	+	175	44531956	13546
chr19	44518410	44718410	harbor1	chr19	44554958	44555279	LTR/ERVL-MaLR	1397	+	160	44555118	36708
chr19	44518410	44718410	harbor1	chr19	44555525	44555691	LTR/ERVL-MaLR	1397	+	83	44555608	37198
chr19	44518410	44718410	harbor1	chr19	44576484	44576663	LTR/ERVL-MaLR	939	+	90	44576574	58164
chr19	44518410	44718410	harbor1	chr19	44576963	44577227	LTR/ERVL-MaLR	939	+	132	44577095	58685
chr19	44518410	44718410	harbor1	chr19	44578932	44579123	LTR/ERVL-MaLR	2098	+	96	44579028	60618
chr19	44518410	44718410	harbor1	chr19	44579718	44579931	LTR/ERVL-MaLR	2098	+	106	44579824	61414
chr19	44518410	44718410	harbor1	chr19	44588556	44589012	LTR/ERVL-MaLR	957	+	228	44588784	70374
chr19	44518410	44718410	harbor1	chr19	44589710	44590120	LTR/ERVL-MaLR	2651	+	205	44589915	71505
chr19	44518410	44718410	harbor1	chr19	44593604	44593757	LTR/ERVL-MaLR	878	+	76	44593680	75270
chr19	44518410	44718410	harbor1	chr19	44599771	44600132	LTR/ERVL-MaLR	925	+	180	44599951	81541
chr19	49288353	49488353	harbor1	chr19	49287766	49289334	LTR/ERVL-MaLR	11924	+	784	49288550	197
chr19	49288353	49488353	harbor1	chr19	49289335	49289688	LTR/ERVL-MaLR	2569	+	176	49289511	1158
chr19	49288353	49488353	harbor1	chr19	49304991	49305309	LTR/ERVL-MaLR	759	+	159	49305150	16797
chr19	49288353	49488353	harbor1	chr19	49305620	49305810	LTR/ERVL-MaLR	759	+	95	49305715	17362
chr19	49288353	49488353	harbor1	chr19	49328630	49329100	LTR/ERVL-MaLR	2136	+	235	49328865	40512
chr19	49288353	49488353	harbor1	chr19	49329384	49329451	LTR/ERVL-MaLR	2136	+	34	49329418	41065
chr19	49288353	49488353	harbor1	chr19	49347878	49348278	LTR/ERVL-MaLR	1457	+	200	49348078	59725
chr19	49288353	49488353	harbor1	chr19	49348918	49349127	LTR/ERVL-MaLR	727	+	104	49349022	60669
chr19	49288353	49488353	harbor1	chr19	49349128	49349182	LTR/ERVL-MaLR	2449	+	27	49349155	60802
chr19	49288353	49488353	harbor1	chr19	49349479	49349841	LTR/ERVL-MaLR	2449	+	181	49349660	61307
chr19	49288353	49488353	harbor1	chr19	49349842	49350059	LTR/ERVL-MaLR	727	+	108	49349950	61597
chr19	49288353	49488353	harbor1	chr19	49350060	49350309	LTR/ERVL-MaLR	847	+	124	49350184	61831
chr19	49288353	49488353	harbor1	chr19	49350632	49350713	LTR/ERVL-MaLR	847	+	40	49350672	62319
chr19	49288353	49488353	harbor1	chr19	49357636	49357815	LTR/ERVL-MaLR	2345	+	90	49357726	69373
chr19	49288353	49488353	harbor1	chr19	49358436	49358621	LTR/ERVL-MaLR	2345	+	92	49358528	70175
chr19	49288353	49488353	harbor1	chr19	49358921	49358948	LTR/ERVL-MaLR	2345	+	14	49358935	70582
chr19	49288353	49488353	harbor1	chr19	49359252	49359308	LTR/ERVL-MaLR	2345	+	28	49359280	70927
chr19	7812837	8012837	harbor1	chr19	7819202	7819827	LTR/ERVL-MaLR	2302	+	312	7819514	6677
chr19	10043853	10243853	harbor1	chr19	10083197	10083550	LTR/ERVL-MaLR	1198	+	176	10083373	39520
chr19	11878930	12078930	harbor1	chr19	11919597	11919913	LTR/ERVL-MaLR	994	+	158	11919755	40825
chr19	11878930	12078930	harbor1	chr19	11961118	11961431	LTR/ERVL-MaLR	1111	+	156	11961274	82344
chr19	5521969	5721969	harbor1	chr19	5585185	5585442	LTR/ERVL-MaLR	789	+	128	5585313	63344
chr19	19564075	19764075	harbor1	chr19	19579357	19579405	LTR/ERVL-MaLR	1634	+	24	19579381	15306
chr19	19564075	19764075	harbor1	chr19	19601454	19601865	LTR/ERVL-MaLR	1386	+	206	19601660	37585
chr19	19564075	19764075	harbor1	chr19	19606089	19606607	LTR/ERVL-MaLR	1612	+	259	19606348	42273
chr19	19564075	19764075	harbor1	chr19	19578730	19579068	LTR/ERVL-MaLR	1634	+	169	19578899	14824
chr19	9575315	9775315	harbor1	chr19	9608566	9608881	LTR/ERVL-MaLR	736	+	158	9608724	33409
chr19	9575315	9775315	harbor1	chr19	9609377	9609612	LTR/ERVL-MaLR	949	+	118	9609495	34180
chr19	9575315	9775315	harbor1	chr19	9651079	9651441	LTR/ERVL-MaLR	1657	+	181	9651260	75945
chr19	9575315	9775315	harbor1	chr19	9651935	9652162	LTR/ERVL-MaLR	1657	+	114	9652049	76734
chr19	35529181	35729181	harbor1	chr19	35556398	35556839	LTR/ERVL-MaLR	1311	+	220	35556618	27437
chr19	35529181	35729181	harbor1	chr19	35608431	35608660	LTR/ERVL-MaLR	672	+	114	35608545	79364
chr19	5522547	5722547	harbor1	chr19	5585185	5585442	LTR/ERVL-MaLR	789	+	128	5585313	62766
chr19	57140996	57340996	harbor1	chr19	57179740	57180097	LTR/ERVL-MaLR	1974	+	178	57179918	38922
chr19	57140996	57340996	harbor1	chr19	57204348	57204683	LTR/ERVL-MaLR	2272	+	168	57204516	63520
chr19	1645781	1845781	harbor1	chr19	1695491	1695788	LTR/ERVL-MaLR	2405	+	148	1695639	49858
chr19	1645781	1845781	harbor1	chr19	1696098	1696167	LTR/ERVL-MaLR	2405	+	34	1696132	50351
chr19	4570478	4770478	harbor1	chr19	4652842	4653023	LTR/ERVL-MaLR	777	+	90	4652932	82454
chr19	15091758	15291758	harbor1	chr19	15104867	15105302	LTR/ERVL-MaLR	986	+	218	15105085	13327
chr19	15091758	15291758	harbor1	chr19	15118222	15118592	LTR/ERVL-MaLR	740	+	185	15118407	26649
chr19	15091758	15291758	harbor1	chr19	15133492	15133710	LTR/ERVL-MaLR	1053	+	109	15133601	41843
chr19	15091758	15291758	harbor1	chr19	15133760	15133842	LTR/ERVL-MaLR	1053	+	41	15133801	42043
chr19	15091758	15291758	harbor1	chr19	15134151	15134433	LTR/ERVL-MaLR	1053	+	141	15134292	42534
chr19	15091758	15291758	harbor1	chr19	15134743	15135006	LTR/ERVL-MaLR	1053	+	132	15134875	43117
chr19	15091758	15291758	harbor1	chr19	15135621	15135819	LTR/ERVL-MaLR	1053	+	99	15135720	43962
chr19	15091758	15291758	harbor1	chr19	15136117	15136233	LTR/ERVL-MaLR	1053	+	58	15136175	44417
chr19	15091758	15291758	harbor1	chr19	15136264	15136456	LTR/ERVL-MaLR	1053	+	96	15136360	44602
chr19	15091758	15291758	harbor1	chr19	15143899	15144325	LTR/ERVL-MaLR	2207	+	213	15144112	52354
chr19	15091758	15291758	harbor1	chr19	15166809	15166971	LTR/ERVL-MaLR	650	+	81	15166890	75132
chr19	15091758	15291758	harbor1	chr19	15169078	15169186	LTR/ERVL-MaLR	1305	+	54	15169132	77374
chr19	15091758	15291758	harbor1	chr19	15169231	15169409	LTR/ERVL-MaLR	1305	+	89	15169320	77562
chr19	15091758	15291758	harbor1	chr19	15169617	15169656	LTR/ERVL-MaLR	1305	+	20	15169637	77879
chr19	7434223	7634223	harbor1	chr19	7481098	7481204	LTR/ERVL-MaLR	2123	+	53	7481151	46928
chr19	7434223	7634223	harbor1	chr19	7481502	7481873	LTR/ERVL-MaLR	2123	+	186	7481688	47465
chr19	9986300	10186300	harbor1	chr19	10083197	10083550	LTR/ERVL-MaLR	1198	+	176	10083373	97073
chr19	1505430	1705430	harbor1	chr19	1597356	1597872	LTR/ERVL-MaLR	1480	+	258	1597614	92184
chr19	1505430	1705430	harbor1	chr19	1600132	1600206	LTR/ERVL-MaLR	1123	+	37	1600169	94739
chr19	1505430	1705430	harbor1	chr19	1600513	1600592	LTR/ERVL-MaLR	1123	+	40	1600553	95123
chr19	1505430	1705430	harbor1	chr19	1601185	1601320	LTR/ERVL-MaLR	1123	+	68	1601253	95823
chr19	1505430	1705430	harbor1	chr19	1601629	1601832	LTR/ERVL-MaLR	1123	+	102	1601731	96301
chr19	49751330	49951330	harbor1	chr19	49752406	49752605	LTR/ERVL-MaLR	867	+	100	49752506	1176
chr19	49751330	49951330	harbor1	chr19	49756657	49756777	LTR/ERVL-MaLR	1088	+	60	49756717	5387
chr19	49751330	49951330	harbor1	chr19	49757079	49757413	LTR/ERVL-MaLR	1088	+	167	49757246	5916
chr19	5518829	5718829	harbor1	chr19	5585185	5585442	LTR/ERVL-MaLR	789	+	128	5585313	66484
chr19	49751380	49951380	harbor1	chr19	49752406	49752605	LTR/ERVL-MaLR	867	+	100	49752506	1126
chr19	49751380	49951380	harbor1	chr19	49756657	49756777	LTR/ERVL-MaLR	1088	+	60	49756717	5337
chr19	49751380	49951380	harbor1	chr19	49757079	49757413	LTR/ERVL-MaLR	1088	+	167	49757246	5866
chr19	19564037	19764037	harbor1	chr19	19579357	19579405	LTR/ERVL-MaLR	1634	+	24	19579381	15344
chr19	19564037	19764037	harbor1	chr19	19601454	19601865	LTR/ERVL-MaLR	1386	+	206	19601660	37623
chr19	19564037	19764037	harbor1	chr19	19606089	19606607	LTR/ERVL-MaLR	1612	+	259	19606348	42311
chr19	19564037	19764037	harbor1	chr19	19578730	19579068	LTR/ERVL-MaLR	1634	+	169	19578899	14862
chr19	5522542	5722542	harbor1	chr19	5585185	5585442	LTR/ERVL-MaLR	789	+	128	5585313	62771
chr19	19557012	19757012	harbor1	chr19	19579357	19579405	LTR/ERVL-MaLR	1634	+	24	19579381	22369
chr19	19557012	19757012	harbor1	chr19	19601454	19601865	LTR/ERVL-MaLR	1386	+	206	19601660	44648
chr19	19557012	19757012	harbor1	chr19	19606089	19606607	LTR/ERVL-MaLR	1612	+	259	19606348	49336
chr19	19557012	19757012	harbor1	chr19	19578730	19579068	LTR/ERVL-MaLR	1634	+	169	19578899	21887
chr19	3287910	3487910	harbor1	chr19	3357189	3357476	LTR/ERVL-MaLR	1210	+	144	3357333	69423
chr19	559301	759301	harbor1	chr19	644132	644407	LTR/ERVL-MaLR	687	+	138	644270	84969
chr19	57140775	57340775	harbor1	chr19	57179740	57180097	LTR/ERVL-MaLR	1974	+	178	57179918	39143
chr19	57140775	57340775	harbor1	chr19	57204348	57204683	LTR/ERVL-MaLR	2272	+	168	57204516	63741
chr19	48119191	48319191	harbor1	chr19	48157855	48158237	LTR/ERVL-MaLR	2142	+	191	48158046	38855
chr19	48119191	48319191	harbor1	chr19	48159470	48159706	LTR/ERVL-MaLR	1652	+	118	48159588	40397
chr19	48119191	48319191	harbor1	chr19	48160017	48160247	LTR/ERVL-MaLR	1652	+	115	48160132	40941
chr19	48119191	48319191	harbor1	chr19	48164361	48164805	LTR/ERVL-MaLR	968	+	222	48164583	45392
chr19	48119191	48319191	harbor1	chr19	48165331	48165376	LTR/ERVL-MaLR	968	+	22	48165353	46162
chr19	5523058	5723058	harbor1	chr19	5585185	5585442	LTR/ERVL-MaLR	789	+	128	5585313	62255
chr19	19563483	19763483	harbor1	chr19	19579357	19579405	LTR/ERVL-MaLR	1634	+	24	19579381	15898
chr19	19563483	19763483	harbor1	chr19	19601454	19601865	LTR/ERVL-MaLR	1386	+	206	19601660	38177
chr19	19563483	19763483	harbor1	chr19	19606089	19606607	LTR/ERVL-MaLR	1612	+	259	19606348	42865
chr19	19563483	19763483	harbor1	chr19	19578730	19579068	LTR/ERVL-MaLR	1634	+	169	19578899	15416
chr19	19564065	19764065	harbor1	chr19	19579357	19579405	LTR/ERVL-MaLR	1634	+	24	19579381	15316
chr19	19564065	19764065	harbor1	chr19	19601454	19601865	LTR/ERVL-MaLR	1386	+	206	19601660	37595
chr19	19564065	19764065	harbor1	chr19	19606089	19606607	LTR/ERVL-MaLR	1612	+	259	19606348	42283
chr19	19564065	19764065	harbor1	chr19	19578730	19579068	LTR/ERVL-MaLR	1634	+	169	19578899	14834
chr19	5522867	5722867	harbor1	chr19	5585185	5585442	LTR/ERVL-MaLR	789	+	128	5585313	62446
chr19	19563446	19763446	harbor1	chr19	19579357	19579405	LTR/ERVL-MaLR	1634	+	24	19579381	15935
chr19	19563446	19763446	harbor1	chr19	19601454	19601865	LTR/ERVL-MaLR	1386	+	206	19601660	38214
chr19	19563446	19763446	harbor1	chr19	19606089	19606607	LTR/ERVL-MaLR	1612	+	259	19606348	42902
chr19	19563446	19763446	harbor1	chr19	19578730	19579068	LTR/ERVL-MaLR	1634	+	169	19578899	15453
chr19	5489582	5689582	harbor1	chr19	5501454	5501694	LTR/ERVL-MaLR	944	+	120	5501574	11992
chr19	5489582	5689582	harbor1	chr19	5502203	5502439	LTR/ERVL-MaLR	1202	+	118	5502321	12739
chr19	5489582	5689582	harbor1	chr19	5513852	5514075	LTR/ERVL-MaLR	1249	+	112	5513964	24382
chr19	5489582	5689582	harbor1	chr19	5585185	5585442	LTR/ERVL-MaLR	789	+	128	5585313	95731
chr19	5489582	5689582	harbor1	chr19	5504873	5505178	LTR/ERVL-MaLR	1099	+	152	5505025	15443
chr19	39685943	39885943	harbor1	chr19	39765144	39765501	LTR/ERVL-MaLR	1530	+	178	39765322	79379
chr19	39685943	39885943	harbor1	chr19	39781424	39781836	LTR/ERVL-MaLR	2506	+	206	39781630	95687
chr19	39685943	39885943	harbor1	chr19	39782227	39782570	LTR/ERVL-MaLR	2257	+	172	39782399	96456
chr19	5522587	5722587	harbor1	chr19	5585185	5585442	LTR/ERVL-MaLR	789	+	128	5585313	62726
chr19	5518947	5718947	harbor1	chr19	5585185	5585442	LTR/ERVL-MaLR	789	+	128	5585313	66366
chr19	32964890	33164890	harbor1	chr19	32993514	32993911	LTR/ERVL-MaLR	1564	+	198	32993712	28822
chr19	19538104	19738104	harbor1	chr19	19579357	19579405	LTR/ERVL-MaLR	1634	+	24	19579381	41277
chr19	19538104	19738104	harbor1	chr19	19601454	19601865	LTR/ERVL-MaLR	1386	+	206	19601660	63556
chr19	19538104	19738104	harbor1	chr19	19606089	19606607	LTR/ERVL-MaLR	1612	+	259	19606348	68244
chr19	19538104	19738104	harbor1	chr19	19578730	19579068	LTR/ERVL-MaLR	1634	+	169	19578899	40795
chr19	49751467	49951467	harbor1	chr19	49752406	49752605	LTR/ERVL-MaLR	867	+	100	49752506	1039
chr19	49751467	49951467	harbor1	chr19	49756657	49756777	LTR/ERVL-MaLR	1088	+	60	49756717	5250
chr19	49751467	49951467	harbor1	chr19	49757079	49757413	LTR/ERVL-MaLR	1088	+	167	49757246	5779
chr19	35165609	35365609	harbor1	chr19	35175817	35176235	LTR/ERVL-MaLR	2418	+	209	35176026	10417
chr19	35165609	35365609	harbor1	chr19	35199378	35199960	LTR/ERVL-MaLR	1497	+	291	35199669	34060
chr19	35165609	35365609	harbor1	chr19	35201945	35202289	LTR/ERVL-MaLR	2752	+	172	35202117	36508
chr19	35165609	35365609	harbor1	chr19	35202588	35202630	LTR/ERVL-MaLR	2752	+	21	35202609	37000
chr19	35165609	35365609	harbor1	chr19	35206135	35206550	LTR/ERVL-MaLR	1326	+	208	35206343	40734
chr19	35165609	35365609	harbor1	chr19	35215659	35215954	LTR/ERVL-MaLR	935	+	148	35215807	50198
chr19	35165609	35365609	harbor1	chr19	35216422	35216891	LTR/ERVL-MaLR	1621	+	234	35216656	51047
chr19	35165609	35365609	harbor1	chr19	35216987	35217370	LTR/ERVL-MaLR	1120	+	192	35217179	51570
chr19	35165609	35365609	harbor1	chr19	35220312	35220608	LTR/ERVL-MaLR	709	+	148	35220460	54851
chr19	35165609	35365609	harbor1	chr19	35226812	35227209	LTR/ERVL-MaLR	1358	+	198	35227010	61401
chr19	35165609	35365609	harbor1	chr19	35237236	35237415	LTR/ERVL-MaLR	2428	+	90	35237326	71717
chr19	35165609	35365609	harbor1	chr19	35237729	35237941	LTR/ERVL-MaLR	2428	+	106	35237835	72226
chr19	35165609	35365609	harbor1	chr19	35238038	35238420	LTR/ERVL-MaLR	2320	+	191	35238229	72620
chr19	49751332	49951332	harbor1	chr19	49752406	49752605	LTR/ERVL-MaLR	867	+	100	49752506	1174
chr19	49751332	49951332	harbor1	chr19	49756657	49756777	LTR/ERVL-MaLR	1088	+	60	49756717	5385
chr19	49751332	49951332	harbor1	chr19	49757079	49757413	LTR/ERVL-MaLR	1088	+	167	49757246	5914
chr19	3352627	3552627	harbor1	chr19	3357189	3357476	LTR/ERVL-MaLR	1210	+	144	3357333	4706
chr19	697422	897422	harbor1	chr19	697414	697571	LTR/ERVL-MaLR	668	+	78	697492	70
chr19	5522894	5722894	harbor1	chr19	5585185	5585442	LTR/ERVL-MaLR	789	+	128	5585313	62419
chr19	16472387	16672387	harbor1	chr19	16523553	16523896	LTR/ERVL-MaLR	1244	+	172	16523725	51338
chr19	16472387	16672387	harbor1	chr19	16544097	16544355	LTR/ERVL-MaLR	1451	+	129	16544226	71839
chr19	16472387	16672387	harbor1	chr19	16544670	16544861	LTR/ERVL-MaLR	1451	+	96	16544766	72379
chr19	6729031	6929031	harbor1	chr19	6761111	6761508	LTR/ERVL-MaLR	1068	+	198	6761309	32278
chr19	6729031	6929031	harbor1	chr19	6818544	6818796	LTR/ERVL-MaLR	1230	+	126	6818670	89639
chr19	7816806	8016806	harbor1	chr19	7819202	7819827	LTR/ERVL-MaLR	2302	+	312	7819514	2708
chr19	19564071	19764071	harbor1	chr19	19579357	19579405	LTR/ERVL-MaLR	1634	+	24	19579381	15310
chr19	19564071	19764071	harbor1	chr19	19601454	19601865	LTR/ERVL-MaLR	1386	+	206	19601660	37589
chr19	19564071	19764071	harbor1	chr19	19606089	19606607	LTR/ERVL-MaLR	1612	+	259	19606348	42277
chr19	19564071	19764071	harbor1	chr19	19578730	19579068	LTR/ERVL-MaLR	1634	+	169	19578899	14828
chr19	49730221	49930221	harbor1	chr19	49749461	49749615	LTR/ERVL-MaLR	724	+	77	49749538	19317
chr19	49730221	49930221	harbor1	chr19	49752406	49752605	LTR/ERVL-MaLR	867	+	100	49752506	22285
chr19	49730221	49930221	harbor1	chr19	49756657	49756777	LTR/ERVL-MaLR	1088	+	60	49756717	26496
chr19	49730221	49930221	harbor1	chr19	49757079	49757413	LTR/ERVL-MaLR	1088	+	167	49757246	27025
chr19	10189223	10389223	harbor1	chr19	10207088	10207548	LTR/ERVL-MaLR	1487	+	230	10207318	18095
chr19	23928631	24128631	harbor1	chr19	23975859	23976210	LTR/ERVL-MaLR	2022	+	176	23976035	47404
chr19	5521174	5721174	harbor1	chr19	5585185	5585442	LTR/ERVL-MaLR	789	+	128	5585313	64139
chr19	10152165	10352165	harbor1	chr19	10188545	10189074	LTR/ERVL-MaLR	1788	+	264	10188809	36644
chr19	10152165	10352165	harbor1	chr19	10207088	10207548	LTR/ERVL-MaLR	1487	+	230	10207318	55153
chr19	12567170	12767170	harbor1	chr19	12574041	12574311	LTR/ERVL-MaLR	894	+	135	12574176	7006
chr19	12567170	12767170	harbor1	chr19	12651190	12651553	LTR/ERVL-MaLR	952	+	182	12651372	84202
chr19	12567170	12767170	harbor1	chr19	12660078	12660230	LTR/ERVL-MaLR	1615	+	76	12660154	92984
chr19	12567170	12767170	harbor1	chr19	12660519	12660752	LTR/ERVL-MaLR	1615	+	116	12660635	93465
chr19	12567170	12767170	harbor1	chr19	12661057	12661175	LTR/ERVL-MaLR	1615	+	59	12661116	93946
chr19	56018198	56218198	harbor1	chr19	56078307	56078480	LTR/ERVL-MaLR	770	+	86	56078393	60195
chr19	3283777	3483777	harbor1	chr19	3357189	3357476	LTR/ERVL-MaLR	1210	+	144	3357333	73556
chr19	208557	408557	harbor1	chr19	234292	234719	LTR/ERVL-MaLR	1356	+	214	234506	25949
chr19	208557	408557	harbor1	chr19	254130	254605	LTR/ERVL-MaLR	1635	+	238	254368	45811
chr19	208557	408557	harbor1	chr19	258475	258578	LTR/ERVL-MaLR	735	+	52	258527	49970
chr19	208557	408557	harbor1	chr19	258612	258893	LTR/ERVL-MaLR	735	+	140	258752	50195
chr19	208557	408557	harbor1	chr19	263298	263482	LTR/ERVL-MaLR	692	+	92	263390	54833
chr19	5522978	5722978	harbor1	chr19	5585185	5585442	LTR/ERVL-MaLR	789	+	128	5585313	62335
chr19	12569729	12769729	harbor1	chr19	12574041	12574311	LTR/ERVL-MaLR	894	+	135	12574176	4447
chr19	12569729	12769729	harbor1	chr19	12651190	12651553	LTR/ERVL-MaLR	952	+	182	12651372	81643
chr19	12569729	12769729	harbor1	chr19	12660078	12660230	LTR/ERVL-MaLR	1615	+	76	12660154	90425
chr19	12569729	12769729	harbor1	chr19	12660519	12660752	LTR/ERVL-MaLR	1615	+	116	12660635	90906
chr19	12569729	12769729	harbor1	chr19	12661057	12661175	LTR/ERVL-MaLR	1615	+	59	12661116	91387
chr19	19563974	19763974	harbor1	chr19	19579357	19579405	LTR/ERVL-MaLR	1634	+	24	19579381	15407
chr19	19563974	19763974	harbor1	chr19	19601454	19601865	LTR/ERVL-MaLR	1386	+	206	19601660	37686
chr19	19563974	19763974	harbor1	chr19	19606089	19606607	LTR/ERVL-MaLR	1612	+	259	19606348	42374
chr19	19563974	19763974	harbor1	chr19	19578730	19579068	LTR/ERVL-MaLR	1634	+	169	19578899	14925
chr19	2355470	2555470	harbor1	chr19	2380636	2380819	LTR/ERVL-MaLR	922	+	92	2380728	25258
chr19	2355470	2555470	harbor1	chr19	2388446	2388624	LTR/ERVL-MaLR	649	+	89	2388535	33065
chr19	2355470	2555470	harbor1	chr19	2388924	2388985	LTR/ERVL-MaLR	649	+	30	2388954	33484
chr19	45134770	45334770	harbor1	chr19	45148825	45148862	LTR/ERVL-MaLR	911	+	18	45148843	14073
chr19	45134770	45334770	harbor1	chr19	45149172	45149549	LTR/ERVL-MaLR	911	+	188	45149360	14590
chr19	45134770	45334770	harbor1	chr19	45201708	45201941	LTR/ERVL-MaLR	2277	+	116	45201824	67054
chr19	45134770	45334770	harbor1	chr19	45202240	45202376	LTR/ERVL-MaLR	2277	+	68	45202308	67538
chr19	9986313	10186313	harbor1	chr19	10083197	10083550	LTR/ERVL-MaLR	1198	+	176	10083373	97060
chr19	7818121	8018121	harbor1	chr19	7819202	7819827	LTR/ERVL-MaLR	2302	+	312	7819514	1393
chr19	1655603	1855603	harbor1	chr19	1695491	1695788	LTR/ERVL-MaLR	2405	+	148	1695639	40036
chr19	1655603	1855603	harbor1	chr19	1696098	1696167	LTR/ERVL-MaLR	2405	+	34	1696132	40529
chr19	5486235	5686235	harbor1	chr19	5486595	5486812	LTR/ERVL-MaLR	762	+	108	5486703	468
chr19	5486235	5686235	harbor1	chr19	5501454	5501694	LTR/ERVL-MaLR	944	+	120	5501574	15339
chr19	5486235	5686235	harbor1	chr19	5502203	5502439	LTR/ERVL-MaLR	1202	+	118	5502321	16086
chr19	5486235	5686235	harbor1	chr19	5513852	5514075	LTR/ERVL-MaLR	1249	+	112	5513964	27729
chr19	5486235	5686235	harbor1	chr19	5585185	5585442	LTR/ERVL-MaLR	789	+	128	5585313	99078
chr19	5486235	5686235	harbor1	chr19	5504873	5505178	LTR/ERVL-MaLR	1099	+	152	5505025	18790
chr19	15191168	15391168	harbor1	chr19	15194301	15194524	LTR/ERVL-MaLR	779	+	112	15194413	3245
chr19	48070297	48270297	harbor1	chr19	48093717	48094087	LTR/ERVL-MaLR	2253	+	185	48093902	23605
chr19	48070297	48270297	harbor1	chr19	48109199	48109266	LTR/ERVL-MaLR	942	+	34	48109233	38936
chr19	48070297	48270297	harbor1	chr19	48109572	48109644	LTR/ERVL-MaLR	942	+	36	48109608	39311
chr19	48070297	48270297	harbor1	chr19	48109949	48110066	LTR/ERVL-MaLR	942	+	58	48110007	39710
chr19	48070297	48270297	harbor1	chr19	48110376	48110462	LTR/ERVL-MaLR	942	+	43	48110419	40122
chr19	48070297	48270297	harbor1	chr19	48114367	48114770	LTR/ERVL-MaLR	1656	+	202	48114569	44272
chr19	48070297	48270297	harbor1	chr19	48118235	48118534	LTR/ERVL-MaLR	2106	+	150	48118385	48088
chr19	48070297	48270297	harbor1	chr19	48157855	48158237	LTR/ERVL-MaLR	2142	+	191	48158046	87749
chr19	48070297	48270297	harbor1	chr19	48159470	48159706	LTR/ERVL-MaLR	1652	+	118	48159588	89291
chr19	48070297	48270297	harbor1	chr19	48160017	48160247	LTR/ERVL-MaLR	1652	+	115	48160132	89835
chr19	48070297	48270297	harbor1	chr19	48164361	48164805	LTR/ERVL-MaLR	968	+	222	48164583	94286
chr19	48070297	48270297	harbor1	chr19	48165331	48165376	LTR/ERVL-MaLR	968	+	22	48165353	95056
chr19	30129086	30329086	harbor1	chr19	30157354	30157505	LTR/ERVL-MaLR	1996	+	76	30157430	28344
chr19	30129086	30329086	harbor1	chr19	30157798	30158057	LTR/ERVL-MaLR	1996	+	130	30157928	28842
chr19	30129086	30329086	harbor1	chr19	30164260	30164674	LTR/ERVL-MaLR	2391	+	207	30164467	35381
chr19	30129086	30329086	harbor1	chr19	30170388	30170737	LTR/ERVL-MaLR	1310	+	174	30170562	41476
chr19	30129086	30329086	harbor1	chr19	30178050	30178526	LTR/ERVL-MaLR	1067	+	238	30178288	49202
chr19	30129086	30329086	harbor1	chr19	30200738	30200876	LTR/ERVL-MaLR	856	+	69	30200807	71721
chr19	30129086	30329086	harbor1	chr19	30201150	30201498	LTR/ERVL-MaLR	856	+	174	30201324	72238
chr19	30129086	30329086	harbor1	chr19	30201800	30201959	LTR/ERVL-MaLR	856	+	80	30201880	72794
chr19	30129086	30329086	harbor1	chr19	30202057	30202318	LTR/ERVL-MaLR	749	+	130	30202187	73101
chr19	57091913	57291913	harbor1	chr19	57179740	57180097	LTR/ERVL-MaLR	1974	+	178	57179918	88005
chr19	1	171218	harbor1	chr19	72301	72469	LTR/ERVL-MaLR	1447	+	84	72385	72384
chr19	1	171218	harbor1	chr19	72569	72740	LTR/ERVL-MaLR	1447	+	86	72655	72654
chr19	1	171218	harbor1	chr19	79865	81073	LTR/ERVL-MaLR	4147	+	604	80469	80468
chr19	1	171218	harbor1	chr19	81074	81232	LTR/ERVL-MaLR	834	+	79	81153	81152
chr19	1	171218	harbor1	chr19	81534	81903	LTR/ERVL-MaLR	834	+	184	81718	81717
chr19	11429104	11629104	harbor1	chr19	11511594	11511752	LTR/ERVL-MaLR	1767	+	79	11511673	82569
chr19	11429104	11629104	harbor1	chr19	11512353	11512571	LTR/ERVL-MaLR	1767	+	109	11512462	83358
chr19	5522956	5722956	harbor1	chr19	5585185	5585442	LTR/ERVL-MaLR	789	+	128	5585313	62357
chr19	697388	897388	harbor1	chr19	697414	697571	LTR/ERVL-MaLR	668	+	78	697492	104
chr19	10189204	10389204	harbor1	chr19	10207088	10207548	LTR/ERVL-MaLR	1487	+	230	10207318	18114
chr19	10189470	10389470	harbor1	chr19	10207088	10207548	LTR/ERVL-MaLR	1487	+	230	10207318	17848
chr19	7429502	7629502	harbor1	chr19	7481098	7481204	LTR/ERVL-MaLR	2123	+	53	7481151	51649
chr19	7429502	7629502	harbor1	chr19	7481502	7481873	LTR/ERVL-MaLR	2123	+	186	7481688	52186
chr19	19563863	19763863	harbor1	chr19	19579357	19579405	LTR/ERVL-MaLR	1634	+	24	19579381	15518
chr19	19563863	19763863	harbor1	chr19	19601454	19601865	LTR/ERVL-MaLR	1386	+	206	19601660	37797
chr19	19563863	19763863	harbor1	chr19	19606089	19606607	LTR/ERVL-MaLR	1612	+	259	19606348	42485
chr19	19563863	19763863	harbor1	chr19	19578730	19579068	LTR/ERVL-MaLR	1634	+	169	19578899	15036
chr19	48865312	49065312	harbor1	chr19	48948127	48948320	LTR/ERVL-MaLR	1829	+	96	48948223	82911
chr19	48865312	49065312	harbor1	chr19	48948822	48948990	LTR/ERVL-MaLR	1829	+	84	48948906	83594
chr19	48865312	49065312	harbor1	chr19	48949250	48949281	LTR/ERVL-MaLR	1829	+	16	48949266	83954
chr19	30129101	30329101	harbor1	chr19	30157354	30157505	LTR/ERVL-MaLR	1996	+	76	30157430	28329
chr19	30129101	30329101	harbor1	chr19	30157798	30158057	LTR/ERVL-MaLR	1996	+	130	30157928	28827
chr19	30129101	30329101	harbor1	chr19	30164260	30164674	LTR/ERVL-MaLR	2391	+	207	30164467	35366
chr19	30129101	30329101	harbor1	chr19	30170388	30170737	LTR/ERVL-MaLR	1310	+	174	30170562	41461
chr19	30129101	30329101	harbor1	chr19	30178050	30178526	LTR/ERVL-MaLR	1067	+	238	30178288	49187
chr19	30129101	30329101	harbor1	chr19	30200738	30200876	LTR/ERVL-MaLR	856	+	69	30200807	71706
chr19	30129101	30329101	harbor1	chr19	30201150	30201498	LTR/ERVL-MaLR	856	+	174	30201324	72223
chr19	30129101	30329101	harbor1	chr19	30201800	30201959	LTR/ERVL-MaLR	856	+	80	30201880	72779
chr19	30129101	30329101	harbor1	chr19	30202057	30202318	LTR/ERVL-MaLR	749	+	130	30202187	73086
chr19	7756106	7956106	harbor1	chr19	7756534	7756908	LTR/ERVL-MaLR	2569	+	187	7756721	615
chr19	7756106	7956106	harbor1	chr19	7756911	7758476	LTR/ERVL-MaLR	9609	+	782	7757693	1587
chr19	7756106	7956106	harbor1	chr19	7758477	7758851	LTR/ERVL-MaLR	2300	+	187	7758664	2558
chr19	7756106	7956106	harbor1	chr19	7775567	7775726	LTR/ERVL-MaLR	1647	+	80	7775647	19541
chr19	7756106	7956106	harbor1	chr19	7776007	7776265	LTR/ERVL-MaLR	1647	+	129	7776136	20030
chr19	7756106	7956106	harbor1	chr19	7811550	7811801	LTR/ERVL-MaLR	1284	+	126	7811676	55570
chr19	7756106	7956106	harbor1	chr19	7819202	7819827	LTR/ERVL-MaLR	2302	+	312	7819514	63408
chr19	208595	408595	harbor1	chr19	234292	234719	LTR/ERVL-MaLR	1356	+	214	234506	25911
chr19	208595	408595	harbor1	chr19	254130	254605	LTR/ERVL-MaLR	1635	+	238	254368	45773
chr19	208595	408595	harbor1	chr19	258475	258578	LTR/ERVL-MaLR	735	+	52	258527	49932
chr19	208595	408595	harbor1	chr19	258612	258893	LTR/ERVL-MaLR	735	+	140	258752	50157
chr19	208595	408595	harbor1	chr19	263298	263482	LTR/ERVL-MaLR	692	+	92	263390	54795
chr19	32574738	32774738	harbor1	chr19	32660130	32660263	LTR/ERVL-MaLR	1323	+	66	32660196	85458
chr19	32574738	32774738	harbor1	chr19	32660536	32660731	LTR/ERVL-MaLR	1323	+	98	32660634	85896
chr19	32574738	32774738	harbor1	chr19	32663176	32663401	LTR/ERVL-MaLR	685	+	112	32663288	88550
chr19	5522879	5722879	harbor1	chr19	5585185	5585442	LTR/ERVL-MaLR	789	+	128	5585313	62434
chr19	1857143	2057143	harbor1	chr19	1915507	1915664	LTR/ERVL-MaLR	868	+	78	1915585	58442
chr19	1857143	2057143	harbor1	chr19	1916254	1916453	LTR/ERVL-MaLR	868	+	100	1916354	59211
chr19	1857143	2057143	harbor1	chr19	1916756	1916817	LTR/ERVL-MaLR	868	+	30	1916786	59643
chr19	1857143	2057143	harbor1	chr19	1928144	1928335	LTR/ERVL-MaLR	842	+	96	1928240	71097
chr19	14879556	15079556	harbor1	chr19	14918511	14918869	LTR/ERVL-MaLR	2718	+	179	14918690	39134
chr19	14879556	15079556	harbor1	chr19	14957322	14957680	LTR/ERVL-MaLR	1782	+	179	14957501	77945
chr19	49751346	49951346	harbor1	chr19	49752406	49752605	LTR/ERVL-MaLR	867	+	100	49752506	1160
chr19	49751346	49951346	harbor1	chr19	49756657	49756777	LTR/ERVL-MaLR	1088	+	60	49756717	5371
chr19	49751346	49951346	harbor1	chr19	49757079	49757413	LTR/ERVL-MaLR	1088	+	167	49757246	5900
chr19	5522932	5722932	harbor1	chr19	5585185	5585442	LTR/ERVL-MaLR	789	+	128	5585313	62381
chr19	5521748	5721748	harbor1	chr19	5585185	5585442	LTR/ERVL-MaLR	789	+	128	5585313	63565
chr19	11667295	11867295	harbor1	chr19	11693948	11694290	LTR/ERVL-MaLR	1503	+	171	11694119	26824
chr19	11667295	11867295	harbor1	chr19	11726404	11726802	LTR/ERVL-MaLR	2037	+	199	11726603	59308
chr19	11667295	11867295	harbor1	chr19	11760841	11761187	LTR/ERVL-MaLR	1773	+	173	11761014	93719
chr19	11667295	11867295	harbor1	chr19	11765481	11765650	LTR/ERVL-MaLR	1229	+	84	11765565	98270
chr19	43618908	43818908	harbor1	chr19	43628481	43628532	LTR/ERVL-MaLR	755	+	26	43628507	9599
chr19	43618908	43818908	harbor1	chr19	43628533	43629052	LTR/ERVL-MaLR	1442	+	260	43628793	9885
chr19	43618908	43818908	harbor1	chr19	43629053	43629384	LTR/ERVL-MaLR	840	+	166	43629219	10311
chr19	43618908	43818908	harbor1	chr19	43631455	43631875	LTR/ERVL-MaLR	1056	+	210	43631665	12757
chr19	43618908	43818908	harbor1	chr19	43644092	43644152	LTR/ERVL-MaLR	877	+	30	43644122	25214
chr19	43618908	43818908	harbor1	chr19	43644460	43644715	LTR/ERVL-MaLR	877	+	128	43644588	25680
chr19	43618908	43818908	harbor1	chr19	43655659	43655972	LTR/ERVL-MaLR	1084	+	156	43655815	36907
chr19	43618908	43818908	harbor1	chr19	43656285	43656427	LTR/ERVL-MaLR	1084	+	71	43656356	37448
chr19	43618908	43818908	harbor1	chr19	43657847	43657920	LTR/ERVL-MaLR	1990	+	36	43657883	38975
chr19	43618908	43818908	harbor1	chr19	43658055	43658476	LTR/ERVL-MaLR	1990	+	210	43658265	39357
chr19	43618908	43818908	harbor1	chr19	43677065	43677590	LTR/ERVL-MaLR	1648	+	262	43677327	58419
chr19	43618908	43818908	harbor1	chr19	43679000	43679189	LTR/ERVL-MaLR	2014	+	94	43679094	60186
chr19	43618908	43818908	harbor1	chr19	43680442	43680646	LTR/ERVL-MaLR	965	+	102	43680544	61636
chr19	43618908	43818908	harbor1	chr19	43679486	43679757	LTR/ERVL-MaLR	2014	+	136	43679622	60714
chr19	49493098	49693098	harbor1	chr19	49508227	49508586	LTR/ERVL-MaLR	1448	+	180	49508407	15309
chr19	5522069	5722069	harbor1	chr19	5585185	5585442	LTR/ERVL-MaLR	789	+	128	5585313	63244
chr19	19488310	19688310	harbor1	chr19	19579357	19579405	LTR/ERVL-MaLR	1634	+	24	19579381	91071
chr19	19488310	19688310	harbor1	chr19	19578730	19579068	LTR/ERVL-MaLR	1634	+	169	19578899	90589
chr19	49751423	49951423	harbor1	chr19	49752406	49752605	LTR/ERVL-MaLR	867	+	100	49752506	1083
chr19	49751423	49951423	harbor1	chr19	49756657	49756777	LTR/ERVL-MaLR	1088	+	60	49756717	5294
chr19	49751423	49951423	harbor1	chr19	49757079	49757413	LTR/ERVL-MaLR	1088	+	167	49757246	5823
chr19	45369302	45569302	harbor1	chr19	45391471	45391813	LTR/ERVL-MaLR	813	+	171	45391642	22340
chr19	48865303	49065303	harbor1	chr19	48948127	48948320	LTR/ERVL-MaLR	1829	+	96	48948223	82920
chr19	48865303	49065303	harbor1	chr19	48948822	48948990	LTR/ERVL-MaLR	1829	+	84	48948906	83603
chr19	48865303	49065303	harbor1	chr19	48949250	48949281	LTR/ERVL-MaLR	1829	+	16	48949266	83963
chr19	15190756	15390756	harbor1	chr19	15194301	15194524	LTR/ERVL-MaLR	779	+	112	15194413	3657
chr19	417890	617890	harbor1	chr19	419289	419714	LTR/ERVL-MaLR	832	+	212	419501	1611
chr19	417890	617890	harbor1	chr19	445164	445450	LTR/ERVL-MaLR	1334	+	143	445307	27417
chr19	5521798	5721798	harbor1	chr19	5585185	5585442	LTR/ERVL-MaLR	789	+	128	5585313	63515
chr19	56006815	56206815	harbor1	chr19	56078307	56078480	LTR/ERVL-MaLR	770	+	86	56078393	71578
chr19	5677377	5877377	harbor1	chr19	5742905	5743021	LTR/ERVL-MaLR	783	+	58	5742963	65586
chr19	19563667	19763667	harbor1	chr19	19579357	19579405	LTR/ERVL-MaLR	1634	+	24	19579381	15714
chr19	19563667	19763667	harbor1	chr19	19601454	19601865	LTR/ERVL-MaLR	1386	+	206	19601660	37993
chr19	19563667	19763667	harbor1	chr19	19606089	19606607	LTR/ERVL-MaLR	1612	+	259	19606348	42681
chr19	19563667	19763667	harbor1	chr19	19578730	19579068	LTR/ERVL-MaLR	1634	+	169	19578899	15232
chr19	5521791	5721791	harbor1	chr19	5585185	5585442	LTR/ERVL-MaLR	789	+	128	5585313	63522
chr19	10170532	10370532	harbor1	chr19	10188545	10189074	LTR/ERVL-MaLR	1788	+	264	10188809	18277
chr19	10170532	10370532	harbor1	chr19	10207088	10207548	LTR/ERVL-MaLR	1487	+	230	10207318	36786
chr19	5493948	5693948	harbor1	chr19	5501454	5501694	LTR/ERVL-MaLR	944	+	120	5501574	7626
chr19	5493948	5693948	harbor1	chr19	5502203	5502439	LTR/ERVL-MaLR	1202	+	118	5502321	8373
chr19	5493948	5693948	harbor1	chr19	5513852	5514075	LTR/ERVL-MaLR	1249	+	112	5513964	20016
chr19	5493948	5693948	harbor1	chr19	5585185	5585442	LTR/ERVL-MaLR	789	+	128	5585313	91365
chr19	5493948	5693948	harbor1	chr19	5504873	5505178	LTR/ERVL-MaLR	1099	+	152	5505025	11077
chr19	13407605	13607605	harbor1	chr19	13407803	13408174	LTR/ERVL-MaLR	2204	+	186	13407989	384
chr19	13407605	13607605	harbor1	chr19	13411288	13411632	LTR/ERVL-MaLR	2454	+	172	13411460	3855
chr19	13407605	13607605	harbor1	chr19	13420319	13420752	LTR/ERVL-MaLR	1518	+	216	13420535	12930
chr19	13407605	13607605	harbor1	chr19	13421490	13421837	LTR/ERVL-MaLR	1949	+	174	13421664	14059
chr19	13407605	13607605	harbor1	chr19	13434405	13434782	LTR/ERVL-MaLR	2400	+	188	13434593	26988
chr19	13407605	13607605	harbor1	chr19	13435406	13435450	LTR/ERVL-MaLR	2400	+	22	13435428	27823
chr19	13407605	13607605	harbor1	chr19	13438284	13438793	LTR/ERVL-MaLR	1692	+	254	13438538	30933
chr19	13407605	13607605	harbor1	chr19	13443147	13443250	LTR/ERVL-MaLR	664	+	52	13443199	35594
chr19	13407605	13607605	harbor1	chr19	13451527	13451858	LTR/ERVL-MaLR	800	+	166	13451693	44088
chr19	13407605	13607605	harbor1	chr19	13452134	13452228	LTR/ERVL-MaLR	800	+	47	13452181	44576
chr19	13407605	13607605	harbor1	chr19	13472825	13472970	LTR/ERVL-MaLR	1219	+	72	13472897	65292
chr19	13407605	13607605	harbor1	chr19	13473280	13473563	LTR/ERVL-MaLR	1219	+	142	13473422	65817
chr19	13407605	13607605	harbor1	chr19	13483069	13483377	LTR/ERVL-MaLR	683	+	154	13483223	75618
chr19	13407605	13607605	harbor1	chr19	13483406	13483824	LTR/ERVL-MaLR	789	+	209	13483615	76010
chr19	48524511	48724511	harbor1	chr19	48524487	48524868	LTR/ERVL-MaLR	753	+	190	48524677	166
chr20	62865629	63065629	harbor1	chr20	62907575	62907879	LTR/ERVL-MaLR	471	+	152	62907727	42098
chr20	2740631	2940631	harbor1	chr20	2761339	2761711	LTR/ERVL-MaLR	1610	+	186	2761525	20894
chr20	2740631	2940631	harbor1	chr20	2792063	2792204	LTR/ERVL-MaLR	458	+	70	2792133	51502
chr20	2740631	2940631	harbor1	chr20	2813205	2813582	LTR/ERVL-MaLR	1941	+	188	2813393	72762
chr20	20267099	20467099	harbor1	chr20	20280015	20280461	LTR/ERVL-MaLR	1554	+	223	20280238	13139
chr20	20267099	20467099	harbor1	chr20	20290515	20290988	LTR/ERVL-MaLR	2286	+	236	20290751	23652
chr20	20267099	20467099	harbor1	chr20	20291575	20291623	LTR/ERVL-MaLR	2286	+	24	20291599	24500
chr20	20267099	20467099	harbor1	chr20	20313015	20313392	LTR/ERVL-MaLR	1440	+	188	20313203	46104
chr20	20267099	20467099	harbor1	chr20	20319362	20319731	LTR/ERVL-MaLR	2291	+	184	20319546	52447
chr20	20267099	20467099	harbor1	chr20	20321773	20322311	LTR/ERVL-MaLR	2291	+	269	20322042	54943
chr20	20267099	20467099	harbor1	chr20	20335352	20335792	LTR/ERVL-MaLR	1055	+	220	20335572	68473
chr20	4586466	4786466	harbor1	chr20	4590406	4590729	LTR/ERVL-MaLR	1850	+	162	4590568	4102
chr20	4586466	4786466	harbor1	chr20	4631666	4632896	LTR/ERVL-MaLR	8252	+	615	4632281	45815
chr20	4586466	4786466	harbor1	chr20	4632897	4633231	LTR/ERVL-MaLR	2177	+	167	4633064	46598
chr20	4586466	4786466	harbor1	chr20	4655690	4655874	LTR/ERVL-MaLR	1269	+	92	4655782	69316
chr20	4586466	4786466	harbor1	chr20	4656220	4656488	LTR/ERVL-MaLR	1269	+	134	4656354	69888
chr20	4586466	4786466	harbor1	chr20	4683631	4683728	LTR/ERVL-MaLR	2007	+	48	4683679	97213
chr20	4586466	4786466	harbor1	chr20	4684028	4684510	LTR/ERVL-MaLR	2007	+	241	4684269	97803
chr20	2738370	2938370	harbor1	chr20	2761339	2761711	LTR/ERVL-MaLR	1610	+	186	2761525	23155
chr20	2738370	2938370	harbor1	chr20	2792063	2792204	LTR/ERVL-MaLR	458	+	70	2792133	53763
chr20	2738370	2938370	harbor1	chr20	2813205	2813582	LTR/ERVL-MaLR	1941	+	188	2813393	75023
chr20	31622218	31822218	harbor1	chr20	31627883	31628037	LTR/ERVL-MaLR	774	+	77	31627960	5742
chr20	31622218	31822218	harbor1	chr20	31628600	31628732	LTR/ERVL-MaLR	774	+	66	31628666	6448
chr20	61877239	62077239	harbor1	chr20	61973766	61974165	LTR/ERVL-MaLR	1053	+	200	61973966	96727
chr20	34725628	34925628	harbor1	chr20	34806939	34807482	LTR/ERVL-MaLR	1719	+	272	34807211	81583
chr20	34725628	34925628	harbor1	chr20	34816237	34816505	LTR/ERVL-MaLR	1341	+	134	34816371	90743
chr20	59094495	59294495	harbor1	chr20	59115699	59116105	LTR/ERVL-MaLR	1186	+	203	59115902	21407
chr20	59094495	59294495	harbor1	chr20	59121383	59121923	LTR/ERVL-MaLR	1646	+	270	59121653	27158
chr20	59094495	59294495	harbor1	chr20	59124811	59125354	LTR/ERVL-MaLR	851	+	272	59125083	30588
chr20	59094495	59294495	harbor1	chr20	59136738	59137188	LTR/ERVL-MaLR	1377	+	225	59136963	42468
chr20	59094495	59294495	harbor1	chr20	59138511	59138704	LTR/ERVL-MaLR	460	+	96	59138607	44112
chr20	59094495	59294495	harbor1	chr20	59187196	59187555	LTR/ERVL-MaLR	1731	+	180	59187376	92881
chr20	50091428	50291428	harbor1	chr20	50099210	50099277	LTR/ERVL-MaLR	459	+	34	50099244	7816
chr20	50091428	50291428	harbor1	chr20	50099264	50099394	LTR/ERVL-MaLR	706	+	65	50099329	7901
chr20	50091428	50291428	harbor1	chr20	50121933	50122130	LTR/ERVL-MaLR	895	+	98	50122031	30603
chr20	50091428	50291428	harbor1	chr20	50130056	50130545	LTR/ERVL-MaLR	1074	+	244	50130300	38872
chr20	50091428	50291428	harbor1	chr20	50171149	50171260	LTR/ERVL-MaLR	1521	+	56	50171205	79777
chr20	50091428	50291428	harbor1	chr20	50171557	50171812	LTR/ERVL-MaLR	1521	+	128	50171685	80257
chr20	50091428	50291428	harbor1	chr20	50178232	50178658	LTR/ERVL-MaLR	1353	+	213	50178445	87017
chr20	50091428	50291428	harbor1	chr20	50180827	50180934	LTR/ERVL-MaLR	466	+	54	50180881	89453
chr20	1018874	1218874	harbor1	chr20	1030336	1030621	LTR/ERVL-MaLR	625	+	142	1030478	11604
chr20	1018874	1218874	harbor1	chr20	1033820	1034247	LTR/ERVL-MaLR	659	+	214	1034034	15160
chr20	1018874	1218874	harbor1	chr20	1034317	1034800	LTR/ERVL-MaLR	1674	+	242	1034559	15685
chr20	1018874	1218874	harbor1	chr20	1047265	1047546	LTR/ERVL-MaLR	861	+	140	1047405	28531
chr20	1018874	1218874	harbor1	chr20	1048664	1049202	LTR/ERVL-MaLR	1455	+	269	1048933	30059
chr20	1018874	1218874	harbor1	chr20	1056887	1056923	LTR/ERVL-MaLR	590	+	18	1056905	38031
chr20	1018874	1218874	harbor1	chr20	1056924	1057293	LTR/ERVL-MaLR	1648	+	184	1057108	38234
chr20	1018874	1218874	harbor1	chr20	1057294	1057319	LTR/ERVL-MaLR	590	+	12	1057306	38432
chr20	1018874	1218874	harbor1	chr20	1057563	1057805	LTR/ERVL-MaLR	590	+	121	1057684	38810
chr20	1018874	1218874	harbor1	chr20	1058088	1058235	LTR/ERVL-MaLR	590	+	74	1058162	39288
chr20	1018874	1218874	harbor1	chr20	1070013	1070413	LTR/ERVL-MaLR	1642	+	200	1070213	51339
chr20	1018874	1218874	harbor1	chr20	1083812	1084163	LTR/ERVL-MaLR	989	+	176	1083988	65114
chr20	1018874	1218874	harbor1	chr20	1088690	1089186	LTR/ERVL-MaLR	2260	+	248	1088938	70064
chr20	1018874	1218874	harbor1	chr20	1110366	1110765	LTR/ERVL-MaLR	2269	+	200	1110566	91692
chr20	1018874	1218874	harbor1	chr20	1081222	1081562	LTR/ERVL-MaLR	1941	+	170	1081392	62518
chr20	34774774	34974774	harbor1	chr20	34806939	34807482	LTR/ERVL-MaLR	1719	+	272	34807211	32437
chr20	34774774	34974774	harbor1	chr20	34816237	34816505	LTR/ERVL-MaLR	1341	+	134	34816371	41597
chr20	34774774	34974774	harbor1	chr20	34858030	34858388	LTR/ERVL-MaLR	1050	+	179	34858209	83435
chr20	34774774	34974774	harbor1	chr20	34868513	34869025	LTR/ERVL-MaLR	1338	+	256	34868769	93995
chr20	24506534	24706534	harbor1	chr20	24509794	24510210	LTR/ERVL-MaLR	2670	+	208	24510002	3468
chr20	4586441	4786441	harbor1	chr20	4590406	4590729	LTR/ERVL-MaLR	1850	+	162	4590568	4127
chr20	4586441	4786441	harbor1	chr20	4631666	4632896	LTR/ERVL-MaLR	8252	+	615	4632281	45840
chr20	4586441	4786441	harbor1	chr20	4632897	4633231	LTR/ERVL-MaLR	2177	+	167	4633064	46623
chr20	4586441	4786441	harbor1	chr20	4655690	4655874	LTR/ERVL-MaLR	1269	+	92	4655782	69341
chr20	4586441	4786441	harbor1	chr20	4656220	4656488	LTR/ERVL-MaLR	1269	+	134	4656354	69913
chr20	4586441	4786441	harbor1	chr20	4683631	4683728	LTR/ERVL-MaLR	2007	+	48	4683679	97238
chr20	4586441	4786441	harbor1	chr20	4684028	4684510	LTR/ERVL-MaLR	2007	+	241	4684269	97828
chr20	1018826	1218826	harbor1	chr20	1030336	1030621	LTR/ERVL-MaLR	625	+	142	1030478	11652
chr20	1018826	1218826	harbor1	chr20	1033820	1034247	LTR/ERVL-MaLR	659	+	214	1034034	15208
chr20	1018826	1218826	harbor1	chr20	1034317	1034800	LTR/ERVL-MaLR	1674	+	242	1034559	15733
chr20	1018826	1218826	harbor1	chr20	1047265	1047546	LTR/ERVL-MaLR	861	+	140	1047405	28579
chr20	1018826	1218826	harbor1	chr20	1048664	1049202	LTR/ERVL-MaLR	1455	+	269	1048933	30107
chr20	1018826	1218826	harbor1	chr20	1056887	1056923	LTR/ERVL-MaLR	590	+	18	1056905	38079
chr20	1018826	1218826	harbor1	chr20	1056924	1057293	LTR/ERVL-MaLR	1648	+	184	1057108	38282
chr20	1018826	1218826	harbor1	chr20	1057294	1057319	LTR/ERVL-MaLR	590	+	12	1057306	38480
chr20	1018826	1218826	harbor1	chr20	1057563	1057805	LTR/ERVL-MaLR	590	+	121	1057684	38858
chr20	1018826	1218826	harbor1	chr20	1058088	1058235	LTR/ERVL-MaLR	590	+	74	1058162	39336
chr20	1018826	1218826	harbor1	chr20	1070013	1070413	LTR/ERVL-MaLR	1642	+	200	1070213	51387
chr20	1018826	1218826	harbor1	chr20	1083812	1084163	LTR/ERVL-MaLR	989	+	176	1083988	65162
chr20	1018826	1218826	harbor1	chr20	1088690	1089186	LTR/ERVL-MaLR	2260	+	248	1088938	70112
chr20	1018826	1218826	harbor1	chr20	1110366	1110765	LTR/ERVL-MaLR	2269	+	200	1110566	91740
chr20	1018826	1218826	harbor1	chr20	1081222	1081562	LTR/ERVL-MaLR	1941	+	170	1081392	62566
chr20	63437341	63637341	harbor1	chr20	63448953	63449300	LTR/ERVL-MaLR	704	+	174	63449127	11786
chr20	63437341	63637341	harbor1	chr20	63479401	63479727	LTR/ERVL-MaLR	1198	+	163	63479564	42223
chr20	63437341	63637341	harbor1	chr20	63486270	63486622	LTR/ERVL-MaLR	698	+	176	63486446	49105
chr20	63437341	63637341	harbor1	chr20	63501202	63501465	LTR/ERVL-MaLR	812	+	132	63501334	63993
chr20	63437341	63637341	harbor1	chr20	63505445	63505770	LTR/ERVL-MaLR	979	+	162	63505607	68266
chr20	9473828	9673828	harbor1	chr20	9495381	9495839	LTR/ERVL-MaLR	558	+	229	9495610	21782
chr20	9473828	9673828	harbor1	chr20	9503042	9503365	LTR/ERVL-MaLR	1296	+	162	9503204	29376
chr20	9473828	9673828	harbor1	chr20	9541700	9542067	LTR/ERVL-MaLR	2055	+	184	9541884	68056
chr20	9473828	9673828	harbor1	chr20	9546943	9547375	LTR/ERVL-MaLR	1477	+	216	9547159	73331
chr20	9473828	9673828	harbor1	chr20	9554120	9554619	LTR/ERVL-MaLR	1174	+	250	9554370	80542
chr20	9473828	9673828	harbor1	chr20	9555624	9556146	LTR/ERVL-MaLR	807	+	261	9555885	82057
chr20	9473828	9673828	harbor1	chr20	9568475	9568685	LTR/ERVL-MaLR	1572	+	105	9568580	94752
chr20	9473828	9673828	harbor1	chr20	9568846	9569232	LTR/ERVL-MaLR	1572	+	193	9569039	95211
chr20	62871332	63071332	harbor1	chr20	62907575	62907879	LTR/ERVL-MaLR	471	+	152	62907727	36395
chr20	34724799	34924799	harbor1	chr20	34806939	34807482	LTR/ERVL-MaLR	1719	+	272	34807211	82412
chr20	34724799	34924799	harbor1	chr20	34816237	34816505	LTR/ERVL-MaLR	1341	+	134	34816371	91572
chr20	50269776	50469776	harbor1	chr20	50286725	50286935	LTR/ERVL-MaLR	480	+	105	50286830	17054
chr20	50269776	50469776	harbor1	chr20	50310963	50311280	LTR/ERVL-MaLR	1532	+	158	50311121	41345
chr20	50269776	50469776	harbor1	chr20	50313277	50313754	LTR/ERVL-MaLR	750	+	238	50313515	43739
chr20	50269776	50469776	harbor1	chr20	50346822	50347313	LTR/ERVL-MaLR	1090	+	246	50347068	77292
chr20	50269776	50469776	harbor1	chr20	50348262	50348531	LTR/ERVL-MaLR	682	+	134	50348396	78620
chr20	3104416	3304416	harbor1	chr20	3119097	3119541	LTR/ERVL-MaLR	1507	+	222	3119319	14903
chr20	3104416	3304416	harbor1	chr20	3180163	3180667	LTR/ERVL-MaLR	1842	+	252	3180415	75999
chr20	63953462	64153462	harbor1	chr20	63973530	63973907	LTR/ERVL-MaLR	580	+	188	63973718	20256
chr20	40589446	40789446	harbor1	chr20	40656433	40656992	LTR/ERVL-MaLR	1929	+	280	40656713	67267
chr20	34725642	34925642	harbor1	chr20	34806939	34807482	LTR/ERVL-MaLR	1719	+	272	34807211	81569
chr20	34725642	34925642	harbor1	chr20	34816237	34816505	LTR/ERVL-MaLR	1341	+	134	34816371	90729
chr20	34725595	34925595	harbor1	chr20	34806939	34807482	LTR/ERVL-MaLR	1719	+	272	34807211	81616
chr20	34725595	34925595	harbor1	chr20	34816237	34816505	LTR/ERVL-MaLR	1341	+	134	34816371	90776
chr20	62023008	62223008	harbor1	chr20	62025429	62025765	LTR/ERVL-MaLR	2022	+	168	62025597	2589
chr20	62023008	62223008	harbor1	chr20	62036789	62037101	LTR/ERVL-MaLR	1178	+	156	62036945	13937
chr20	62023008	62223008	harbor1	chr20	62082492	62082837	LTR/ERVL-MaLR	2319	+	172	62082664	59656
chr20	62023008	62223008	harbor1	chr20	62083143	62083193	LTR/ERVL-MaLR	2319	+	25	62083168	60160
chr20	62023008	62223008	harbor1	chr20	62084907	62085306	LTR/ERVL-MaLR	1460	+	200	62085107	62099
chr20	62023008	62223008	harbor1	chr20	62086838	62086970	LTR/ERVL-MaLR	546	+	66	62086904	63896
chr20	62023008	62223008	harbor1	chr20	62091835	62092389	LTR/ERVL-MaLR	3354	+	277	62092112	69104
chr20	62023008	62223008	harbor1	chr20	62092697	62093326	LTR/ERVL-MaLR	3354	+	314	62093011	70003
chr20	62023008	62223008	harbor1	chr20	62093631	62093853	LTR/ERVL-MaLR	3354	+	111	62093742	70734
chr20	62023008	62223008	harbor1	chr20	62093879	62094212	LTR/ERVL-MaLR	1327	+	166	62094045	71037
chr20	62023008	62223008	harbor1	chr20	62102581	62102960	LTR/ERVL-MaLR	1943	+	190	62102771	79763
chr20	62023008	62223008	harbor1	chr20	62107664	62107868	LTR/ERVL-MaLR	947	+	102	62107766	84758
chr20	62023008	62223008	harbor1	chr20	62110060	62110404	LTR/ERVL-MaLR	1755	+	172	62110232	87224
chr20	62023008	62223008	harbor1	chr20	62110692	62110719	LTR/ERVL-MaLR	1755	+	14	62110706	87698
chr20	62023008	62223008	harbor1	chr20	62111031	62111075	LTR/ERVL-MaLR	1755	+	22	62111053	88045
chr20	62023008	62223008	harbor1	chr20	62111076	62111482	LTR/ERVL-MaLR	2433	+	203	62111279	88271
chr20	34725630	34925630	harbor1	chr20	34806939	34807482	LTR/ERVL-MaLR	1719	+	272	34807211	81581
chr20	34725630	34925630	harbor1	chr20	34816237	34816505	LTR/ERVL-MaLR	1341	+	134	34816371	90741
chr20	63437464	63637464	harbor1	chr20	63448953	63449300	LTR/ERVL-MaLR	704	+	174	63449127	11663
chr20	63437464	63637464	harbor1	chr20	63479401	63479727	LTR/ERVL-MaLR	1198	+	163	63479564	42100
chr20	63437464	63637464	harbor1	chr20	63486270	63486622	LTR/ERVL-MaLR	698	+	176	63486446	48982
chr20	63437464	63637464	harbor1	chr20	63501202	63501465	LTR/ERVL-MaLR	812	+	132	63501334	63870
chr20	63437464	63637464	harbor1	chr20	63505445	63505770	LTR/ERVL-MaLR	979	+	162	63505607	68143
chr20	1018844	1218844	harbor1	chr20	1030336	1030621	LTR/ERVL-MaLR	625	+	142	1030478	11634
chr20	1018844	1218844	harbor1	chr20	1033820	1034247	LTR/ERVL-MaLR	659	+	214	1034034	15190
chr20	1018844	1218844	harbor1	chr20	1034317	1034800	LTR/ERVL-MaLR	1674	+	242	1034559	15715
chr20	1018844	1218844	harbor1	chr20	1047265	1047546	LTR/ERVL-MaLR	861	+	140	1047405	28561
chr20	1018844	1218844	harbor1	chr20	1048664	1049202	LTR/ERVL-MaLR	1455	+	269	1048933	30089
chr20	1018844	1218844	harbor1	chr20	1056887	1056923	LTR/ERVL-MaLR	590	+	18	1056905	38061
chr20	1018844	1218844	harbor1	chr20	1056924	1057293	LTR/ERVL-MaLR	1648	+	184	1057108	38264
chr20	1018844	1218844	harbor1	chr20	1057294	1057319	LTR/ERVL-MaLR	590	+	12	1057306	38462
chr20	1018844	1218844	harbor1	chr20	1057563	1057805	LTR/ERVL-MaLR	590	+	121	1057684	38840
chr20	1018844	1218844	harbor1	chr20	1058088	1058235	LTR/ERVL-MaLR	590	+	74	1058162	39318
chr20	1018844	1218844	harbor1	chr20	1070013	1070413	LTR/ERVL-MaLR	1642	+	200	1070213	51369
chr20	1018844	1218844	harbor1	chr20	1083812	1084163	LTR/ERVL-MaLR	989	+	176	1083988	65144
chr20	1018844	1218844	harbor1	chr20	1088690	1089186	LTR/ERVL-MaLR	2260	+	248	1088938	70094
chr20	1018844	1218844	harbor1	chr20	1110366	1110765	LTR/ERVL-MaLR	2269	+	200	1110566	91722
chr20	1018844	1218844	harbor1	chr20	1081222	1081562	LTR/ERVL-MaLR	1941	+	170	1081392	62548
chr20	9473814	9673814	harbor1	chr20	9495381	9495839	LTR/ERVL-MaLR	558	+	229	9495610	21796
chr20	9473814	9673814	harbor1	chr20	9503042	9503365	LTR/ERVL-MaLR	1296	+	162	9503204	29390
chr20	9473814	9673814	harbor1	chr20	9541700	9542067	LTR/ERVL-MaLR	2055	+	184	9541884	68070
chr20	9473814	9673814	harbor1	chr20	9546943	9547375	LTR/ERVL-MaLR	1477	+	216	9547159	73345
chr20	9473814	9673814	harbor1	chr20	9554120	9554619	LTR/ERVL-MaLR	1174	+	250	9554370	80556
chr20	9473814	9673814	harbor1	chr20	9555624	9556146	LTR/ERVL-MaLR	807	+	261	9555885	82071
chr20	9473814	9673814	harbor1	chr20	9568475	9568685	LTR/ERVL-MaLR	1572	+	105	9568580	94766
chr20	9473814	9673814	harbor1	chr20	9568846	9569232	LTR/ERVL-MaLR	1572	+	193	9569039	95225
chr20	2740701	2940701	harbor1	chr20	2761339	2761711	LTR/ERVL-MaLR	1610	+	186	2761525	20824
chr20	2740701	2940701	harbor1	chr20	2792063	2792204	LTR/ERVL-MaLR	458	+	70	2792133	51432
chr20	2740701	2940701	harbor1	chr20	2813205	2813582	LTR/ERVL-MaLR	1941	+	188	2813393	72692
chr20	34725651	34925651	harbor1	chr20	34806939	34807482	LTR/ERVL-MaLR	1719	+	272	34807211	81560
chr20	34725651	34925651	harbor1	chr20	34816237	34816505	LTR/ERVL-MaLR	1341	+	134	34816371	90720
chr20	62040581	62240581	harbor1	chr20	62082492	62082837	LTR/ERVL-MaLR	2319	+	172	62082664	42083
chr20	62040581	62240581	harbor1	chr20	62083143	62083193	LTR/ERVL-MaLR	2319	+	25	62083168	42587
chr20	62040581	62240581	harbor1	chr20	62084907	62085306	LTR/ERVL-MaLR	1460	+	200	62085107	44526
chr20	62040581	62240581	harbor1	chr20	62086838	62086970	LTR/ERVL-MaLR	546	+	66	62086904	46323
chr20	62040581	62240581	harbor1	chr20	62091835	62092389	LTR/ERVL-MaLR	3354	+	277	62092112	51531
chr20	62040581	62240581	harbor1	chr20	62092697	62093326	LTR/ERVL-MaLR	3354	+	314	62093011	52430
chr20	62040581	62240581	harbor1	chr20	62093631	62093853	LTR/ERVL-MaLR	3354	+	111	62093742	53161
chr20	62040581	62240581	harbor1	chr20	62093879	62094212	LTR/ERVL-MaLR	1327	+	166	62094045	53464
chr20	62040581	62240581	harbor1	chr20	62102581	62102960	LTR/ERVL-MaLR	1943	+	190	62102771	62190
chr20	62040581	62240581	harbor1	chr20	62107664	62107868	LTR/ERVL-MaLR	947	+	102	62107766	67185
chr20	62040581	62240581	harbor1	chr20	62110060	62110404	LTR/ERVL-MaLR	1755	+	172	62110232	69651
chr20	62040581	62240581	harbor1	chr20	62110692	62110719	LTR/ERVL-MaLR	1755	+	14	62110706	70125
chr20	62040581	62240581	harbor1	chr20	62111031	62111075	LTR/ERVL-MaLR	1755	+	22	62111053	70472
chr20	62040581	62240581	harbor1	chr20	62111076	62111482	LTR/ERVL-MaLR	2433	+	203	62111279	70698
chr20	21818076	22018076	harbor1	chr20	21893949	21894263	LTR/ERVL-MaLR	1306	+	157	21894106	76030
chr20	21818076	22018076	harbor1	chr20	21896847	21897405	LTR/ERVL-MaLR	1996	+	279	21897126	79050
chr20	21818076	22018076	harbor1	chr20	21908708	21909111	LTR/ERVL-MaLR	787	+	202	21908910	90834
chr20	63471550	63671550	harbor1	chr20	63479401	63479727	LTR/ERVL-MaLR	1198	+	163	63479564	8014
chr20	63471550	63671550	harbor1	chr20	63486270	63486622	LTR/ERVL-MaLR	698	+	176	63486446	14896
chr20	63471550	63671550	harbor1	chr20	63501202	63501465	LTR/ERVL-MaLR	812	+	132	63501334	29784
chr20	63471550	63671550	harbor1	chr20	63505445	63505770	LTR/ERVL-MaLR	979	+	162	63505607	34057
chr20	63935698	64135698	harbor1	chr20	63973530	63973907	LTR/ERVL-MaLR	580	+	188	63973718	38020
chr20	2740649	2940649	harbor1	chr20	2761339	2761711	LTR/ERVL-MaLR	1610	+	186	2761525	20876
chr20	2740649	2940649	harbor1	chr20	2792063	2792204	LTR/ERVL-MaLR	458	+	70	2792133	51484
chr20	2740649	2940649	harbor1	chr20	2813205	2813582	LTR/ERVL-MaLR	1941	+	188	2813393	72744
chr20	2740637	2940637	harbor1	chr20	2761339	2761711	LTR/ERVL-MaLR	1610	+	186	2761525	20888
chr20	2740637	2940637	harbor1	chr20	2792063	2792204	LTR/ERVL-MaLR	458	+	70	2792133	51496
chr20	2740637	2940637	harbor1	chr20	2813205	2813582	LTR/ERVL-MaLR	1941	+	188	2813393	72756
chr20	11791069	11991069	harbor1	chr20	11806485	11806960	LTR/ERVL-MaLR	2104	+	238	11806723	15654
chr20	11791069	11991069	harbor1	chr20	11808432	11808642	LTR/ERVL-MaLR	1182	+	105	11808537	17468
chr20	11791069	11991069	harbor1	chr20	11813421	11813878	LTR/ERVL-MaLR	1921	+	228	11813649	22580
chr20	11791069	11991069	harbor1	chr20	11815417	11815663	LTR/ERVL-MaLR	469	+	123	11815540	24471
chr20	11791069	11991069	harbor1	chr20	11827641	11827990	LTR/ERVL-MaLR	2016	+	174	11827815	36746
chr20	11791069	11991069	harbor1	chr20	11830762	11831071	LTR/ERVL-MaLR	826	+	154	11830916	39847
chr20	11791069	11991069	harbor1	chr20	11846632	11846976	LTR/ERVL-MaLR	772	+	172	11846804	55735
chr20	11791069	11991069	harbor1	chr20	11850369	11850700	LTR/ERVL-MaLR	1556	+	166	11850535	59466
chr20	11791069	11991069	harbor1	chr20	11852389	11852948	LTR/ERVL-MaLR	709	+	280	11852669	61600
chr20	11791069	11991069	harbor1	chr20	11862853	11863232	LTR/ERVL-MaLR	1773	+	190	11863043	71974
chr20	11791069	11991069	harbor1	chr20	11875441	11875572	LTR/ERVL-MaLR	488	+	66	11875507	84438
chr20	11791069	11991069	harbor1	chr20	11880756	11880862	LTR/ERVL-MaLR	504	+	53	11880809	89740
chr20	63472070	63672070	harbor1	chr20	63479401	63479727	LTR/ERVL-MaLR	1198	+	163	63479564	7494
chr20	63472070	63672070	harbor1	chr20	63486270	63486622	LTR/ERVL-MaLR	698	+	176	63486446	14376
chr20	63472070	63672070	harbor1	chr20	63501202	63501465	LTR/ERVL-MaLR	812	+	132	63501334	29264
chr20	63472070	63672070	harbor1	chr20	63505445	63505770	LTR/ERVL-MaLR	979	+	162	63505607	33537
chr20	21614820	21814820	harbor1	chr20	21637358	21637510	LTR/ERVL-MaLR	521	+	76	21637434	22614
chr20	21614820	21814820	harbor1	chr20	21639330	21639790	LTR/ERVL-MaLR	635	+	230	21639560	24740
chr20	21614820	21814820	harbor1	chr20	21675302	21675713	LTR/ERVL-MaLR	1668	+	206	21675508	60688
chr20	61877182	62077182	harbor1	chr20	61973766	61974165	LTR/ERVL-MaLR	1053	+	200	61973966	96784
chr20	34725603	34925603	harbor1	chr20	34806939	34807482	LTR/ERVL-MaLR	1719	+	272	34807211	81608
chr20	34725603	34925603	harbor1	chr20	34816237	34816505	LTR/ERVL-MaLR	1341	+	134	34816371	90768
chr20	4586511	4786511	harbor1	chr20	4590406	4590729	LTR/ERVL-MaLR	1850	+	162	4590568	4057
chr20	4586511	4786511	harbor1	chr20	4631666	4632896	LTR/ERVL-MaLR	8252	+	615	4632281	45770
chr20	4586511	4786511	harbor1	chr20	4632897	4633231	LTR/ERVL-MaLR	2177	+	167	4633064	46553
chr20	4586511	4786511	harbor1	chr20	4655690	4655874	LTR/ERVL-MaLR	1269	+	92	4655782	69271
chr20	4586511	4786511	harbor1	chr20	4656220	4656488	LTR/ERVL-MaLR	1269	+	134	4656354	69843
chr20	4586511	4786511	harbor1	chr20	4683631	4683728	LTR/ERVL-MaLR	2007	+	48	4683679	97168
chr20	4586511	4786511	harbor1	chr20	4684028	4684510	LTR/ERVL-MaLR	2007	+	241	4684269	97758
chr20	50269786	50469786	harbor1	chr20	50286725	50286935	LTR/ERVL-MaLR	480	+	105	50286830	17044
chr20	50269786	50469786	harbor1	chr20	50310963	50311280	LTR/ERVL-MaLR	1532	+	158	50311121	41335
chr20	50269786	50469786	harbor1	chr20	50313277	50313754	LTR/ERVL-MaLR	750	+	238	50313515	43729
chr20	50269786	50469786	harbor1	chr20	50346822	50347313	LTR/ERVL-MaLR	1090	+	246	50347068	77282
chr20	50269786	50469786	harbor1	chr20	50348262	50348531	LTR/ERVL-MaLR	682	+	134	50348396	78610
chr21	14337898	14537898	harbor1	chr21	14386893	14387357	LTR/ERVL-MaLR	1900	+	232	14387125	49227
chr21	14337898	14537898	harbor1	chr21	14405937	14406333	LTR/ERVL-MaLR	2114	+	198	14406135	68237
chr21	14337898	14537898	harbor1	chr21	14407496	14407613	LTR/ERVL-MaLR	522	+	58	14407554	69656
chr21	14337898	14537898	harbor1	chr21	14408444	14408515	LTR/ERVL-MaLR	483	+	36	14408480	70582
chr21	14337898	14537898	harbor1	chr21	14414342	14414682	LTR/ERVL-MaLR	1301	+	170	14414512	76614
chr21	14337898	14537898	harbor1	chr21	14432707	14433062	LTR/ERVL-MaLR	1588	+	178	14432885	94987
chr21	29198992	29398992	harbor1	chr21	29205030	29205376	LTR/ERVL-MaLR	2103	+	173	29205203	6211
chr21	29198992	29398992	harbor1	chr21	29223879	29224257	LTR/ERVL-MaLR	2136	+	189	29224068	25076
chr21	29198992	29398992	harbor1	chr21	29240668	29241042	LTR/ERVL-MaLR	2146	+	187	29240855	41863
chr21	29198992	29398992	harbor1	chr21	29250460	29251048	LTR/ERVL-MaLR	2627	+	294	29250754	51762
chr21	29198992	29398992	harbor1	chr21	29257435	29257571	LTR/ERVL-MaLR	519	+	68	29257503	58511
chr21	29198992	29398992	harbor1	chr21	29265739	29266097	LTR/ERVL-MaLR	2253	+	179	29265918	66926
chr21	29198992	29398992	harbor1	chr21	29270171	29270538	LTR/ERVL-MaLR	2162	+	184	29270355	71363
chr21	29198992	29398992	harbor1	chr21	29274538	29275063	LTR/ERVL-MaLR	2282	+	262	29274800	75808
chr21	29198992	29398992	harbor1	chr21	29212667	29212983	LTR/ERVL-MaLR	1229	+	158	29212825	13833
chr21	44718448	44918448	harbor1	chr21	44739677	44740010	LTR/ERVL-MaLR	906	+	166	44739843	21395
chr21	44718448	44918448	harbor1	chr21	44758017	44758178	LTR/ERVL-MaLR	463	+	80	44758097	39649
chr21	44718448	44918448	harbor1	chr21	44776550	44776911	LTR/ERVL-MaLR	2826	+	180	44776730	58282
chr21	44718448	44918448	harbor1	chr21	44789739	44790058	LTR/ERVL-MaLR	1604	+	160	44789899	71451
chr21	44718448	44918448	harbor1	chr21	44790434	44790793	LTR/ERVL-MaLR	2227	+	180	44790614	72166
chr21	44718448	44918448	harbor1	chr21	44790796	44792312	LTR/ERVL-MaLR	9762	+	758	44791554	73106
chr21	44718448	44918448	harbor1	chr21	44792314	44792672	LTR/ERVL-MaLR	1988	+	179	44792493	74045
chr21	44718448	44918448	harbor1	chr21	44794035	44794269	LTR/ERVL-MaLR	738	+	117	44794152	75704
chr21	44718448	44918448	harbor1	chr21	44795863	44796107	LTR/ERVL-MaLR	784	+	122	44795985	77537
chr21	44718448	44918448	harbor1	chr21	44804613	44804768	LTR/ERVL-MaLR	1014	+	78	44804691	86243
chr21	45793754	45993754	harbor1	chr21	45809785	45809971	LTR/ERVL-MaLR	728	+	93	45809878	16124
chr21	45793754	45993754	harbor1	chr21	45837245	45837461	LTR/ERVL-MaLR	469	+	108	45837353	43599
chr21	45793754	45993754	harbor1	chr21	45852755	45852886	LTR/ERVL-MaLR	553	+	66	45852821	59067
chr21	45793754	45993754	harbor1	chr21	45856394	45856662	LTR/ERVL-MaLR	2072	+	134	45856528	62774
chr21	45793754	45993754	harbor1	chr21	45857412	45857557	LTR/ERVL-MaLR	2072	+	72	45857484	63730
chr21	45793754	45993754	harbor1	chr21	45858721	45859086	LTR/ERVL-MaLR	2821	+	182	45858903	65149
chr21	46282980	46482980	harbor1	chr21	46308683	46309032	LTR/ERVL-MaLR	2035	+	174	46308857	25877
chr21	43620271	43820271	harbor1	chr21	43643297	43643677	LTR/ERVL-MaLR	1959	+	190	43643487	23216
chr21	43620271	43820271	harbor1	chr21	43643978	43644031	LTR/ERVL-MaLR	1959	+	26	43644004	23733
chr21	43620271	43820271	harbor1	chr21	43665657	43665914	LTR/ERVL-MaLR	1038	+	128	43665785	45514
chr21	43620271	43820271	harbor1	chr21	43707578	43707996	LTR/ERVL-MaLR	2371	+	209	43707787	87516
chr21	41040224	41240224	harbor1	chr21	41085041	41085113	LTR/ERVL-MaLR	601	+	36	41085077	44853
chr21	41040224	41240224	harbor1	chr21	41085456	41085494	LTR/ERVL-MaLR	601	+	19	41085475	45251
chr21	41040224	41240224	harbor1	chr21	41100244	41100667	LTR/ERVL-MaLR	2766	+	212	41100456	60232
chr21	41040224	41240224	harbor1	chr21	41104653	41104930	LTR/ERVL-MaLR	1412	+	138	41104791	64567
chr21	41040224	41240224	harbor1	chr21	41138396	41138781	LTR/ERVL-MaLR	2101	+	192	41138588	98364
chr21	7645362	7845362	harbor1	chr21	7668665	7668989	LTR/ERVL-MaLR	1066	+	162	7668827	23465
chr21	7645362	7845362	harbor1	chr21	7681787	7682118	LTR/ERVL-MaLR	1314	+	166	7681953	36591
chr21	7645362	7845362	harbor1	chr21	7692885	7692975	LTR/ERVL-MaLR	548	+	45	7692930	47568
chr21	29198971	29398971	harbor1	chr21	29205030	29205376	LTR/ERVL-MaLR	2103	+	173	29205203	6232
chr21	29198971	29398971	harbor1	chr21	29223879	29224257	LTR/ERVL-MaLR	2136	+	189	29224068	25097
chr21	29198971	29398971	harbor1	chr21	29240668	29241042	LTR/ERVL-MaLR	2146	+	187	29240855	41884
chr21	29198971	29398971	harbor1	chr21	29250460	29251048	LTR/ERVL-MaLR	2627	+	294	29250754	51783
chr21	29198971	29398971	harbor1	chr21	29257435	29257571	LTR/ERVL-MaLR	519	+	68	29257503	58532
chr21	29198971	29398971	harbor1	chr21	29265739	29266097	LTR/ERVL-MaLR	2253	+	179	29265918	66947
chr21	29198971	29398971	harbor1	chr21	29270171	29270538	LTR/ERVL-MaLR	2162	+	184	29270355	71384
chr21	29198971	29398971	harbor1	chr21	29274538	29275063	LTR/ERVL-MaLR	2282	+	262	29274800	75829
chr21	29198971	29398971	harbor1	chr21	29212667	29212983	LTR/ERVL-MaLR	1229	+	158	29212825	13854
chr21	29198960	29398960	harbor1	chr21	29205030	29205376	LTR/ERVL-MaLR	2103	+	173	29205203	6243
chr21	29198960	29398960	harbor1	chr21	29223879	29224257	LTR/ERVL-MaLR	2136	+	189	29224068	25108
chr21	29198960	29398960	harbor1	chr21	29240668	29241042	LTR/ERVL-MaLR	2146	+	187	29240855	41895
chr21	29198960	29398960	harbor1	chr21	29250460	29251048	LTR/ERVL-MaLR	2627	+	294	29250754	51794
chr21	29198960	29398960	harbor1	chr21	29257435	29257571	LTR/ERVL-MaLR	519	+	68	29257503	58543
chr21	29198960	29398960	harbor1	chr21	29265739	29266097	LTR/ERVL-MaLR	2253	+	179	29265918	66958
chr21	29198960	29398960	harbor1	chr21	29270171	29270538	LTR/ERVL-MaLR	2162	+	184	29270355	71395
chr21	29198960	29398960	harbor1	chr21	29274538	29275063	LTR/ERVL-MaLR	2282	+	262	29274800	75840
chr21	29198960	29398960	harbor1	chr21	29212667	29212983	LTR/ERVL-MaLR	1229	+	158	29212825	13865
chr21	14337849	14537849	harbor1	chr21	14386893	14387357	LTR/ERVL-MaLR	1900	+	232	14387125	49276
chr21	14337849	14537849	harbor1	chr21	14405937	14406333	LTR/ERVL-MaLR	2114	+	198	14406135	68286
chr21	14337849	14537849	harbor1	chr21	14407496	14407613	LTR/ERVL-MaLR	522	+	58	14407554	69705
chr21	14337849	14537849	harbor1	chr21	14408444	14408515	LTR/ERVL-MaLR	483	+	36	14408480	70631
chr21	14337849	14537849	harbor1	chr21	14414342	14414682	LTR/ERVL-MaLR	1301	+	170	14414512	76663
chr21	14337849	14537849	harbor1	chr21	14432707	14433062	LTR/ERVL-MaLR	1588	+	178	14432885	95036
chr21	44410644	44610644	harbor1	chr21	44415222	44415652	LTR/ERVL-MaLR	1399	+	215	44415437	4793
chr21	44410644	44610644	harbor1	chr21	44464713	44464875	LTR/ERVL-MaLR	601	+	81	44464794	54150
chr21	44410644	44610644	harbor1	chr21	44464946	44465124	LTR/ERVL-MaLR	837	+	89	44465035	54391
chr21	44410644	44610644	harbor1	chr21	44476117	44476460	LTR/ERVL-MaLR	1879	+	172	44476289	65645
chr21	42595318	42795318	harbor1	chr21	42596010	42596290	LTR/ERVL-MaLR	575	+	140	42596150	832
chr21	42595318	42795318	harbor1	chr21	42626477	42626798	LTR/ERVL-MaLR	922	+	160	42626637	31319
chr21	42595318	42795318	harbor1	chr21	42664891	42665347	LTR/ERVL-MaLR	1206	+	228	42665119	69801
chr21	42595318	42795318	harbor1	chr21	42675837	42676263	LTR/ERVL-MaLR	2191	+	213	42676050	80732
chr21	42595318	42795318	harbor1	chr21	42598349	42598526	LTR/ERVL-MaLR	477	+	88	42598437	3119
chr21	29198958	29398958	harbor1	chr21	29205030	29205376	LTR/ERVL-MaLR	2103	+	173	29205203	6245
chr21	29198958	29398958	harbor1	chr21	29223879	29224257	LTR/ERVL-MaLR	2136	+	189	29224068	25110
chr21	29198958	29398958	harbor1	chr21	29240668	29241042	LTR/ERVL-MaLR	2146	+	187	29240855	41897
chr21	29198958	29398958	harbor1	chr21	29250460	29251048	LTR/ERVL-MaLR	2627	+	294	29250754	51796
chr21	29198958	29398958	harbor1	chr21	29257435	29257571	LTR/ERVL-MaLR	519	+	68	29257503	58545
chr21	29198958	29398958	harbor1	chr21	29265739	29266097	LTR/ERVL-MaLR	2253	+	179	29265918	66960
chr21	29198958	29398958	harbor1	chr21	29270171	29270538	LTR/ERVL-MaLR	2162	+	184	29270355	71397
chr21	29198958	29398958	harbor1	chr21	29274538	29275063	LTR/ERVL-MaLR	2282	+	262	29274800	75842
chr21	29198958	29398958	harbor1	chr21	29212667	29212983	LTR/ERVL-MaLR	1229	+	158	29212825	13867
chr21	5028549	5228549	harbor1	chr21	5083419	5083768	LTR/ERVL-MaLR	581	+	174	5083593	55044
chr21	5028549	5228549	harbor1	chr21	5103815	5104078	LTR/ERVL-MaLR	685	+	132	5103947	75398
chr21	5028549	5228549	harbor1	chr21	5105066	5105411	LTR/ERVL-MaLR	557	+	172	5105238	76689
chr21	46358914	46558914	harbor1	chr21	46450076	46450446	LTR/ERVL-MaLR	2342	+	185	46450261	91347
chr21	46358914	46558914	harbor1	chr21	46450735	46450771	LTR/ERVL-MaLR	2342	+	18	46450753	91839
chr21	46358914	46558914	harbor1	chr21	46455558	46456078	LTR/ERVL-MaLR	1305	+	260	46455818	96904
chr21	46358914	46558914	harbor1	chr21	46456266	46456723	LTR/ERVL-MaLR	1961	+	228	46456494	97580
chr21	46081078	46281078	harbor1	chr21	46089222	46089590	LTR/ERVL-MaLR	1126	+	184	46089406	8328
chr21	46081078	46281078	harbor1	chr21	46090136	46090631	LTR/ERVL-MaLR	1500	+	248	46090384	9306
chr21	46081078	46281078	harbor1	chr21	46156727	46157035	LTR/ERVL-MaLR	1780	+	154	46156881	75803
chr21	46081078	46281078	harbor1	chr21	46157889	46158097	LTR/ERVL-MaLR	776	+	104	46157993	76915
chr21	46089884	46289884	harbor1	chr21	46090136	46090631	LTR/ERVL-MaLR	1500	+	248	46090384	500
chr21	46089884	46289884	harbor1	chr21	46156727	46157035	LTR/ERVL-MaLR	1780	+	154	46156881	66997
chr21	46089884	46289884	harbor1	chr21	46157889	46158097	LTR/ERVL-MaLR	776	+	104	46157993	68109
chr21	44410702	44610702	harbor1	chr21	44415222	44415652	LTR/ERVL-MaLR	1399	+	215	44415437	4735
chr21	44410702	44610702	harbor1	chr21	44464713	44464875	LTR/ERVL-MaLR	601	+	81	44464794	54092
chr21	44410702	44610702	harbor1	chr21	44464946	44465124	LTR/ERVL-MaLR	837	+	89	44465035	54333
chr21	44410702	44610702	harbor1	chr21	44476117	44476460	LTR/ERVL-MaLR	1879	+	172	44476289	65587
chr21	45121058	45321058	harbor1	chr21	45192317	45192598	LTR/ERVL-MaLR	671	+	140	45192457	71399
chr21	44409441	44609441	harbor1	chr21	44415222	44415652	LTR/ERVL-MaLR	1399	+	215	44415437	5996
chr21	44409441	44609441	harbor1	chr21	44464713	44464875	LTR/ERVL-MaLR	601	+	81	44464794	55353
chr21	44409441	44609441	harbor1	chr21	44464946	44465124	LTR/ERVL-MaLR	837	+	89	44465035	55594
chr21	44409441	44609441	harbor1	chr21	44476117	44476460	LTR/ERVL-MaLR	1879	+	172	44476289	66848
chr21	41209974	41409974	harbor1	chr21	41217890	41218075	LTR/ERVL-MaLR	598	+	92	41217982	8008
chr21	41209974	41409974	harbor1	chr21	41232452	41232860	LTR/ERVL-MaLR	2302	+	204	41232656	22682
chr21	41209974	41409974	harbor1	chr21	41233997	41234356	LTR/ERVL-MaLR	2195	+	180	41234177	24203
chr21	41209974	41409974	harbor1	chr21	41272836	41272884	LTR/ERVL-MaLR	1219	+	24	41272860	62886
chr21	41209974	41409974	harbor1	chr21	41273949	41274139	LTR/ERVL-MaLR	1219	+	95	41274044	64070
chr21	42275771	42475771	harbor1	chr21	42278356	42278723	LTR/ERVL-MaLR	1594	+	184	42278540	2769
chr21	42275771	42475771	harbor1	chr21	42320496	42320608	LTR/ERVL-MaLR	1167	+	56	42320552	44781
chr21	42275771	42475771	harbor1	chr21	42320832	42321239	LTR/ERVL-MaLR	1167	+	204	42321036	45265
chr21	42275771	42475771	harbor1	chr21	42355474	42355891	LTR/ERVL-MaLR	2405	+	208	42355682	79911
chr21	42275771	42475771	harbor1	chr21	42358887	42358964	LTR/ERVL-MaLR	967	+	38	42358925	83154
chr21	42275771	42475771	harbor1	chr21	42359764	42359925	LTR/ERVL-MaLR	967	+	80	42359844	84073
chr21	42330687	42530687	harbor1	chr21	42355474	42355891	LTR/ERVL-MaLR	2405	+	208	42355682	24995
chr21	42330687	42530687	harbor1	chr21	42358887	42358964	LTR/ERVL-MaLR	967	+	38	42358925	28238
chr21	42330687	42530687	harbor1	chr21	42359764	42359925	LTR/ERVL-MaLR	967	+	80	42359844	29157
chr21	42330687	42530687	harbor1	chr21	42377099	42377595	LTR/ERVL-MaLR	1501	+	248	42377347	46660
chr21	42330687	42530687	harbor1	chr21	42378336	42378680	LTR/ERVL-MaLR	684	+	172	42378508	47821
chr21	42330687	42530687	harbor1	chr21	42390265	42390446	LTR/ERVL-MaLR	1790	+	90	42390355	59668
chr21	42330687	42530687	harbor1	chr21	42390755	42391064	LTR/ERVL-MaLR	1790	+	154	42390909	60222
chr21	42330687	42530687	harbor1	chr21	42414628	42414851	LTR/ERVL-MaLR	713	+	112	42414740	84053
chr21	42330687	42530687	harbor1	chr21	42424713	42425094	LTR/ERVL-MaLR	1997	+	190	42424903	94216
chr21	42330687	42530687	harbor1	chr21	42427884	42428235	LTR/ERVL-MaLR	1708	+	176	42428060	97373
chr21	42330687	42530687	harbor1	chr21	42428890	42429329	LTR/ERVL-MaLR	1102	+	220	42429110	98423
chr21	39008427	39208427	harbor1	chr21	39036248	39036676	LTR/ERVL-MaLR	1422	+	214	39036462	28035
chr21	39008427	39208427	harbor1	chr21	39058684	39058826	LTR/ERVL-MaLR	1234	+	71	39058755	50328
chr21	39008427	39208427	harbor1	chr21	39059118	39059372	LTR/ERVL-MaLR	1234	+	127	39059245	50818
chr21	39008427	39208427	harbor1	chr21	39064379	39064713	LTR/ERVL-MaLR	718	+	167	39064546	56119
chr21	39008427	39208427	harbor1	chr21	39072377	39072804	LTR/ERVL-MaLR	1479	+	214	39072591	64164
chr21	39008427	39208427	harbor1	chr21	39088276	39088373	LTR/ERVL-MaLR	1181	+	48	39088324	79897
chr21	39008427	39208427	harbor1	chr21	39088870	39089165	LTR/ERVL-MaLR	1181	+	148	39089018	80591
chr21	39008427	39208427	harbor1	chr21	39089609	39089664	LTR/ERVL-MaLR	1181	+	28	39089637	81210
chr21	39008427	39208427	harbor1	chr21	39089673	39089934	LTR/ERVL-MaLR	1682	+	130	39089803	81376
chr21	37167966	37367966	harbor1	chr21	37206534	37206893	LTR/ERVL-MaLR	1818	+	180	37206714	38748
chr21	39008529	39208529	harbor1	chr21	39036248	39036676	LTR/ERVL-MaLR	1422	+	214	39036462	27933
chr21	39008529	39208529	harbor1	chr21	39058684	39058826	LTR/ERVL-MaLR	1234	+	71	39058755	50226
chr21	39008529	39208529	harbor1	chr21	39059118	39059372	LTR/ERVL-MaLR	1234	+	127	39059245	50716
chr21	39008529	39208529	harbor1	chr21	39064379	39064713	LTR/ERVL-MaLR	718	+	167	39064546	56017
chr21	39008529	39208529	harbor1	chr21	39072377	39072804	LTR/ERVL-MaLR	1479	+	214	39072591	64062
chr21	39008529	39208529	harbor1	chr21	39088276	39088373	LTR/ERVL-MaLR	1181	+	48	39088324	79795
chr21	39008529	39208529	harbor1	chr21	39088870	39089165	LTR/ERVL-MaLR	1181	+	148	39089018	80489
chr21	39008529	39208529	harbor1	chr21	39089609	39089664	LTR/ERVL-MaLR	1181	+	28	39089637	81108
chr21	39008529	39208529	harbor1	chr21	39089673	39089934	LTR/ERVL-MaLR	1682	+	130	39089803	81274
chr21	41615341	41815341	harbor1	chr21	41618521	41618944	LTR/ERVL-MaLR	990	+	212	41618733	3392
chr21	41615341	41815341	harbor1	chr21	41619458	41619815	LTR/ERVL-MaLR	2259	+	178	41619636	4295
chr21	41615341	41815341	harbor1	chr21	41663152	41663503	LTR/ERVL-MaLR	1879	+	176	41663328	47987
chr21	41615341	41815341	harbor1	chr21	41678981	41679180	LTR/ERVL-MaLR	772	+	100	41679081	63740
chr21	41615341	41815341	harbor1	chr21	41686611	41686970	LTR/ERVL-MaLR	1860	+	180	41686791	71450
chr21	41615341	41815341	harbor1	chr21	41700351	41700704	LTR/ERVL-MaLR	2759	+	176	41700527	85186
chr21	41615341	41815341	harbor1	chr21	41705493	41705959	LTR/ERVL-MaLR	1262	+	233	41705726	90385
chr21	44624134	44824134	harbor1	chr21	44649906	44649950	LTR/ERVL-MaLR	533	+	22	44649928	25794
chr21	44624134	44824134	harbor1	chr21	44650236	44650706	LTR/ERVL-MaLR	930	+	235	44650471	26337
chr21	44624134	44824134	harbor1	chr21	44672672	44673051	LTR/ERVL-MaLR	1990	+	190	44672862	48728
chr21	44624134	44824134	harbor1	chr21	44678194	44678592	LTR/ERVL-MaLR	2251	+	199	44678393	54259
chr21	44624134	44824134	harbor1	chr21	44714398	44714774	LTR/ERVL-MaLR	1859	+	188	44714586	90452
chr21	44624134	44824134	harbor1	chr21	44715921	44716299	LTR/ERVL-MaLR	1999	+	189	44716110	91976
chr21	29198951	29398951	harbor1	chr21	29205030	29205376	LTR/ERVL-MaLR	2103	+	173	29205203	6252
chr21	29198951	29398951	harbor1	chr21	29223879	29224257	LTR/ERVL-MaLR	2136	+	189	29224068	25117
chr21	29198951	29398951	harbor1	chr21	29240668	29241042	LTR/ERVL-MaLR	2146	+	187	29240855	41904
chr21	29198951	29398951	harbor1	chr21	29250460	29251048	LTR/ERVL-MaLR	2627	+	294	29250754	51803
chr21	29198951	29398951	harbor1	chr21	29257435	29257571	LTR/ERVL-MaLR	519	+	68	29257503	58552
chr21	29198951	29398951	harbor1	chr21	29265739	29266097	LTR/ERVL-MaLR	2253	+	179	29265918	66967
chr21	29198951	29398951	harbor1	chr21	29270171	29270538	LTR/ERVL-MaLR	2162	+	184	29270355	71404
chr21	29198951	29398951	harbor1	chr21	29274538	29275063	LTR/ERVL-MaLR	2282	+	262	29274800	75849
chr21	29198951	29398951	harbor1	chr21	29212667	29212983	LTR/ERVL-MaLR	1229	+	158	29212825	13874
chr21	39008418	39208418	harbor1	chr21	39036248	39036676	LTR/ERVL-MaLR	1422	+	214	39036462	28044
chr21	39008418	39208418	harbor1	chr21	39058684	39058826	LTR/ERVL-MaLR	1234	+	71	39058755	50337
chr21	39008418	39208418	harbor1	chr21	39059118	39059372	LTR/ERVL-MaLR	1234	+	127	39059245	50827
chr21	39008418	39208418	harbor1	chr21	39064379	39064713	LTR/ERVL-MaLR	718	+	167	39064546	56128
chr21	39008418	39208418	harbor1	chr21	39072377	39072804	LTR/ERVL-MaLR	1479	+	214	39072591	64173
chr21	39008418	39208418	harbor1	chr21	39088276	39088373	LTR/ERVL-MaLR	1181	+	48	39088324	79906
chr21	39008418	39208418	harbor1	chr21	39088870	39089165	LTR/ERVL-MaLR	1181	+	148	39089018	80600
chr21	39008418	39208418	harbor1	chr21	39089609	39089664	LTR/ERVL-MaLR	1181	+	28	39089637	81219
chr21	39008418	39208418	harbor1	chr21	39089673	39089934	LTR/ERVL-MaLR	1682	+	130	39089803	81385
chr21	8119783	8319783	harbor1	chr21	8120298	8120619	LTR/ERVL-MaLR	865	+	160	8120458	675
chr22	39578289	39778289	harbor1	chr22	39611992	39612381	LTR/ERVL-MaLR	2162	+	194	39612186	33897
chr22	44201157	44401157	harbor1	chr22	44214814	44215145	LTR/ERVL-MaLR	417	+	166	44214980	13823
chr22	44201157	44401157	harbor1	chr22	44229819	44230011	LTR/ERVL-MaLR	596	+	96	44229915	28758
chr22	44201157	44401157	harbor1	chr22	44230045	44230711	LTR/ERVL-MaLR	892	+	333	44230378	29221
chr22	44201157	44401157	harbor1	chr22	44230891	44231107	LTR/ERVL-MaLR	567	+	108	44230999	29842
chr22	44201157	44401157	harbor1	chr22	44231378	44231534	LTR/ERVL-MaLR	534	+	78	44231456	30299
chr22	44201157	44401157	harbor1	chr22	44232416	44232628	LTR/ERVL-MaLR	1024	+	106	44232522	31365
chr22	44201157	44401157	harbor1	chr22	44232766	44232913	LTR/ERVL-MaLR	941	+	74	44232840	31683
chr22	44201157	44401157	harbor1	chr22	44235847	44235975	LTR/ERVL-MaLR	732	+	64	44235911	34754
chr22	44201157	44401157	harbor1	chr22	44263522	44263939	LTR/ERVL-MaLR	1412	+	208	44263730	62573
chr22	44201157	44401157	harbor1	chr22	44265116	44265677	LTR/ERVL-MaLR	1597	+	280	44265396	64239
chr22	44201157	44401157	harbor1	chr22	44291054	44291360	LTR/ERVL-MaLR	473	+	153	44291207	90050
chr22	45966963	46166963	harbor1	chr22	45985409	45985437	LTR/ERVL-MaLR	1605	+	14	45985423	18460
chr22	45966963	46166963	harbor1	chr22	45985984	45986469	LTR/ERVL-MaLR	1605	+	242	45986226	19263
chr22	45966963	46166963	harbor1	chr22	46009636	46010183	LTR/ERVL-MaLR	2146	+	274	46009910	42947
chr22	45966963	46166963	harbor1	chr22	46019390	46019730	LTR/ERVL-MaLR	2445	+	170	46019560	52597
chr22	45966963	46166963	harbor1	chr22	46020041	46020091	LTR/ERVL-MaLR	2445	+	25	46020066	53103
chr22	42986422	43186422	harbor1	chr22	43005818	43005954	LTR/ERVL-MaLR	700	+	68	43005886	19464
chr22	42986422	43186422	harbor1	chr22	43006098	43006316	LTR/ERVL-MaLR	801	+	109	43006207	19785
chr22	42986422	43186422	harbor1	chr22	43085385	43085710	LTR/ERVL-MaLR	1973	+	162	43085547	99125
chr22	23976652	24176652	harbor1	chr22	24027506	24027899	LTR/ERVL-MaLR	1962	+	196	24027702	51050
chr22	42989585	43189585	harbor1	chr22	43005818	43005954	LTR/ERVL-MaLR	700	+	68	43005886	16301
chr22	42989585	43189585	harbor1	chr22	43006098	43006316	LTR/ERVL-MaLR	801	+	109	43006207	16622
chr22	42989585	43189585	harbor1	chr22	43085385	43085710	LTR/ERVL-MaLR	1973	+	162	43085547	95962
chr22	42756724	42956724	harbor1	chr22	42768237	42768714	LTR/ERVL-MaLR	1707	+	238	42768475	11751
chr22	42756724	42956724	harbor1	chr22	42772213	42772409	LTR/ERVL-MaLR	830	+	98	42772311	15587
chr22	42756724	42956724	harbor1	chr22	42781004	42781339	LTR/ERVL-MaLR	925	+	168	42781172	24448
chr22	42756724	42956724	harbor1	chr22	42781760	42782167	LTR/ERVL-MaLR	2041	+	204	42781964	25240
chr22	42756724	42956724	harbor1	chr22	42811030	42811376	LTR/ERVL-MaLR	443	+	173	42811203	54479
chr22	42756724	42956724	harbor1	chr22	42848753	42849293	LTR/ERVL-MaLR	1730	+	270	42849023	92299
chr22	37416208	37616208	harbor1	chr22	37441047	37441259	LTR/ERVL-MaLR	448	+	106	37441153	24945
chr22	37416208	37616208	harbor1	chr22	37442540	37443012	LTR/ERVL-MaLR	1188	+	236	37442776	26568
chr22	37416208	37616208	harbor1	chr22	37451557	37451897	LTR/ERVL-MaLR	1531	+	170	37451727	35519
chr22	37416208	37616208	harbor1	chr22	37454479	37454693	LTR/ERVL-MaLR	502	+	107	37454586	38378
chr22	36407036	36607036	harbor1	chr22	36415581	36415852	LTR/ERVL-MaLR	1278	+	136	36415717	8681
chr22	36407036	36607036	harbor1	chr22	36416851	36417113	LTR/ERVL-MaLR	1278	+	131	36416982	9946
chr22	36407036	36607036	harbor1	chr22	36443849	36444127	LTR/ERVL-MaLR	1310	+	139	36443988	36952
chr22	36407036	36607036	harbor1	chr22	36444427	36444505	LTR/ERVL-MaLR	1310	+	39	36444466	37430
chr22	36407036	36607036	harbor1	chr22	36445037	36445143	LTR/ERVL-MaLR	488	+	53	36445090	38054
chr22	36407036	36607036	harbor1	chr22	36460320	36460515	LTR/ERVL-MaLR	1261	+	98	36460418	53382
chr22	36407036	36607036	harbor1	chr22	36491293	36491394	LTR/ERVL-MaLR	628	+	50	36491343	84307
chr22	36407036	36607036	harbor1	chr22	36491693	36491708	LTR/ERVL-MaLR	466	+	8	36491701	84665
chr22	36407036	36607036	harbor1	chr22	36491702	36491818	LTR/ERVL-MaLR	739	+	58	36491760	84724
chr22	36186433	36386433	harbor1	chr22	36195569	36195776	LTR/ERVL-MaLR	1202	+	104	36195673	9240
chr22	36186433	36386433	harbor1	chr22	36195818	36196011	LTR/ERVL-MaLR	1202	+	96	36195914	9481
chr22	36186433	36386433	harbor1	chr22	36231609	36231764	LTR/ERVL-MaLR	627	+	78	36231687	45254
chr22	36186433	36386433	harbor1	chr22	36273041	36273347	LTR/ERVL-MaLR	1156	+	153	36273194	86761
chr22	36194376	36394376	harbor1	chr22	36195569	36195776	LTR/ERVL-MaLR	1202	+	104	36195673	1297
chr22	36194376	36394376	harbor1	chr22	36195818	36196011	LTR/ERVL-MaLR	1202	+	96	36195914	1538
chr22	36194376	36394376	harbor1	chr22	36231609	36231764	LTR/ERVL-MaLR	627	+	78	36231687	37311
chr22	36194376	36394376	harbor1	chr22	36273041	36273347	LTR/ERVL-MaLR	1156	+	153	36273194	78818
chr22	36918544	37118544	harbor1	chr22	36920297	36920586	LTR/ERVL-MaLR	1051	+	144	36920441	1897
chr22	36918544	37118544	harbor1	chr22	36956467	36956905	LTR/ERVL-MaLR	2725	+	219	36956686	38142
chr22	36918544	37118544	harbor1	chr22	36964193	36964699	LTR/ERVL-MaLR	1393	+	253	36964446	45902
chr22	36918544	37118544	harbor1	chr22	36989698	36990164	LTR/ERVL-MaLR	1049	+	233	36989931	71387
chr22	36918544	37118544	harbor1	chr22	36995649	36995888	LTR/ERVL-MaLR	1397	+	120	36995769	77225
chr22	36918544	37118544	harbor1	chr22	37004988	37005417	LTR/ERVL-MaLR	1195	+	214	37005202	86658
chr22	36918544	37118544	harbor1	chr22	37005419	37006723	LTR/ERVL-MaLR	1825	+	652	37006071	87527
chr22	36918544	37118544	harbor1	chr22	37006726	37007239	LTR/ERVL-MaLR	2185	+	256	37006982	88438
chr22	50098549	50298549	harbor1	chr22	50099105	50099353	LTR/ERVL-MaLR	1145	+	124	50099229	680
chr22	45868002	46068002	harbor1	chr22	45910989	45911429	LTR/ERVL-MaLR	873	+	220	45911209	43207
chr22	45868002	46068002	harbor1	chr22	45927448	45927613	LTR/ERVL-MaLR	401	+	82	45927530	59528
chr22	45868002	46068002	harbor1	chr22	45927920	45928082	LTR/ERVL-MaLR	401	+	81	45928001	59999
chr22	36186444	36386444	harbor1	chr22	36195569	36195776	LTR/ERVL-MaLR	1202	+	104	36195673	9229
chr22	36186444	36386444	harbor1	chr22	36195818	36196011	LTR/ERVL-MaLR	1202	+	96	36195914	9470
chr22	36186444	36386444	harbor1	chr22	36231609	36231764	LTR/ERVL-MaLR	627	+	78	36231687	45243
chr22	36186444	36386444	harbor1	chr22	36273041	36273347	LTR/ERVL-MaLR	1156	+	153	36273194	86750
chr22	36406317	36606317	harbor1	chr22	36415581	36415852	LTR/ERVL-MaLR	1278	+	136	36415717	9400
chr22	36406317	36606317	harbor1	chr22	36416851	36417113	LTR/ERVL-MaLR	1278	+	131	36416982	10665
chr22	36406317	36606317	harbor1	chr22	36443849	36444127	LTR/ERVL-MaLR	1310	+	139	36443988	37671
chr22	36406317	36606317	harbor1	chr22	36444427	36444505	LTR/ERVL-MaLR	1310	+	39	36444466	38149
chr22	36406317	36606317	harbor1	chr22	36445037	36445143	LTR/ERVL-MaLR	488	+	53	36445090	38773
chr22	36406317	36606317	harbor1	chr22	36460320	36460515	LTR/ERVL-MaLR	1261	+	98	36460418	54101
chr22	36406317	36606317	harbor1	chr22	36491293	36491394	LTR/ERVL-MaLR	628	+	50	36491343	85026
chr22	36406317	36606317	harbor1	chr22	36491693	36491708	LTR/ERVL-MaLR	466	+	8	36491701	85384
chr22	36406317	36606317	harbor1	chr22	36491702	36491818	LTR/ERVL-MaLR	739	+	58	36491760	85443
chr22	19658147	19858147	harbor1	chr22	19669259	19669605	LTR/ERVL-MaLR	1463	+	173	19669432	11285
chr22	19658147	19858147	harbor1	chr22	19679084	19679437	LTR/ERVL-MaLR	1336	+	176	19679260	21113
chr22	19658147	19858147	harbor1	chr22	19693846	19694198	LTR/ERVL-MaLR	1647	+	176	19694022	35875
chr22	19658147	19858147	harbor1	chr22	19697120	19697263	LTR/ERVL-MaLR	541	+	72	19697192	39045
chr22	19658147	19858147	harbor1	chr22	19705922	19706074	LTR/ERVL-MaLR	1477	+	76	19705998	47851
chr22	19658147	19858147	harbor1	chr22	19706359	19706395	LTR/ERVL-MaLR	1477	+	18	19706377	48230
chr22	19658147	19858147	harbor1	chr22	19706711	19706933	LTR/ERVL-MaLR	1477	+	111	19706822	48675
chr22	50061640	50261640	harbor1	chr22	50086974	50087368	LTR/ERVL-MaLR	2724	+	197	50087171	25531
chr22	50061640	50261640	harbor1	chr22	50099105	50099353	LTR/ERVL-MaLR	1145	+	124	50099229	37589
chr22	46291620	46491620	harbor1	chr22	46303675	46304008	LTR/ERVL-MaLR	1224	+	166	46303841	12221
chr22	46291620	46491620	harbor1	chr22	46304290	46304345	LTR/ERVL-MaLR	1224	+	28	46304318	12698
chr22	46291620	46491620	harbor1	chr22	46382978	46383175	LTR/ERVL-MaLR	927	+	98	46383076	91456
chr22	42951342	43151342	harbor1	chr22	42977600	42977970	LTR/ERVL-MaLR	1841	+	185	42977785	26443
chr22	42951342	43151342	harbor1	chr22	43005818	43005954	LTR/ERVL-MaLR	700	+	68	43005886	54544
chr22	42951342	43151342	harbor1	chr22	43006098	43006316	LTR/ERVL-MaLR	801	+	109	43006207	54865
chr22	39578199	39778199	harbor1	chr22	39611992	39612381	LTR/ERVL-MaLR	2162	+	194	39612186	33987
chr22	19658301	19858301	harbor1	chr22	19669259	19669605	LTR/ERVL-MaLR	1463	+	173	19669432	11131
chr22	19658301	19858301	harbor1	chr22	19679084	19679437	LTR/ERVL-MaLR	1336	+	176	19679260	20959
chr22	19658301	19858301	harbor1	chr22	19693846	19694198	LTR/ERVL-MaLR	1647	+	176	19694022	35721
chr22	19658301	19858301	harbor1	chr22	19697120	19697263	LTR/ERVL-MaLR	541	+	72	19697192	38891
chr22	19658301	19858301	harbor1	chr22	19705922	19706074	LTR/ERVL-MaLR	1477	+	76	19705998	47697
chr22	19658301	19858301	harbor1	chr22	19706359	19706395	LTR/ERVL-MaLR	1477	+	18	19706377	48076
chr22	19658301	19858301	harbor1	chr22	19706711	19706933	LTR/ERVL-MaLR	1477	+	111	19706822	48521
chr22	22547227	22747227	harbor1	chr22	22567950	22568345	LTR/ERVL-MaLR	1119	+	198	22568148	20921
chr22	22547227	22747227	harbor1	chr22	22592850	22593010	LTR/ERVL-MaLR	543	+	80	22592930	45703
chr22	22547227	22747227	harbor1	chr22	22593014	22593408	LTR/ERVL-MaLR	1520	+	197	22593211	45984
chr22	39578244	39778244	harbor1	chr22	39611992	39612381	LTR/ERVL-MaLR	2162	+	194	39612186	33942
chr22	28341001	28541001	harbor1	chr22	28362122	28362475	LTR/ERVL-MaLR	2241	+	176	28362298	21297
chr22	28341001	28541001	harbor1	chr22	28362476	28364086	LTR/ERVL-MaLR	11770	+	805	28363281	22280
chr22	28341001	28541001	harbor1	chr22	28364089	28364442	LTR/ERVL-MaLR	2341	+	176	28364265	23264
chr22	49851551	50051551	harbor1	chr22	49945817	49945986	LTR/ERVL-MaLR	621	+	84	49945901	94350
chr22	49851551	50051551	harbor1	chr22	49905370	49905793	LTR/ERVL-MaLR	2520	+	212	49905582	54031
chr22	24394912	24594912	harbor1	chr22	24463040	24463405	LTR/ERVL-MaLR	2020	+	182	24463222	68310
chr22	24394912	24594912	harbor1	chr22	24465688	24466169	LTR/ERVL-MaLR	2078	+	240	24465928	71016
chr22	24007472	24207472	harbor1	chr22	24027506	24027899	LTR/ERVL-MaLR	1962	+	196	24027702	20230
chr22	37218535	37418535	harbor1	chr22	37224845	37225344	LTR/ERVL-MaLR	947	+	250	37225095	6560
chr22	37218535	37418535	harbor1	chr22	37253085	37253266	LTR/ERVL-MaLR	522	+	90	37253175	34640
chr22	37218535	37418535	harbor1	chr22	37261467	37261781	LTR/ERVL-MaLR	1384	+	157	37261624	43089
chr22	37218535	37418535	harbor1	chr22	37263117	37263210	LTR/ERVL-MaLR	2162	+	46	37263163	44628
chr22	37218535	37418535	harbor1	chr22	37263494	37263789	LTR/ERVL-MaLR	2162	+	148	37263642	45107
chr22	37218535	37418535	harbor1	chr22	37270828	37270987	LTR/ERVL-MaLR	516	+	80	37270908	52373
chr22	37218535	37418535	harbor1	chr22	37276864	37277120	LTR/ERVL-MaLR	518	+	128	37276992	58457
chr22	37218535	37418535	harbor1	chr22	37279026	37279292	LTR/ERVL-MaLR	771	+	133	37279159	60624
chr22	37218535	37418535	harbor1	chr22	37291988	37292153	LTR/ERVL-MaLR	569	+	82	37292070	73535
chr22	23971820	24171820	harbor1	chr22	24027506	24027899	LTR/ERVL-MaLR	1962	+	196	24027702	55882
chr22	17452700	17652700	harbor1	chr22	17516443	17516601	LTR/ERVL-MaLR	1468	+	79	17516522	63822
chr22	17452700	17652700	harbor1	chr22	17516893	17516921	LTR/ERVL-MaLR	1468	+	14	17516907	64207
chr22	17452700	17652700	harbor1	chr22	17517177	17517435	LTR/ERVL-MaLR	1468	+	129	17517306	64606
chr22	44788190	44988190	harbor1	chr22	44826940	44827336	LTR/ERVL-MaLR	1910	+	198	44827138	38948
chr22	44788190	44988190	harbor1	chr22	44827643	44827701	LTR/ERVL-MaLR	1910	+	29	44827672	39482
chr22	44788190	44988190	harbor1	chr22	44859185	44859537	LTR/ERVL-MaLR	1792	+	176	44859361	71171
chr22	39578286	39778286	harbor1	chr22	39611992	39612381	LTR/ERVL-MaLR	2162	+	194	39612186	33900
chr22	18822251	19022251	harbor1	chr22	18861334	18861719	LTR/ERVL-MaLR	520	+	192	18861526	39275
chr22	18822251	19022251	harbor1	chr22	18920649	18921078	LTR/ERVL-MaLR	693	+	214	18920863	98612
chr22	24852758	25052758	harbor1	chr22	24932452	24932703	LTR/ERVL-MaLR	391	+	126	24932578	79820
chr22	23421603	23621603	harbor1	chr22	23509856	23510184	LTR/ERVL-MaLR	617	+	164	23510020	88417
chr22	23421603	23621603	harbor1	chr22	23517475	23517749	LTR/ERVL-MaLR	1267	+	137	23517612	96009
chr22	42519774	42719774	harbor1	chr22	42522606	42522995	LTR/ERVL-MaLR	1970	+	194	42522800	3026
chr22	42519774	42719774	harbor1	chr22	42523363	42523404	LTR/ERVL-MaLR	1472	+	20	42523383	3609
chr22	42519774	42719774	harbor1	chr22	42524001	42524431	LTR/ERVL-MaLR	1472	+	215	42524216	4442
chr22	42519774	42719774	harbor1	chr22	42530918	42531148	LTR/ERVL-MaLR	847	+	115	42531033	11259
chr22	42519774	42719774	harbor1	chr22	42532364	42532623	LTR/ERVL-MaLR	632	+	130	42532494	12720
chr22	42519774	42719774	harbor1	chr22	42604817	42605113	LTR/ERVL-MaLR	1964	+	148	42604965	85191
chr22	42519774	42719774	harbor1	chr22	42605425	42605492	LTR/ERVL-MaLR	1964	+	34	42605459	85685
chr22	46266866	46466866	harbor1	chr22	46303675	46304008	LTR/ERVL-MaLR	1224	+	166	46303841	36975
chr22	46266866	46466866	harbor1	chr22	46304290	46304345	LTR/ERVL-MaLR	1224	+	28	46304318	37452
chr22	18756011	18956011	harbor1	chr22	18798869	18799048	LTR/ERVL-MaLR	443	+	90	18798959	42948
chr22	18756011	18956011	harbor1	chr22	18799302	18799717	LTR/ERVL-MaLR	2698	+	208	18799510	43499
chr22	18756011	18956011	harbor1	chr22	18799835	18800002	LTR/ERVL-MaLR	698	+	84	18799919	43908
chr22	18756011	18956011	harbor1	chr22	18802944	18803485	LTR/ERVL-MaLR	1024	+	270	18803214	47203
chr22	18756011	18956011	harbor1	chr22	18812693	18813219	LTR/ERVL-MaLR	1045	+	263	18812956	56945
chr22	37416206	37616206	harbor1	chr22	37441047	37441259	LTR/ERVL-MaLR	448	+	106	37441153	24947
chr22	37416206	37616206	harbor1	chr22	37442540	37443012	LTR/ERVL-MaLR	1188	+	236	37442776	26570
chr22	37416206	37616206	harbor1	chr22	37451557	37451897	LTR/ERVL-MaLR	1531	+	170	37451727	35521
chr22	37416206	37616206	harbor1	chr22	37454479	37454693	LTR/ERVL-MaLR	502	+	107	37454586	38380
chr22	38674448	38874448	harbor1	chr22	38744919	38745433	LTR/ERVL-MaLR	1301	+	257	38745176	70728
chr22	38674448	38874448	harbor1	chr22	38757658	38757830	LTR/ERVL-MaLR	625	+	86	38757744	83296
chr22	38674448	38874448	harbor1	chr22	38758164	38758220	LTR/ERVL-MaLR	625	+	28	38758192	83744
chr22	38674424	38874424	harbor1	chr22	38744919	38745433	LTR/ERVL-MaLR	1301	+	257	38745176	70752
chr22	38674424	38874424	harbor1	chr22	38757658	38757830	LTR/ERVL-MaLR	625	+	86	38757744	83320
chr22	38674424	38874424	harbor1	chr22	38758164	38758220	LTR/ERVL-MaLR	625	+	28	38758192	83768
chr22	24852840	25052840	harbor1	chr22	24932452	24932703	LTR/ERVL-MaLR	391	+	126	24932578	79738
chr22	37416203	37616203	harbor1	chr22	37441047	37441259	LTR/ERVL-MaLR	448	+	106	37441153	24950
chr22	37416203	37616203	harbor1	chr22	37442540	37443012	LTR/ERVL-MaLR	1188	+	236	37442776	26573
chr22	37416203	37616203	harbor1	chr22	37451557	37451897	LTR/ERVL-MaLR	1531	+	170	37451727	35524
chr22	37416203	37616203	harbor1	chr22	37454479	37454693	LTR/ERVL-MaLR	502	+	107	37454586	38383
chr22	20395167	20595167	harbor1	chr22	20443243	20443458	LTR/ERVL-MaLR	1577	+	108	20443351	48184
chr22	20395167	20595167	harbor1	chr22	20443755	20443765	LTR/ERVL-MaLR	1274	+	5	20443760	48593
chr22	20395167	20595167	harbor1	chr22	20444075	20444431	LTR/ERVL-MaLR	1274	+	178	20444253	49086
chr22	20395167	20595167	harbor1	chr22	20460850	20461166	LTR/ERVL-MaLR	1246	+	158	20461008	65841
chrX	135350040	135550040	harbor1	chrX	135365900	135366396	LTR/ERVL-MaLR	1355	+	248	135366148	16108
chrX	135350040	135550040	harbor1	chrX	135376748	135377175	LTR/ERVL-MaLR	2862	+	214	135376962	26922
chrX	135350040	135550040	harbor1	chrX	135383899	135384367	LTR/ERVL-MaLR	1485	+	234	135384133	34093
chrX	135350040	135550040	harbor1	chrX	135412489	135412849	LTR/ERVL-MaLR	2235	+	180	135412669	62629
chrX	135350040	135550040	harbor1	chrX	135417588	135418002	LTR/ERVL-MaLR	2800	+	207	135417795	67755
chrX	24365240	24565240	harbor1	chrX	24382421	24382780	LTR/ERVL-MaLR	2269	+	180	24382601	17361
chrX	24365240	24565240	harbor1	chrX	24414230	24414606	LTR/ERVL-MaLR	2053	+	188	24414418	49178
chrX	24365240	24565240	harbor1	chrX	24414609	24414710	LTR/ERVL-MaLR	559	+	50	24414659	49419
chrX	24365240	24565240	harbor1	chrX	24414900	24416171	LTR/ERVL-MaLR	5694	+	636	24415536	50296
chrX	24365240	24565240	harbor1	chrX	24416736	24416956	LTR/ERVL-MaLR	5694	+	110	24416846	51606
chrX	24365240	24565240	harbor1	chrX	24416957	24417329	LTR/ERVL-MaLR	1821	+	186	24417143	51903
chrX	24365240	24565240	harbor1	chrX	24417447	24417924	LTR/ERVL-MaLR	912	+	238	24417685	52445
chrX	24365240	24565240	harbor1	chrX	24429139	24429497	LTR/ERVL-MaLR	2094	+	179	24429318	64078
chrX	24365240	24565240	harbor1	chrX	24441796	24442186	LTR/ERVL-MaLR	2196	+	195	24441991	76751
chrX	24365240	24565240	harbor1	chrX	24446014	24446477	LTR/ERVL-MaLR	2445	+	232	24446246	81006
chrX	24365240	24565240	harbor1	chrX	24452848	24453210	LTR/ERVL-MaLR	2576	+	181	24453029	87789
chrX	48953792	49153792	harbor1	chrX	48984005	48984452	LTR/ERVL-MaLR	1606	+	224	48984229	30437
chrX	48953792	49153792	harbor1	chrX	49024500	49025056	LTR/ERVL-MaLR	1486	+	278	49024778	70986
chrX	48953792	49153792	harbor1	chrX	49048652	49048847	LTR/ERVL-MaLR	810	+	98	49048750	94958
chrX	48953792	49153792	harbor1	chrX	49049508	49049620	LTR/ERVL-MaLR	569	+	56	49049564	95772
chrX	153409879	153609879	harbor1	chrX	153417722	153418136	LTR/ERVL-MaLR	1338	+	207	153417929	8050
chrX	153409879	153609879	harbor1	chrX	153426669	153427083	LTR/ERVL-MaLR	2840	+	207	153426876	16997
chrX	153409879	153609879	harbor1	chrX	153427791	153427855	LTR/ERVL-MaLR	1694	+	32	153427823	17944
chrX	153409879	153609879	harbor1	chrX	153428217	153428527	LTR/ERVL-MaLR	1694	+	155	153428372	18493
chrX	153409879	153609879	harbor1	chrX	153431293	153431648	LTR/ERVL-MaLR	1502	+	178	153431471	21592
chrX	153409879	153609879	harbor1	chrX	153436822	153437289	LTR/ERVL-MaLR	1974	+	234	153437056	27177
chrX	153409879	153609879	harbor1	chrX	153439629	153439938	LTR/ERVL-MaLR	762	+	154	153439783	29904
chrX	153409879	153609879	harbor1	chrX	153443144	153443474	LTR/ERVL-MaLR	1000	+	165	153443309	33430
chrX	72206994	72406994	harbor1	chrX	72216042	72216423	LTR/ERVL-MaLR	1583	+	190	72216232	9238
chrX	72206994	72406994	harbor1	chrX	72241182	72241541	LTR/ERVL-MaLR	2070	+	180	72241362	34368
chrX	72206994	72406994	harbor1	chrX	72241830	72241879	LTR/ERVL-MaLR	2070	+	24	72241854	34860
chrX	72206994	72406994	harbor1	chrX	72284245	72284573	LTR/ERVL-MaLR	2208	+	164	72284409	77415
chrX	72206994	72406994	harbor1	chrX	72288293	72288644	LTR/ERVL-MaLR	2746	+	176	72288469	81475
chrX	48953749	49153749	harbor1	chrX	48984005	48984452	LTR/ERVL-MaLR	1606	+	224	48984229	30480
chrX	48953749	49153749	harbor1	chrX	49024500	49025056	LTR/ERVL-MaLR	1486	+	278	49024778	71029
chrX	48953749	49153749	harbor1	chrX	49048652	49048847	LTR/ERVL-MaLR	810	+	98	49048750	95001
chrX	48953749	49153749	harbor1	chrX	49049508	49049620	LTR/ERVL-MaLR	569	+	56	49049564	95815
chrX	18254781	18454781	harbor1	chrX	18269179	18269553	LTR/ERVL-MaLR	2399	+	187	18269366	14585
chrX	18254781	18454781	harbor1	chrX	18313197	18313547	LTR/ERVL-MaLR	2737	+	175	18313372	58591
chrX	18254781	18454781	harbor1	chrX	18318845	18319108	LTR/ERVL-MaLR	1604	+	132	18318977	64196
chrX	18254781	18454781	harbor1	chrX	18319695	18319960	LTR/ERVL-MaLR	1075	+	132	18319827	65046
chrX	18254781	18454781	harbor1	chrX	18320103	18320212	LTR/ERVL-MaLR	834	+	54	18320157	65376
chrX	18254781	18454781	harbor1	chrX	18344462	18344810	LTR/ERVL-MaLR	2107	+	174	18344636	89855
chrX	152928214	153128214	harbor1	chrX	153002235	153002551	LTR/ERVL-MaLR	1615	+	158	153002393	74179
chrX	152928214	153128214	harbor1	chrX	153009578	153009772	LTR/ERVL-MaLR	1335	+	97	153009675	81461
chrX	130071741	130271741	harbor1	chrX	130153522	130153921	LTR/ERVL-MaLR	1416	+	200	130153722	81981
chrX	150672938	150872938	harbor1	chrX	150680420	150680950	LTR/ERVL-MaLR	1943	+	265	150680685	7747
chrX	150672938	150872938	harbor1	chrX	150687597	150687986	LTR/ERVL-MaLR	1920	+	194	150687791	14853
chrX	150672938	150872938	harbor1	chrX	150690952	150691393	LTR/ERVL-MaLR	2389	+	220	150691172	18234
chrX	150672938	150872938	harbor1	chrX	150734856	150735295	LTR/ERVL-MaLR	1995	+	220	150735076	62138
chrX	150672938	150872938	harbor1	chrX	150736053	150736470	LTR/ERVL-MaLR	1686	+	208	150736261	63323
chrX	72206945	72406945	harbor1	chrX	72216042	72216423	LTR/ERVL-MaLR	1583	+	190	72216232	9287
chrX	72206945	72406945	harbor1	chrX	72241182	72241541	LTR/ERVL-MaLR	2070	+	180	72241362	34417
chrX	72206945	72406945	harbor1	chrX	72241830	72241879	LTR/ERVL-MaLR	2070	+	24	72241854	34909
chrX	72206945	72406945	harbor1	chrX	72284245	72284573	LTR/ERVL-MaLR	2208	+	164	72284409	77464
chrX	72206945	72406945	harbor1	chrX	72288293	72288644	LTR/ERVL-MaLR	2746	+	176	72288469	81524
chrX	18254315	18454315	harbor1	chrX	18269179	18269553	LTR/ERVL-MaLR	2399	+	187	18269366	15051
chrX	18254315	18454315	harbor1	chrX	18313197	18313547	LTR/ERVL-MaLR	2737	+	175	18313372	59057
chrX	18254315	18454315	harbor1	chrX	18318845	18319108	LTR/ERVL-MaLR	1604	+	132	18318977	64662
chrX	18254315	18454315	harbor1	chrX	18319695	18319960	LTR/ERVL-MaLR	1075	+	132	18319827	65512
chrX	18254315	18454315	harbor1	chrX	18320103	18320212	LTR/ERVL-MaLR	834	+	54	18320157	65842
chrX	18254315	18454315	harbor1	chrX	18344462	18344810	LTR/ERVL-MaLR	2107	+	174	18344636	90321
chrX	17671917	17871917	harbor1	chrX	17683894	17684261	LTR/ERVL-MaLR	2809	+	184	17684078	12161
chrX	39992279	40192279	harbor1	chrX	40021611	40022128	LTR/ERVL-MaLR	2771	+	258	40021869	29590
chrX	39992279	40192279	harbor1	chrX	40029644	40029872	LTR/ERVL-MaLR	1362	+	114	40029758	37479
chrX	39992279	40192279	harbor1	chrX	40030042	40030285	LTR/ERVL-MaLR	1017	+	122	40030164	37885
chrX	39992279	40192279	harbor1	chrX	40034974	40035045	LTR/ERVL-MaLR	970	+	36	40035010	42731
chrX	39992279	40192279	harbor1	chrX	40035352	40035447	LTR/ERVL-MaLR	970	+	48	40035400	43121
chrX	39992279	40192279	harbor1	chrX	40035743	40036073	LTR/ERVL-MaLR	970	+	165	40035908	43629
chrX	286893	486893	harbor1	chrX	309499	309740	LTR/ERVL-MaLR	695	+	120	309619	22726
chrX	286893	486893	harbor1	chrX	309756	310079	LTR/ERVL-MaLR	873	+	162	309918	23025
chrX	286893	486893	harbor1	chrX	310095	310419	LTR/ERVL-MaLR	871	+	162	310257	23364
chrX	286893	486893	harbor1	chrX	310435	310746	LTR/ERVL-MaLR	787	+	156	310591	23698
chrX	286893	486893	harbor1	chrX	313492	313895	LTR/ERVL-MaLR	978	+	202	313694	26801
chrX	286893	486893	harbor1	chrX	349102	349404	LTR/ERVL-MaLR	1155	+	151	349253	62360
chrX	153409904	153609904	harbor1	chrX	153417722	153418136	LTR/ERVL-MaLR	1338	+	207	153417929	8025
chrX	153409904	153609904	harbor1	chrX	153426669	153427083	LTR/ERVL-MaLR	2840	+	207	153426876	16972
chrX	153409904	153609904	harbor1	chrX	153427791	153427855	LTR/ERVL-MaLR	1694	+	32	153427823	17919
chrX	153409904	153609904	harbor1	chrX	153428217	153428527	LTR/ERVL-MaLR	1694	+	155	153428372	18468
chrX	153409904	153609904	harbor1	chrX	153431293	153431648	LTR/ERVL-MaLR	1502	+	178	153431471	21567
chrX	153409904	153609904	harbor1	chrX	153436822	153437289	LTR/ERVL-MaLR	1974	+	234	153437056	27152
chrX	153409904	153609904	harbor1	chrX	153439629	153439938	LTR/ERVL-MaLR	762	+	154	153439783	29879
chrX	153409904	153609904	harbor1	chrX	153443144	153443474	LTR/ERVL-MaLR	1000	+	165	153443309	33405
