H_chr	H_start	H_end	Harbor	TE_chr	TE_start	TE_end	TE	score	TE_strand	TE_half	TE_middle_pos	TE_dis
chr1	8230832	8430832	harbor2	chr1	8249893	8250469	LTR/ERV1	3230	+	288	8250181	19349
chr1	150462182	150662182	harbor2	chr1	150531155	150531212	LTR/ERV1	2485	+	28	150531183	69001
chr1	150462182	150662182	harbor2	chr1	150531490	150531932	LTR/ERV1	2485	+	221	150531711	69529
chr1	150462182	150662182	harbor2	chr1	150532207	150532247	LTR/ERV1	2485	+	20	150532227	70045
chr1	21991636	22191636	harbor2	chr1	21993006	21993153	LTR/ERV1	753	+	74	21993080	1444
chr1	21991636	22191636	harbor2	chr1	21996200	21996695	LTR/ERV1	3321	+	248	21996448	4812
chr1	21991636	22191636	harbor2	chr1	22021164	22021646	LTR/ERV1	2256	+	241	22021405	29769
chr1	21991636	22191636	harbor2	chr1	22070132	22070443	LTR/ERV1	4507	+	156	22070288	78652
chr1	21991636	22191636	harbor2	chr1	22070764	22071032	LTR/ERV1	4507	+	134	22070898	79262
chr1	196878094	197078094	harbor2	chr1	196933510	196934428	LTR/ERV1	5237	+	459	196933969	55875
chr1	16597141	16797141	harbor2	chr1	16667986	16668531	LTR/ERV1	3509	+	272	16668258	71117
chr1	16597141	16797141	harbor2	chr1	16674777	16675682	LTR/ERV1	4973	+	452	16675229	78088
chr1	1451442	1651442	harbor2	chr1	1469769	1470201	LTR/ERV1	3482	+	216	1469985	18543
chr1	1451442	1651442	harbor2	chr1	1470859	1471236	LTR/ERV1	1862	+	188	1471047	19605
chr1	89907751	90107751	harbor2	chr1	89912336	89912639	LTR/ERV1	1244	+	152	89912488	4737
chr1	89907751	90107751	harbor2	chr1	89952738	89953657	LTR/ERV1	3799	+	460	89953198	45447
chr1	89907751	90107751	harbor2	chr1	89955198	89955825	LTR/ERV1	2987	+	314	89955512	47761
chr1	89907751	90107751	harbor2	chr1	89965868	89966129	LTR/ERV1	2144	+	130	89965998	58247
chr1	89907751	90107751	harbor2	chr1	89966458	89966814	LTR/ERV1	2144	+	178	89966636	58885
chr1	193014143	193214143	harbor2	chr1	193021365	193021606	LTR/ERV1	893	+	120	193021485	7342
chr1	193014143	193214143	harbor2	chr1	193021612	193021720	LTR/ERV1	441	+	54	193021666	7523
chr1	193014143	193214143	harbor2	chr1	193110359	193110508	LTR/ERV1	1039	+	74	193110433	96290
chr1	193014143	193214143	harbor2	chr1	193110801	193110921	LTR/ERV1	1039	+	60	193110861	96718
chr1	193014143	193214143	harbor2	chr1	193111403	193111641	LTR/ERV1	628	+	119	193111522	97379
chr1	16808665	17008665	harbor2	chr1	16876821	16877538	LTR/ERV1	2769	+	358	16877179	68514
chr1	16808665	17008665	harbor2	chr1	16877845	16878758	LTR/ERV1	2769	+	456	16878301	69636
chr1	16808665	17008665	harbor2	chr1	16892232	16892285	LTR/ERV1	895	+	26	16892258	83593
chr1	16808665	17008665	harbor2	chr1	16892582	16892736	LTR/ERV1	895	+	77	16892659	83994
chr1	16808665	17008665	harbor2	chr1	16892755	16893007	LTR/ERV1	617	+	126	16892881	84216
chr1	16808665	17008665	harbor2	chr1	16893062	16893197	LTR/ERV1	2978	+	68	16893130	84465
chr1	16808665	17008665	harbor2	chr1	16893547	16894128	LTR/ERV1	2978	+	290	16893837	85172
chr1	16808665	17008665	harbor2	chr1	16900667	16901163	LTR/ERV1	2089	+	248	16900915	92250
chr1	16808665	17008665	harbor2	chr1	16901743	16902026	LTR/ERV1	531	+	142	16901885	93220
chr1	16808665	17008665	harbor2	chr1	16903668	16904000	LTR/ERV1	508	+	166	16903834	95169
chr1	16808665	17008665	harbor2	chr1	16905464	16905857	LTR/ERV1	1328	+	196	16905660	96995
chr1	16808665	17008665	harbor2	chr1	16907531	16907942	LTR/ERV1	2029	+	206	16907737	99072
chr1	230009530	230209530	harbor2	chr1	230018264	230018664	LTR/ERV1	2575	+	200	230018464	8934
chr1	230009530	230209530	harbor2	chr1	230026378	230027050	LTR/ERV1	3942	+	336	230026714	17184
chr1	230009530	230209530	harbor2	chr1	230036649	230037440	LTR/ERV1	4986	+	396	230037045	27515
chr1	16603811	16803811	harbor2	chr1	16667986	16668531	LTR/ERV1	3509	+	272	16668258	64447
chr1	16603811	16803811	harbor2	chr1	16674777	16675682	LTR/ERV1	4973	+	452	16675229	71418
chr1	227442365	227642365	harbor2	chr1	227499424	227499610	LTR/ERV1	830	+	93	227499517	57152
chr1	227442365	227642365	harbor2	chr1	227500566	227503796	LTR/ERV1	12933	+	1615	227502181	59816
chr1	227442365	227642365	harbor2	chr1	227504450	227506052	LTR/ERV1	12933	+	801	227505251	62886
chr1	227442365	227642365	harbor2	chr1	227516809	227518273	LTR/ERV1	2504	+	732	227517541	75176
chr1	145350740	145550740	harbor2	chr1	145409349	145410006	LTR/ERV1	4808	+	328	145409677	58937
chr1	145350740	145550740	harbor2	chr1	145445027	145445129	LTR/ERV1	649	+	51	145445078	94338
chr1	77659514	77859514	harbor2	chr1	77670768	77670877	LTR/ERV1	497	+	54	77670822	11308
chr1	77659514	77859514	harbor2	chr1	77671033	77671299	LTR/ERV1	1508	+	133	77671166	11652
chr1	6689234	6889234	harbor2	chr1	6693819	6693834	LTR/ERV1	848	+	8	6693827	4593
chr1	6689234	6889234	harbor2	chr1	6694137	6694304	LTR/ERV1	848	+	84	6694221	4987
chr1	6689234	6889234	harbor2	chr1	6694340	6694611	LTR/ERV1	936	+	136	6694476	5242
chr1	6689234	6889234	harbor2	chr1	6699931	6700411	LTR/ERV1	3152	+	240	6700171	10937
chr1	6689234	6889234	harbor2	chr1	6747770	6748324	LTR/ERV1	3616	+	277	6748047	58813
chr1	6689234	6889234	harbor2	chr1	6750611	6750709	LTR/ERV1	550	+	49	6750660	61426
chr1	6689234	6889234	harbor2	chr1	6752295	6752737	LTR/ERV1	3242	+	221	6752516	63282
chr1	17341836	17541836	harbor2	chr1	17366435	17366903	LTR/ERV1	905	+	234	17366669	24833
chr1	17341836	17541836	harbor2	chr1	17370496	17370668	LTR/ERV1	902	+	86	17370582	28746
chr1	3679565	3879565	harbor2	chr1	3741083	3741698	LTR/ERV1	3116	+	308	3741391	61826
chr1	3679565	3879565	harbor2	chr1	3751583	3751609	LTR/ERV1	574	+	13	3751596	72031
chr1	3679565	3879565	harbor2	chr1	3751901	3752001	LTR/ERV1	574	+	50	3751951	72386
chr1	244605778	244805778	harbor2	chr1	244642423	244643225	LTR/ERV1	4952	+	401	244642824	37046
chr1	6685470	6885470	harbor2	chr1	6685409	6685826	LTR/ERV1	2226	+	208	6685617	147
chr1	6685470	6885470	harbor2	chr1	6693819	6693834	LTR/ERV1	848	+	8	6693827	8357
chr1	6685470	6885470	harbor2	chr1	6694137	6694304	LTR/ERV1	848	+	84	6694221	8751
chr1	6685470	6885470	harbor2	chr1	6694340	6694611	LTR/ERV1	936	+	136	6694476	9006
chr1	6685470	6885470	harbor2	chr1	6699931	6700411	LTR/ERV1	3152	+	240	6700171	14701
chr1	6685470	6885470	harbor2	chr1	6747770	6748324	LTR/ERV1	3616	+	277	6748047	62577
chr1	6685470	6885470	harbor2	chr1	6750611	6750709	LTR/ERV1	550	+	49	6750660	65190
chr1	6685470	6885470	harbor2	chr1	6752295	6752737	LTR/ERV1	3242	+	221	6752516	67046
chr1	240671354	240871354	harbor2	chr1	240725424	240725681	LTR/ERV1	4471	+	128	240725552	54198
chr1	240671354	240871354	harbor2	chr1	240726002	240726497	LTR/ERV1	4471	+	248	240726250	54896
chr1	240671354	240871354	harbor2	chr1	240762308	240763695	LTR/ERV1	10253	+	694	240763002	91648
chr1	156560138	156760138	harbor2	chr1	156576103	156576520	LTR/ERV1	3217	+	208	156576311	16173
chr1	156560138	156760138	harbor2	chr1	156577747	156577840	LTR/ERV1	3217	+	46	156577793	17655
chr1	156560138	156760138	harbor2	chr1	156606453	156606489	LTR/ERV1	2112	+	18	156606471	46333
chr1	156560138	156760138	harbor2	chr1	156606783	156607154	LTR/ERV1	2112	+	186	156606969	46831
chr1	227442270	227642270	harbor2	chr1	227499424	227499610	LTR/ERV1	830	+	93	227499517	57247
chr1	227442270	227642270	harbor2	chr1	227500566	227503796	LTR/ERV1	12933	+	1615	227502181	59911
chr1	227442270	227642270	harbor2	chr1	227504450	227506052	LTR/ERV1	12933	+	801	227505251	62981
chr1	227442270	227642270	harbor2	chr1	227516809	227518273	LTR/ERV1	2504	+	732	227517541	75271
chr1	16625198	16825198	harbor2	chr1	16667986	16668531	LTR/ERV1	3509	+	272	16668258	43060
chr1	16625198	16825198	harbor2	chr1	16674777	16675682	LTR/ERV1	4973	+	452	16675229	50031
chr1	156560141	156760141	harbor2	chr1	156576103	156576520	LTR/ERV1	3217	+	208	156576311	16170
chr1	156560141	156760141	harbor2	chr1	156577747	156577840	LTR/ERV1	3217	+	46	156577793	17652
chr1	156560141	156760141	harbor2	chr1	156606453	156606489	LTR/ERV1	2112	+	18	156606471	46330
chr1	156560141	156760141	harbor2	chr1	156606783	156607154	LTR/ERV1	2112	+	186	156606969	46828
chr1	6685464	6885464	harbor2	chr1	6685409	6685826	LTR/ERV1	2226	+	208	6685617	153
chr1	6685464	6885464	harbor2	chr1	6693819	6693834	LTR/ERV1	848	+	8	6693827	8363
chr1	6685464	6885464	harbor2	chr1	6694137	6694304	LTR/ERV1	848	+	84	6694221	8757
chr1	6685464	6885464	harbor2	chr1	6694340	6694611	LTR/ERV1	936	+	136	6694476	9012
chr1	6685464	6885464	harbor2	chr1	6699931	6700411	LTR/ERV1	3152	+	240	6700171	14707
chr1	6685464	6885464	harbor2	chr1	6747770	6748324	LTR/ERV1	3616	+	277	6748047	62583
chr1	6685464	6885464	harbor2	chr1	6750611	6750709	LTR/ERV1	550	+	49	6750660	65196
chr1	6685464	6885464	harbor2	chr1	6752295	6752737	LTR/ERV1	3242	+	221	6752516	67052
chr1	53374991	53574991	harbor2	chr1	53402573	53403608	LTR/ERV1	3819	+	518	53403091	28100
chr1	53374991	53574991	harbor2	chr1	53421647	53422820	LTR/ERV1	10737	+	586	53422233	47242
chr1	53374991	53574991	harbor2	chr1	53423122	53423947	LTR/ERV1	10737	+	412	53423534	48543
chr1	53374991	53574991	harbor2	chr1	53424225	53424334	LTR/ERV1	10737	+	54	53424279	49288
chr1	53374991	53574991	harbor2	chr1	53424337	53424766	LTR/ERV1	3338	+	214	53424551	49560
chr1	53374991	53574991	harbor2	chr1	53424769	53427698	LTR/ERV1	15840	+	1464	53426233	51242
chr1	53374991	53574991	harbor2	chr1	53427671	53427840	LTR/ERV1	869	+	84	53427755	52764
chr1	53374991	53574991	harbor2	chr1	53428335	53428996	LTR/ERV1	4376	+	330	53428665	53674
chr1	53374991	53574991	harbor2	chr1	53428998	53429599	LTR/ERV1	2556	+	300	53429298	54307
chr1	53374991	53574991	harbor2	chr1	53429600	53430029	LTR/ERV1	3346	+	214	53429814	54823
chr1	53374991	53574991	harbor2	chr1	53430031	53430736	LTR/ERV1	4450	+	352	53430383	55392
chr1	53374991	53574991	harbor2	chr1	53430737	53431047	LTR/ERV1	3312	+	155	53430892	55901
chr1	53374991	53574991	harbor2	chr1	53431095	53431320	LTR/ERV1	3312	+	112	53431207	56216
chr1	53374991	53574991	harbor2	chr1	53432880	53432985	LTR/ERV1	703	+	52	53432932	57941
chr1	53374991	53574991	harbor2	chr1	53432998	53434803	LTR/ERV1	8266	+	902	53433900	58909
chr1	53374991	53574991	harbor2	chr1	53434809	53435177	LTR/ERV1	2006	+	184	53434993	60002
chr1	53374991	53574991	harbor2	chr1	53447480	53447860	LTR/ERV1	2473	+	190	53447670	72679
chr1	53374991	53574991	harbor2	chr1	53449415	53449824	LTR/ERV1	3003	+	204	53449619	74628
chr1	53374991	53574991	harbor2	chr1	53427831	53428332	LTR/ERV1	3387	+	250	53428081	53090
chr1	23859371	24059371	harbor2	chr1	23899292	23899533	LTR/ERV1	1776	+	120	23899412	40041
chr1	23859371	24059371	harbor2	chr1	23900011	23900435	LTR/ERV1	3223	+	212	23900223	40852
chr1	23859371	24059371	harbor2	chr1	23920659	23920924	LTR/ERV1	1186	+	132	23920791	61420
chr1	23859371	24059371	harbor2	chr1	23920924	23921139	LTR/ERV1	1094	+	108	23921032	61661
chr1	23859371	24059371	harbor2	chr1	23921912	23922117	LTR/ERV1	1076	+	102	23922014	62643
chr1	23859371	24059371	harbor2	chr1	23922422	23922448	LTR/ERV1	549	+	13	23922435	63064
chr1	23859371	24059371	harbor2	chr1	23922449	23922628	LTR/ERV1	700	+	90	23922539	63168
chr1	23859371	24059371	harbor2	chr1	23924439	23924497	LTR/ERV1	2026	+	29	23924468	65097
chr1	23859371	24059371	harbor2	chr1	23924809	23925263	LTR/ERV1	2026	+	227	23925036	65665
chr1	23859371	24059371	harbor2	chr1	23933190	23933650	LTR/ERV1	3826	+	230	23933420	74049
chr1	23859371	24059371	harbor2	chr1	23887710	23888236	LTR/ERV1	3957	+	263	23887973	28602
chr1	23859371	24059371	harbor2	chr1	23936525	23937195	LTR/ERV1	3191	+	335	23936860	77489
chr1	226638243	226838243	harbor2	chr1	226672144	226672561	LTR/ERV1	1191	+	208	226672352	34109
chr1	6685487	6885487	harbor2	chr1	6685409	6685826	LTR/ERV1	2226	+	208	6685617	130
chr1	6685487	6885487	harbor2	chr1	6693819	6693834	LTR/ERV1	848	+	8	6693827	8340
chr1	6685487	6885487	harbor2	chr1	6694137	6694304	LTR/ERV1	848	+	84	6694221	8734
chr1	6685487	6885487	harbor2	chr1	6694340	6694611	LTR/ERV1	936	+	136	6694476	8989
chr1	6685487	6885487	harbor2	chr1	6699931	6700411	LTR/ERV1	3152	+	240	6700171	14684
chr1	6685487	6885487	harbor2	chr1	6747770	6748324	LTR/ERV1	3616	+	277	6748047	62560
chr1	6685487	6885487	harbor2	chr1	6750611	6750709	LTR/ERV1	550	+	49	6750660	65173
chr1	6685487	6885487	harbor2	chr1	6752295	6752737	LTR/ERV1	3242	+	221	6752516	67029
chr1	46124232	46324232	harbor2	chr1	46148862	46149139	LTR/ERV1	3233	+	138	46149000	24768
chr1	46124232	46324232	harbor2	chr1	46149444	46149527	LTR/ERV1	3233	+	42	46149486	25254
chr1	46124232	46324232	harbor2	chr1	46149831	46150121	LTR/ERV1	3233	+	145	46149976	25744
chr1	6685468	6885468	harbor2	chr1	6685409	6685826	LTR/ERV1	2226	+	208	6685617	149
chr1	6685468	6885468	harbor2	chr1	6693819	6693834	LTR/ERV1	848	+	8	6693827	8359
chr1	6685468	6885468	harbor2	chr1	6694137	6694304	LTR/ERV1	848	+	84	6694221	8753
chr1	6685468	6885468	harbor2	chr1	6694340	6694611	LTR/ERV1	936	+	136	6694476	9008
chr1	6685468	6885468	harbor2	chr1	6699931	6700411	LTR/ERV1	3152	+	240	6700171	14703
chr1	6685468	6885468	harbor2	chr1	6747770	6748324	LTR/ERV1	3616	+	277	6748047	62579
chr1	6685468	6885468	harbor2	chr1	6750611	6750709	LTR/ERV1	550	+	49	6750660	65192
chr1	6685468	6885468	harbor2	chr1	6752295	6752737	LTR/ERV1	3242	+	221	6752516	67048
chr1	65260750	65460750	harbor2	chr1	65297506	65298214	LTR/ERV1	2665	+	354	65297860	37110
chr1	2379170	2579170	harbor2	chr1	2384393	2384801	LTR/ERV1	980	+	204	2384597	5427
chr1	16617135	16817135	harbor2	chr1	16667986	16668531	LTR/ERV1	3509	+	272	16668258	51123
chr1	16617135	16817135	harbor2	chr1	16674777	16675682	LTR/ERV1	4973	+	452	16675229	58094
chr1	2989858	3189858	harbor2	chr1	3036644	3036789	LTR/ERV1	550	+	72	3036716	46858
chr1	2375235	2575235	harbor2	chr1	2384393	2384801	LTR/ERV1	980	+	204	2384597	9362
chr1	227442279	227642279	harbor2	chr1	227499424	227499610	LTR/ERV1	830	+	93	227499517	57238
chr1	227442279	227642279	harbor2	chr1	227500566	227503796	LTR/ERV1	12933	+	1615	227502181	59902
chr1	227442279	227642279	harbor2	chr1	227504450	227506052	LTR/ERV1	12933	+	801	227505251	62972
chr1	227442279	227642279	harbor2	chr1	227516809	227518273	LTR/ERV1	2504	+	732	227517541	75262
chr1	3696450	3896450	harbor2	chr1	3741083	3741698	LTR/ERV1	3116	+	308	3741391	44941
chr1	3696450	3896450	harbor2	chr1	3751583	3751609	LTR/ERV1	574	+	13	3751596	55146
chr1	3696450	3896450	harbor2	chr1	3793022	3793116	LTR/ERV1	3831	+	47	3793069	96619
chr1	3696450	3896450	harbor2	chr1	3793393	3793914	LTR/ERV1	3831	+	260	3793653	97203
chr1	3696450	3896450	harbor2	chr1	3794221	3794339	LTR/ERV1	3831	+	59	3794280	97830
chr1	3696450	3896450	harbor2	chr1	3751901	3752001	LTR/ERV1	574	+	50	3751951	55501
chr1	89425677	89625677	harbor2	chr1	89436963	89437331	LTR/ERV1	1422	+	184	89437147	11470
chr1	89425677	89625677	harbor2	chr1	89449529	89449703	LTR/ERV1	704	+	87	89449616	23939
chr1	89425677	89625677	harbor2	chr1	89449709	89450146	LTR/ERV1	1143	+	218	89449927	24250
chr1	89425677	89625677	harbor2	chr1	89450152	89450367	LTR/ERV1	518	+	108	89450260	24583
chr1	89425677	89625677	harbor2	chr1	89486013	89486174	LTR/ERV1	490	+	80	89486093	60416
chr1	89425677	89625677	harbor2	chr1	89488130	89488265	LTR/ERV1	468	+	68	89488198	62521
chr1	89425677	89625677	harbor2	chr1	89505231	89505747	LTR/ERV1	3658	+	258	89505489	79812
chr1	89425677	89625677	harbor2	chr1	89506521	89506798	LTR/ERV1	1083	+	138	89506659	80982
chr1	89425677	89625677	harbor2	chr1	89520954	89521045	LTR/ERV1	474	+	46	89521000	95323
chr1	89425677	89625677	harbor2	chr1	89522588	89523203	LTR/ERV1	3237	+	308	89522896	97219
chr1	153664662	153864662	harbor2	chr1	153705544	153705809	LTR/ERV1	2497	+	132	153705676	41014
chr1	153664662	153864662	harbor2	chr1	153706113	153706136	LTR/ERV1	2497	+	12	153706125	41463
chr1	153664662	153864662	harbor2	chr1	153706445	153706649	LTR/ERV1	2497	+	102	153706547	41885
chr1	153664662	153864662	harbor2	chr1	153724123	153724251	LTR/ERV1	1347	+	64	153724187	59525
chr1	153664662	153864662	harbor2	chr1	153724559	153724768	LTR/ERV1	1347	+	104	153724663	60001
chr1	153664662	153864662	harbor2	chr1	153725060	153725078	LTR/ERV1	445	+	9	153725069	60407
chr1	16821931	17021931	harbor2	chr1	16876821	16877538	LTR/ERV1	2769	+	358	16877179	55248
chr1	16821931	17021931	harbor2	chr1	16877845	16878758	LTR/ERV1	2769	+	456	16878301	56370
chr1	16821931	17021931	harbor2	chr1	16892232	16892285	LTR/ERV1	895	+	26	16892258	70327
chr1	16821931	17021931	harbor2	chr1	16892582	16892736	LTR/ERV1	895	+	77	16892659	70728
chr1	16821931	17021931	harbor2	chr1	16892755	16893007	LTR/ERV1	617	+	126	16892881	70950
chr1	16821931	17021931	harbor2	chr1	16893062	16893197	LTR/ERV1	2978	+	68	16893130	71199
chr1	16821931	17021931	harbor2	chr1	16893547	16894128	LTR/ERV1	2978	+	290	16893837	71906
chr1	16821931	17021931	harbor2	chr1	16900667	16901163	LTR/ERV1	2089	+	248	16900915	78984
chr1	16821931	17021931	harbor2	chr1	16901743	16902026	LTR/ERV1	531	+	142	16901885	79954
chr1	16821931	17021931	harbor2	chr1	16903668	16904000	LTR/ERV1	508	+	166	16903834	81903
chr1	16821931	17021931	harbor2	chr1	16905464	16905857	LTR/ERV1	1328	+	196	16905660	83729
chr1	16821931	17021931	harbor2	chr1	16907531	16907942	LTR/ERV1	2029	+	206	16907737	85806
chr1	16821931	17021931	harbor2	chr1	16910542	16910705	LTR/ERV1	1435	+	82	16910624	88693
chr1	16821931	17021931	harbor2	chr1	16911015	16911111	LTR/ERV1	1435	+	48	16911063	89132
chr1	16660930	16860930	harbor2	chr1	16667986	16668531	LTR/ERV1	3509	+	272	16668258	7328
chr1	16660930	16860930	harbor2	chr1	16674777	16675682	LTR/ERV1	4973	+	452	16675229	14299
chr1	16660930	16860930	harbor2	chr1	16736083	16736995	LTR/ERV1	1678	+	456	16736539	75609
chr1	16660930	16860930	harbor2	chr1	16738075	16738644	LTR/ERV1	2701	+	284	16738359	77429
chr1	16660930	16860930	harbor2	chr1	16745203	16745708	LTR/ERV1	2148	+	252	16745455	84525
chr1	16660930	16860930	harbor2	chr1	16747791	16748326	LTR/ERV1	1442	+	268	16748059	87129
chr1	12673928	12873928	harbor2	chr1	12713470	12713728	LTR/ERV1	1642	+	129	12713599	39671
chr1	12673928	12873928	harbor2	chr1	12743184	12743292	LTR/ERV1	2198	+	54	12743238	69310
chr1	12673928	12873928	harbor2	chr1	12743586	12743861	LTR/ERV1	2198	+	138	12743724	69796
chr1	12673928	12873928	harbor2	chr1	12744110	12744348	LTR/ERV1	1343	+	119	12744229	70301
chr1	12673928	12873928	harbor2	chr1	12713729	12714137	LTR/ERV1	2122	+	204	12713933	40005
chr1	53371603	53571603	harbor2	chr1	53402573	53403608	LTR/ERV1	3819	+	518	53403091	31488
chr1	53371603	53571603	harbor2	chr1	53421647	53422820	LTR/ERV1	10737	+	586	53422233	50630
chr1	53371603	53571603	harbor2	chr1	53423122	53423947	LTR/ERV1	10737	+	412	53423534	51931
chr1	53371603	53571603	harbor2	chr1	53424225	53424334	LTR/ERV1	10737	+	54	53424279	52676
chr1	53371603	53571603	harbor2	chr1	53424337	53424766	LTR/ERV1	3338	+	214	53424551	52948
chr1	53371603	53571603	harbor2	chr1	53424769	53427698	LTR/ERV1	15840	+	1464	53426233	54630
chr1	53371603	53571603	harbor2	chr1	53427671	53427840	LTR/ERV1	869	+	84	53427755	56152
chr1	53371603	53571603	harbor2	chr1	53428335	53428996	LTR/ERV1	4376	+	330	53428665	57062
chr1	53371603	53571603	harbor2	chr1	53428998	53429599	LTR/ERV1	2556	+	300	53429298	57695
chr1	53371603	53571603	harbor2	chr1	53429600	53430029	LTR/ERV1	3346	+	214	53429814	58211
chr1	53371603	53571603	harbor2	chr1	53430031	53430736	LTR/ERV1	4450	+	352	53430383	58780
chr1	53371603	53571603	harbor2	chr1	53430737	53431047	LTR/ERV1	3312	+	155	53430892	59289
chr1	53371603	53571603	harbor2	chr1	53431095	53431320	LTR/ERV1	3312	+	112	53431207	59604
chr1	53371603	53571603	harbor2	chr1	53432880	53432985	LTR/ERV1	703	+	52	53432932	61329
chr1	53371603	53571603	harbor2	chr1	53432998	53434803	LTR/ERV1	8266	+	902	53433900	62297
chr1	53371603	53571603	harbor2	chr1	53434809	53435177	LTR/ERV1	2006	+	184	53434993	63390
chr1	53371603	53571603	harbor2	chr1	53447480	53447860	LTR/ERV1	2473	+	190	53447670	76067
chr1	53371603	53571603	harbor2	chr1	53449415	53449824	LTR/ERV1	3003	+	204	53449619	78016
chr1	53371603	53571603	harbor2	chr1	53427831	53428332	LTR/ERV1	3387	+	250	53428081	56478
chr1	204585865	204785865	harbor2	chr1	204641022	204641427	LTR/ERV1	2685	+	202	204641224	55359
chr1	216443727	216643727	harbor2	chr1	216480766	216480973	LTR/ERV1	1133	+	104	216480870	37143
chr1	216443727	216643727	harbor2	chr1	216483902	216484418	LTR/ERV1	1494	+	258	216484160	40433
chr1	216443727	216643727	harbor2	chr1	216484421	216484870	LTR/ERV1	3019	+	224	216484645	40918
chr1	216443727	216643727	harbor2	chr1	216481088	216483697	LTR/ERV1	1731	+	1304	216482392	38665
chr1	16625110	16825110	harbor2	chr1	16667986	16668531	LTR/ERV1	3509	+	272	16668258	43148
chr1	16625110	16825110	harbor2	chr1	16674777	16675682	LTR/ERV1	4973	+	452	16675229	50119
chr1	211400835	211600835	harbor2	chr1	211487002	211487482	LTR/ERV1	1691	+	240	211487242	86407
chr1	16661815	16861815	harbor2	chr1	16667986	16668531	LTR/ERV1	3509	+	272	16668258	6443
chr1	16661815	16861815	harbor2	chr1	16674777	16675682	LTR/ERV1	4973	+	452	16675229	13414
chr1	16661815	16861815	harbor2	chr1	16736083	16736995	LTR/ERV1	1678	+	456	16736539	74724
chr1	16661815	16861815	harbor2	chr1	16738075	16738644	LTR/ERV1	2701	+	284	16738359	76544
chr1	16661815	16861815	harbor2	chr1	16745203	16745708	LTR/ERV1	2148	+	252	16745455	83640
chr1	16661815	16861815	harbor2	chr1	16747791	16748326	LTR/ERV1	1442	+	268	16748059	86244
chr1	2375888	2575888	harbor2	chr1	2384393	2384801	LTR/ERV1	980	+	204	2384597	8709
chr1	53371621	53571621	harbor2	chr1	53402573	53403608	LTR/ERV1	3819	+	518	53403091	31470
chr1	53371621	53571621	harbor2	chr1	53421647	53422820	LTR/ERV1	10737	+	586	53422233	50612
chr1	53371621	53571621	harbor2	chr1	53423122	53423947	LTR/ERV1	10737	+	412	53423534	51913
chr1	53371621	53571621	harbor2	chr1	53424225	53424334	LTR/ERV1	10737	+	54	53424279	52658
chr1	53371621	53571621	harbor2	chr1	53424337	53424766	LTR/ERV1	3338	+	214	53424551	52930
chr1	53371621	53571621	harbor2	chr1	53424769	53427698	LTR/ERV1	15840	+	1464	53426233	54612
chr1	53371621	53571621	harbor2	chr1	53427671	53427840	LTR/ERV1	869	+	84	53427755	56134
chr1	53371621	53571621	harbor2	chr1	53428335	53428996	LTR/ERV1	4376	+	330	53428665	57044
chr1	53371621	53571621	harbor2	chr1	53428998	53429599	LTR/ERV1	2556	+	300	53429298	57677
chr1	53371621	53571621	harbor2	chr1	53429600	53430029	LTR/ERV1	3346	+	214	53429814	58193
chr1	53371621	53571621	harbor2	chr1	53430031	53430736	LTR/ERV1	4450	+	352	53430383	58762
chr1	53371621	53571621	harbor2	chr1	53430737	53431047	LTR/ERV1	3312	+	155	53430892	59271
chr1	53371621	53571621	harbor2	chr1	53431095	53431320	LTR/ERV1	3312	+	112	53431207	59586
chr1	53371621	53571621	harbor2	chr1	53432880	53432985	LTR/ERV1	703	+	52	53432932	61311
chr1	53371621	53571621	harbor2	chr1	53432998	53434803	LTR/ERV1	8266	+	902	53433900	62279
chr1	53371621	53571621	harbor2	chr1	53434809	53435177	LTR/ERV1	2006	+	184	53434993	63372
chr1	53371621	53571621	harbor2	chr1	53447480	53447860	LTR/ERV1	2473	+	190	53447670	76049
chr1	53371621	53571621	harbor2	chr1	53449415	53449824	LTR/ERV1	3003	+	204	53449619	77998
chr1	53371621	53571621	harbor2	chr1	53427831	53428332	LTR/ERV1	3387	+	250	53428081	56460
chr1	53227374	53427374	harbor2	chr1	53270150	53270914	LTR/ERV1	3548	+	382	53270532	43158
chr1	36756807	36956807	harbor2	chr1	36821194	36821768	LTR/ERV1	715	+	287	36821481	64674
chr1	2375982	2575982	harbor2	chr1	2384393	2384801	LTR/ERV1	980	+	204	2384597	8615
chr1	1605807	1805807	harbor2	chr1	1614166	1614629	LTR/ERV1	722	+	232	1614398	8591
chr1	229333991	229533991	harbor2	chr1	229351730	229352230	LTR/ERV1	1363	+	250	229351980	17989
chr1	229333991	229533991	harbor2	chr1	229352229	229352431	LTR/ERV1	951	+	101	229352330	18339
chr1	229333991	229533991	harbor2	chr1	229352648	229352658	LTR/ERV1	951	+	5	229352653	18662
chr1	229333991	229533991	harbor2	chr1	229412418	229412815	LTR/ERV1	2954	+	198	229412616	78625
chr1	229333991	229533991	harbor2	chr1	229412820	229415776	LTR/ERV1	19247	+	1478	229414298	80307
chr1	229333991	229533991	harbor2	chr1	229415749	229415920	LTR/ERV1	875	+	86	229415835	81844
chr1	229333991	229533991	harbor2	chr1	229415911	229417633	LTR/ERV1	8271	+	861	229416772	82781
chr1	229333991	229533991	harbor2	chr1	229417635	229417842	LTR/ERV1	1130	+	104	229417739	83748
chr1	229333991	229533991	harbor2	chr1	229417841	229418220	LTR/ERV1	2515	+	190	229418031	84040
chr1	229333991	229533991	harbor2	chr1	229418221	229418665	LTR/ERV1	3479	+	222	229418443	84452
chr1	229333991	229533991	harbor2	chr1	229418824	229419191	LTR/ERV1	2007	+	184	229419008	85017
chr1	145758969	145958969	harbor2	chr1	145796890	145797382	LTR/ERV1	3414	+	246	145797136	38167
chr1	2375920	2575920	harbor2	chr1	2384393	2384801	LTR/ERV1	980	+	204	2384597	8677
chr1	53371668	53571668	harbor2	chr1	53402573	53403608	LTR/ERV1	3819	+	518	53403091	31423
chr1	53371668	53571668	harbor2	chr1	53421647	53422820	LTR/ERV1	10737	+	586	53422233	50565
chr1	53371668	53571668	harbor2	chr1	53423122	53423947	LTR/ERV1	10737	+	412	53423534	51866
chr1	53371668	53571668	harbor2	chr1	53424225	53424334	LTR/ERV1	10737	+	54	53424279	52611
chr1	53371668	53571668	harbor2	chr1	53424337	53424766	LTR/ERV1	3338	+	214	53424551	52883
chr1	53371668	53571668	harbor2	chr1	53424769	53427698	LTR/ERV1	15840	+	1464	53426233	54565
chr1	53371668	53571668	harbor2	chr1	53427671	53427840	LTR/ERV1	869	+	84	53427755	56087
chr1	53371668	53571668	harbor2	chr1	53428335	53428996	LTR/ERV1	4376	+	330	53428665	56997
chr1	53371668	53571668	harbor2	chr1	53428998	53429599	LTR/ERV1	2556	+	300	53429298	57630
chr1	53371668	53571668	harbor2	chr1	53429600	53430029	LTR/ERV1	3346	+	214	53429814	58146
chr1	53371668	53571668	harbor2	chr1	53430031	53430736	LTR/ERV1	4450	+	352	53430383	58715
chr1	53371668	53571668	harbor2	chr1	53430737	53431047	LTR/ERV1	3312	+	155	53430892	59224
chr1	53371668	53571668	harbor2	chr1	53431095	53431320	LTR/ERV1	3312	+	112	53431207	59539
chr1	53371668	53571668	harbor2	chr1	53432880	53432985	LTR/ERV1	703	+	52	53432932	61264
chr1	53371668	53571668	harbor2	chr1	53432998	53434803	LTR/ERV1	8266	+	902	53433900	62232
chr1	53371668	53571668	harbor2	chr1	53434809	53435177	LTR/ERV1	2006	+	184	53434993	63325
chr1	53371668	53571668	harbor2	chr1	53447480	53447860	LTR/ERV1	2473	+	190	53447670	76002
chr1	53371668	53571668	harbor2	chr1	53449415	53449824	LTR/ERV1	3003	+	204	53449619	77951
chr1	53371668	53571668	harbor2	chr1	53427831	53428332	LTR/ERV1	3387	+	250	53428081	56413
chr1	727513	927513	harbor2	chr1	787352	787718	LTR/ERV1	2003	+	183	787535	60022
chr1	204636318	204836318	harbor2	chr1	204641022	204641427	LTR/ERV1	2685	+	202	204641224	4906
chr1	15277447	15477447	harbor2	chr1	15279440	15279552	LTR/ERV1	682	+	56	15279496	2049
chr1	160901756	161101756	harbor2	chr1	160925467	160925714	LTR/ERV1	1305	+	124	160925591	23835
chr1	160901756	161101756	harbor2	chr1	160925698	160925971	LTR/ERV1	1510	+	136	160925834	24078
chr1	160901756	161101756	harbor2	chr1	160969111	160969297	LTR/ERV1	1731	+	93	160969204	67448
chr1	160901756	161101756	harbor2	chr1	160969608	160969780	LTR/ERV1	1731	+	86	160969694	67938
chr1	160901756	161101756	harbor2	chr1	160975402	160975509	LTR/ERV1	443	+	54	160975456	73700
chr1	160901756	161101756	harbor2	chr1	160978003	160978238	LTR/ERV1	1579	+	118	160978121	76365
chr1	160901756	161101756	harbor2	chr1	160978553	160978597	LTR/ERV1	1579	+	22	160978575	76819
chr1	160901756	161101756	harbor2	chr1	160978953	160979048	LTR/ERV1	448	+	48	160979001	77245
chr1	160901756	161101756	harbor2	chr1	160979120	160979310	LTR/ERV1	1077	+	95	160979215	77459
chr1	160901756	161101756	harbor2	chr1	160983517	160983716	LTR/ERV1	484	+	100	160983617	81861
chr1	160901756	161101756	harbor2	chr1	160987572	160988160	LTR/ERV1	1239	+	294	160987866	86110
chr1	160901756	161101756	harbor2	chr1	160988461	160988514	LTR/ERV1	444	+	26	160988487	86731
chr1	153261923	153461923	harbor2	chr1	153273775	153274171	LTR/ERV1	1532	+	198	153273973	12050
chr1	153261923	153461923	harbor2	chr1	153274176	153274282	LTR/ERV1	880	+	53	153274229	12306
chr1	153261923	153461923	harbor2	chr1	153274372	153274487	LTR/ERV1	880	+	58	153274430	12507
chr1	153261923	153461923	harbor2	chr1	153274519	153275289	LTR/ERV1	3217	+	385	153274904	12981
chr1	153261923	153461923	harbor2	chr1	153275567	153276086	LTR/ERV1	3217	+	260	153275827	13904
chr1	153261923	153461923	harbor2	chr1	153276089	153276553	LTR/ERV1	1939	+	232	153276321	14398
chr1	153261923	153461923	harbor2	chr1	153276560	153276933	LTR/ERV1	2292	+	186	153276746	14823
chr1	153261923	153461923	harbor2	chr1	153295786	153296632	LTR/ERV1	5498	+	423	153296209	34286
chr1	153261923	153461923	harbor2	chr1	153300452	153300914	LTR/ERV1	540	+	231	153300683	38760
chr1	153261923	153461923	harbor2	chr1	153301221	153301269	LTR/ERV1	540	+	24	153301245	39322
chr1	153261923	153461923	harbor2	chr1	153343705	153344272	LTR/ERV1	4089	+	284	153343989	82066
chr1	16625199	16825199	harbor2	chr1	16667986	16668531	LTR/ERV1	3509	+	272	16668258	43059
chr1	16625199	16825199	harbor2	chr1	16674777	16675682	LTR/ERV1	4973	+	452	16675229	50030
chr1	1071988	1271988	harbor2	chr1	1106614	1108045	LTR/ERV1	9434	+	716	1107330	35342
chr1	1071988	1271988	harbor2	chr1	1112044	1112400	LTR/ERV1	1679	+	178	1112222	40234
chr1	1071988	1271988	harbor2	chr1	1112648	1112917	LTR/ERV1	1595	+	134	1112782	40794
chr1	1071988	1271988	harbor2	chr1	1113212	1113335	LTR/ERV1	1595	+	62	1113274	41286
chr1	6685458	6885458	harbor2	chr1	6685409	6685826	LTR/ERV1	2226	+	208	6685617	159
chr1	6685458	6885458	harbor2	chr1	6693819	6693834	LTR/ERV1	848	+	8	6693827	8369
chr1	6685458	6885458	harbor2	chr1	6694137	6694304	LTR/ERV1	848	+	84	6694221	8763
chr1	6685458	6885458	harbor2	chr1	6694340	6694611	LTR/ERV1	936	+	136	6694476	9018
chr1	6685458	6885458	harbor2	chr1	6699931	6700411	LTR/ERV1	3152	+	240	6700171	14713
chr1	6685458	6885458	harbor2	chr1	6747770	6748324	LTR/ERV1	3616	+	277	6748047	62589
chr1	6685458	6885458	harbor2	chr1	6750611	6750709	LTR/ERV1	550	+	49	6750660	65202
chr1	6685458	6885458	harbor2	chr1	6752295	6752737	LTR/ERV1	3242	+	221	6752516	67058
chr1	20561543	20761543	harbor2	chr1	20612289	20612679	LTR/ERV1	2115	+	195	20612484	50941
chr1	20561543	20761543	harbor2	chr1	20612963	20613001	LTR/ERV1	2115	+	19	20612982	51439
chr1	20561543	20761543	harbor2	chr1	20627893	20628503	LTR/ERV1	3589	+	305	20628198	66655
chr1	70743302	70943302	harbor2	chr1	70755025	70755468	LTR/ERV1	2922	+	222	70755247	11945
chr1	70743302	70943302	harbor2	chr1	70765433	70765659	LTR/ERV1	1372	+	113	70765546	22244
chr1	70743302	70943302	harbor2	chr1	70765656	70767711	LTR/ERV1	4164	+	1028	70766684	23382
chr1	70743302	70943302	harbor2	chr1	70775269	70775421	LTR/ERV1	894	+	76	70775345	32043
chr1	70743302	70943302	harbor2	chr1	70775423	70775530	LTR/ERV1	494	+	54	70775477	32175
chr1	70743302	70943302	harbor2	chr1	70775627	70775668	LTR/ERV1	1191	+	20	70775647	32345
chr1	70743302	70943302	harbor2	chr1	70775966	70776149	LTR/ERV1	1191	+	92	70776058	32756
chr1	70743302	70943302	harbor2	chr1	70776228	70776581	LTR/ERV1	2183	+	176	70776404	33102
chr1	70743302	70943302	harbor2	chr1	70776585	70776774	LTR/ERV1	3472	+	94	70776679	33377
chr1	70743302	70943302	harbor2	chr1	70777105	70777457	LTR/ERV1	3472	+	176	70777281	33979
chr1	70743302	70943302	harbor2	chr1	70838285	70838382	LTR/ERV1	658	+	48	70838333	95031
chr1	3874035	4074035	harbor2	chr1	3949409	3949952	LTR/ERV1	3516	+	272	3949681	75646
chr1	3874035	4074035	harbor2	chr1	3955922	3956539	LTR/ERV1	3832	+	308	3956230	82195
chr1	3874035	4074035	harbor2	chr1	3965487	3965976	LTR/ERV1	3169	+	244	3965731	91696
chr1	152207691	152407691	harbor2	chr1	152240646	152241123	LTR/ERV1	1726	+	238	152240884	33193
chr1	153558724	153758724	harbor2	chr1	153603714	153603915	LTR/ERV1	1389	+	100	153603814	45090
chr1	153558724	153758724	harbor2	chr1	153603958	153604083	LTR/ERV1	973	+	62	153604020	45296
chr1	153558724	153758724	harbor2	chr1	153604083	153605478	LTR/ERV1	8647	+	698	153604781	46057
chr1	153558724	153758724	harbor2	chr1	153605480	153605539	LTR/ERV1	456	+	30	153605510	46786
chr1	153558724	153758724	harbor2	chr1	153605778	153606012	LTR/ERV1	2746	+	117	153605895	47171
chr1	153558724	153758724	harbor2	chr1	153606324	153606579	LTR/ERV1	2746	+	128	153606452	47728
chr1	153558724	153758724	harbor2	chr1	153621608	153621682	LTR/ERV1	581	+	37	153621645	62921
chr1	110682470	110882470	harbor2	chr1	110729611	110730431	LTR/ERV1	4235	+	410	110730021	47551
chr1	44170897	44370897	harbor2	chr1	44179973	44180070	LTR/ERV1	716	+	48	44180021	9124
chr1	44170897	44370897	harbor2	chr1	44195724	44196131	LTR/ERV1	2564	+	204	44195928	25031
chr1	2375915	2575915	harbor2	chr1	2384393	2384801	LTR/ERV1	980	+	204	2384597	8682
chr1	727387	927387	harbor2	chr1	787352	787718	LTR/ERV1	2003	+	183	787535	60148
chr1	3525669	3725669	harbor2	chr1	3558525	3558828	LTR/ERV1	1243	+	152	3558677	33008
chr1	2375967	2575967	harbor2	chr1	2384393	2384801	LTR/ERV1	980	+	204	2384597	8630
chr1	53313469	53513469	harbor2	chr1	53402573	53403608	LTR/ERV1	3819	+	518	53403091	89622
chr1	2551671	2751671	harbor2	chr1	2584459	2584709	LTR/ERV1	1038	+	125	2584584	32913
chr1	2551671	2751671	harbor2	chr1	2584733	2584930	LTR/ERV1	638	+	98	2584831	33160
chr1	2551671	2751671	harbor2	chr1	2591111	2591488	LTR/ERV1	1342	+	188	2591299	39628
chr1	2551671	2751671	harbor2	chr1	2620815	2621003	LTR/ERV1	2701	+	94	2620909	69238
chr1	2551671	2751671	harbor2	chr1	2621862	2622049	LTR/ERV1	2701	+	94	2621956	70285
chr1	2551671	2751671	harbor2	chr1	2621303	2621572	LTR/ERV1	2701	+	134	2621437	69766
chr1	19615803	19815803	harbor2	chr1	19689866	19690644	LTR/ERV1	2344	+	389	19690255	74452
chr1	38817717	39017717	harbor2	chr1	38829778	38829976	LTR/ERV1	3230	+	99	38829877	12160
chr1	38817717	39017717	harbor2	chr1	38830231	38830650	LTR/ERV1	3230	+	210	38830441	12724
chr1	38817717	39017717	harbor2	chr1	38830959	38831020	LTR/ERV1	3230	+	30	38830989	13272
chr1	38817717	39017717	harbor2	chr1	38892668	38893135	LTR/ERV1	2067	+	234	38892902	75185
chr1	38817717	39017717	harbor2	chr1	38895265	38895336	LTR/ERV1	495	+	36	38895301	77584
chr1	22610841	22810841	harbor2	chr1	22631888	22632096	LTR/ERV1	728	+	104	22631992	21151
chr1	22610841	22810841	harbor2	chr1	22632124	22632421	LTR/ERV1	681	+	148	22632272	21431
chr1	6689187	6889187	harbor2	chr1	6693819	6693834	LTR/ERV1	848	+	8	6693827	4640
chr1	6689187	6889187	harbor2	chr1	6694137	6694304	LTR/ERV1	848	+	84	6694221	5034
chr1	6689187	6889187	harbor2	chr1	6694340	6694611	LTR/ERV1	936	+	136	6694476	5289
chr1	6689187	6889187	harbor2	chr1	6699931	6700411	LTR/ERV1	3152	+	240	6700171	10984
chr1	6689187	6889187	harbor2	chr1	6747770	6748324	LTR/ERV1	3616	+	277	6748047	58860
chr1	6689187	6889187	harbor2	chr1	6750611	6750709	LTR/ERV1	550	+	49	6750660	61473
chr1	6689187	6889187	harbor2	chr1	6752295	6752737	LTR/ERV1	3242	+	221	6752516	63329
chr1	26600726	26800726	harbor2	chr1	26630418	26630568	LTR/ERV1	1194	+	75	26630493	29767
chr1	26600726	26800726	harbor2	chr1	26630754	26631094	LTR/ERV1	8153	+	170	26630924	30198
chr1	26600726	26800726	harbor2	chr1	26631400	26631508	LTR/ERV1	8153	+	54	26631454	30728
chr1	26600726	26800726	harbor2	chr1	26631736	26632821	LTR/ERV1	8153	+	542	26632278	31552
chr1	26600726	26800726	harbor2	chr1	26633123	26633264	LTR/ERV1	5388	+	70	26633193	32467
chr1	26600726	26800726	harbor2	chr1	26633868	26634089	LTR/ERV1	5388	+	110	26633978	33252
chr1	26600726	26800726	harbor2	chr1	26634393	26634601	LTR/ERV1	5388	+	104	26634497	33771
chr1	26600726	26800726	harbor2	chr1	26635237	26635617	LTR/ERV1	5388	+	190	26635427	34701
chr1	26600726	26800726	harbor2	chr1	26635649	26635904	LTR/ERV1	1860	+	128	26635777	35051
chr1	26600726	26800726	harbor2	chr1	26635905	26636092	LTR/ERV1	1584	+	94	26635999	35273
chr1	26600726	26800726	harbor2	chr1	26636549	26636878	LTR/ERV1	3107	+	164	26636713	35987
chr1	26600726	26800726	harbor2	chr1	26637171	26637291	LTR/ERV1	3107	+	60	26637231	36505
chr1	207652046	207852046	harbor2	chr1	207680633	207681071	LTR/ERV1	2599	+	219	207680852	28806
chr1	207652046	207852046	harbor2	chr1	207711358	207711624	LTR/ERV1	2376	+	133	207711491	59445
chr1	207652046	207852046	harbor2	chr1	207711928	207712163	LTR/ERV1	2376	+	118	207712046	60000
chr1	207652046	207852046	harbor2	chr1	207740549	207741155	LTR/ERV1	3743	+	303	207740852	88806
chr1	207652046	207852046	harbor2	chr1	207741921	207741944	LTR/ERV1	3743	+	12	207741933	89887
chr1	207652046	207852046	harbor2	chr1	207741945	207742041	LTR/ERV1	446	+	48	207741993	89947
chr1	207652046	207852046	harbor2	chr1	207742045	207742181	LTR/ERV1	765	+	68	207742113	90067
chr1	207652046	207852046	harbor2	chr1	207742195	207743985	LTR/ERV1	6397	+	895	207743090	91044
chr1	207652046	207852046	harbor2	chr1	207744396	207745208	LTR/ERV1	4873	+	406	207744802	92756
chr1	207652046	207852046	harbor2	chr1	207745200	207747909	LTR/ERV1	17774	+	1354	207746554	94508
chr1	207652046	207852046	harbor2	chr1	207747920	207748554	LTR/ERV1	4036	+	317	207748237	96191
chr1	207903426	208103426	harbor2	chr1	207935101	207935552	LTR/ERV1	2409	+	226	207935327	31901
chr1	16803066	17003066	harbor2	chr1	16876821	16877538	LTR/ERV1	2769	+	358	16877179	74113
chr1	16803066	17003066	harbor2	chr1	16877845	16878758	LTR/ERV1	2769	+	456	16878301	75235
chr1	16803066	17003066	harbor2	chr1	16892232	16892285	LTR/ERV1	895	+	26	16892258	89192
chr1	16803066	17003066	harbor2	chr1	16892582	16892736	LTR/ERV1	895	+	77	16892659	89593
chr1	16803066	17003066	harbor2	chr1	16892755	16893007	LTR/ERV1	617	+	126	16892881	89815
chr1	16803066	17003066	harbor2	chr1	16893062	16893197	LTR/ERV1	2978	+	68	16893130	90064
chr1	16803066	17003066	harbor2	chr1	16893547	16894128	LTR/ERV1	2978	+	290	16893837	90771
chr1	16803066	17003066	harbor2	chr1	16900667	16901163	LTR/ERV1	2089	+	248	16900915	97849
chr1	16803066	17003066	harbor2	chr1	16901743	16902026	LTR/ERV1	531	+	142	16901885	98819
chr1	41949951	42149951	harbor2	chr1	41948879	41949987	LTR/ERV1	9345	+	554	41949433	518
chr1	41949951	42149951	harbor2	chr1	41949988	41950309	LTR/ERV1	2747	+	160	41950148	197
chr1	41949951	42149951	harbor2	chr1	42018577	42019087	LTR/ERV1	1573	+	255	42018832	68881
chr1	244609722	244809722	harbor2	chr1	244642423	244643225	LTR/ERV1	4952	+	401	244642824	33102
chr1	225365084	225565084	harbor2	chr1	225431183	225432744	LTR/ERV1	9078	+	780	225431963	66879
chr1	225365084	225565084	harbor2	chr1	225438551	225438642	LTR/ERV1	2547	+	46	225438597	73513
chr1	225365084	225565084	harbor2	chr1	225438935	225439247	LTR/ERV1	2547	+	156	225439091	74007
chr1	225365084	225565084	harbor2	chr1	225439539	225439685	LTR/ERV1	2547	+	73	225439612	74528
chr1	225365084	225565084	harbor2	chr1	225462619	225463184	LTR/ERV1	3239	+	282	225462901	97817
chr1	206353548	206553548	harbor2	chr1	206378554	206378884	LTR/ERV1	1679	+	165	206378719	25171
chr1	226786659	226986659	harbor2	chr1	226833503	226833944	LTR/ERV1	2842	+	220	226833723	47064
chr1	226786659	226986659	harbor2	chr1	226833945	226834368	LTR/ERV1	931	+	212	226834157	47498
chr1	226786659	226986659	harbor2	chr1	226837537	226837969	LTR/ERV1	2938	+	216	226837753	51094
chr1	226786659	226986659	harbor2	chr1	226837970	226838404	LTR/ERV1	2561	+	217	226838187	51528
chr1	226786659	226986659	harbor2	chr1	226847392	226847807	LTR/ERV1	3093	+	208	226847600	60941
chr1	226786659	226986659	harbor2	chr1	226847834	226848407	LTR/ERV1	3224	+	286	226848120	61461
chr1	226786659	226986659	harbor2	chr1	226848592	226848692	LTR/ERV1	1469	+	50	226848642	61983
chr1	226786659	226986659	harbor2	chr1	226849002	226849251	LTR/ERV1	1469	+	124	226849126	62467
chr1	226786659	226986659	harbor2	chr1	226849250	226849942	LTR/ERV1	4210	+	346	226849596	62937
chr1	226786659	226986659	harbor2	chr1	226850172	226850312	LTR/ERV1	2391	+	70	226850242	63583
chr1	226786659	226986659	harbor2	chr1	226850627	226850934	LTR/ERV1	2391	+	154	226850781	64122
chr1	226786659	226986659	harbor2	chr1	226850935	226851468	LTR/ERV1	4222	+	266	226851201	64542
chr1	226786659	226986659	harbor2	chr1	226851469	226851556	LTR/ERV1	2391	+	44	226851513	64854
chr1	226786659	226986659	harbor2	chr1	226851543	226851990	LTR/ERV1	8970	+	224	226851767	65108
chr1	226786659	226986659	harbor2	chr1	226855071	226856309	LTR/ERV1	8740	+	619	226855690	69031
chr1	226786659	226986659	harbor2	chr1	226856311	226856641	LTR/ERV1	1993	+	165	226856476	69817
chr1	226786659	226986659	harbor2	chr1	226834435	226837538	LTR/ERV1	16349	+	1552	226835987	49328
chr1	226786659	226986659	harbor2	chr1	226852296	226853229	LTR/ERV1	8970	+	466	226852762	66103
chr1	226638205	226838205	harbor2	chr1	226672144	226672561	LTR/ERV1	1191	+	208	226672352	34147
chr1	161528751	161728751	harbor2	chr1	161532230	161532642	LTR/ERV1	1657	+	206	161532436	3685
chr1	161528751	161728751	harbor2	chr1	161532665	161533392	LTR/ERV1	4245	+	364	161533029	4278
chr1	161528751	161728751	harbor2	chr1	161571606	161572348	LTR/ERV1	2073	+	371	161571977	43226
chr1	161528751	161728751	harbor2	chr1	161576354	161576567	LTR/ERV1	1158	+	106	161576460	47709
chr1	161528751	161728751	harbor2	chr1	161578783	161578931	LTR/ERV1	891	+	74	161578857	50106
chr1	161528751	161728751	harbor2	chr1	161579497	161579819	LTR/ERV1	1933	+	161	161579658	50907
chr1	161528751	161728751	harbor2	chr1	161595662	161596126	LTR/ERV1	1375	+	232	161595894	67143
chr1	161528751	161728751	harbor2	chr1	161596130	161596326	LTR/ERV1	717	+	98	161596228	67477
chr1	161528751	161728751	harbor2	chr1	161597054	161597707	LTR/ERV1	1417	+	326	161597380	68629
chr1	161528751	161728751	harbor2	chr1	161597910	161598811	LTR/ERV1	1337	+	450	161598360	69609
chr1	161528751	161728751	harbor2	chr1	161599476	161599694	LTR/ERV1	465	+	109	161599585	70834
chr1	161528751	161728751	harbor2	chr1	161599869	161600201	LTR/ERV1	790	+	166	161600035	71284
chr1	161528751	161728751	harbor2	chr1	161613095	161613338	LTR/ERV1	1160	+	122	161613217	84466
chr1	16618103	16818103	harbor2	chr1	16667986	16668531	LTR/ERV1	3509	+	272	16668258	50155
chr1	16618103	16818103	harbor2	chr1	16674777	16675682	LTR/ERV1	4973	+	452	16675229	57126
chr1	36055774	36255774	harbor2	chr1	36146970	36147051	LTR/ERV1	492	+	40	36147010	91236
chr1	113990947	114190947	harbor2	chr1	114021840	114022391	LTR/ERV1	865	+	276	114022116	31169
chr1	113990947	114190947	harbor2	chr1	114023161	114023795	LTR/ERV1	3265	+	317	114023478	32531
chr1	113990947	114190947	harbor2	chr1	114024298	114024379	LTR/ERV1	480	+	40	114024338	33391
chr1	113990947	114190947	harbor2	chr1	114025153	114025568	LTR/ERV1	2984	+	208	114025361	34414
chr1	113990947	114190947	harbor2	chr1	114025876	114026013	LTR/ERV1	2984	+	68	114025944	34997
chr1	113990947	114190947	harbor2	chr1	114029672	114029933	LTR/ERV1	1792	+	130	114029802	38855
chr1	113990947	114190947	harbor2	chr1	114029930	114031524	LTR/ERV1	8008	+	797	114030727	39780
chr1	113990947	114190947	harbor2	chr1	114031518	114032083	LTR/ERV1	3601	+	282	114031800	40853
chr1	113990947	114190947	harbor2	chr1	114032084	114032484	LTR/ERV1	2616	+	200	114032284	41337
chr1	113990947	114190947	harbor2	chr1	114034031	114034597	LTR/ERV1	2427	+	283	114034314	43367
chr1	113990947	114190947	harbor2	chr1	114037075	114037525	LTR/ERV1	3539	+	225	114037300	46353
chr1	113990947	114190947	harbor2	chr1	114038424	114038744	LTR/ERV1	1592	+	160	114038584	47637
chr1	113990947	114190947	harbor2	chr1	114038730	114039157	LTR/ERV1	2786	+	214	114038944	47997
chr1	113990947	114190947	harbor2	chr1	114061019	114061165	LTR/ERV1	727	+	73	114061092	70145
chr1	113990947	114190947	harbor2	chr1	114061148	114062029	LTR/ERV1	4254	+	440	114061588	70641
chr1	46294779	46494779	harbor2	chr1	46323241	46323405	LTR/ERV1	707	+	82	46323323	28544
chr1	46294779	46494779	harbor2	chr1	46323701	46323737	LTR/ERV1	707	+	18	46323719	28940
chr1	46294779	46494779	harbor2	chr1	46324046	46324111	LTR/ERV1	707	+	32	46324078	29299
chr1	46294779	46494779	harbor2	chr1	46324456	46324524	LTR/ERV1	707	+	34	46324490	29711
chr1	46294779	46494779	harbor2	chr1	46325370	46325547	LTR/ERV1	1020	+	88	46325458	30679
chr1	46294779	46494779	harbor2	chr1	46332951	46333273	LTR/ERV1	2203	+	161	46333112	38333
chr1	46294779	46494779	harbor2	chr1	46333558	46333601	LTR/ERV1	2203	+	22	46333580	38801
chr1	46294779	46494779	harbor2	chr1	46334275	46334379	LTR/ERV1	2363	+	52	46334327	39548
chr1	46294779	46494779	harbor2	chr1	46334381	46334599	LTR/ERV1	1110	+	109	46334490	39711
chr1	46294779	46494779	harbor2	chr1	46334910	46335031	LTR/ERV1	1110	+	60	46334970	40191
chr1	46294779	46494779	harbor2	chr1	46333602	46333993	LTR/ERV1	2363	+	196	46333798	39019
chr1	2375244	2575244	harbor2	chr1	2384393	2384801	LTR/ERV1	980	+	204	2384597	9353
chr1	207707062	207907062	harbor2	chr1	207711358	207711624	LTR/ERV1	2376	+	133	207711491	4429
chr1	207707062	207907062	harbor2	chr1	207711928	207712163	LTR/ERV1	2376	+	118	207712046	4984
chr1	207707062	207907062	harbor2	chr1	207740549	207741155	LTR/ERV1	3743	+	303	207740852	33790
chr1	207707062	207907062	harbor2	chr1	207741921	207741944	LTR/ERV1	3743	+	12	207741933	34871
chr1	207707062	207907062	harbor2	chr1	207741945	207742041	LTR/ERV1	446	+	48	207741993	34931
chr1	207707062	207907062	harbor2	chr1	207742045	207742181	LTR/ERV1	765	+	68	207742113	35051
chr1	207707062	207907062	harbor2	chr1	207742195	207743985	LTR/ERV1	6397	+	895	207743090	36028
chr1	207707062	207907062	harbor2	chr1	207744396	207745208	LTR/ERV1	4873	+	406	207744802	37740
chr1	207707062	207907062	harbor2	chr1	207745200	207747909	LTR/ERV1	17774	+	1354	207746554	39492
chr1	207707062	207907062	harbor2	chr1	207747920	207748554	LTR/ERV1	4036	+	317	207748237	41175
chr1	10913141	11113141	harbor2	chr1	10926261	10926598	LTR/ERV1	1025	+	168	10926429	13288
chr1	10913141	11113141	harbor2	chr1	10926789	10926958	LTR/ERV1	1025	+	84	10926873	13732
chr1	10913141	11113141	harbor2	chr1	10973588	10974728	LTR/ERV1	6617	+	570	10974158	61017
chr1	17337716	17537716	harbor2	chr1	17366435	17366903	LTR/ERV1	905	+	234	17366669	28953
chr1	17337716	17537716	harbor2	chr1	17370496	17370668	LTR/ERV1	902	+	86	17370582	32866
chr1	53312834	53512834	harbor2	chr1	53402573	53403608	LTR/ERV1	3819	+	518	53403091	90257
chr1	13290765	13490765	harbor2	chr1	13294084	13294161	LTR/ERV1	647	+	38	13294122	3357
chr1	13290765	13490765	harbor2	chr1	13296892	13297093	LTR/ERV1	529	+	100	13296992	6227
chr1	13290765	13490765	harbor2	chr1	13336828	13337143	LTR/ERV1	3238	+	158	13336986	46221
chr1	13290765	13490765	harbor2	chr1	13337482	13337777	LTR/ERV1	3238	+	148	13337630	46865
chr1	13290765	13490765	harbor2	chr1	13363498	13363813	LTR/ERV1	4410	+	158	13363656	72891
chr1	13290765	13490765	harbor2	chr1	13364110	13364438	LTR/ERV1	4410	+	164	13364274	73509
chr1	13290765	13490765	harbor2	chr1	13365034	13365279	LTR/ERV1	4410	+	122	13365156	74391
chr1	13290765	13490765	harbor2	chr1	13377157	13377365	LTR/ERV1	676	+	104	13377261	86496
chr1	13290765	13490765	harbor2	chr1	13377838	13378291	LTR/ERV1	1518	+	226	13378064	87299
chr1	13290765	13490765	harbor2	chr1	13381961	13382322	LTR/ERV1	1516	+	180	13382141	91376
chr1	13290765	13490765	harbor2	chr1	13382638	13382885	LTR/ERV1	1232	+	124	13382762	91997
chr1	7926217	8126217	harbor2	chr1	7928555	7928609	LTR/ERV1	1373	+	27	7928582	2365
chr1	7926217	8126217	harbor2	chr1	7928909	7929136	LTR/ERV1	1373	+	114	7929023	2806
chr1	7926217	8126217	harbor2	chr1	7929467	7929600	LTR/ERV1	1373	+	66	7929533	3316
chr1	7926217	8126217	harbor2	chr1	7960625	7960739	LTR/ERV1	863	+	57	7960682	34465
chr1	206973128	207173128	harbor2	chr1	206978276	206978671	LTR/ERV1	2743	+	198	206978474	5346
chr1	206973128	207173128	harbor2	chr1	206987988	206988430	LTR/ERV1	829	+	221	206988209	15081
chr1	206973128	207173128	harbor2	chr1	206989983	206990577	LTR/ERV1	2337	+	297	206990280	17152
chr1	206973128	207173128	harbor2	chr1	207000985	207001146	LTR/ERV1	793	+	80	207001065	27937
chr1	117032433	117232433	harbor2	chr1	117036094	117036616	LTR/ERV1	3315	+	261	117036355	3922
chr1	230539629	230739629	harbor2	chr1	230576018	230576505	LTR/ERV1	3087	+	244	230576262	36633
chr1	230539629	230739629	harbor2	chr1	230579052	230579519	LTR/ERV1	2852	+	234	230579286	39657
chr1	230539629	230739629	harbor2	chr1	230599782	230600292	LTR/ERV1	2257	+	255	230600037	60408
chr1	230539629	230739629	harbor2	chr1	230601216	230601646	LTR/ERV1	2707	+	215	230601431	61802
chr1	230539629	230739629	harbor2	chr1	230604920	230605422	LTR/ERV1	3467	+	251	230605171	65542
chr1	230539629	230739629	harbor2	chr1	230605425	230608660	LTR/ERV1	25200	+	1618	230607043	67414
chr1	230539629	230739629	harbor2	chr1	230608661	230609094	LTR/ERV1	2658	+	216	230608877	69248
chr1	230539629	230739629	harbor2	chr1	230610566	230611162	LTR/ERV1	3487	+	298	230610864	71235
chr1	230539629	230739629	harbor2	chr1	230622081	230622291	LTR/ERV1	519	+	105	230622186	82557
chr1	230539629	230739629	harbor2	chr1	230623954	230624566	LTR/ERV1	4156	+	306	230624260	84631
chr1	230539629	230739629	harbor2	chr1	230635098	230635451	LTR/ERV1	1277	+	176	230635274	95645
chr1	230539629	230739629	harbor2	chr1	230635757	230635822	LTR/ERV1	1277	+	32	230635789	96160
chr1	230539629	230739629	harbor2	chr1	230601649	230604929	LTR/ERV1	22468	+	1640	230603289	63660
chr1	230539629	230739629	harbor2	chr1	230637029	230637633	LTR/ERV1	1731	+	302	230637331	97702
chr2	1788562	1988562	harbor2	chr2	1850554	1851010	LTR/ERV1	1063	+	228	1850782	62220
chr2	53472337	53672337	harbor2	chr2	53472449	53472562	LTR/ERV1	1811	+	56	53472505	168
chr2	53472337	53672337	harbor2	chr2	53472860	53473071	LTR/ERV1	1811	+	106	53472966	629
chr2	53472337	53672337	harbor2	chr2	53483709	53484352	LTR/ERV1	4381	+	322	53484031	11694
chr2	53472337	53672337	harbor2	chr2	53486285	53487492	LTR/ERV1	6717	+	604	53486889	14552
chr2	53472337	53672337	harbor2	chr2	53553648	53555257	LTR/ERV1	7910	+	804	53554452	82115
chr2	72043327	72243327	harbor2	chr2	72051101	72051702	LTR/ERV1	2256	+	300	72051401	8074
chr2	72043327	72243327	harbor2	chr2	72062248	72062964	LTR/ERV1	4285	+	358	72062606	19279
chr2	72043327	72243327	harbor2	chr2	72080329	72081396	LTR/ERV1	2871	+	534	72080863	37536
chr2	72043327	72243327	harbor2	chr2	72086707	72088019	LTR/ERV1	7106	+	656	72087363	44036
chr2	72043327	72243327	harbor2	chr2	72088482	72089105	LTR/ERV1	4547	+	312	72088794	45467
chr2	72043327	72243327	harbor2	chr2	72089456	72090146	LTR/ERV1	4279	+	345	72089801	46474
chr2	26406627	26606627	harbor2	chr2	26407447	26408136	LTR/ERV1	879	+	344	26407791	1164
chr2	26406627	26606627	harbor2	chr2	26493549	26494007	LTR/ERV1	3470	+	229	26493778	87151
chr2	171822444	172022444	harbor2	chr2	171827382	171827789	LTR/ERV1	1351	+	204	171827586	5142
chr2	171822444	172022444	harbor2	chr2	171827949	171828389	LTR/ERV1	2788	+	220	171828169	5725
chr2	171822444	172022444	harbor2	chr2	171828706	171830109	LTR/ERV1	7039	+	702	171829408	6964
chr2	171822444	172022444	harbor2	chr2	171831120	171831391	LTR/ERV1	1570	+	136	171831256	8812
chr2	171822444	172022444	harbor2	chr2	171831399	171831614	LTR/ERV1	1048	+	108	171831507	9063
chr2	171822444	172022444	harbor2	chr2	171832261	171833335	LTR/ERV1	1678	+	537	171832798	10354
chr2	171822444	172022444	harbor2	chr2	171874836	171875423	LTR/ERV1	3074	+	294	171875130	52686
chr2	171822444	172022444	harbor2	chr2	171908870	171909076	LTR/ERV1	596	+	103	171908973	86529
chr2	171822444	172022444	harbor2	chr2	171909388	171909524	LTR/ERV1	596	+	68	171909456	87012
chr2	195072898	195272898	harbor2	chr2	195073545	195073950	LTR/ERV1	2533	+	202	195073747	849
chr2	195072898	195272898	harbor2	chr2	195132944	195133177	LTR/ERV1	891	+	116	195133060	60162
chr2	195072898	195272898	harbor2	chr2	195145100	195145856	LTR/ERV1	3070	+	378	195145478	72580
chr2	26404185	26604185	harbor2	chr2	26407447	26408136	LTR/ERV1	879	+	344	26407791	3606
chr2	26404185	26604185	harbor2	chr2	26493549	26494007	LTR/ERV1	3470	+	229	26493778	89593
chr2	3480298	3680298	harbor2	chr2	3494467	3494548	LTR/ERV1	4465	+	40	3494507	14209
chr2	3480298	3680298	harbor2	chr2	3494849	3495623	LTR/ERV1	4465	+	387	3495236	14938
chr2	3480298	3680298	harbor2	chr2	3495932	3495977	LTR/ERV1	4465	+	22	3495954	15656
chr2	3480298	3680298	harbor2	chr2	3517027	3517448	LTR/ERV1	1058	+	210	3517237	36939
chr2	3480298	3680298	harbor2	chr2	3533850	3534784	LTR/ERV1	2834	+	467	3534317	54019
chr2	3480298	3680298	harbor2	chr2	3536384	3536708	LTR/ERV1	592	+	162	3536546	56248
chr2	3480298	3680298	harbor2	chr2	3543020	3543367	LTR/ERV1	1194	+	174	3543194	62896
chr2	3480298	3680298	harbor2	chr2	3571159	3571240	LTR/ERV1	496	+	40	3571199	90901
chr2	3480298	3680298	harbor2	chr2	3554956	3555368	LTR/ERV1	2106	+	206	3555162	74864
chr2	113484990	113684990	harbor2	chr2	113508186	113508307	LTR/ERV1	503	+	60	113508246	23256
chr2	113484990	113684990	harbor2	chr2	113523289	113523687	LTR/ERV1	2438	+	199	113523488	38498
chr2	71056951	71256951	harbor2	chr2	71084726	71085063	LTR/ERV1	2424	+	168	71084894	27943
chr2	71056951	71256951	harbor2	chr2	71103422	71104354	LTR/ERV1	5293	+	466	71103888	46937
chr2	242029286	242229286	harbor2	chr2	242041023	242041293	LTR/ERV1	695	+	135	242041158	11872
chr2	242029286	242229286	harbor2	chr2	242059296	242059878	LTR/ERV1	3183	+	291	242059587	30301
chr2	242029286	242229286	harbor2	chr2	242086911	242086976	LTR/ERV1	869	+	32	242086943	57657
chr2	242029286	242229286	harbor2	chr2	242087016	242087363	LTR/ERV1	1289	+	174	242087190	57904
chr2	74426974	74626974	harbor2	chr2	74450757	74451063	LTR/ERV1	2754	+	153	74450910	23936
chr2	74426974	74626974	harbor2	chr2	74451364	74451659	LTR/ERV1	2754	+	148	74451512	24538
chr2	238807569	239007569	harbor2	chr2	238823628	238824079	LTR/ERV1	2607	+	226	238823854	16285
chr2	217854217	218054217	harbor2	chr2	217873443	217873815	LTR/ERV1	569	+	186	217873629	19412
chr2	217854217	218054217	harbor2	chr2	217874128	217874283	LTR/ERV1	597	+	78	217874206	19989
chr2	113484950	113684950	harbor2	chr2	113508186	113508307	LTR/ERV1	503	+	60	113508246	23296
chr2	113484950	113684950	harbor2	chr2	113523289	113523687	LTR/ERV1	2438	+	199	113523488	38538
chr2	152618727	152818727	harbor2	chr2	152701339	152701696	LTR/ERV1	1721	+	178	152701517	82790
chr2	152618727	152818727	harbor2	chr2	152701697	152702008	LTR/ERV1	1160	+	156	152701853	83126
chr2	152618727	152818727	harbor2	chr2	152702069	152702204	LTR/ERV1	483	+	68	152702137	83410
chr2	152618727	152818727	harbor2	chr2	152702248	152708261	LTR/ERV1	39267	+	3006	152705254	86527
chr2	152618727	152818727	harbor2	chr2	152708267	152708834	LTR/ERV1	2879	+	284	152708551	89824
chr2	152618727	152818727	harbor2	chr2	152708835	152709137	LTR/ERV1	1330	+	151	152708986	90259
chr2	72787348	72987348	harbor2	chr2	72829487	72830233	LTR/ERV1	4119	+	373	72829860	42512
chr2	72787348	72987348	harbor2	chr2	72833159	72833497	LTR/ERV1	2263	+	169	72833328	45980
chr2	72787348	72987348	harbor2	chr2	72847132	72847593	LTR/ERV1	1817	+	230	72847362	60014
chr2	72787348	72987348	harbor2	chr2	72870195	72870362	LTR/ERV1	1119	+	84	72870279	82931
chr2	229968889	230168889	harbor2	chr2	229992955	229993351	LTR/ERV1	3076	+	198	229993153	24264
chr2	229968889	230168889	harbor2	chr2	230022710	230023049	LTR/ERV1	1189	+	170	230022880	53991
chr2	229968889	230168889	harbor2	chr2	230054261	230054715	LTR/ERV1	3031	+	227	230054488	85599
chr2	6817447	7017447	harbor2	chr2	6869773	6870225	LTR/ERV1	2403	+	226	6869999	52552
chr2	6817447	7017447	harbor2	chr2	6870230	6873927	LTR/ERV1	27324	+	1848	6872078	54631
chr2	6817447	7017447	harbor2	chr2	6874361	6876489	LTR/ERV1	27324	+	1064	6875425	57978
chr2	169386758	169586758	harbor2	chr2	169410659	169411112	LTR/ERV1	1367	+	226	169410885	24127
chr2	169386758	169586758	harbor2	chr2	169478310	169478929	LTR/ERV1	3782	+	310	169478620	91862
chr2	242055177	242255177	harbor2	chr2	242059296	242059878	LTR/ERV1	3183	+	291	242059587	4410
chr2	242055177	242255177	harbor2	chr2	242086911	242086976	LTR/ERV1	869	+	32	242086943	31766
chr2	242055177	242255177	harbor2	chr2	242087016	242087363	LTR/ERV1	1289	+	174	242087190	32013
chr2	232387413	232587413	harbor2	chr2	232389159	232389450	LTR/ERV1	1491	+	146	232389305	1892
chr2	232387413	232587413	harbor2	chr2	232389472	232389716	LTR/ERV1	5428	+	122	232389594	2181
chr2	232387413	232587413	harbor2	chr2	232389784	232390154	LTR/ERV1	5428	+	185	232389969	2556
chr2	232387413	232587413	harbor2	chr2	232391715	232391775	LTR/ERV1	5428	+	30	232391745	4332
chr2	232387413	232587413	harbor2	chr2	232392075	232392329	LTR/ERV1	5428	+	127	232392202	4789
chr2	232387413	232587413	harbor2	chr2	232393250	232393373	LTR/ERV1	1956	+	62	232393312	5899
chr2	232387413	232587413	harbor2	chr2	232394393	232394403	LTR/ERV1	1956	+	5	232394398	6985
chr2	232387413	232587413	harbor2	chr2	232394698	232394940	LTR/ERV1	1956	+	121	232394819	7406
chr2	232387413	232587413	harbor2	chr2	232395334	232395374	LTR/ERV1	877	+	20	232395354	7941
chr2	232387413	232587413	harbor2	chr2	232395493	232395928	LTR/ERV1	1116	+	218	232395711	8298
chr2	232387413	232587413	harbor2	chr2	232396649	232396769	LTR/ERV1	460	+	60	232396709	9296
chr2	232387413	232587413	harbor2	chr2	232422442	232422858	LTR/ERV1	2070	+	208	232422650	35237
chr2	232387413	232587413	harbor2	chr2	232422875	232422992	LTR/ERV1	885	+	58	232422933	35520
chr2	232387413	232587413	harbor2	chr2	232423966	232424094	LTR/ERV1	885	+	64	232424030	36617
chr2	232387413	232587413	harbor2	chr2	232424462	232424800	LTR/ERV1	4340	+	169	232424631	37218
chr2	232387413	232587413	harbor2	chr2	232425148	232426432	LTR/ERV1	4340	+	642	232425790	38377
chr2	232387413	232587413	harbor2	chr2	232426922	232427095	LTR/ERV1	622	+	86	232427008	39595
chr2	232387413	232587413	harbor2	chr2	232427536	232427631	LTR/ERV1	1674	+	48	232427584	40171
chr2	232387413	232587413	harbor2	chr2	232427934	232428276	LTR/ERV1	1674	+	171	232428105	40692
chr2	232387413	232587413	harbor2	chr2	232428576	232428697	LTR/ERV1	1674	+	60	232428636	41223
chr2	232387413	232587413	harbor2	chr2	232428999	232429315	LTR/ERV1	790	+	158	232429157	41744
chr2	232387413	232587413	harbor2	chr2	232429335	232429345	LTR/ERV1	531	+	5	232429340	41927
chr2	232387413	232587413	harbor2	chr2	232429453	232429720	LTR/ERV1	710	+	134	232429587	42174
chr2	232387413	232587413	harbor2	chr2	232430765	232431076	LTR/ERV1	1738	+	156	232430921	43508
chr2	232387413	232587413	harbor2	chr2	232390432	232391412	LTR/ERV1	5428	+	490	232390922	3509
chr2	86515479	86715479	harbor2	chr2	86520843	86521292	LTR/ERV1	3766	+	224	86521067	5588
chr2	86515479	86715479	harbor2	chr2	86543327	86543763	LTR/ERV1	2499	+	218	86543545	28066
chr2	237919027	238119027	harbor2	chr2	237930215	237930770	LTR/ERV1	3381	+	278	237930493	11466
chr2	237919027	238119027	harbor2	chr2	237935696	237936177	LTR/ERV1	2413	+	240	237935936	16909
chr2	237919027	238119027	harbor2	chr2	237947340	237947704	LTR/ERV1	1555	+	182	237947522	28495
chr2	237919027	238119027	harbor2	chr2	237948012	237948184	LTR/ERV1	1555	+	86	237948098	29071
chr2	237919027	238119027	harbor2	chr2	237963074	237963386	LTR/ERV1	5181	+	156	237963230	44203
chr2	237919027	238119027	harbor2	chr2	237963679	237964101	LTR/ERV1	5181	+	211	237963890	44863
chr2	237919027	238119027	harbor2	chr2	237964702	237964854	LTR/ERV1	5181	+	76	237964778	45751
chr2	237919027	238119027	harbor2	chr2	237943526	237945170	LTR/ERV1	7877	+	822	237944348	25321
chr2	113779869	113979869	harbor2	chr2	113807959	113808353	LTR/ERV1	2215	+	197	113808156	28287
chr2	113779869	113979869	harbor2	chr2	113808665	113808908	LTR/ERV1	2215	+	122	113808787	28918
chr2	113779869	113979869	harbor2	chr2	113809016	113809740	LTR/ERV1	4771	+	362	113809378	29509
chr2	239858832	240058832	harbor2	chr2	239878988	239879084	LTR/ERV1	2683	+	48	239879036	20204
chr2	239858832	240058832	harbor2	chr2	239879398	239879730	LTR/ERV1	2683	+	166	239879564	20732
chr2	239858832	240058832	harbor2	chr2	239900406	239900567	LTR/ERV1	881	+	80	239900486	41654
chr2	239858832	240058832	harbor2	chr2	239917169	239917860	LTR/ERV1	4362	+	346	239917515	58683
chr2	42261218	42461218	harbor2	chr2	42312240	42312557	LTR/ERV1	2615	+	158	42312398	51180
chr2	42261218	42461218	harbor2	chr2	42312853	42312946	LTR/ERV1	2615	+	46	42312899	51681
chr2	42261218	42461218	harbor2	chr2	42313255	42313440	LTR/ERV1	2615	+	92	42313347	52129
chr2	127929061	128129061	harbor2	chr2	127981045	127981347	LTR/ERV1	1996	+	151	127981196	52135
chr2	127929061	128129061	harbor2	chr2	127981348	127981399	LTR/ERV1	445	+	26	127981374	52313
chr2	127929061	128129061	harbor2	chr2	127981510	127981550	LTR/ERV1	445	+	20	127981530	52469
chr2	127929061	128129061	harbor2	chr2	127981592	127981684	LTR/ERV1	1578	+	46	127981638	52577
chr2	127929061	128129061	harbor2	chr2	127981794	127982006	LTR/ERV1	1578	+	106	127981900	52839
chr2	127929061	128129061	harbor2	chr2	127985623	127986410	LTR/ERV1	5011	+	394	127986017	56956
chr2	111955657	112155657	harbor2	chr2	112040229	112040674	LTR/ERV1	3193	+	222	112040451	84794
chr2	113497566	113697566	harbor2	chr2	113508186	113508307	LTR/ERV1	503	+	60	113508246	10680
chr2	113497566	113697566	harbor2	chr2	113523289	113523687	LTR/ERV1	2438	+	199	113523488	25922
chr2	86976784	87176784	harbor2	chr2	87027968	87028409	LTR/ERV1	2875	+	220	87028188	51404
chr2	86976784	87176784	harbor2	chr2	87039336	87039555	LTR/ERV1	1083	+	110	87039446	62662
chr2	86976784	87176784	harbor2	chr2	87039873	87042637	LTR/ERV1	10419	+	1382	87041255	64471
chr2	86976784	87176784	harbor2	chr2	87042795	87043095	LTR/ERV1	1798	+	150	87042945	66161
chr2	86976784	87176784	harbor2	chr2	87043096	87043487	LTR/ERV1	1451	+	196	87043292	66508
chr2	152618540	152818540	harbor2	chr2	152701339	152701696	LTR/ERV1	1721	+	178	152701517	82977
chr2	152618540	152818540	harbor2	chr2	152701697	152702008	LTR/ERV1	1160	+	156	152701853	83313
chr2	152618540	152818540	harbor2	chr2	152702069	152702204	LTR/ERV1	483	+	68	152702137	83597
chr2	152618540	152818540	harbor2	chr2	152702248	152708261	LTR/ERV1	39267	+	3006	152705254	86714
chr2	152618540	152818540	harbor2	chr2	152708267	152708834	LTR/ERV1	2879	+	284	152708551	90011
chr2	152618540	152818540	harbor2	chr2	152708835	152709137	LTR/ERV1	1330	+	151	152708986	90446
chr2	63489005	63689005	harbor2	chr2	63513399	63514017	LTR/ERV1	3092	+	309	63513708	24703
chr2	63489005	63689005	harbor2	chr2	63566154	63566612	LTR/ERV1	3242	+	229	63566383	77378
chr2	74415881	74615881	harbor2	chr2	74450757	74451063	LTR/ERV1	2754	+	153	74450910	35029
chr2	74415881	74615881	harbor2	chr2	74451364	74451659	LTR/ERV1	2754	+	148	74451512	35631
chr2	203717178	203917178	harbor2	chr2	203767213	203767672	LTR/ERV1	2499	+	230	203767443	50265
chr2	219343736	219543736	harbor2	chr2	219364312	219364483	LTR/ERV1	572	+	86	219364398	20662
chr2	219343736	219543736	harbor2	chr2	219365876	219366426	LTR/ERV1	2119	+	275	219366151	22415
chr2	219343736	219543736	harbor2	chr2	219365328	219365569	LTR/ERV1	2119	+	120	219365448	21712
chr2	74427953	74627953	harbor2	chr2	74450757	74451063	LTR/ERV1	2754	+	153	74450910	22957
chr2	74427953	74627953	harbor2	chr2	74451364	74451659	LTR/ERV1	2754	+	148	74451512	23559
chr2	232394713	232594713	harbor2	chr2	232394698	232394940	LTR/ERV1	1956	+	121	232394819	106
chr2	232394713	232594713	harbor2	chr2	232395334	232395374	LTR/ERV1	877	+	20	232395354	641
chr2	232394713	232594713	harbor2	chr2	232395493	232395928	LTR/ERV1	1116	+	218	232395711	998
chr2	232394713	232594713	harbor2	chr2	232396649	232396769	LTR/ERV1	460	+	60	232396709	1996
chr2	232394713	232594713	harbor2	chr2	232422442	232422858	LTR/ERV1	2070	+	208	232422650	27937
chr2	232394713	232594713	harbor2	chr2	232422875	232422992	LTR/ERV1	885	+	58	232422933	28220
chr2	232394713	232594713	harbor2	chr2	232423966	232424094	LTR/ERV1	885	+	64	232424030	29317
chr2	232394713	232594713	harbor2	chr2	232424462	232424800	LTR/ERV1	4340	+	169	232424631	29918
chr2	232394713	232594713	harbor2	chr2	232425148	232426432	LTR/ERV1	4340	+	642	232425790	31077
chr2	232394713	232594713	harbor2	chr2	232426922	232427095	LTR/ERV1	622	+	86	232427008	32295
chr2	232394713	232594713	harbor2	chr2	232427536	232427631	LTR/ERV1	1674	+	48	232427584	32871
chr2	232394713	232594713	harbor2	chr2	232427934	232428276	LTR/ERV1	1674	+	171	232428105	33392
chr2	232394713	232594713	harbor2	chr2	232428576	232428697	LTR/ERV1	1674	+	60	232428636	33923
chr2	232394713	232594713	harbor2	chr2	232428999	232429315	LTR/ERV1	790	+	158	232429157	34444
chr2	232394713	232594713	harbor2	chr2	232429335	232429345	LTR/ERV1	531	+	5	232429340	34627
chr2	232394713	232594713	harbor2	chr2	232429453	232429720	LTR/ERV1	710	+	134	232429587	34874
chr2	232394713	232594713	harbor2	chr2	232430765	232431076	LTR/ERV1	1738	+	156	232430921	36208
chr2	240592789	240792789	harbor2	chr2	240670154	240670797	LTR/ERV1	3723	+	322	240670476	77687
chr2	240592789	240792789	harbor2	chr2	240675220	240675538	LTR/ERV1	1191	+	159	240675379	82590
chr2	240592789	240792789	harbor2	chr2	240675579	240675754	LTR/ERV1	722	+	88	240675667	82878
chr2	240592789	240792789	harbor2	chr2	240688964	240689149	LTR/ERV1	879	+	92	240689056	96267
chr2	56085624	56285624	harbor2	chr2	56102218	56102763	LTR/ERV1	3653	+	272	56102490	16866
chr2	56085624	56285624	harbor2	chr2	56158620	56159831	LTR/ERV1	8792	+	606	56159226	73602
chr2	56085624	56285624	harbor2	chr2	56159834	56160407	LTR/ERV1	3471	+	286	56160120	74496
chr2	56148544	56348544	harbor2	chr2	56158620	56159831	LTR/ERV1	8792	+	606	56159226	10682
chr2	56148544	56348544	harbor2	chr2	56159834	56160407	LTR/ERV1	3471	+	286	56160120	11576
chr2	56148544	56348544	harbor2	chr2	56240221	56240581	LTR/ERV1	1637	+	180	56240401	91857
chr2	6845395	7045395	harbor2	chr2	6869773	6870225	LTR/ERV1	2403	+	226	6869999	24604
chr2	6845395	7045395	harbor2	chr2	6870230	6873927	LTR/ERV1	27324	+	1848	6872078	26683
chr2	6845395	7045395	harbor2	chr2	6874361	6876489	LTR/ERV1	27324	+	1064	6875425	30030
chr2	130084190	130284190	harbor2	chr2	130102486	130102977	LTR/ERV1	1317	+	246	130102732	18542
chr2	26246115	26446115	harbor2	chr2	26296969	26297465	LTR/ERV1	3923	+	248	26297217	51102
chr2	26246115	26446115	harbor2	chr2	26297755	26297858	LTR/ERV1	3923	+	52	26297807	51692
chr2	26246115	26446115	harbor2	chr2	26297921	26298397	LTR/ERV1	3205	+	238	26298159	52044
chr2	26246115	26446115	harbor2	chr2	26298404	26299683	LTR/ERV1	7990	+	640	26299044	52929
chr2	26246115	26446115	harbor2	chr2	26299721	26300034	LTR/ERV1	1243	+	156	26299877	53762
chr2	26246115	26446115	harbor2	chr2	26300024	26301463	LTR/ERV1	6388	+	720	26300744	54629
chr2	26246115	26446115	harbor2	chr2	26301464	26304444	LTR/ERV1	21452	+	1490	26302954	56839
chr2	26246115	26446115	harbor2	chr2	26304438	26305540	LTR/ERV1	8240	+	551	26304989	58874
chr2	26246115	26446115	harbor2	chr2	26305521	26305910	LTR/ERV1	2794	+	194	26305715	59600
chr2	26246115	26446115	harbor2	chr2	26305911	26306395	LTR/ERV1	3075	+	242	26306153	60038
chr2	26246115	26446115	harbor2	chr2	26339177	26339213	LTR/ERV1	3687	+	18	26339195	93080
chr2	26246115	26446115	harbor2	chr2	26339526	26340107	LTR/ERV1	3687	+	290	26339816	93701
chr2	26403683	26603683	harbor2	chr2	26407447	26408136	LTR/ERV1	879	+	344	26407791	4108
chr2	26403683	26603683	harbor2	chr2	26493549	26494007	LTR/ERV1	3470	+	229	26493778	90095
chr2	74272719	74472719	harbor2	chr2	74306089	74306553	LTR/ERV1	3185	+	232	74306321	33602
chr2	74272719	74472719	harbor2	chr2	74316353	74317269	LTR/ERV1	5882	+	458	74316811	44092
chr2	74272719	74472719	harbor2	chr2	74340703	74341022	LTR/ERV1	769	+	160	74340863	68144
chr2	74272719	74472719	harbor2	chr2	74341331	74341409	LTR/ERV1	769	+	39	74341370	68651
chr2	74415899	74615899	harbor2	chr2	74450757	74451063	LTR/ERV1	2754	+	153	74450910	35011
chr2	74415899	74615899	harbor2	chr2	74451364	74451659	LTR/ERV1	2754	+	148	74451512	35613
chr2	3169197	3369197	harbor2	chr2	3252883	3253455	LTR/ERV1	2647	+	286	3253169	83972
chr2	74372415	74572415	harbor2	chr2	74406028	74406603	LTR/ERV1	3671	+	288	74406316	33901
chr2	74372415	74572415	harbor2	chr2	74450757	74451063	LTR/ERV1	2754	+	153	74450910	78495
chr2	74372415	74572415	harbor2	chr2	74451364	74451659	LTR/ERV1	2754	+	148	74451512	79097
chr2	240348203	240548203	harbor2	chr2	240387268	240387343	LTR/ERV1	554	+	38	240387306	39103
chr2	240348203	240548203	harbor2	chr2	240414262	240414743	LTR/ERV1	2199	+	240	240414502	66299
chr2	240348203	240548203	harbor2	chr2	240415051	240416238	LTR/ERV1	2199	+	594	240415645	67442
chr2	240348203	240548203	harbor2	chr2	240416224	240416299	LTR/ERV1	447	+	38	240416262	68059
chr2	240348203	240548203	harbor2	chr2	240416761	240417234	LTR/ERV1	849	+	236	240416997	68794
chr2	240348203	240548203	harbor2	chr2	240417982	240418404	LTR/ERV1	2308	+	211	240418193	69990
chr2	240348203	240548203	harbor2	chr2	240426341	240426727	LTR/ERV1	770	+	193	240426534	78331
chr2	240348203	240548203	harbor2	chr2	240427139	240427176	LTR/ERV1	770	+	18	240427157	78954
chr2	61805670	62005670	harbor2	chr2	61805538	61805707	LTR/ERV1	3408	+	84	61805622	48
chr2	61805670	62005670	harbor2	chr2	61814716	61814880	LTR/ERV1	892	+	82	61814798	9128
chr2	61805670	62005670	harbor2	chr2	61875631	61875799	LTR/ERV1	533	+	84	61875715	70045
chr2	61805670	62005670	harbor2	chr2	61896642	61896814	LTR/ERV1	2257	+	86	61896728	91058
chr2	61805670	62005670	harbor2	chr2	61897126	61897469	LTR/ERV1	2257	+	172	61897298	91628
chr2	61805670	62005670	harbor2	chr2	61899096	61899616	LTR/ERV1	2456	+	260	61899356	93686
chr2	111955694	112155694	harbor2	chr2	112040229	112040674	LTR/ERV1	3193	+	222	112040451	84757
chr2	26416022	26616022	harbor2	chr2	26493549	26494007	LTR/ERV1	3470	+	229	26493778	77756
chr2	120666618	120866618	harbor2	chr2	120690958	120691377	LTR/ERV1	726	+	210	120691168	24550
chr2	120666618	120866618	harbor2	chr2	120699838	120700306	LTR/ERV1	2549	+	234	120700072	33454
chr2	152619118	152819118	harbor2	chr2	152701339	152701696	LTR/ERV1	1721	+	178	152701517	82399
chr2	152619118	152819118	harbor2	chr2	152701697	152702008	LTR/ERV1	1160	+	156	152701853	82735
chr2	152619118	152819118	harbor2	chr2	152702069	152702204	LTR/ERV1	483	+	68	152702137	83019
chr2	152619118	152819118	harbor2	chr2	152702248	152708261	LTR/ERV1	39267	+	3006	152705254	86136
chr2	152619118	152819118	harbor2	chr2	152708267	152708834	LTR/ERV1	2879	+	284	152708551	89433
chr2	152619118	152819118	harbor2	chr2	152708835	152709137	LTR/ERV1	1330	+	151	152708986	89868
chr2	44379608	44579608	harbor2	chr2	44444649	44445645	LTR/ERV1	7079	+	498	44445147	65539
chr2	44379608	44579608	harbor2	chr2	44445694	44446040	LTR/ERV1	2268	+	173	44445867	66259
chr2	178350868	178550868	harbor2	chr2	178417851	178418311	LTR/ERV1	2602	+	230	178418081	67213
chr2	111956912	112156912	harbor2	chr2	112040229	112040674	LTR/ERV1	3193	+	222	112040451	83539
chr2	48215708	48415708	harbor2	chr2	48261787	48262436	LTR/ERV1	3484	+	324	48262111	46403
chr2	48215708	48415708	harbor2	chr2	48266364	48267041	LTR/ERV1	4903	+	338	48266702	50994
chr2	48215708	48415708	harbor2	chr2	48284937	48285479	LTR/ERV1	2867	+	271	48285208	69500
chr2	48215708	48415708	harbor2	chr2	48304262	48304710	LTR/ERV1	2434	+	224	48304486	88778
chr2	217119672	217319672	harbor2	chr2	217209504	217210005	LTR/ERV1	5060	+	250	217209754	90082
chr2	217119672	217319672	harbor2	chr2	217210317	217210375	LTR/ERV1	5060	+	29	217210346	90674
chr2	217119672	217319672	harbor2	chr2	217211068	217211413	LTR/ERV1	5060	+	172	217211240	91568
chr2	113484926	113684926	harbor2	chr2	113508186	113508307	LTR/ERV1	503	+	60	113508246	23320
chr2	113484926	113684926	harbor2	chr2	113523289	113523687	LTR/ERV1	2438	+	199	113523488	38562
chr2	113619441	113819441	harbor2	chr2	113625731	113626140	LTR/ERV1	2668	+	204	113625935	6494
chr2	113619441	113819441	harbor2	chr2	113626279	113626718	LTR/ERV1	3035	+	220	113626499	7058
chr2	113619441	113819441	harbor2	chr2	113673129	113673525	LTR/ERV1	1770	+	198	113673327	53886
chr2	113619441	113819441	harbor2	chr2	113675989	113676335	LTR/ERV1	1995	+	173	113676162	56721
chr2	95821397	96021397	harbor2	chr2	95857529	95858276	LTR/ERV1	5553	+	374	95857903	36506
chr2	26246633	26446633	harbor2	chr2	26296969	26297465	LTR/ERV1	3923	+	248	26297217	50584
chr2	26246633	26446633	harbor2	chr2	26297755	26297858	LTR/ERV1	3923	+	52	26297807	51174
chr2	26246633	26446633	harbor2	chr2	26297921	26298397	LTR/ERV1	3205	+	238	26298159	51526
chr2	26246633	26446633	harbor2	chr2	26298404	26299683	LTR/ERV1	7990	+	640	26299044	52411
chr2	26246633	26446633	harbor2	chr2	26299721	26300034	LTR/ERV1	1243	+	156	26299877	53244
chr2	26246633	26446633	harbor2	chr2	26300024	26301463	LTR/ERV1	6388	+	720	26300744	54111
chr2	26246633	26446633	harbor2	chr2	26301464	26304444	LTR/ERV1	21452	+	1490	26302954	56321
chr2	26246633	26446633	harbor2	chr2	26304438	26305540	LTR/ERV1	8240	+	551	26304989	58356
chr2	26246633	26446633	harbor2	chr2	26305521	26305910	LTR/ERV1	2794	+	194	26305715	59082
chr2	26246633	26446633	harbor2	chr2	26305911	26306395	LTR/ERV1	3075	+	242	26306153	59520
chr2	26246633	26446633	harbor2	chr2	26339177	26339213	LTR/ERV1	3687	+	18	26339195	92562
chr2	26246633	26446633	harbor2	chr2	26339526	26340107	LTR/ERV1	3687	+	290	26339816	93183
chr2	159046393	159246393	harbor2	chr2	159047418	159047856	LTR/ERV1	3024	+	219	159047637	1244
chr2	159046393	159246393	harbor2	chr2	159061260	159061750	LTR/ERV1	2009	+	245	159061505	15112
chr2	159046393	159246393	harbor2	chr2	159099523	159099980	LTR/ERV1	2226	+	228	159099751	53358
chr2	105442419	105642419	harbor2	chr2	105441879	105442451	LTR/ERV1	3425	+	286	105442165	254
chr2	105442419	105642419	harbor2	chr2	105442748	105442849	LTR/ERV1	3425	+	50	105442798	379
chr2	105442419	105642419	harbor2	chr2	105462035	105462450	LTR/ERV1	1600	+	208	105462243	19824
chr2	105442419	105642419	harbor2	chr2	105464265	105464773	LTR/ERV1	2248	+	254	105464519	22100
chr2	105442419	105642419	harbor2	chr2	105467826	105468461	LTR/ERV1	4790	+	318	105468144	25725
chr2	105442419	105642419	harbor2	chr2	105510744	105511016	LTR/ERV1	902	+	136	105510880	68461
chr2	105442419	105642419	harbor2	chr2	105525030	105525557	LTR/ERV1	1550	+	264	105525294	82875
chr2	105442419	105642419	harbor2	chr2	105525563	105526829	LTR/ERV1	7064	+	633	105526196	83777
chr2	105442419	105642419	harbor2	chr2	105536685	105537241	LTR/ERV1	2964	+	278	105536963	94544
chr2	113484846	113684846	harbor2	chr2	113508186	113508307	LTR/ERV1	503	+	60	113508246	23400
chr2	113484846	113684846	harbor2	chr2	113523289	113523687	LTR/ERV1	2438	+	199	113523488	38642
chr2	152618543	152818543	harbor2	chr2	152701339	152701696	LTR/ERV1	1721	+	178	152701517	82974
chr2	152618543	152818543	harbor2	chr2	152701697	152702008	LTR/ERV1	1160	+	156	152701853	83310
chr2	152618543	152818543	harbor2	chr2	152702069	152702204	LTR/ERV1	483	+	68	152702137	83594
chr2	152618543	152818543	harbor2	chr2	152702248	152708261	LTR/ERV1	39267	+	3006	152705254	86711
chr2	152618543	152818543	harbor2	chr2	152708267	152708834	LTR/ERV1	2879	+	284	152708551	90008
chr2	152618543	152818543	harbor2	chr2	152708835	152709137	LTR/ERV1	1330	+	151	152708986	90443
chr2	199357332	199557332	harbor2	chr2	199398404	199398539	LTR/ERV1	649	+	68	199398472	41140
chr2	96108919	96308919	harbor2	chr2	96159588	96159719	LTR/ERV1	541	+	66	96159654	50735
chr2	96108919	96308919	harbor2	chr2	96167756	96168430	LTR/ERV1	3832	+	337	96168093	59174
chr2	111957164	112157164	harbor2	chr2	112040229	112040674	LTR/ERV1	3193	+	222	112040451	83287
chr2	120635614	120835614	harbor2	chr2	120690958	120691377	LTR/ERV1	726	+	210	120691168	55554
chr2	120635614	120835614	harbor2	chr2	120699838	120700306	LTR/ERV1	2549	+	234	120700072	64458
chr3	107992947	108192947	harbor2	chr3	108004049	108004862	LTR/ERV1	4649	+	406	108004455	11508
chr3	107992947	108192947	harbor2	chr3	108015103	108015632	LTR/ERV1	886	+	264	108015367	22420
chr3	107992947	108192947	harbor2	chr3	108022756	108023270	LTR/ERV1	3041	+	257	108023013	30066
chr3	107992947	108192947	harbor2	chr3	108082189	108082611	LTR/ERV1	786	+	211	108082400	89453
chr3	107992058	108192058	harbor2	chr3	108004049	108004862	LTR/ERV1	4649	+	406	108004455	12397
chr3	107992058	108192058	harbor2	chr3	108015103	108015632	LTR/ERV1	886	+	264	108015367	23309
chr3	107992058	108192058	harbor2	chr3	108022756	108023270	LTR/ERV1	3041	+	257	108023013	30955
chr3	107992058	108192058	harbor2	chr3	108082189	108082611	LTR/ERV1	786	+	211	108082400	90342
chr3	50288151	50488151	harbor2	chr3	50304978	50305233	LTR/ERV1	2395	+	128	50305106	16955
chr3	50288151	50488151	harbor2	chr3	50305833	50306021	LTR/ERV1	2395	+	94	50305927	17776
chr3	50288151	50488151	harbor2	chr3	50306024	50306564	LTR/ERV1	2367	+	270	50306294	18143
chr3	50288151	50488151	harbor2	chr3	50309030	50309182	LTR/ERV1	2292	+	76	50309106	20955
chr3	50288151	50488151	harbor2	chr3	50309485	50309688	LTR/ERV1	2292	+	102	50309587	21436
chr3	50288151	50488151	harbor2	chr3	50309786	50310263	LTR/ERV1	2292	+	238	50310024	21873
chr3	50288151	50488151	harbor2	chr3	50313340	50313494	LTR/ERV1	1704	+	77	50313417	25266
chr3	50288151	50488151	harbor2	chr3	50313797	50314006	LTR/ERV1	1704	+	104	50313901	25750
chr3	50288151	50488151	harbor2	chr3	50314007	50314445	LTR/ERV1	2633	+	219	50314226	26075
chr3	107999874	108199874	harbor2	chr3	108004049	108004862	LTR/ERV1	4649	+	406	108004455	4581
chr3	107999874	108199874	harbor2	chr3	108015103	108015632	LTR/ERV1	886	+	264	108015367	15493
chr3	107999874	108199874	harbor2	chr3	108022756	108023270	LTR/ERV1	3041	+	257	108023013	23139
chr3	107999874	108199874	harbor2	chr3	108082189	108082611	LTR/ERV1	786	+	211	108082400	82526
chr3	46806484	47006484	harbor2	chr3	46826598	46826866	LTR/ERV1	3056	+	134	46826732	20248
chr3	46806484	47006484	harbor2	chr3	46827252	46827474	LTR/ERV1	3056	+	111	46827363	20879
chr3	178973707	179173707	harbor2	chr3	178986349	178986835	LTR/ERV1	1577	+	243	178986592	12885
chr3	178973707	179173707	harbor2	chr3	178987239	178987990	LTR/ERV1	3671	+	376	178987615	13908
chr3	178973707	179173707	harbor2	chr3	178997188	178997975	LTR/ERV1	5002	+	394	178997582	23875
chr3	178973707	179173707	harbor2	chr3	178998226	178998779	LTR/ERV1	2161	+	276	178998502	24795
chr3	178973707	179173707	harbor2	chr3	178998859	178999054	LTR/ERV1	567	+	98	178998957	25250
chr3	178973707	179173707	harbor2	chr3	178999085	178999296	LTR/ERV1	493	+	106	178999191	25484
chr3	178973707	179173707	harbor2	chr3	179000204	179000860	LTR/ERV1	7248	+	328	179000532	26825
chr3	178973707	179173707	harbor2	chr3	179001636	179002920	LTR/ERV1	7248	+	642	179002278	28571
chr3	178973707	179173707	harbor2	chr3	179003336	179003736	LTR/ERV1	928	+	200	179003536	29829
chr3	178973707	179173707	harbor2	chr3	179003759	179003922	LTR/ERV1	431	+	82	179003841	30134
chr3	178973707	179173707	harbor2	chr3	179012325	179012593	LTR/ERV1	1869	+	134	179012459	38752
chr3	178973707	179173707	harbor2	chr3	179012899	179013065	LTR/ERV1	1869	+	83	179012982	39275
chr3	178973707	179173707	harbor2	chr3	179013074	179013730	LTR/ERV1	2068	+	328	179013402	39695
chr3	178973707	179173707	harbor2	chr3	179013731	179013845	LTR/ERV1	476	+	57	179013788	40081
chr3	178973707	179173707	harbor2	chr3	179036743	179037622	LTR/ERV1	3649	+	440	179037183	63476
chr3	178973707	179173707	harbor2	chr3	179054591	179055103	LTR/ERV1	3671	+	256	179054847	81140
chr3	178973707	179173707	harbor2	chr3	179055134	179058474	LTR/ERV1	30917	+	1670	179056804	83097
chr3	178973707	179173707	harbor2	chr3	179058786	179059514	LTR/ERV1	30917	+	364	179059150	85443
chr3	178973707	179173707	harbor2	chr3	179059537	179059828	LTR/ERV1	2324	+	146	179059683	85976
chr3	178973707	179173707	harbor2	chr3	179059829	179060155	LTR/ERV1	2423	+	163	179059992	86285
chr3	178973707	179173707	harbor2	chr3	179011539	179011954	LTR/ERV1	1437	+	208	179011747	38040
chr3	51941658	52141658	harbor2	chr3	51990374	51991626	LTR/ERV1	8156	+	626	51991000	49342
chr3	51940304	52140304	harbor2	chr3	51990374	51991626	LTR/ERV1	8156	+	626	51991000	50696
chr3	132356932	132556932	harbor2	chr3	132396248	132397368	LTR/ERV1	7793	+	560	132396808	39876
chr3	132356932	132556932	harbor2	chr3	132413725	132414171	LTR/ERV1	2362	+	223	132413948	57016
chr3	132356932	132556932	harbor2	chr3	132414458	132414491	LTR/ERV1	2362	+	16	132414474	57542
chr3	50288175	50488175	harbor2	chr3	50304978	50305233	LTR/ERV1	2395	+	128	50305106	16931
chr3	50288175	50488175	harbor2	chr3	50305833	50306021	LTR/ERV1	2395	+	94	50305927	17752
chr3	50288175	50488175	harbor2	chr3	50306024	50306564	LTR/ERV1	2367	+	270	50306294	18119
chr3	50288175	50488175	harbor2	chr3	50309030	50309182	LTR/ERV1	2292	+	76	50309106	20931
chr3	50288175	50488175	harbor2	chr3	50309485	50309688	LTR/ERV1	2292	+	102	50309587	21412
chr3	50288175	50488175	harbor2	chr3	50309786	50310263	LTR/ERV1	2292	+	238	50310024	21849
chr3	50288175	50488175	harbor2	chr3	50313340	50313494	LTR/ERV1	1704	+	77	50313417	25242
chr3	50288175	50488175	harbor2	chr3	50313797	50314006	LTR/ERV1	1704	+	104	50313901	25726
chr3	50288175	50488175	harbor2	chr3	50314007	50314445	LTR/ERV1	2633	+	219	50314226	26051
chr3	107993020	108193020	harbor2	chr3	108004049	108004862	LTR/ERV1	4649	+	406	108004455	11435
chr3	107993020	108193020	harbor2	chr3	108015103	108015632	LTR/ERV1	886	+	264	108015367	22347
chr3	107993020	108193020	harbor2	chr3	108022756	108023270	LTR/ERV1	3041	+	257	108023013	29993
chr3	107993020	108193020	harbor2	chr3	108082189	108082611	LTR/ERV1	786	+	211	108082400	89380
chr3	127490780	127690780	harbor2	chr3	127496043	127497557	LTR/ERV1	7331	+	757	127496800	6020
chr3	127490780	127690780	harbor2	chr3	127512675	127513142	LTR/ERV1	2544	+	234	127512909	22129
chr3	127490780	127690780	harbor2	chr3	127543041	127543380	LTR/ERV1	1454	+	170	127543211	52431
chr3	51939426	52139426	harbor2	chr3	51990374	51991626	LTR/ERV1	8156	+	626	51991000	51574
chr3	140273579	140473579	harbor2	chr3	140325501	140326017	LTR/ERV1	3928	+	258	140325759	52180
chr3	143035218	143235218	harbor2	chr3	143095161	143096764	LTR/ERV1	8646	+	802	143095963	60745
chr3	143035218	143235218	harbor2	chr3	143103534	143103960	LTR/ERV1	3039	+	213	143103747	68529
chr3	143035218	143235218	harbor2	chr3	143104239	143104431	LTR/ERV1	3039	+	96	143104335	69117
chr3	143035218	143235218	harbor2	chr3	143104432	143104669	LTR/ERV1	526	+	118	143104550	69332
chr3	143035218	143235218	harbor2	chr3	143104670	143105075	LTR/ERV1	2054	+	202	143104872	69654
chr3	143035218	143235218	harbor2	chr3	143105080	143105917	LTR/ERV1	4215	+	418	143105498	70280
chr3	143035218	143235218	harbor2	chr3	143105927	143106055	LTR/ERV1	680	+	64	143105991	70773
chr3	143035218	143235218	harbor2	chr3	143106056	143108916	LTR/ERV1	17026	+	1430	143107486	72268
chr3	143035218	143235218	harbor2	chr3	143109212	143109316	LTR/ERV1	17026	+	52	143109264	74046
chr3	143035218	143235218	harbor2	chr3	143109616	143109993	LTR/ERV1	17026	+	188	143109804	74586
chr3	143035218	143235218	harbor2	chr3	143109994	143110152	LTR/ERV1	524	+	79	143110073	74855
chr3	108053599	108253599	harbor2	chr3	108082189	108082611	LTR/ERV1	786	+	211	108082400	28801
chr3	50288522	50488522	harbor2	chr3	50304978	50305233	LTR/ERV1	2395	+	128	50305106	16584
chr3	50288522	50488522	harbor2	chr3	50305833	50306021	LTR/ERV1	2395	+	94	50305927	17405
chr3	50288522	50488522	harbor2	chr3	50306024	50306564	LTR/ERV1	2367	+	270	50306294	17772
chr3	50288522	50488522	harbor2	chr3	50309030	50309182	LTR/ERV1	2292	+	76	50309106	20584
chr3	50288522	50488522	harbor2	chr3	50309485	50309688	LTR/ERV1	2292	+	102	50309587	21065
chr3	50288522	50488522	harbor2	chr3	50309786	50310263	LTR/ERV1	2292	+	238	50310024	21502
chr3	50288522	50488522	harbor2	chr3	50313340	50313494	LTR/ERV1	1704	+	77	50313417	24895
chr3	50288522	50488522	harbor2	chr3	50313797	50314006	LTR/ERV1	1704	+	104	50313901	25379
chr3	50288522	50488522	harbor2	chr3	50314007	50314445	LTR/ERV1	2633	+	219	50314226	25704
chr3	50288101	50488101	harbor2	chr3	50304978	50305233	LTR/ERV1	2395	+	128	50305106	17005
chr3	50288101	50488101	harbor2	chr3	50305833	50306021	LTR/ERV1	2395	+	94	50305927	17826
chr3	50288101	50488101	harbor2	chr3	50306024	50306564	LTR/ERV1	2367	+	270	50306294	18193
chr3	50288101	50488101	harbor2	chr3	50309030	50309182	LTR/ERV1	2292	+	76	50309106	21005
chr3	50288101	50488101	harbor2	chr3	50309485	50309688	LTR/ERV1	2292	+	102	50309587	21486
chr3	50288101	50488101	harbor2	chr3	50309786	50310263	LTR/ERV1	2292	+	238	50310024	21923
chr3	50288101	50488101	harbor2	chr3	50313340	50313494	LTR/ERV1	1704	+	77	50313417	25316
chr3	50288101	50488101	harbor2	chr3	50313797	50314006	LTR/ERV1	1704	+	104	50313901	25800
chr3	50288101	50488101	harbor2	chr3	50314007	50314445	LTR/ERV1	2633	+	219	50314226	26125
chr3	197860224	198060224	harbor2	chr3	197935463	197935501	LTR/ERV1	1174	+	19	197935482	75258
chr3	197860224	198060224	harbor2	chr3	197935775	197935962	LTR/ERV1	1174	+	94	197935869	75645
chr3	197860224	198060224	harbor2	chr3	197935092	197935158	LTR/ERV1	1174	+	33	197935125	74901
chr3	107992017	108192017	harbor2	chr3	108004049	108004862	LTR/ERV1	4649	+	406	108004455	12438
chr3	107992017	108192017	harbor2	chr3	108015103	108015632	LTR/ERV1	886	+	264	108015367	23350
chr3	107992017	108192017	harbor2	chr3	108022756	108023270	LTR/ERV1	3041	+	257	108023013	30996
chr3	107992017	108192017	harbor2	chr3	108082189	108082611	LTR/ERV1	786	+	211	108082400	90383
chr3	51948441	52148441	harbor2	chr3	51990374	51991626	LTR/ERV1	8156	+	626	51991000	42559
chr3	108122047	108322047	harbor2	chr3	108183274	108183740	LTR/ERV1	1574	+	233	108183507	61460
chr3	52085449	52285449	harbor2	chr3	52155574	52156144	LTR/ERV1	3629	+	285	52155859	70410
chr3	52085449	52285449	harbor2	chr3	52156148	52156636	LTR/ERV1	7193	+	244	52156392	70943
chr3	52085449	52285449	harbor2	chr3	52156947	52157145	LTR/ERV1	7193	+	99	52157046	71597
chr3	52085449	52285449	harbor2	chr3	52157442	52157893	LTR/ERV1	7193	+	226	52157668	72219
chr3	52085449	52285449	harbor2	chr3	52158207	52158226	LTR/ERV1	7193	+	10	52158217	72768
chr3	52085449	52285449	harbor2	chr3	52159468	52160111	LTR/ERV1	7193	+	322	52159790	74341
chr3	52085449	52285449	harbor2	chr3	52160393	52160484	LTR/ERV1	7193	+	46	52160439	74990
chr3	52085449	52285449	harbor2	chr3	52160792	52161075	LTR/ERV1	7193	+	142	52160934	75485
chr3	52085449	52285449	harbor2	chr3	52161378	52161423	LTR/ERV1	10035	+	22	52161400	75951
chr3	52085449	52285449	harbor2	chr3	52162862	52163142	LTR/ERV1	10035	+	140	52163002	77553
chr3	52085449	52285449	harbor2	chr3	52163446	52163803	LTR/ERV1	10035	+	178	52163624	78175
chr3	52085449	52285449	harbor2	chr3	52164397	52164430	LTR/ERV1	10035	+	16	52164413	78964
chr3	52085449	52285449	harbor2	chr3	52165067	52166322	LTR/ERV1	10035	+	628	52165695	80246
chr3	52085449	52285449	harbor2	chr3	52166714	52167033	LTR/ERV1	1831	+	160	52166874	81425
chr3	52085449	52285449	harbor2	chr3	52167289	52167645	LTR/ERV1	1622	+	178	52167467	82018
chr3	52085449	52285449	harbor2	chr3	52167646	52167966	LTR/ERV1	4666	+	160	52167806	82357
chr3	52085449	52285449	harbor2	chr3	52168268	52168370	LTR/ERV1	4666	+	51	52168319	82870
chr3	52085449	52285449	harbor2	chr3	52168668	52169005	LTR/ERV1	4666	+	168	52168836	83387
chr3	52085449	52285449	harbor2	chr3	52169356	52169660	LTR/ERV1	1836	+	152	52169508	84059
chr3	52085449	52285449	harbor2	chr3	52166635	52166690	LTR/ERV1	10035	+	28	52166663	81214
chr3	184086443	184286443	harbor2	chr3	184110171	184110701	LTR/ERV1	3953	+	265	184110436	23993
chr3	153062933	153262933	harbor2	chr3	153082962	153083400	LTR/ERV1	817	+	219	153083181	20248
chr3	153062933	153262933	harbor2	chr3	153096655	153097372	LTR/ERV1	3628	+	358	153097013	34080
chr3	108053564	108253564	harbor2	chr3	108082189	108082611	LTR/ERV1	786	+	211	108082400	28836
chr3	127270146	127470146	harbor2	chr3	127273843	127275184	LTR/ERV1	4321	+	670	127274513	4367
chr3	127270146	127470146	harbor2	chr3	127275185	127277040	LTR/ERV1	7622	+	928	127276113	5967
chr3	107996441	108196441	harbor2	chr3	108004049	108004862	LTR/ERV1	4649	+	406	108004455	8014
chr3	107996441	108196441	harbor2	chr3	108015103	108015632	LTR/ERV1	886	+	264	108015367	18926
chr3	107996441	108196441	harbor2	chr3	108022756	108023270	LTR/ERV1	3041	+	257	108023013	26572
chr3	107996441	108196441	harbor2	chr3	108082189	108082611	LTR/ERV1	786	+	211	108082400	85959
chr3	107993193	108193193	harbor2	chr3	108004049	108004862	LTR/ERV1	4649	+	406	108004455	11262
chr3	107993193	108193193	harbor2	chr3	108015103	108015632	LTR/ERV1	886	+	264	108015367	22174
chr3	107993193	108193193	harbor2	chr3	108022756	108023270	LTR/ERV1	3041	+	257	108023013	29820
chr3	107993193	108193193	harbor2	chr3	108082189	108082611	LTR/ERV1	786	+	211	108082400	89207
chr3	107996552	108196552	harbor2	chr3	108004049	108004862	LTR/ERV1	4649	+	406	108004455	7903
chr3	107996552	108196552	harbor2	chr3	108015103	108015632	LTR/ERV1	886	+	264	108015367	18815
chr3	107996552	108196552	harbor2	chr3	108022756	108023270	LTR/ERV1	3041	+	257	108023013	26461
chr3	107996552	108196552	harbor2	chr3	108082189	108082611	LTR/ERV1	786	+	211	108082400	85848
chr3	50291763	50491763	harbor2	chr3	50304978	50305233	LTR/ERV1	2395	+	128	50305106	13343
chr3	50291763	50491763	harbor2	chr3	50305833	50306021	LTR/ERV1	2395	+	94	50305927	14164
chr3	50291763	50491763	harbor2	chr3	50306024	50306564	LTR/ERV1	2367	+	270	50306294	14531
chr3	50291763	50491763	harbor2	chr3	50309030	50309182	LTR/ERV1	2292	+	76	50309106	17343
chr3	50291763	50491763	harbor2	chr3	50309485	50309688	LTR/ERV1	2292	+	102	50309587	17824
chr3	50291763	50491763	harbor2	chr3	50309786	50310263	LTR/ERV1	2292	+	238	50310024	18261
chr3	50291763	50491763	harbor2	chr3	50313340	50313494	LTR/ERV1	1704	+	77	50313417	21654
chr3	50291763	50491763	harbor2	chr3	50313797	50314006	LTR/ERV1	1704	+	104	50313901	22138
chr3	50291763	50491763	harbor2	chr3	50314007	50314445	LTR/ERV1	2633	+	219	50314226	22463
chr3	108018365	108218365	harbor2	chr3	108022756	108023270	LTR/ERV1	3041	+	257	108023013	4648
chr3	108018365	108218365	harbor2	chr3	108082189	108082611	LTR/ERV1	786	+	211	108082400	64035
chr3	107992129	108192129	harbor2	chr3	108004049	108004862	LTR/ERV1	4649	+	406	108004455	12326
chr3	107992129	108192129	harbor2	chr3	108015103	108015632	LTR/ERV1	886	+	264	108015367	23238
chr3	107992129	108192129	harbor2	chr3	108022756	108023270	LTR/ERV1	3041	+	257	108023013	30884
chr3	107992129	108192129	harbor2	chr3	108082189	108082611	LTR/ERV1	786	+	211	108082400	90271
chr3	107993138	108193138	harbor2	chr3	108004049	108004862	LTR/ERV1	4649	+	406	108004455	11317
chr3	107993138	108193138	harbor2	chr3	108015103	108015632	LTR/ERV1	886	+	264	108015367	22229
chr3	107993138	108193138	harbor2	chr3	108022756	108023270	LTR/ERV1	3041	+	257	108023013	29875
chr3	107993138	108193138	harbor2	chr3	108082189	108082611	LTR/ERV1	786	+	211	108082400	89262
chr3	129022332	129222332	harbor2	chr3	129058382	129058924	LTR/ERV1	1794	+	271	129058653	36321
chr3	129022332	129222332	harbor2	chr3	129069292	129069886	LTR/ERV1	3375	+	297	129069589	47257
chr3	196218304	196418304	harbor2	chr3	196302750	196303416	LTR/ERV1	5155	+	333	196303083	84779
chr3	53155971	53355971	harbor2	chr3	53201152	53201529	LTR/ERV1	2488	+	188	53201340	45369
chr3	53155971	53355971	harbor2	chr3	53201828	53201929	LTR/ERV1	2488	+	50	53201878	45907
chr3	53155971	53355971	harbor2	chr3	53215304	53215369	LTR/ERV1	402	+	32	53215336	59365
chr3	53155971	53355971	harbor2	chr3	53215674	53215706	LTR/ERV1	402	+	16	53215690	59719
chr3	51939700	52139700	harbor2	chr3	51990374	51991626	LTR/ERV1	8156	+	626	51991000	51300
chr3	123552608	123752608	harbor2	chr3	123587994	123588459	LTR/ERV1	2238	+	232	123588226	35618
chr3	123552608	123752608	harbor2	chr3	123588746	123588910	LTR/ERV1	1952	+	82	123588828	36220
chr3	50517037	50717037	harbor2	chr3	50538693	50539032	LTR/ERV1	1048	+	170	50538863	21826
chr3	51939851	52139851	harbor2	chr3	51990374	51991626	LTR/ERV1	8156	+	626	51991000	51149
chr3	51939435	52139435	harbor2	chr3	51990374	51991626	LTR/ERV1	8156	+	626	51991000	51565
chr3	107992955	108192955	harbor2	chr3	108004049	108004862	LTR/ERV1	4649	+	406	108004455	11500
chr3	107992955	108192955	harbor2	chr3	108015103	108015632	LTR/ERV1	886	+	264	108015367	22412
chr3	107992955	108192955	harbor2	chr3	108022756	108023270	LTR/ERV1	3041	+	257	108023013	30058
chr3	107992955	108192955	harbor2	chr3	108082189	108082611	LTR/ERV1	786	+	211	108082400	89445
chr3	108004632	108204632	harbor2	chr3	108004049	108004862	LTR/ERV1	4649	+	406	108004455	177
chr3	108004632	108204632	harbor2	chr3	108015103	108015632	LTR/ERV1	886	+	264	108015367	10735
chr3	108004632	108204632	harbor2	chr3	108022756	108023270	LTR/ERV1	3041	+	257	108023013	18381
chr3	108004632	108204632	harbor2	chr3	108082189	108082611	LTR/ERV1	786	+	211	108082400	77768
chr3	107992065	108192065	harbor2	chr3	108004049	108004862	LTR/ERV1	4649	+	406	108004455	12390
chr3	107992065	108192065	harbor2	chr3	108015103	108015632	LTR/ERV1	886	+	264	108015367	23302
chr3	107992065	108192065	harbor2	chr3	108022756	108023270	LTR/ERV1	3041	+	257	108023013	30948
chr3	107992065	108192065	harbor2	chr3	108082189	108082611	LTR/ERV1	786	+	211	108082400	90335
chr3	123560147	123760147	harbor2	chr3	123587994	123588459	LTR/ERV1	2238	+	232	123588226	28079
chr3	123560147	123760147	harbor2	chr3	123588746	123588910	LTR/ERV1	1952	+	82	123588828	28681
chr3	197860219	198060219	harbor2	chr3	197935463	197935501	LTR/ERV1	1174	+	19	197935482	75263
chr3	197860219	198060219	harbor2	chr3	197935775	197935962	LTR/ERV1	1174	+	94	197935869	75650
chr3	197860219	198060219	harbor2	chr3	197935092	197935158	LTR/ERV1	1174	+	33	197935125	74906
chr3	189960849	190160849	harbor2	chr3	190026252	190026776	LTR/ERV1	3721	+	262	190026514	65665
chr3	107992067	108192067	harbor2	chr3	108004049	108004862	LTR/ERV1	4649	+	406	108004455	12388
chr3	107992067	108192067	harbor2	chr3	108015103	108015632	LTR/ERV1	886	+	264	108015367	23300
chr3	107992067	108192067	harbor2	chr3	108022756	108023270	LTR/ERV1	3041	+	257	108023013	30946
chr3	107992067	108192067	harbor2	chr3	108082189	108082611	LTR/ERV1	786	+	211	108082400	90333
chr3	157028447	157228447	harbor2	chr3	157119434	157119870	LTR/ERV1	2238	+	218	157119652	91205
chr3	157028447	157228447	harbor2	chr3	157126868	157127294	LTR/ERV1	482	+	213	157127081	98634
chr3	142864715	143064715	harbor2	chr3	142866707	142867333	LTR/ERV1	3026	+	313	142867020	2305
chr3	142864715	143064715	harbor2	chr3	142868276	142868389	LTR/ERV1	926	+	56	142868332	3617
chr3	142864715	143064715	harbor2	chr3	142868926	142869009	LTR/ERV1	5175	+	42	142868968	4253
chr3	142864715	143064715	harbor2	chr3	142869312	142869978	LTR/ERV1	5175	+	333	142869645	4930
chr3	142864715	143064715	harbor2	chr3	142906036	142906726	LTR/ERV1	4318	+	345	142906381	41666
chr3	142864715	143064715	harbor2	chr3	142868390	142868924	LTR/ERV1	3571	+	267	142868657	3942
chr3	198091436	198291436	harbor2	chr3	198097082	198097453	LTR/ERV1	2155	+	186	198097268	5832
chr3	198091436	198291436	harbor2	chr3	198117357	198117439	LTR/ERV1	405	+	41	198117398	25962
chr3	198091436	198291436	harbor2	chr3	198118453	198119647	LTR/ERV1	1951	+	597	198119050	27614
chr3	198091436	198291436	harbor2	chr3	198150272	198150864	LTR/ERV1	4666	+	296	198150568	59132
chr3	198091436	198291436	harbor2	chr3	198161522	198161708	LTR/ERV1	643	+	93	198161615	70179
chr3	198091436	198291436	harbor2	chr3	198171135	198171639	LTR/ERV1	912	+	252	198171387	79951
chr3	107993135	108193135	harbor2	chr3	108004049	108004862	LTR/ERV1	4649	+	406	108004455	11320
chr3	107993135	108193135	harbor2	chr3	108015103	108015632	LTR/ERV1	886	+	264	108015367	22232
chr3	107993135	108193135	harbor2	chr3	108022756	108023270	LTR/ERV1	3041	+	257	108023013	29878
chr3	107993135	108193135	harbor2	chr3	108082189	108082611	LTR/ERV1	786	+	211	108082400	89265
chr3	116673098	116873098	harbor2	chr3	116678412	116679197	LTR/ERV1	4291	+	392	116678804	5706
chr3	51939445	52139445	harbor2	chr3	51990374	51991626	LTR/ERV1	8156	+	626	51991000	51555
chr3	127490762	127690762	harbor2	chr3	127496043	127497557	LTR/ERV1	7331	+	757	127496800	6038
chr3	127490762	127690762	harbor2	chr3	127512675	127513142	LTR/ERV1	2544	+	234	127512909	22147
chr3	127490762	127690762	harbor2	chr3	127543041	127543380	LTR/ERV1	1454	+	170	127543211	52449
chr3	196218330	196418330	harbor2	chr3	196302750	196303416	LTR/ERV1	5155	+	333	196303083	84753
chr3	161006321	161206321	harbor2	chr3	161007941	161008587	LTR/ERV1	3563	+	323	161008264	1943
chr3	161006321	161206321	harbor2	chr3	161038753	161039299	LTR/ERV1	4103	+	273	161039026	32705
chr3	161006321	161206321	harbor2	chr3	161040678	161041467	LTR/ERV1	5420	+	394	161041072	34751
chr3	197860204	198060204	harbor2	chr3	197935463	197935501	LTR/ERV1	1174	+	19	197935482	75278
chr3	197860204	198060204	harbor2	chr3	197935775	197935962	LTR/ERV1	1174	+	94	197935869	75665
chr3	197860204	198060204	harbor2	chr3	197935092	197935158	LTR/ERV1	1174	+	33	197935125	74921
chr3	107992061	108192061	harbor2	chr3	108004049	108004862	LTR/ERV1	4649	+	406	108004455	12394
chr3	107992061	108192061	harbor2	chr3	108015103	108015632	LTR/ERV1	886	+	264	108015367	23306
chr3	107992061	108192061	harbor2	chr3	108022756	108023270	LTR/ERV1	3041	+	257	108023013	30952
chr3	107992061	108192061	harbor2	chr3	108082189	108082611	LTR/ERV1	786	+	211	108082400	90339
chr3	36670495	36870495	harbor2	chr3	36674759	36675238	LTR/ERV1	4058	+	240	36674999	4504
chr3	36670495	36870495	harbor2	chr3	36691443	36691773	LTR/ERV1	713	+	165	36691608	21113
chr3	51860342	52060342	harbor2	chr3	51861263	51861329	LTR/ERV1	472	+	33	51861296	954
chr3	51860342	52060342	harbor2	chr3	51861326	51861493	LTR/ERV1	1134	+	84	51861410	1068
chr3	51860342	52060342	harbor2	chr3	51864904	51865584	LTR/ERV1	7859	+	340	51865244	4902
chr3	51860342	52060342	harbor2	chr3	51865891	51866180	LTR/ERV1	7859	+	144	51866035	5693
chr3	51860342	52060342	harbor2	chr3	51866487	51867174	LTR/ERV1	7859	+	344	51866831	6489
chr3	51860342	52060342	harbor2	chr3	51867218	51868205	LTR/ERV1	7859	+	494	51867712	7370
chr3	51860342	52060342	harbor2	chr3	51895799	51896547	LTR/ERV1	5044	+	374	51896173	35831
chr3	51860342	52060342	harbor2	chr3	51896962	51897435	LTR/ERV1	3272	+	236	51897198	36856
chr3	51860342	52060342	harbor2	chr3	51897436	51897751	LTR/ERV1	2032	+	158	51897594	37252
chr3	51860342	52060342	harbor2	chr3	51897992	51902373	LTR/ERV1	32537	+	2190	51900182	39840
chr3	51860342	52060342	harbor2	chr3	51902374	51902910	LTR/ERV1	3686	+	268	51902642	42300
chr3	51860342	52060342	harbor2	chr3	51915783	51916377	LTR/ERV1	3569	+	297	51916080	55738
chr3	108026049	108226049	harbor2	chr3	108082189	108082611	LTR/ERV1	786	+	211	108082400	56351
chr3	107992090	108192090	harbor2	chr3	108004049	108004862	LTR/ERV1	4649	+	406	108004455	12365
chr3	107992090	108192090	harbor2	chr3	108015103	108015632	LTR/ERV1	886	+	264	108015367	23277
chr3	107992090	108192090	harbor2	chr3	108022756	108023270	LTR/ERV1	3041	+	257	108023013	30923
chr3	107992090	108192090	harbor2	chr3	108082189	108082611	LTR/ERV1	786	+	211	108082400	90310
chr3	108053563	108253563	harbor2	chr3	108082189	108082611	LTR/ERV1	786	+	211	108082400	28837
chr3	123544944	123744944	harbor2	chr3	123587994	123588459	LTR/ERV1	2238	+	232	123588226	43282
chr3	123544944	123744944	harbor2	chr3	123588746	123588910	LTR/ERV1	1952	+	82	123588828	43884
chr3	108053682	108253682	harbor2	chr3	108082189	108082611	LTR/ERV1	786	+	211	108082400	28718
chr3	107993195	108193195	harbor2	chr3	108004049	108004862	LTR/ERV1	4649	+	406	108004455	11260
chr3	107993195	108193195	harbor2	chr3	108015103	108015632	LTR/ERV1	886	+	264	108015367	22172
chr3	107993195	108193195	harbor2	chr3	108022756	108023270	LTR/ERV1	3041	+	257	108023013	29818
chr3	107993195	108193195	harbor2	chr3	108082189	108082611	LTR/ERV1	786	+	211	108082400	89205
chr3	138339763	138539763	harbor2	chr3	138419680	138420399	LTR/ERV1	4621	+	360	138420040	80277
chr3	138339763	138539763	harbor2	chr3	138423381	138423696	LTR/ERV1	2512	+	158	138423539	83776
chr3	138339763	138539763	harbor2	chr3	138424025	138424169	LTR/ERV1	2512	+	72	138424097	84334
chr3	51948342	52148342	harbor2	chr3	51990374	51991626	LTR/ERV1	8156	+	626	51991000	42658
chr3	108000209	108200209	harbor2	chr3	108004049	108004862	LTR/ERV1	4649	+	406	108004455	4246
chr3	108000209	108200209	harbor2	chr3	108015103	108015632	LTR/ERV1	886	+	264	108015367	15158
chr3	108000209	108200209	harbor2	chr3	108022756	108023270	LTR/ERV1	3041	+	257	108023013	22804
chr3	108000209	108200209	harbor2	chr3	108082189	108082611	LTR/ERV1	786	+	211	108082400	82191
chr3	51940436	52140436	harbor2	chr3	51990374	51991626	LTR/ERV1	8156	+	626	51991000	50564
chr3	182693462	182893462	harbor2	chr3	182727882	182728019	LTR/ERV1	863	+	68	182727950	34488
chr3	182693462	182893462	harbor2	chr3	182728332	182728681	LTR/ERV1	976	+	174	182728506	35044
chr3	182693462	182893462	harbor2	chr3	182745404	182745551	LTR/ERV1	674	+	74	182745478	52016
chr3	182693462	182893462	harbor2	chr3	182790470	182790986	LTR/ERV1	1832	+	258	182790728	97266
chr3	142529008	142729008	harbor2	chr3	142568465	142569182	LTR/ERV1	2660	+	358	142568823	39815
chr3	125112713	125312713	harbor2	chr3	125178422	125178849	LTR/ERV1	831	+	214	125178636	65923
chr3	108468945	108668945	harbor2	chr3	108471414	108471815	LTR/ERV1	1925	+	200	108471614	2669
chr3	108468945	108668945	harbor2	chr3	108555258	108556040	LTR/ERV1	3683	+	391	108555649	86704
chr3	108468945	108668945	harbor2	chr3	108564451	108564868	LTR/ERV1	1489	+	208	108564659	95714
chr3	52126019	52326019	harbor2	chr3	52155574	52156144	LTR/ERV1	3629	+	285	52155859	29840
chr3	52126019	52326019	harbor2	chr3	52156148	52156636	LTR/ERV1	7193	+	244	52156392	30373
chr3	52126019	52326019	harbor2	chr3	52156947	52157145	LTR/ERV1	7193	+	99	52157046	31027
chr3	52126019	52326019	harbor2	chr3	52157442	52157893	LTR/ERV1	7193	+	226	52157668	31649
chr3	52126019	52326019	harbor2	chr3	52158207	52158226	LTR/ERV1	7193	+	10	52158217	32198
chr3	52126019	52326019	harbor2	chr3	52159468	52160111	LTR/ERV1	7193	+	322	52159790	33771
chr3	52126019	52326019	harbor2	chr3	52160393	52160484	LTR/ERV1	7193	+	46	52160439	34420
chr3	52126019	52326019	harbor2	chr3	52160792	52161075	LTR/ERV1	7193	+	142	52160934	34915
chr3	52126019	52326019	harbor2	chr3	52161378	52161423	LTR/ERV1	10035	+	22	52161400	35381
chr3	52126019	52326019	harbor2	chr3	52162862	52163142	LTR/ERV1	10035	+	140	52163002	36983
chr3	52126019	52326019	harbor2	chr3	52163446	52163803	LTR/ERV1	10035	+	178	52163624	37605
chr3	52126019	52326019	harbor2	chr3	52164397	52164430	LTR/ERV1	10035	+	16	52164413	38394
chr3	52126019	52326019	harbor2	chr3	52165067	52166322	LTR/ERV1	10035	+	628	52165695	39676
chr3	52126019	52326019	harbor2	chr3	52166714	52167033	LTR/ERV1	1831	+	160	52166874	40855
chr3	52126019	52326019	harbor2	chr3	52167289	52167645	LTR/ERV1	1622	+	178	52167467	41448
chr3	52126019	52326019	harbor2	chr3	52167646	52167966	LTR/ERV1	4666	+	160	52167806	41787
chr3	52126019	52326019	harbor2	chr3	52168268	52168370	LTR/ERV1	4666	+	51	52168319	42300
chr3	52126019	52326019	harbor2	chr3	52168668	52169005	LTR/ERV1	4666	+	168	52168836	42817
chr3	52126019	52326019	harbor2	chr3	52169356	52169660	LTR/ERV1	1836	+	152	52169508	43489
chr3	52126019	52326019	harbor2	chr3	52166635	52166690	LTR/ERV1	10035	+	28	52166663	40644
chr3	184086432	184286432	harbor2	chr3	184110171	184110701	LTR/ERV1	3953	+	265	184110436	24004
chr3	50289500	50489500	harbor2	chr3	50304978	50305233	LTR/ERV1	2395	+	128	50305106	15606
chr3	50289500	50489500	harbor2	chr3	50305833	50306021	LTR/ERV1	2395	+	94	50305927	16427
chr3	50289500	50489500	harbor2	chr3	50306024	50306564	LTR/ERV1	2367	+	270	50306294	16794
chr3	50289500	50489500	harbor2	chr3	50309030	50309182	LTR/ERV1	2292	+	76	50309106	19606
chr3	50289500	50489500	harbor2	chr3	50309485	50309688	LTR/ERV1	2292	+	102	50309587	20087
chr3	50289500	50489500	harbor2	chr3	50309786	50310263	LTR/ERV1	2292	+	238	50310024	20524
chr3	50289500	50489500	harbor2	chr3	50313340	50313494	LTR/ERV1	1704	+	77	50313417	23917
chr3	50289500	50489500	harbor2	chr3	50313797	50314006	LTR/ERV1	1704	+	104	50313901	24401
chr3	50289500	50489500	harbor2	chr3	50314007	50314445	LTR/ERV1	2633	+	219	50314226	24726
chr3	108359237	108559237	harbor2	chr3	108377864	108378321	LTR/ERV1	3710	+	228	108378092	18855
chr3	51939791	52139791	harbor2	chr3	51990374	51991626	LTR/ERV1	8156	+	626	51991000	51209
chr3	50308663	50508663	harbor2	chr3	50309030	50309182	LTR/ERV1	2292	+	76	50309106	443
chr3	50308663	50508663	harbor2	chr3	50309485	50309688	LTR/ERV1	2292	+	102	50309587	924
chr3	50308663	50508663	harbor2	chr3	50309786	50310263	LTR/ERV1	2292	+	238	50310024	1361
chr3	50308663	50508663	harbor2	chr3	50313340	50313494	LTR/ERV1	1704	+	77	50313417	4754
chr3	50308663	50508663	harbor2	chr3	50313797	50314006	LTR/ERV1	1704	+	104	50313901	5238
chr3	50308663	50508663	harbor2	chr3	50314007	50314445	LTR/ERV1	2633	+	219	50314226	5563
chr3	129875421	130075421	harbor2	chr3	129917227	129917682	LTR/ERV1	2117	+	228	129917455	42034
chr3	129875421	130075421	harbor2	chr3	129940158	129940685	LTR/ERV1	2831	+	264	129940422	65001
chr3	182693567	182893567	harbor2	chr3	182727882	182728019	LTR/ERV1	863	+	68	182727950	34383
chr3	182693567	182893567	harbor2	chr3	182728332	182728681	LTR/ERV1	976	+	174	182728506	34939
chr3	182693567	182893567	harbor2	chr3	182745404	182745551	LTR/ERV1	674	+	74	182745478	51911
chr3	182693567	182893567	harbor2	chr3	182790470	182790986	LTR/ERV1	1832	+	258	182790728	97161
chr3	50290968	50490968	harbor2	chr3	50304978	50305233	LTR/ERV1	2395	+	128	50305106	14138
chr3	50290968	50490968	harbor2	chr3	50305833	50306021	LTR/ERV1	2395	+	94	50305927	14959
chr3	50290968	50490968	harbor2	chr3	50306024	50306564	LTR/ERV1	2367	+	270	50306294	15326
chr3	50290968	50490968	harbor2	chr3	50309030	50309182	LTR/ERV1	2292	+	76	50309106	18138
chr3	50290968	50490968	harbor2	chr3	50309485	50309688	LTR/ERV1	2292	+	102	50309587	18619
chr3	50290968	50490968	harbor2	chr3	50309786	50310263	LTR/ERV1	2292	+	238	50310024	19056
chr3	50290968	50490968	harbor2	chr3	50313340	50313494	LTR/ERV1	1704	+	77	50313417	22449
chr3	50290968	50490968	harbor2	chr3	50313797	50314006	LTR/ERV1	1704	+	104	50313901	22933
chr3	50290968	50490968	harbor2	chr3	50314007	50314445	LTR/ERV1	2633	+	219	50314226	23258
chr3	51940440	52140440	harbor2	chr3	51990374	51991626	LTR/ERV1	8156	+	626	51991000	50560
chr3	127490198	127690198	harbor2	chr3	127496043	127497557	LTR/ERV1	7331	+	757	127496800	6602
chr3	127490198	127690198	harbor2	chr3	127512675	127513142	LTR/ERV1	2544	+	234	127512909	22711
chr3	127490198	127690198	harbor2	chr3	127543041	127543380	LTR/ERV1	1454	+	170	127543211	53013
chr3	123518827	123718827	harbor2	chr3	123587994	123588459	LTR/ERV1	2238	+	232	123588226	69399
chr3	123518827	123718827	harbor2	chr3	123588746	123588910	LTR/ERV1	1952	+	82	123588828	70001
chr3	196218333	196418333	harbor2	chr3	196302750	196303416	LTR/ERV1	5155	+	333	196303083	84750
chr3	50288119	50488119	harbor2	chr3	50304978	50305233	LTR/ERV1	2395	+	128	50305106	16987
chr3	50288119	50488119	harbor2	chr3	50305833	50306021	LTR/ERV1	2395	+	94	50305927	17808
chr3	50288119	50488119	harbor2	chr3	50306024	50306564	LTR/ERV1	2367	+	270	50306294	18175
chr3	50288119	50488119	harbor2	chr3	50309030	50309182	LTR/ERV1	2292	+	76	50309106	20987
chr3	50288119	50488119	harbor2	chr3	50309485	50309688	LTR/ERV1	2292	+	102	50309587	21468
chr3	50288119	50488119	harbor2	chr3	50309786	50310263	LTR/ERV1	2292	+	238	50310024	21905
chr3	50288119	50488119	harbor2	chr3	50313340	50313494	LTR/ERV1	1704	+	77	50313417	25298
chr3	50288119	50488119	harbor2	chr3	50313797	50314006	LTR/ERV1	1704	+	104	50313901	25782
chr3	50288119	50488119	harbor2	chr3	50314007	50314445	LTR/ERV1	2633	+	219	50314226	26107
chr3	108053525	108253525	harbor2	chr3	108082189	108082611	LTR/ERV1	786	+	211	108082400	28875
chr3	195800094	196000094	harbor2	chr3	195802815	195802975	LTR/ERV1	691	+	80	195802895	2801
chr3	195800094	196000094	harbor2	chr3	195803005	195803410	LTR/ERV1	1059	+	202	195803207	3113
chr4	832453	1032453	harbor2	chr4	904804	905349	LTR/ERV1	2491	+	272	905076	72623
chr4	39082469	39282469	harbor2	chr4	39126711	39127033	LTR/ERV1	2018	+	161	39126872	44403
chr4	39082469	39282469	harbor2	chr4	39181116	39181611	LTR/ERV1	3577	+	248	39181364	98895
chr4	98161348	98361348	harbor2	chr4	98161597	98163015	LTR/ERV1	26999	+	709	98162306	958
chr4	98161348	98361348	harbor2	chr4	98163314	98163969	LTR/ERV1	17869	+	328	98163642	2294
chr4	98161348	98361348	harbor2	chr4	98163970	98164542	LTR/ERV1	3977	+	286	98164256	2908
chr4	98161348	98361348	harbor2	chr4	98171875	98171922	LTR/ERV1	1248	+	24	98171899	10551
chr4	98161348	98361348	harbor2	chr4	98172227	98172470	LTR/ERV1	1248	+	122	98172349	11001
chr4	98161348	98361348	harbor2	chr4	98194371	98194733	LTR/ERV1	1719	+	181	98194552	33204
chr4	98161348	98361348	harbor2	chr4	98194734	98195394	LTR/ERV1	3665	+	330	98195064	33716
chr4	98161348	98361348	harbor2	chr4	98201281	98201827	LTR/ERV1	2823	+	273	98201554	40206
chr4	98161348	98361348	harbor2	chr4	98202341	98202841	LTR/ERV1	3680	+	250	98202591	41243
chr4	3569998	3769998	harbor2	chr4	3596995	3597149	LTR/ERV1	454	+	77	3597072	27074
chr4	3569998	3769998	harbor2	chr4	3617743	3618052	LTR/ERV1	1465	+	154	3617897	47899
chr4	3569998	3769998	harbor2	chr4	3628763	3629341	LTR/ERV1	2571	+	289	3629052	59054
chr4	3569998	3769998	harbor2	chr4	3656038	3656447	LTR/ERV1	1196	+	204	3656242	86244
chr4	38573365	38773365	harbor2	chr4	38626722	38628102	LTR/ERV1	9687	+	690	38627412	54047
chr4	38573365	38773365	harbor2	chr4	38648985	38649447	LTR/ERV1	4862	+	231	38649216	75851
chr4	38573365	38773365	harbor2	chr4	38650329	38650428	LTR/ERV1	4862	+	50	38650379	77014
chr4	38573365	38773365	harbor2	chr4	38649747	38650024	LTR/ERV1	4862	+	138	38649885	76520
chr4	55295797	55495797	harbor2	chr4	55296671	55296758	LTR/ERV1	606	+	44	55296715	918
chr4	55295797	55495797	harbor2	chr4	55296759	55297157	LTR/ERV1	2525	+	199	55296958	1161
chr4	55295797	55495797	harbor2	chr4	55303433	55303538	LTR/ERV1	601	+	52	55303485	7688
chr4	55295797	55495797	harbor2	chr4	55330288	55330872	LTR/ERV1	3669	+	292	55330580	34783
chr4	55295797	55495797	harbor2	chr4	55338515	55339073	LTR/ERV1	3052	+	279	55338794	42997
chr4	55295797	55495797	harbor2	chr4	55339098	55339375	LTR/ERV1	1361	+	138	55339236	43439
chr4	55295797	55495797	harbor2	chr4	55339951	55341621	LTR/ERV1	5999	+	835	55340786	44989
chr4	55295797	55495797	harbor2	chr4	55341631	55342450	LTR/ERV1	4035	+	410	55342041	46244
chr4	55295797	55495797	harbor2	chr4	55342592	55342916	LTR/ERV1	1159	+	162	55342754	46957
chr4	55295797	55495797	harbor2	chr4	55343154	55343398	LTR/ERV1	1270	+	122	55343276	47479
chr4	55295797	55495797	harbor2	chr4	55353172	55353951	LTR/ERV1	5943	+	390	55353562	57765
chr4	55295797	55495797	harbor2	chr4	55386892	55387472	LTR/ERV1	3725	+	290	55387182	91385
chr4	55295797	55495797	harbor2	chr4	55393983	55394368	LTR/ERV1	2142	+	192	55394175	98378
chr4	89737944	89937944	harbor2	chr4	89750407	89750577	LTR/ERV1	477	+	85	89750492	12548
chr4	89737944	89937944	harbor2	chr4	89750739	89750995	LTR/ERV1	688	+	128	89750867	12923
chr4	911518	1111518	harbor2	chr4	983209	983747	LTR/ERV1	1576	+	269	983478	71960
chr4	189959153	190159153	harbor2	chr4	189995620	189995755	LTR/ERV1	718	+	68	189995688	36535
chr4	189959153	190159153	harbor2	chr4	190009563	190010438	LTR/ERV1	6264	+	438	190010001	50848
chr4	189959153	190159153	harbor2	chr4	190010726	190010955	LTR/ERV1	6264	+	114	190010840	51687
chr4	189959153	190159153	harbor2	chr4	190010983	190011526	LTR/ERV1	3366	+	272	190011255	52102
chr4	189959153	190159153	harbor2	chr4	190051558	190051896	LTR/ERV1	2679	+	169	190051727	92574
chr4	8058806	8258806	harbor2	chr4	8058663	8059114	LTR/ERV1	938	+	226	8058889	83
chr4	8058806	8258806	harbor2	chr4	8059207	8059618	LTR/ERV1	2074	+	206	8059413	607
chr4	8058806	8258806	harbor2	chr4	8059938	8060134	LTR/ERV1	2074	+	98	8060036	1230
chr4	8058806	8258806	harbor2	chr4	8063748	8064254	LTR/ERV1	3376	+	253	8064001	5195
chr4	8058806	8258806	harbor2	chr4	8092323	8092454	LTR/ERV1	773	+	66	8092389	33583
chr4	8058806	8258806	harbor2	chr4	8092487	8092820	LTR/ERV1	1150	+	166	8092653	33847
chr4	8058806	8258806	harbor2	chr4	8108365	8108848	LTR/ERV1	1344	+	242	8108607	49801
chr4	122858241	123058241	harbor2	chr4	122906625	122907125	LTR/ERV1	4262	+	250	122906875	48634
chr4	122858241	123058241	harbor2	chr4	122907435	122907445	LTR/ERV1	4262	+	5	122907440	49199
chr4	122858241	123058241	harbor2	chr4	122907749	122907863	LTR/ERV1	4262	+	57	122907806	49565
chr4	122858241	123058241	harbor2	chr4	122908044	122908318	LTR/ERV1	1651	+	137	122908181	49940
chr4	122858241	123058241	harbor2	chr4	122908357	122908727	LTR/ERV1	1400	+	185	122908542	50301
chr4	911393	1111393	harbor2	chr4	983209	983747	LTR/ERV1	1576	+	269	983478	72085
chr4	145413737	145613737	harbor2	chr4	145421421	145421646	LTR/ERV1	650	+	112	145421533	7796
chr4	145413737	145613737	harbor2	chr4	145421640	145421907	LTR/ERV1	651	+	134	145421774	8037
chr4	145413737	145613737	harbor2	chr4	145478148	145478515	LTR/ERV1	2245	+	184	145478332	64595
chr4	6251701	6451701	harbor2	chr4	6311245	6311794	LTR/ERV1	4479	+	274	6311519	59818
chr4	6251701	6451701	harbor2	chr4	6312994	6313567	LTR/ERV1	3288	+	286	6313280	61579
chr4	6251701	6451701	harbor2	chr4	6313854	6314052	LTR/ERV1	3288	+	99	6313953	62252
chr4	6251701	6451701	harbor2	chr4	6314537	6314777	LTR/ERV1	2491	+	120	6314657	62956
chr4	6251701	6451701	harbor2	chr4	6315089	6315415	LTR/ERV1	2491	+	163	6315252	63551
chr4	2151563	2351563	harbor2	chr4	2161088	2162515	LTR/ERV1	10450	+	714	2161802	10239
chr4	2151563	2351563	harbor2	chr4	2172124	2172590	LTR/ERV1	2801	+	233	2172357	20794
chr4	2151563	2351563	harbor2	chr4	2221319	2221579	LTR/ERV1	2344	+	130	2221449	69886
chr4	2151563	2351563	harbor2	chr4	2221875	2222113	LTR/ERV1	2344	+	119	2221994	70431
chr4	17477327	17677327	harbor2	chr4	17494205	17494612	LTR/ERV1	2633	+	204	17494409	17082
chr4	17477327	17677327	harbor2	chr4	17572863	17573080	LTR/ERV1	1260	+	108	17572971	95644
chr4	17477327	17677327	harbor2	chr4	17573323	17573702	LTR/ERV1	1349	+	190	17573513	96186
chr4	17477327	17677327	harbor2	chr4	17573732	17573760	LTR/ERV1	1349	+	14	17573746	96419
chr4	17477327	17677327	harbor2	chr4	17574051	17574151	LTR/ERV1	1349	+	50	17574101	96774
chr4	17477327	17677327	harbor2	chr4	17575708	17576240	LTR/ERV1	3526	+	266	17575974	98647
chr4	144468740	144668740	harbor2	chr4	144534233	144534868	LTR/ERV1	3476	+	318	144534551	65811
chr4	1215637	1415637	harbor2	chr4	1264489	1264611	LTR/ERV1	1059	+	61	1264550	48913
chr4	1215637	1415637	harbor2	chr4	1264908	1265184	LTR/ERV1	1059	+	138	1265046	49409
chr4	1215637	1415637	harbor2	chr4	1265291	1265318	LTR/ERV1	1059	+	14	1265305	49668
chr4	1215637	1415637	harbor2	chr4	1285715	1285834	LTR/ERV1	4258	+	60	1285775	70138
chr4	1215637	1415637	harbor2	chr4	1287215	1287575	LTR/ERV1	4258	+	180	1287395	71758
chr4	1215637	1415637	harbor2	chr4	1287878	1288323	LTR/ERV1	4258	+	222	1288100	72463
chr4	120879554	121079554	harbor2	chr4	120953268	120954076	LTR/ERV1	4920	+	404	120953672	74118
chr4	120879554	121079554	harbor2	chr4	120961761	120962177	LTR/ERV1	2732	+	208	120961969	82415
chr4	7839706	8039706	harbor2	chr4	7924641	7925164	LTR/ERV1	1633	+	262	7924903	85197
chr4	2701308	2901308	harbor2	chr4	2725486	2725713	LTR/ERV1	649	+	114	2725600	24292
chr4	2701308	2901308	harbor2	chr4	2726339	2726406	LTR/ERV1	649	+	34	2726373	25065
chr4	2701308	2901308	harbor2	chr4	2728490	2728616	LTR/ERV1	495	+	63	2728553	27245
chr4	2701308	2901308	harbor2	chr4	2728985	2729680	LTR/ERV1	4094	+	348	2729333	28025
chr4	2701308	2901308	harbor2	chr4	2763383	2763549	LTR/ERV1	1178	+	83	2763466	62158
chr4	2701308	2901308	harbor2	chr4	2774818	2775007	LTR/ERV1	2360	+	94	2774912	73604
chr4	2701308	2901308	harbor2	chr4	2775310	2775719	LTR/ERV1	2360	+	204	2775514	74206
chr4	2701308	2901308	harbor2	chr4	2785518	2785948	LTR/ERV1	2212	+	215	2785733	84425
chr4	2701308	2901308	harbor2	chr4	2785159	2785510	LTR/ERV1	888	+	176	2785335	84027
chr4	871018	1071018	harbor2	chr4	904804	905349	LTR/ERV1	2491	+	272	905076	34058
chr4	911525	1111525	harbor2	chr4	983209	983747	LTR/ERV1	1576	+	269	983478	71953
chr4	911521	1111521	harbor2	chr4	983209	983747	LTR/ERV1	1576	+	269	983478	71957
chr4	86792393	86992393	harbor2	chr4	86882351	86883009	LTR/ERV1	4146	+	329	86882680	90287
chr4	867539	1067539	harbor2	chr4	904804	905349	LTR/ERV1	2491	+	272	905076	37537
chr4	911387	1111387	harbor2	chr4	983209	983747	LTR/ERV1	1576	+	269	983478	72091
chr4	1482489	1682489	harbor2	chr4	1510910	1511338	LTR/ERV1	1350	+	214	1511124	28635
chr4	867048	1067048	harbor2	chr4	904804	905349	LTR/ERV1	2491	+	272	905076	38028
chr4	76849477	77049477	harbor2	chr4	76859538	76860108	LTR/ERV1	3776	+	285	76859823	10346
chr4	189959360	190159360	harbor2	chr4	189995620	189995755	LTR/ERV1	718	+	68	189995688	36328
chr4	189959360	190159360	harbor2	chr4	190009563	190010438	LTR/ERV1	6264	+	438	190010001	50641
chr4	189959360	190159360	harbor2	chr4	190010726	190010955	LTR/ERV1	6264	+	114	190010840	51480
chr4	189959360	190159360	harbor2	chr4	190010983	190011526	LTR/ERV1	3366	+	272	190011255	51895
chr4	189959360	190159360	harbor2	chr4	190051558	190051896	LTR/ERV1	2679	+	169	190051727	92367
chr4	55296360	55496360	harbor2	chr4	55296671	55296758	LTR/ERV1	606	+	44	55296715	355
chr4	55296360	55496360	harbor2	chr4	55296759	55297157	LTR/ERV1	2525	+	199	55296958	598
chr4	55296360	55496360	harbor2	chr4	55303433	55303538	LTR/ERV1	601	+	52	55303485	7125
chr4	55296360	55496360	harbor2	chr4	55330288	55330872	LTR/ERV1	3669	+	292	55330580	34220
chr4	55296360	55496360	harbor2	chr4	55338515	55339073	LTR/ERV1	3052	+	279	55338794	42434
chr4	55296360	55496360	harbor2	chr4	55339098	55339375	LTR/ERV1	1361	+	138	55339236	42876
chr4	55296360	55496360	harbor2	chr4	55339951	55341621	LTR/ERV1	5999	+	835	55340786	44426
chr4	55296360	55496360	harbor2	chr4	55341631	55342450	LTR/ERV1	4035	+	410	55342041	45681
chr4	55296360	55496360	harbor2	chr4	55342592	55342916	LTR/ERV1	1159	+	162	55342754	46394
chr4	55296360	55496360	harbor2	chr4	55343154	55343398	LTR/ERV1	1270	+	122	55343276	46916
chr4	55296360	55496360	harbor2	chr4	55353172	55353951	LTR/ERV1	5943	+	390	55353562	57202
chr4	55296360	55496360	harbor2	chr4	55386892	55387472	LTR/ERV1	3725	+	290	55387182	90822
chr4	55296360	55496360	harbor2	chr4	55393983	55394368	LTR/ERV1	2142	+	192	55394175	97815
chr4	189957449	190157449	harbor2	chr4	189995620	189995755	LTR/ERV1	718	+	68	189995688	38239
chr4	189957449	190157449	harbor2	chr4	190009563	190010438	LTR/ERV1	6264	+	438	190010001	52552
chr4	189957449	190157449	harbor2	chr4	190010726	190010955	LTR/ERV1	6264	+	114	190010840	53391
chr4	189957449	190157449	harbor2	chr4	190010983	190011526	LTR/ERV1	3366	+	272	190011255	53806
chr4	189957449	190157449	harbor2	chr4	190051558	190051896	LTR/ERV1	2679	+	169	190051727	94278
chr5	87001616	87201616	harbor2	chr5	87022218	87022913	LTR/ERV1	3955	+	348	87022566	20950
chr5	171287646	171487646	harbor2	chr5	171361288	171361840	LTR/ERV1	4348	+	276	171361564	73918
chr5	171287646	171487646	harbor2	chr5	171369080	171369551	LTR/ERV1	2956	+	236	171369316	81670
chr5	10341874	10541874	harbor2	chr5	10374977	10376523	LTR/ERV1	11125	+	773	10375750	33876
chr5	10341874	10541874	harbor2	chr5	10420548	10421090	LTR/ERV1	2519	+	271	10420819	78945
chr5	150970772	151170772	harbor2	chr5	150970326	150970793	LTR/ERV1	3398	+	234	150970560	212
chr5	150970772	151170772	harbor2	chr5	151019760	151020068	LTR/ERV1	1773	+	154	151019914	49142
chr5	171288490	171488490	harbor2	chr5	171361288	171361840	LTR/ERV1	4348	+	276	171361564	73074
chr5	171288490	171488490	harbor2	chr5	171369080	171369551	LTR/ERV1	2956	+	236	171369316	80826
chr5	10341865	10541865	harbor2	chr5	10374977	10376523	LTR/ERV1	11125	+	773	10375750	33885
chr5	10341865	10541865	harbor2	chr5	10420548	10421090	LTR/ERV1	2519	+	271	10420819	78954
chr5	41804360	42004360	harbor2	chr5	41816553	41816978	LTR/ERV1	2182	+	212	41816765	12405
chr5	41804360	42004360	harbor2	chr5	41874496	41874922	LTR/ERV1	2886	+	213	41874709	70349
chr5	41804360	42004360	harbor2	chr5	41890353	41890677	LTR/ERV1	5150	+	162	41890515	86155
chr5	41804360	42004360	harbor2	chr5	41890975	41891553	LTR/ERV1	5150	+	289	41891264	86904
chr5	112319140	112519140	harbor2	chr5	112323354	112323756	LTR/ERV1	900	+	201	112323555	4415
chr5	112319140	112519140	harbor2	chr5	112333925	112334860	LTR/ERV1	4560	+	468	112334393	15253
chr5	112319140	112519140	harbor2	chr5	112389295	112389802	LTR/ERV1	2610	+	254	112389549	70409
chr5	10341837	10541837	harbor2	chr5	10374977	10376523	LTR/ERV1	11125	+	773	10375750	33913
chr5	10341837	10541837	harbor2	chr5	10420548	10421090	LTR/ERV1	2519	+	271	10420819	78982
chr5	134425024	134625024	harbor2	chr5	134424922	134425365	LTR/ERV1	1276	+	222	134425144	120
chr5	134425024	134625024	harbor2	chr5	134477574	134477987	LTR/ERV1	2237	+	206	134477780	52756
chr5	134425024	134625024	harbor2	chr5	134478468	134478571	LTR/ERV1	699	+	52	134478520	53496
chr5	6533324	6733324	harbor2	chr5	6533558	6534031	LTR/ERV1	2901	+	236	6533794	470
chr5	6533324	6733324	harbor2	chr5	6574997	6575253	LTR/ERV1	572	+	128	6575125	41801
chr5	6533324	6733324	harbor2	chr5	6594011	6594896	LTR/ERV1	4766	+	442	6594453	61129
chr5	171287662	171487662	harbor2	chr5	171361288	171361840	LTR/ERV1	4348	+	276	171361564	73902
chr5	171287662	171487662	harbor2	chr5	171369080	171369551	LTR/ERV1	2956	+	236	171369316	81654
chr5	10348809	10548809	harbor2	chr5	10374977	10376523	LTR/ERV1	11125	+	773	10375750	26941
chr5	10348809	10548809	harbor2	chr5	10420548	10421090	LTR/ERV1	2519	+	271	10420819	72010
chr5	76930492	77130492	harbor2	chr5	77015219	77015679	LTR/ERV1	2232	+	230	77015449	84957
chr5	76930492	77130492	harbor2	chr5	77029653	77030099	LTR/ERV1	2873	+	223	77029876	99384
chr5	176018013	176218013	harbor2	chr5	176088499	176088611	LTR/ERV1	515	+	56	176088555	70542
chr5	14760188	14960188	harbor2	chr5	14761483	14761763	LTR/ERV1	719	+	140	14761623	1435
chr5	14760188	14960188	harbor2	chr5	14762065	14762193	LTR/ERV1	719	+	64	14762129	1941
chr5	14760188	14960188	harbor2	chr5	14812518	14812747	LTR/ERV1	964	+	114	14812632	52444
chr5	14760188	14960188	harbor2	chr5	14812733	14812801	LTR/ERV1	430	+	34	14812767	52579
chr5	14760188	14960188	harbor2	chr5	14848136	14848861	LTR/ERV1	4971	+	362	14848498	88310
chr5	42530223	42730223	harbor2	chr5	42581660	42583145	LTR/ERV1	3444	+	742	42582402	52179
chr5	178021742	178221742	harbor2	chr5	178034104	178034243	LTR/ERV1	517	+	70	178034174	12432
chr5	178021742	178221742	harbor2	chr5	178074154	178074890	LTR/ERV1	4367	+	368	178074522	52780
chr5	178021742	178221742	harbor2	chr5	178081973	178082414	LTR/ERV1	2509	+	220	178082193	60451
chr5	178021742	178221742	harbor2	chr5	178101315	178101527	LTR/ERV1	1069	+	106	178101421	79679
chr5	132222297	132422297	harbor2	chr5	132241957	132242301	LTR/ERV1	1028	+	172	132242129	19832
chr5	79137556	79337556	harbor2	chr5	79204717	79205130	LTR/ERV1	1527	+	206	79204923	67367
chr5	79137556	79337556	harbor2	chr5	79214651	79214803	LTR/ERV1	447	+	76	79214727	77171
chr5	79137556	79337556	harbor2	chr5	79216242	79216420	LTR/ERV1	863	+	89	79216331	78775
chr5	79137556	79337556	harbor2	chr5	79222892	79222954	LTR/ERV1	474	+	31	79222923	85367
chr5	10341873	10541873	harbor2	chr5	10374977	10376523	LTR/ERV1	11125	+	773	10375750	33877
chr5	10341873	10541873	harbor2	chr5	10420548	10421090	LTR/ERV1	2519	+	271	10420819	78946
chr5	10341897	10541897	harbor2	chr5	10374977	10376523	LTR/ERV1	11125	+	773	10375750	33853
chr5	10341897	10541897	harbor2	chr5	10420548	10421090	LTR/ERV1	2519	+	271	10420819	78922
chr5	10341909	10541909	harbor2	chr5	10374977	10376523	LTR/ERV1	11125	+	773	10375750	33841
chr5	10341909	10541909	harbor2	chr5	10420548	10421090	LTR/ERV1	2519	+	271	10420819	78910
chr5	12782680	12982680	harbor2	chr5	12790477	12790975	LTR/ERV1	2794	+	249	12790726	8046
chr5	12782680	12982680	harbor2	chr5	12796176	12796866	LTR/ERV1	4008	+	345	12796521	13841
chr5	12782680	12982680	harbor2	chr5	12804765	12805672	LTR/ERV1	4804	+	454	12805219	22539
chr5	12782680	12982680	harbor2	chr5	12853652	12856982	LTR/ERV1	25398	+	1665	12855317	72637
chr5	12782680	12982680	harbor2	chr5	12876566	12877619	LTR/ERV1	5320	+	526	12877092	94412
chr5	6617520	6817520	harbor2	chr5	6675966	6676586	LTR/ERV1	1551	+	310	6676276	58756
chr5	10341893	10541893	harbor2	chr5	10374977	10376523	LTR/ERV1	11125	+	773	10375750	33857
chr5	10341893	10541893	harbor2	chr5	10420548	10421090	LTR/ERV1	2519	+	271	10420819	78926
chr5	6630162	6830162	harbor2	chr5	6675966	6676586	LTR/ERV1	1551	+	310	6676276	46114
chr5	10527792	10727792	harbor2	chr5	10546183	10546307	LTR/ERV1	477	+	62	10546245	18453
chr5	10527792	10727792	harbor2	chr5	10546800	10547100	LTR/ERV1	1070	+	150	10546950	19158
chr5	10401998	10601998	harbor2	chr5	10420548	10421090	LTR/ERV1	2519	+	271	10420819	18821
chr5	37741093	37941093	harbor2	chr5	37777548	37777935	LTR/ERV1	2855	+	194	37777742	36649
chr5	37741093	37941093	harbor2	chr5	37786158	37786956	LTR/ERV1	3943	+	399	37786557	45464
chr5	37741093	37941093	harbor2	chr5	37799892	37800263	LTR/ERV1	1821	+	186	37800078	58985
chr5	147722928	147922928	harbor2	chr5	147724857	147725495	LTR/ERV1	4291	+	319	147725176	2248
chr5	147722928	147922928	harbor2	chr5	147725498	147727329	LTR/ERV1	19757	+	916	147726414	3486
chr5	147722928	147922928	harbor2	chr5	147727673	147729086	LTR/ERV1	19757	+	706	147728379	5451
chr5	147722928	147922928	harbor2	chr5	147730245	147730448	LTR/ERV1	2760	+	102	147730347	7419
chr5	147722928	147922928	harbor2	chr5	147730754	147731036	LTR/ERV1	2760	+	141	147730895	7967
chr5	147722928	147922928	harbor2	chr5	147738854	147739729	LTR/ERV1	559	+	438	147739292	16364
chr5	147722928	147922928	harbor2	chr5	147739774	147740020	LTR/ERV1	694	+	123	147739897	16969
chr5	147722928	147922928	harbor2	chr5	147748389	147749046	LTR/ERV1	4241	+	328	147748717	25789
chr5	147722928	147922928	harbor2	chr5	147755260	147755504	LTR/ERV1	1330	+	122	147755382	32454
chr5	147722928	147922928	harbor2	chr5	147813757	147814243	LTR/ERV1	1060	+	243	147814000	91072
chr5	178133234	178333234	harbor2	chr5	178180544	178180898	LTR/ERV1	1732	+	177	178180721	47487
chr5	178133234	178333234	harbor2	chr5	178182377	178182738	LTR/ERV1	2404	+	180	178182557	49323
chr5	75136870	75336870	harbor2	chr5	75197862	75198368	LTR/ERV1	2533	+	253	75198115	61245
chr5	75136870	75336870	harbor2	chr5	75201632	75202252	LTR/ERV1	3095	+	310	75201942	65072
chr5	75136870	75336870	harbor2	chr5	75208291	75209029	LTR/ERV1	2544	+	369	75208660	71790
chr5	75136870	75336870	harbor2	chr5	75232728	75233047	LTR/ERV1	1544	+	160	75232888	96018
chr5	75136870	75336870	harbor2	chr5	75233363	75233534	LTR/ERV1	1544	+	86	75233449	96579
chr5	91180678	91380678	harbor2	chr5	91185684	91186272	LTR/ERV1	2378	+	294	91185978	5300
chr5	91180678	91380678	harbor2	chr5	91186296	91186526	LTR/ERV1	505	+	115	91186411	5733
chr5	91180678	91380678	harbor2	chr5	91267084	91267149	LTR/ERV1	490	+	32	91267116	86438
chr5	10341849	10541849	harbor2	chr5	10374977	10376523	LTR/ERV1	11125	+	773	10375750	33901
chr5	10341849	10541849	harbor2	chr5	10420548	10421090	LTR/ERV1	2519	+	271	10420819	78970
chr5	134446054	134646054	harbor2	chr5	134477574	134477987	LTR/ERV1	2237	+	206	134477780	31726
chr5	134446054	134646054	harbor2	chr5	134478468	134478571	LTR/ERV1	699	+	52	134478520	32466
chr5	687864	887864	harbor2	chr5	702471	702899	LTR/ERV1	3438	+	214	702685	14821
chr5	687864	887864	harbor2	chr5	706183	706330	LTR/ERV1	715	+	74	706257	18393
chr5	687864	887864	harbor2	chr5	706330	706821	LTR/ERV1	3028	+	246	706576	18712
chr5	687864	887864	harbor2	chr5	706824	707478	LTR/ERV1	3678	+	327	707151	19287
chr5	687864	887864	harbor2	chr5	707480	707696	LTR/ERV1	1313	+	108	707588	19724
chr5	687864	887864	harbor2	chr5	707695	708074	LTR/ERV1	2307	+	190	707885	20021
chr5	687864	887864	harbor2	chr5	708075	708501	LTR/ERV1	3355	+	213	708288	20424
chr5	687864	887864	harbor2	chr5	764205	765906	LTR/ERV1	9101	+	850	765055	77191
chr5	687864	887864	harbor2	chr5	702902	706188	LTR/ERV1	15214	+	1643	704545	16681
chr5	10341903	10541903	harbor2	chr5	10374977	10376523	LTR/ERV1	11125	+	773	10375750	33847
chr5	10341903	10541903	harbor2	chr5	10420548	10421090	LTR/ERV1	2519	+	271	10420819	78916
chr5	10341907	10541907	harbor2	chr5	10374977	10376523	LTR/ERV1	11125	+	773	10375750	33843
chr5	10341907	10541907	harbor2	chr5	10420548	10421090	LTR/ERV1	2519	+	271	10420819	78912
chr5	10341896	10541896	harbor2	chr5	10374977	10376523	LTR/ERV1	11125	+	773	10375750	33854
chr5	10341896	10541896	harbor2	chr5	10420548	10421090	LTR/ERV1	2519	+	271	10420819	78923
chr5	171288520	171488520	harbor2	chr5	171361288	171361840	LTR/ERV1	4348	+	276	171361564	73044
chr5	171288520	171488520	harbor2	chr5	171369080	171369551	LTR/ERV1	2956	+	236	171369316	80796
chr5	134461279	134661279	harbor2	chr5	134477574	134477987	LTR/ERV1	2237	+	206	134477780	16501
chr5	134461279	134661279	harbor2	chr5	134478468	134478571	LTR/ERV1	699	+	52	134478520	17241
chr5	168386830	168586830	harbor2	chr5	168475356	168475871	LTR/ERV1	2024	+	258	168475614	88784
chr5	168386830	168586830	harbor2	chr5	168477060	168477748	LTR/ERV1	3640	+	344	168477404	90574
chr5	168386830	168586830	harbor2	chr5	168481497	168481626	LTR/ERV1	557	+	64	168481561	94731
chr5	168386830	168586830	harbor2	chr5	168481702	168481992	LTR/ERV1	1492	+	145	168481847	95017
chr5	73405863	73605863	harbor2	chr5	73460849	73461513	LTR/ERV1	4971	+	332	73461181	55318
chr5	73405863	73605863	harbor2	chr5	73461615	73462159	LTR/ERV1	2863	+	272	73461887	56024
chr5	73405863	73605863	harbor2	chr5	73486707	73486941	LTR/ERV1	1271	+	117	73486824	80961
chr5	73405863	73605863	harbor2	chr5	73486981	73487460	LTR/ERV1	3107	+	240	73487221	81358
chr5	7883420	8083420	harbor2	chr5	7931413	7932201	LTR/ERV1	4755	+	394	7931807	48387
chr5	7883420	8083420	harbor2	chr5	7975684	7976191	LTR/ERV1	2122	+	254	7975938	92518
chr5	92439	292439	harbor2	chr5	128800	129661	LTR/ERV1	5005	+	430	129230	36791
chr5	10387001	10587001	harbor2	chr5	10420548	10421090	LTR/ERV1	2519	+	271	10420819	33818
chr5	1053127	1253127	harbor2	chr5	1106702	1107319	LTR/ERV1	535	+	308	1107010	53883
chr5	1053127	1253127	harbor2	chr5	1117288	1117790	LTR/ERV1	3929	+	251	1117539	64412
chr5	1053127	1253127	harbor2	chr5	1118094	1118335	LTR/ERV1	3929	+	120	1118214	65087
chr5	1053127	1253127	harbor2	chr5	1131917	1132532	LTR/ERV1	3656	+	308	1132225	79098
chr5	1053127	1253127	harbor2	chr5	1147104	1147378	LTR/ERV1	661	+	137	1147241	94114
chr5	1053127	1253127	harbor2	chr5	1147476	1147730	LTR/ERV1	834	+	127	1147603	94476
chr5	1053127	1253127	harbor2	chr5	1148019	1148189	LTR/ERV1	977	+	85	1148104	94977
chr5	1053127	1253127	harbor2	chr5	1146462	1147032	LTR/ERV1	2637	+	285	1146747	93620
chr5	6613124	6813124	harbor2	chr5	6675966	6676586	LTR/ERV1	1551	+	310	6676276	63152
chr5	132774151	132974151	harbor2	chr5	132808729	132809429	LTR/ERV1	4163	+	350	132809079	34928
chr5	132774151	132974151	harbor2	chr5	132832977	132833578	LTR/ERV1	3269	+	300	132833277	59126
chr5	10762842	10962842	harbor2	chr5	10765364	10765686	LTR/ERV1	1719	+	161	10765525	2683
chr5	10762842	10962842	harbor2	chr5	10792427	10793004	LTR/ERV1	4136	+	288	10792715	29873
chr5	10762842	10962842	harbor2	chr5	10793309	10793399	LTR/ERV1	4136	+	45	10793354	30512
chr5	10762842	10962842	harbor2	chr5	10763877	10764585	LTR/ERV1	4007	+	354	10764231	1389
chr5	133166465	133366465	harbor2	chr5	133238809	133240300	LTR/ERV1	10441	+	746	133239555	73090
chr5	133166465	133366465	harbor2	chr5	133251451	133251772	LTR/ERV1	895	+	160	133251611	85146
chr5	133166465	133366465	harbor2	chr5	133261368	133261575	LTR/ERV1	1149	+	104	133261472	95007
chr5	133166465	133366465	harbor2	chr5	133262011	133262732	LTR/ERV1	4102	+	360	133262371	95906
chr5	37740773	37940773	harbor2	chr5	37777548	37777935	LTR/ERV1	2855	+	194	37777742	36969
chr5	37740773	37940773	harbor2	chr5	37786158	37786956	LTR/ERV1	3943	+	399	37786557	45784
chr5	37740773	37940773	harbor2	chr5	37799892	37800263	LTR/ERV1	1821	+	186	37800078	59305
chr5	100503	300503	harbor2	chr5	128800	129661	LTR/ERV1	5005	+	430	129230	28727
chr5	171288579	171488579	harbor2	chr5	171361288	171361840	LTR/ERV1	4348	+	276	171361564	72985
chr5	171288579	171488579	harbor2	chr5	171369080	171369551	LTR/ERV1	2956	+	236	171369316	80737
chr5	10342482	10542482	harbor2	chr5	10374977	10376523	LTR/ERV1	11125	+	773	10375750	33268
chr5	10342482	10542482	harbor2	chr5	10420548	10421090	LTR/ERV1	2519	+	271	10420819	78337
chr5	50869990	51069990	harbor2	chr5	50879428	50879680	LTR/ERV1	1499	+	126	50879554	9564
chr5	50869990	51069990	harbor2	chr5	50879675	50879983	LTR/ERV1	1813	+	154	50879829	9839
chr5	50869990	51069990	harbor2	chr5	50898089	50898608	LTR/ERV1	1178	+	260	50898349	28359
chr5	50869990	51069990	harbor2	chr5	50954359	50954695	LTR/ERV1	2045	+	168	50954527	84537
chr5	50869990	51069990	harbor2	chr5	50954994	50955267	LTR/ERV1	2045	+	136	50955130	85140
chr5	6533029	6733029	harbor2	chr5	6533558	6534031	LTR/ERV1	2901	+	236	6533794	765
chr5	6533029	6733029	harbor2	chr5	6574997	6575253	LTR/ERV1	572	+	128	6575125	42096
chr5	6533029	6733029	harbor2	chr5	6594011	6594896	LTR/ERV1	4766	+	442	6594453	61424
chr5	53460613	53660613	harbor2	chr5	53474742	53475226	LTR/ERV1	3132	+	242	53474984	14371
chr5	53460613	53660613	harbor2	chr5	53548565	53549027	LTR/ERV1	3472	+	231	53548796	88183
chr6	147104110	147304110	harbor2	chr6	147111195	147111321	LTR/ERV1	463	+	63	147111258	7148
chr6	147104110	147304110	harbor2	chr6	147145376	147145782	LTR/ERV1	1001	+	203	147145579	41469
chr6	147104110	147304110	harbor2	chr6	147166341	147166891	LTR/ERV1	2856	+	275	147166616	62506
chr6	147104110	147304110	harbor2	chr6	147181019	147181514	LTR/ERV1	3020	+	248	147181267	77157
chr6	147104110	147304110	harbor2	chr6	147194694	147194826	LTR/ERV1	3677	+	66	147194760	90650
chr6	147104110	147304110	harbor2	chr6	147193829	147194403	LTR/ERV1	3677	+	287	147194116	90006
chr6	152902804	153102804	harbor2	chr6	152916371	152916597	LTR/ERV1	2523	+	113	152916484	13680
chr6	152902804	153102804	harbor2	chr6	152917550	152918019	LTR/ERV1	2523	+	234	152917784	14980
chr6	152902804	153102804	harbor2	chr6	152918415	152918433	LTR/ERV1	2523	+	9	152918424	15620
chr6	7626958	7826958	harbor2	chr6	7668248	7668579	LTR/ERV1	460	+	166	7668414	41456
chr6	7626958	7826958	harbor2	chr6	7699068	7699141	LTR/ERV1	3769	+	36	7699104	72146
chr6	7626958	7826958	harbor2	chr6	7699446	7699990	LTR/ERV1	3769	+	272	7699718	72760
chr6	7626958	7826958	harbor2	chr6	7710556	7710726	LTR/ERV1	591	+	85	7710641	83683
chr6	125225390	125425390	harbor2	chr6	125298327	125298708	LTR/ERV1	1552	+	190	125298517	73127
chr6	125225390	125425390	harbor2	chr6	125302382	125302445	LTR/ERV1	481	+	32	125302414	77024
chr6	37071463	37271463	harbor2	chr6	37123524	37123722	LTR/ERV1	885	+	99	37123623	52160
chr6	37071463	37271463	harbor2	chr6	37124559	37124828	LTR/ERV1	1660	+	134	37124693	53230
chr6	29530473	29730473	harbor2	chr6	29556588	29556674	LTR/ERV1	5248	+	43	29556631	26158
chr6	29530473	29730473	harbor2	chr6	29556977	29557801	LTR/ERV1	5248	+	412	29557389	26916
chr6	29530473	29730473	harbor2	chr6	29558214	29558989	LTR/ERV1	6267	+	388	29558602	28129
chr6	29530473	29730473	harbor2	chr6	29561984	29562613	LTR/ERV1	4603	+	314	29562298	31825
chr6	29530473	29730473	harbor2	chr6	29591885	29592343	LTR/ERV1	3323	+	229	29592114	61641
chr6	29530473	29730473	harbor2	chr6	29592602	29592682	LTR/ERV1	3323	+	40	29592642	62169
chr6	29530473	29730473	harbor2	chr6	29592974	29593042	LTR/ERV1	3323	+	34	29593008	62535
chr6	29530473	29730473	harbor2	chr6	29593346	29593367	LTR/ERV1	3323	+	10	29593356	62883
chr6	29530473	29730473	harbor2	chr6	29593377	29594044	LTR/ERV1	4107	+	334	29593711	63238
chr6	29530473	29730473	harbor2	chr6	29594068	29594247	LTR/ERV1	851	+	90	29594158	63685
chr6	29530473	29730473	harbor2	chr6	29594921	29595296	LTR/ERV1	697	+	188	29595109	64636
chr6	29530473	29730473	harbor2	chr6	29596036	29596851	LTR/ERV1	4882	+	408	29596444	65971
chr6	29530473	29730473	harbor2	chr6	29598287	29598485	LTR/ERV1	986	+	99	29598386	67913
chr6	10445756	10645756	harbor2	chr6	10449809	10450126	LTR/ERV1	2311	+	158	10449967	4211
chr6	10445756	10645756	harbor2	chr6	10491487	10492779	LTR/ERV1	5062	+	646	10492133	46377
chr6	7626956	7826956	harbor2	chr6	7668248	7668579	LTR/ERV1	460	+	166	7668414	41458
chr6	7626956	7826956	harbor2	chr6	7699068	7699141	LTR/ERV1	3769	+	36	7699104	72148
chr6	7626956	7826956	harbor2	chr6	7699446	7699990	LTR/ERV1	3769	+	272	7699718	72762
chr6	7626956	7826956	harbor2	chr6	7710556	7710726	LTR/ERV1	591	+	85	7710641	83685
chr6	169864631	170064631	harbor2	chr6	169911820	169912564	LTR/ERV1	4306	+	372	169912192	47561
chr6	139275464	139475464	harbor2	chr6	139289070	139289527	LTR/ERV1	3470	+	228	139289298	13834
chr6	139275464	139475464	harbor2	chr6	139312645	139313063	LTR/ERV1	2170	+	209	139312854	37390
chr6	139275464	139475464	harbor2	chr6	139313372	139313464	LTR/ERV1	2170	+	46	139313418	37954
chr6	139275464	139475464	harbor2	chr6	139313782	139314674	LTR/ERV1	5332	+	446	139314228	38764
chr6	139275464	139475464	harbor2	chr6	139314719	139315429	LTR/ERV1	3433	+	355	139315074	39610
chr6	139275464	139475464	harbor2	chr6	139316173	139316659	LTR/ERV1	2928	+	243	139316416	40952
chr6	139275464	139475464	harbor2	chr6	139326277	139326806	LTR/ERV1	2202	+	264	139326541	51077
chr6	139275464	139475464	harbor2	chr6	139327101	139327131	LTR/ERV1	2202	+	15	139327116	51652
chr6	170009885	170209885	harbor2	chr6	170035481	170035852	LTR/ERV1	1848	+	186	170035667	25782
chr6	170009885	170209885	harbor2	chr6	170040666	170041257	LTR/ERV1	2224	+	296	170040962	31077
chr6	170009885	170209885	harbor2	chr6	170042710	170043198	LTR/ERV1	2261	+	244	170042954	33069
chr6	7772024	7972024	harbor2	chr6	7847998	7848704	LTR/ERV1	1148	+	353	7848351	76327
chr6	139275450	139475450	harbor2	chr6	139289070	139289527	LTR/ERV1	3470	+	228	139289298	13848
chr6	139275450	139475450	harbor2	chr6	139312645	139313063	LTR/ERV1	2170	+	209	139312854	37404
chr6	139275450	139475450	harbor2	chr6	139313372	139313464	LTR/ERV1	2170	+	46	139313418	37968
chr6	139275450	139475450	harbor2	chr6	139313782	139314674	LTR/ERV1	5332	+	446	139314228	38778
chr6	139275450	139475450	harbor2	chr6	139314719	139315429	LTR/ERV1	3433	+	355	139315074	39624
chr6	139275450	139475450	harbor2	chr6	139316173	139316659	LTR/ERV1	2928	+	243	139316416	40966
chr6	139275450	139475450	harbor2	chr6	139326277	139326806	LTR/ERV1	2202	+	264	139326541	51091
chr6	139275450	139475450	harbor2	chr6	139327101	139327131	LTR/ERV1	2202	+	15	139327116	51666
chr6	169863955	170063955	harbor2	chr6	169911820	169912564	LTR/ERV1	4306	+	372	169912192	48237
chr6	7629037	7829037	harbor2	chr6	7668248	7668579	LTR/ERV1	460	+	166	7668414	39377
chr6	7629037	7829037	harbor2	chr6	7699068	7699141	LTR/ERV1	3769	+	36	7699104	70067
chr6	7629037	7829037	harbor2	chr6	7699446	7699990	LTR/ERV1	3769	+	272	7699718	70681
chr6	7629037	7829037	harbor2	chr6	7710556	7710726	LTR/ERV1	591	+	85	7710641	81604
chr6	139275453	139475453	harbor2	chr6	139289070	139289527	LTR/ERV1	3470	+	228	139289298	13845
chr6	139275453	139475453	harbor2	chr6	139312645	139313063	LTR/ERV1	2170	+	209	139312854	37401
chr6	139275453	139475453	harbor2	chr6	139313372	139313464	LTR/ERV1	2170	+	46	139313418	37965
chr6	139275453	139475453	harbor2	chr6	139313782	139314674	LTR/ERV1	5332	+	446	139314228	38775
chr6	139275453	139475453	harbor2	chr6	139314719	139315429	LTR/ERV1	3433	+	355	139315074	39621
chr6	139275453	139475453	harbor2	chr6	139316173	139316659	LTR/ERV1	2928	+	243	139316416	40963
chr6	139275453	139475453	harbor2	chr6	139326277	139326806	LTR/ERV1	2202	+	264	139326541	51088
chr6	139275453	139475453	harbor2	chr6	139327101	139327131	LTR/ERV1	2202	+	15	139327116	51663
chr6	37071432	37271432	harbor2	chr6	37123524	37123722	LTR/ERV1	885	+	99	37123623	52191
chr6	37071432	37271432	harbor2	chr6	37124559	37124828	LTR/ERV1	1660	+	134	37124693	53261
chr6	139275439	139475439	harbor2	chr6	139289070	139289527	LTR/ERV1	3470	+	228	139289298	13859
chr6	139275439	139475439	harbor2	chr6	139312645	139313063	LTR/ERV1	2170	+	209	139312854	37415
chr6	139275439	139475439	harbor2	chr6	139313372	139313464	LTR/ERV1	2170	+	46	139313418	37979
chr6	139275439	139475439	harbor2	chr6	139313782	139314674	LTR/ERV1	5332	+	446	139314228	38789
chr6	139275439	139475439	harbor2	chr6	139314719	139315429	LTR/ERV1	3433	+	355	139315074	39635
chr6	139275439	139475439	harbor2	chr6	139316173	139316659	LTR/ERV1	2928	+	243	139316416	40977
chr6	139275439	139475439	harbor2	chr6	139326277	139326806	LTR/ERV1	2202	+	264	139326541	51102
chr6	139275439	139475439	harbor2	chr6	139327101	139327131	LTR/ERV1	2202	+	15	139327116	51677
chr6	13879117	14079117	harbor2	chr6	13878864	13880548	LTR/ERV1	14444	+	842	13879706	589
chr6	13879117	14079117	harbor2	chr6	13880849	13881161	LTR/ERV1	14444	+	156	13881005	1888
chr6	13879117	14079117	harbor2	chr6	13881154	13883083	LTR/ERV1	10969	+	964	13882118	3001
chr6	13879117	14079117	harbor2	chr6	13883106	13883392	LTR/ERV1	2373	+	143	13883249	4132
chr6	13879117	14079117	harbor2	chr6	13883397	13883724	LTR/ERV1	2431	+	164	13883561	4444
chr6	90487353	90687353	harbor2	chr6	90487923	90488348	LTR/ERV1	1115	+	212	90488135	782
chr6	7626983	7826983	harbor2	chr6	7668248	7668579	LTR/ERV1	460	+	166	7668414	41431
chr6	7626983	7826983	harbor2	chr6	7699068	7699141	LTR/ERV1	3769	+	36	7699104	72121
chr6	7626983	7826983	harbor2	chr6	7699446	7699990	LTR/ERV1	3769	+	272	7699718	72735
chr6	7626983	7826983	harbor2	chr6	7710556	7710726	LTR/ERV1	591	+	85	7710641	83658
chr6	37074400	37274400	harbor2	chr6	37123524	37123722	LTR/ERV1	885	+	99	37123623	49223
chr6	37074400	37274400	harbor2	chr6	37124559	37124828	LTR/ERV1	1660	+	134	37124693	50293
chr6	6447005	6647005	harbor2	chr6	6462718	6463102	LTR/ERV1	3000	+	192	6462910	15905
chr6	6447005	6647005	harbor2	chr6	6477682	6478452	LTR/ERV1	6083	+	385	6478067	31062
chr6	138473227	138673227	harbor2	chr6	138520921	138521216	LTR/ERV1	535	+	148	138521069	47842
chr6	138473227	138673227	harbor2	chr6	138521479	138521619	LTR/ERV1	535	+	70	138521549	48322
chr6	63703058	63903058	harbor2	chr6	63762704	63763032	LTR/ERV1	503	+	164	63762868	59810
chr6	7628030	7828030	harbor2	chr6	7668248	7668579	LTR/ERV1	460	+	166	7668414	40384
chr6	7628030	7828030	harbor2	chr6	7699068	7699141	LTR/ERV1	3769	+	36	7699104	71074
chr6	7628030	7828030	harbor2	chr6	7699446	7699990	LTR/ERV1	3769	+	272	7699718	71688
chr6	7628030	7828030	harbor2	chr6	7710556	7710726	LTR/ERV1	591	+	85	7710641	82611
chr6	139292147	139492147	harbor2	chr6	139312645	139313063	LTR/ERV1	2170	+	209	139312854	20707
chr6	139292147	139492147	harbor2	chr6	139313372	139313464	LTR/ERV1	2170	+	46	139313418	21271
chr6	139292147	139492147	harbor2	chr6	139313782	139314674	LTR/ERV1	5332	+	446	139314228	22081
chr6	139292147	139492147	harbor2	chr6	139314719	139315429	LTR/ERV1	3433	+	355	139315074	22927
chr6	139292147	139492147	harbor2	chr6	139316173	139316659	LTR/ERV1	2928	+	243	139316416	24269
chr6	139292147	139492147	harbor2	chr6	139326277	139326806	LTR/ERV1	2202	+	264	139326541	34394
chr6	139292147	139492147	harbor2	chr6	139327101	139327131	LTR/ERV1	2202	+	15	139327116	34969
chr6	139275441	139475441	harbor2	chr6	139289070	139289527	LTR/ERV1	3470	+	228	139289298	13857
chr6	139275441	139475441	harbor2	chr6	139312645	139313063	LTR/ERV1	2170	+	209	139312854	37413
chr6	139275441	139475441	harbor2	chr6	139313372	139313464	LTR/ERV1	2170	+	46	139313418	37977
chr6	139275441	139475441	harbor2	chr6	139313782	139314674	LTR/ERV1	5332	+	446	139314228	38787
chr6	139275441	139475441	harbor2	chr6	139314719	139315429	LTR/ERV1	3433	+	355	139315074	39633
chr6	139275441	139475441	harbor2	chr6	139316173	139316659	LTR/ERV1	2928	+	243	139316416	40975
chr6	139275441	139475441	harbor2	chr6	139326277	139326806	LTR/ERV1	2202	+	264	139326541	51100
chr6	139275441	139475441	harbor2	chr6	139327101	139327131	LTR/ERV1	2202	+	15	139327116	51675
chr6	166057634	166257634	harbor2	chr6	166067762	166067918	LTR/ERV1	965	+	78	166067840	10206
chr6	166057634	166257634	harbor2	chr6	166152380	166152798	LTR/ERV1	1345	+	209	166152589	94955
chr6	43872696	44072696	harbor2	chr6	43901672	43902504	LTR/ERV1	1486	+	416	43902088	29392
chr6	139275444	139475444	harbor2	chr6	139289070	139289527	LTR/ERV1	3470	+	228	139289298	13854
chr6	139275444	139475444	harbor2	chr6	139312645	139313063	LTR/ERV1	2170	+	209	139312854	37410
chr6	139275444	139475444	harbor2	chr6	139313372	139313464	LTR/ERV1	2170	+	46	139313418	37974
chr6	139275444	139475444	harbor2	chr6	139313782	139314674	LTR/ERV1	5332	+	446	139314228	38784
chr6	139275444	139475444	harbor2	chr6	139314719	139315429	LTR/ERV1	3433	+	355	139315074	39630
chr6	139275444	139475444	harbor2	chr6	139316173	139316659	LTR/ERV1	2928	+	243	139316416	40972
chr6	139275444	139475444	harbor2	chr6	139326277	139326806	LTR/ERV1	2202	+	264	139326541	51097
chr6	139275444	139475444	harbor2	chr6	139327101	139327131	LTR/ERV1	2202	+	15	139327116	51672
chr6	37073934	37273934	harbor2	chr6	37123524	37123722	LTR/ERV1	885	+	99	37123623	49689
chr6	37073934	37273934	harbor2	chr6	37124559	37124828	LTR/ERV1	1660	+	134	37124693	50759
chr6	37072538	37272538	harbor2	chr6	37123524	37123722	LTR/ERV1	885	+	99	37123623	51085
chr6	37072538	37272538	harbor2	chr6	37124559	37124828	LTR/ERV1	1660	+	134	37124693	52155
chr6	165561181	165761181	harbor2	chr6	165585800	165586254	LTR/ERV1	1367	+	227	165586027	24846
chr6	33522490	33722490	harbor2	chr6	33525131	33525210	LTR/ERV1	447	+	40	33525171	2681
chr6	33522490	33722490	harbor2	chr6	33532208	33533731	LTR/ERV1	10429	+	762	33532970	10480
chr6	152219275	152419275	harbor2	chr6	152221855	152222323	LTR/ERV1	1539	+	234	152222089	2814
chr6	169887372	170087372	harbor2	chr6	169911820	169912564	LTR/ERV1	4306	+	372	169912192	24820
chr6	139275438	139475438	harbor2	chr6	139289070	139289527	LTR/ERV1	3470	+	228	139289298	13860
chr6	139275438	139475438	harbor2	chr6	139312645	139313063	LTR/ERV1	2170	+	209	139312854	37416
chr6	139275438	139475438	harbor2	chr6	139313372	139313464	LTR/ERV1	2170	+	46	139313418	37980
chr6	139275438	139475438	harbor2	chr6	139313782	139314674	LTR/ERV1	5332	+	446	139314228	38790
chr6	139275438	139475438	harbor2	chr6	139314719	139315429	LTR/ERV1	3433	+	355	139315074	39636
chr6	139275438	139475438	harbor2	chr6	139316173	139316659	LTR/ERV1	2928	+	243	139316416	40978
chr6	139275438	139475438	harbor2	chr6	139326277	139326806	LTR/ERV1	2202	+	264	139326541	51103
chr6	139275438	139475438	harbor2	chr6	139327101	139327131	LTR/ERV1	2202	+	15	139327116	51678
chr6	37253997	37453997	harbor2	chr6	37347699	37348276	LTR/ERV1	4112	+	288	37347987	93990
chr6	47581748	47781748	harbor2	chr6	47634584	47634756	LTR/ERV1	784	+	86	47634670	52922
chr6	47581748	47781748	harbor2	chr6	47634758	47635217	LTR/ERV1	3759	+	230	47634988	53240
chr6	47581748	47781748	harbor2	chr6	47635218	47635635	LTR/ERV1	3089	+	208	47635426	53678
chr6	47581748	47781748	harbor2	chr6	47647692	47648143	LTR/ERV1	3411	+	226	47647918	66170
chr6	47581748	47781748	harbor2	chr6	47648149	47648425	LTR/ERV1	805	+	138	47648287	66539
chr6	47581748	47781748	harbor2	chr6	47641260	47647687	LTR/ERV1	45868	+	3214	47644474	62726
chr6	42953847	43153847	harbor2	chr6	42954338	42954909	LTR/ERV1	4582	+	286	42954624	777
chr6	127285001	127485001	harbor2	chr6	127297420	127297984	LTR/ERV1	3260	+	282	127297702	12701
chr6	127285001	127485001	harbor2	chr6	127336967	127337718	LTR/ERV1	5527	+	376	127337343	52342
chr6	127285001	127485001	harbor2	chr6	127357472	127357800	LTR/ERV1	1174	+	164	127357636	72635
chr6	127285001	127485001	harbor2	chr6	127373762	127373890	LTR/ERV1	591	+	64	127373826	88825
chr6	127285001	127485001	harbor2	chr6	127374096	127374598	LTR/ERV1	1523	+	251	127374347	89346
chr6	127285001	127485001	harbor2	chr6	127376615	127376735	LTR/ERV1	829	+	60	127376675	91674
chr6	127285001	127485001	harbor2	chr6	127380531	127381075	LTR/ERV1	4118	+	272	127380803	95802
chr6	30370013	30570013	harbor2	chr6	30405806	30406317	LTR/ERV1	1599	+	256	30406062	36049
chr6	30370013	30570013	harbor2	chr6	30442291	30442831	LTR/ERV1	1300	+	270	30442561	72548
chr6	30370013	30570013	harbor2	chr6	30457693	30458430	LTR/ERV1	1410	+	368	30458061	88048
chr6	4985270	5185270	harbor2	chr6	5054569	5055401	LTR/ERV1	5596	+	416	5054985	69715
chr6	4985270	5185270	harbor2	chr6	5059619	5059801	LTR/ERV1	883	+	91	5059710	74440
chr6	4985270	5185270	harbor2	chr6	5059965	5060040	LTR/ERV1	883	+	38	5060003	74733
chr6	30946660	31146660	harbor2	chr6	30998932	30999444	LTR/ERV1	2692	+	256	30999188	52528
chr6	30946660	31146660	harbor2	chr6	30999745	31000000	LTR/ERV1	2692	+	128	30999873	53213
chr6	30946660	31146660	harbor2	chr6	31000001	31000144	LTR/ERV1	471	+	72	31000073	53413
chr6	30946660	31146660	harbor2	chr6	31000121	31000234	LTR/ERV1	605	+	56	31000177	53517
chr6	30946660	31146660	harbor2	chr6	31000295	31001611	LTR/ERV1	8917	+	658	31000953	54293
chr6	30946660	31146660	harbor2	chr6	31016620	31018142	LTR/ERV1	9241	+	761	31017381	70721
chr6	30946660	31146660	harbor2	chr6	31020539	31022248	LTR/ERV1	10881	+	854	31021393	74733
chr6	52185079	52385079	harbor2	chr6	52211354	52212093	LTR/ERV1	3586	+	370	52211724	26645
chr6	52185079	52385079	harbor2	chr6	52217856	52218281	LTR/ERV1	1631	+	212	52218068	32989
chr6	3749942	3949942	harbor2	chr6	3753120	3753621	LTR/ERV1	2981	+	250	3753370	3428
chr6	3749942	3949942	harbor2	chr6	3753622	3753977	LTR/ERV1	2556	+	178	3753800	3858
chr6	3749942	3949942	harbor2	chr6	3753978	3753995	LTR/ERV1	2981	+	8	3753986	4044
chr6	3749942	3949942	harbor2	chr6	3757991	3759348	LTR/ERV1	8909	+	678	3758669	8727
chr6	3749942	3949942	harbor2	chr6	3761203	3762164	LTR/ERV1	3003	+	480	3761683	11741
chr6	3749942	3949942	harbor2	chr6	3771456	3772976	LTR/ERV1	10159	+	760	3772216	22274
chr6	3749942	3949942	harbor2	chr6	3802278	3802403	LTR/ERV1	520	+	62	3802340	52398
chr6	3749942	3949942	harbor2	chr6	3802699	3802851	LTR/ERV1	520	+	76	3802775	52833
chr6	169873505	170073505	harbor2	chr6	169911820	169912564	LTR/ERV1	4306	+	372	169912192	38687
chr6	139275442	139475442	harbor2	chr6	139289070	139289527	LTR/ERV1	3470	+	228	139289298	13856
chr6	139275442	139475442	harbor2	chr6	139312645	139313063	LTR/ERV1	2170	+	209	139312854	37412
chr6	139275442	139475442	harbor2	chr6	139313372	139313464	LTR/ERV1	2170	+	46	139313418	37976
chr6	139275442	139475442	harbor2	chr6	139313782	139314674	LTR/ERV1	5332	+	446	139314228	38786
chr6	139275442	139475442	harbor2	chr6	139314719	139315429	LTR/ERV1	3433	+	355	139315074	39632
chr6	139275442	139475442	harbor2	chr6	139316173	139316659	LTR/ERV1	2928	+	243	139316416	40974
chr6	139275442	139475442	harbor2	chr6	139326277	139326806	LTR/ERV1	2202	+	264	139326541	51099
chr6	139275442	139475442	harbor2	chr6	139327101	139327131	LTR/ERV1	2202	+	15	139327116	51674
chr6	146813947	147013947	harbor2	chr6	146823314	146823509	LTR/ERV1	584	+	98	146823412	9465
chr6	146813947	147013947	harbor2	chr6	146828135	146828928	LTR/ERV1	4113	+	396	146828531	14584
chr6	146813947	147013947	harbor2	chr6	146829859	146830716	LTR/ERV1	5082	+	428	146830287	16340
chr6	146813947	147013947	harbor2	chr6	146879944	146880550	LTR/ERV1	3916	+	303	146880247	66300
chr6	146813947	147013947	harbor2	chr6	146883926	146884252	LTR/ERV1	1894	+	163	146884089	70142
chr6	106533593	106733593	harbor2	chr6	106604387	106604868	LTR/ERV1	1014	+	240	106604627	71034
chr6	106533593	106733593	harbor2	chr6	106612550	106613049	LTR/ERV1	3226	+	250	106612800	79207
chr6	106533593	106733593	harbor2	chr6	106613597	106614165	LTR/ERV1	3343	+	284	106613881	80288
chr6	140279813	140479813	harbor2	chr6	140301231	140301667	LTR/ERV1	1963	+	218	140301449	21636
chr6	140279813	140479813	harbor2	chr6	140301668	140301896	LTR/ERV1	1186	+	114	140301782	21969
chr6	140279813	140479813	harbor2	chr6	140301897	140302057	LTR/ERV1	1089	+	80	140301977	22164
chr6	140279813	140479813	harbor2	chr6	140368439	140368635	LTR/ERV1	727	+	98	140368537	88724
chr6	140279813	140479813	harbor2	chr6	140368919	140369027	LTR/ERV1	727	+	54	140368973	89160
chr6	133854144	134054144	harbor2	chr6	133867754	133868072	LTR/ERV1	2295	+	159	133867913	13769
chr6	133854144	134054144	harbor2	chr6	133918518	133918981	LTR/ERV1	772	+	232	133918750	64606
chr6	133854144	134054144	harbor2	chr6	133940776	133941237	LTR/ERV1	2240	+	230	133941006	86862
chr6	37072323	37272323	harbor2	chr6	37123524	37123722	LTR/ERV1	885	+	99	37123623	51300
chr6	37072323	37272323	harbor2	chr6	37124559	37124828	LTR/ERV1	1660	+	134	37124693	52370
chr6	139276317	139476317	harbor2	chr6	139289070	139289527	LTR/ERV1	3470	+	228	139289298	12981
chr6	139276317	139476317	harbor2	chr6	139312645	139313063	LTR/ERV1	2170	+	209	139312854	36537
chr6	139276317	139476317	harbor2	chr6	139313372	139313464	LTR/ERV1	2170	+	46	139313418	37101
chr6	139276317	139476317	harbor2	chr6	139313782	139314674	LTR/ERV1	5332	+	446	139314228	37911
chr6	139276317	139476317	harbor2	chr6	139314719	139315429	LTR/ERV1	3433	+	355	139315074	38757
chr6	139276317	139476317	harbor2	chr6	139316173	139316659	LTR/ERV1	2928	+	243	139316416	40099
chr6	139276317	139476317	harbor2	chr6	139326277	139326806	LTR/ERV1	2202	+	264	139326541	50224
chr6	139276317	139476317	harbor2	chr6	139327101	139327131	LTR/ERV1	2202	+	15	139327116	50799
chr6	169864808	170064808	harbor2	chr6	169911820	169912564	LTR/ERV1	4306	+	372	169912192	47384
chr6	37071349	37271349	harbor2	chr6	37123524	37123722	LTR/ERV1	885	+	99	37123623	52274
chr6	37071349	37271349	harbor2	chr6	37124559	37124828	LTR/ERV1	1660	+	134	37124693	53344
chr6	139275455	139475455	harbor2	chr6	139289070	139289527	LTR/ERV1	3470	+	228	139289298	13843
chr6	139275455	139475455	harbor2	chr6	139312645	139313063	LTR/ERV1	2170	+	209	139312854	37399
chr6	139275455	139475455	harbor2	chr6	139313372	139313464	LTR/ERV1	2170	+	46	139313418	37963
chr6	139275455	139475455	harbor2	chr6	139313782	139314674	LTR/ERV1	5332	+	446	139314228	38773
chr6	139275455	139475455	harbor2	chr6	139314719	139315429	LTR/ERV1	3433	+	355	139315074	39619
chr6	139275455	139475455	harbor2	chr6	139316173	139316659	LTR/ERV1	2928	+	243	139316416	40961
chr6	139275455	139475455	harbor2	chr6	139326277	139326806	LTR/ERV1	2202	+	264	139326541	51086
chr6	139275455	139475455	harbor2	chr6	139327101	139327131	LTR/ERV1	2202	+	15	139327116	51661
chr6	11912017	12112017	harbor2	chr6	11932843	11934427	LTR/ERV1	10141	+	792	11933635	21618
chr6	11912017	12112017	harbor2	chr6	11960483	11961029	LTR/ERV1	2388	+	273	11960756	48739
chr6	37072379	37272379	harbor2	chr6	37123524	37123722	LTR/ERV1	885	+	99	37123623	51244
chr6	37072379	37272379	harbor2	chr6	37124559	37124828	LTR/ERV1	1660	+	134	37124693	52314
chr6	56126551	56326551	harbor2	chr6	56156278	56156840	LTR/ERV1	1811	+	281	56156559	30008
chr6	24674917	24874917	harbor2	chr6	24759802	24759910	LTR/ERV1	1255	+	54	24759856	84939
chr6	24674917	24874917	harbor2	chr6	24760209	24760390	LTR/ERV1	1255	+	90	24760299	85382
chr6	24674917	24874917	harbor2	chr6	24760717	24760849	LTR/ERV1	500	+	66	24760783	85866
chr6	151205921	151405921	harbor2	chr6	151212766	151213003	LTR/ERV1	4491	+	118	151212884	6963
chr6	151205921	151405921	harbor2	chr6	151213302	151213826	LTR/ERV1	4491	+	262	151213564	7643
chr6	151205921	151405921	harbor2	chr6	151229099	151229724	LTR/ERV1	4582	+	312	151229411	23490
chr6	37071596	37271596	harbor2	chr6	37123524	37123722	LTR/ERV1	885	+	99	37123623	52027
chr6	37071596	37271596	harbor2	chr6	37124559	37124828	LTR/ERV1	1660	+	134	37124693	53097
chr6	41449219	41649219	harbor2	chr6	41455876	41456301	LTR/ERV1	661	+	212	41456088	6869
chr6	37070833	37270833	harbor2	chr6	37123524	37123722	LTR/ERV1	885	+	99	37123623	52790
chr6	37070833	37270833	harbor2	chr6	37124559	37124828	LTR/ERV1	1660	+	134	37124693	53860
chr6	52190864	52390864	harbor2	chr6	52211354	52212093	LTR/ERV1	3586	+	370	52211724	20860
chr6	52190864	52390864	harbor2	chr6	52217856	52218281	LTR/ERV1	1631	+	212	52218068	27204
chr6	23317064	23517064	harbor2	chr6	23342480	23343224	LTR/ERV1	3784	+	372	23342852	25788
chr6	139275447	139475447	harbor2	chr6	139289070	139289527	LTR/ERV1	3470	+	228	139289298	13851
chr6	139275447	139475447	harbor2	chr6	139312645	139313063	LTR/ERV1	2170	+	209	139312854	37407
chr6	139275447	139475447	harbor2	chr6	139313372	139313464	LTR/ERV1	2170	+	46	139313418	37971
chr6	139275447	139475447	harbor2	chr6	139313782	139314674	LTR/ERV1	5332	+	446	139314228	38781
chr6	139275447	139475447	harbor2	chr6	139314719	139315429	LTR/ERV1	3433	+	355	139315074	39627
chr6	139275447	139475447	harbor2	chr6	139316173	139316659	LTR/ERV1	2928	+	243	139316416	40969
chr6	139275447	139475447	harbor2	chr6	139326277	139326806	LTR/ERV1	2202	+	264	139326541	51094
chr6	139275447	139475447	harbor2	chr6	139327101	139327131	LTR/ERV1	2202	+	15	139327116	51669
chr6	37073886	37273886	harbor2	chr6	37123524	37123722	LTR/ERV1	885	+	99	37123623	49737
chr6	37073886	37273886	harbor2	chr6	37124559	37124828	LTR/ERV1	1660	+	134	37124693	50807
chr6	169864138	170064138	harbor2	chr6	169911820	169912564	LTR/ERV1	4306	+	372	169912192	48054
chr6	127447015	127647015	harbor2	chr6	127481732	127482268	LTR/ERV1	4110	+	268	127482000	34985
chr6	7770431	7970431	harbor2	chr6	7847998	7848704	LTR/ERV1	1148	+	353	7848351	77920
chr6	107718911	107918911	harbor2	chr6	107740478	107741053	LTR/ERV1	1804	+	288	107740766	21855
chr6	107718911	107918911	harbor2	chr6	107743252	107743424	LTR/ERV1	546	+	86	107743338	24427
chr6	107718911	107918911	harbor2	chr6	107765565	107765632	LTR/ERV1	461	+	34	107765599	46688
chr6	56333514	56533514	harbor2	chr6	56335231	56335782	LTR/ERV1	2834	+	276	56335507	1993
chr6	56333514	56533514	harbor2	chr6	56425444	56425710	LTR/ERV1	996	+	133	56425577	92063
chr6	7634787	7834787	harbor2	chr6	7668248	7668579	LTR/ERV1	460	+	166	7668414	33627
chr6	7634787	7834787	harbor2	chr6	7699068	7699141	LTR/ERV1	3769	+	36	7699104	64317
chr6	7634787	7834787	harbor2	chr6	7699446	7699990	LTR/ERV1	3769	+	272	7699718	64931
chr6	7634787	7834787	harbor2	chr6	7710556	7710726	LTR/ERV1	591	+	85	7710641	75854
chr6	7628065	7828065	harbor2	chr6	7668248	7668579	LTR/ERV1	460	+	166	7668414	40349
chr6	7628065	7828065	harbor2	chr6	7699068	7699141	LTR/ERV1	3769	+	36	7699104	71039
chr6	7628065	7828065	harbor2	chr6	7699446	7699990	LTR/ERV1	3769	+	272	7699718	71653
chr6	7628065	7828065	harbor2	chr6	7710556	7710726	LTR/ERV1	591	+	85	7710641	82576
chr6	149646190	149846190	harbor2	chr6	149709067	149709668	LTR/ERV1	5325	+	300	149709367	63177
chr6	149646190	149846190	harbor2	chr6	149709974	149710321	LTR/ERV1	5325	+	174	149710148	63958
chr6	169994233	170194233	harbor2	chr6	169999476	170000000	LTR/ERV1	1700	+	262	169999738	5505
chr6	169994233	170194233	harbor2	chr6	170000002	170000155	LTR/ERV1	759	+	76	170000078	5845
chr6	169994233	170194233	harbor2	chr6	170035481	170035852	LTR/ERV1	1848	+	186	170035667	41434
chr6	169994233	170194233	harbor2	chr6	170040666	170041257	LTR/ERV1	2224	+	296	170040962	46729
chr6	169994233	170194233	harbor2	chr6	170042710	170043198	LTR/ERV1	2261	+	244	170042954	48721
chr6	146972244	147172244	harbor2	chr6	146990892	146990990	LTR/ERV1	531	+	49	146990941	18697
chr6	146972244	147172244	harbor2	chr6	147034466	147035014	LTR/ERV1	4000	+	274	147034740	62496
chr6	146972244	147172244	harbor2	chr6	147069134	147069762	LTR/ERV1	2925	+	314	147069448	97204
chr7	44442212	44642212	harbor2	chr7	44469002	44469410	LTR/ERV1	1504	+	204	44469206	26994
chr7	149524712	149724712	harbor2	chr7	149527024	149527125	LTR/ERV1	1222	+	50	149527074	2362
chr7	149524712	149724712	harbor2	chr7	149527429	149527854	LTR/ERV1	1394	+	212	149527641	2929
chr7	149524712	149724712	harbor2	chr7	149527865	149529552	LTR/ERV1	9178	+	844	149528709	3997
chr7	149524712	149724712	harbor2	chr7	149529583	149531015	LTR/ERV1	7735	+	716	149530299	5587
chr7	149524712	149724712	harbor2	chr7	149531004	149531205	LTR/ERV1	1610	+	100	149531104	6392
chr7	149524712	149724712	harbor2	chr7	149531450	149531509	LTR/ERV1	5652	+	30	149531480	6768
chr7	149524712	149724712	harbor2	chr7	149531808	149532818	LTR/ERV1	5652	+	505	149532313	7601
chr7	149524712	149724712	harbor2	chr7	149532820	149533047	LTR/ERV1	11660	+	114	149532934	8222
chr7	149524712	149724712	harbor2	chr7	149533338	149535145	LTR/ERV1	11660	+	904	149534242	9530
chr7	149524712	149724712	harbor2	chr7	149535148	149535465	LTR/ERV1	1153	+	158	149535306	10594
chr7	149524712	149724712	harbor2	chr7	149535512	149535698	LTR/ERV1	1153	+	93	149535605	10893
chr7	149524712	149724712	harbor2	chr7	149548055	149548554	LTR/ERV1	3265	+	250	149548305	23593
chr7	149524712	149724712	harbor2	chr7	149564786	149565233	LTR/ERV1	2366	+	224	149565010	40298
chr7	149524712	149724712	harbor2	chr7	149568739	149569346	LTR/ERV1	3500	+	304	149569043	44331
chr7	149524712	149724712	harbor2	chr7	149570437	149570690	LTR/ERV1	1439	+	126	149570563	45851
chr7	149524712	149724712	harbor2	chr7	149571228	149572599	LTR/ERV1	5081	+	686	149571914	47202
chr7	149524712	149724712	harbor2	chr7	149572697	149572962	LTR/ERV1	3828	+	132	149572829	48117
chr7	149524712	149724712	harbor2	chr7	149573451	149573817	LTR/ERV1	3828	+	183	149573634	48922
chr7	149524712	149724712	harbor2	chr7	149596185	149596507	LTR/ERV1	1753	+	161	149596346	71634
chr7	149524712	149724712	harbor2	chr7	149569356	149570100	LTR/ERV1	2249	+	372	149569728	45016
chr7	72825583	73025583	harbor2	chr7	72850899	72851370	LTR/ERV1	2438	+	236	72851135	25552
chr7	72825583	73025583	harbor2	chr7	72875216	72875398	LTR/ERV1	2233	+	91	72875307	49724
chr7	72825583	73025583	harbor2	chr7	72875708	72875955	LTR/ERV1	2233	+	124	72875832	50249
chr7	72825583	73025583	harbor2	chr7	72876281	72876380	LTR/ERV1	2233	+	50	72876331	50748
chr7	72825583	73025583	harbor2	chr7	72876684	72876821	LTR/ERV1	2233	+	68	72876752	51169
chr7	72825583	73025583	harbor2	chr7	72877265	72877905	LTR/ERV1	4205	+	320	72877585	52002
chr7	72825583	73025583	harbor2	chr7	72878166	72878474	LTR/ERV1	4205	+	154	72878320	52737
chr7	86417400	86617400	harbor2	chr7	86440386	86441810	LTR/ERV1	10243	+	712	86441098	23698
chr7	86417400	86617400	harbor2	chr7	86461073	86461674	LTR/ERV1	2634	+	300	86461373	43973
chr7	25270423	25470423	harbor2	chr7	25287224	25287579	LTR/ERV1	2802	+	178	25287402	16979
chr7	25270423	25470423	harbor2	chr7	25287721	25287773	LTR/ERV1	2802	+	26	25287747	17324
chr7	25270423	25470423	harbor2	chr7	25351633	25352109	LTR/ERV1	1781	+	238	25351871	81448
chr7	25270423	25470423	harbor2	chr7	25352388	25352437	LTR/ERV1	1781	+	24	25352412	81989
chr7	148599806	148799806	harbor2	chr7	148611173	148611970	LTR/ERV1	4763	+	398	148611571	11765
chr7	123649533	123849533	harbor2	chr7	123719431	123719881	LTR/ERV1	2822	+	225	123719656	70123
chr7	32628830	32828830	harbor2	chr7	32658790	32659163	LTR/ERV1	1060	+	186	32658976	30146
chr7	32628830	32828830	harbor2	chr7	32680768	32681266	LTR/ERV1	2622	+	249	32681017	52187
chr7	44507353	44707353	harbor2	chr7	44603456	44603488	LTR/ERV1	1473	+	16	44603472	96119
chr7	44507353	44707353	harbor2	chr7	44603797	44604282	LTR/ERV1	1473	+	242	44604039	96686
chr7	97828524	98028524	harbor2	chr7	97836207	97836647	LTR/ERV1	2055	+	220	97836427	7903
chr7	97828524	98028524	harbor2	chr7	97840419	97840776	LTR/ERV1	1293	+	178	97840597	12073
chr7	97828524	98028524	harbor2	chr7	97841081	97841179	LTR/ERV1	1293	+	49	97841130	12606
chr7	100028636	100228636	harbor2	chr7	100041843	100042033	LTR/ERV1	1030	+	95	100041938	13302
chr7	100028636	100228636	harbor2	chr7	100043676	100043745	LTR/ERV1	2092	+	34	100043710	15074
chr7	100028636	100228636	harbor2	chr7	100044077	100044386	LTR/ERV1	2092	+	154	100044231	15595
chr7	100028636	100228636	harbor2	chr7	100044706	100044725	LTR/ERV1	2092	+	10	100044716	16080
chr7	100028636	100228636	harbor2	chr7	100048030	100048471	LTR/ERV1	3577	+	220	100048250	19614
chr7	100028636	100228636	harbor2	chr7	100049008	100049341	LTR/ERV1	3577	+	166	100049174	20538
chr7	100028636	100228636	harbor2	chr7	100082616	100083179	LTR/ERV1	3539	+	282	100082898	54262
chr7	32328390	32528390	harbor2	chr7	32358922	32359374	LTR/ERV1	1732	+	226	32359148	30758
chr7	32328390	32528390	harbor2	chr7	32378288	32378965	LTR/ERV1	3924	+	338	32378626	50236
chr7	142754209	142954209	harbor2	chr7	142781563	142781641	LTR/ERV1	3943	+	39	142781602	27393
chr7	142754209	142954209	harbor2	chr7	142781952	142782610	LTR/ERV1	3943	+	329	142782281	28072
chr7	135684417	135884417	harbor2	chr7	135704466	135704836	LTR/ERV1	493	+	185	135704651	20234
chr7	135684417	135884417	harbor2	chr7	135775477	135775574	LTR/ERV1	856	+	48	135775525	91108
chr7	135684417	135884417	harbor2	chr7	135775879	135776109	LTR/ERV1	856	+	115	135775994	91577
chr7	123650448	123850448	harbor2	chr7	123719431	123719881	LTR/ERV1	2822	+	225	123719656	69208
chr7	20777006	20977006	harbor2	chr7	20817811	20818410	LTR/ERV1	4499	+	300	20818111	41105
chr7	123649492	123849492	harbor2	chr7	123719431	123719881	LTR/ERV1	2822	+	225	123719656	70164
chr7	44507472	44707472	harbor2	chr7	44603456	44603488	LTR/ERV1	1473	+	16	44603472	96000
chr7	44507472	44707472	harbor2	chr7	44603797	44604282	LTR/ERV1	1473	+	242	44604039	96567
chr7	123650423	123850423	harbor2	chr7	123719431	123719881	LTR/ERV1	2822	+	225	123719656	69233
chr7	159003487	159203487	harbor2	chr7	159015974	159016683	LTR/ERV1	2850	+	354	159016328	12841
chr7	159003487	159203487	harbor2	chr7	159075343	159075490	LTR/ERV1	586	+	74	159075417	71930
chr7	159003487	159203487	harbor2	chr7	159076447	159076854	LTR/ERV1	468	+	204	159076651	73164
chr7	159003487	159203487	harbor2	chr7	159076918	159077286	LTR/ERV1	1006	+	184	159077102	73615
chr7	159003487	159203487	harbor2	chr7	159077794	159078394	LTR/ERV1	1876	+	300	159078094	74607
chr7	100329872	100529872	harbor2	chr7	100381554	100382995	LTR/ERV1	9817	+	720	100382274	52402
chr7	44440642	44640642	harbor2	chr7	44469002	44469410	LTR/ERV1	1504	+	204	44469206	28564
chr7	128769421	128969421	harbor2	chr7	128789840	128790382	LTR/ERV1	4090	+	271	128790111	20690
chr7	44696651	44896651	harbor2	chr7	44713869	44714489	LTR/ERV1	3149	+	310	44714179	17528
chr7	44696651	44896651	harbor2	chr7	44729492	44730548	LTR/ERV1	3845	+	528	44730020	33369
chr7	90497085	90697085	harbor2	chr7	90575190	90575602	LTR/ERV1	1401	+	206	90575396	78311
chr7	139383658	139583658	harbor2	chr7	139447371	139447399	LTR/ERV1	2164	+	14	139447385	63727
chr7	139383658	139583658	harbor2	chr7	139447703	139447989	LTR/ERV1	2164	+	143	139447846	64188
chr7	139383658	139583658	harbor2	chr7	139448296	139448448	LTR/ERV1	2164	+	76	139448372	64714
chr7	139383658	139583658	harbor2	chr7	139461465	139461863	LTR/ERV1	2414	+	199	139461664	78006
chr7	139383658	139583658	harbor2	chr7	139461864	139464526	LTR/ERV1	12777	+	1331	139463195	79537
chr7	139383658	139583658	harbor2	chr7	139464527	139465412	LTR/ERV1	6057	+	442	139464969	81311
chr7	139383658	139583658	harbor2	chr7	139465719	139466471	LTR/ERV1	6057	+	376	139466095	82437
chr7	139383658	139583658	harbor2	chr7	139466439	139466703	LTR/ERV1	1400	+	132	139466571	82913
chr7	139383658	139583658	harbor2	chr7	139466697	139467289	LTR/ERV1	3413	+	296	139466993	83335
chr7	139383658	139583658	harbor2	chr7	139467290	139467404	LTR/ERV1	1935	+	57	139467347	83689
chr7	139383658	139583658	harbor2	chr7	139468374	139468653	LTR/ERV1	1935	+	140	139468514	84856
chr7	25269994	25469994	harbor2	chr7	25287224	25287579	LTR/ERV1	2802	+	178	25287402	17408
chr7	25269994	25469994	harbor2	chr7	25287721	25287773	LTR/ERV1	2802	+	26	25287747	17753
chr7	25269994	25469994	harbor2	chr7	25351633	25352109	LTR/ERV1	1781	+	238	25351871	81877
chr7	25269994	25469994	harbor2	chr7	25352388	25352437	LTR/ERV1	1781	+	24	25352412	82418
chr7	150420511	150620511	harbor2	chr7	150508663	150509225	LTR/ERV1	1915	+	281	150508944	88433
chr7	150420511	150620511	harbor2	chr7	150509887	150510055	LTR/ERV1	539	+	84	150509971	89460
chr7	93330	293330	harbor2	chr7	136119	136735	LTR/ERV1	4220	+	308	136427	43097
chr7	93330	293330	harbor2	chr7	140677	140948	LTR/ERV1	1426	+	136	140813	47483
chr7	93330	293330	harbor2	chr7	141037	141344	LTR/ERV1	1324	+	154	141191	47861
chr7	93330	293330	harbor2	chr7	165706	165971	LTR/ERV1	577	+	132	165838	72508
chr7	93330	293330	harbor2	chr7	187988	188409	LTR/ERV1	1517	+	210	188198	94868
chr7	44441524	44641524	harbor2	chr7	44469002	44469410	LTR/ERV1	1504	+	204	44469206	27682
chr7	25270014	25470014	harbor2	chr7	25287224	25287579	LTR/ERV1	2802	+	178	25287402	17388
chr7	25270014	25470014	harbor2	chr7	25287721	25287773	LTR/ERV1	2802	+	26	25287747	17733
chr7	25270014	25470014	harbor2	chr7	25351633	25352109	LTR/ERV1	1781	+	238	25351871	81857
chr7	25270014	25470014	harbor2	chr7	25352388	25352437	LTR/ERV1	1781	+	24	25352412	82398
chr7	128756973	128956973	harbor2	chr7	128789840	128790382	LTR/ERV1	4090	+	271	128790111	33138
chr7	104911716	105111716	harbor2	chr7	104939975	104941430	LTR/ERV1	9115	+	728	104940703	28987
chr7	6060741	6260741	harbor2	chr7	6062240	6062660	LTR/ERV1	1453	+	210	6062450	1709
chr7	123649199	123849199	harbor2	chr7	123719431	123719881	LTR/ERV1	2822	+	225	123719656	70457
chr7	107463451	107663451	harbor2	chr7	107529237	107529910	LTR/ERV1	4025	+	336	107529573	66122
chr7	107463451	107663451	harbor2	chr7	107537906	107538580	LTR/ERV1	4245	+	337	107538243	74792
chr7	31973371	32173371	harbor2	chr7	32015892	32016371	LTR/ERV1	1839	+	240	32016132	42761
chr7	31973371	32173371	harbor2	chr7	32030539	32030667	LTR/ERV1	471	+	64	32030603	57232
chr7	31973371	32173371	harbor2	chr7	32030959	32031284	LTR/ERV1	1223	+	162	32031121	57750
chr7	31973371	32173371	harbor2	chr7	32035041	32035485	LTR/ERV1	3119	+	222	32035263	61892
chr7	44697576	44897576	harbor2	chr7	44713869	44714489	LTR/ERV1	3149	+	310	44714179	16603
chr7	44697576	44897576	harbor2	chr7	44729492	44730548	LTR/ERV1	3845	+	528	44730020	32444
chr7	47569705	47769705	harbor2	chr7	47595690	47595763	LTR/ERV1	480	+	36	47595726	26021
chr7	47569705	47769705	harbor2	chr7	47596039	47596181	LTR/ERV1	4894	+	71	47596110	26405
chr7	47569705	47769705	harbor2	chr7	47596505	47597140	LTR/ERV1	4894	+	318	47596823	27118
chr7	47569705	47769705	harbor2	chr7	47597141	47600035	LTR/ERV1	13879	+	1447	47598588	28883
chr7	47569705	47769705	harbor2	chr7	47600038	47600882	LTR/ERV1	5653	+	422	47600460	30755
chr7	47569705	47769705	harbor2	chr7	47603510	47604260	LTR/ERV1	5565	+	375	47603885	34180
chr7	47569705	47769705	harbor2	chr7	47618898	47619704	LTR/ERV1	5225	+	403	47619301	49596
chr7	47569705	47769705	harbor2	chr7	47628296	47629715	LTR/ERV1	9986	+	710	47629006	59301
chr7	44441056	44641056	harbor2	chr7	44469002	44469410	LTR/ERV1	1504	+	204	44469206	28150
chr7	90496247	90696247	harbor2	chr7	90575190	90575602	LTR/ERV1	1401	+	206	90575396	79149
chr7	90145189	90345189	harbor2	chr7	90224172	90224642	LTR/ERV1	2718	+	235	90224407	79218
chr7	41382564	41582564	harbor2	chr7	41435024	41435608	LTR/ERV1	3602	+	292	41435316	52752
chr7	156540425	156740425	harbor2	chr7	156619544	156619819	LTR/ERV1	1080	+	138	156619682	79257
chr7	156540425	156740425	harbor2	chr7	156626549	156626959	LTR/ERV1	2090	+	205	156626754	86329
chr7	156540425	156740425	harbor2	chr7	156626960	156627580	LTR/ERV1	6323	+	310	156627270	86845
chr7	156540425	156740425	harbor2	chr7	156627881	156628367	LTR/ERV1	6323	+	243	156628124	87699
chr7	156540425	156740425	harbor2	chr7	156632924	156633315	LTR/ERV1	2445	+	196	156633120	92695
chr7	156540425	156740425	harbor2	chr7	156633832	156634990	LTR/ERV1	7165	+	579	156634411	93986
chr7	156540425	156740425	harbor2	chr7	156630936	156632928	LTR/ERV1	7770	+	996	156631932	91507
chr7	21327951	21527951	harbor2	chr7	21389138	21389316	LTR/ERV1	3880	+	89	21389227	61276
chr7	21327951	21527951	harbor2	chr7	21389602	21390118	LTR/ERV1	3880	+	258	21389860	61909
chr7	21327951	21527951	harbor2	chr7	21405714	21406288	LTR/ERV1	1723	+	287	21406001	78050
chr7	107099067	107299067	harbor2	chr7	107102223	107102619	LTR/ERV1	2284	+	198	107102421	3354
chr7	157236951	157436951	harbor2	chr7	157293505	157293902	LTR/ERV1	1083	+	198	157293703	56752
chr7	157236951	157436951	harbor2	chr7	157307579	157307767	LTR/ERV1	1156	+	94	157307673	70722
chr7	157236951	157436951	harbor2	chr7	157309294	157309418	LTR/ERV1	1156	+	62	157309356	72405
chr7	157236951	157436951	harbor2	chr7	157314438	157314585	LTR/ERV1	797	+	74	157314512	77561
chr7	157236951	157436951	harbor2	chr7	157314586	157314607	LTR/ERV1	3380	+	10	157314596	77645
chr7	157236951	157436951	harbor2	chr7	157314922	157315247	LTR/ERV1	3380	+	162	157315084	78133
chr7	157236951	157436951	harbor2	chr7	157315546	157315710	LTR/ERV1	3380	+	82	157315628	78677
chr7	157236951	157436951	harbor2	chr7	157315901	157316169	LTR/ERV1	1865	+	134	157316035	79084
chr7	157236951	157436951	harbor2	chr7	157316170	157316728	LTR/ERV1	2025	+	279	157316449	79498
chr7	92428769	92628769	harbor2	chr7	92478628	92479192	LTR/ERV1	2781	+	282	92478910	50141
chr7	92428769	92628769	harbor2	chr7	92485275	92485341	LTR/ERV1	537	+	33	92485308	56539
chr7	123649212	123849212	harbor2	chr7	123719431	123719881	LTR/ERV1	2822	+	225	123719656	70444
chr7	50340926	50540926	harbor2	chr7	50422616	50423045	LTR/ERV1	1072	+	214	50422830	81904
chr7	50340926	50540926	harbor2	chr7	50423437	50423482	LTR/ERV1	1072	+	22	50423459	82533
chr7	44466421	44666421	harbor2	chr7	44469002	44469410	LTR/ERV1	1504	+	204	44469206	2785
chr7	127292472	127492472	harbor2	chr7	127308901	127309387	LTR/ERV1	2680	+	243	127309144	16672
chr7	127292472	127492472	harbor2	chr7	127337654	127338166	LTR/ERV1	1640	+	256	127337910	45438
chr7	152811886	153011886	harbor2	chr7	152884633	152885000	LTR/ERV1	2274	+	184	152884817	72931
chr7	152811886	153011886	harbor2	chr7	152899495	152899926	LTR/ERV1	3001	+	216	152899711	87825
chr8	23428848	23628848	harbor2	chr8	23489175	23489689	LTR/ERV1	3743	+	257	23489432	60584
chr8	38169595	38369595	harbor2	chr8	38229500	38229570	LTR/ERV1	594	+	35	38229535	59940
chr8	23429416	23629416	harbor2	chr8	23489175	23489689	LTR/ERV1	3743	+	257	23489432	60016
chr8	124273072	124473072	harbor2	chr8	124338809	124338908	LTR/ERV1	2155	+	50	124338859	65787
chr8	124273072	124473072	harbor2	chr8	124339222	124339542	LTR/ERV1	2155	+	160	124339382	66310
chr8	124273072	124473072	harbor2	chr8	124340148	124340712	LTR/ERV1	1138	+	282	124340430	67358
chr8	124273072	124473072	harbor2	chr8	124340713	124340828	LTR/ERV1	619	+	58	124340771	67699
chr8	124273072	124473072	harbor2	chr8	124340848	124343117	LTR/ERV1	4800	+	1134	124341982	68910
chr8	124273072	124473072	harbor2	chr8	124343112	124343836	LTR/ERV1	2894	+	362	124343474	70402
chr8	124273072	124473072	harbor2	chr8	124344099	124345029	LTR/ERV1	2491	+	465	124344564	71492
chr8	124273072	124473072	harbor2	chr8	124345030	124345428	LTR/ERV1	2184	+	199	124345229	72157
chr8	124273072	124473072	harbor2	chr8	124356205	124356397	LTR/ERV1	740	+	96	124356301	83229
chr8	124273072	124473072	harbor2	chr8	124358340	124358756	LTR/ERV1	1952	+	208	124358548	85476
chr8	124273072	124473072	harbor2	chr8	124358757	124359475	LTR/ERV1	5814	+	359	124359116	86044
chr8	124273072	124473072	harbor2	chr8	124359760	124360106	LTR/ERV1	5814	+	173	124359933	86861
chr8	124273072	124473072	harbor2	chr8	124360107	124360148	LTR/ERV1	955	+	20	124360127	87055
chr8	124273072	124473072	harbor2	chr8	124360452	124360671	LTR/ERV1	955	+	110	124360562	87490
chr8	124273072	124473072	harbor2	chr8	124360672	124360971	LTR/ERV1	1536	+	150	124360822	87750
chr8	124273072	124473072	harbor2	chr8	124360974	124361151	LTR/ERV1	5444	+	88	124361062	87990
chr8	124273072	124473072	harbor2	chr8	124361456	124361551	LTR/ERV1	5444	+	48	124361504	88432
chr8	124273072	124473072	harbor2	chr8	124361858	124361901	LTR/ERV1	5444	+	22	124361880	88808
chr8	124273072	124473072	harbor2	chr8	124362192	124362379	LTR/ERV1	5444	+	94	124362286	89214
chr8	124273072	124473072	harbor2	chr8	124362684	124363495	LTR/ERV1	5444	+	406	124363090	90018
chr8	23428811	23628811	harbor2	chr8	23489175	23489689	LTR/ERV1	3743	+	257	23489432	60621
chr8	23439328	23639328	harbor2	chr8	23489175	23489689	LTR/ERV1	3743	+	257	23489432	50104
chr8	23428778	23628778	harbor2	chr8	23489175	23489689	LTR/ERV1	3743	+	257	23489432	60654
chr8	23428784	23628784	harbor2	chr8	23489175	23489689	LTR/ERV1	3743	+	257	23489432	60648
chr8	23428892	23628892	harbor2	chr8	23489175	23489689	LTR/ERV1	3743	+	257	23489432	60540
chr8	23429271	23629271	harbor2	chr8	23489175	23489689	LTR/ERV1	3743	+	257	23489432	60161
chr8	23430686	23630686	harbor2	chr8	23489175	23489689	LTR/ERV1	3743	+	257	23489432	58746
chr8	17985030	18185030	harbor2	chr8	18015304	18015712	LTR/ERV1	1208	+	204	18015508	30478
chr8	17985030	18185030	harbor2	chr8	18015718	18015897	LTR/ERV1	675	+	90	18015808	30778
chr8	17985030	18185030	harbor2	chr8	18016187	18016260	LTR/ERV1	675	+	36	18016223	31193
chr8	17985030	18185030	harbor2	chr8	18018942	18019198	LTR/ERV1	454	+	128	18019070	34040
chr8	17985030	18185030	harbor2	chr8	18019837	18020881	LTR/ERV1	445	+	522	18020359	35329
chr8	17985030	18185030	harbor2	chr8	18020979	18022254	LTR/ERV1	1316	+	638	18021617	36587
chr8	17985030	18185030	harbor2	chr8	18023030	18023377	LTR/ERV1	690	+	174	18023204	38174
chr8	17985030	18185030	harbor2	chr8	18023994	18024138	LTR/ERV1	567	+	72	18024066	39036
chr8	17985030	18185030	harbor2	chr8	18082290	18082821	LTR/ERV1	823	+	266	18082556	97526
chr8	23429353	23629353	harbor2	chr8	23489175	23489689	LTR/ERV1	3743	+	257	23489432	60079
chr8	23428870	23628870	harbor2	chr8	23489175	23489689	LTR/ERV1	3743	+	257	23489432	60562
chr8	23429241	23629241	harbor2	chr8	23489175	23489689	LTR/ERV1	3743	+	257	23489432	60191
chr8	10823758	11023758	harbor2	chr8	10829315	10829447	LTR/ERV1	422	+	66	10829381	5623
chr8	10823758	11023758	harbor2	chr8	10837846	10838230	LTR/ERV1	1662	+	192	10838038	14280
chr8	10823758	11023758	harbor2	chr8	10844017	10844689	LTR/ERV1	2278	+	336	10844353	20595
chr8	23428834	23628834	harbor2	chr8	23489175	23489689	LTR/ERV1	3743	+	257	23489432	60598
chr8	29150120	29350120	harbor2	chr8	29208696	29209035	LTR/ERV1	1281	+	170	29208866	58746
chr8	23428832	23628832	harbor2	chr8	23489175	23489689	LTR/ERV1	3743	+	257	23489432	60600
chr8	23428810	23628810	harbor2	chr8	23489175	23489689	LTR/ERV1	3743	+	257	23489432	60622
chr8	23432814	23632814	harbor2	chr8	23489175	23489689	LTR/ERV1	3743	+	257	23489432	56618
chr8	23430803	23630803	harbor2	chr8	23489175	23489689	LTR/ERV1	3743	+	257	23489432	58629
chr8	38169968	38369968	harbor2	chr8	38229500	38229570	LTR/ERV1	594	+	35	38229535	59567
chr8	23428809	23628809	harbor2	chr8	23489175	23489689	LTR/ERV1	3743	+	257	23489432	60623
chr8	23428725	23628725	harbor2	chr8	23489175	23489689	LTR/ERV1	3743	+	257	23489432	60707
chr8	23429172	23629172	harbor2	chr8	23489175	23489689	LTR/ERV1	3743	+	257	23489432	60260
chr8	23428835	23628835	harbor2	chr8	23489175	23489689	LTR/ERV1	3743	+	257	23489432	60597
chr8	23429068	23629068	harbor2	chr8	23489175	23489689	LTR/ERV1	3743	+	257	23489432	60364
chr8	38169167	38369167	harbor2	chr8	38229500	38229570	LTR/ERV1	594	+	35	38229535	60368
chr8	23428926	23628926	harbor2	chr8	23489175	23489689	LTR/ERV1	3743	+	257	23489432	60506
chr8	23428913	23628913	harbor2	chr8	23489175	23489689	LTR/ERV1	3743	+	257	23489432	60519
chr8	90979035	91179035	harbor2	chr8	91041734	91042202	LTR/ERV1	2635	+	234	91041968	62933
chr8	90979035	91179035	harbor2	chr8	91048084	91048901	LTR/ERV1	1181	+	408	91048492	69457
chr8	90979035	91179035	harbor2	chr8	91049212	91049403	LTR/ERV1	1181	+	96	91049308	70273
chr8	23429294	23629294	harbor2	chr8	23489175	23489689	LTR/ERV1	3743	+	257	23489432	60138
chr8	38169193	38369193	harbor2	chr8	38229500	38229570	LTR/ERV1	594	+	35	38229535	60342
chr8	30073247	30273247	harbor2	chr8	30087970	30089243	LTR/ERV1	7820	+	636	30088606	15359
chr8	30073247	30273247	harbor2	chr8	30089803	30089917	LTR/ERV1	444	+	57	30089860	16613
chr8	30073247	30273247	harbor2	chr8	30089929	30090078	LTR/ERV1	648	+	74	30090003	16756
chr8	30073247	30273247	harbor2	chr8	30090520	30090799	LTR/ERV1	1852	+	140	30090660	17413
chr8	30073247	30273247	harbor2	chr8	30133818	30134143	LTR/ERV1	2074	+	162	30133980	60733
chr8	30073247	30273247	harbor2	chr8	30134452	30134538	LTR/ERV1	2074	+	43	30134495	61248
chr8	30073247	30273247	harbor2	chr8	30134848	30134869	LTR/ERV1	2074	+	10	30134858	61611
chr8	30073247	30273247	harbor2	chr8	30135192	30135241	LTR/ERV1	2074	+	24	30135216	61969
chr8	30073247	30273247	harbor2	chr8	30137592	30138312	LTR/ERV1	4106	+	360	30137952	64705
chr8	23429109	23629109	harbor2	chr8	23489175	23489689	LTR/ERV1	3743	+	257	23489432	60323
chr8	102557354	102757354	harbor2	chr8	102581363	102581580	LTR/ERV1	454	+	108	102581471	24117
chr8	102557354	102757354	harbor2	chr8	102593780	102594523	LTR/ERV1	5075	+	372	102594152	36798
chr8	102557354	102757354	harbor2	chr8	102635459	102635922	LTR/ERV1	3370	+	232	102635691	78337
chr8	23428807	23628807	harbor2	chr8	23489175	23489689	LTR/ERV1	3743	+	257	23489432	60625
chr8	23431300	23631300	harbor2	chr8	23489175	23489689	LTR/ERV1	3743	+	257	23489432	58132
chr8	89802895	90002895	harbor2	chr8	89805158	89805694	LTR/ERV1	3925	+	268	89805426	2531
chr8	89802895	90002895	harbor2	chr8	89861203	89861351	LTR/ERV1	692	+	74	89861277	58382
chr8	89802895	90002895	harbor2	chr8	89861429	89861649	LTR/ERV1	1039	+	110	89861539	58644
chr8	89802895	90002895	harbor2	chr8	89861841	89862332	LTR/ERV1	684	+	246	89862087	59192
chr8	89802895	90002895	harbor2	chr8	89862349	89862516	LTR/ERV1	504	+	84	89862433	59538
chr8	89802895	90002895	harbor2	chr8	89862653	89864278	LTR/ERV1	2304	+	812	89863465	60570
chr8	89802895	90002895	harbor2	chr8	89864580	89864773	LTR/ERV1	2304	+	96	89864676	61781
chr8	89802895	90002895	harbor2	chr8	89864783	89865070	LTR/ERV1	1215	+	144	89864927	62032
chr8	89802895	90002895	harbor2	chr8	89865040	89865537	LTR/ERV1	1539	+	248	89865288	62393
chr8	89802895	90002895	harbor2	chr8	89865550	89865735	LTR/ERV1	700	+	92	89865642	62747
chr8	89802895	90002895	harbor2	chr8	89865750	89865955	LTR/ERV1	1037	+	102	89865852	62957
chr8	89802895	90002895	harbor2	chr8	89884862	89885383	LTR/ERV1	2736	+	260	89885122	82227
chr8	23428847	23628847	harbor2	chr8	23489175	23489689	LTR/ERV1	3743	+	257	23489432	60585
chr8	23429149	23629149	harbor2	chr8	23489175	23489689	LTR/ERV1	3743	+	257	23489432	60283
chr8	23430721	23630721	harbor2	chr8	23489175	23489689	LTR/ERV1	3743	+	257	23489432	58711
chr8	27226138	27426138	harbor2	chr8	27232562	27233324	LTR/ERV1	3802	+	381	27232943	6805
chr8	27226138	27426138	harbor2	chr8	27266668	27267412	LTR/ERV1	4191	+	372	27267040	40902
chr8	27226138	27426138	harbor2	chr8	27312595	27312886	LTR/ERV1	1950	+	146	27312741	86603
chr8	27226138	27426138	harbor2	chr8	27314060	27314266	LTR/ERV1	1369	+	103	27314163	88025
chr8	27226138	27426138	harbor2	chr8	27314463	27314820	LTR/ERV1	2532	+	178	27314641	88503
chr8	27226138	27426138	harbor2	chr8	27314951	27315040	LTR/ERV1	425	+	44	27314995	88857
chr8	27226138	27426138	harbor2	chr8	27319987	27320322	LTR/ERV1	2436	+	168	27320155	94017
chr8	27226138	27426138	harbor2	chr8	27229740	27230390	LTR/ERV1	4278	+	325	27230065	3927
chr8	23428862	23628862	harbor2	chr8	23489175	23489689	LTR/ERV1	3743	+	257	23489432	60570
chr8	23429308	23629308	harbor2	chr8	23489175	23489689	LTR/ERV1	3743	+	257	23489432	60124
chr8	90973852	91173852	harbor2	chr8	91041734	91042202	LTR/ERV1	2635	+	234	91041968	68116
chr8	90973852	91173852	harbor2	chr8	91048084	91048901	LTR/ERV1	1181	+	408	91048492	74640
chr8	90973852	91173852	harbor2	chr8	91049212	91049403	LTR/ERV1	1181	+	96	91049308	75456
chr8	38172676	38372676	harbor2	chr8	38229500	38229570	LTR/ERV1	594	+	35	38229535	56859
chr8	23428822	23628822	harbor2	chr8	23489175	23489689	LTR/ERV1	3743	+	257	23489432	60610
chr8	23432595	23632595	harbor2	chr8	23489175	23489689	LTR/ERV1	3743	+	257	23489432	56837
chr8	23428886	23628886	harbor2	chr8	23489175	23489689	LTR/ERV1	3743	+	257	23489432	60546
chr8	23428849	23628849	harbor2	chr8	23489175	23489689	LTR/ERV1	3743	+	257	23489432	60583
chr8	23428839	23628839	harbor2	chr8	23489175	23489689	LTR/ERV1	3743	+	257	23489432	60593
chr8	23447867	23647867	harbor2	chr8	23489175	23489689	LTR/ERV1	3743	+	257	23489432	41565
chr8	30013870	30213870	harbor2	chr8	30035257	30035666	LTR/ERV1	2924	+	204	30035461	21591
chr8	30013870	30213870	harbor2	chr8	30087970	30089243	LTR/ERV1	7820	+	636	30088606	74736
chr8	30013870	30213870	harbor2	chr8	30089803	30089917	LTR/ERV1	444	+	57	30089860	75990
chr8	30013870	30213870	harbor2	chr8	30089929	30090078	LTR/ERV1	648	+	74	30090003	76133
chr8	30013870	30213870	harbor2	chr8	30090520	30090799	LTR/ERV1	1852	+	140	30090660	76790
chr8	23428736	23628736	harbor2	chr8	23489175	23489689	LTR/ERV1	3743	+	257	23489432	60696
chr8	23429123	23629123	harbor2	chr8	23489175	23489689	LTR/ERV1	3743	+	257	23489432	60309
chr8	143477721	143677721	harbor2	chr8	143545687	143546127	LTR/ERV1	2957	+	220	143545907	68186
chr8	143477721	143677721	harbor2	chr8	143547575	143547762	LTR/ERV1	3945	+	94	143547669	69948
chr8	143477721	143677721	harbor2	chr8	143548065	143548370	LTR/ERV1	3945	+	152	143548217	70496
chr8	143477721	143677721	harbor2	chr8	143550508	143550928	LTR/ERV1	2193	+	210	143550718	72997
chr8	143477721	143677721	harbor2	chr8	143551393	143551567	LTR/ERV1	725	+	87	143551480	73759
chr8	141003841	141203841	harbor2	chr8	141076505	141078018	LTR/ERV1	10992	+	756	141077261	73420
chr8	54001877	54201877	harbor2	chr8	54072541	54072619	LTR/ERV1	492	+	39	54072580	70703
chr8	38169170	38369170	harbor2	chr8	38229500	38229570	LTR/ERV1	594	+	35	38229535	60365
chr8	143852180	144052180	harbor2	chr8	143904764	143905037	LTR/ERV1	1922	+	136	143904900	52720
chr8	143852180	144052180	harbor2	chr8	143905197	143905331	LTR/ERV1	1922	+	67	143905264	53084
chr8	143852180	144052180	harbor2	chr8	143905630	143905709	LTR/ERV1	1922	+	40	143905670	53490
chr8	42742785	42942785	harbor2	chr8	42745161	42745301	LTR/ERV1	871	+	70	42745231	2446
chr8	42742785	42942785	harbor2	chr8	42786594	42787999	LTR/ERV1	9757	+	702	42787296	44511
chr8	42742785	42942785	harbor2	chr8	42791914	42792356	LTR/ERV1	2354	+	221	42792135	49350
chr8	42742785	42942785	harbor2	chr8	42795020	42795035	LTR/ERV1	951	+	8	42795028	52243
chr8	42742785	42942785	harbor2	chr8	42795332	42795478	LTR/ERV1	951	+	73	42795405	52620
chr8	42742785	42942785	harbor2	chr8	42795479	42795693	LTR/ERV1	7984	+	107	42795586	52801
chr8	42742785	42942785	harbor2	chr8	42796664	42797705	LTR/ERV1	7984	+	520	42797184	54399
chr8	42742785	42942785	harbor2	chr8	42797733	42798009	LTR/ERV1	1508	+	138	42797871	55086
chr8	42742785	42942785	harbor2	chr8	42803381	42803798	LTR/ERV1	2245	+	208	42803589	60804
chr8	42742785	42942785	harbor2	chr8	42745642	42745898	LTR/ERV1	840	+	128	42745770	2985
chr8	143458753	143658753	harbor2	chr8	143545687	143546127	LTR/ERV1	2957	+	220	143545907	87154
chr8	143458753	143658753	harbor2	chr8	143547575	143547762	LTR/ERV1	3945	+	94	143547669	88916
chr8	143458753	143658753	harbor2	chr8	143548065	143548370	LTR/ERV1	3945	+	152	143548217	89464
chr8	143458753	143658753	harbor2	chr8	143550508	143550928	LTR/ERV1	2193	+	210	143550718	91965
chr8	143458753	143658753	harbor2	chr8	143551393	143551567	LTR/ERV1	725	+	87	143551480	92727
chr8	23428733	23628733	harbor2	chr8	23489175	23489689	LTR/ERV1	3743	+	257	23489432	60699
chr8	23429202	23629202	harbor2	chr8	23489175	23489689	LTR/ERV1	3743	+	257	23489432	60230
chr8	125678475	125878475	harbor2	chr8	125723142	125723686	LTR/ERV1	856	+	272	125723414	44939
chr8	125678475	125878475	harbor2	chr8	125734673	125734846	LTR/ERV1	3976	+	86	125734759	56284
chr8	125678475	125878475	harbor2	chr8	125735169	125735583	LTR/ERV1	3976	+	207	125735376	56901
chr8	125678475	125878475	harbor2	chr8	125750118	125750579	LTR/ERV1	1640	+	230	125750348	71873
chr8	23430734	23630734	harbor2	chr8	23489175	23489689	LTR/ERV1	3743	+	257	23489432	58698
chr8	8292230	8492230	harbor2	chr8	8301989	8302444	LTR/ERV1	2350	+	228	8302217	9987
chr8	8292230	8492230	harbor2	chr8	8322460	8323034	LTR/ERV1	2925	+	287	8322747	30517
chr8	38169192	38369192	harbor2	chr8	38229500	38229570	LTR/ERV1	594	+	35	38229535	60343
chr8	54001882	54201882	harbor2	chr8	54072541	54072619	LTR/ERV1	492	+	39	54072580	70698
chr8	143329372	143529372	harbor2	chr8	143337690	143338148	LTR/ERV1	2473	+	229	143337919	8547
chr8	143329372	143529372	harbor2	chr8	143349195	143349639	LTR/ERV1	1674	+	222	143349417	20045
chr8	143329372	143529372	harbor2	chr8	143350877	143351290	LTR/ERV1	1222	+	206	143351083	21711
chr8	23428636	23628636	harbor2	chr8	23489175	23489689	LTR/ERV1	3743	+	257	23489432	60796
chr8	23428840	23628840	harbor2	chr8	23489175	23489689	LTR/ERV1	3743	+	257	23489432	60592
chr8	8793157	8993157	harbor2	chr8	8807031	8807626	LTR/ERV1	1130	+	298	8807329	14172
chr8	8793157	8993157	harbor2	chr8	8863737	8864233	LTR/ERV1	3071	+	248	8863985	70828
chr8	27543509	27743509	harbor2	chr8	27626558	27627042	LTR/ERV1	3157	+	242	27626800	83291
chr8	27543509	27743509	harbor2	chr8	27632171	27632217	LTR/ERV1	3048	+	23	27632194	88685
chr8	27543509	27743509	harbor2	chr8	27632246	27632815	LTR/ERV1	3048	+	284	27632530	89021
chr8	27543509	27743509	harbor2	chr8	27557494	27557926	LTR/ERV1	2532	+	216	27557710	14201
chr8	25085369	25285369	harbor2	chr8	25164315	25165860	LTR/ERV1	10734	+	772	25165087	79718
chr8	23428828	23628828	harbor2	chr8	23489175	23489689	LTR/ERV1	3743	+	257	23489432	60604
chr8	23428920	23628920	harbor2	chr8	23489175	23489689	LTR/ERV1	3743	+	257	23489432	60512
chr8	29983300	30183300	harbor2	chr8	30006055	30006486	LTR/ERV1	4303	+	216	30006271	22971
chr8	29983300	30183300	harbor2	chr8	30006860	30007217	LTR/ERV1	4303	+	178	30007038	23738
chr8	29983300	30183300	harbor2	chr8	30035257	30035666	LTR/ERV1	2924	+	204	30035461	52161
chr8	23428899	23628899	harbor2	chr8	23489175	23489689	LTR/ERV1	3743	+	257	23489432	60533
chr8	23651754	23851754	harbor2	chr8	23734736	23734835	LTR/ERV1	2127	+	50	23734786	83032
chr8	23651754	23851754	harbor2	chr8	23735128	23735598	LTR/ERV1	2127	+	235	23735363	83609
chr8	600587	800587	harbor2	chr8	607457	607536	LTR/ERV1	799	+	40	607497	6910
chr8	600587	800587	harbor2	chr8	607767	607954	LTR/ERV1	799	+	94	607861	7274
chr8	600587	800587	harbor2	chr8	608250	608404	LTR/ERV1	799	+	77	608327	7740
chr8	600587	800587	harbor2	chr8	653239	653668	LTR/ERV1	2947	+	214	653453	52866
chr8	600587	800587	harbor2	chr8	681781	682194	LTR/ERV1	1449	+	206	681987	81400
chr8	41429283	41629283	harbor2	chr8	41458158	41458581	LTR/ERV1	3050	+	212	41458370	29087
chr8	41429283	41629283	harbor2	chr8	41458746	41458964	LTR/ERV1	1304	+	109	41458855	29572
chr8	41429283	41629283	harbor2	chr8	41479977	41480247	LTR/ERV1	1693	+	135	41480112	50829
chr8	41429283	41629283	harbor2	chr8	41483264	41483614	LTR/ERV1	2078	+	175	41483439	54156
chr8	41429283	41629283	harbor2	chr8	41517954	41518138	LTR/ERV1	497	+	92	41518046	88763
chr8	144280379	144480379	harbor2	chr8	144365288	144365341	LTR/ERV1	692	+	26	144365314	84935
chr8	144280379	144480379	harbor2	chr8	144366958	144367197	LTR/ERV1	692	+	120	144367078	86699
chr8	144280379	144480379	harbor2	chr8	144367888	144368030	LTR/ERV1	666	+	71	144367959	87580
chr8	8795419	8995419	harbor2	chr8	8807031	8807626	LTR/ERV1	1130	+	298	8807329	11910
chr8	8795419	8995419	harbor2	chr8	8894107	8894653	LTR/ERV1	3354	+	273	8894380	98961
chr8	8795419	8995419	harbor2	chr8	8863737	8864233	LTR/ERV1	3071	+	248	8863985	68566
chr8	143960530	144160530	harbor2	chr8	143995654	143996178	LTR/ERV1	2220	+	262	143995916	35386
chr8	144362830	144562830	harbor2	chr8	144365288	144365341	LTR/ERV1	692	+	26	144365314	2484
chr8	144362830	144562830	harbor2	chr8	144366958	144367197	LTR/ERV1	692	+	120	144367078	4248
chr8	144362830	144562830	harbor2	chr8	144367888	144368030	LTR/ERV1	666	+	71	144367959	5129
chr8	144365516	144565516	harbor2	chr8	144366958	144367197	LTR/ERV1	692	+	120	144367078	1562
chr8	144365516	144565516	harbor2	chr8	144367888	144368030	LTR/ERV1	666	+	71	144367959	2443
chr8	142682932	142882932	harbor2	chr8	142688345	142688572	LTR/ERV1	1090	+	114	142688459	5527
chr8	142682932	142882932	harbor2	chr8	142697896	142698333	LTR/ERV1	1724	+	218	142698114	15182
chr8	142682932	142882932	harbor2	chr8	142699004	142699439	LTR/ERV1	2091	+	218	142699222	16290
chr8	142682932	142882932	harbor2	chr8	142721471	142723200	LTR/ERV1	1310	+	864	142722335	39403
chr8	142682932	142882932	harbor2	chr8	142724761	142725128	LTR/ERV1	2776	+	184	142724945	42013
chr8	142682932	142882932	harbor2	chr8	142725256	142725521	LTR/ERV1	2776	+	132	142725388	42456
chr8	142682932	142882932	harbor2	chr8	142758988	142759586	LTR/ERV1	2573	+	299	142759287	76355
chr8	142682932	142882932	harbor2	chr8	142765644	142765678	LTR/ERV1	2772	+	17	142765661	82729
chr8	142682932	142882932	harbor2	chr8	142765993	142766460	LTR/ERV1	2772	+	234	142766227	83295
chr8	142682932	142882932	harbor2	chr8	142720976	142721112	LTR/ERV1	433	+	68	142721044	38112
chr8	142626665	142826665	harbor2	chr8	142646193	142646409	LTR/ERV1	833	+	108	142646301	19636
chr8	142626665	142826665	harbor2	chr8	142653039	142653387	LTR/ERV1	3528	+	174	142653213	26548
chr8	142626665	142826665	harbor2	chr8	142653677	142654028	LTR/ERV1	3528	+	176	142653853	27188
chr8	142626665	142826665	harbor2	chr8	142688345	142688572	LTR/ERV1	1090	+	114	142688459	61794
chr8	142626665	142826665	harbor2	chr8	142697896	142698333	LTR/ERV1	1724	+	218	142698114	71449
chr8	142626665	142826665	harbor2	chr8	142699004	142699439	LTR/ERV1	2091	+	218	142699222	72557
chr8	142626665	142826665	harbor2	chr8	142721471	142723200	LTR/ERV1	1310	+	864	142722335	95670
chr8	142626665	142826665	harbor2	chr8	142724761	142725128	LTR/ERV1	2776	+	184	142724945	98280
chr8	142626665	142826665	harbor2	chr8	142725256	142725521	LTR/ERV1	2776	+	132	142725388	98723
chr8	142626665	142826665	harbor2	chr8	142720976	142721112	LTR/ERV1	433	+	68	142721044	94379
chr8	38169185	38369185	harbor2	chr8	38229500	38229570	LTR/ERV1	594	+	35	38229535	60350
chr8	142739966	142939966	harbor2	chr8	142758988	142759586	LTR/ERV1	2573	+	299	142759287	19321
chr8	142739966	142939966	harbor2	chr8	142765644	142765678	LTR/ERV1	2772	+	17	142765661	25695
chr8	142739966	142939966	harbor2	chr8	142765993	142766460	LTR/ERV1	2772	+	234	142766227	26261
chr8	142739966	142939966	harbor2	chr8	142814860	142815418	LTR/ERV1	2874	+	279	142815139	75173
chr8	142739966	142939966	harbor2	chr8	142824852	142824977	LTR/ERV1	576	+	62	142824914	84948
chr8	142739966	142939966	harbor2	chr8	142825520	142826021	LTR/ERV1	2286	+	250	142825770	85804
chr8	142739966	142939966	harbor2	chr8	142826329	142826371	LTR/ERV1	2286	+	21	142826350	86384
chr8	142739966	142939966	harbor2	chr8	142827880	142828351	LTR/ERV1	2286	+	236	142828116	88150
chr8	142739966	142939966	harbor2	chr8	142828659	142828842	LTR/ERV1	2286	+	92	142828751	88785
chr8	142739966	142939966	harbor2	chr8	142829805	142829911	LTR/ERV1	2286	+	53	142829858	89892
chr8	142739966	142939966	harbor2	chr8	142829932	142830293	LTR/ERV1	533	+	180	142830112	90146
chr8	142739966	142939966	harbor2	chr8	142830593	142830963	LTR/ERV1	1366	+	185	142830778	90812
chr8	142739966	142939966	harbor2	chr8	142830965	142831191	LTR/ERV1	679	+	113	142831078	91112
chr8	142739966	142939966	harbor2	chr8	142831220	142831315	LTR/ERV1	458	+	48	142831268	91302
chr8	142739966	142939966	harbor2	chr8	142831324	142831583	LTR/ERV1	1215	+	130	142831454	91488
chr8	142739966	142939966	harbor2	chr8	142831817	142832484	LTR/ERV1	2178	+	334	142832151	92185
chr8	142739966	142939966	harbor2	chr8	142833396	142833736	LTR/ERV1	1971	+	170	142833566	93600
chr8	142739966	142939966	harbor2	chr8	142834021	142834159	LTR/ERV1	1971	+	69	142834090	94124
chr8	102203037	102403037	harbor2	chr8	102227954	102228861	LTR/ERV1	5638	+	454	102228408	25371
chr8	38172009	38372009	harbor2	chr8	38229500	38229570	LTR/ERV1	594	+	35	38229535	57526
chr8	23456020	23656020	harbor2	chr8	23489175	23489689	LTR/ERV1	3743	+	257	23489432	33412
chr8	38175043	38375043	harbor2	chr8	38229500	38229570	LTR/ERV1	594	+	35	38229535	54492
chr8	115390199	115590199	harbor2	chr8	115400298	115400735	LTR/ERV1	638	+	218	115400516	10317
chr8	23428854	23628854	harbor2	chr8	23489175	23489689	LTR/ERV1	3743	+	257	23489432	60578
chr8	23428795	23628795	harbor2	chr8	23489175	23489689	LTR/ERV1	3743	+	257	23489432	60637
chr8	143982665	144182665	harbor2	chr8	143995654	143996178	LTR/ERV1	2220	+	262	143995916	13251
chr8	143982665	144182665	harbor2	chr8	144061158	144061311	LTR/ERV1	1072	+	76	144061234	78569
chr8	143982665	144182665	harbor2	chr8	144061544	144061740	LTR/ERV1	2092	+	98	144061642	78977
chr8	143982665	144182665	harbor2	chr8	144062038	144062206	LTR/ERV1	2092	+	84	144062122	79457
chr8	143982665	144182665	harbor2	chr8	144067956	144068410	LTR/ERV1	2713	+	227	144068183	85518
chr8	142956401	143156401	harbor2	chr8	142958887	142959238	LTR/ERV1	1701	+	176	142959063	2662
chr8	142956401	143156401	harbor2	chr8	142959226	142959296	LTR/ERV1	650	+	35	142959261	2860
chr8	142956401	143156401	harbor2	chr8	142959297	142960879	LTR/ERV1	11013	+	791	142960088	3687
chr8	142956401	143156401	harbor2	chr8	142960880	142960949	LTR/ERV1	650	+	34	142960914	4513
chr8	142956401	143156401	harbor2	chr8	142960993	142962730	LTR/ERV1	12599	+	868	142961861	5460
chr8	142956401	143156401	harbor2	chr8	142963046	142964082	LTR/ERV1	12599	+	518	142963564	7163
chr8	142956401	143156401	harbor2	chr8	142965165	142965633	LTR/ERV1	12599	+	234	142965399	8998
chr8	142956401	143156401	harbor2	chr8	142965634	142966057	LTR/ERV1	3890	+	212	142965846	9445
chr8	142956401	143156401	harbor2	chr8	142966367	142966487	LTR/ERV1	3890	+	60	142966427	10026
chr8	142956401	143156401	harbor2	chr8	142973058	142973545	LTR/ERV1	2612	+	244	142973302	16901
chr8	142956401	143156401	harbor2	chr8	142991580	142992035	LTR/ERV1	1132	+	228	142991808	35407
chr8	142956401	143156401	harbor2	chr8	142992528	142992845	LTR/ERV1	1518	+	158	142992686	36285
chr8	142956401	143156401	harbor2	chr8	143012539	143012710	LTR/ERV1	624	+	86	143012625	56224
chr8	142956401	143156401	harbor2	chr8	143013063	143013336	LTR/ERV1	970	+	136	143013199	56798
chr8	142956401	143156401	harbor2	chr8	143031416	143031788	LTR/ERV1	1374	+	186	143031602	75201
chr8	142956401	143156401	harbor2	chr8	143031788	143031804	LTR/ERV1	1147	+	8	143031796	75395
chr8	142956401	143156401	harbor2	chr8	143032469	143032701	LTR/ERV1	1147	+	116	143032585	76184
chr8	142956401	143156401	harbor2	chr8	143032712	143032951	LTR/ERV1	597	+	120	143032832	76431
chr8	142956401	143156401	harbor2	chr8	143035572	143036097	LTR/ERV1	1415	+	262	143035834	79433
chr8	142956401	143156401	harbor2	chr8	143037292	143037461	LTR/ERV1	971	+	84	143037376	80975
chr8	142956401	143156401	harbor2	chr8	143039025	143039470	LTR/ERV1	1067	+	222	143039247	82846
chr8	142956401	143156401	harbor2	chr8	143046260	143046295	LTR/ERV1	1155	+	18	143046278	89877
chr8	142956401	143156401	harbor2	chr8	143046596	143046722	LTR/ERV1	1155	+	63	143046659	90258
chr8	142956401	143156401	harbor2	chr8	143047032	143047145	LTR/ERV1	1155	+	56	143047088	90687
chr8	142956401	143156401	harbor2	chr8	143047465	143048063	LTR/ERV1	3826	+	299	143047764	91363
chr8	142956401	143156401	harbor2	chr8	143048905	143049309	LTR/ERV1	1523	+	202	143049107	92706
chr8	142956401	143156401	harbor2	chr8	143050063	143050176	LTR/ERV1	1620	+	56	143050119	93718
chr8	142956401	143156401	harbor2	chr8	143050481	143051280	LTR/ERV1	1620	+	400	143050881	94480
chr8	142956401	143156401	harbor2	chr8	143051569	143051690	LTR/ERV1	1620	+	60	143051629	95228
chr8	142956401	143156401	harbor2	chr8	143052293	143053296	LTR/ERV1	1620	+	502	143052795	96394
chr8	142956401	143156401	harbor2	chr8	143053274	143053798	LTR/ERV1	1298	+	262	143053536	97135
chr8	142956401	143156401	harbor2	chr8	143054337	143054433	LTR/ERV1	424	+	48	143054385	97984
chr8	142956401	143156401	harbor2	chr8	143054498	143055195	LTR/ERV1	2891	+	348	143054846	98445
chr8	142956401	143156401	harbor2	chr8	142966508	142966886	LTR/ERV1	2299	+	189	142966697	10296
chr8	10960481	11160481	harbor2	chr8	11043637	11044506	LTR/ERV1	4417	+	434	11044071	83590
chr8	38169198	38369198	harbor2	chr8	38229500	38229570	LTR/ERV1	594	+	35	38229535	60337
chr8	41849522	42049522	harbor2	chr8	41905366	41905896	LTR/ERV1	3142	+	265	41905631	56109
chr8	138813637	139013637	harbor2	chr8	138831841	138832377	LTR/ERV1	4514	+	268	138832109	18472
chr8	138813637	139013637	harbor2	chr8	138901853	138902180	LTR/ERV1	444	+	164	138902017	88380
chr8	143327452	143527452	harbor2	chr8	143337690	143338148	LTR/ERV1	2473	+	229	143337919	10467
chr8	143327452	143527452	harbor2	chr8	143349195	143349639	LTR/ERV1	1674	+	222	143349417	21965
chr8	143327452	143527452	harbor2	chr8	143350877	143351290	LTR/ERV1	1222	+	206	143351083	23631
chr8	102598762	102798762	harbor2	chr8	102635459	102635922	LTR/ERV1	3370	+	232	102635691	36929
chr8	102598762	102798762	harbor2	chr8	102691498	102691526	LTR/ERV1	2081	+	14	102691512	92750
chr8	102598762	102798762	harbor2	chr8	102691558	102691951	LTR/ERV1	2081	+	196	102691754	92992
chr8	23429259	23629259	harbor2	chr8	23489175	23489689	LTR/ERV1	3743	+	257	23489432	60173
chr8	144365278	144565278	harbor2	chr8	144365288	144365341	LTR/ERV1	692	+	26	144365314	36
chr8	144365278	144565278	harbor2	chr8	144366958	144367197	LTR/ERV1	692	+	120	144367078	1800
chr8	144365278	144565278	harbor2	chr8	144367888	144368030	LTR/ERV1	666	+	71	144367959	2681
chr8	30059382	30259382	harbor2	chr8	30087970	30089243	LTR/ERV1	7820	+	636	30088606	29224
chr8	30059382	30259382	harbor2	chr8	30089803	30089917	LTR/ERV1	444	+	57	30089860	30478
chr8	30059382	30259382	harbor2	chr8	30089929	30090078	LTR/ERV1	648	+	74	30090003	30621
chr8	30059382	30259382	harbor2	chr8	30090520	30090799	LTR/ERV1	1852	+	140	30090660	31278
chr8	30059382	30259382	harbor2	chr8	30133818	30134143	LTR/ERV1	2074	+	162	30133980	74598
chr8	30059382	30259382	harbor2	chr8	30134452	30134538	LTR/ERV1	2074	+	43	30134495	75113
chr8	30059382	30259382	harbor2	chr8	30134848	30134869	LTR/ERV1	2074	+	10	30134858	75476
chr8	30059382	30259382	harbor2	chr8	30135192	30135241	LTR/ERV1	2074	+	24	30135216	75834
chr8	30059382	30259382	harbor2	chr8	30137592	30138312	LTR/ERV1	4106	+	360	30137952	78570
chr8	30068591	30268591	harbor2	chr8	30087970	30089243	LTR/ERV1	7820	+	636	30088606	20015
chr8	30068591	30268591	harbor2	chr8	30089803	30089917	LTR/ERV1	444	+	57	30089860	21269
chr8	30068591	30268591	harbor2	chr8	30089929	30090078	LTR/ERV1	648	+	74	30090003	21412
chr8	30068591	30268591	harbor2	chr8	30090520	30090799	LTR/ERV1	1852	+	140	30090660	22069
chr8	30068591	30268591	harbor2	chr8	30133818	30134143	LTR/ERV1	2074	+	162	30133980	65389
chr8	30068591	30268591	harbor2	chr8	30134452	30134538	LTR/ERV1	2074	+	43	30134495	65904
chr8	30068591	30268591	harbor2	chr8	30134848	30134869	LTR/ERV1	2074	+	10	30134858	66267
chr8	30068591	30268591	harbor2	chr8	30135192	30135241	LTR/ERV1	2074	+	24	30135216	66625
chr8	30068591	30268591	harbor2	chr8	30137592	30138312	LTR/ERV1	4106	+	360	30137952	69361
chr8	89884671	90084671	harbor2	chr8	89884862	89885383	LTR/ERV1	2736	+	260	89885122	451
chr8	89884671	90084671	harbor2	chr8	89944147	89944218	LTR/ERV1	420	+	36	89944183	59512
chr8	89884671	90084671	harbor2	chr8	89944219	89944631	LTR/ERV1	2168	+	206	89944425	59754
chr8	23428874	23628874	harbor2	chr8	23489175	23489689	LTR/ERV1	3743	+	257	23489432	60558
chr8	38169188	38369188	harbor2	chr8	38229500	38229570	LTR/ERV1	594	+	35	38229535	60347
chr8	73779046	73979046	harbor2	chr8	73821865	73821965	LTR/ERV1	881	+	50	73821915	42869
chr8	73779046	73979046	harbor2	chr8	73821988	73822277	LTR/ERV1	2414	+	144	73822132	43086
chr8	73779046	73979046	harbor2	chr8	73822278	73822603	LTR/ERV1	2737	+	162	73822440	43394
chr8	73779046	73979046	harbor2	chr8	73838813	73839150	LTR/ERV1	2367	+	168	73838981	59935
chr9	4884805	5084805	harbor2	chr9	4886929	4887563	LTR/ERV1	5132	+	317	4887246	2441
chr9	4886038	5086038	harbor2	chr9	4886929	4887563	LTR/ERV1	5132	+	317	4887246	1208
chr9	4884737	5084737	harbor2	chr9	4886929	4887563	LTR/ERV1	5132	+	317	4887246	2509
chr9	4884821	5084821	harbor2	chr9	4886929	4887563	LTR/ERV1	5132	+	317	4887246	2425
chr9	4886039	5086039	harbor2	chr9	4886929	4887563	LTR/ERV1	5132	+	317	4887246	1207
chr9	4884782	5084782	harbor2	chr9	4886929	4887563	LTR/ERV1	5132	+	317	4887246	2464
chr9	21909388	22109388	harbor2	chr9	21921892	21922597	LTR/ERV1	3892	+	352	21922244	12856
chr9	21909388	22109388	harbor2	chr9	21922598	21928866	LTR/ERV1	21619	+	3134	21925732	16344
chr9	21909388	22109388	harbor2	chr9	21930151	21931320	LTR/ERV1	7668	+	584	21930735	21347
chr9	21909388	22109388	harbor2	chr9	21931321	21931935	LTR/ERV1	1732	+	307	21931628	22240
chr9	21909388	22109388	harbor2	chr9	21932126	21932869	LTR/ERV1	4183	+	372	21932498	23110
chr9	21909388	22109388	harbor2	chr9	21933242	21933453	LTR/ERV1	761	+	106	21933348	23960
chr9	21909388	22109388	harbor2	chr9	21933459	21933961	LTR/ERV1	1974	+	251	21933710	24322
chr9	21909388	22109388	harbor2	chr9	21934395	21934697	LTR/ERV1	1974	+	151	21934546	25158
chr9	21909388	22109388	harbor2	chr9	21934999	21935173	LTR/ERV1	1974	+	87	21935086	25698
chr9	21909388	22109388	harbor2	chr9	21936430	21937070	LTR/ERV1	4379	+	320	21936750	27362
chr9	21909388	22109388	harbor2	chr9	21937349	21937857	LTR/ERV1	4379	+	254	21937603	28215
chr9	21909388	22109388	harbor2	chr9	21938465	21938948	LTR/ERV1	4379	+	242	21938707	29319
chr9	21909388	22109388	harbor2	chr9	21939295	21939581	LTR/ERV1	4379	+	143	21939438	30050
chr9	21909388	22109388	harbor2	chr9	21939896	21939999	LTR/ERV1	4379	+	52	21939948	30560
chr9	21909388	22109388	harbor2	chr9	21940099	21940551	LTR/ERV1	4379	+	226	21940325	30937
chr9	21909388	22109388	harbor2	chr9	21959076	21960297	LTR/ERV1	7632	+	610	21959686	50298
chr9	21909388	22109388	harbor2	chr9	21960298	21960419	LTR/ERV1	956	+	60	21960358	50970
chr9	21909388	22109388	harbor2	chr9	21966282	21966570	LTR/ERV1	1522	+	144	21966426	57038
chr9	4886275	5086275	harbor2	chr9	4886929	4887563	LTR/ERV1	5132	+	317	4887246	971
chr9	4692826	4892826	harbor2	chr9	4758445	4758862	LTR/ERV1	1167	+	208	4758653	65827
chr9	4692782	4892782	harbor2	chr9	4758445	4758862	LTR/ERV1	1167	+	208	4758653	65871
chr9	4884843	5084843	harbor2	chr9	4886929	4887563	LTR/ERV1	5132	+	317	4887246	2403
chr9	4884788	5084788	harbor2	chr9	4886929	4887563	LTR/ERV1	5132	+	317	4887246	2458
chr9	4692810	4892810	harbor2	chr9	4758445	4758862	LTR/ERV1	1167	+	208	4758653	65843
chr9	4886030	5086030	harbor2	chr9	4886929	4887563	LTR/ERV1	5132	+	317	4887246	1216
chr9	4884822	5084822	harbor2	chr9	4886929	4887563	LTR/ERV1	5132	+	317	4887246	2424
chr9	112389442	112589442	harbor2	chr9	112472126	112472435	LTR/ERV1	1622	+	154	112472280	82838
chr9	4694791	4894791	harbor2	chr9	4758445	4758862	LTR/ERV1	1167	+	208	4758653	63862
chr9	136639478	136839478	harbor2	chr9	136693167	136693434	LTR/ERV1	1258	+	134	136693301	53823
chr9	136639478	136839478	harbor2	chr9	136704861	136705030	LTR/ERV1	979	+	84	136704945	65467
chr9	136639478	136839478	harbor2	chr9	136705353	136705519	LTR/ERV1	979	+	83	136705436	65958
chr9	4884859	5084859	harbor2	chr9	4886929	4887563	LTR/ERV1	5132	+	317	4887246	2387
chr9	4884785	5084785	harbor2	chr9	4886929	4887563	LTR/ERV1	5132	+	317	4887246	2461
chr9	137070385	137270385	harbor2	chr9	137075103	137075645	LTR/ERV1	3968	+	271	137075374	4989
chr9	112387666	112587666	harbor2	chr9	112472126	112472435	LTR/ERV1	1622	+	154	112472280	84614
chr9	4884771	5084771	harbor2	chr9	4886929	4887563	LTR/ERV1	5132	+	317	4887246	2475
chr9	4885574	5085574	harbor2	chr9	4886929	4887563	LTR/ERV1	5132	+	317	4887246	1672
chr9	4884790	5084790	harbor2	chr9	4886929	4887563	LTR/ERV1	5132	+	317	4887246	2456
chr9	4692766	4892766	harbor2	chr9	4758445	4758862	LTR/ERV1	1167	+	208	4758653	65887
chr9	4886294	5086294	harbor2	chr9	4886929	4887563	LTR/ERV1	5132	+	317	4887246	952
chr9	4692809	4892809	harbor2	chr9	4758445	4758862	LTR/ERV1	1167	+	208	4758653	65844
chr9	4885943	5085943	harbor2	chr9	4886929	4887563	LTR/ERV1	5132	+	317	4887246	1303
chr9	4884804	5084804	harbor2	chr9	4886929	4887563	LTR/ERV1	5132	+	317	4887246	2442
chr9	137358533	137558533	harbor2	chr9	137375951	137376062	LTR/ERV1	1897	+	56	137376007	17474
chr9	137358533	137558533	harbor2	chr9	137376373	137376647	LTR/ERV1	1897	+	137	137376510	17977
chr9	137358533	137558533	harbor2	chr9	137376949	137377101	LTR/ERV1	1897	+	76	137377025	18492
chr9	137358533	137558533	harbor2	chr9	137418377	137418703	LTR/ERV1	1325	+	163	137418540	60007
chr9	137358533	137558533	harbor2	chr9	137418686	137419387	LTR/ERV1	8501	+	350	137419036	60503
chr9	137358533	137558533	harbor2	chr9	137419698	137419877	LTR/ERV1	8501	+	90	137419788	61255
chr9	137358533	137558533	harbor2	chr9	137420178	137420819	LTR/ERV1	8501	+	320	137420498	61965
chr9	137358533	137558533	harbor2	chr9	137421116	137421142	LTR/ERV1	8501	+	13	137421129	62596
chr9	137358533	137558533	harbor2	chr9	137421241	137421562	LTR/ERV1	8501	+	160	137421401	62868
chr9	137358533	137558533	harbor2	chr9	137421867	137422205	LTR/ERV1	1534	+	169	137422036	63503
chr9	4730682	4930682	harbor2	chr9	4758445	4758862	LTR/ERV1	1167	+	208	4758653	27971
chr9	4884786	5084786	harbor2	chr9	4886929	4887563	LTR/ERV1	5132	+	317	4887246	2460
chr9	4884800	5084800	harbor2	chr9	4886929	4887563	LTR/ERV1	5132	+	317	4887246	2446
chr9	4884853	5084853	harbor2	chr9	4886929	4887563	LTR/ERV1	5132	+	317	4887246	2393
chr9	4885772	5085772	harbor2	chr9	4886929	4887563	LTR/ERV1	5132	+	317	4887246	1474
chr9	4692868	4892868	harbor2	chr9	4758445	4758862	LTR/ERV1	1167	+	208	4758653	65785
chr9	4880270	5080270	harbor2	chr9	4886929	4887563	LTR/ERV1	5132	+	317	4887246	6976
chr9	111797010	111997010	harbor2	chr9	111808417	111808886	LTR/ERV1	3397	+	234	111808651	11641
chr9	111797010	111997010	harbor2	chr9	111810243	111810973	LTR/ERV1	3185	+	365	111810608	13598
chr9	111797010	111997010	harbor2	chr9	111868286	111868935	LTR/ERV1	4302	+	324	111868610	71600
chr9	111797010	111997010	harbor2	chr9	111871411	111871837	LTR/ERV1	2842	+	213	111871624	74614
chr9	4693721	4893721	harbor2	chr9	4758445	4758862	LTR/ERV1	1167	+	208	4758653	64932
chr9	4884777	5084777	harbor2	chr9	4886929	4887563	LTR/ERV1	5132	+	317	4887246	2469
chr9	133682117	133882117	harbor2	chr9	133735498	133735761	LTR/ERV1	3400	+	132	133735630	53513
chr9	133682117	133882117	harbor2	chr9	133736060	133736384	LTR/ERV1	3400	+	162	133736222	54105
chr9	133682117	133882117	harbor2	chr9	133736696	133736747	LTR/ERV1	3400	+	26	133736722	54605
chr9	133682117	133882117	harbor2	chr9	133753678	133754166	LTR/ERV1	3605	+	244	133753922	71805
chr9	4884851	5084851	harbor2	chr9	4886929	4887563	LTR/ERV1	5132	+	317	4887246	2395
chr9	4729013	4929013	harbor2	chr9	4758445	4758862	LTR/ERV1	1167	+	208	4758653	29640
chr9	4884799	5084799	harbor2	chr9	4886929	4887563	LTR/ERV1	5132	+	317	4887246	2447
chr9	4884830	5084830	harbor2	chr9	4886929	4887563	LTR/ERV1	5132	+	317	4887246	2416
chr9	112387642	112587642	harbor2	chr9	112472126	112472435	LTR/ERV1	1622	+	154	112472280	84638
chr9	4884809	5084809	harbor2	chr9	4886929	4887563	LTR/ERV1	5132	+	317	4887246	2437
chr9	4692828	4892828	harbor2	chr9	4758445	4758862	LTR/ERV1	1167	+	208	4758653	65825
chr9	5596372	5796372	harbor2	chr9	5598997	5599420	LTR/ERV1	2170	+	212	5599209	2837
chr9	5596372	5796372	harbor2	chr9	5674482	5674935	LTR/ERV1	2965	+	226	5674708	78336
chr9	5596372	5796372	harbor2	chr9	5675904	5676105	LTR/ERV1	1386	+	100	5676004	79632
chr9	4886033	5086033	harbor2	chr9	4886929	4887563	LTR/ERV1	5132	+	317	4887246	1213
chr9	4692895	4892895	harbor2	chr9	4758445	4758862	LTR/ERV1	1167	+	208	4758653	65758
chr9	69292250	69492250	harbor2	chr9	69347465	69347830	LTR/ERV1	738	+	182	69347647	55397
chr9	4884854	5084854	harbor2	chr9	4886929	4887563	LTR/ERV1	5132	+	317	4887246	2392
chr9	4693416	4893416	harbor2	chr9	4758445	4758862	LTR/ERV1	1167	+	208	4758653	65237
chr9	4886098	5086098	harbor2	chr9	4886929	4887563	LTR/ERV1	5132	+	317	4887246	1148
chr9	4885756	5085756	harbor2	chr9	4886929	4887563	LTR/ERV1	5132	+	317	4887246	1490
chr9	4693543	4893543	harbor2	chr9	4758445	4758862	LTR/ERV1	1167	+	208	4758653	65110
chr9	4823950	5023950	harbor2	chr9	4886929	4887563	LTR/ERV1	5132	+	317	4887246	63296
chr9	137069399	137269399	harbor2	chr9	137075103	137075645	LTR/ERV1	3968	+	271	137075374	5975
chr9	112387652	112587652	harbor2	chr9	112472126	112472435	LTR/ERV1	1622	+	154	112472280	84628
chr9	4884826	5084826	harbor2	chr9	4886929	4887563	LTR/ERV1	5132	+	317	4887246	2420
chr9	128001718	128201718	harbor2	chr9	128084096	128084260	LTR/ERV1	960	+	82	128084178	82460
chr9	128001718	128201718	harbor2	chr9	128084466	128084801	LTR/ERV1	1954	+	168	128084634	82916
chr9	4751660	4951660	harbor2	chr9	4758445	4758862	LTR/ERV1	1167	+	208	4758653	6993
chr9	135599679	135799679	harbor2	chr9	135625356	135625939	LTR/ERV1	4313	+	292	135625648	25969
chr9	135599679	135799679	harbor2	chr9	135644567	135645131	LTR/ERV1	3293	+	282	135644849	45170
chr9	135599679	135799679	harbor2	chr9	135645972	135646417	LTR/ERV1	2683	+	222	135646194	46515
chr9	135599679	135799679	harbor2	chr9	135646608	135647364	LTR/ERV1	5147	+	378	135646986	47307
chr9	135599679	135799679	harbor2	chr9	135647365	135647751	LTR/ERV1	1290	+	193	135647558	47879
chr9	135599679	135799679	harbor2	chr9	135647884	135648220	LTR/ERV1	1408	+	168	135648052	48373
chr9	135599679	135799679	harbor2	chr9	135648406	135648518	LTR/ERV1	1271	+	56	135648462	48783
chr9	135599679	135799679	harbor2	chr9	135649158	135649564	LTR/ERV1	1271	+	203	135649361	49682
chr9	135599679	135799679	harbor2	chr9	135649736	135650310	LTR/ERV1	2225	+	287	135650023	50344
chr9	135599679	135799679	harbor2	chr9	135650312	135650448	LTR/ERV1	540	+	68	135650380	50701
chr9	135599679	135799679	harbor2	chr9	135650751	135651022	LTR/ERV1	1142	+	136	135650887	51208
chr9	135599679	135799679	harbor2	chr9	135651022	135651165	LTR/ERV1	831	+	72	135651094	51415
chr9	135599679	135799679	harbor2	chr9	135652210	135652488	LTR/ERV1	3942	+	139	135652349	52670
chr9	135599679	135799679	harbor2	chr9	135653246	135653833	LTR/ERV1	3942	+	294	135653540	53861
chr9	135599679	135799679	harbor2	chr9	135654131	135654261	LTR/ERV1	3942	+	65	135654196	54517
chr9	135599679	135799679	harbor2	chr9	135654258	135654625	LTR/ERV1	1672	+	184	135654442	54763
chr9	135599679	135799679	harbor2	chr9	135656414	135656506	LTR/ERV1	3925	+	46	135656460	56781
chr9	135599679	135799679	harbor2	chr9	135656823	135657341	LTR/ERV1	3925	+	259	135657082	57403
chr9	135599679	135799679	harbor2	chr9	135657351	135658342	LTR/ERV1	16765	+	496	135657847	58168
chr9	135599679	135799679	harbor2	chr9	135660671	135660751	LTR/ERV1	5289	+	40	135660711	61032
chr9	135599679	135799679	harbor2	chr9	135661050	135661580	LTR/ERV1	5289	+	265	135661315	61636
chr9	135599679	135799679	harbor2	chr9	135661871	135662290	LTR/ERV1	5289	+	210	135662081	62402
chr9	135599679	135799679	harbor2	chr9	135662291	135662919	LTR/ERV1	3987	+	314	135662605	62926
chr9	135599679	135799679	harbor2	chr9	135658647	135660564	LTR/ERV1	16765	+	958	135659605	59926
chr9	4694621	4894621	harbor2	chr9	4758445	4758862	LTR/ERV1	1167	+	208	4758653	64032
chr9	135994504	136194504	harbor2	chr9	136028520	136030023	LTR/ERV1	8133	+	752	136029272	34768
chr9	135994504	136194504	harbor2	chr9	136073538	136074013	LTR/ERV1	1222	+	238	136073776	79272
chr9	135994504	136194504	harbor2	chr9	136076191	136076346	LTR/ERV1	490	+	78	136076269	81765
chr9	4886446	5086446	harbor2	chr9	4886929	4887563	LTR/ERV1	5132	+	317	4887246	800
chr9	4692744	4892744	harbor2	chr9	4758445	4758862	LTR/ERV1	1167	+	208	4758653	65909
chr9	4693371	4893371	harbor2	chr9	4758445	4758862	LTR/ERV1	1167	+	208	4758653	65282
chr9	133064003	133264003	harbor2	chr9	133074537	133075038	LTR/ERV1	4283	+	250	133074787	10784
chr9	133064003	133264003	harbor2	chr9	133075353	133075707	LTR/ERV1	4283	+	177	133075530	11527
chr9	133064003	133264003	harbor2	chr9	133080128	133080326	LTR/ERV1	1005	+	99	133080227	16224
chr9	133064003	133264003	harbor2	chr9	133089366	133089708	LTR/ERV1	2506	+	171	133089537	25534
chr9	133064003	133264003	harbor2	chr9	133089996	133090078	LTR/ERV1	2506	+	41	133090037	26034
chr9	4693463	4893463	harbor2	chr9	4758445	4758862	LTR/ERV1	1167	+	208	4758653	65190
chr9	4728727	4928727	harbor2	chr9	4758445	4758862	LTR/ERV1	1167	+	208	4758653	29926
chr9	92959665	93159665	harbor2	chr9	92977789	92978000	LTR/ERV1	2799	+	106	92977895	18230
chr9	92959665	93159665	harbor2	chr9	92978307	92978659	LTR/ERV1	2799	+	176	92978483	18818
chr9	112647605	112847605	harbor2	chr9	112693146	112693678	LTR/ERV1	1347	+	266	112693412	45807
chr9	112647605	112847605	harbor2	chr9	112715035	112715112	LTR/ERV1	546	+	38	112715073	67468
chr9	4884787	5084787	harbor2	chr9	4886929	4887563	LTR/ERV1	5132	+	317	4887246	2459
chr9	4885119	5085119	harbor2	chr9	4886929	4887563	LTR/ERV1	5132	+	317	4887246	2127
chr9	4692900	4892900	harbor2	chr9	4758445	4758862	LTR/ERV1	1167	+	208	4758653	65753
chr9	112422739	112622739	harbor2	chr9	112472126	112472435	LTR/ERV1	1622	+	154	112472280	49541
chr9	4692825	4892825	harbor2	chr9	4758445	4758862	LTR/ERV1	1167	+	208	4758653	65828
chr9	4692909	4892909	harbor2	chr9	4758445	4758862	LTR/ERV1	1167	+	208	4758653	65744
chr9	4693624	4893624	harbor2	chr9	4758445	4758862	LTR/ERV1	1167	+	208	4758653	65029
chr9	4884754	5084754	harbor2	chr9	4886929	4887563	LTR/ERV1	5132	+	317	4887246	2492
chr9	137029761	137229761	harbor2	chr9	137058489	137058981	LTR/ERV1	3276	+	246	137058735	28974
chr9	137029761	137229761	harbor2	chr9	137075103	137075645	LTR/ERV1	3968	+	271	137075374	45613
chr9	4884882	5084882	harbor2	chr9	4886929	4887563	LTR/ERV1	5132	+	317	4887246	2364
chr9	4692802	4892802	harbor2	chr9	4758445	4758862	LTR/ERV1	1167	+	208	4758653	65851
chr9	4884779	5084779	harbor2	chr9	4886929	4887563	LTR/ERV1	5132	+	317	4887246	2467
chr9	135599667	135799667	harbor2	chr9	135625356	135625939	LTR/ERV1	4313	+	292	135625648	25981
chr9	135599667	135799667	harbor2	chr9	135644567	135645131	LTR/ERV1	3293	+	282	135644849	45182
chr9	135599667	135799667	harbor2	chr9	135645972	135646417	LTR/ERV1	2683	+	222	135646194	46527
chr9	135599667	135799667	harbor2	chr9	135646608	135647364	LTR/ERV1	5147	+	378	135646986	47319
chr9	135599667	135799667	harbor2	chr9	135647365	135647751	LTR/ERV1	1290	+	193	135647558	47891
chr9	135599667	135799667	harbor2	chr9	135647884	135648220	LTR/ERV1	1408	+	168	135648052	48385
chr9	135599667	135799667	harbor2	chr9	135648406	135648518	LTR/ERV1	1271	+	56	135648462	48795
chr9	135599667	135799667	harbor2	chr9	135649158	135649564	LTR/ERV1	1271	+	203	135649361	49694
chr9	135599667	135799667	harbor2	chr9	135649736	135650310	LTR/ERV1	2225	+	287	135650023	50356
chr9	135599667	135799667	harbor2	chr9	135650312	135650448	LTR/ERV1	540	+	68	135650380	50713
chr9	135599667	135799667	harbor2	chr9	135650751	135651022	LTR/ERV1	1142	+	136	135650887	51220
chr9	135599667	135799667	harbor2	chr9	135651022	135651165	LTR/ERV1	831	+	72	135651094	51427
chr9	135599667	135799667	harbor2	chr9	135652210	135652488	LTR/ERV1	3942	+	139	135652349	52682
chr9	135599667	135799667	harbor2	chr9	135653246	135653833	LTR/ERV1	3942	+	294	135653540	53873
chr9	135599667	135799667	harbor2	chr9	135654131	135654261	LTR/ERV1	3942	+	65	135654196	54529
chr9	135599667	135799667	harbor2	chr9	135654258	135654625	LTR/ERV1	1672	+	184	135654442	54775
chr9	135599667	135799667	harbor2	chr9	135656414	135656506	LTR/ERV1	3925	+	46	135656460	56793
chr9	135599667	135799667	harbor2	chr9	135656823	135657341	LTR/ERV1	3925	+	259	135657082	57415
chr9	135599667	135799667	harbor2	chr9	135657351	135658342	LTR/ERV1	16765	+	496	135657847	58180
chr9	135599667	135799667	harbor2	chr9	135660671	135660751	LTR/ERV1	5289	+	40	135660711	61044
chr9	135599667	135799667	harbor2	chr9	135661050	135661580	LTR/ERV1	5289	+	265	135661315	61648
chr9	135599667	135799667	harbor2	chr9	135661871	135662290	LTR/ERV1	5289	+	210	135662081	62414
chr9	135599667	135799667	harbor2	chr9	135662291	135662919	LTR/ERV1	3987	+	314	135662605	62938
chr9	135599667	135799667	harbor2	chr9	135658647	135660564	LTR/ERV1	16765	+	958	135659605	59938
chr9	112387662	112587662	harbor2	chr9	112472126	112472435	LTR/ERV1	1622	+	154	112472280	84618
chr9	4693135	4893135	harbor2	chr9	4758445	4758862	LTR/ERV1	1167	+	208	4758653	65518
chr9	4692731	4892731	harbor2	chr9	4758445	4758862	LTR/ERV1	1167	+	208	4758653	65922
chr9	4734149	4934149	harbor2	chr9	4758445	4758862	LTR/ERV1	1167	+	208	4758653	24504
chr9	4884735	5084735	harbor2	chr9	4886929	4887563	LTR/ERV1	5132	+	317	4887246	2511
chr9	133071539	133271539	harbor2	chr9	133074537	133075038	LTR/ERV1	4283	+	250	133074787	3248
chr9	133071539	133271539	harbor2	chr9	133075353	133075707	LTR/ERV1	4283	+	177	133075530	3991
chr9	133071539	133271539	harbor2	chr9	133080128	133080326	LTR/ERV1	1005	+	99	133080227	8688
chr9	133071539	133271539	harbor2	chr9	133089366	133089708	LTR/ERV1	2506	+	171	133089537	17998
chr9	133071539	133271539	harbor2	chr9	133089996	133090078	LTR/ERV1	2506	+	41	133090037	18498
chr9	4693367	4893367	harbor2	chr9	4758445	4758862	LTR/ERV1	1167	+	208	4758653	65286
chr9	20286384	20486384	harbor2	chr9	20337537	20337708	LTR/ERV1	547	+	86	20337623	51239
chr9	20286384	20486384	harbor2	chr9	20337996	20338356	LTR/ERV1	1613	+	180	20338176	51792
chr9	137316862	137516862	harbor2	chr9	137375951	137376062	LTR/ERV1	1897	+	56	137376007	59145
chr9	137316862	137516862	harbor2	chr9	137376373	137376647	LTR/ERV1	1897	+	137	137376510	59648
chr9	137316862	137516862	harbor2	chr9	137376949	137377101	LTR/ERV1	1897	+	76	137377025	60163
chr9	4885199	5085199	harbor2	chr9	4886929	4887563	LTR/ERV1	5132	+	317	4887246	2047
chr9	137029768	137229768	harbor2	chr9	137058489	137058981	LTR/ERV1	3276	+	246	137058735	28967
chr9	137029768	137229768	harbor2	chr9	137075103	137075645	LTR/ERV1	3968	+	271	137075374	45606
chr9	130746613	130946613	harbor2	chr9	130817152	130817741	LTR/ERV1	5154	+	294	130817446	70833
chr9	91323874	91523874	harbor2	chr9	91327216	91328114	LTR/ERV1	3181	+	449	91327665	3791
chr9	91323874	91523874	harbor2	chr9	91343907	91344533	LTR/ERV1	2901	+	313	91344220	20346
chr9	91323874	91523874	harbor2	chr9	91364086	91365196	LTR/ERV1	4912	+	555	91364641	40767
chr9	4694263	4894263	harbor2	chr9	4758445	4758862	LTR/ERV1	1167	+	208	4758653	64390
chr9	136610462	136810462	harbor2	chr9	136693167	136693434	LTR/ERV1	1258	+	134	136693301	82839
chr9	136610462	136810462	harbor2	chr9	136704861	136705030	LTR/ERV1	979	+	84	136704945	94483
chr9	136610462	136810462	harbor2	chr9	136705353	136705519	LTR/ERV1	979	+	83	136705436	94974
chr9	4692878	4892878	harbor2	chr9	4758445	4758862	LTR/ERV1	1167	+	208	4758653	65775
chr9	137069338	137269338	harbor2	chr9	137075103	137075645	LTR/ERV1	3968	+	271	137075374	6036
chr9	4886398	5086398	harbor2	chr9	4886929	4887563	LTR/ERV1	5132	+	317	4887246	848
chr9	131637199	131837199	harbor2	chr9	131688524	131688649	LTR/ERV1	671	+	62	131688586	51387
chr9	131637199	131837199	harbor2	chr9	131688926	131689007	LTR/ERV1	671	+	40	131688966	51767
chr9	131637199	131837199	harbor2	chr9	131689422	131689539	LTR/ERV1	1101	+	58	131689480	52281
chr9	131637199	131837199	harbor2	chr9	131689838	131690514	LTR/ERV1	1101	+	338	131690176	52977
chr9	131637199	131837199	harbor2	chr9	131690920	131692762	LTR/ERV1	2583	+	921	131691841	54642
chr9	131637199	131837199	harbor2	chr9	131692813	131693302	LTR/ERV1	2364	+	244	131693057	55858
chr9	131637199	131837199	harbor2	chr9	131693303	131693729	LTR/ERV1	2446	+	213	131693516	56317
chr9	131637199	131837199	harbor2	chr9	131695660	131695793	LTR/ERV1	483	+	66	131695726	58527
chr9	91845860	92045860	harbor2	chr9	91930298	91930614	LTR/ERV1	1660	+	158	91930456	84596
chr9	133063982	133263982	harbor2	chr9	133074537	133075038	LTR/ERV1	4283	+	250	133074787	10805
chr9	133063982	133263982	harbor2	chr9	133075353	133075707	LTR/ERV1	4283	+	177	133075530	11548
chr9	133063982	133263982	harbor2	chr9	133080128	133080326	LTR/ERV1	1005	+	99	133080227	16245
chr9	133063982	133263982	harbor2	chr9	133089366	133089708	LTR/ERV1	2506	+	171	133089537	25555
chr9	133063982	133263982	harbor2	chr9	133089996	133090078	LTR/ERV1	2506	+	41	133090037	26055
chr9	5394375	5594375	harbor2	chr9	5398804	5399323	LTR/ERV1	2059	+	260	5399064	4689
chr9	99191390	99391390	harbor2	chr9	99196421	99196877	LTR/ERV1	3382	+	228	99196649	5259
chr9	67768338	67968338	harbor2	chr9	67786632	67787056	LTR/ERV1	1656	+	212	67786844	18506
chr9	67768338	67968338	harbor2	chr9	67824290	67825160	LTR/ERV1	4677	+	435	67824725	56387
chr9	67768338	67968338	harbor2	chr9	67847343	67847729	LTR/ERV1	1331	+	193	67847536	79198
chr9	130839891	131039891	harbor2	chr9	130909938	130911357	LTR/ERV1	10007	+	710	130910648	70757
chr9	4885182	5085182	harbor2	chr9	4886929	4887563	LTR/ERV1	5132	+	317	4887246	2064
chr9	4884847	5084847	harbor2	chr9	4886929	4887563	LTR/ERV1	5132	+	317	4887246	2399
chr9	4885867	5085867	harbor2	chr9	4886929	4887563	LTR/ERV1	5132	+	317	4887246	1379
chr9	4692808	4892808	harbor2	chr9	4758445	4758862	LTR/ERV1	1167	+	208	4758653	65845
chr9	135467518	135667518	harbor2	chr9	135468602	135469313	LTR/ERV1	4589	+	356	135468958	1440
chr9	135467518	135667518	harbor2	chr9	135469564	135469755	LTR/ERV1	2704	+	96	135469660	2142
chr9	135467518	135667518	harbor2	chr9	135470035	135470603	LTR/ERV1	2704	+	284	135470319	2801
chr9	135467518	135667518	harbor2	chr9	135543388	135543932	LTR/ERV1	3918	+	272	135543660	76142
chr9	135467518	135667518	harbor2	chr9	135559789	135559954	LTR/ERV1	794	+	82	135559871	92353
chr9	4886482	5086482	harbor2	chr9	4886929	4887563	LTR/ERV1	5132	+	317	4887246	764
chr9	4884812	5084812	harbor2	chr9	4886929	4887563	LTR/ERV1	5132	+	317	4887246	2434
chr9	4692907	4892907	harbor2	chr9	4758445	4758862	LTR/ERV1	1167	+	208	4758653	65746
chr9	4694161	4894161	harbor2	chr9	4758445	4758862	LTR/ERV1	1167	+	208	4758653	64492
chr9	68607235	68807235	harbor2	chr9	68616842	68618167	LTR/ERV1	9795	+	662	68617504	10269
chr9	4884845	5084845	harbor2	chr9	4886929	4887563	LTR/ERV1	5132	+	317	4887246	2401
chr9	4885145	5085145	harbor2	chr9	4886929	4887563	LTR/ERV1	5132	+	317	4887246	2101
chr9	4886035	5086035	harbor2	chr9	4886929	4887563	LTR/ERV1	5132	+	317	4887246	1211
chr9	108349469	108549469	harbor2	chr9	108393323	108394878	LTR/ERV1	10634	+	778	108394101	44632
chr9	108349469	108549469	harbor2	chr9	108405948	108406225	LTR/ERV1	1469	+	138	108406086	56617
chr9	108349469	108549469	harbor2	chr9	108406261	108406616	LTR/ERV1	1820	+	178	108406439	56970
chr9	4887289	5087289	harbor2	chr9	4886929	4887563	LTR/ERV1	5132	+	317	4887246	43
chr9	4886440	5086440	harbor2	chr9	4886929	4887563	LTR/ERV1	5132	+	317	4887246	806
chr9	4693547	4893547	harbor2	chr9	4758445	4758862	LTR/ERV1	1167	+	208	4758653	65106
chr9	4886206	5086206	harbor2	chr9	4886929	4887563	LTR/ERV1	5132	+	317	4887246	1040
chr9	135951490	136151490	harbor2	chr9	135962012	135962421	LTR/ERV1	2068	+	204	135962216	10726
chr9	135951490	136151490	harbor2	chr9	136028520	136030023	LTR/ERV1	8133	+	752	136029272	77782
chr9	4885197	5085197	harbor2	chr9	4886929	4887563	LTR/ERV1	5132	+	317	4887246	2049
chr9	4692770	4892770	harbor2	chr9	4758445	4758862	LTR/ERV1	1167	+	208	4758653	65883
chr9	34027426	34227426	harbor2	chr9	34058248	34058394	LTR/ERV1	928	+	73	34058321	30895
chr9	34027426	34227426	harbor2	chr9	34084953	34085184	LTR/ERV1	1577	+	116	34085069	57643
chr9	34027426	34227426	harbor2	chr9	34120373	34120388	LTR/ERV1	2142	+	8	34120381	92955
chr9	34027426	34227426	harbor2	chr9	34120697	34120871	LTR/ERV1	2142	+	87	34120784	93358
chr9	34027426	34227426	harbor2	chr9	34121180	34121538	LTR/ERV1	2142	+	179	34121359	93933
chr9	4692800	4892800	harbor2	chr9	4758445	4758862	LTR/ERV1	1167	+	208	4758653	65853
chr9	4884895	5084895	harbor2	chr9	4886929	4887563	LTR/ERV1	5132	+	317	4887246	2351
chr9	85705754	85905754	harbor2	chr9	85745784	85746395	LTR/ERV1	3050	+	306	85746090	40336
chr9	4884866	5084866	harbor2	chr9	4886929	4887563	LTR/ERV1	5132	+	317	4887246	2380
chr9	4692867	4892867	harbor2	chr9	4758445	4758862	LTR/ERV1	1167	+	208	4758653	65786
chr9	27249897	27449897	harbor2	chr9	27280875	27281200	LTR/ERV1	1247	+	162	27281037	31140
chr9	27249897	27449897	harbor2	chr9	27281205	27281566	LTR/ERV1	1922	+	180	27281385	31488
chr9	4692804	4892804	harbor2	chr9	4758445	4758862	LTR/ERV1	1167	+	208	4758653	65849
chr9	135601618	135801618	harbor2	chr9	135625356	135625939	LTR/ERV1	4313	+	292	135625648	24030
chr9	135601618	135801618	harbor2	chr9	135644567	135645131	LTR/ERV1	3293	+	282	135644849	43231
chr9	135601618	135801618	harbor2	chr9	135645972	135646417	LTR/ERV1	2683	+	222	135646194	44576
chr9	135601618	135801618	harbor2	chr9	135646608	135647364	LTR/ERV1	5147	+	378	135646986	45368
chr9	135601618	135801618	harbor2	chr9	135647365	135647751	LTR/ERV1	1290	+	193	135647558	45940
chr9	135601618	135801618	harbor2	chr9	135647884	135648220	LTR/ERV1	1408	+	168	135648052	46434
chr9	135601618	135801618	harbor2	chr9	135648406	135648518	LTR/ERV1	1271	+	56	135648462	46844
chr9	135601618	135801618	harbor2	chr9	135649158	135649564	LTR/ERV1	1271	+	203	135649361	47743
chr9	135601618	135801618	harbor2	chr9	135649736	135650310	LTR/ERV1	2225	+	287	135650023	48405
chr9	135601618	135801618	harbor2	chr9	135650312	135650448	LTR/ERV1	540	+	68	135650380	48762
chr9	135601618	135801618	harbor2	chr9	135650751	135651022	LTR/ERV1	1142	+	136	135650887	49269
chr9	135601618	135801618	harbor2	chr9	135651022	135651165	LTR/ERV1	831	+	72	135651094	49476
chr9	135601618	135801618	harbor2	chr9	135652210	135652488	LTR/ERV1	3942	+	139	135652349	50731
chr9	135601618	135801618	harbor2	chr9	135653246	135653833	LTR/ERV1	3942	+	294	135653540	51922
chr9	135601618	135801618	harbor2	chr9	135654131	135654261	LTR/ERV1	3942	+	65	135654196	52578
chr9	135601618	135801618	harbor2	chr9	135654258	135654625	LTR/ERV1	1672	+	184	135654442	52824
chr9	135601618	135801618	harbor2	chr9	135656414	135656506	LTR/ERV1	3925	+	46	135656460	54842
chr9	135601618	135801618	harbor2	chr9	135656823	135657341	LTR/ERV1	3925	+	259	135657082	55464
chr9	135601618	135801618	harbor2	chr9	135657351	135658342	LTR/ERV1	16765	+	496	135657847	56229
chr9	135601618	135801618	harbor2	chr9	135660671	135660751	LTR/ERV1	5289	+	40	135660711	59093
chr9	135601618	135801618	harbor2	chr9	135661050	135661580	LTR/ERV1	5289	+	265	135661315	59697
chr9	135601618	135801618	harbor2	chr9	135661871	135662290	LTR/ERV1	5289	+	210	135662081	60463
chr9	135601618	135801618	harbor2	chr9	135662291	135662919	LTR/ERV1	3987	+	314	135662605	60987
chr9	135601618	135801618	harbor2	chr9	135658647	135660564	LTR/ERV1	16765	+	958	135659605	57987
chr9	4734367	4934367	harbor2	chr9	4758445	4758862	LTR/ERV1	1167	+	208	4758653	24286
chr9	4884763	5084763	harbor2	chr9	4886929	4887563	LTR/ERV1	5132	+	317	4887246	2483
chr9	128981398	129181398	harbor2	chr9	129031609	129032095	LTR/ERV1	5101	+	243	129031852	50454
chr9	128981398	129181398	harbor2	chr9	129032422	129032861	LTR/ERV1	5101	+	220	129032642	51244
chr9	4692864	4892864	harbor2	chr9	4758445	4758862	LTR/ERV1	1167	+	208	4758653	65789
chr9	87687012	87887012	harbor2	chr9	87742617	87743300	LTR/ERV1	5077	+	342	87742959	55947
chr9	87687012	87887012	harbor2	chr9	87748562	87749078	LTR/ERV1	2160	+	258	87748820	61808
chr9	87687012	87887012	harbor2	chr9	87777063	87777452	LTR/ERV1	930	+	194	87777257	90245
chr9	105154708	105354708	harbor2	chr9	105179559	105179865	LTR/ERV1	773	+	153	105179712	25004
chr9	105154708	105354708	harbor2	chr9	105223107	105223636	LTR/ERV1	2494	+	264	105223371	68663
chr9	4884860	5084860	harbor2	chr9	4886929	4887563	LTR/ERV1	5132	+	317	4887246	2386
chr9	34027547	34227547	harbor2	chr9	34058248	34058394	LTR/ERV1	928	+	73	34058321	30774
chr9	34027547	34227547	harbor2	chr9	34084953	34085184	LTR/ERV1	1577	+	116	34085069	57522
chr9	34027547	34227547	harbor2	chr9	34120373	34120388	LTR/ERV1	2142	+	8	34120381	92834
chr9	34027547	34227547	harbor2	chr9	34120697	34120871	LTR/ERV1	2142	+	87	34120784	93237
chr9	34027547	34227547	harbor2	chr9	34121180	34121538	LTR/ERV1	2142	+	179	34121359	93812
chr9	4885129	5085129	harbor2	chr9	4886929	4887563	LTR/ERV1	5132	+	317	4887246	2117
chr9	4692777	4892777	harbor2	chr9	4758445	4758862	LTR/ERV1	1167	+	208	4758653	65876
chr9	136843738	137043738	harbor2	chr9	136871173	136871224	LTR/ERV1	607	+	26	136871199	27461
chr9	136843738	137043738	harbor2	chr9	136871520	136871824	LTR/ERV1	891	+	152	136871672	27934
chr9	136843738	137043738	harbor2	chr9	136872151	136872237	LTR/ERV1	891	+	43	136872194	28456
chr9	136843738	137043738	harbor2	chr9	136872550	136872625	LTR/ERV1	891	+	38	136872588	28850
chr9	136843738	137043738	harbor2	chr9	136872910	136873081	LTR/ERV1	891	+	86	136872996	29258
chr9	136843738	137043738	harbor2	chr9	136873391	136873735	LTR/ERV1	985	+	172	136873563	29825
chr9	136843738	137043738	harbor2	chr9	136873724	136873761	LTR/ERV1	766	+	18	136873742	30004
chr9	136843738	137043738	harbor2	chr9	136874363	136874659	LTR/ERV1	766	+	148	136874511	30773
chr9	136843738	137043738	harbor2	chr9	136874946	136875014	LTR/ERV1	760	+	34	136874980	31242
chr9	136843738	137043738	harbor2	chr9	136875045	136875278	LTR/ERV1	848	+	116	136875161	31423
chr9	136843738	137043738	harbor2	chr9	136875284	136875446	LTR/ERV1	478	+	81	136875365	31627
chr9	133822376	134022376	harbor2	chr9	133835075	133835245	LTR/ERV1	855	+	85	133835160	12784
chr9	133822376	134022376	harbor2	chr9	133900329	133900766	LTR/ERV1	1830	+	218	133900547	78171
chr9	133822376	134022376	harbor2	chr9	133901100	133901155	LTR/ERV1	603	+	28	133901128	78752
chr9	4743685	4943685	harbor2	chr9	4758445	4758862	LTR/ERV1	1167	+	208	4758653	14968
chr9	35629934	35829934	harbor2	chr9	35636819	35637342	LTR/ERV1	3199	+	262	35637081	7147
chr9	35629934	35829934	harbor2	chr9	35637343	35637794	LTR/ERV1	1986	+	226	35637569	7635
chr9	35629934	35829934	harbor2	chr9	35637853	35639025	LTR/ERV1	3784	+	586	35638439	8505
chr9	35629934	35829934	harbor2	chr9	35642828	35643368	LTR/ERV1	2344	+	270	35643098	13164
chr9	4885175	5085175	harbor2	chr9	4886929	4887563	LTR/ERV1	5132	+	317	4887246	2071
chr9	133678753	133878753	harbor2	chr9	133678262	133678933	LTR/ERV1	3061	+	336	133678598	155
chr9	133678753	133878753	harbor2	chr9	133735498	133735761	LTR/ERV1	3400	+	132	133735630	56877
chr9	133678753	133878753	harbor2	chr9	133736060	133736384	LTR/ERV1	3400	+	162	133736222	57469
chr9	133678753	133878753	harbor2	chr9	133736696	133736747	LTR/ERV1	3400	+	26	133736722	57969
chr9	133678753	133878753	harbor2	chr9	133753678	133754166	LTR/ERV1	3605	+	244	133753922	75169
chr9	38155453	38355453	harbor2	chr9	38169271	38169874	LTR/ERV1	3992	+	302	38169573	14120
chr9	38155453	38355453	harbor2	chr9	38170704	38170764	LTR/ERV1	498	+	30	38170734	15281
chr9	38155453	38355453	harbor2	chr9	38171326	38171787	LTR/ERV1	2914	+	230	38171556	16103
chr9	38155453	38355453	harbor2	chr9	38183492	38183705	LTR/ERV1	781	+	106	38183598	28145
chr9	38155453	38355453	harbor2	chr9	38186846	38187374	LTR/ERV1	4021	+	264	38187110	31657
chr9	38155453	38355453	harbor2	chr9	38194086	38194329	LTR/ERV1	1933	+	122	38194208	38755
chr9	38155453	38355453	harbor2	chr9	38194611	38195017	LTR/ERV1	2951	+	203	38194814	39361
chr9	38155453	38355453	harbor2	chr9	38195119	38195337	LTR/ERV1	3587	+	109	38195228	39775
chr9	38155453	38355453	harbor2	chr9	38195641	38196004	LTR/ERV1	3587	+	182	38195823	40370
chr9	38155453	38355453	harbor2	chr9	38196141	38196292	LTR/ERV1	820	+	76	38196217	40764
chr9	38155453	38355453	harbor2	chr9	38252730	38253283	LTR/ERV1	4377	+	276	38253006	97553
chr9	4886443	5086443	harbor2	chr9	4886929	4887563	LTR/ERV1	5132	+	317	4887246	803
chr9	4886329	5086329	harbor2	chr9	4886929	4887563	LTR/ERV1	5132	+	317	4887246	917
chr9	4725632	4925632	harbor2	chr9	4758445	4758862	LTR/ERV1	1167	+	208	4758653	33021
chr9	4693424	4893424	harbor2	chr9	4758445	4758862	LTR/ERV1	1167	+	208	4758653	65229
chr9	136986144	137186144	harbor2	chr9	136989213	136989739	LTR/ERV1	2313	+	263	136989476	3332
chr9	136986144	137186144	harbor2	chr9	137058489	137058981	LTR/ERV1	3276	+	246	137058735	72591
chr9	136986144	137186144	harbor2	chr9	137075103	137075645	LTR/ERV1	3968	+	271	137075374	89230
chr9	4694515	4894515	harbor2	chr9	4758445	4758862	LTR/ERV1	1167	+	208	4758653	64138
chr9	4884829	5084829	harbor2	chr9	4886929	4887563	LTR/ERV1	5132	+	317	4887246	2417
chr9	4693490	4893490	harbor2	chr9	4758445	4758862	LTR/ERV1	1167	+	208	4758653	65163
chr9	133793578	133993578	harbor2	chr9	133835075	133835245	LTR/ERV1	855	+	85	133835160	41582
chr9	4692797	4892797	harbor2	chr9	4758445	4758862	LTR/ERV1	1167	+	208	4758653	65856
chr9	135602393	135802393	harbor2	chr9	135625356	135625939	LTR/ERV1	4313	+	292	135625648	23255
chr9	135602393	135802393	harbor2	chr9	135644567	135645131	LTR/ERV1	3293	+	282	135644849	42456
chr9	135602393	135802393	harbor2	chr9	135645972	135646417	LTR/ERV1	2683	+	222	135646194	43801
chr9	135602393	135802393	harbor2	chr9	135646608	135647364	LTR/ERV1	5147	+	378	135646986	44593
chr9	135602393	135802393	harbor2	chr9	135647365	135647751	LTR/ERV1	1290	+	193	135647558	45165
chr9	135602393	135802393	harbor2	chr9	135647884	135648220	LTR/ERV1	1408	+	168	135648052	45659
chr9	135602393	135802393	harbor2	chr9	135648406	135648518	LTR/ERV1	1271	+	56	135648462	46069
chr9	135602393	135802393	harbor2	chr9	135649158	135649564	LTR/ERV1	1271	+	203	135649361	46968
chr9	135602393	135802393	harbor2	chr9	135649736	135650310	LTR/ERV1	2225	+	287	135650023	47630
chr9	135602393	135802393	harbor2	chr9	135650312	135650448	LTR/ERV1	540	+	68	135650380	47987
chr9	135602393	135802393	harbor2	chr9	135650751	135651022	LTR/ERV1	1142	+	136	135650887	48494
chr9	135602393	135802393	harbor2	chr9	135651022	135651165	LTR/ERV1	831	+	72	135651094	48701
chr9	135602393	135802393	harbor2	chr9	135652210	135652488	LTR/ERV1	3942	+	139	135652349	49956
chr9	135602393	135802393	harbor2	chr9	135653246	135653833	LTR/ERV1	3942	+	294	135653540	51147
chr9	135602393	135802393	harbor2	chr9	135654131	135654261	LTR/ERV1	3942	+	65	135654196	51803
chr9	135602393	135802393	harbor2	chr9	135654258	135654625	LTR/ERV1	1672	+	184	135654442	52049
chr9	135602393	135802393	harbor2	chr9	135656414	135656506	LTR/ERV1	3925	+	46	135656460	54067
chr9	135602393	135802393	harbor2	chr9	135656823	135657341	LTR/ERV1	3925	+	259	135657082	54689
chr9	135602393	135802393	harbor2	chr9	135657351	135658342	LTR/ERV1	16765	+	496	135657847	55454
chr9	135602393	135802393	harbor2	chr9	135660671	135660751	LTR/ERV1	5289	+	40	135660711	58318
chr9	135602393	135802393	harbor2	chr9	135661050	135661580	LTR/ERV1	5289	+	265	135661315	58922
chr9	135602393	135802393	harbor2	chr9	135661871	135662290	LTR/ERV1	5289	+	210	135662081	59688
chr9	135602393	135802393	harbor2	chr9	135662291	135662919	LTR/ERV1	3987	+	314	135662605	60212
chr9	135602393	135802393	harbor2	chr9	135658647	135660564	LTR/ERV1	16765	+	958	135659605	57212
chr9	135957339	136157339	harbor2	chr9	135962012	135962421	LTR/ERV1	2068	+	204	135962216	4877
chr9	135957339	136157339	harbor2	chr9	136028520	136030023	LTR/ERV1	8133	+	752	136029272	71933
chr9	4824090	5024090	harbor2	chr9	4886929	4887563	LTR/ERV1	5132	+	317	4887246	63156
chr9	126299693	126499693	harbor2	chr9	126303897	126304056	LTR/ERV1	922	+	80	126303977	4284
chr9	133248112	133448112	harbor2	chr9	133249112	133249735	LTR/ERV1	2345	+	312	133249424	1312
chr9	133248112	133448112	harbor2	chr9	133269164	133269643	LTR/ERV1	3248	+	240	133269404	21292
chr9	133248112	133448112	harbor2	chr9	133272410	133273034	LTR/ERV1	5009	+	312	133272722	24610
chr9	133248112	133448112	harbor2	chr9	133277809	133277942	LTR/ERV1	480	+	66	133277875	29763
chr9	133248112	133448112	harbor2	chr9	133278002	133278275	LTR/ERV1	521	+	136	133278138	30026
chr9	133248112	133448112	harbor2	chr9	133302961	133303099	LTR/ERV1	935	+	69	133303030	54918
chr9	4884856	5084856	harbor2	chr9	4886929	4887563	LTR/ERV1	5132	+	317	4887246	2390
chr9	4692893	4892893	harbor2	chr9	4758445	4758862	LTR/ERV1	1167	+	208	4758653	65760
chr9	4885087	5085087	harbor2	chr9	4886929	4887563	LTR/ERV1	5132	+	317	4887246	2159
chr9	4694556	4894556	harbor2	chr9	4758445	4758862	LTR/ERV1	1167	+	208	4758653	64097
chr9	135401583	135601583	harbor2	chr9	135420834	135420931	LTR/ERV1	4383	+	48	135420882	19299
chr9	135401583	135601583	harbor2	chr9	135421258	135421679	LTR/ERV1	4383	+	210	135421468	19885
chr9	135401583	135601583	harbor2	chr9	135421987	135422107	LTR/ERV1	4383	+	60	135422047	20464
chr9	135401583	135601583	harbor2	chr9	135423371	135424025	LTR/ERV1	2944	+	327	135423698	22115
chr9	135401583	135601583	harbor2	chr9	135424631	135425013	LTR/ERV1	2936	+	191	135424822	23239
chr9	135401583	135601583	harbor2	chr9	135425312	135425512	LTR/ERV1	2936	+	100	135425412	23829
chr9	135401583	135601583	harbor2	chr9	135426243	135426677	LTR/ERV1	3200	+	217	135426460	24877
chr9	135401583	135601583	harbor2	chr9	135439588	135440176	LTR/ERV1	4074	+	294	135439882	38299
chr9	135401583	135601583	harbor2	chr9	135464021	135464531	LTR/ERV1	2473	+	255	135464276	62693
chr9	135401583	135601583	harbor2	chr9	135468602	135469313	LTR/ERV1	4589	+	356	135468958	67375
chr9	135401583	135601583	harbor2	chr9	135469564	135469755	LTR/ERV1	2704	+	96	135469660	68077
chr9	135401583	135601583	harbor2	chr9	135470035	135470603	LTR/ERV1	2704	+	284	135470319	68736
chr9	4886608	5086608	harbor2	chr9	4886929	4887563	LTR/ERV1	5132	+	317	4887246	638
chr9	4885766	5085766	harbor2	chr9	4886929	4887563	LTR/ERV1	5132	+	317	4887246	1480
chr9	4692786	4892786	harbor2	chr9	4758445	4758862	LTR/ERV1	1167	+	208	4758653	65867
chr9	4884865	5084865	harbor2	chr9	4886929	4887563	LTR/ERV1	5132	+	317	4887246	2381
chr9	135594610	135794610	harbor2	chr9	135596156	135596498	LTR/ERV1	1966	+	171	135596327	1717
chr9	135594610	135794610	harbor2	chr9	135596506	135596764	LTR/ERV1	1590	+	129	135596635	2025
chr9	135594610	135794610	harbor2	chr9	135596884	135597156	LTR/ERV1	669	+	136	135597020	2410
chr9	135594610	135794610	harbor2	chr9	135597283	135597452	LTR/ERV1	582	+	84	135597367	2757
chr9	135594610	135794610	harbor2	chr9	135597528	135597750	LTR/ERV1	1169	+	111	135597639	3029
chr9	135594610	135794610	harbor2	chr9	135598128	135598425	LTR/ERV1	1578	+	148	135598276	3666
chr9	135594610	135794610	harbor2	chr9	135598728	135598878	LTR/ERV1	1578	+	75	135598803	4193
chr9	135594610	135794610	harbor2	chr9	135625356	135625939	LTR/ERV1	4313	+	292	135625648	31038
chr9	135594610	135794610	harbor2	chr9	135644567	135645131	LTR/ERV1	3293	+	282	135644849	50239
chr9	135594610	135794610	harbor2	chr9	135645972	135646417	LTR/ERV1	2683	+	222	135646194	51584
chr9	135594610	135794610	harbor2	chr9	135646608	135647364	LTR/ERV1	5147	+	378	135646986	52376
chr9	135594610	135794610	harbor2	chr9	135647365	135647751	LTR/ERV1	1290	+	193	135647558	52948
chr9	135594610	135794610	harbor2	chr9	135647884	135648220	LTR/ERV1	1408	+	168	135648052	53442
chr9	135594610	135794610	harbor2	chr9	135648406	135648518	LTR/ERV1	1271	+	56	135648462	53852
chr9	135594610	135794610	harbor2	chr9	135649158	135649564	LTR/ERV1	1271	+	203	135649361	54751
chr9	135594610	135794610	harbor2	chr9	135649736	135650310	LTR/ERV1	2225	+	287	135650023	55413
chr9	135594610	135794610	harbor2	chr9	135650312	135650448	LTR/ERV1	540	+	68	135650380	55770
chr9	135594610	135794610	harbor2	chr9	135650751	135651022	LTR/ERV1	1142	+	136	135650887	56277
chr9	135594610	135794610	harbor2	chr9	135651022	135651165	LTR/ERV1	831	+	72	135651094	56484
chr9	135594610	135794610	harbor2	chr9	135652210	135652488	LTR/ERV1	3942	+	139	135652349	57739
chr9	135594610	135794610	harbor2	chr9	135653246	135653833	LTR/ERV1	3942	+	294	135653540	58930
chr9	135594610	135794610	harbor2	chr9	135654131	135654261	LTR/ERV1	3942	+	65	135654196	59586
chr9	135594610	135794610	harbor2	chr9	135654258	135654625	LTR/ERV1	1672	+	184	135654442	59832
chr9	135594610	135794610	harbor2	chr9	135656414	135656506	LTR/ERV1	3925	+	46	135656460	61850
chr9	135594610	135794610	harbor2	chr9	135656823	135657341	LTR/ERV1	3925	+	259	135657082	62472
chr9	135594610	135794610	harbor2	chr9	135657351	135658342	LTR/ERV1	16765	+	496	135657847	63237
chr9	135594610	135794610	harbor2	chr9	135660671	135660751	LTR/ERV1	5289	+	40	135660711	66101
chr9	135594610	135794610	harbor2	chr9	135661050	135661580	LTR/ERV1	5289	+	265	135661315	66705
chr9	135594610	135794610	harbor2	chr9	135661871	135662290	LTR/ERV1	5289	+	210	135662081	67471
chr9	135594610	135794610	harbor2	chr9	135662291	135662919	LTR/ERV1	3987	+	314	135662605	67995
chr9	135594610	135794610	harbor2	chr9	135658647	135660564	LTR/ERV1	16765	+	958	135659605	64995
chr9	108356062	108556062	harbor2	chr9	108393323	108394878	LTR/ERV1	10634	+	778	108394101	38039
chr9	108356062	108556062	harbor2	chr9	108405948	108406225	LTR/ERV1	1469	+	138	108406086	50024
chr9	108356062	108556062	harbor2	chr9	108406261	108406616	LTR/ERV1	1820	+	178	108406439	50377
chr9	99259961	99459961	harbor2	chr9	99301912	99302535	LTR/ERV1	5070	+	312	99302224	42263
chr9	99259961	99459961	harbor2	chr9	99308020	99308893	LTR/ERV1	5434	+	436	99308456	48495
chr10	132234146	132434146	harbor2	chr10	132312665	132312757	LTR/ERV1	1708	+	46	132312711	78565
chr10	132234146	132434146	harbor2	chr10	132313068	132313324	LTR/ERV1	1708	+	128	132313196	79050
chr10	132235038	132435038	harbor2	chr10	132312665	132312757	LTR/ERV1	1708	+	46	132312711	77673
chr10	132235038	132435038	harbor2	chr10	132313068	132313324	LTR/ERV1	1708	+	128	132313196	78158
chr10	102141600	102341600	harbor2	chr10	102185117	102185572	LTR/ERV1	2394	+	228	102185345	43745
chr10	102141600	102341600	harbor2	chr10	102185574	102185660	LTR/ERV1	579	+	43	102185617	44017
chr10	102141600	102341600	harbor2	chr10	102185777	102186059	LTR/ERV1	1594	+	141	102185918	44318
chr10	102141600	102341600	harbor2	chr10	102186227	102186601	LTR/ERV1	1787	+	187	102186414	44814
chr10	102141600	102341600	harbor2	chr10	102189323	102189625	LTR/ERV1	2446	+	151	102189474	47874
chr10	102141600	102341600	harbor2	chr10	102189929	102190030	LTR/ERV1	2446	+	50	102189979	48379
chr10	102141600	102341600	harbor2	chr10	102190298	102190326	LTR/ERV1	1264	+	14	102190312	48712
chr10	102141600	102341600	harbor2	chr10	102190622	102190760	LTR/ERV1	1264	+	69	102190691	49091
chr10	102141600	102341600	harbor2	chr10	102191064	102191112	LTR/ERV1	1264	+	24	102191088	49488
chr10	102141600	102341600	harbor2	chr10	102191437	102191728	LTR/ERV1	1845	+	146	102191583	49983
chr10	102141600	102341600	harbor2	chr10	102191728	102191818	LTR/ERV1	650	+	45	102191773	50173
chr10	102141600	102341600	harbor2	chr10	102191819	102192261	LTR/ERV1	2472	+	221	102192040	50440
chr10	102141600	102341600	harbor2	chr10	102186702	102187010	LTR/ERV1	1723	+	154	102186856	45256
chr10	102141600	102341600	harbor2	chr10	102186979	102187954	LTR/ERV1	6130	+	488	102187467	45867
chr10	102141612	102341612	harbor2	chr10	102185117	102185572	LTR/ERV1	2394	+	228	102185345	43733
chr10	102141612	102341612	harbor2	chr10	102185574	102185660	LTR/ERV1	579	+	43	102185617	44005
chr10	102141612	102341612	harbor2	chr10	102185777	102186059	LTR/ERV1	1594	+	141	102185918	44306
chr10	102141612	102341612	harbor2	chr10	102186227	102186601	LTR/ERV1	1787	+	187	102186414	44802
chr10	102141612	102341612	harbor2	chr10	102189323	102189625	LTR/ERV1	2446	+	151	102189474	47862
chr10	102141612	102341612	harbor2	chr10	102189929	102190030	LTR/ERV1	2446	+	50	102189979	48367
chr10	102141612	102341612	harbor2	chr10	102190298	102190326	LTR/ERV1	1264	+	14	102190312	48700
chr10	102141612	102341612	harbor2	chr10	102190622	102190760	LTR/ERV1	1264	+	69	102190691	49079
chr10	102141612	102341612	harbor2	chr10	102191064	102191112	LTR/ERV1	1264	+	24	102191088	49476
chr10	102141612	102341612	harbor2	chr10	102191437	102191728	LTR/ERV1	1845	+	146	102191583	49971
chr10	102141612	102341612	harbor2	chr10	102191728	102191818	LTR/ERV1	650	+	45	102191773	50161
chr10	102141612	102341612	harbor2	chr10	102191819	102192261	LTR/ERV1	2472	+	221	102192040	50428
chr10	102141612	102341612	harbor2	chr10	102186702	102187010	LTR/ERV1	1723	+	154	102186856	45244
chr10	102141612	102341612	harbor2	chr10	102186979	102187954	LTR/ERV1	6130	+	488	102187467	45855
chr10	103893614	104093614	harbor2	chr10	103920613	103921224	LTR/ERV1	2022	+	306	103920919	27305
chr10	103893614	104093614	harbor2	chr10	103933015	103933434	LTR/ERV1	2189	+	210	103933225	39611
chr10	14996869	15196869	harbor2	chr10	15027765	15028260	LTR/ERV1	3340	+	248	15028013	31144
chr10	14996869	15196869	harbor2	chr10	15053151	15053716	LTR/ERV1	3845	+	282	15053433	56564
chr10	14996869	15196869	harbor2	chr10	15054026	15054039	LTR/ERV1	3845	+	6	15054032	57163
chr10	14996869	15196869	harbor2	chr10	15054341	15054496	LTR/ERV1	3845	+	78	15054419	57550
chr10	14996869	15196869	harbor2	chr10	15081099	15081722	LTR/ERV1	4035	+	312	15081411	84542
chr10	14779254	14979254	harbor2	chr10	14812156	14812807	LTR/ERV1	4268	+	326	14812482	33228
chr10	14779254	14979254	harbor2	chr10	14815595	14815891	LTR/ERV1	2593	+	148	14815743	36489
chr10	14779254	14979254	harbor2	chr10	14816198	14816350	LTR/ERV1	2593	+	76	14816274	37020
chr10	97778537	97978537	harbor2	chr10	97797649	97798106	LTR/ERV1	864	+	228	97797877	19340
chr10	14778679	14978679	harbor2	chr10	14779116	14779192	LTR/ERV1	607	+	38	14779154	475
chr10	14778679	14978679	harbor2	chr10	14812156	14812807	LTR/ERV1	4268	+	326	14812482	33803
chr10	14778679	14978679	harbor2	chr10	14815595	14815891	LTR/ERV1	2593	+	148	14815743	37064
chr10	14778679	14978679	harbor2	chr10	14816198	14816350	LTR/ERV1	2593	+	76	14816274	37595
chr10	97398820	97598820	harbor2	chr10	97479064	97479267	LTR/ERV1	1304	+	102	97479166	80346
chr10	97398820	97598820	harbor2	chr10	97479310	97479507	LTR/ERV1	1192	+	98	97479408	80588
chr10	97398820	97598820	harbor2	chr10	97479848	97480367	LTR/ERV1	3300	+	260	97480108	81288
chr10	14778676	14978676	harbor2	chr10	14779116	14779192	LTR/ERV1	607	+	38	14779154	478
chr10	14778676	14978676	harbor2	chr10	14812156	14812807	LTR/ERV1	4268	+	326	14812482	33806
chr10	14778676	14978676	harbor2	chr10	14815595	14815891	LTR/ERV1	2593	+	148	14815743	37067
chr10	14778676	14978676	harbor2	chr10	14816198	14816350	LTR/ERV1	2593	+	76	14816274	37598
chr10	132642315	132842315	harbor2	chr10	132680478	132681589	LTR/ERV1	7082	+	556	132681034	38719
chr10	97415128	97615128	harbor2	chr10	97479064	97479267	LTR/ERV1	1304	+	102	97479166	64038
chr10	97415128	97615128	harbor2	chr10	97479310	97479507	LTR/ERV1	1192	+	98	97479408	64280
chr10	97415128	97615128	harbor2	chr10	97479848	97480367	LTR/ERV1	3300	+	260	97480108	64980
chr10	102141599	102341599	harbor2	chr10	102185117	102185572	LTR/ERV1	2394	+	228	102185345	43746
chr10	102141599	102341599	harbor2	chr10	102185574	102185660	LTR/ERV1	579	+	43	102185617	44018
chr10	102141599	102341599	harbor2	chr10	102185777	102186059	LTR/ERV1	1594	+	141	102185918	44319
chr10	102141599	102341599	harbor2	chr10	102186227	102186601	LTR/ERV1	1787	+	187	102186414	44815
chr10	102141599	102341599	harbor2	chr10	102189323	102189625	LTR/ERV1	2446	+	151	102189474	47875
chr10	102141599	102341599	harbor2	chr10	102189929	102190030	LTR/ERV1	2446	+	50	102189979	48380
chr10	102141599	102341599	harbor2	chr10	102190298	102190326	LTR/ERV1	1264	+	14	102190312	48713
chr10	102141599	102341599	harbor2	chr10	102190622	102190760	LTR/ERV1	1264	+	69	102190691	49092
chr10	102141599	102341599	harbor2	chr10	102191064	102191112	LTR/ERV1	1264	+	24	102191088	49489
chr10	102141599	102341599	harbor2	chr10	102191437	102191728	LTR/ERV1	1845	+	146	102191583	49984
chr10	102141599	102341599	harbor2	chr10	102191728	102191818	LTR/ERV1	650	+	45	102191773	50174
chr10	102141599	102341599	harbor2	chr10	102191819	102192261	LTR/ERV1	2472	+	221	102192040	50441
chr10	102141599	102341599	harbor2	chr10	102186702	102187010	LTR/ERV1	1723	+	154	102186856	45257
chr10	102141599	102341599	harbor2	chr10	102186979	102187954	LTR/ERV1	6130	+	488	102187467	45868
chr10	133106978	133306978	harbor2	chr10	133151676	133152229	LTR/ERV1	1204	+	276	133151952	44974
chr10	23340660	23540660	harbor2	chr10	23373410	23373624	LTR/ERV1	1375	+	107	23373517	32857
chr10	23340660	23540660	harbor2	chr10	23373916	23374250	LTR/ERV1	2098	+	167	23374083	33423
chr10	23340660	23540660	harbor2	chr10	23379264	23379781	LTR/ERV1	2559	+	258	23379522	38862
chr10	23340660	23540660	harbor2	chr10	23405605	23405847	LTR/ERV1	605	+	121	23405726	65066
chr10	23340660	23540660	harbor2	chr10	23406037	23406271	LTR/ERV1	1064	+	117	23406154	65494
chr10	23340660	23540660	harbor2	chr10	23417328	23417948	LTR/ERV1	4205	+	310	23417638	76978
chr10	129121176	129321176	harbor2	chr10	129150608	129151176	LTR/ERV1	3144	+	284	129150892	29716
chr10	130648896	130848896	harbor2	chr10	130649550	130649786	LTR/ERV1	1262	+	118	130649668	772
chr10	130648896	130848896	harbor2	chr10	130662817	130662968	LTR/ERV1	588	+	76	130662893	13997
chr10	130648896	130848896	harbor2	chr10	130712920	130713407	LTR/ERV1	1268	+	244	130713164	64268
chr10	130648896	130848896	harbor2	chr10	130746685	130746892	LTR/ERV1	742	+	104	130746789	97893
chr10	130648896	130848896	harbor2	chr10	130747295	130747467	LTR/ERV1	468	+	86	130747381	98485
chr10	130648896	130848896	harbor2	chr10	130747469	130747815	LTR/ERV1	789	+	173	130747642	98746
chr10	102141615	102341615	harbor2	chr10	102185117	102185572	LTR/ERV1	2394	+	228	102185345	43730
chr10	102141615	102341615	harbor2	chr10	102185574	102185660	LTR/ERV1	579	+	43	102185617	44002
chr10	102141615	102341615	harbor2	chr10	102185777	102186059	LTR/ERV1	1594	+	141	102185918	44303
chr10	102141615	102341615	harbor2	chr10	102186227	102186601	LTR/ERV1	1787	+	187	102186414	44799
chr10	102141615	102341615	harbor2	chr10	102189323	102189625	LTR/ERV1	2446	+	151	102189474	47859
chr10	102141615	102341615	harbor2	chr10	102189929	102190030	LTR/ERV1	2446	+	50	102189979	48364
chr10	102141615	102341615	harbor2	chr10	102190298	102190326	LTR/ERV1	1264	+	14	102190312	48697
chr10	102141615	102341615	harbor2	chr10	102190622	102190760	LTR/ERV1	1264	+	69	102190691	49076
chr10	102141615	102341615	harbor2	chr10	102191064	102191112	LTR/ERV1	1264	+	24	102191088	49473
chr10	102141615	102341615	harbor2	chr10	102191437	102191728	LTR/ERV1	1845	+	146	102191583	49968
chr10	102141615	102341615	harbor2	chr10	102191728	102191818	LTR/ERV1	650	+	45	102191773	50158
chr10	102141615	102341615	harbor2	chr10	102191819	102192261	LTR/ERV1	2472	+	221	102192040	50425
chr10	102141615	102341615	harbor2	chr10	102186702	102187010	LTR/ERV1	1723	+	154	102186856	45241
chr10	102141615	102341615	harbor2	chr10	102186979	102187954	LTR/ERV1	6130	+	488	102187467	45852
chr10	101132788	101332788	harbor2	chr10	101158695	101159174	LTR/ERV1	2958	+	240	101158935	26147
chr10	101132788	101332788	harbor2	chr10	101183258	101183746	LTR/ERV1	3458	+	244	101183502	50714
chr10	101132788	101332788	harbor2	chr10	101202783	101203022	LTR/ERV1	1820	+	120	101202903	70115
chr10	101132788	101332788	harbor2	chr10	101203251	101203414	LTR/ERV1	1067	+	82	101203333	70545
chr10	101132788	101332788	harbor2	chr10	101207860	101207901	LTR/ERV1	2956	+	20	101207880	75092
chr10	101132788	101332788	harbor2	chr10	101208208	101208260	LTR/ERV1	2956	+	26	101208234	75446
chr10	101132788	101332788	harbor2	chr10	101208573	101208988	LTR/ERV1	2956	+	208	101208781	75993
chr10	97398798	97598798	harbor2	chr10	97479064	97479267	LTR/ERV1	1304	+	102	97479166	80368
chr10	97398798	97598798	harbor2	chr10	97479310	97479507	LTR/ERV1	1192	+	98	97479408	80610
chr10	97398798	97598798	harbor2	chr10	97479848	97480367	LTR/ERV1	3300	+	260	97480108	81310
chr10	75111508	75311508	harbor2	chr10	75186614	75186668	LTR/ERV1	1149	+	27	75186641	75133
chr10	75111508	75311508	harbor2	chr10	75185886	75186311	LTR/ERV1	1149	+	212	75186098	74590
chr10	72361013	72561013	harbor2	chr10	72402173	72402567	LTR/ERV1	2475	+	197	72402370	41357
chr10	72361013	72561013	harbor2	chr10	72423570	72423824	LTR/ERV1	1571	+	127	72423697	62684
chr10	102013280	102213280	harbor2	chr10	102082875	102083342	LTR/ERV1	2523	+	234	102083109	69829
chr10	6420714	6620714	harbor2	chr10	6440455	6440706	LTR/ERV1	592	+	126	6440581	19867
chr10	6420714	6620714	harbor2	chr10	6440999	6441199	LTR/ERV1	592	+	100	6441099	20385
chr10	6420714	6620714	harbor2	chr10	6472505	6472706	LTR/ERV1	1517	+	100	6472605	51891
chr10	6420714	6620714	harbor2	chr10	6473013	6473384	LTR/ERV1	1517	+	186	6473199	52485
chr10	6420714	6620714	harbor2	chr10	6486319	6486743	LTR/ERV1	1975	+	212	6486531	65817
chr10	6420714	6620714	harbor2	chr10	6519328	6520001	LTR/ERV1	3674	+	336	6519664	98950
chr10	14778686	14978686	harbor2	chr10	14779116	14779192	LTR/ERV1	607	+	38	14779154	468
chr10	14778686	14978686	harbor2	chr10	14812156	14812807	LTR/ERV1	4268	+	326	14812482	33796
chr10	14778686	14978686	harbor2	chr10	14815595	14815891	LTR/ERV1	2593	+	148	14815743	37057
chr10	14778686	14978686	harbor2	chr10	14816198	14816350	LTR/ERV1	2593	+	76	14816274	37588
chr10	132233372	132433372	harbor2	chr10	132312665	132312757	LTR/ERV1	1708	+	46	132312711	79339
chr10	132233372	132433372	harbor2	chr10	132313068	132313324	LTR/ERV1	1708	+	128	132313196	79824
chr10	131882110	132082110	harbor2	chr10	131897313	131897886	LTR/ERV1	4340	+	286	131897599	15489
chr10	131882110	132082110	harbor2	chr10	131898190	131898477	LTR/ERV1	4340	+	144	131898334	16224
chr10	130028498	130228498	harbor2	chr10	130120570	130121010	LTR/ERV1	3217	+	220	130120790	92292
chr10	122908712	123108712	harbor2	chr10	122913691	122913967	LTR/ERV1	903	+	138	122913829	5117
chr10	122908712	123108712	harbor2	chr10	122914267	122914392	LTR/ERV1	903	+	62	122914329	5617
chr10	122908712	123108712	harbor2	chr10	122927875	122928076	LTR/ERV1	1546	+	100	122927975	19263
chr10	122908712	123108712	harbor2	chr10	122928254	122928318	LTR/ERV1	1546	+	32	122928286	19574
chr10	97436621	97636621	harbor2	chr10	97479064	97479267	LTR/ERV1	1304	+	102	97479166	42545
chr10	97436621	97636621	harbor2	chr10	97479310	97479507	LTR/ERV1	1192	+	98	97479408	42787
chr10	97436621	97636621	harbor2	chr10	97479848	97480367	LTR/ERV1	3300	+	260	97480108	43487
chr10	122065358	122265358	harbor2	chr10	122075102	122075187	LTR/ERV1	594	+	42	122075144	9786
chr10	97398789	97598789	harbor2	chr10	97479064	97479267	LTR/ERV1	1304	+	102	97479166	80377
chr10	97398789	97598789	harbor2	chr10	97479310	97479507	LTR/ERV1	1192	+	98	97479408	80619
chr10	97398789	97598789	harbor2	chr10	97479848	97480367	LTR/ERV1	3300	+	260	97480108	81319
chr10	33635957	33835957	harbor2	chr10	33636987	33637412	LTR/ERV1	4469	+	212	33637199	1242
chr10	33635957	33835957	harbor2	chr10	33637701	33637944	LTR/ERV1	4469	+	122	33637823	1866
chr10	33635957	33835957	harbor2	chr10	33653265	33653707	LTR/ERV1	1996	+	221	33653486	17529
chr10	33635957	33835957	harbor2	chr10	33664403	33664828	LTR/ERV1	2275	+	212	33664615	28658
chr10	33635957	33835957	harbor2	chr10	33687892	33688388	LTR/ERV1	3432	+	248	33688140	52183
chr10	33635957	33835957	harbor2	chr10	33719894	33720510	LTR/ERV1	4026	+	308	33720202	84245
chr10	33635957	33835957	harbor2	chr10	33723227	33723677	LTR/ERV1	1981	+	225	33723452	87495
chr10	33635957	33835957	harbor2	chr10	33728136	33728820	LTR/ERV1	5408	+	342	33728478	92521
chr10	75120756	75320756	harbor2	chr10	75186614	75186668	LTR/ERV1	1149	+	27	75186641	65885
chr10	75120756	75320756	harbor2	chr10	75185886	75186311	LTR/ERV1	1149	+	212	75186098	65342
chr10	132233889	132433889	harbor2	chr10	132312665	132312757	LTR/ERV1	1708	+	46	132312711	78822
chr10	132233889	132433889	harbor2	chr10	132313068	132313324	LTR/ERV1	1708	+	128	132313196	79307
chr10	4452699	4652699	harbor2	chr10	4548828	4548913	LTR/ERV1	2277	+	42	4548870	96171
chr10	4452699	4652699	harbor2	chr10	4549226	4549645	LTR/ERV1	2277	+	210	4549436	96737
chr10	97398825	97598825	harbor2	chr10	97479064	97479267	LTR/ERV1	1304	+	102	97479166	80341
chr10	97398825	97598825	harbor2	chr10	97479310	97479507	LTR/ERV1	1192	+	98	97479408	80583
chr10	97398825	97598825	harbor2	chr10	97479848	97480367	LTR/ERV1	3300	+	260	97480108	81283
chr10	43005484	43205484	harbor2	chr10	43012191	43013104	LTR/ERV1	4934	+	456	43012647	7163
chr10	114721684	114921684	harbor2	chr10	114723675	114724069	LTR/ERV1	1574	+	197	114723872	2188
chr10	97402257	97602257	harbor2	chr10	97479064	97479267	LTR/ERV1	1304	+	102	97479166	76909
chr10	97402257	97602257	harbor2	chr10	97479310	97479507	LTR/ERV1	1192	+	98	97479408	77151
chr10	97402257	97602257	harbor2	chr10	97479848	97480367	LTR/ERV1	3300	+	260	97480108	77851
chr10	69630792	69830792	harbor2	chr10	69652080	69654070	LTR/ERV1	9516	+	995	69653075	22283
chr10	69630792	69830792	harbor2	chr10	69704245	69704716	LTR/ERV1	2397	+	236	69704481	73689
chr10	69630792	69830792	harbor2	chr10	69705789	69706239	LTR/ERV1	3194	+	225	69706014	75222
chr10	69630792	69830792	harbor2	chr10	69708112	69708904	LTR/ERV1	4443	+	396	69708508	77716
chr10	14782782	14982782	harbor2	chr10	14812156	14812807	LTR/ERV1	4268	+	326	14812482	29700
chr10	14782782	14982782	harbor2	chr10	14815595	14815891	LTR/ERV1	2593	+	148	14815743	32961
chr10	14782782	14982782	harbor2	chr10	14816198	14816350	LTR/ERV1	2593	+	76	14816274	33492
chr10	46182801	46382801	harbor2	chr10	46208910	46209354	LTR/ERV1	3126	+	222	46209132	26331
chr10	46182801	46382801	harbor2	chr10	46209358	46209705	LTR/ERV1	2361	+	174	46209532	26731
chr10	46182801	46382801	harbor2	chr10	46209706	46210163	LTR/ERV1	3569	+	228	46209934	27133
chr10	46182801	46382801	harbor2	chr10	46210164	46210856	LTR/ERV1	4525	+	346	46210510	27709
chr10	46182801	46382801	harbor2	chr10	46210916	46211528	LTR/ERV1	4525	+	306	46211222	28421
chr10	46182801	46382801	harbor2	chr10	46211834	46211877	LTR/ERV1	4525	+	22	46211856	29055
chr10	46182801	46382801	harbor2	chr10	46239260	46239670	LTR/ERV1	1457	+	205	46239465	56664
chr10	46182801	46382801	harbor2	chr10	46255904	46256131	LTR/ERV1	999	+	114	46256018	73217
chr10	46182801	46382801	harbor2	chr10	46256763	46257208	LTR/ERV1	2121	+	222	46256985	74184
chr10	46182801	46382801	harbor2	chr10	46257265	46257680	LTR/ERV1	896	+	208	46257473	74672
chr10	46182801	46382801	harbor2	chr10	46258213	46258504	LTR/ERV1	1468	+	146	46258359	75558
chr10	46182801	46382801	harbor2	chr10	46258702	46259718	LTR/ERV1	4443	+	508	46259210	76409
chr10	46182801	46382801	harbor2	chr10	46259718	46259971	LTR/ERV1	782	+	126	46259844	77043
chr10	46182801	46382801	harbor2	chr10	46259961	46260157	LTR/ERV1	1694	+	98	46260059	77258
chr10	46182801	46382801	harbor2	chr10	46260436	46260676	LTR/ERV1	1694	+	120	46260556	77755
chr10	46182801	46382801	harbor2	chr10	46260680	46260854	LTR/ERV1	1908	+	87	46260767	77966
chr10	46182801	46382801	harbor2	chr10	46261215	46261626	LTR/ERV1	1908	+	206	46261421	78620
chr10	46182801	46382801	harbor2	chr10	46261628	46262072	LTR/ERV1	1946	+	222	46261850	79049
chr10	46182801	46382801	harbor2	chr10	46281634	46282149	LTR/ERV1	3956	+	258	46281892	99091
chr10	133562176	133762176	harbor2	chr10	133561251	133562261	LTR/ERV1	3688	+	505	133561756	420
chr10	133562176	133762176	harbor2	chr10	133591271	133591766	LTR/ERV1	3125	+	248	133591519	29343
chr10	133562176	133762176	harbor2	chr10	133650905	133651243	LTR/ERV1	2426	+	169	133651074	88898
chr10	133562176	133762176	harbor2	chr10	133562317	133562870	LTR/ERV1	2376	+	276	133562593	417
chr10	71364878	71564878	harbor2	chr10	71379251	71379762	LTR/ERV1	2312	+	256	71379507	14629
chr10	132811155	133011155	harbor2	chr10	132848296	132848877	LTR/ERV1	2171	+	290	132848586	37431
chr10	132811155	133011155	harbor2	chr10	132886660	132886944	LTR/ERV1	714	+	142	132886802	75647
chr10	132811155	133011155	harbor2	chr10	132888070	132888197	LTR/ERV1	538	+	64	132888134	76979
chr10	132811155	133011155	harbor2	chr10	132890320	132890554	LTR/ERV1	682	+	117	132890437	79282
chr10	132811155	133011155	harbor2	chr10	132891218	132892094	LTR/ERV1	5038	+	438	132891656	80501
chr10	132811155	133011155	harbor2	chr10	132892488	132892809	LTR/ERV1	1198	+	160	132892648	81493
chr10	132811155	133011155	harbor2	chr10	132892850	132893316	LTR/ERV1	3671	+	233	132893083	81928
chr10	132811155	133011155	harbor2	chr10	132893317	132893661	LTR/ERV1	2315	+	172	132893489	82334
chr10	132811155	133011155	harbor2	chr10	132893662	132893895	LTR/ERV1	3671	+	116	132893778	82623
chr10	132811155	133011155	harbor2	chr10	132890600	132890765	LTR/ERV1	733	+	82	132890682	79527
chr10	100085958	100285958	harbor2	chr10	100111387	100111512	LTR/ERV1	3455	+	62	100111449	25491
chr10	100085958	100285958	harbor2	chr10	100111805	100112223	LTR/ERV1	3455	+	209	100112014	26056
chr10	100085958	100285958	harbor2	chr10	100169156	100169249	LTR/ERV1	510	+	46	100169202	83244
chr10	131033279	131233279	harbor2	chr10	131040585	131041177	LTR/ERV1	3601	+	296	131040881	7602
chr10	131033279	131233279	harbor2	chr10	131046968	131047672	LTR/ERV1	2735	+	352	131047320	14041
chr10	131033279	131233279	harbor2	chr10	131050054	131050185	LTR/ERV1	947	+	66	131050120	16841
chr10	131033279	131233279	harbor2	chr10	131050177	131050303	LTR/ERV1	940	+	63	131050240	16961
chr10	131033279	131233279	harbor2	chr10	131053210	131054031	LTR/ERV1	4635	+	410	131053620	20341
chr10	131033279	131233279	harbor2	chr10	131066274	131066520	LTR/ERV1	656	+	123	131066397	33118
chr10	131033279	131233279	harbor2	chr10	131118388	131118815	LTR/ERV1	892	+	214	131118602	85323
chr10	50611910	50811910	harbor2	chr10	50671548	50672097	LTR/ERV1	3430	+	274	50671822	59912
chr10	50611910	50811910	harbor2	chr10	50672277	50672700	LTR/ERV1	1287	+	212	50672489	60579
chr10	13710585	13910585	harbor2	chr10	13723625	13723844	LTR/ERV1	619	+	110	13723735	13150
chr10	13710585	13910585	harbor2	chr10	13723874	13724096	LTR/ERV1	863	+	111	13723985	13400
chr10	13710585	13910585	harbor2	chr10	13758511	13758817	LTR/ERV1	1917	+	153	13758664	48079
chr10	13710585	13910585	harbor2	chr10	13772303	13772658	LTR/ERV1	3007	+	178	13772481	61896
chr10	13710585	13910585	harbor2	chr10	13773105	13773374	LTR/ERV1	3007	+	134	13773239	62654
chr10	102144633	102344633	harbor2	chr10	102185117	102185572	LTR/ERV1	2394	+	228	102185345	40712
chr10	102144633	102344633	harbor2	chr10	102185574	102185660	LTR/ERV1	579	+	43	102185617	40984
chr10	102144633	102344633	harbor2	chr10	102185777	102186059	LTR/ERV1	1594	+	141	102185918	41285
chr10	102144633	102344633	harbor2	chr10	102186227	102186601	LTR/ERV1	1787	+	187	102186414	41781
chr10	102144633	102344633	harbor2	chr10	102189323	102189625	LTR/ERV1	2446	+	151	102189474	44841
chr10	102144633	102344633	harbor2	chr10	102189929	102190030	LTR/ERV1	2446	+	50	102189979	45346
chr10	102144633	102344633	harbor2	chr10	102190298	102190326	LTR/ERV1	1264	+	14	102190312	45679
chr10	102144633	102344633	harbor2	chr10	102190622	102190760	LTR/ERV1	1264	+	69	102190691	46058
chr10	102144633	102344633	harbor2	chr10	102191064	102191112	LTR/ERV1	1264	+	24	102191088	46455
chr10	102144633	102344633	harbor2	chr10	102191437	102191728	LTR/ERV1	1845	+	146	102191583	46950
chr10	102144633	102344633	harbor2	chr10	102191728	102191818	LTR/ERV1	650	+	45	102191773	47140
chr10	102144633	102344633	harbor2	chr10	102191819	102192261	LTR/ERV1	2472	+	221	102192040	47407
chr10	102144633	102344633	harbor2	chr10	102186702	102187010	LTR/ERV1	1723	+	154	102186856	42223
chr10	102144633	102344633	harbor2	chr10	102186979	102187954	LTR/ERV1	6130	+	488	102187467	42834
chr10	97399300	97599300	harbor2	chr10	97479064	97479267	LTR/ERV1	1304	+	102	97479166	79866
chr10	97399300	97599300	harbor2	chr10	97479310	97479507	LTR/ERV1	1192	+	98	97479408	80108
chr10	97399300	97599300	harbor2	chr10	97479848	97480367	LTR/ERV1	3300	+	260	97480108	80808
chr10	97398808	97598808	harbor2	chr10	97479064	97479267	LTR/ERV1	1304	+	102	97479166	80358
chr10	97398808	97598808	harbor2	chr10	97479310	97479507	LTR/ERV1	1192	+	98	97479408	80600
chr10	97398808	97598808	harbor2	chr10	97479848	97480367	LTR/ERV1	3300	+	260	97480108	81300
chr10	132252813	132452813	harbor2	chr10	132312665	132312757	LTR/ERV1	1708	+	46	132312711	59898
chr10	132252813	132452813	harbor2	chr10	132313068	132313324	LTR/ERV1	1708	+	128	132313196	60383
chr10	10822731	11022731	harbor2	chr10	10863658	10864071	LTR/ERV1	2094	+	206	10863864	41133
chr10	75111469	75311469	harbor2	chr10	75186614	75186668	LTR/ERV1	1149	+	27	75186641	75172
chr10	75111469	75311469	harbor2	chr10	75185886	75186311	LTR/ERV1	1149	+	212	75186098	74629
chr10	132813125	133013125	harbor2	chr10	132848296	132848877	LTR/ERV1	2171	+	290	132848586	35461
chr10	132813125	133013125	harbor2	chr10	132886660	132886944	LTR/ERV1	714	+	142	132886802	73677
chr10	132813125	133013125	harbor2	chr10	132888070	132888197	LTR/ERV1	538	+	64	132888134	75009
chr10	132813125	133013125	harbor2	chr10	132890320	132890554	LTR/ERV1	682	+	117	132890437	77312
chr10	132813125	133013125	harbor2	chr10	132891218	132892094	LTR/ERV1	5038	+	438	132891656	78531
chr10	132813125	133013125	harbor2	chr10	132892488	132892809	LTR/ERV1	1198	+	160	132892648	79523
chr10	132813125	133013125	harbor2	chr10	132892850	132893316	LTR/ERV1	3671	+	233	132893083	79958
chr10	132813125	133013125	harbor2	chr10	132893317	132893661	LTR/ERV1	2315	+	172	132893489	80364
chr10	132813125	133013125	harbor2	chr10	132893662	132893895	LTR/ERV1	3671	+	116	132893778	80653
chr10	132813125	133013125	harbor2	chr10	132890600	132890765	LTR/ERV1	733	+	82	132890682	77557
chr10	131149473	131349473	harbor2	chr10	131156497	131156950	LTR/ERV1	3601	+	226	131156723	7250
chr10	131149473	131349473	harbor2	chr10	131199545	131199870	LTR/ERV1	750	+	162	131199707	50234
chr10	102141601	102341601	harbor2	chr10	102185117	102185572	LTR/ERV1	2394	+	228	102185345	43744
chr10	102141601	102341601	harbor2	chr10	102185574	102185660	LTR/ERV1	579	+	43	102185617	44016
chr10	102141601	102341601	harbor2	chr10	102185777	102186059	LTR/ERV1	1594	+	141	102185918	44317
chr10	102141601	102341601	harbor2	chr10	102186227	102186601	LTR/ERV1	1787	+	187	102186414	44813
chr10	102141601	102341601	harbor2	chr10	102189323	102189625	LTR/ERV1	2446	+	151	102189474	47873
chr10	102141601	102341601	harbor2	chr10	102189929	102190030	LTR/ERV1	2446	+	50	102189979	48378
chr10	102141601	102341601	harbor2	chr10	102190298	102190326	LTR/ERV1	1264	+	14	102190312	48711
chr10	102141601	102341601	harbor2	chr10	102190622	102190760	LTR/ERV1	1264	+	69	102190691	49090
chr10	102141601	102341601	harbor2	chr10	102191064	102191112	LTR/ERV1	1264	+	24	102191088	49487
chr10	102141601	102341601	harbor2	chr10	102191437	102191728	LTR/ERV1	1845	+	146	102191583	49982
chr10	102141601	102341601	harbor2	chr10	102191728	102191818	LTR/ERV1	650	+	45	102191773	50172
chr10	102141601	102341601	harbor2	chr10	102191819	102192261	LTR/ERV1	2472	+	221	102192040	50439
chr10	102141601	102341601	harbor2	chr10	102186702	102187010	LTR/ERV1	1723	+	154	102186856	45255
chr10	102141601	102341601	harbor2	chr10	102186979	102187954	LTR/ERV1	6130	+	488	102187467	45866
chr10	132233777	132433777	harbor2	chr10	132312665	132312757	LTR/ERV1	1708	+	46	132312711	78934
chr10	132233777	132433777	harbor2	chr10	132313068	132313324	LTR/ERV1	1708	+	128	132313196	79419
chr10	14778685	14978685	harbor2	chr10	14779116	14779192	LTR/ERV1	607	+	38	14779154	469
chr10	14778685	14978685	harbor2	chr10	14812156	14812807	LTR/ERV1	4268	+	326	14812482	33797
chr10	14778685	14978685	harbor2	chr10	14815595	14815891	LTR/ERV1	2593	+	148	14815743	37058
chr10	14778685	14978685	harbor2	chr10	14816198	14816350	LTR/ERV1	2593	+	76	14816274	37589
chr10	133138880	133338880	harbor2	chr10	133151676	133152229	LTR/ERV1	1204	+	276	133151952	13072
chr10	17267852	17467852	harbor2	chr10	17276824	17277318	LTR/ERV1	2686	+	247	17277071	9219
chr10	17267852	17467852	harbor2	chr10	17287136	17287614	LTR/ERV1	2795	+	239	17287375	19523
chr10	17267852	17467852	harbor2	chr10	17287907	17288049	LTR/ERV1	2795	+	71	17287978	20126
chr10	17267852	17467852	harbor2	chr10	17328715	17328833	LTR/ERV1	595	+	59	17328774	60922
chr10	17267852	17467852	harbor2	chr10	17340089	17340680	LTR/ERV1	2607	+	296	17340385	72533
chr10	14778673	14978673	harbor2	chr10	14779116	14779192	LTR/ERV1	607	+	38	14779154	481
chr10	14778673	14978673	harbor2	chr10	14812156	14812807	LTR/ERV1	4268	+	326	14812482	33809
chr10	14778673	14978673	harbor2	chr10	14815595	14815891	LTR/ERV1	2593	+	148	14815743	37070
chr10	14778673	14978673	harbor2	chr10	14816198	14816350	LTR/ERV1	2593	+	76	14816274	37601
chr10	46006333	46206333	harbor2	chr10	46040355	46040673	LTR/ERV1	2307	+	159	46040514	34181
chr10	46006333	46206333	harbor2	chr10	46040967	46041061	LTR/ERV1	2307	+	47	46041014	34681
chr10	46006333	46206333	harbor2	chr10	46041367	46041414	LTR/ERV1	2307	+	24	46041391	35058
chr10	46006333	46206333	harbor2	chr10	46053335	46053960	LTR/ERV1	4399	+	312	46053647	47314
chr10	46006333	46206333	harbor2	chr10	46053961	46054405	LTR/ERV1	3387	+	222	46054183	47850
chr10	46006333	46206333	harbor2	chr10	46054406	46054554	LTR/ERV1	4399	+	74	46054480	48147
chr10	46006333	46206333	harbor2	chr10	46105142	46105657	LTR/ERV1	3878	+	258	46105400	99067
chr10	132233702	132433702	harbor2	chr10	132312665	132312757	LTR/ERV1	1708	+	46	132312711	79009
chr10	132233702	132433702	harbor2	chr10	132313068	132313324	LTR/ERV1	1708	+	128	132313196	79494
chr10	72525952	72725952	harbor2	chr10	72541052	72541813	LTR/ERV1	4584	+	380	72541432	15480
chr10	72525952	72725952	harbor2	chr10	72543910	72544367	LTR/ERV1	3735	+	228	72544138	18186
chr10	72525952	72725952	harbor2	chr10	72546260	72546629	LTR/ERV1	2084	+	184	72546444	20492
chr10	72525952	72725952	harbor2	chr10	72605050	72605577	LTR/ERV1	2676	+	264	72605314	79362
chr10	72525952	72725952	harbor2	chr10	72608675	72609031	LTR/ERV1	1746	+	178	72608853	82901
chr10	122066259	122266259	harbor2	chr10	122075102	122075187	LTR/ERV1	594	+	42	122075144	8885
chr10	132789479	132989479	harbor2	chr10	132848296	132848877	LTR/ERV1	2171	+	290	132848586	59107
chr10	132789479	132989479	harbor2	chr10	132886660	132886944	LTR/ERV1	714	+	142	132886802	97323
chr10	132789479	132989479	harbor2	chr10	132888070	132888197	LTR/ERV1	538	+	64	132888134	98655
chr10	72255024	72455024	harbor2	chr10	72300429	72302020	LTR/ERV1	11792	+	796	72301225	46201
chr10	72255024	72455024	harbor2	chr10	72325773	72327178	LTR/ERV1	10490	+	702	72326475	71451
chr10	97402365	97602365	harbor2	chr10	97479064	97479267	LTR/ERV1	1304	+	102	97479166	76801
chr10	97402365	97602365	harbor2	chr10	97479310	97479507	LTR/ERV1	1192	+	98	97479408	77043
chr10	97402365	97602365	harbor2	chr10	97479848	97480367	LTR/ERV1	3300	+	260	97480108	77743
chr10	14778687	14978687	harbor2	chr10	14779116	14779192	LTR/ERV1	607	+	38	14779154	467
chr10	14778687	14978687	harbor2	chr10	14812156	14812807	LTR/ERV1	4268	+	326	14812482	33795
chr10	14778687	14978687	harbor2	chr10	14815595	14815891	LTR/ERV1	2593	+	148	14815743	37056
chr10	14778687	14978687	harbor2	chr10	14816198	14816350	LTR/ERV1	2593	+	76	14816274	37587
chr10	102141624	102341624	harbor2	chr10	102185117	102185572	LTR/ERV1	2394	+	228	102185345	43721
chr10	102141624	102341624	harbor2	chr10	102185574	102185660	LTR/ERV1	579	+	43	102185617	43993
chr10	102141624	102341624	harbor2	chr10	102185777	102186059	LTR/ERV1	1594	+	141	102185918	44294
chr10	102141624	102341624	harbor2	chr10	102186227	102186601	LTR/ERV1	1787	+	187	102186414	44790
chr10	102141624	102341624	harbor2	chr10	102189323	102189625	LTR/ERV1	2446	+	151	102189474	47850
chr10	102141624	102341624	harbor2	chr10	102189929	102190030	LTR/ERV1	2446	+	50	102189979	48355
chr10	102141624	102341624	harbor2	chr10	102190298	102190326	LTR/ERV1	1264	+	14	102190312	48688
chr10	102141624	102341624	harbor2	chr10	102190622	102190760	LTR/ERV1	1264	+	69	102190691	49067
chr10	102141624	102341624	harbor2	chr10	102191064	102191112	LTR/ERV1	1264	+	24	102191088	49464
chr10	102141624	102341624	harbor2	chr10	102191437	102191728	LTR/ERV1	1845	+	146	102191583	49959
chr10	102141624	102341624	harbor2	chr10	102191728	102191818	LTR/ERV1	650	+	45	102191773	50149
chr10	102141624	102341624	harbor2	chr10	102191819	102192261	LTR/ERV1	2472	+	221	102192040	50416
chr10	102141624	102341624	harbor2	chr10	102186702	102187010	LTR/ERV1	1723	+	154	102186856	45232
chr10	102141624	102341624	harbor2	chr10	102186979	102187954	LTR/ERV1	6130	+	488	102187467	45843
chr10	72255019	72455019	harbor2	chr10	72300429	72302020	LTR/ERV1	11792	+	796	72301225	46206
chr10	72255019	72455019	harbor2	chr10	72325773	72327178	LTR/ERV1	10490	+	702	72326475	71456
chr10	14778684	14978684	harbor2	chr10	14779116	14779192	LTR/ERV1	607	+	38	14779154	470
chr10	14778684	14978684	harbor2	chr10	14812156	14812807	LTR/ERV1	4268	+	326	14812482	33798
chr10	14778684	14978684	harbor2	chr10	14815595	14815891	LTR/ERV1	2593	+	148	14815743	37059
chr10	14778684	14978684	harbor2	chr10	14816198	14816350	LTR/ERV1	2593	+	76	14816274	37590
chr11	5127098	5327098	harbor2	chr11	5135423	5135970	LTR/ERV1	2531	+	274	5135697	8599
chr11	5127098	5327098	harbor2	chr11	5144231	5145619	LTR/ERV1	9589	+	694	5144925	17827
chr11	5127138	5327138	harbor2	chr11	5135423	5135970	LTR/ERV1	2531	+	274	5135697	8559
chr11	5127138	5327138	harbor2	chr11	5144231	5145619	LTR/ERV1	9589	+	694	5144925	17787
chr11	5127141	5327141	harbor2	chr11	5135423	5135970	LTR/ERV1	2531	+	274	5135697	8556
chr11	5127141	5327141	harbor2	chr11	5144231	5145619	LTR/ERV1	9589	+	694	5144925	17784
chr11	5127548	5327548	harbor2	chr11	5135423	5135970	LTR/ERV1	2531	+	274	5135697	8149
chr11	5127548	5327548	harbor2	chr11	5144231	5145619	LTR/ERV1	9589	+	694	5144925	17377
chr11	76587360	76787360	harbor2	chr11	76605467	76606173	LTR/ERV1	4447	+	353	76605820	18460
chr11	5127182	5327182	harbor2	chr11	5135423	5135970	LTR/ERV1	2531	+	274	5135697	8515
chr11	5127182	5327182	harbor2	chr11	5144231	5145619	LTR/ERV1	9589	+	694	5144925	17743
chr11	5127157	5327157	harbor2	chr11	5135423	5135970	LTR/ERV1	2531	+	274	5135697	8540
chr11	5127157	5327157	harbor2	chr11	5144231	5145619	LTR/ERV1	9589	+	694	5144925	17768
chr11	5128062	5328062	harbor2	chr11	5135423	5135970	LTR/ERV1	2531	+	274	5135697	7635
chr11	5128062	5328062	harbor2	chr11	5144231	5145619	LTR/ERV1	9589	+	694	5144925	16863
chr11	65969869	66169869	harbor2	chr11	66000649	66001148	LTR/ERV1	4074	+	250	66000899	31030
chr11	5127137	5327137	harbor2	chr11	5135423	5135970	LTR/ERV1	2531	+	274	5135697	8560
chr11	5127137	5327137	harbor2	chr11	5144231	5145619	LTR/ERV1	9589	+	694	5144925	17788
chr11	5135292	5335292	harbor2	chr11	5135423	5135970	LTR/ERV1	2531	+	274	5135697	405
chr11	5135292	5335292	harbor2	chr11	5144231	5145619	LTR/ERV1	9589	+	694	5144925	9633
chr11	24165672	24365672	harbor2	chr11	24181335	24181873	LTR/ERV1	1809	+	269	24181604	15932
chr11	5127495	5327495	harbor2	chr11	5135423	5135970	LTR/ERV1	2531	+	274	5135697	8202
chr11	5127495	5327495	harbor2	chr11	5144231	5145619	LTR/ERV1	9589	+	694	5144925	17430
chr11	5191443	5391443	harbor2	chr11	5246542	5246729	LTR/ERV1	1210	+	94	5246636	55193
chr11	5191443	5391443	harbor2	chr11	5251328	5251513	LTR/ERV1	1106	+	92	5251420	59977
chr11	57400290	57600290	harbor2	chr11	57441200	57441307	LTR/ERV1	545	+	54	57441254	40964
chr11	57400290	57600290	harbor2	chr11	57441964	57441990	LTR/ERV1	1008	+	13	57441977	41687
chr11	57400290	57600290	harbor2	chr11	57444277	57444404	LTR/ERV1	836	+	64	57444341	44051
chr11	5128051	5328051	harbor2	chr11	5135423	5135970	LTR/ERV1	2531	+	274	5135697	7646
chr11	5128051	5328051	harbor2	chr11	5144231	5145619	LTR/ERV1	9589	+	694	5144925	16874
chr11	5134388	5334388	harbor2	chr11	5135423	5135970	LTR/ERV1	2531	+	274	5135697	1309
chr11	5134388	5334388	harbor2	chr11	5144231	5145619	LTR/ERV1	9589	+	694	5144925	10537
chr11	5128327	5328327	harbor2	chr11	5135423	5135970	LTR/ERV1	2531	+	274	5135697	7370
chr11	5128327	5328327	harbor2	chr11	5144231	5145619	LTR/ERV1	9589	+	694	5144925	16598
chr11	76580960	76780960	harbor2	chr11	76605467	76606173	LTR/ERV1	4447	+	353	76605820	24860
chr11	5127140	5327140	harbor2	chr11	5135423	5135970	LTR/ERV1	2531	+	274	5135697	8557
chr11	5127140	5327140	harbor2	chr11	5144231	5145619	LTR/ERV1	9589	+	694	5144925	17785
chr11	5134538	5334538	harbor2	chr11	5135423	5135970	LTR/ERV1	2531	+	274	5135697	1159
chr11	5134538	5334538	harbor2	chr11	5144231	5145619	LTR/ERV1	9589	+	694	5144925	10387
chr11	5134084	5334084	harbor2	chr11	5135423	5135970	LTR/ERV1	2531	+	274	5135697	1613
chr11	5134084	5334084	harbor2	chr11	5144231	5145619	LTR/ERV1	9589	+	694	5144925	10841
chr11	5134540	5334540	harbor2	chr11	5135423	5135970	LTR/ERV1	2531	+	274	5135697	1157
chr11	5134540	5334540	harbor2	chr11	5144231	5145619	LTR/ERV1	9589	+	694	5144925	10385
chr11	5127159	5327159	harbor2	chr11	5135423	5135970	LTR/ERV1	2531	+	274	5135697	8538
chr11	5127159	5327159	harbor2	chr11	5144231	5145619	LTR/ERV1	9589	+	694	5144925	17766
chr11	32346594	32546594	harbor2	chr11	32372377	32372484	LTR/ERV1	425	+	54	32372431	25837
chr11	5134020	5334020	harbor2	chr11	5135423	5135970	LTR/ERV1	2531	+	274	5135697	1677
chr11	5134020	5334020	harbor2	chr11	5144231	5145619	LTR/ERV1	9589	+	694	5144925	10905
chr11	108021913	108221913	harbor2	chr11	108022686	108022761	LTR/ERV1	498	+	38	108022724	811
chr11	108021913	108221913	harbor2	chr11	108115814	108116251	LTR/ERV1	2770	+	218	108116032	94119
chr11	5133982	5333982	harbor2	chr11	5135423	5135970	LTR/ERV1	2531	+	274	5135697	1715
chr11	5133982	5333982	harbor2	chr11	5144231	5145619	LTR/ERV1	9589	+	694	5144925	10943
chr11	5128415	5328415	harbor2	chr11	5135423	5135970	LTR/ERV1	2531	+	274	5135697	7282
chr11	5128415	5328415	harbor2	chr11	5144231	5145619	LTR/ERV1	9589	+	694	5144925	16510
chr11	6373185	6573185	harbor2	chr11	6381300	6381487	LTR/ERV1	971	+	94	6381394	8209
chr11	6373185	6573185	harbor2	chr11	6381813	6381976	LTR/ERV1	2856	+	82	6381895	8710
chr11	6373185	6573185	harbor2	chr11	6382302	6382353	LTR/ERV1	2856	+	26	6382328	9143
chr11	6373185	6573185	harbor2	chr11	6382660	6383021	LTR/ERV1	2856	+	180	6382840	9655
chr11	6373185	6573185	harbor2	chr11	6383031	6383185	LTR/ERV1	3068	+	77	6383108	9923
chr11	6373185	6573185	harbor2	chr11	6383467	6384051	LTR/ERV1	3068	+	292	6383759	10574
chr11	6373185	6573185	harbor2	chr11	6385786	6386064	LTR/ERV1	2397	+	139	6385925	12740
chr11	6373185	6573185	harbor2	chr11	6387502	6387668	LTR/ERV1	2397	+	83	6387585	14400
chr11	6373185	6573185	harbor2	chr11	6387827	6387965	LTR/ERV1	1030	+	69	6387896	14711
chr11	6373185	6573185	harbor2	chr11	6388152	6388456	LTR/ERV1	2030	+	152	6388304	15119
chr11	5134352	5334352	harbor2	chr11	5135423	5135970	LTR/ERV1	2531	+	274	5135697	1345
chr11	5134352	5334352	harbor2	chr11	5144231	5145619	LTR/ERV1	9589	+	694	5144925	10573
chr11	5226186	5426186	harbor2	chr11	5246542	5246729	LTR/ERV1	1210	+	94	5246636	20450
chr11	5226186	5426186	harbor2	chr11	5251328	5251513	LTR/ERV1	1106	+	92	5251420	25234
chr11	5134552	5334552	harbor2	chr11	5135423	5135970	LTR/ERV1	2531	+	274	5135697	1145
chr11	5134552	5334552	harbor2	chr11	5144231	5145619	LTR/ERV1	9589	+	694	5144925	10373
chr11	5201291	5401291	harbor2	chr11	5246542	5246729	LTR/ERV1	1210	+	94	5246636	45345
chr11	5201291	5401291	harbor2	chr11	5251328	5251513	LTR/ERV1	1106	+	92	5251420	50129
chr11	5127124	5327124	harbor2	chr11	5135423	5135970	LTR/ERV1	2531	+	274	5135697	8573
chr11	5127124	5327124	harbor2	chr11	5144231	5145619	LTR/ERV1	9589	+	694	5144925	17801
chr11	108021542	108221542	harbor2	chr11	108022686	108022761	LTR/ERV1	498	+	38	108022724	1182
chr11	108021542	108221542	harbor2	chr11	108115814	108116251	LTR/ERV1	2770	+	218	108116032	94490
chr11	5176047	5376047	harbor2	chr11	5246542	5246729	LTR/ERV1	1210	+	94	5246636	70589
chr11	5176047	5376047	harbor2	chr11	5251328	5251513	LTR/ERV1	1106	+	92	5251420	75373
chr11	1471975	1671975	harbor2	chr11	1518691	1519060	LTR/ERV1	1927	+	184	1518875	46900
chr11	5137986	5337986	harbor2	chr11	5144231	5145619	LTR/ERV1	9589	+	694	5144925	6939
chr11	5141739	5341739	harbor2	chr11	5144231	5145619	LTR/ERV1	9589	+	694	5144925	3186
chr11	5175971	5375971	harbor2	chr11	5246542	5246729	LTR/ERV1	1210	+	94	5246636	70665
chr11	5175971	5375971	harbor2	chr11	5251328	5251513	LTR/ERV1	1106	+	92	5251420	75449
chr11	2371480	2571480	harbor2	chr11	2374146	2374291	LTR/ERV1	576	+	72	2374218	2738
chr11	5127119	5327119	harbor2	chr11	5135423	5135970	LTR/ERV1	2531	+	274	5135697	8578
chr11	5127119	5327119	harbor2	chr11	5144231	5145619	LTR/ERV1	9589	+	694	5144925	17806
chr11	5128030	5328030	harbor2	chr11	5135423	5135970	LTR/ERV1	2531	+	274	5135697	7667
chr11	5128030	5328030	harbor2	chr11	5144231	5145619	LTR/ERV1	9589	+	694	5144925	16895
chr11	5127097	5327097	harbor2	chr11	5135423	5135970	LTR/ERV1	2531	+	274	5135697	8600
chr11	5127097	5327097	harbor2	chr11	5144231	5145619	LTR/ERV1	9589	+	694	5144925	17828
chr11	5127546	5327546	harbor2	chr11	5135423	5135970	LTR/ERV1	2531	+	274	5135697	8151
chr11	5127546	5327546	harbor2	chr11	5144231	5145619	LTR/ERV1	9589	+	694	5144925	17379
chr11	5127094	5327094	harbor2	chr11	5135423	5135970	LTR/ERV1	2531	+	274	5135697	8603
chr11	5127094	5327094	harbor2	chr11	5144231	5145619	LTR/ERV1	9589	+	694	5144925	17831
chr11	5140721	5340721	harbor2	chr11	5144231	5145619	LTR/ERV1	9589	+	694	5144925	4204
chr11	76580967	76780967	harbor2	chr11	76605467	76606173	LTR/ERV1	4447	+	353	76605820	24853
chr11	57399778	57599778	harbor2	chr11	57441200	57441307	LTR/ERV1	545	+	54	57441254	41476
chr11	57399778	57599778	harbor2	chr11	57441964	57441990	LTR/ERV1	1008	+	13	57441977	42199
chr11	57399778	57599778	harbor2	chr11	57444277	57444404	LTR/ERV1	836	+	64	57444341	44563
chr11	128776611	128976611	harbor2	chr11	128846775	128847337	LTR/ERV1	2460	+	281	128847056	70445
chr11	5127985	5327985	harbor2	chr11	5135423	5135970	LTR/ERV1	2531	+	274	5135697	7712
chr11	5127985	5327985	harbor2	chr11	5144231	5145619	LTR/ERV1	9589	+	694	5144925	16940
chr11	5134553	5334553	harbor2	chr11	5135423	5135970	LTR/ERV1	2531	+	274	5135697	1144
chr11	5134553	5334553	harbor2	chr11	5144231	5145619	LTR/ERV1	9589	+	694	5144925	10372
chr11	44479732	44679732	harbor2	chr11	44486699	44487067	LTR/ERV1	2630	+	184	44486883	7151
chr11	5127528	5327528	harbor2	chr11	5135423	5135970	LTR/ERV1	2531	+	274	5135697	8169
chr11	5127528	5327528	harbor2	chr11	5144231	5145619	LTR/ERV1	9589	+	694	5144925	17397
chr11	5127122	5327122	harbor2	chr11	5135423	5135970	LTR/ERV1	2531	+	274	5135697	8575
chr11	5127122	5327122	harbor2	chr11	5144231	5145619	LTR/ERV1	9589	+	694	5144925	17803
chr11	5181711	5381711	harbor2	chr11	5246542	5246729	LTR/ERV1	1210	+	94	5246636	64925
chr11	5181711	5381711	harbor2	chr11	5251328	5251513	LTR/ERV1	1106	+	92	5251420	69709
chr11	5221268	5421268	harbor2	chr11	5246542	5246729	LTR/ERV1	1210	+	94	5246636	25368
chr11	5221268	5421268	harbor2	chr11	5251328	5251513	LTR/ERV1	1106	+	92	5251420	30152
chr11	108021539	108221539	harbor2	chr11	108022686	108022761	LTR/ERV1	498	+	38	108022724	1185
chr11	108021539	108221539	harbor2	chr11	108115814	108116251	LTR/ERV1	2770	+	218	108116032	94493
chr11	73152931	73352931	harbor2	chr11	73170400	73170531	LTR/ERV1	418	+	66	73170466	17535
chr11	5134462	5334462	harbor2	chr11	5135423	5135970	LTR/ERV1	2531	+	274	5135697	1235
chr11	5134462	5334462	harbor2	chr11	5144231	5145619	LTR/ERV1	9589	+	694	5144925	10463
chr11	125389599	125589599	harbor2	chr11	125458513	125458786	LTR/ERV1	728	+	136	125458649	69050
chr11	125389599	125589599	harbor2	chr11	125459096	125459165	LTR/ERV1	728	+	34	125459130	69531
chr11	125389599	125589599	harbor2	chr11	125459173	125459309	LTR/ERV1	929	+	68	125459241	69642
chr11	125389599	125589599	harbor2	chr11	125459617	125459708	LTR/ERV1	929	+	46	125459663	70064
chr11	124701200	124901200	harbor2	chr11	124734863	124735525	LTR/ERV1	3694	+	331	124735194	33994
chr11	5135406	5335406	harbor2	chr11	5135423	5135970	LTR/ERV1	2531	+	274	5135697	291
chr11	5135406	5335406	harbor2	chr11	5144231	5145619	LTR/ERV1	9589	+	694	5144925	9519
chr11	5134536	5334536	harbor2	chr11	5135423	5135970	LTR/ERV1	2531	+	274	5135697	1161
chr11	5134536	5334536	harbor2	chr11	5144231	5145619	LTR/ERV1	9589	+	694	5144925	10389
chr11	76580928	76780928	harbor2	chr11	76605467	76606173	LTR/ERV1	4447	+	353	76605820	24892
chr11	5141120	5341120	harbor2	chr11	5144231	5145619	LTR/ERV1	9589	+	694	5144925	3805
chr11	5127125	5327125	harbor2	chr11	5135423	5135970	LTR/ERV1	2531	+	274	5135697	8572
chr11	5127125	5327125	harbor2	chr11	5144231	5145619	LTR/ERV1	9589	+	694	5144925	17800
chr11	5191352	5391352	harbor2	chr11	5246542	5246729	LTR/ERV1	1210	+	94	5246636	55284
chr11	5191352	5391352	harbor2	chr11	5251328	5251513	LTR/ERV1	1106	+	92	5251420	60068
chr11	67383369	67583369	harbor2	chr11	67446493	67446563	LTR/ERV1	4590	+	35	67446528	63159
chr11	67383369	67583369	harbor2	chr11	67446874	67447059	LTR/ERV1	4590	+	92	67446966	63597
chr11	67383369	67583369	harbor2	chr11	67447374	67447781	LTR/ERV1	4590	+	204	67447578	64209
chr11	67383369	67583369	harbor2	chr11	67475910	67477234	LTR/ERV1	9575	+	662	67476572	93203
chr11	5145521	5345521	harbor2	chr11	5144231	5145619	LTR/ERV1	9589	+	694	5144925	596
chr11	68651712	68851712	harbor2	chr11	68694466	68695351	LTR/ERV1	5675	+	442	68694908	43196
chr11	5134532	5334532	harbor2	chr11	5135423	5135970	LTR/ERV1	2531	+	274	5135697	1165
chr11	5134532	5334532	harbor2	chr11	5144231	5145619	LTR/ERV1	9589	+	694	5144925	10393
chr11	72131325	72331325	harbor2	chr11	72143209	72143858	LTR/ERV1	1595	+	324	72143533	12208
chr11	72131325	72331325	harbor2	chr11	72144869	72145038	LTR/ERV1	500	+	84	72144953	13628
chr11	72131325	72331325	harbor2	chr11	72145339	72145414	LTR/ERV1	500	+	38	72145377	14052
chr11	72131325	72331325	harbor2	chr11	72146246	72146474	LTR/ERV1	872	+	114	72146360	15035
chr11	72131325	72331325	harbor2	chr11	72146475	72146920	LTR/ERV1	2031	+	222	72146697	15372
chr11	72131325	72331325	harbor2	chr11	72147039	72147368	LTR/ERV1	2031	+	164	72147203	15878
chr11	72131325	72331325	harbor2	chr11	72149027	72149448	LTR/ERV1	2992	+	210	72149237	17912
chr11	72131325	72331325	harbor2	chr11	72149754	72149910	LTR/ERV1	2992	+	78	72149832	18507
chr11	72131325	72331325	harbor2	chr11	72153927	72154685	LTR/ERV1	6143	+	379	72154306	22981
chr11	72131325	72331325	harbor2	chr11	72157557	72158144	LTR/ERV1	4731	+	294	72157851	26526
chr11	72131325	72331325	harbor2	chr11	72158442	72158499	LTR/ERV1	4731	+	28	72158470	27145
chr11	72131325	72331325	harbor2	chr11	72182012	72182405	LTR/ERV1	1370	+	196	72182208	50883
chr11	72131325	72331325	harbor2	chr11	72182704	72182870	LTR/ERV1	1370	+	83	72182787	51462
chr11	72131325	72331325	harbor2	chr11	72185491	72185815	LTR/ERV1	895	+	162	72185653	54328
chr11	72131325	72331325	harbor2	chr11	72185816	72185836	LTR/ERV1	886	+	10	72185826	54501
chr11	72131325	72331325	harbor2	chr11	72186148	72186397	LTR/ERV1	886	+	124	72186272	54947
chr11	72131325	72331325	harbor2	chr11	72186760	72186912	LTR/ERV1	580	+	76	72186836	55511
chr11	72131325	72331325	harbor2	chr11	72187220	72187241	LTR/ERV1	580	+	10	72187230	55905
chr11	72131325	72331325	harbor2	chr11	72188326	72188615	LTR/ERV1	1372	+	144	72188470	57145
chr11	5127149	5327149	harbor2	chr11	5135423	5135970	LTR/ERV1	2531	+	274	5135697	8548
chr11	5127149	5327149	harbor2	chr11	5144231	5145619	LTR/ERV1	9589	+	694	5144925	17776
chr11	5128043	5328043	harbor2	chr11	5135423	5135970	LTR/ERV1	2531	+	274	5135697	7654
chr11	5128043	5328043	harbor2	chr11	5144231	5145619	LTR/ERV1	9589	+	694	5144925	16882
chr11	5129645	5329645	harbor2	chr11	5135423	5135970	LTR/ERV1	2531	+	274	5135697	6052
chr11	5129645	5329645	harbor2	chr11	5144231	5145619	LTR/ERV1	9589	+	694	5144925	15280
chr11	5175946	5375946	harbor2	chr11	5246542	5246729	LTR/ERV1	1210	+	94	5246636	70690
chr11	5175946	5375946	harbor2	chr11	5251328	5251513	LTR/ERV1	1106	+	92	5251420	75474
chr11	5134537	5334537	harbor2	chr11	5135423	5135970	LTR/ERV1	2531	+	274	5135697	1160
chr11	5134537	5334537	harbor2	chr11	5144231	5145619	LTR/ERV1	9589	+	694	5144925	10388
chr11	108021866	108221866	harbor2	chr11	108022686	108022761	LTR/ERV1	498	+	38	108022724	858
chr11	108021866	108221866	harbor2	chr11	108115814	108116251	LTR/ERV1	2770	+	218	108116032	94166
chr11	5145526	5345526	harbor2	chr11	5144231	5145619	LTR/ERV1	9589	+	694	5144925	601
chr11	108021556	108221556	harbor2	chr11	108022686	108022761	LTR/ERV1	498	+	38	108022724	1168
chr11	108021556	108221556	harbor2	chr11	108115814	108116251	LTR/ERV1	2770	+	218	108116032	94476
chr11	5134924	5334924	harbor2	chr11	5135423	5135970	LTR/ERV1	2531	+	274	5135697	773
chr11	5134924	5334924	harbor2	chr11	5144231	5145619	LTR/ERV1	9589	+	694	5144925	10001
chr11	5127139	5327139	harbor2	chr11	5135423	5135970	LTR/ERV1	2531	+	274	5135697	8558
chr11	5127139	5327139	harbor2	chr11	5144231	5145619	LTR/ERV1	9589	+	694	5144925	17786
chr11	5503303	5703303	harbor2	chr11	5589230	5589640	LTR/ERV1	730	+	205	5589435	86132
chr11	5503303	5703303	harbor2	chr11	5589695	5591016	LTR/ERV1	9744	+	660	5590355	87052
chr11	6583608	6783608	harbor2	chr11	6586520	6587937	LTR/ERV1	5342	+	708	6587228	3620
chr11	6583608	6783608	harbor2	chr11	6594457	6594828	LTR/ERV1	492	+	186	6594643	11035
chr11	46517295	46717295	harbor2	chr11	46566679	46566927	LTR/ERV1	1571	+	124	46566803	49508
chr11	46517295	46717295	harbor2	chr11	46567661	46567863	LTR/ERV1	753	+	101	46567762	50467
chr11	125492737	125692737	harbor2	chr11	125506295	125506736	LTR/ERV1	2875	+	220	125506515	13778
chr11	125492737	125692737	harbor2	chr11	125507045	125507075	LTR/ERV1	2875	+	15	125507060	14323
chr11	125492737	125692737	harbor2	chr11	125511868	125511948	LTR/ERV1	467	+	40	125511908	19171
chr11	125492737	125692737	harbor2	chr11	125511949	125512392	LTR/ERV1	2031	+	222	125512171	19434
chr11	125492737	125692737	harbor2	chr11	125512599	125512661	LTR/ERV1	1913	+	31	125512630	19893
chr11	125492737	125692737	harbor2	chr11	125512970	125513374	LTR/ERV1	1913	+	202	125513172	20435
chr11	125492737	125692737	harbor2	chr11	125513688	125513892	LTR/ERV1	1913	+	102	125513790	21053
chr11	125492737	125692737	harbor2	chr11	125519621	125520337	LTR/ERV1	4258	+	358	125519979	27242
chr11	125492737	125692737	harbor2	chr11	125524013	125524138	LTR/ERV1	480	+	62	125524075	31338
chr11	125492737	125692737	harbor2	chr11	125525332	125525366	LTR/ERV1	1029	+	17	125525349	32612
chr11	125492737	125692737	harbor2	chr11	125525730	125525874	LTR/ERV1	1029	+	72	125525802	33065
chr11	125492737	125692737	harbor2	chr11	125526179	125526279	LTR/ERV1	1029	+	50	125526229	33492
chr11	125492737	125692737	harbor2	chr11	125526274	125526641	LTR/ERV1	1971	+	184	125526458	33721
chr11	125492737	125692737	harbor2	chr11	125526919	125527102	LTR/ERV1	925	+	92	125527011	34274
chr11	125492737	125692737	harbor2	chr11	125527220	125527355	LTR/ERV1	412	+	68	125527288	34551
chr11	125492737	125692737	harbor2	chr11	125535257	125536031	LTR/ERV1	4725	+	387	125535644	42907
chr11	125492737	125692737	harbor2	chr11	125536059	125536264	LTR/ERV1	1069	+	102	125536161	43424
chr11	125492737	125692737	harbor2	chr11	125536567	125536605	LTR/ERV1	1069	+	19	125536586	43849
chr11	125492737	125692737	harbor2	chr11	125542655	125543347	LTR/ERV1	3627	+	346	125543001	50264
chr11	125492737	125692737	harbor2	chr11	125543348	125543762	LTR/ERV1	2423	+	207	125543555	50818
chr11	125492737	125692737	harbor2	chr11	125543763	125544263	LTR/ERV1	12910	+	250	125544013	51276
chr11	125492737	125692737	harbor2	chr11	125544605	125544860	LTR/ERV1	12910	+	128	125544733	51996
chr11	125492737	125692737	harbor2	chr11	125545163	125547199	LTR/ERV1	12910	+	1018	125546181	53444
chr11	125492737	125692737	harbor2	chr11	125547200	125547417	LTR/ERV1	1648	+	108	125547308	54571
chr11	125492737	125692737	harbor2	chr11	125547726	125547780	LTR/ERV1	1648	+	27	125547753	55016
chr11	125492737	125692737	harbor2	chr11	125551738	125552166	LTR/ERV1	2461	+	214	125551952	59215
chr11	125492737	125692737	harbor2	chr11	125556622	125557700	LTR/ERV1	29257	+	539	125557161	64424
chr11	125492737	125692737	harbor2	chr11	125558002	125558479	LTR/ERV1	29257	+	238	125558240	65503
chr11	125492737	125692737	harbor2	chr11	125558775	125558804	LTR/ERV1	29257	+	14	125558789	66052
chr11	125492737	125692737	harbor2	chr11	125559090	125559294	LTR/ERV1	29257	+	102	125559192	66455
chr11	125492737	125692737	harbor2	chr11	125559583	125560308	LTR/ERV1	29257	+	362	125559945	67208
chr11	125492737	125692737	harbor2	chr11	125560616	125562427	LTR/ERV1	29257	+	906	125561522	68785
chr11	125492737	125692737	harbor2	chr11	125562463	125562850	LTR/ERV1	2785	+	194	125562657	69920
chr11	125492737	125692737	harbor2	chr11	125562851	125563247	LTR/ERV1	1874	+	198	125563049	70312
chr11	125492737	125692737	harbor2	chr11	125563551	125563655	LTR/ERV1	4035	+	52	125563603	70866
chr11	125492737	125692737	harbor2	chr11	125563956	125564490	LTR/ERV1	4035	+	267	125564223	71486
chr11	5127134	5327134	harbor2	chr11	5135423	5135970	LTR/ERV1	2531	+	274	5135697	8563
chr11	5127134	5327134	harbor2	chr11	5144231	5145619	LTR/ERV1	9589	+	694	5144925	17791
chr11	5134274	5334274	harbor2	chr11	5135423	5135970	LTR/ERV1	2531	+	274	5135697	1423
chr11	5134274	5334274	harbor2	chr11	5144231	5145619	LTR/ERV1	9589	+	694	5144925	10651
chr11	6512776	6712776	harbor2	chr11	6586520	6587937	LTR/ERV1	5342	+	708	6587228	74452
chr11	6512776	6712776	harbor2	chr11	6594457	6594828	LTR/ERV1	492	+	186	6594643	81867
chr11	5211379	5411379	harbor2	chr11	5246542	5246729	LTR/ERV1	1210	+	94	5246636	35257
chr11	5211379	5411379	harbor2	chr11	5251328	5251513	LTR/ERV1	1106	+	92	5251420	40041
chr11	5134545	5334545	harbor2	chr11	5135423	5135970	LTR/ERV1	2531	+	274	5135697	1152
chr11	5134545	5334545	harbor2	chr11	5144231	5145619	LTR/ERV1	9589	+	694	5144925	10380
chr11	5130232	5330232	harbor2	chr11	5135423	5135970	LTR/ERV1	2531	+	274	5135697	5465
chr11	5130232	5330232	harbor2	chr11	5144231	5145619	LTR/ERV1	9589	+	694	5144925	14693
chr11	5127145	5327145	harbor2	chr11	5135423	5135970	LTR/ERV1	2531	+	274	5135697	8552
chr11	5127145	5327145	harbor2	chr11	5144231	5145619	LTR/ERV1	9589	+	694	5144925	17780
chr11	5134509	5334509	harbor2	chr11	5135423	5135970	LTR/ERV1	2531	+	274	5135697	1188
chr11	5134509	5334509	harbor2	chr11	5144231	5145619	LTR/ERV1	9589	+	694	5144925	10416
chr11	5127131	5327131	harbor2	chr11	5135423	5135970	LTR/ERV1	2531	+	274	5135697	8566
chr11	5127131	5327131	harbor2	chr11	5144231	5145619	LTR/ERV1	9589	+	694	5144925	17794
chr11	1471923	1671923	harbor2	chr11	1518691	1519060	LTR/ERV1	1927	+	184	1518875	46952
chr11	108021552	108221552	harbor2	chr11	108022686	108022761	LTR/ERV1	498	+	38	108022724	1172
chr11	108021552	108221552	harbor2	chr11	108115814	108116251	LTR/ERV1	2770	+	218	108116032	94480
chr11	5135402	5335402	harbor2	chr11	5135423	5135970	LTR/ERV1	2531	+	274	5135697	295
chr11	5135402	5335402	harbor2	chr11	5144231	5145619	LTR/ERV1	9589	+	694	5144925	9523
chr11	5127113	5327113	harbor2	chr11	5135423	5135970	LTR/ERV1	2531	+	274	5135697	8584
chr11	5127113	5327113	harbor2	chr11	5144231	5145619	LTR/ERV1	9589	+	694	5144925	17812
chr11	5127198	5327198	harbor2	chr11	5135423	5135970	LTR/ERV1	2531	+	274	5135697	8499
chr11	5127198	5327198	harbor2	chr11	5144231	5145619	LTR/ERV1	9589	+	694	5144925	17727
chr11	76580957	76780957	harbor2	chr11	76605467	76606173	LTR/ERV1	4447	+	353	76605820	24863
chr11	5199897	5399897	harbor2	chr11	5246542	5246729	LTR/ERV1	1210	+	94	5246636	46739
chr11	5199897	5399897	harbor2	chr11	5251328	5251513	LTR/ERV1	1106	+	92	5251420	51523
chr11	5134148	5334148	harbor2	chr11	5135423	5135970	LTR/ERV1	2531	+	274	5135697	1549
chr11	5134148	5334148	harbor2	chr11	5144231	5145619	LTR/ERV1	9589	+	694	5144925	10777
chr11	5129657	5329657	harbor2	chr11	5135423	5135970	LTR/ERV1	2531	+	274	5135697	6040
chr11	5129657	5329657	harbor2	chr11	5144231	5145619	LTR/ERV1	9589	+	694	5144925	15268
chr11	5127118	5327118	harbor2	chr11	5135423	5135970	LTR/ERV1	2531	+	274	5135697	8579
chr11	5127118	5327118	harbor2	chr11	5144231	5145619	LTR/ERV1	9589	+	694	5144925	17807
chr11	461593	661593	harbor2	chr11	505032	505252	LTR/ERV1	1273	+	110	505142	43549
chr11	461593	661593	harbor2	chr11	512918	513076	LTR/ERV1	931	+	79	512997	51404
chr11	5130451	5330451	harbor2	chr11	5135423	5135970	LTR/ERV1	2531	+	274	5135697	5246
chr11	5130451	5330451	harbor2	chr11	5144231	5145619	LTR/ERV1	9589	+	694	5144925	14474
chr11	43955448	44155448	harbor2	chr11	43961752	43962088	LTR/ERV1	2263	+	168	43961920	6472
chr11	43955448	44155448	harbor2	chr11	43957922	43958628	LTR/ERV1	2882	+	353	43958275	2827
chr11	78110765	78310765	harbor2	chr11	78178638	78179202	LTR/ERV1	3374	+	282	78178920	68155
chr11	84774083	84974083	harbor2	chr11	84794313	84796143	LTR/ERV1	7666	+	915	84795228	21145
chr11	64349298	64549298	harbor2	chr11	64408540	64408630	LTR/ERV1	769	+	45	64408585	59287
chr11	64349298	64549298	harbor2	chr11	64408932	64409211	LTR/ERV1	1431	+	140	64409072	59774
chr11	64349298	64549298	harbor2	chr11	64413610	64414050	LTR/ERV1	4004	+	220	64413830	64532
chr11	64349298	64549298	harbor2	chr11	64414792	64414910	LTR/ERV1	4004	+	59	64414851	65553
chr11	108021537	108221537	harbor2	chr11	108022686	108022761	LTR/ERV1	498	+	38	108022724	1187
chr11	108021537	108221537	harbor2	chr11	108115814	108116251	LTR/ERV1	2770	+	218	108116032	94495
chr11	5191359	5391359	harbor2	chr11	5246542	5246729	LTR/ERV1	1210	+	94	5246636	55277
chr11	5191359	5391359	harbor2	chr11	5251328	5251513	LTR/ERV1	1106	+	92	5251420	60061
chr11	5130062	5330062	harbor2	chr11	5135423	5135970	LTR/ERV1	2531	+	274	5135697	5635
chr11	5130062	5330062	harbor2	chr11	5144231	5145619	LTR/ERV1	9589	+	694	5144925	14863
chr11	5191377	5391377	harbor2	chr11	5246542	5246729	LTR/ERV1	1210	+	94	5246636	55259
chr11	5191377	5391377	harbor2	chr11	5251328	5251513	LTR/ERV1	1106	+	92	5251420	60043
chr11	5132412	5332412	harbor2	chr11	5135423	5135970	LTR/ERV1	2531	+	274	5135697	3285
chr11	5132412	5332412	harbor2	chr11	5144231	5145619	LTR/ERV1	9589	+	694	5144925	12513
chr11	5129603	5329603	harbor2	chr11	5135423	5135970	LTR/ERV1	2531	+	274	5135697	6094
chr11	5129603	5329603	harbor2	chr11	5144231	5145619	LTR/ERV1	9589	+	694	5144925	15322
chr11	73152932	73352932	harbor2	chr11	73170400	73170531	LTR/ERV1	418	+	66	73170466	17534
chr11	5134257	5334257	harbor2	chr11	5135423	5135970	LTR/ERV1	2531	+	274	5135697	1440
chr11	5134257	5334257	harbor2	chr11	5144231	5145619	LTR/ERV1	9589	+	694	5144925	10668
chr11	5227113	5427113	harbor2	chr11	5246542	5246729	LTR/ERV1	1210	+	94	5246636	19523
chr11	5227113	5427113	harbor2	chr11	5251328	5251513	LTR/ERV1	1106	+	92	5251420	24307
chr11	133733618	133933618	harbor2	chr11	133782166	133783649	LTR/ERV1	10847	+	742	133782908	49290
chr11	27266585	27466585	harbor2	chr11	27304507	27306094	LTR/ERV1	7298	+	794	27305301	38716
chr11	108021538	108221538	harbor2	chr11	108022686	108022761	LTR/ERV1	498	+	38	108022724	1186
chr11	108021538	108221538	harbor2	chr11	108115814	108116251	LTR/ERV1	2770	+	218	108116032	94494
chr11	9360730	9560730	harbor2	chr11	9364994	9365144	LTR/ERV1	2489	+	75	9365069	4339
chr11	9360730	9560730	harbor2	chr11	9365750	9366023	LTR/ERV1	2489	+	136	9365886	5156
chr11	9360730	9560730	harbor2	chr11	9378575	9378668	LTR/ERV1	4920	+	46	9378621	17891
chr11	9360730	9560730	harbor2	chr11	9378975	9379760	LTR/ERV1	4920	+	392	9379367	18637
chr11	5140120	5340120	harbor2	chr11	5144231	5145619	LTR/ERV1	9589	+	694	5144925	4805
chr11	5199336	5399336	harbor2	chr11	5246542	5246729	LTR/ERV1	1210	+	94	5246636	47300
chr11	5199336	5399336	harbor2	chr11	5251328	5251513	LTR/ERV1	1106	+	92	5251420	52084
chr11	45786822	45986822	harbor2	chr11	45823390	45823880	LTR/ERV1	4137	+	245	45823635	36813
chr11	45786822	45986822	harbor2	chr11	45825202	45825655	LTR/ERV1	1506	+	226	45825428	38606
chr11	45786822	45986822	harbor2	chr11	45872343	45872457	LTR/ERV1	742	+	57	45872400	85578
chr11	32377105	32577105	harbor2	chr11	32473115	32473256	LTR/ERV1	978	+	70	32473185	96080
chr11	32377105	32577105	harbor2	chr11	32473284	32473603	LTR/ERV1	2171	+	160	32473444	96339
chr11	5135401	5335401	harbor2	chr11	5135423	5135970	LTR/ERV1	2531	+	274	5135697	296
chr11	5135401	5335401	harbor2	chr11	5144231	5145619	LTR/ERV1	9589	+	694	5144925	9524
chr11	10799794	10999794	harbor2	chr11	10862486	10862946	LTR/ERV1	2503	+	230	10862716	62922
chr11	47115696	47315696	harbor2	chr11	47192240	47192651	LTR/ERV1	3677	+	206	47192446	76750
chr11	47115696	47315696	harbor2	chr11	47192951	47192999	LTR/ERV1	3677	+	24	47192975	77279
chr11	47115696	47315696	harbor2	chr11	47193296	47193432	LTR/ERV1	3677	+	68	47193364	77668
chr11	47115696	47315696	harbor2	chr11	47196344	47196514	LTR/ERV1	1804	+	85	47196429	80733
chr11	47115696	47315696	harbor2	chr11	47198304	47198318	LTR/ERV1	1804	+	7	47198311	82615
chr11	47115696	47315696	harbor2	chr11	47198627	47198859	LTR/ERV1	1804	+	116	47198743	83047
chr11	47115696	47315696	harbor2	chr11	47209045	47209207	LTR/ERV1	4841	+	81	47209126	93430
chr11	47115696	47315696	harbor2	chr11	47209483	47209900	LTR/ERV1	4841	+	208	47209691	93995
chr11	47115696	47315696	harbor2	chr11	47210206	47210380	LTR/ERV1	4841	+	87	47210293	94597
chr11	5130296	5330296	harbor2	chr11	5135423	5135970	LTR/ERV1	2531	+	274	5135697	5401
chr11	5130296	5330296	harbor2	chr11	5144231	5145619	LTR/ERV1	9589	+	694	5144925	14629
chr11	5127143	5327143	harbor2	chr11	5135423	5135970	LTR/ERV1	2531	+	274	5135697	8554
chr11	5127143	5327143	harbor2	chr11	5144231	5145619	LTR/ERV1	9589	+	694	5144925	17782
chr11	2288029	2488029	harbor2	chr11	2335043	2335124	LTR/ERV1	511	+	40	2335083	47054
chr11	2288029	2488029	harbor2	chr11	2335785	2336242	LTR/ERV1	2310	+	228	2336013	47984
chr11	2288029	2488029	harbor2	chr11	2336261	2337444	LTR/ERV1	3207	+	592	2336853	48824
chr11	2288029	2488029	harbor2	chr11	2337443	2337624	LTR/ERV1	1061	+	90	2337533	49504
chr11	2288029	2488029	harbor2	chr11	2337605	2338513	LTR/ERV1	3718	+	454	2338059	50030
chr11	2288029	2488029	harbor2	chr11	2338514	2338768	LTR/ERV1	4201	+	127	2338641	50612
chr11	2288029	2488029	harbor2	chr11	2339201	2339318	LTR/ERV1	4201	+	58	2339259	51230
chr11	2288029	2488029	harbor2	chr11	2339319	2339771	LTR/ERV1	3501	+	226	2339545	51516
chr11	2288029	2488029	harbor2	chr11	2339772	2339998	LTR/ERV1	4201	+	113	2339885	51856
chr11	2288029	2488029	harbor2	chr11	2340000	2341044	LTR/ERV1	4642	+	522	2340522	52493
chr11	2288029	2488029	harbor2	chr11	2341053	2341847	LTR/ERV1	3232	+	397	2341450	53421
chr11	2288029	2488029	harbor2	chr11	2342022	2342573	LTR/ERV1	3301	+	276	2342298	54269
chr11	2288029	2488029	harbor2	chr11	2374146	2374291	LTR/ERV1	576	+	72	2374218	86189
chr11	5127183	5327183	harbor2	chr11	5135423	5135970	LTR/ERV1	2531	+	274	5135697	8514
chr11	5127183	5327183	harbor2	chr11	5144231	5145619	LTR/ERV1	9589	+	694	5144925	17742
chr11	5127212	5327212	harbor2	chr11	5135423	5135970	LTR/ERV1	2531	+	274	5135697	8485
chr11	5127212	5327212	harbor2	chr11	5144231	5145619	LTR/ERV1	9589	+	694	5144925	17713
chr11	5134525	5334525	harbor2	chr11	5135423	5135970	LTR/ERV1	2531	+	274	5135697	1172
chr11	5134525	5334525	harbor2	chr11	5144231	5145619	LTR/ERV1	9589	+	694	5144925	10400
chr11	5130571	5330571	harbor2	chr11	5135423	5135970	LTR/ERV1	2531	+	274	5135697	5126
chr11	5130571	5330571	harbor2	chr11	5144231	5145619	LTR/ERV1	9589	+	694	5144925	14354
chr11	5130397	5330397	harbor2	chr11	5135423	5135970	LTR/ERV1	2531	+	274	5135697	5300
chr11	5130397	5330397	harbor2	chr11	5144231	5145619	LTR/ERV1	9589	+	694	5144925	14528
chr11	22729649	22929649	harbor2	chr11	22783521	22783719	LTR/ERV1	1401	+	99	22783620	53971
chr11	702826	902826	harbor2	chr11	745478	745813	LTR/ERV1	2401	+	168	745646	42820
chr11	702826	902826	harbor2	chr11	746101	746133	LTR/ERV1	2401	+	16	746117	43291
chr11	702826	902826	harbor2	chr11	746428	746778	LTR/ERV1	2401	+	175	746603	43777
chr11	5204580	5404580	harbor2	chr11	5246542	5246729	LTR/ERV1	1210	+	94	5246636	42056
chr11	5204580	5404580	harbor2	chr11	5251328	5251513	LTR/ERV1	1106	+	92	5251420	46840
chr11	38440721	38640721	harbor2	chr11	38481304	38482098	LTR/ERV1	5184	+	397	38481701	40980
chr11	38440721	38640721	harbor2	chr11	38503622	38504330	LTR/ERV1	4444	+	354	38503976	63255
chr11	108021971	108221971	harbor2	chr11	108022686	108022761	LTR/ERV1	498	+	38	108022724	753
chr11	108021971	108221971	harbor2	chr11	108115814	108116251	LTR/ERV1	2770	+	218	108116032	94061
chr11	63743240	63943240	harbor2	chr11	63791140	63791220	LTR/ERV1	4467	+	40	63791180	47940
chr11	63743240	63943240	harbor2	chr11	63791518	63792075	LTR/ERV1	4467	+	278	63791796	48556
chr11	5140756	5340756	harbor2	chr11	5144231	5145619	LTR/ERV1	9589	+	694	5144925	4169
chr11	5128321	5328321	harbor2	chr11	5135423	5135970	LTR/ERV1	2531	+	274	5135697	7376
chr11	5128321	5328321	harbor2	chr11	5144231	5145619	LTR/ERV1	9589	+	694	5144925	16604
chr11	5127556	5327556	harbor2	chr11	5135423	5135970	LTR/ERV1	2531	+	274	5135697	8141
chr11	5127556	5327556	harbor2	chr11	5144231	5145619	LTR/ERV1	9589	+	694	5144925	17369
chr11	65948857	66148857	harbor2	chr11	66000649	66001148	LTR/ERV1	4074	+	250	66000899	52042
chr11	3245481	3445481	harbor2	chr11	3251241	3251798	LTR/ERV1	2953	+	278	3251519	6038
chr11	3245481	3445481	harbor2	chr11	3251988	3252534	LTR/ERV1	3153	+	273	3252261	6780
chr11	3245481	3445481	harbor2	chr11	3261692	3262304	LTR/ERV1	2072	+	306	3261998	16517
chr11	3245481	3445481	harbor2	chr11	3274885	3275085	LTR/ERV1	1540	+	100	3274985	29504
chr11	3245481	3445481	harbor2	chr11	3275383	3275584	LTR/ERV1	1540	+	100	3275483	30002
chr11	3245481	3445481	harbor2	chr11	3278869	3279298	LTR/ERV1	1161	+	214	3279083	33602
chr11	3245481	3445481	harbor2	chr11	3283221	3283735	LTR/ERV1	3530	+	257	3283478	37997
chr11	3245481	3445481	harbor2	chr11	3297044	3297601	LTR/ERV1	3135	+	278	3297322	51841
chr11	3245481	3445481	harbor2	chr11	3297791	3298337	LTR/ERV1	3264	+	273	3298064	52583
chr11	3245481	3445481	harbor2	chr11	3307522	3308133	LTR/ERV1	2155	+	306	3307828	62347
chr11	3245481	3445481	harbor2	chr11	3320704	3320904	LTR/ERV1	1631	+	100	3320804	75323
chr11	3245481	3445481	harbor2	chr11	3321200	3321401	LTR/ERV1	1631	+	100	3321300	75819
chr11	3245481	3445481	harbor2	chr11	3324685	3325114	LTR/ERV1	1175	+	214	3324899	79418
chr11	3245481	3445481	harbor2	chr11	3329038	3329552	LTR/ERV1	3549	+	257	3329295	83814
chr11	9520097	9720097	harbor2	chr11	9533693	9534033	LTR/ERV1	1937	+	170	9533863	13766
chr11	9520097	9720097	harbor2	chr11	9534034	9534453	LTR/ERV1	2723	+	210	9534244	14147
chr11	9520097	9720097	harbor2	chr11	9534454	9534610	LTR/ERV1	1937	+	78	9534532	14435
chr11	5143135	5343135	harbor2	chr11	5144231	5145619	LTR/ERV1	9589	+	694	5144925	1790
chr11	5134529	5334529	harbor2	chr11	5135423	5135970	LTR/ERV1	2531	+	274	5135697	1168
chr11	5134529	5334529	harbor2	chr11	5144231	5145619	LTR/ERV1	9589	+	694	5144925	10396
chr11	5141844	5341844	harbor2	chr11	5144231	5145619	LTR/ERV1	9589	+	694	5144925	3081
chr11	58480005	58680005	harbor2	chr11	58531779	58533240	LTR/ERV1	8817	+	730	58532509	52504
chr11	58480005	58680005	harbor2	chr11	58546777	58547104	LTR/ERV1	692	+	164	58546941	66936
chr11	58480005	58680005	harbor2	chr11	58547433	58547925	LTR/ERV1	741	+	246	58547679	67674
chr11	3116281	3316281	harbor2	chr11	3115175	3116573	LTR/ERV1	15487	+	699	3115874	407
chr11	3116281	3316281	harbor2	chr11	3116876	3118164	LTR/ERV1	15487	+	644	3117520	1239
chr11	3116281	3316281	harbor2	chr11	3118166	3118570	LTR/ERV1	3224	+	202	3118368	2087
chr11	3116281	3316281	harbor2	chr11	3118869	3118925	LTR/ERV1	3224	+	28	3118897	2616
chr11	3116281	3316281	harbor2	chr11	3211590	3212029	LTR/ERV1	2766	+	220	3211810	95529
chr11	464063	664063	harbor2	chr11	505032	505252	LTR/ERV1	1273	+	110	505142	41079
chr11	464063	664063	harbor2	chr11	512918	513076	LTR/ERV1	931	+	79	512997	48934
chr11	5134380	5334380	harbor2	chr11	5135423	5135970	LTR/ERV1	2531	+	274	5135697	1317
chr11	5134380	5334380	harbor2	chr11	5144231	5145619	LTR/ERV1	9589	+	694	5144925	10545
chr11	5130263	5330263	harbor2	chr11	5135423	5135970	LTR/ERV1	2531	+	274	5135697	5434
chr11	5130263	5330263	harbor2	chr11	5144231	5145619	LTR/ERV1	9589	+	694	5144925	14662
chr11	76580984	76780984	harbor2	chr11	76605467	76606173	LTR/ERV1	4447	+	353	76605820	24836
chr11	76580958	76780958	harbor2	chr11	76605467	76606173	LTR/ERV1	4447	+	353	76605820	24862
chr11	11446354	11646354	harbor2	chr11	11476781	11477142	LTR/ERV1	725	+	180	11476961	30607
chr11	11446354	11646354	harbor2	chr11	11477386	11477610	LTR/ERV1	637	+	112	11477498	31144
chr11	11446354	11646354	harbor2	chr11	11477634	11477864	LTR/ERV1	580	+	115	11477749	31395
chr11	108021777	108221777	harbor2	chr11	108022686	108022761	LTR/ERV1	498	+	38	108022724	947
chr11	108021777	108221777	harbor2	chr11	108115814	108116251	LTR/ERV1	2770	+	218	108116032	94255
chr11	5127207	5327207	harbor2	chr11	5135423	5135970	LTR/ERV1	2531	+	274	5135697	8490
chr11	5127207	5327207	harbor2	chr11	5144231	5145619	LTR/ERV1	9589	+	694	5144925	17718
chr11	133621545	133821545	harbor2	chr11	133626775	133627185	LTR/ERV1	2943	+	205	133626980	5435
chr11	133621545	133821545	harbor2	chr11	133630189	133631036	LTR/ERV1	5832	+	424	133630613	9068
chr11	133621545	133821545	harbor2	chr11	133631040	133631702	LTR/ERV1	4492	+	331	133631371	9826
chr11	133621545	133821545	harbor2	chr11	133631704	133631919	LTR/ERV1	1342	+	108	133631812	10267
chr11	133621545	133821545	harbor2	chr11	133631913	133632296	LTR/ERV1	2464	+	192	133632105	10560
chr11	133621545	133821545	harbor2	chr11	133632297	133632692	LTR/ERV1	2781	+	198	133632495	10950
chr11	133621545	133821545	harbor2	chr11	133627188	133630194	LTR/ERV1	19540	+	1503	133628691	7146
chr11	5130262	5330262	harbor2	chr11	5135423	5135970	LTR/ERV1	2531	+	274	5135697	5435
chr11	5130262	5330262	harbor2	chr11	5144231	5145619	LTR/ERV1	9589	+	694	5144925	14663
chr11	66161658	66361658	harbor2	chr11	66189818	66190268	LTR/ERV1	2413	+	225	66190043	28385
chr11	5127995	5327995	harbor2	chr11	5135423	5135970	LTR/ERV1	2531	+	274	5135697	7702
chr11	5127995	5327995	harbor2	chr11	5144231	5145619	LTR/ERV1	9589	+	694	5144925	16930
chr11	72123532	72323532	harbor2	chr11	72143209	72143858	LTR/ERV1	1595	+	324	72143533	20001
chr11	72123532	72323532	harbor2	chr11	72144869	72145038	LTR/ERV1	500	+	84	72144953	21421
chr11	72123532	72323532	harbor2	chr11	72145339	72145414	LTR/ERV1	500	+	38	72145377	21845
chr11	72123532	72323532	harbor2	chr11	72146246	72146474	LTR/ERV1	872	+	114	72146360	22828
chr11	72123532	72323532	harbor2	chr11	72146475	72146920	LTR/ERV1	2031	+	222	72146697	23165
chr11	72123532	72323532	harbor2	chr11	72147039	72147368	LTR/ERV1	2031	+	164	72147203	23671
chr11	72123532	72323532	harbor2	chr11	72149027	72149448	LTR/ERV1	2992	+	210	72149237	25705
chr11	72123532	72323532	harbor2	chr11	72149754	72149910	LTR/ERV1	2992	+	78	72149832	26300
chr11	72123532	72323532	harbor2	chr11	72153927	72154685	LTR/ERV1	6143	+	379	72154306	30774
chr11	72123532	72323532	harbor2	chr11	72157557	72158144	LTR/ERV1	4731	+	294	72157851	34319
chr11	72123532	72323532	harbor2	chr11	72158442	72158499	LTR/ERV1	4731	+	28	72158470	34938
chr11	72123532	72323532	harbor2	chr11	72182012	72182405	LTR/ERV1	1370	+	196	72182208	58676
chr11	72123532	72323532	harbor2	chr11	72182704	72182870	LTR/ERV1	1370	+	83	72182787	59255
chr11	72123532	72323532	harbor2	chr11	72185491	72185815	LTR/ERV1	895	+	162	72185653	62121
chr11	72123532	72323532	harbor2	chr11	72185816	72185836	LTR/ERV1	886	+	10	72185826	62294
chr11	72123532	72323532	harbor2	chr11	72186148	72186397	LTR/ERV1	886	+	124	72186272	62740
chr11	72123532	72323532	harbor2	chr11	72186760	72186912	LTR/ERV1	580	+	76	72186836	63304
chr11	72123532	72323532	harbor2	chr11	72187220	72187241	LTR/ERV1	580	+	10	72187230	63698
chr11	72123532	72323532	harbor2	chr11	72188326	72188615	LTR/ERV1	1372	+	144	72188470	64938
chr11	468706	668706	harbor2	chr11	505032	505252	LTR/ERV1	1273	+	110	505142	36436
chr11	468706	668706	harbor2	chr11	512918	513076	LTR/ERV1	931	+	79	512997	44291
chr11	5189904	5389904	harbor2	chr11	5246542	5246729	LTR/ERV1	1210	+	94	5246636	56732
chr11	5189904	5389904	harbor2	chr11	5251328	5251513	LTR/ERV1	1106	+	92	5251420	61516
chr11	61589431	61789431	harbor2	chr11	61622959	61623168	LTR/ERV1	3547	+	104	61623063	33632
chr11	61589431	61789431	harbor2	chr11	61623654	61623893	LTR/ERV1	3547	+	120	61623774	34343
chr11	61589431	61789431	harbor2	chr11	61624478	61624568	LTR/ERV1	3547	+	45	61624523	35092
chr11	61589431	61789431	harbor2	chr11	61624885	61625046	LTR/ERV1	3547	+	80	61624965	35534
chr11	61589431	61789431	harbor2	chr11	61639913	61640531	LTR/ERV1	4548	+	309	61640222	50791
chr11	61589431	61789431	harbor2	chr11	61653436	61654057	LTR/ERV1	3460	+	310	61653746	64315
chr11	61589431	61789431	harbor2	chr11	61659782	61660134	LTR/ERV1	3510	+	176	61659958	70527
chr11	61589431	61789431	harbor2	chr11	61660741	61660893	LTR/ERV1	3510	+	76	61660817	71386
chr11	61589431	61789431	harbor2	chr11	61662010	61662098	LTR/ERV1	616	+	44	61662054	72623
chr11	61589431	61789431	harbor2	chr11	61668561	61668983	LTR/ERV1	3728	+	211	61668772	79341
chr11	61589431	61789431	harbor2	chr11	61669306	61669424	LTR/ERV1	3728	+	59	61669365	79934
chr11	5142126	5342126	harbor2	chr11	5144231	5145619	LTR/ERV1	9589	+	694	5144925	2799
chr11	5127199	5327199	harbor2	chr11	5135423	5135970	LTR/ERV1	2531	+	274	5135697	8498
chr11	5127199	5327199	harbor2	chr11	5144231	5145619	LTR/ERV1	9589	+	694	5144925	17726
chr11	126082252	126282252	harbor2	chr11	126088962	126089487	LTR/ERV1	2202	+	262	126089224	6972
chr11	67369200	67569200	harbor2	chr11	67446493	67446563	LTR/ERV1	4590	+	35	67446528	77328
chr11	67369200	67569200	harbor2	chr11	67446874	67447059	LTR/ERV1	4590	+	92	67446966	77766
chr11	67369200	67569200	harbor2	chr11	67447374	67447781	LTR/ERV1	4590	+	204	67447578	78378
chr11	6206956	6406956	harbor2	chr11	6280783	6281284	LTR/ERV1	3669	+	250	6281033	74077
chr11	6206956	6406956	harbor2	chr11	6283647	6284169	LTR/ERV1	3655	+	261	6283908	76952
chr11	6206956	6406956	harbor2	chr11	6284170	6285213	LTR/ERV1	4966	+	522	6284692	77736
chr11	6206956	6406956	harbor2	chr11	6285251	6288201	LTR/ERV1	12563	+	1475	6286726	79770
chr11	6206956	6406956	harbor2	chr11	6288204	6288759	LTR/ERV1	4374	+	278	6288482	81526
chr11	6206956	6406956	harbor2	chr11	6296383	6296502	LTR/ERV1	427	+	60	6296443	89487
chr11	6206956	6406956	harbor2	chr11	6296609	6297193	LTR/ERV1	2817	+	292	6296901	89945
chr11	6206956	6406956	harbor2	chr11	6298876	6299053	LTR/ERV1	735	+	88	6298964	92008
chr11	6206956	6406956	harbor2	chr11	6299179	6299470	LTR/ERV1	894	+	146	6299325	92369
chr11	6206956	6406956	harbor2	chr11	6299471	6299864	LTR/ERV1	1603	+	196	6299667	92711
chr11	117887566	118087566	harbor2	chr11	117903238	117903420	LTR/ERV1	895	+	91	117903329	15763
chr11	117887566	118087566	harbor2	chr11	117904651	117904861	LTR/ERV1	1814	+	105	117904756	17190
chr11	117887566	118087566	harbor2	chr11	117905195	117905445	LTR/ERV1	1814	+	125	117905320	17754
chr11	117887566	118087566	harbor2	chr11	117926965	117927340	LTR/ERV1	2213	+	188	117927153	39587
chr11	117887566	118087566	harbor2	chr11	117942282	117942889	LTR/ERV1	3379	+	304	117942586	55020
chr11	117887566	118087566	harbor2	chr11	117983408	117983960	LTR/ERV1	3062	+	276	117983684	96118
chr11	67892044	68092044	harbor2	chr11	67963085	67964484	LTR/ERV1	9973	+	700	67963785	71741
chr11	5216243	5416243	harbor2	chr11	5246542	5246729	LTR/ERV1	1210	+	94	5246636	30393
chr11	5216243	5416243	harbor2	chr11	5251328	5251513	LTR/ERV1	1106	+	92	5251420	35177
chr11	57400308	57600308	harbor2	chr11	57441200	57441307	LTR/ERV1	545	+	54	57441254	40946
chr11	57400308	57600308	harbor2	chr11	57441964	57441990	LTR/ERV1	1008	+	13	57441977	41669
chr11	57400308	57600308	harbor2	chr11	57444277	57444404	LTR/ERV1	836	+	64	57444341	44033
chr11	76580941	76780941	harbor2	chr11	76605467	76606173	LTR/ERV1	4447	+	353	76605820	24879
chr11	70734473	70934473	harbor2	chr11	70745029	70745351	LTR/ERV1	616	+	161	70745190	10717
chr11	70734473	70934473	harbor2	chr11	70757966	70758680	LTR/ERV1	5181	+	357	70758323	23850
chr11	70734473	70934473	harbor2	chr11	70758804	70758878	LTR/ERV1	3632	+	37	70758841	24368
chr11	70734473	70934473	harbor2	chr11	70759507	70760403	LTR/ERV1	3632	+	448	70759955	25482
chr11	70734473	70934473	harbor2	chr11	70772475	70773039	LTR/ERV1	3357	+	282	70772757	38284
chr11	70734473	70934473	harbor2	chr11	70796725	70797253	LTR/ERV1	2505	+	264	70796989	62516
chr11	76587997	76787997	harbor2	chr11	76605467	76606173	LTR/ERV1	4447	+	353	76605820	17823
chr11	120127774	120327774	harbor2	chr11	120143502	120143980	LTR/ERV1	3823	+	239	120143741	15967
chr11	6519524	6719524	harbor2	chr11	6586520	6587937	LTR/ERV1	5342	+	708	6587228	67704
chr11	6519524	6719524	harbor2	chr11	6594457	6594828	LTR/ERV1	492	+	186	6594643	75119
chr11	5130579	5330579	harbor2	chr11	5135423	5135970	LTR/ERV1	2531	+	274	5135697	5118
chr11	5130579	5330579	harbor2	chr11	5144231	5145619	LTR/ERV1	9589	+	694	5144925	14346
chr11	33600881	33800881	harbor2	chr11	33646479	33646942	LTR/ERV1	2328	+	232	33646711	45830
chr11	5180299	5380299	harbor2	chr11	5246542	5246729	LTR/ERV1	1210	+	94	5246636	66337
chr11	5180299	5380299	harbor2	chr11	5251328	5251513	LTR/ERV1	1106	+	92	5251420	71121
chr11	70740848	70940848	harbor2	chr11	70745029	70745351	LTR/ERV1	616	+	161	70745190	4342
chr11	70740848	70940848	harbor2	chr11	70757966	70758680	LTR/ERV1	5181	+	357	70758323	17475
chr11	70740848	70940848	harbor2	chr11	70758804	70758878	LTR/ERV1	3632	+	37	70758841	17993
chr11	70740848	70940848	harbor2	chr11	70759507	70760403	LTR/ERV1	3632	+	448	70759955	19107
chr11	70740848	70940848	harbor2	chr11	70772475	70773039	LTR/ERV1	3357	+	282	70772757	31909
chr11	70740848	70940848	harbor2	chr11	70796725	70797253	LTR/ERV1	2505	+	264	70796989	56141
chr11	67369215	67569215	harbor2	chr11	67446493	67446563	LTR/ERV1	4590	+	35	67446528	77313
chr11	67369215	67569215	harbor2	chr11	67446874	67447059	LTR/ERV1	4590	+	92	67446966	77751
chr11	67369215	67569215	harbor2	chr11	67447374	67447781	LTR/ERV1	4590	+	204	67447578	78363
chr11	63953820	64153820	harbor2	chr11	63965685	63965829	LTR/ERV1	890	+	72	63965757	11937
chr11	63953820	64153820	harbor2	chr11	63966517	63966740	LTR/ERV1	1006	+	112	63966629	12809
chr11	63953820	64153820	harbor2	chr11	63968647	63968783	LTR/ERV1	818	+	68	63968715	14895
chr11	63953820	64153820	harbor2	chr11	63968793	63968875	LTR/ERV1	1575	+	41	63968834	15014
chr11	63953820	64153820	harbor2	chr11	63969165	63969365	LTR/ERV1	1575	+	100	63969265	15445
chr11	63953820	64153820	harbor2	chr11	63969804	63969918	LTR/ERV1	1575	+	57	63969861	16041
chr11	67408273	67608273	harbor2	chr11	67446493	67446563	LTR/ERV1	4590	+	35	67446528	38255
chr11	67408273	67608273	harbor2	chr11	67446874	67447059	LTR/ERV1	4590	+	92	67446966	38693
chr11	67408273	67608273	harbor2	chr11	67447374	67447781	LTR/ERV1	4590	+	204	67447578	39305
chr11	67408273	67608273	harbor2	chr11	67475910	67477234	LTR/ERV1	9575	+	662	67476572	68299
chr11	5128063	5328063	harbor2	chr11	5135423	5135970	LTR/ERV1	2531	+	274	5135697	7634
chr11	5128063	5328063	harbor2	chr11	5144231	5145619	LTR/ERV1	9589	+	694	5144925	16862
chr11	5133681	5333681	harbor2	chr11	5135423	5135970	LTR/ERV1	2531	+	274	5135697	2016
chr11	5133681	5333681	harbor2	chr11	5144231	5145619	LTR/ERV1	9589	+	694	5144925	11244
chr11	57399755	57599755	harbor2	chr11	57441200	57441307	LTR/ERV1	545	+	54	57441254	41499
chr11	57399755	57599755	harbor2	chr11	57441964	57441990	LTR/ERV1	1008	+	13	57441977	42222
chr11	57399755	57599755	harbor2	chr11	57444277	57444404	LTR/ERV1	836	+	64	57444341	44586
chr11	5127169	5327169	harbor2	chr11	5135423	5135970	LTR/ERV1	2531	+	274	5135697	8528
chr11	5127169	5327169	harbor2	chr11	5144231	5145619	LTR/ERV1	9589	+	694	5144925	17756
chr11	492608	692608	harbor2	chr11	505032	505252	LTR/ERV1	1273	+	110	505142	12534
chr11	492608	692608	harbor2	chr11	512918	513076	LTR/ERV1	931	+	79	512997	20389
chr11	6519523	6719523	harbor2	chr11	6586520	6587937	LTR/ERV1	5342	+	708	6587228	67705
chr11	6519523	6719523	harbor2	chr11	6594457	6594828	LTR/ERV1	492	+	186	6594643	75120
chr11	134094872	134294872	harbor2	chr11	134188033	134188841	LTR/ERV1	6371	+	404	134188437	93565
chr11	76580976	76780976	harbor2	chr11	76605467	76606173	LTR/ERV1	4447	+	353	76605820	24844
chr11	118813698	119013698	harbor2	chr11	118866008	118866033	LTR/ERV1	1016	+	12	118866020	52322
chr11	118813698	119013698	harbor2	chr11	118866345	118866466	LTR/ERV1	1016	+	60	118866405	52707
chr11	118813698	119013698	harbor2	chr11	118866468	118866552	LTR/ERV1	526	+	42	118866510	52812
chr11	118813698	119013698	harbor2	chr11	118866548	118867471	LTR/ERV1	6319	+	462	118867010	53312
chr11	118813698	119013698	harbor2	chr11	118867731	118867768	LTR/ERV1	6319	+	18	118867749	54051
chr11	66182603	66382603	harbor2	chr11	66189818	66190268	LTR/ERV1	2413	+	225	66190043	7440
chr11	133740735	133940735	harbor2	chr11	133782166	133783649	LTR/ERV1	10847	+	742	133782908	42173
chr11	5191433	5391433	harbor2	chr11	5246542	5246729	LTR/ERV1	1210	+	94	5246636	55203
chr11	5191433	5391433	harbor2	chr11	5251328	5251513	LTR/ERV1	1106	+	92	5251420	59987
chr11	5134480	5334480	harbor2	chr11	5135423	5135970	LTR/ERV1	2531	+	274	5135697	1217
chr11	5134480	5334480	harbor2	chr11	5144231	5145619	LTR/ERV1	9589	+	694	5144925	10445
chr11	66182673	66382673	harbor2	chr11	66189818	66190268	LTR/ERV1	2413	+	225	66190043	7370
chr11	68028552	68228552	harbor2	chr11	68029157	68029352	LTR/ERV1	706	+	98	68029255	703
chr11	6201662	6401662	harbor2	chr11	6280783	6281284	LTR/ERV1	3669	+	250	6281033	79371
chr11	6201662	6401662	harbor2	chr11	6283647	6284169	LTR/ERV1	3655	+	261	6283908	82246
chr11	6201662	6401662	harbor2	chr11	6284170	6285213	LTR/ERV1	4966	+	522	6284692	83030
chr11	6201662	6401662	harbor2	chr11	6285251	6288201	LTR/ERV1	12563	+	1475	6286726	85064
chr11	6201662	6401662	harbor2	chr11	6288204	6288759	LTR/ERV1	4374	+	278	6288482	86820
chr11	6201662	6401662	harbor2	chr11	6296383	6296502	LTR/ERV1	427	+	60	6296443	94781
chr11	6201662	6401662	harbor2	chr11	6296609	6297193	LTR/ERV1	2817	+	292	6296901	95239
chr11	6201662	6401662	harbor2	chr11	6298876	6299053	LTR/ERV1	735	+	88	6298964	97302
chr11	6201662	6401662	harbor2	chr11	6299179	6299470	LTR/ERV1	894	+	146	6299325	97663
chr11	6201662	6401662	harbor2	chr11	6299471	6299864	LTR/ERV1	1603	+	196	6299667	98005
chr11	76599762	76799762	harbor2	chr11	76605467	76606173	LTR/ERV1	4447	+	353	76605820	6058
chr11	124700459	124900459	harbor2	chr11	124734863	124735525	LTR/ERV1	3694	+	331	124735194	34735
chr11	76580924	76780924	harbor2	chr11	76605467	76606173	LTR/ERV1	4447	+	353	76605820	24896
chr11	57579843	57779843	harbor2	chr11	57580304	57580556	LTR/ERV1	887	+	126	57580430	587
chr11	57579843	57779843	harbor2	chr11	57593435	57593671	LTR/ERV1	2506	+	118	57593553	13710
chr11	57579843	57779843	harbor2	chr11	57593997	57594246	LTR/ERV1	2506	+	124	57594121	14278
chr12	132055531	132255531	harbor2	chr12	132095737	132096306	LTR/ERV1	2909	+	284	132096021	40490
chr12	62967049	63167049	harbor2	chr12	63008183	63008487	LTR/ERV1	3104	+	152	63008335	41286
chr12	62967049	63167049	harbor2	chr12	63008852	63009127	LTR/ERV1	3104	+	138	63008990	41941
chr12	49415274	49615274	harbor2	chr12	49458952	49459339	LTR/ERV1	3406	+	194	49459146	43872
chr12	49415274	49615274	harbor2	chr12	49459647	49459732	LTR/ERV1	3406	+	42	49459689	44415
chr12	49415274	49615274	harbor2	chr12	49475944	49476721	LTR/ERV1	5062	+	388	49476332	61058
chr12	6863231	7063231	harbor2	chr12	6899979	6900402	LTR/ERV1	1831	+	212	6900191	36960
chr12	118276406	118476406	harbor2	chr12	118308025	118308407	LTR/ERV1	3110	+	191	118308216	31810
chr12	133030495	133230495	harbor2	chr12	133035402	133035446	LTR/ERV1	2768	+	22	133035424	4929
chr12	133030495	133230495	harbor2	chr12	133035741	133036210	LTR/ERV1	2768	+	234	133035975	5480
chr12	133030495	133230495	harbor2	chr12	133047212	133047541	LTR/ERV1	2011	+	164	133047376	16881
chr12	133030495	133230495	harbor2	chr12	133047630	133047769	LTR/ERV1	742	+	70	133047700	17205
chr12	133030495	133230495	harbor2	chr12	133079235	133079463	LTR/ERV1	1542	+	114	133079349	48854
chr12	133030495	133230495	harbor2	chr12	133079464	133079975	LTR/ERV1	3692	+	256	133079720	49225
chr12	53898513	54098513	harbor2	chr12	53925569	53925957	LTR/ERV1	659	+	194	53925763	27250
chr12	6864781	7064781	harbor2	chr12	6899979	6900402	LTR/ERV1	1831	+	212	6900191	35410
chr12	131808853	132008853	harbor2	chr12	131812500	131812640	LTR/ERV1	1392	+	70	131812570	3717
chr12	131808853	132008853	harbor2	chr12	131812937	131813102	LTR/ERV1	1392	+	82	131813019	4166
chr12	131808853	132008853	harbor2	chr12	131813381	131813402	LTR/ERV1	1392	+	10	131813391	4538
chr12	131808853	132008853	harbor2	chr12	131813526	131813708	LTR/ERV1	1370	+	91	131813617	4764
chr12	131808853	132008853	harbor2	chr12	131813745	131814442	LTR/ERV1	1370	+	348	131814093	5240
chr12	131808853	132008853	harbor2	chr12	131815371	131815721	LTR/ERV1	1551	+	175	131815546	6693
chr12	131808853	132008853	harbor2	chr12	131816026	131816092	LTR/ERV1	1551	+	33	131816059	7206
chr12	131808853	132008853	harbor2	chr12	131818302	131818622	LTR/ERV1	1558	+	160	131818462	9609
chr12	131808853	132008853	harbor2	chr12	131818628	131819016	LTR/ERV1	1461	+	194	131818822	9969
chr12	131808853	132008853	harbor2	chr12	131819015	131819561	LTR/ERV1	1898	+	273	131819288	10435
chr12	131808853	132008853	harbor2	chr12	131819873	131819912	LTR/ERV1	1898	+	20	131819893	11040
chr12	131808853	132008853	harbor2	chr12	131820513	131820544	LTR/ERV1	1898	+	16	131820529	11676
chr12	131808853	132008853	harbor2	chr12	131821305	131821718	LTR/ERV1	2007	+	206	131821511	12658
chr12	131808853	132008853	harbor2	chr12	131881042	131881130	LTR/ERV1	1062	+	44	131881086	72233
chr12	131808853	132008853	harbor2	chr12	131881452	131881540	LTR/ERV1	1062	+	44	131881496	72643
chr12	6863232	7063232	harbor2	chr12	6899979	6900402	LTR/ERV1	1831	+	212	6900191	36959
chr12	53854927	54054927	harbor2	chr12	53925569	53925957	LTR/ERV1	659	+	194	53925763	70836
chr12	6862957	7062957	harbor2	chr12	6899979	6900402	LTR/ERV1	1831	+	212	6900191	37234
chr12	67170399	67370399	harbor2	chr12	67255777	67256179	LTR/ERV1	3154	+	201	67255978	85579
chr12	67170399	67370399	harbor2	chr12	67256490	67256762	LTR/ERV1	3154	+	136	67256626	86227
chr12	67170399	67370399	harbor2	chr12	67256808	67257085	LTR/ERV1	917	+	138	67256946	86547
chr12	67170399	67370399	harbor2	chr12	67257488	67258067	LTR/ERV1	3414	+	290	67257778	87379
chr12	67170399	67370399	harbor2	chr12	67259639	67259695	LTR/ERV1	3022	+	28	67259667	89268
chr12	67170399	67370399	harbor2	chr12	67260037	67260745	LTR/ERV1	4615	+	354	67260391	89992
chr12	67170399	67370399	harbor2	chr12	67261058	67262746	LTR/ERV1	4615	+	844	67261902	91503
chr12	67170399	67370399	harbor2	chr12	67263415	67263723	LTR/ERV1	2794	+	154	67263569	93170
chr12	67170399	67370399	harbor2	chr12	67264029	67264359	LTR/ERV1	2794	+	165	67264194	93795
chr12	51140362	51340362	harbor2	chr12	51166443	51166892	LTR/ERV1	2342	+	224	51166667	26305
chr12	131686732	131886732	harbor2	chr12	131707386	131707715	LTR/ERV1	1429	+	164	131707550	20818
chr12	131246816	131446816	harbor2	chr12	131322675	131322938	LTR/ERV1	1206	+	132	131322807	75991
chr12	131246816	131446816	harbor2	chr12	131334871	131335398	LTR/ERV1	3816	+	264	131335135	88319
chr12	131246816	131446816	harbor2	chr12	131335420	131340111	LTR/ERV1	28704	+	2346	131337766	90950
chr12	49460462	49660462	harbor2	chr12	49475944	49476721	LTR/ERV1	5062	+	388	49476332	15870
chr12	6863195	7063195	harbor2	chr12	6899979	6900402	LTR/ERV1	1831	+	212	6900191	36996
chr12	49466948	49666948	harbor2	chr12	49475944	49476721	LTR/ERV1	5062	+	388	49476332	9384
chr12	69139511	69339511	harbor2	chr12	69139518	69140271	LTR/ERV1	5740	+	376	69139894	383
chr12	69139511	69339511	harbor2	chr12	69141126	69141368	LTR/ERV1	1265	+	121	69141247	1736
chr12	69139511	69339511	harbor2	chr12	69141357	69141507	LTR/ERV1	2573	+	75	69141432	1921
chr12	69139511	69339511	harbor2	chr12	69141809	69142031	LTR/ERV1	2573	+	111	69141920	2409
chr12	69139511	69339511	harbor2	chr12	69142330	69142393	LTR/ERV1	2573	+	32	69142362	2851
chr12	69139511	69339511	harbor2	chr12	69142694	69143430	LTR/ERV1	3086	+	368	69143062	3551
chr12	69139511	69339511	harbor2	chr12	69143783	69144228	LTR/ERV1	4656	+	222	69144005	4494
chr12	69139511	69339511	harbor2	chr12	69144527	69145129	LTR/ERV1	4656	+	301	69144828	5317
chr12	69139511	69339511	harbor2	chr12	69145147	69145540	LTR/ERV1	2398	+	196	69145343	5832
chr12	69139511	69339511	harbor2	chr12	69145537	69146314	LTR/ERV1	4765	+	388	69145925	6414
chr12	69139511	69339511	harbor2	chr12	69146607	69146662	LTR/ERV1	4765	+	28	69146635	7124
chr12	69139511	69339511	harbor2	chr12	69148715	69149182	LTR/ERV1	3124	+	234	69148949	9438
chr12	69139511	69339511	harbor2	chr12	69164927	69165571	LTR/ERV1	3525	+	322	69165249	25738
chr12	69139511	69339511	harbor2	chr12	69166353	69166795	LTR/ERV1	1943	+	221	69166574	27063
chr12	69139511	69339511	harbor2	chr12	69168383	69168854	LTR/ERV1	2295	+	236	69168619	29108
chr12	69139511	69339511	harbor2	chr12	69169318	69169513	LTR/ERV1	1744	+	98	69169416	29905
chr12	69139511	69339511	harbor2	chr12	69169821	69169861	LTR/ERV1	1744	+	20	69169841	30330
chr12	69139511	69339511	harbor2	chr12	69176079	69176620	LTR/ERV1	2928	+	270	69176349	36838
chr12	69139511	69339511	harbor2	chr12	69184340	69184732	LTR/ERV1	2300	+	196	69184536	45025
chr12	69139511	69339511	harbor2	chr12	69185979	69186419	LTR/ERV1	3333	+	220	69186199	46688
chr12	69139511	69339511	harbor2	chr12	69186423	69186692	LTR/ERV1	1840	+	134	69186557	47046
chr12	69139511	69339511	harbor2	chr12	69186808	69186976	LTR/ERV1	6020	+	84	69186892	47381
chr12	69139511	69339511	harbor2	chr12	69187271	69187445	LTR/ERV1	6020	+	87	69187358	47847
chr12	69139511	69339511	harbor2	chr12	69187813	69188534	LTR/ERV1	6020	+	360	69188173	48662
chr12	69139511	69339511	harbor2	chr12	69188778	69188969	LTR/ERV1	4432	+	96	69188874	49363
chr12	69139511	69339511	harbor2	chr12	69189965	69191766	LTR/ERV1	11487	+	900	69190865	51354
chr12	69139511	69339511	harbor2	chr12	69191767	69192204	LTR/ERV1	3135	+	218	69191985	52474
chr12	69139511	69339511	harbor2	chr12	69194210	69194758	LTR/ERV1	4205	+	274	69194484	54973
chr12	69139511	69339511	harbor2	chr12	69140272	69141104	LTR/ERV1	5552	+	416	69140688	1177
chr12	69139511	69339511	harbor2	chr12	69189242	69189985	LTR/ERV1	4432	+	372	69189614	50103
chr12	119889846	120089846	harbor2	chr12	119906381	119906904	LTR/ERV1	3384	+	262	119906643	16797
chr12	119889846	120089846	harbor2	chr12	119912736	119912904	LTR/ERV1	3794	+	84	119912820	22974
chr12	119889846	120089846	harbor2	chr12	119913496	119913986	LTR/ERV1	3794	+	245	119913741	23895
chr12	119889846	120089846	harbor2	chr12	119954695	119954741	LTR/ERV1	3274	+	23	119954718	64872
chr12	119889846	120089846	harbor2	chr12	119955324	119955485	LTR/ERV1	3274	+	80	119955404	65558
chr12	119889846	120089846	harbor2	chr12	119955784	119956179	LTR/ERV1	3274	+	198	119955982	66136
chr12	21402003	21602003	harbor2	chr12	21414009	21414237	LTR/ERV1	744	+	114	21414123	12120
chr12	30881310	31081310	harbor2	chr12	30898614	30899253	LTR/ERV1	2348	+	320	30898934	17624
chr12	30881310	31081310	harbor2	chr12	30899548	30899598	LTR/ERV1	2348	+	25	30899573	18263
chr12	92828979	93028979	harbor2	chr12	92897071	92897705	LTR/ERV1	3878	+	317	92897388	68409
chr12	49382161	49582161	harbor2	chr12	49458952	49459339	LTR/ERV1	3406	+	194	49459146	76985
chr12	49382161	49582161	harbor2	chr12	49459647	49459732	LTR/ERV1	3406	+	42	49459689	77528
chr12	49382161	49582161	harbor2	chr12	49475944	49476721	LTR/ERV1	5062	+	388	49476332	94171
chr12	102856603	103056603	harbor2	chr12	102871624	102871640	LTR/ERV1	959	+	8	102871632	15029
chr12	102856603	103056603	harbor2	chr12	102871986	102872450	LTR/ERV1	959	+	232	102872218	15615
chr12	56884786	57084786	harbor2	chr12	56899882	56900023	LTR/ERV1	704	+	70	56899952	15166
chr12	56884786	57084786	harbor2	chr12	56900035	56900984	LTR/ERV1	5197	+	474	56900509	15723
chr12	56884786	57084786	harbor2	chr12	56900989	56901543	LTR/ERV1	4056	+	277	56901266	16480
chr12	56884786	57084786	harbor2	chr12	56901660	56903161	LTR/ERV1	9658	+	750	56902410	17624
chr12	56884786	57084786	harbor2	chr12	56903162	56904081	LTR/ERV1	5252	+	460	56903622	18836
chr12	56884786	57084786	harbor2	chr12	56904143	56904302	LTR/ERV1	802	+	80	56904223	19437
chr12	56884786	57084786	harbor2	chr12	56904305	56904759	LTR/ERV1	2268	+	227	56904532	19746
chr12	56884786	57084786	harbor2	chr12	56905980	56906222	LTR/ERV1	1366	+	121	56906101	21315
chr12	56884786	57084786	harbor2	chr12	56906222	56906564	LTR/ERV1	5546	+	171	56906393	21607
chr12	56884786	57084786	harbor2	chr12	56906859	56907789	LTR/ERV1	5546	+	465	56907324	22538
chr12	56884786	57084786	harbor2	chr12	56907845	56908042	LTR/ERV1	1418	+	98	56907943	23157
chr12	56884786	57084786	harbor2	chr12	56908045	56908399	LTR/ERV1	1304	+	177	56908222	23436
chr12	56884786	57084786	harbor2	chr12	56908721	56908997	LTR/ERV1	1242	+	138	56908859	24073
chr12	56884786	57084786	harbor2	chr12	56916725	56917099	LTR/ERV1	2041	+	187	56916912	32126
chr12	130739286	130939286	harbor2	chr12	130749557	130750021	LTR/ERV1	3294	+	232	130749789	10503
chr12	130739286	130939286	harbor2	chr12	130767477	130768033	LTR/ERV1	1033	+	278	130767755	28469
chr12	130739286	130939286	harbor2	chr12	130768071	130768267	LTR/ERV1	1228	+	98	130768169	28883
chr12	130739286	130939286	harbor2	chr12	130768314	130768968	LTR/ERV1	2378	+	327	130768641	29355
chr12	130739286	130939286	harbor2	chr12	130807779	130808492	LTR/ERV1	2371	+	356	130808135	68849
chr12	6363187	6563187	harbor2	chr12	6395532	6396209	LTR/ERV1	3266	+	338	6395870	32683
chr12	6870704	7070704	harbor2	chr12	6899979	6900402	LTR/ERV1	1831	+	212	6900191	29487
chr12	92366739	92566739	harbor2	chr12	92386713	92387163	LTR/ERV1	3167	+	225	92386938	20199
chr12	92366739	92566739	harbor2	chr12	92392562	92393746	LTR/ERV1	9715	+	592	92393154	26415
chr12	92366739	92566739	harbor2	chr12	92393751	92394200	LTR/ERV1	3432	+	224	92393975	27236
chr12	92366739	92566739	harbor2	chr12	92387186	92392560	LTR/ERV1	34674	+	2687	92389873	23134
chr12	32006641	32206641	harbor2	chr12	32012301	32012695	LTR/ERV1	2981	+	197	32012498	5857
chr12	32006641	32206641	harbor2	chr12	32012977	32013055	LTR/ERV1	2981	+	39	32013016	6375
chr12	32006641	32206641	harbor2	chr12	32022002	32022072	LTR/ERV1	4154	+	35	32022037	15396
chr12	32006641	32206641	harbor2	chr12	32022409	32022995	LTR/ERV1	4154	+	293	32022702	16061
chr12	32006641	32206641	harbor2	chr12	32025634	32025785	LTR/ERV1	857	+	76	32025710	19069
chr12	32006641	32206641	harbor2	chr12	32025790	32026042	LTR/ERV1	915	+	126	32025916	19275
chr12	32006641	32206641	harbor2	chr12	32026042	32026364	LTR/ERV1	1555	+	161	32026203	19562
chr12	32006641	32206641	harbor2	chr12	32026363	32026619	LTR/ERV1	5576	+	128	32026491	19850
chr12	32006641	32206641	harbor2	chr12	32026952	32027928	LTR/ERV1	5576	+	488	32027440	20799
chr12	32006641	32206641	harbor2	chr12	32028015	32028539	LTR/ERV1	2862	+	262	32028277	21636
chr12	32006641	32206641	harbor2	chr12	32032295	32032469	LTR/ERV1	1125	+	87	32032382	25741
chr12	32006641	32206641	harbor2	chr12	32040084	32040483	LTR/ERV1	985	+	200	32040284	33643
chr12	32006641	32206641	harbor2	chr12	32051729	32052090	LTR/ERV1	1172	+	180	32051909	45268
chr12	32006641	32206641	harbor2	chr12	32052129	32052807	LTR/ERV1	949	+	339	32052468	45827
chr12	32006641	32206641	harbor2	chr12	32054719	32055272	LTR/ERV1	4394	+	276	32054995	48354
chr12	32006641	32206641	harbor2	chr12	32056399	32056881	LTR/ERV1	5783	+	241	32056640	49999
chr12	32006641	32206641	harbor2	chr12	32057192	32057512	LTR/ERV1	5783	+	160	32057352	50711
chr12	32006641	32206641	harbor2	chr12	32058932	32059665	LTR/ERV1	5502	+	366	32059298	52657
chr12	32006641	32206641	harbor2	chr12	32059958	32059989	LTR/ERV1	5502	+	16	32059974	53333
chr12	32006641	32206641	harbor2	chr12	32063091	32063314	LTR/ERV1	602	+	112	32063203	56562
chr12	32006641	32206641	harbor2	chr12	32069278	32069594	LTR/ERV1	609	+	158	32069436	62795
chr12	6863214	7063214	harbor2	chr12	6899979	6900402	LTR/ERV1	1831	+	212	6900191	36977
chr12	6864775	7064775	harbor2	chr12	6899979	6900402	LTR/ERV1	1831	+	212	6900191	35416
chr12	94973026	95173026	harbor2	chr12	94987434	94987518	LTR/ERV1	2812	+	42	94987476	14450
chr12	94973026	95173026	harbor2	chr12	94987817	94988263	LTR/ERV1	2812	+	223	94988040	15014
chr12	94973026	95173026	harbor2	chr12	94988535	94988910	LTR/ERV1	2667	+	188	94988723	15697
chr12	6863226	7063226	harbor2	chr12	6899979	6900402	LTR/ERV1	1831	+	212	6900191	36965
chr13	113726181	113926181	harbor2	chr13	113746115	113746547	LTR/ERV1	2019	+	216	113746331	20150
chr13	113726181	113926181	harbor2	chr13	113782476	113782548	LTR/ERV1	430	+	36	113782512	56331
chr13	113726041	113926041	harbor2	chr13	113746115	113746547	LTR/ERV1	2019	+	216	113746331	20290
chr13	113726041	113926041	harbor2	chr13	113782476	113782548	LTR/ERV1	430	+	36	113782512	56471
chr13	113726150	113926150	harbor2	chr13	113746115	113746547	LTR/ERV1	2019	+	216	113746331	20181
chr13	113726150	113926150	harbor2	chr13	113782476	113782548	LTR/ERV1	430	+	36	113782512	56362
chr13	39962056	40162056	harbor2	chr13	40040937	40041488	LTR/ERV1	3541	+	276	40041213	79157
chr13	48136920	48336920	harbor2	chr13	48156554	48156906	LTR/ERV1	1739	+	176	48156730	19810
chr13	48136920	48336920	harbor2	chr13	48160632	48161169	LTR/ERV1	2961	+	268	48160900	23980
chr13	20315477	20515477	harbor2	chr13	20324423	20324667	LTR/ERV1	2552	+	122	20324545	9068
chr13	20315477	20515477	harbor2	chr13	20324965	20325537	LTR/ERV1	2786	+	286	20325251	9774
chr13	20315477	20515477	harbor2	chr13	20325752	20326536	LTR/ERV1	4570	+	392	20326144	10667
chr13	20315477	20515477	harbor2	chr13	20343718	20344310	LTR/ERV1	3312	+	296	20344014	28537
chr13	20315477	20515477	harbor2	chr13	20359933	20360425	LTR/ERV1	2682	+	246	20360179	44702
chr13	20315477	20515477	harbor2	chr13	20374977	20375424	LTR/ERV1	2239	+	224	20375201	59724
chr13	75382379	75582379	harbor2	chr13	75465570	75466167	LTR/ERV1	2632	+	298	75465868	83489
chr13	113726142	113926142	harbor2	chr13	113746115	113746547	LTR/ERV1	2019	+	216	113746331	20189
chr13	113726142	113926142	harbor2	chr13	113782476	113782548	LTR/ERV1	430	+	36	113782512	56370
chr13	113727916	113927916	harbor2	chr13	113746115	113746547	LTR/ERV1	2019	+	216	113746331	18415
chr13	113727916	113927916	harbor2	chr13	113782476	113782548	LTR/ERV1	430	+	36	113782512	54596
chr13	113726060	113926060	harbor2	chr13	113746115	113746547	LTR/ERV1	2019	+	216	113746331	20271
chr13	113726060	113926060	harbor2	chr13	113782476	113782548	LTR/ERV1	430	+	36	113782512	56452
chr13	20317804	20517804	harbor2	chr13	20324423	20324667	LTR/ERV1	2552	+	122	20324545	6741
chr13	20317804	20517804	harbor2	chr13	20324965	20325537	LTR/ERV1	2786	+	286	20325251	7447
chr13	20317804	20517804	harbor2	chr13	20325752	20326536	LTR/ERV1	4570	+	392	20326144	8340
chr13	20317804	20517804	harbor2	chr13	20343718	20344310	LTR/ERV1	3312	+	296	20344014	26210
chr13	20317804	20517804	harbor2	chr13	20359933	20360425	LTR/ERV1	2682	+	246	20360179	42375
chr13	20317804	20517804	harbor2	chr13	20374977	20375424	LTR/ERV1	2239	+	224	20375201	57397
chr13	113726141	113926141	harbor2	chr13	113746115	113746547	LTR/ERV1	2019	+	216	113746331	20190
chr13	113726141	113926141	harbor2	chr13	113782476	113782548	LTR/ERV1	430	+	36	113782512	56371
chr13	100574883	100774883	harbor2	chr13	100579317	100579919	LTR/ERV1	2798	+	301	100579618	4735
chr13	100574883	100774883	harbor2	chr13	100594858	100595426	LTR/ERV1	3528	+	284	100595142	20259
chr13	20327632	20527632	harbor2	chr13	20343718	20344310	LTR/ERV1	3312	+	296	20344014	16382
chr13	20327632	20527632	harbor2	chr13	20359933	20360425	LTR/ERV1	2682	+	246	20360179	32547
chr13	20327632	20527632	harbor2	chr13	20374977	20375424	LTR/ERV1	2239	+	224	20375201	47569
chr13	19858665	20058665	harbor2	chr13	19867926	19868224	LTR/ERV1	1587	+	149	19868075	9410
chr13	19858665	20058665	harbor2	chr13	19891799	19891957	LTR/ERV1	541	+	79	19891878	33213
chr13	19858665	20058665	harbor2	chr13	19892241	19892252	LTR/ERV1	541	+	6	19892247	33582
chr13	19858665	20058665	harbor2	chr13	19892575	19892654	LTR/ERV1	541	+	40	19892615	33950
chr13	19858665	20058665	harbor2	chr13	19938569	19939020	LTR/ERV1	1378	+	226	19938795	80130
chr13	19858665	20058665	harbor2	chr13	19950346	19950742	LTR/ERV1	2311	+	198	19950544	91879
chr13	19858665	20058665	harbor2	chr13	19939324	19939342	LTR/ERV1	1378	+	9	19939333	80668
chr13	20344110	20544110	harbor2	chr13	20343718	20344310	LTR/ERV1	3312	+	296	20344014	96
chr13	20344110	20544110	harbor2	chr13	20359933	20360425	LTR/ERV1	2682	+	246	20360179	16069
chr13	20344110	20544110	harbor2	chr13	20374977	20375424	LTR/ERV1	2239	+	224	20375201	31091
chr13	20344110	20544110	harbor2	chr13	20434204	20434824	LTR/ERV1	2641	+	310	20434514	90404
chr13	20344110	20544110	harbor2	chr13	20439857	20440379	LTR/ERV1	1371	+	261	20440118	96008
chr13	113736151	113936151	harbor2	chr13	113746115	113746547	LTR/ERV1	2019	+	216	113746331	10180
chr13	113736151	113936151	harbor2	chr13	113782476	113782548	LTR/ERV1	430	+	36	113782512	46361
chr13	24918114	25118114	harbor2	chr13	24921028	24921473	LTR/ERV1	1996	+	222	24921250	3136
chr13	24918114	25118114	harbor2	chr13	24995133	24995294	LTR/ERV1	1000	+	80	24995213	77099
chr13	24918114	25118114	harbor2	chr13	24995288	24995427	LTR/ERV1	789	+	70	24995358	77244
chr13	24918114	25118114	harbor2	chr13	24995439	24996056	LTR/ERV1	4258	+	308	24995747	77633
chr13	24918114	25118114	harbor2	chr13	24996042	24996078	LTR/ERV1	3828	+	18	24996060	77946
chr13	24918114	25118114	harbor2	chr13	24996388	24997195	LTR/ERV1	3828	+	404	24996792	78678
chr13	24918114	25118114	harbor2	chr13	24997197	24997382	LTR/ERV1	740	+	92	24997289	79175
chr13	24918114	25118114	harbor2	chr13	24997666	24997925	LTR/ERV1	1337	+	130	24997796	79682
chr13	24918114	25118114	harbor2	chr13	24997933	24998556	LTR/ERV1	3303	+	312	24998245	80131
chr13	100574737	100774737	harbor2	chr13	100579317	100579919	LTR/ERV1	2798	+	301	100579618	4881
chr13	100574737	100774737	harbor2	chr13	100594858	100595426	LTR/ERV1	3528	+	284	100595142	20405
chr13	49768516	49968516	harbor2	chr13	49778154	49778521	LTR/ERV1	2431	+	184	49778338	9822
chr13	49768516	49968516	harbor2	chr13	49821470	49822022	LTR/ERV1	3801	+	276	49821746	53230
chr13	49768516	49968516	harbor2	chr13	49824076	49825108	LTR/ERV1	8626	+	516	49824592	56076
chr13	49768516	49968516	harbor2	chr13	49825436	49825629	LTR/ERV1	8626	+	96	49825532	57016
chr13	49768516	49968516	harbor2	chr13	49825950	49826447	LTR/ERV1	8626	+	248	49826198	57682
chr13	49768516	49968516	harbor2	chr13	49826762	49827064	LTR/ERV1	8626	+	151	49826913	58397
chr13	49768516	49968516	harbor2	chr13	49827370	49828008	LTR/ERV1	8626	+	319	49827689	59173
chr13	49768516	49968516	harbor2	chr13	49827998	49828255	LTR/ERV1	1606	+	128	49828126	59610
chr13	49768516	49968516	harbor2	chr13	49828561	49828591	LTR/ERV1	1606	+	15	49828576	60060
chr13	49768516	49968516	harbor2	chr13	49828593	49829080	LTR/ERV1	3238	+	244	49828837	60321
chr13	49768516	49968516	harbor2	chr13	49842904	49843336	LTR/ERV1	3120	+	216	49843120	74604
chr13	49768516	49968516	harbor2	chr13	49822157	49824090	LTR/ERV1	4160	+	966	49823123	54607
chr13	36899380	37099380	harbor2	chr13	36956650	36956762	LTR/ERV1	744	+	56	36956706	57326
chr13	36899380	37099380	harbor2	chr13	36956763	36958343	LTR/ERV1	12246	+	790	36957553	58173
chr13	36899380	37099380	harbor2	chr13	36958369	36958652	LTR/ERV1	2140	+	142	36958511	59131
chr13	36899380	37099380	harbor2	chr13	36958653	36958981	LTR/ERV1	2310	+	164	36958817	59437
chr13	113727396	113927396	harbor2	chr13	113746115	113746547	LTR/ERV1	2019	+	216	113746331	18935
chr13	113727396	113927396	harbor2	chr13	113782476	113782548	LTR/ERV1	430	+	36	113782512	55116
chr13	20317117	20517117	harbor2	chr13	20324423	20324667	LTR/ERV1	2552	+	122	20324545	7428
chr13	20317117	20517117	harbor2	chr13	20324965	20325537	LTR/ERV1	2786	+	286	20325251	8134
chr13	20317117	20517117	harbor2	chr13	20325752	20326536	LTR/ERV1	4570	+	392	20326144	9027
chr13	20317117	20517117	harbor2	chr13	20343718	20344310	LTR/ERV1	3312	+	296	20344014	26897
chr13	20317117	20517117	harbor2	chr13	20359933	20360425	LTR/ERV1	2682	+	246	20360179	43062
chr13	20317117	20517117	harbor2	chr13	20374977	20375424	LTR/ERV1	2239	+	224	20375201	58084
chr13	113727945	113927945	harbor2	chr13	113746115	113746547	LTR/ERV1	2019	+	216	113746331	18386
chr13	113727945	113927945	harbor2	chr13	113782476	113782548	LTR/ERV1	430	+	36	113782512	54567
chr13	20342080	20542080	harbor2	chr13	20343718	20344310	LTR/ERV1	3312	+	296	20344014	1934
chr13	20342080	20542080	harbor2	chr13	20359933	20360425	LTR/ERV1	2682	+	246	20360179	18099
chr13	20342080	20542080	harbor2	chr13	20374977	20375424	LTR/ERV1	2239	+	224	20375201	33121
chr13	20342080	20542080	harbor2	chr13	20434204	20434824	LTR/ERV1	2641	+	310	20434514	92434
chr13	20342080	20542080	harbor2	chr13	20439857	20440379	LTR/ERV1	1371	+	261	20440118	98038
chr13	21574582	21774582	harbor2	chr13	21582527	21582993	LTR/ERV1	3026	+	233	21582760	8178
chr13	21574582	21774582	harbor2	chr13	21588022	21589513	LTR/ERV1	9958	+	746	21588768	14186
chr13	21574582	21774582	harbor2	chr13	21589514	21590048	LTR/ERV1	3389	+	267	21589781	15199
chr13	21574582	21774582	harbor2	chr13	21610979	21611538	LTR/ERV1	3161	+	280	21611259	36677
chr13	36899390	37099390	harbor2	chr13	36956650	36956762	LTR/ERV1	744	+	56	36956706	57316
chr13	36899390	37099390	harbor2	chr13	36956763	36958343	LTR/ERV1	12246	+	790	36957553	58163
chr13	36899390	37099390	harbor2	chr13	36958369	36958652	LTR/ERV1	2140	+	142	36958511	59121
chr13	36899390	37099390	harbor2	chr13	36958653	36958981	LTR/ERV1	2310	+	164	36958817	59427
chr14	52595606	52795606	harbor2	chr14	52656949	52657285	LTR/ERV1	1966	+	168	52657117	61511
chr14	90283137	90483137	harbor2	chr14	90309525	90309728	LTR/ERV1	625	+	102	90309627	26490
chr14	95435240	95635240	harbor2	chr14	95532438	95532822	LTR/ERV1	2251	+	192	95532630	97390
chr14	75886299	76086299	harbor2	chr14	75943998	75944253	LTR/ERV1	1340	+	128	75944126	57827
chr14	75886299	76086299	harbor2	chr14	75944289	75944599	LTR/ERV1	2316	+	155	75944444	58145
chr14	75886299	76086299	harbor2	chr14	75944601	75945190	LTR/ERV1	3638	+	294	75944895	58596
chr14	104606429	104806429	harbor2	chr14	104622425	104622944	LTR/ERV1	4091	+	260	104622685	16256
chr14	104857736	105057736	harbor2	chr14	104910323	104910686	LTR/ERV1	2783	+	182	104910505	52769
chr14	104857736	105057736	harbor2	chr14	104910993	104911285	LTR/ERV1	2783	+	146	104911139	53403
chr14	104857736	105057736	harbor2	chr14	104918950	104919548	LTR/ERV1	4942	+	299	104919249	61513
chr14	100281320	100481320	harbor2	chr14	100371865	100372268	LTR/ERV1	2522	+	202	100372067	90747
chr14	69668087	69868087	harbor2	chr14	69729468	69729812	LTR/ERV1	1264	+	172	69729640	61553
chr14	69668087	69868087	harbor2	chr14	69744480	69744722	LTR/ERV1	1560	+	121	69744601	76514
chr14	69668087	69868087	harbor2	chr14	69730097	69730311	LTR/ERV1	1264	+	107	69730204	62117
chr14	20990974	21190974	harbor2	chr14	20998034	20998208	LTR/ERV1	782	+	87	20998121	7147
chr14	20990974	21190974	harbor2	chr14	21003288	21003917	LTR/ERV1	4625	+	314	21003602	12628
chr14	20990974	21190974	harbor2	chr14	21004803	21005297	LTR/ERV1	3754	+	247	21005050	14076
chr14	20990974	21190974	harbor2	chr14	21005507	21006081	LTR/ERV1	20398	+	287	21005794	14820
chr14	20990974	21190974	harbor2	chr14	21006154	21006269	LTR/ERV1	20398	+	58	21006212	15238
chr14	20990974	21190974	harbor2	chr14	21006573	21007541	LTR/ERV1	20398	+	484	21007057	16083
chr14	20990974	21190974	harbor2	chr14	21007849	21007966	LTR/ERV1	20398	+	58	21007907	16933
chr14	20990974	21190974	harbor2	chr14	21008279	21009671	LTR/ERV1	20398	+	696	21008975	18001
chr14	20990974	21190974	harbor2	chr14	21009672	21010322	LTR/ERV1	5253	+	325	21009997	19023
chr14	20990974	21190974	harbor2	chr14	21003918	21004810	LTR/ERV1	6713	+	446	21004364	13390
chr14	90283171	90483171	harbor2	chr14	90309525	90309728	LTR/ERV1	625	+	102	90309627	26456
chr14	95435743	95635743	harbor2	chr14	95532438	95532822	LTR/ERV1	2251	+	192	95532630	96887
chr14	104224547	104424547	harbor2	chr14	104304402	104304986	LTR/ERV1	941	+	292	104304694	80147
chr14	90283174	90483174	harbor2	chr14	90309525	90309728	LTR/ERV1	625	+	102	90309627	26453
chr14	75914984	76114984	harbor2	chr14	75943998	75944253	LTR/ERV1	1340	+	128	75944126	29142
chr14	75914984	76114984	harbor2	chr14	75944289	75944599	LTR/ERV1	2316	+	155	75944444	29460
chr14	75914984	76114984	harbor2	chr14	75944601	75945190	LTR/ERV1	3638	+	294	75944895	29911
chr14	81176400	81376400	harbor2	chr14	81225519	81226066	LTR/ERV1	3233	+	274	81225793	49393
chr14	81176400	81376400	harbor2	chr14	81235929	81237577	LTR/ERV1	9269	+	824	81236753	60353
chr14	104470380	104670380	harbor2	chr14	104528698	104528945	LTR/ERV1	2230	+	124	104528822	58442
chr14	104470380	104670380	harbor2	chr14	104529239	104529466	LTR/ERV1	2230	+	114	104529353	58973
chr14	104470380	104670380	harbor2	chr14	104531689	104532137	LTR/ERV1	2715	+	224	104531913	61533
chr14	104470380	104670380	harbor2	chr14	104534640	104535038	LTR/ERV1	1790	+	199	104534839	64459
chr14	100276551	100476551	harbor2	chr14	100371865	100372268	LTR/ERV1	2522	+	202	100372067	95516
chr14	102092831	102292831	harbor2	chr14	102116414	102118271	LTR/ERV1	7284	+	928	102117342	24511
chr14	88927417	89127417	harbor2	chr14	89008650	89009181	LTR/ERV1	825	+	266	89008916	81499
chr14	95456322	95656322	harbor2	chr14	95532438	95532822	LTR/ERV1	2251	+	192	95532630	76308
chr14	91227150	91427150	harbor2	chr14	91265964	91266296	LTR/ERV1	1702	+	166	91266130	38980
chr14	76886650	77086650	harbor2	chr14	76980156	76980504	LTR/ERV1	2226	+	174	76980330	93680
chr14	102039472	102239472	harbor2	chr14	102056022	102056485	LTR/ERV1	3449	+	232	102056254	16782
chr14	102039472	102239472	harbor2	chr14	102057810	102057883	LTR/ERV1	583	+	36	102057846	18374
chr14	102039472	102239472	harbor2	chr14	102057970	102058587	LTR/ERV1	2824	+	308	102058278	18806
chr14	102039472	102239472	harbor2	chr14	102058890	102058980	LTR/ERV1	2824	+	45	102058935	19463
chr14	102039472	102239472	harbor2	chr14	102064726	102065279	LTR/ERV1	4488	+	276	102065002	25530
chr14	102039472	102239472	harbor2	chr14	102116414	102118271	LTR/ERV1	7284	+	928	102117342	77870
chr14	100186150	100386150	harbor2	chr14	100190160	100190611	LTR/ERV1	2669	+	226	100190386	4236
chr14	100186150	100386150	harbor2	chr14	100204284	100204327	LTR/ERV1	2038	+	22	100204306	18156
chr14	100186150	100386150	harbor2	chr14	100205151	100205177	LTR/ERV1	2038	+	13	100205164	19014
chr14	100186150	100386150	harbor2	chr14	100205470	100205505	LTR/ERV1	2038	+	18	100205488	19338
chr14	100186150	100386150	harbor2	chr14	100204487	100204852	LTR/ERV1	2038	+	182	100204669	18519
chr14	103624423	103824423	harbor2	chr14	103702720	103703132	LTR/ERV1	1586	+	206	103702926	78503
chr14	103624423	103824423	harbor2	chr14	103712861	103713310	LTR/ERV1	1300	+	224	103713085	88662
chr14	103624423	103824423	harbor2	chr14	103719951	103720339	LTR/ERV1	776	+	194	103720145	95722
chr14	100185464	100385464	harbor2	chr14	100190160	100190611	LTR/ERV1	2669	+	226	100190386	4922
chr14	100185464	100385464	harbor2	chr14	100204284	100204327	LTR/ERV1	2038	+	22	100204306	18842
chr14	100185464	100385464	harbor2	chr14	100205151	100205177	LTR/ERV1	2038	+	13	100205164	19700
chr14	100185464	100385464	harbor2	chr14	100205470	100205505	LTR/ERV1	2038	+	18	100205488	20024
chr14	100185464	100385464	harbor2	chr14	100204487	100204852	LTR/ERV1	2038	+	182	100204669	19205
chr14	23464322	23664322	harbor2	chr14	23465444	23465627	LTR/ERV1	3761	+	92	23465536	1214
chr14	23464322	23664322	harbor2	chr14	23466182	23466228	LTR/ERV1	3761	+	23	23466205	1883
chr14	23464322	23664322	harbor2	chr14	23466534	23466696	LTR/ERV1	3761	+	81	23466615	2293
chr14	23464322	23664322	harbor2	chr14	23467114	23467427	LTR/ERV1	3761	+	156	23467270	2948
chr14	105067542	105267542	harbor2	chr14	105072182	105072358	LTR/ERV1	527	+	88	105072270	4728
chr14	105067542	105267542	harbor2	chr14	105100749	105101219	LTR/ERV1	2712	+	235	105100984	33442
chr14	105067542	105267542	harbor2	chr14	105128113	105128303	LTR/ERV1	1157	+	95	105128208	60666
chr14	105067542	105267542	harbor2	chr14	105128972	105129306	LTR/ERV1	1687	+	167	105129139	61597
chr14	105067542	105267542	harbor2	chr14	105131106	105131905	LTR/ERV1	3784	+	400	105131506	63964
chr14	105067542	105267542	harbor2	chr14	105132196	105133141	LTR/ERV1	3784	+	472	105132668	65126
chr14	105067542	105267542	harbor2	chr14	105133382	105134395	LTR/ERV1	2890	+	506	105133888	66346
chr14	67519986	67719986	harbor2	chr14	67596560	67596981	LTR/ERV1	1099	+	210	67596770	76784
chr14	67519986	67719986	harbor2	chr14	67610183	67610971	LTR/ERV1	1854	+	394	67610577	90591
chr14	67519986	67719986	harbor2	chr14	67613863	67613925	LTR/ERV1	939	+	31	67613894	93908
chr14	67519986	67719986	harbor2	chr14	67614235	67614329	LTR/ERV1	939	+	47	67614282	94296
chr14	76994915	77194915	harbor2	chr14	77075182	77075419	LTR/ERV1	1474	+	118	77075300	80385
chr14	76994915	77194915	harbor2	chr14	77075720	77076235	LTR/ERV1	1474	+	258	77075978	81063
chr14	94075512	94275512	harbor2	chr14	94094087	94094460	LTR/ERV1	2588	+	186	94094273	18761
chr14	94075512	94275512	harbor2	chr14	94094515	94094596	LTR/ERV1	500	+	40	94094555	19043
chr14	94075512	94275512	harbor2	chr14	94094572	94094813	LTR/ERV1	944	+	120	94094692	19180
chr14	94075512	94275512	harbor2	chr14	94094817	94095026	LTR/ERV1	1536	+	104	94094921	19409
chr14	76998329	77198329	harbor2	chr14	77075182	77075419	LTR/ERV1	1474	+	118	77075300	76971
chr14	76998329	77198329	harbor2	chr14	77075720	77076235	LTR/ERV1	1474	+	258	77075978	77649
chr14	76939921	77139921	harbor2	chr14	76980156	76980504	LTR/ERV1	2226	+	174	76980330	40409
chr14	76942497	77142497	harbor2	chr14	76980156	76980504	LTR/ERV1	2226	+	174	76980330	37833
chr14	51140675	51340675	harbor2	chr14	51148586	51148806	LTR/ERV1	482	+	110	51148696	8021
chr14	51140675	51340675	harbor2	chr14	51150138	51150581	LTR/ERV1	874	+	222	51150360	9685
chr14	51140675	51340675	harbor2	chr14	51155054	51155655	LTR/ERV1	759	+	300	51155354	14679
chr14	51140675	51340675	harbor2	chr14	51164619	51165312	LTR/ERV1	1217	+	346	51164965	24290
chr14	51140675	51340675	harbor2	chr14	51165650	51165778	LTR/ERV1	1705	+	64	51165714	25039
chr14	51140675	51340675	harbor2	chr14	51166389	51167220	LTR/ERV1	1705	+	416	51166805	26130
chr14	91481271	91681271	harbor2	chr14	91515714	91516435	LTR/ERV1	3982	+	360	91516074	34803
chr14	91481271	91681271	harbor2	chr14	91568301	91568610	LTR/ERV1	1949	+	154	91568455	87184
chr14	91481271	91681271	harbor2	chr14	91575368	91575971	LTR/ERV1	3950	+	302	91575670	94399
chr14	91481271	91681271	harbor2	chr14	91577489	91577778	LTR/ERV1	4804	+	144	91577633	96362
chr14	91481271	91681271	harbor2	chr14	91577779	91579392	LTR/ERV1	9540	+	806	91578585	97314
chr14	91481271	91681271	harbor2	chr14	91579393	91579969	LTR/ERV1	4804	+	288	91579681	98410
chr14	76928705	77128705	harbor2	chr14	76980156	76980504	LTR/ERV1	2226	+	174	76980330	51625
chr14	23332799	23532799	harbor2	chr14	23335106	23335298	LTR/ERV1	3242	+	96	23335202	2403
chr14	23332799	23532799	harbor2	chr14	23335608	23336013	LTR/ERV1	3242	+	202	23335810	3011
chr14	23332799	23532799	harbor2	chr14	23336017	23336610	LTR/ERV1	2732	+	296	23336313	3514
chr14	23332799	23532799	harbor2	chr14	23336725	23337068	LTR/ERV1	1412	+	172	23336897	4098
chr14	23332799	23532799	harbor2	chr14	23337068	23337151	LTR/ERV1	8277	+	42	23337110	4311
chr14	23332799	23532799	harbor2	chr14	23337443	23338858	LTR/ERV1	8277	+	708	23338151	5352
chr14	23332799	23532799	harbor2	chr14	23339242	23339848	LTR/ERV1	6551	+	303	23339545	6746
chr14	23332799	23532799	harbor2	chr14	23340220	23341898	LTR/ERV1	8904	+	839	23341059	8260
chr14	23332799	23532799	harbor2	chr14	23342173	23342277	LTR/ERV1	8904	+	52	23342225	9426
chr14	23332799	23532799	harbor2	chr14	23342380	23343346	LTR/ERV1	8904	+	483	23342863	10064
chr14	23332799	23532799	harbor2	chr14	23343319	23343860	LTR/ERV1	6522	+	270	23343589	10790
chr14	23332799	23532799	harbor2	chr14	23344140	23344650	LTR/ERV1	6522	+	255	23344395	11596
chr14	23332799	23532799	harbor2	chr14	23344651	23345236	LTR/ERV1	3406	+	292	23344943	12144
chr14	23087290	23287290	harbor2	chr14	23106682	23107337	LTR/ERV1	2165	+	328	23107010	19720
chr14	23087290	23287290	harbor2	chr14	23124293	23124627	LTR/ERV1	2098	+	167	23124460	37170
chr14	23087290	23287290	harbor2	chr14	23124926	23125107	LTR/ERV1	2098	+	90	23125016	37726
chr14	23087290	23287290	harbor2	chr14	23177178	23177569	LTR/ERV1	2575	+	196	23177374	90084
chr14	100323696	100523696	harbor2	chr14	100371865	100372268	LTR/ERV1	2522	+	202	100372067	48371
chr14	75915240	76115240	harbor2	chr14	75943998	75944253	LTR/ERV1	1340	+	128	75944126	28886
chr14	75915240	76115240	harbor2	chr14	75944289	75944599	LTR/ERV1	2316	+	155	75944444	29204
chr14	75915240	76115240	harbor2	chr14	75944601	75945190	LTR/ERV1	3638	+	294	75944895	29655
chr14	100185466	100385466	harbor2	chr14	100190160	100190611	LTR/ERV1	2669	+	226	100190386	4920
chr14	100185466	100385466	harbor2	chr14	100204284	100204327	LTR/ERV1	2038	+	22	100204306	18840
chr14	100185466	100385466	harbor2	chr14	100205151	100205177	LTR/ERV1	2038	+	13	100205164	19698
chr14	100185466	100385466	harbor2	chr14	100205470	100205505	LTR/ERV1	2038	+	18	100205488	20022
chr14	100185466	100385466	harbor2	chr14	100204487	100204852	LTR/ERV1	2038	+	182	100204669	19203
chr14	104590261	104790261	harbor2	chr14	104622425	104622944	LTR/ERV1	4091	+	260	104622685	32424
chr14	99658830	99858830	harbor2	chr14	99681556	99682121	LTR/ERV1	4253	+	282	99681838	23008
chr14	99658830	99858830	harbor2	chr14	99682434	99682573	LTR/ERV1	4253	+	70	99682504	23674
chr14	76932189	77132189	harbor2	chr14	76980156	76980504	LTR/ERV1	2226	+	174	76980330	48141
chr14	105568664	105768664	harbor2	chr14	105609924	105610740	LTR/ERV1	4450	+	408	105610332	41668
chr14	105568664	105768664	harbor2	chr14	105614125	105614230	LTR/ERV1	875	+	52	105614177	45513
chr14	105568664	105768664	harbor2	chr14	105614562	105614861	LTR/ERV1	875	+	150	105614712	46048
chr14	105568664	105768664	harbor2	chr14	105615503	105615632	LTR/ERV1	448	+	64	105615567	46903
chr14	105568664	105768664	harbor2	chr14	105615664	105615974	LTR/ERV1	1107	+	155	105615819	47155
chr14	105568664	105768664	harbor2	chr14	105618879	105619519	LTR/ERV1	1326	+	320	105619199	50535
chr14	105568664	105768664	harbor2	chr14	105633541	105633665	LTR/ERV1	864	+	62	105633603	64939
chr14	105568664	105768664	harbor2	chr14	105633997	105634295	LTR/ERV1	864	+	149	105634146	65482
chr14	105568664	105768664	harbor2	chr14	105634937	105635068	LTR/ERV1	436	+	66	105635003	66339
chr14	105568664	105768664	harbor2	chr14	105635100	105635410	LTR/ERV1	1094	+	155	105635255	66591
chr14	105568664	105768664	harbor2	chr14	105638125	105638753	LTR/ERV1	1324	+	314	105638439	69775
chr14	105568664	105768664	harbor2	chr14	105655563	105656381	LTR/ERV1	4606	+	409	105655972	87308
chr14	105568664	105768664	harbor2	chr14	105661787	105662415	LTR/ERV1	1274	+	314	105662101	93437
chr14	76959696	77159696	harbor2	chr14	76980156	76980504	LTR/ERV1	2226	+	174	76980330	20634
chr14	21007545	21207545	harbor2	chr14	21007849	21007966	LTR/ERV1	20398	+	58	21007907	362
chr14	21007545	21207545	harbor2	chr14	21008279	21009671	LTR/ERV1	20398	+	696	21008975	1430
chr14	21007545	21207545	harbor2	chr14	21009672	21010322	LTR/ERV1	5253	+	325	21009997	2452
chr14	69667754	69867754	harbor2	chr14	69729468	69729812	LTR/ERV1	1264	+	172	69729640	61886
chr14	69667754	69867754	harbor2	chr14	69744480	69744722	LTR/ERV1	1560	+	121	69744601	76847
chr14	69667754	69867754	harbor2	chr14	69730097	69730311	LTR/ERV1	1264	+	107	69730204	62450
chr14	102111829	102311829	harbor2	chr14	102116414	102118271	LTR/ERV1	7284	+	928	102117342	5513
chr14	105737928	105937928	harbor2	chr14	105754519	105755337	LTR/ERV1	4722	+	409	105754928	17000
chr14	105737928	105937928	harbor2	chr14	105758721	105758826	LTR/ERV1	866	+	52	105758773	20845
chr14	105737928	105937928	harbor2	chr14	105759157	105759455	LTR/ERV1	866	+	149	105759306	21378
chr14	105737928	105937928	harbor2	chr14	105760098	105760222	LTR/ERV1	472	+	62	105760160	22232
chr14	105737928	105937928	harbor2	chr14	105760259	105760569	LTR/ERV1	1136	+	155	105760414	22486
chr14	105737928	105937928	harbor2	chr14	105763069	105763697	LTR/ERV1	1312	+	314	105763383	25455
chr14	95436168	95636168	harbor2	chr14	95532438	95532822	LTR/ERV1	2251	+	192	95532630	96462
chr14	67259750	67459750	harbor2	chr14	67343922	67344395	LTR/ERV1	2611	+	236	67344158	84408
chr14	105122027	105322027	harbor2	chr14	105128113	105128303	LTR/ERV1	1157	+	95	105128208	6181
chr14	105122027	105322027	harbor2	chr14	105128972	105129306	LTR/ERV1	1687	+	167	105129139	7112
chr14	105122027	105322027	harbor2	chr14	105131106	105131905	LTR/ERV1	3784	+	400	105131506	9479
chr14	105122027	105322027	harbor2	chr14	105132196	105133141	LTR/ERV1	3784	+	472	105132668	10641
chr14	105122027	105322027	harbor2	chr14	105133382	105134395	LTR/ERV1	2890	+	506	105133888	11861
chr14	23986853	24186853	harbor2	chr14	24020327	24020892	LTR/ERV1	1375	+	282	24020609	33756
chr14	102409678	102609678	harbor2	chr14	102410504	102410681	LTR/ERV1	1086	+	88	102410592	914
chr14	102409678	102609678	harbor2	chr14	102410683	102410910	LTR/ERV1	1314	+	114	102410797	1119
chr14	102409678	102609678	harbor2	chr14	102410909	102411288	LTR/ERV1	2530	+	190	102411099	1421
chr14	102409678	102609678	harbor2	chr14	102411289	102411706	LTR/ERV1	3076	+	208	102411497	1819
chr14	73684556	73884556	harbor2	chr14	73703339	73703768	LTR/ERV1	3437	+	214	73703553	18997
chr14	73684556	73884556	harbor2	chr14	73703771	73707030	LTR/ERV1	21093	+	1630	73705401	20845
chr14	73684556	73884556	harbor2	chr14	73707021	73707528	LTR/ERV1	3404	+	254	73707275	22719
chr14	73684556	73884556	harbor2	chr14	73707531	73708191	LTR/ERV1	4292	+	330	73707861	23305
chr14	73684556	73884556	harbor2	chr14	73708193	73708409	LTR/ERV1	1412	+	108	73708301	23745
chr14	73684556	73884556	harbor2	chr14	73708408	73708784	LTR/ERV1	2560	+	188	73708596	24040
chr14	73684556	73884556	harbor2	chr14	73708785	73709213	LTR/ERV1	3395	+	214	73708999	24443
chr14	104119074	104319074	harbor2	chr14	104207710	104208037	LTR/ERV1	1687	+	164	104207874	88800
chr14	104119074	104319074	harbor2	chr14	104209489	104209613	LTR/ERV1	493	+	62	104209551	90477
chr14	91474914	91674914	harbor2	chr14	91515714	91516435	LTR/ERV1	3982	+	360	91516074	41160
chr14	91474914	91674914	harbor2	chr14	91568301	91568610	LTR/ERV1	1949	+	154	91568455	93541
chr14	100581532	100781532	harbor2	chr14	100596596	100596892	LTR/ERV1	2517	+	148	100596744	15212
chr14	100581532	100781532	harbor2	chr14	100597200	100597383	LTR/ERV1	2517	+	92	100597292	15760
chr14	64194993	64394993	harbor2	chr14	64278786	64279350	LTR/ERV1	3327	+	282	64279068	84075
chr14	103637279	103837279	harbor2	chr14	103702720	103703132	LTR/ERV1	1586	+	206	103702926	65647
chr14	103637279	103837279	harbor2	chr14	103712861	103713310	LTR/ERV1	1300	+	224	103713085	75806
chr14	103637279	103837279	harbor2	chr14	103719951	103720339	LTR/ERV1	776	+	194	103720145	82866
chr14	67500239	67700239	harbor2	chr14	67505095	67505703	LTR/ERV1	1635	+	304	67505399	5160
chr14	67500239	67700239	harbor2	chr14	67505999	67506084	LTR/ERV1	1635	+	42	67506041	5802
chr14	67500239	67700239	harbor2	chr14	67506233	67506435	LTR/ERV1	829	+	101	67506334	6095
chr14	67500239	67700239	harbor2	chr14	67596560	67596981	LTR/ERV1	1099	+	210	67596770	96531
chr14	100185458	100385458	harbor2	chr14	100190160	100190611	LTR/ERV1	2669	+	226	100190386	4928
chr14	100185458	100385458	harbor2	chr14	100204284	100204327	LTR/ERV1	2038	+	22	100204306	18848
chr14	100185458	100385458	harbor2	chr14	100205151	100205177	LTR/ERV1	2038	+	13	100205164	19706
chr14	100185458	100385458	harbor2	chr14	100205470	100205505	LTR/ERV1	2038	+	18	100205488	20030
chr14	100185458	100385458	harbor2	chr14	100204487	100204852	LTR/ERV1	2038	+	182	100204669	19211
chr14	76928673	77128673	harbor2	chr14	76980156	76980504	LTR/ERV1	2226	+	174	76980330	51657
chr14	90288480	90488480	harbor2	chr14	90309525	90309728	LTR/ERV1	625	+	102	90309627	21147
chr14	105652859	105852859	harbor2	chr14	105655563	105656381	LTR/ERV1	4606	+	409	105655972	3113
chr14	105652859	105852859	harbor2	chr14	105661787	105662415	LTR/ERV1	1274	+	314	105662101	9242
chr14	105652859	105852859	harbor2	chr14	105670159	105670264	LTR/ERV1	521	+	52	105670211	17352
chr14	105652859	105852859	harbor2	chr14	105670871	105671017	LTR/ERV1	521	+	73	105670944	18085
chr14	105652859	105852859	harbor2	chr14	105676204	105676717	LTR/ERV1	2589	+	256	105676460	23601
chr14	105652859	105852859	harbor2	chr14	105677155	105677505	LTR/ERV1	1954	+	175	105677330	24471
chr14	105652859	105852859	harbor2	chr14	105729352	105729457	LTR/ERV1	836	+	52	105729404	76545
chr14	105652859	105852859	harbor2	chr14	105729787	105730087	LTR/ERV1	836	+	150	105729937	77078
chr14	105652859	105852859	harbor2	chr14	105730724	105730848	LTR/ERV1	466	+	62	105730786	77927
chr14	105652859	105852859	harbor2	chr14	105730885	105731195	LTR/ERV1	1080	+	155	105731040	78181
chr14	105652859	105852859	harbor2	chr14	105734912	105735540	LTR/ERV1	1229	+	314	105735226	82367
chr14	105652859	105852859	harbor2	chr14	105676726	105676831	LTR/ERV1	1954	+	52	105676778	23919
chr14	105652859	105852859	harbor2	chr14	105725142	105725964	LTR/ERV1	4674	+	411	105725553	72694
chr14	105058745	105258745	harbor2	chr14	105059428	105059826	LTR/ERV1	1918	+	199	105059627	882
chr14	105058745	105258745	harbor2	chr14	105072182	105072358	LTR/ERV1	527	+	88	105072270	13525
chr14	105058745	105258745	harbor2	chr14	105100749	105101219	LTR/ERV1	2712	+	235	105100984	42239
chr14	105058745	105258745	harbor2	chr14	105128113	105128303	LTR/ERV1	1157	+	95	105128208	69463
chr14	105058745	105258745	harbor2	chr14	105128972	105129306	LTR/ERV1	1687	+	167	105129139	70394
chr14	105058745	105258745	harbor2	chr14	105131106	105131905	LTR/ERV1	3784	+	400	105131506	72761
chr14	105058745	105258745	harbor2	chr14	105132196	105133141	LTR/ERV1	3784	+	472	105132668	73923
chr14	105058745	105258745	harbor2	chr14	105133382	105134395	LTR/ERV1	2890	+	506	105133888	75143
chr15	29170198	29370198	harbor2	chr15	29178461	29178806	LTR/ERV1	1036	+	172	29178633	8435
chr15	29170198	29370198	harbor2	chr15	29222002	29222533	LTR/ERV1	4067	+	266	29222268	52070
chr15	29170198	29370198	harbor2	chr15	29253990	29254134	LTR/ERV1	772	+	72	29254062	83864
chr15	29170198	29370198	harbor2	chr15	29254191	29254558	LTR/ERV1	1119	+	184	29254375	84177
chr15	29170198	29370198	harbor2	chr15	29259352	29259692	LTR/ERV1	1770	+	170	29259522	89324
chr15	29170198	29370198	harbor2	chr15	29259865	29260002	LTR/ERV1	798	+	68	29259933	89735
chr15	35496867	35696867	harbor2	chr15	35590780	35591017	LTR/ERV1	1526	+	118	35590898	94031
chr15	101861517	102061517	harbor2	chr15	101944451	101944528	LTR/ERV1	631	+	38	101944489	82972
chr15	45030353	45230353	harbor2	chr15	45034652	45036266	LTR/ERV1	8568	+	807	45035459	5106
chr15	45030353	45230353	harbor2	chr15	45057154	45057488	LTR/ERV1	884	+	167	45057321	26968
chr15	101861533	102061533	harbor2	chr15	101944451	101944528	LTR/ERV1	631	+	38	101944489	82956
chr15	45378429	45578429	harbor2	chr15	45385585	45386154	LTR/ERV1	3403	+	284	45385869	7440
chr15	45378429	45578429	harbor2	chr15	45469033	45469477	LTR/ERV1	1279	+	222	45469255	90826
chr15	45378429	45578429	harbor2	chr15	45469478	45469896	LTR/ERV1	2805	+	209	45469687	91258
chr15	45378429	45578429	harbor2	chr15	45469897	45469988	LTR/ERV1	1279	+	46	45469943	91514
chr15	45378429	45578429	harbor2	chr15	45471336	45471678	LTR/ERV1	1919	+	171	45471507	93078
chr15	45378429	45578429	harbor2	chr15	45472254	45472900	LTR/ERV1	2310	+	323	45472577	94148
chr15	79333661	79533661	harbor2	chr15	79364421	79365162	LTR/ERV1	5209	+	370	79364791	31130
chr15	79333661	79533661	harbor2	chr15	79365955	79366446	LTR/ERV1	2447	+	246	79366201	32540
chr15	79333661	79533661	harbor2	chr15	79367440	79367643	LTR/ERV1	920	+	102	79367542	33881
chr15	79333661	79533661	harbor2	chr15	79368683	79368805	LTR/ERV1	2785	+	61	79368744	35083
chr15	79333661	79533661	harbor2	chr15	79369115	79369605	LTR/ERV1	2785	+	245	79369360	35699
chr15	101862196	102062196	harbor2	chr15	101944451	101944528	LTR/ERV1	631	+	38	101944489	82293
chr15	34109976	34309976	harbor2	chr15	34114411	34115400	LTR/ERV1	4446	+	494	34114905	4929
chr15	34109976	34309976	harbor2	chr15	34121726	34122182	LTR/ERV1	2314	+	228	34121954	11978
chr15	34109976	34309976	harbor2	chr15	34186202	34187495	LTR/ERV1	8549	+	646	34186848	76872
chr15	65277620	65477620	harbor2	chr15	65347477	65347648	LTR/ERV1	4273	+	86	65347563	69943
chr15	65277620	65477620	harbor2	chr15	65347988	65348376	LTR/ERV1	4273	+	194	65348182	70562
chr15	65277620	65477620	harbor2	chr15	65348463	65350041	LTR/ERV1	5097	+	789	65349252	71632
chr15	65277620	65477620	harbor2	chr15	65350026	65350119	LTR/ERV1	686	+	46	65350072	72452
chr15	65277620	65477620	harbor2	chr15	65350765	65351254	LTR/ERV1	10600	+	244	65351009	73389
chr15	65277620	65477620	harbor2	chr15	65351553	65353190	LTR/ERV1	10711	+	818	65352371	74751
chr15	65277620	65477620	harbor2	chr15	65353551	65353892	LTR/ERV1	3162	+	170	65353721	76101
chr15	65277620	65477620	harbor2	chr15	65354203	65354320	LTR/ERV1	3162	+	58	65354261	76641
chr15	35537214	35737214	harbor2	chr15	35590780	35591017	LTR/ERV1	1526	+	118	35590898	53684
chr15	101624468	101824468	harbor2	chr15	101696607	101697263	LTR/ERV1	2695	+	328	101696935	72467
chr15	101876518	102076518	harbor2	chr15	101944451	101944528	LTR/ERV1	631	+	38	101944489	67971
chr15	101875496	102075496	harbor2	chr15	101944451	101944528	LTR/ERV1	631	+	38	101944489	68993
chr15	41872068	42072068	harbor2	chr15	41906020	41906893	LTR/ERV1	4782	+	436	41906456	34388
chr15	35569538	35769538	harbor2	chr15	35590780	35591017	LTR/ERV1	1526	+	118	35590898	21360
chr15	50808701	51008701	harbor2	chr15	50811794	50813094	LTR/ERV1	8957	+	650	50812444	3743
chr15	50808701	51008701	harbor2	chr15	50892300	50892551	LTR/ERV1	1299	+	126	50892426	83725
chr15	50808701	51008701	harbor2	chr15	50901309	50901479	LTR/ERV1	2313	+	85	50901394	92693
chr15	50808701	51008701	harbor2	chr15	50901779	50902294	LTR/ERV1	2313	+	258	50902037	93336
chr15	50808701	51008701	harbor2	chr15	50902585	50903076	LTR/ERV1	1010	+	246	50902831	94130
chr15	101861525	102061525	harbor2	chr15	101944451	101944528	LTR/ERV1	631	+	38	101944489	82964
chr15	29334927	29534927	harbor2	chr15	29385679	29386466	LTR/ERV1	5338	+	394	29386073	51146
chr15	69999345	70199345	harbor2	chr15	70022117	70022308	LTR/ERV1	1190	+	96	70022213	22868
chr15	68720982	68920982	harbor2	chr15	68790829	68791428	LTR/ERV1	3336	+	300	68791129	70147
chr15	101862010	102062010	harbor2	chr15	101944451	101944528	LTR/ERV1	631	+	38	101944489	82479
chr15	41521437	41721437	harbor2	chr15	41586620	41586712	LTR/ERV1	3492	+	46	41586666	65229
chr15	41521437	41721437	harbor2	chr15	41587024	41587419	LTR/ERV1	3492	+	198	41587222	65785
chr15	41521437	41721437	harbor2	chr15	41587503	41592733	LTR/ERV1	42218	+	2615	41590118	68681
chr15	41521437	41721437	harbor2	chr15	41592734	41593097	LTR/ERV1	2866	+	182	41592916	71479
chr15	41521437	41721437	harbor2	chr15	41593394	41593518	LTR/ERV1	2866	+	62	41593456	72019
chr15	29332913	29532913	harbor2	chr15	29385679	29386466	LTR/ERV1	5338	+	394	29386073	53160
chr15	20980576	21180576	harbor2	chr15	20985265	20985672	LTR/ERV1	2545	+	204	20985469	4893
chr15	20980576	21180576	harbor2	chr15	21000099	21000971	LTR/ERV1	3875	+	436	21000535	19959
chr15	20980576	21180576	harbor2	chr15	21045704	21045933	LTR/ERV1	1669	+	114	21045818	65242
chr15	20980576	21180576	harbor2	chr15	21046369	21046764	LTR/ERV1	2767	+	198	21046567	65991
chr15	20980576	21180576	harbor2	chr15	21055627	21055947	LTR/ERV1	1511	+	160	21055787	75211
chr15	20980576	21180576	harbor2	chr15	21058521	21059273	LTR/ERV1	1284	+	376	21058897	78321
chr15	20980576	21180576	harbor2	chr15	21077348	21077709	LTR/ERV1	1231	+	180	21077528	96952
chr15	39197828	39397828	harbor2	chr15	39232908	39233005	LTR/ERV1	602	+	48	39232956	35128
chr15	39197828	39397828	harbor2	chr15	39233108	39233433	LTR/ERV1	1110	+	162	39233270	35442
chr15	39197828	39397828	harbor2	chr15	39234157	39234294	LTR/ERV1	733	+	68	39234225	36397
chr15	29169893	29369893	harbor2	chr15	29178461	29178806	LTR/ERV1	1036	+	172	29178633	8740
chr15	29169893	29369893	harbor2	chr15	29222002	29222533	LTR/ERV1	4067	+	266	29222268	52375
chr15	29169893	29369893	harbor2	chr15	29253990	29254134	LTR/ERV1	772	+	72	29254062	84169
chr15	29169893	29369893	harbor2	chr15	29254191	29254558	LTR/ERV1	1119	+	184	29254375	84482
chr15	29169893	29369893	harbor2	chr15	29259352	29259692	LTR/ERV1	1770	+	170	29259522	89629
chr15	29169893	29369893	harbor2	chr15	29259865	29260002	LTR/ERV1	798	+	68	29259933	90040
chr15	35569564	35769564	harbor2	chr15	35590780	35591017	LTR/ERV1	1526	+	118	35590898	21334
chr15	63405661	63605661	harbor2	chr15	63434646	63435329	LTR/ERV1	3195	+	342	63434988	29327
chr15	63405661	63605661	harbor2	chr15	63435598	63436302	LTR/ERV1	4299	+	352	63435950	30289
chr15	63405661	63605661	harbor2	chr15	63458891	63460258	LTR/ERV1	8158	+	684	63459575	53914
chr15	64052241	64252241	harbor2	chr15	64069710	64069933	LTR/ERV1	1205	+	112	64069822	17581
chr15	64052241	64252241	harbor2	chr15	64070166	64070621	LTR/ERV1	3063	+	228	64070394	18153
chr15	64052241	64252241	harbor2	chr15	64060668	64062121	LTR/ERV1	9107	+	726	64061394	9153
chr15	34238104	34438104	harbor2	chr15	34262070	34263014	LTR/ERV1	3012	+	472	34262542	24438
chr15	69999529	70199529	harbor2	chr15	70022117	70022308	LTR/ERV1	1190	+	96	70022213	22684
chr15	100177694	100377694	harbor2	chr15	100240381	100240832	LTR/ERV1	2542	+	226	100240607	62913
chr15	100177694	100377694	harbor2	chr15	100241124	100241223	LTR/ERV1	2542	+	50	100241174	63480
chr15	45302521	45502521	harbor2	chr15	45306145	45306375	LTR/ERV1	1395	+	115	45306260	3739
chr15	45302521	45502521	harbor2	chr15	45306713	45306946	LTR/ERV1	1395	+	116	45306829	4308
chr15	45302521	45502521	harbor2	chr15	45313910	45315184	LTR/ERV1	8327	+	637	45314547	12026
chr15	45302521	45502521	harbor2	chr15	45319933	45320070	LTR/ERV1	4455	+	68	45320001	17480
chr15	45302521	45502521	harbor2	chr15	45320384	45321050	LTR/ERV1	4455	+	333	45320717	18196
chr15	45302521	45502521	harbor2	chr15	45323480	45323994	LTR/ERV1	3835	+	257	45323737	21216
chr15	45302521	45502521	harbor2	chr15	45327892	45328226	LTR/ERV1	2130	+	167	45328059	25538
chr15	45302521	45502521	harbor2	chr15	45332698	45332984	LTR/ERV1	833	+	143	45332841	30320
chr15	45302521	45502521	harbor2	chr15	45385585	45386154	LTR/ERV1	3403	+	284	45385869	83348
chr15	56979942	57179942	harbor2	chr15	57016020	57016432	LTR/ERV1	519	+	206	57016226	36284
chr15	74806668	75006668	harbor2	chr15	74876702	74877262	LTR/ERV1	3208	+	280	74876982	70314
chr15	74806668	75006668	harbor2	chr15	74877571	74877599	LTR/ERV1	3208	+	14	74877585	70917
chr15	74806668	75006668	harbor2	chr15	74878215	74878382	LTR/ERV1	3208	+	84	74878299	71631
chr15	74806668	75006668	harbor2	chr15	74880467	74880492	LTR/ERV1	611	+	12	74880479	73811
chr15	74806668	75006668	harbor2	chr15	74880802	74880865	LTR/ERV1	951	+	32	74880834	74166
chr15	74806668	75006668	harbor2	chr15	74881167	74881305	LTR/ERV1	951	+	69	74881236	74568
chr15	74806668	75006668	harbor2	chr15	74882012	74882124	LTR/ERV1	621	+	56	74882068	75400
chr15	29169897	29369897	harbor2	chr15	29178461	29178806	LTR/ERV1	1036	+	172	29178633	8736
chr15	29169897	29369897	harbor2	chr15	29222002	29222533	LTR/ERV1	4067	+	266	29222268	52371
chr15	29169897	29369897	harbor2	chr15	29253990	29254134	LTR/ERV1	772	+	72	29254062	84165
chr15	29169897	29369897	harbor2	chr15	29254191	29254558	LTR/ERV1	1119	+	184	29254375	84478
chr15	29169897	29369897	harbor2	chr15	29259352	29259692	LTR/ERV1	1770	+	170	29259522	89625
chr15	29169897	29369897	harbor2	chr15	29259865	29260002	LTR/ERV1	798	+	68	29259933	90036
chr15	71630657	71830657	harbor2	chr15	71650504	71650891	LTR/ERV1	2962	+	194	71650698	20041
chr15	35526392	35726392	harbor2	chr15	35590780	35591017	LTR/ERV1	1526	+	118	35590898	64506
chr15	73800179	74000179	harbor2	chr15	73891377	73892853	LTR/ERV1	7547	+	738	73892115	91936
chr15	101859001	102059001	harbor2	chr15	101859703	101859976	LTR/ERV1	2902	+	136	101859839	838
chr15	101859001	102059001	harbor2	chr15	101860945	101861193	LTR/ERV1	2902	+	124	101861069	2068
chr15	101859001	102059001	harbor2	chr15	101944451	101944528	LTR/ERV1	631	+	38	101944489	85488
chr15	101859001	102059001	harbor2	chr15	101859256	101859449	LTR/ERV1	426	+	96	101859352	351
chr15	101624486	101824486	harbor2	chr15	101696607	101697263	LTR/ERV1	2695	+	328	101696935	72449
chr15	45487658	45687658	harbor2	chr15	45548693	45549274	LTR/ERV1	3938	+	290	45548983	61325
chr15	45487658	45687658	harbor2	chr15	45564380	45564810	LTR/ERV1	2232	+	215	45564595	76937
chr15	73826340	74026340	harbor2	chr15	73891377	73892853	LTR/ERV1	7547	+	738	73892115	65775
chr16	2198935	2398935	harbor2	chr16	2258735	2258831	LTR/ERV1	626	+	48	2258783	59848
chr16	2198935	2398935	harbor2	chr16	2259141	2259607	LTR/ERV1	4147	+	233	2259374	60439
chr16	2198935	2398935	harbor2	chr16	2259901	2260147	LTR/ERV1	4147	+	123	2260024	61089
chr16	2198935	2398935	harbor2	chr16	2260399	2260848	LTR/ERV1	4147	+	224	2260623	61688
chr16	2198935	2398935	harbor2	chr16	2261145	2261551	LTR/ERV1	2406	+	203	2261348	62413
chr16	2198935	2398935	harbor2	chr16	2261552	2262137	LTR/ERV1	3537	+	292	2261844	62909
chr16	88757148	88957148	harbor2	chr16	88813681	88814167	LTR/ERV1	999	+	243	88813924	56776
chr16	2665224	2865224	harbor2	chr16	2724745	2725243	LTR/ERV1	1637	+	249	2724994	59770
chr16	2665224	2865224	harbor2	chr16	2731942	2732270	LTR/ERV1	604	+	164	2732106	66882
chr16	66712056	66912056	harbor2	chr16	66752168	66752399	LTR/ERV1	736	+	116	66752284	40228
chr16	67010338	67210338	harbor2	chr16	67011897	67012057	LTR/ERV1	1877	+	80	67011977	1639
chr16	67010338	67210338	harbor2	chr16	67012358	67012614	LTR/ERV1	1877	+	128	67012486	2148
chr16	67009867	67209867	harbor2	chr16	67011897	67012057	LTR/ERV1	1877	+	80	67011977	2110
chr16	67009867	67209867	harbor2	chr16	67012358	67012614	LTR/ERV1	1877	+	128	67012486	2619
chr16	688197	888197	harbor2	chr16	753382	753654	LTR/ERV1	1294	+	136	753518	65321
chr16	688197	888197	harbor2	chr16	753723	753859	LTR/ERV1	695	+	68	753791	65594
chr16	688197	888197	harbor2	chr16	754162	754367	LTR/ERV1	695	+	102	754264	66067
chr16	688197	888197	harbor2	chr16	754656	754667	LTR/ERV1	695	+	6	754662	66465
chr16	688197	888197	harbor2	chr16	777756	778061	LTR/ERV1	717	+	152	777908	89711
chr16	1555502	1755502	harbor2	chr16	1573886	1574283	LTR/ERV1	1099	+	198	1574084	18582
chr16	427636	627636	harbor2	chr16	483277	484114	LTR/ERV1	4267	+	418	483695	56059
chr16	2838432	3038432	harbor2	chr16	2844182	2844409	LTR/ERV1	780	+	114	2844296	5864
chr16	2838432	3038432	harbor2	chr16	2844543	2844610	LTR/ERV1	780	+	34	2844577	6145
chr16	2838432	3038432	harbor2	chr16	2845652	2845686	LTR/ERV1	2118	+	17	2845669	7237
chr16	2838432	3038432	harbor2	chr16	2845687	2846020	LTR/ERV1	3830	+	166	2845853	7421
chr16	2838432	3038432	harbor2	chr16	2846328	2846695	LTR/ERV1	3830	+	184	2846512	8080
chr16	2838432	3038432	harbor2	chr16	2846696	2847174	LTR/ERV1	2118	+	239	2846935	8503
chr16	2838432	3038432	harbor2	chr16	2866339	2866728	LTR/ERV1	1403	+	194	2866533	28101
chr16	2838432	3038432	harbor2	chr16	2879667	2880445	LTR/ERV1	3148	+	389	2880056	41624
chr16	2838432	3038432	harbor2	chr16	2907335	2907834	LTR/ERV1	3841	+	250	2907585	69153
chr16	4017125	4217125	harbor2	chr16	4026830	4027367	LTR/ERV1	1877	+	268	4027098	9973
chr16	4017125	4217125	harbor2	chr16	4071400	4071809	LTR/ERV1	1547	+	204	4071604	54479
chr16	4017125	4217125	harbor2	chr16	4072008	4072247	LTR/ERV1	998	+	120	4072128	55003
chr16	1	168578	harbor2	chr16	27849	28407	LTR/ERV1	1042	+	279	28128	28127
chr16	1	168578	harbor2	chr16	41012	41496	LTR/ERV1	3445	+	242	41254	41253
chr16	1	168578	harbor2	chr16	41497	42751	LTR/ERV1	5592	+	627	42124	42123
chr16	1	168578	harbor2	chr16	42729	43450	LTR/ERV1	4199	+	360	43089	43088
chr16	1	168578	harbor2	chr16	43897	44027	LTR/ERV1	2023	+	65	43962	43961
chr16	1	168578	harbor2	chr16	44342	44709	LTR/ERV1	2023	+	184	44526	44525
chr16	1	168578	harbor2	chr16	44715	46385	LTR/ERV1	7723	+	835	45550	45549
chr16	1	168578	harbor2	chr16	74663	75026	LTR/ERV1	2084	+	182	74845	74844
chr16	56535582	56735582	harbor2	chr16	56540102	56540554	LTR/ERV1	2561	+	226	56540328	4746
chr16	56535582	56735582	harbor2	chr16	56541040	56541195	LTR/ERV1	974	+	78	56541118	5536
chr16	2204042	2404042	harbor2	chr16	2258735	2258831	LTR/ERV1	626	+	48	2258783	54741
chr16	2204042	2404042	harbor2	chr16	2259141	2259607	LTR/ERV1	4147	+	233	2259374	55332
chr16	2204042	2404042	harbor2	chr16	2259901	2260147	LTR/ERV1	4147	+	123	2260024	55982
chr16	2204042	2404042	harbor2	chr16	2260399	2260848	LTR/ERV1	4147	+	224	2260623	56581
chr16	2204042	2404042	harbor2	chr16	2261145	2261551	LTR/ERV1	2406	+	203	2261348	57306
chr16	2204042	2404042	harbor2	chr16	2261552	2262137	LTR/ERV1	3537	+	292	2261844	57802
chr16	12196224	12396224	harbor2	chr16	12288139	12288625	LTR/ERV1	2588	+	243	12288382	92158
chr16	700509	900509	harbor2	chr16	753382	753654	LTR/ERV1	1294	+	136	753518	53009
chr16	700509	900509	harbor2	chr16	753723	753859	LTR/ERV1	695	+	68	753791	53282
chr16	700509	900509	harbor2	chr16	754162	754367	LTR/ERV1	695	+	102	754264	53755
chr16	700509	900509	harbor2	chr16	754656	754667	LTR/ERV1	695	+	6	754662	54153
chr16	700509	900509	harbor2	chr16	777756	778061	LTR/ERV1	717	+	152	777908	77399
chr16	71341038	71541038	harbor2	chr16	71404176	71404695	LTR/ERV1	3370	+	260	71404436	63398
chr16	71341038	71541038	harbor2	chr16	71409012	71409505	LTR/ERV1	2298	+	246	71409258	68220
chr16	4153746	4353746	harbor2	chr16	4243707	4243879	LTR/ERV1	938	+	86	4243793	90047
chr16	4153746	4353746	harbor2	chr16	4243927	4244053	LTR/ERV1	920	+	63	4243990	90244
chr16	4153746	4353746	harbor2	chr16	4244104	4244303	LTR/ERV1	1195	+	100	4244204	90458
chr16	4153746	4353746	harbor2	chr16	4244304	4244803	LTR/ERV1	2704	+	250	4244554	90808
chr16	245098	445098	harbor2	chr16	278988	279415	LTR/ERV1	2416	+	214	279202	34104
chr16	245098	445098	harbor2	chr16	303181	303384	LTR/ERV1	2289	+	102	303283	58185
chr16	245098	445098	harbor2	chr16	303682	303812	LTR/ERV1	2289	+	65	303747	58649
chr16	245098	445098	harbor2	chr16	341083	342390	LTR/ERV1	9339	+	654	341737	96639
chr16	1	168358	harbor2	chr16	27849	28407	LTR/ERV1	1042	+	279	28128	28127
chr16	1	168358	harbor2	chr16	41012	41496	LTR/ERV1	3445	+	242	41254	41253
chr16	1	168358	harbor2	chr16	41497	42751	LTR/ERV1	5592	+	627	42124	42123
chr16	1	168358	harbor2	chr16	42729	43450	LTR/ERV1	4199	+	360	43089	43088
chr16	1	168358	harbor2	chr16	43897	44027	LTR/ERV1	2023	+	65	43962	43961
chr16	1	168358	harbor2	chr16	44342	44709	LTR/ERV1	2023	+	184	44526	44525
chr16	1	168358	harbor2	chr16	44715	46385	LTR/ERV1	7723	+	835	45550	45549
chr16	1	168358	harbor2	chr16	74663	75026	LTR/ERV1	2084	+	182	74845	74844
chr16	1606172	1806172	harbor2	chr16	1690335	1690523	LTR/ERV1	931	+	94	1690429	84257
chr16	2199555	2399555	harbor2	chr16	2258735	2258831	LTR/ERV1	626	+	48	2258783	59228
chr16	2199555	2399555	harbor2	chr16	2259141	2259607	LTR/ERV1	4147	+	233	2259374	59819
chr16	2199555	2399555	harbor2	chr16	2259901	2260147	LTR/ERV1	4147	+	123	2260024	60469
chr16	2199555	2399555	harbor2	chr16	2260399	2260848	LTR/ERV1	4147	+	224	2260623	61068
chr16	2199555	2399555	harbor2	chr16	2261145	2261551	LTR/ERV1	2406	+	203	2261348	61793
chr16	2199555	2399555	harbor2	chr16	2261552	2262137	LTR/ERV1	3537	+	292	2261844	62289
chr16	1	168450	harbor2	chr16	27849	28407	LTR/ERV1	1042	+	279	28128	28127
chr16	1	168450	harbor2	chr16	41012	41496	LTR/ERV1	3445	+	242	41254	41253
chr16	1	168450	harbor2	chr16	41497	42751	LTR/ERV1	5592	+	627	42124	42123
chr16	1	168450	harbor2	chr16	42729	43450	LTR/ERV1	4199	+	360	43089	43088
chr16	1	168450	harbor2	chr16	43897	44027	LTR/ERV1	2023	+	65	43962	43961
chr16	1	168450	harbor2	chr16	44342	44709	LTR/ERV1	2023	+	184	44526	44525
chr16	1	168450	harbor2	chr16	44715	46385	LTR/ERV1	7723	+	835	45550	45549
chr16	1	168450	harbor2	chr16	74663	75026	LTR/ERV1	2084	+	182	74845	74844
chr16	1892491	2092491	harbor2	chr16	1943652	1943800	LTR/ERV1	4838	+	74	1943726	51235
chr16	1892491	2092491	harbor2	chr16	1944109	1944737	LTR/ERV1	4838	+	314	1944423	51932
chr16	1606165	1806165	harbor2	chr16	1690335	1690523	LTR/ERV1	931	+	94	1690429	84264
chr16	700920	900920	harbor2	chr16	753382	753654	LTR/ERV1	1294	+	136	753518	52598
chr16	700920	900920	harbor2	chr16	753723	753859	LTR/ERV1	695	+	68	753791	52871
chr16	700920	900920	harbor2	chr16	754162	754367	LTR/ERV1	695	+	102	754264	53344
chr16	700920	900920	harbor2	chr16	754656	754667	LTR/ERV1	695	+	6	754662	53742
chr16	700920	900920	harbor2	chr16	777756	778061	LTR/ERV1	717	+	152	777908	76988
chr16	57884872	58084872	harbor2	chr16	57910045	57910363	LTR/ERV1	3218	+	159	57910204	25332
chr16	57884872	58084872	harbor2	chr16	57910674	57910969	LTR/ERV1	3218	+	148	57910822	25950
chr16	89220363	89420363	harbor2	chr16	89250156	89250505	LTR/ERV1	2083	+	174	89250330	29967
chr16	456224	656224	harbor2	chr16	483277	484114	LTR/ERV1	4267	+	418	483695	27471
chr16	89542207	89742207	harbor2	chr16	89607317	89607482	LTR/ERV1	662	+	82	89607399	65192
chr16	89542207	89742207	harbor2	chr16	89610017	89610598	LTR/ERV1	1360	+	290	89610307	68100
chr16	85109928	85309928	harbor2	chr16	85140408	85140585	LTR/ERV1	1008	+	88	85140496	30568
chr16	1606161	1806161	harbor2	chr16	1690335	1690523	LTR/ERV1	931	+	94	1690429	84268
chr16	66929017	67129017	harbor2	chr16	66974097	66975386	LTR/ERV1	9139	+	644	66974741	45724
chr16	66929017	67129017	harbor2	chr16	67011897	67012057	LTR/ERV1	1877	+	80	67011977	82960
chr16	66929017	67129017	harbor2	chr16	67012358	67012614	LTR/ERV1	1877	+	128	67012486	83469
chr16	700529	900529	harbor2	chr16	753382	753654	LTR/ERV1	1294	+	136	753518	52989
chr16	700529	900529	harbor2	chr16	753723	753859	LTR/ERV1	695	+	68	753791	53262
chr16	700529	900529	harbor2	chr16	754162	754367	LTR/ERV1	695	+	102	754264	53735
chr16	700529	900529	harbor2	chr16	754656	754667	LTR/ERV1	695	+	6	754662	54133
chr16	700529	900529	harbor2	chr16	777756	778061	LTR/ERV1	717	+	152	777908	77379
chr16	700514	900514	harbor2	chr16	753382	753654	LTR/ERV1	1294	+	136	753518	53004
chr16	700514	900514	harbor2	chr16	753723	753859	LTR/ERV1	695	+	68	753791	53277
chr16	700514	900514	harbor2	chr16	754162	754367	LTR/ERV1	695	+	102	754264	53750
chr16	700514	900514	harbor2	chr16	754656	754667	LTR/ERV1	695	+	6	754662	54148
chr16	700514	900514	harbor2	chr16	777756	778061	LTR/ERV1	717	+	152	777908	77394
chr16	700917	900917	harbor2	chr16	753382	753654	LTR/ERV1	1294	+	136	753518	52601
chr16	700917	900917	harbor2	chr16	753723	753859	LTR/ERV1	695	+	68	753791	52874
chr16	700917	900917	harbor2	chr16	754162	754367	LTR/ERV1	695	+	102	754264	53347
chr16	700917	900917	harbor2	chr16	754656	754667	LTR/ERV1	695	+	6	754662	53745
chr16	700917	900917	harbor2	chr16	777756	778061	LTR/ERV1	717	+	152	777908	76991
chr16	57885293	58085293	harbor2	chr16	57910045	57910363	LTR/ERV1	3218	+	159	57910204	24911
chr16	57885293	58085293	harbor2	chr16	57910674	57910969	LTR/ERV1	3218	+	148	57910822	25529
chr16	56836588	57036588	harbor2	chr16	56864423	56864885	LTR/ERV1	3639	+	231	56864654	28066
chr16	459863	659863	harbor2	chr16	483277	484114	LTR/ERV1	4267	+	418	483695	23832
chr16	57884864	58084864	harbor2	chr16	57910045	57910363	LTR/ERV1	3218	+	159	57910204	25340
chr16	57884864	58084864	harbor2	chr16	57910674	57910969	LTR/ERV1	3218	+	148	57910822	25958
chr16	701130	901130	harbor2	chr16	753382	753654	LTR/ERV1	1294	+	136	753518	52388
chr16	701130	901130	harbor2	chr16	753723	753859	LTR/ERV1	695	+	68	753791	52661
chr16	701130	901130	harbor2	chr16	754162	754367	LTR/ERV1	695	+	102	754264	53134
chr16	701130	901130	harbor2	chr16	754656	754667	LTR/ERV1	695	+	6	754662	53532
chr16	701130	901130	harbor2	chr16	777756	778061	LTR/ERV1	717	+	152	777908	76778
chr16	88757158	88957158	harbor2	chr16	88813681	88814167	LTR/ERV1	999	+	243	88813924	56766
chr16	57885269	58085269	harbor2	chr16	57910045	57910363	LTR/ERV1	3218	+	159	57910204	24935
chr16	57885269	58085269	harbor2	chr16	57910674	57910969	LTR/ERV1	3218	+	148	57910822	25553
chr16	47360971	47560971	harbor2	chr16	47370155	47370525	LTR/ERV1	1995	+	185	47370340	9369
chr16	47360971	47560971	harbor2	chr16	47370519	47370891	LTR/ERV1	890	+	186	47370705	9734
chr16	47360971	47560971	harbor2	chr16	47374075	47374253	LTR/ERV1	720	+	89	47374164	13193
chr16	47360971	47560971	harbor2	chr16	47388690	47389168	LTR/ERV1	3864	+	239	47388929	27958
chr16	2199256	2399256	harbor2	chr16	2258735	2258831	LTR/ERV1	626	+	48	2258783	59527
chr16	2199256	2399256	harbor2	chr16	2259141	2259607	LTR/ERV1	4147	+	233	2259374	60118
chr16	2199256	2399256	harbor2	chr16	2259901	2260147	LTR/ERV1	4147	+	123	2260024	60768
chr16	2199256	2399256	harbor2	chr16	2260399	2260848	LTR/ERV1	4147	+	224	2260623	61367
chr16	2199256	2399256	harbor2	chr16	2261145	2261551	LTR/ERV1	2406	+	203	2261348	62092
chr16	2199256	2399256	harbor2	chr16	2261552	2262137	LTR/ERV1	3537	+	292	2261844	62588
chr16	1	170311	harbor2	chr16	27849	28407	LTR/ERV1	1042	+	279	28128	28127
chr16	1	170311	harbor2	chr16	41012	41496	LTR/ERV1	3445	+	242	41254	41253
chr16	1	170311	harbor2	chr16	41497	42751	LTR/ERV1	5592	+	627	42124	42123
chr16	1	170311	harbor2	chr16	42729	43450	LTR/ERV1	4199	+	360	43089	43088
chr16	1	170311	harbor2	chr16	43897	44027	LTR/ERV1	2023	+	65	43962	43961
chr16	1	170311	harbor2	chr16	44342	44709	LTR/ERV1	2023	+	184	44526	44525
chr16	1	170311	harbor2	chr16	44715	46385	LTR/ERV1	7723	+	835	45550	45549
chr16	1	170311	harbor2	chr16	74663	75026	LTR/ERV1	2084	+	182	74845	74844
chr16	66222805	66422805	harbor2	chr16	66249436	66249863	LTR/ERV1	1310	+	214	66249650	26845
chr16	1	168367	harbor2	chr16	27849	28407	LTR/ERV1	1042	+	279	28128	28127
chr16	1	168367	harbor2	chr16	41012	41496	LTR/ERV1	3445	+	242	41254	41253
chr16	1	168367	harbor2	chr16	41497	42751	LTR/ERV1	5592	+	627	42124	42123
chr16	1	168367	harbor2	chr16	42729	43450	LTR/ERV1	4199	+	360	43089	43088
chr16	1	168367	harbor2	chr16	43897	44027	LTR/ERV1	2023	+	65	43962	43961
chr16	1	168367	harbor2	chr16	44342	44709	LTR/ERV1	2023	+	184	44526	44525
chr16	1	168367	harbor2	chr16	44715	46385	LTR/ERV1	7723	+	835	45550	45549
chr16	1	168367	harbor2	chr16	74663	75026	LTR/ERV1	2084	+	182	74845	74844
chr16	428373	628373	harbor2	chr16	483277	484114	LTR/ERV1	4267	+	418	483695	55322
chr16	67980152	68180152	harbor2	chr16	67982094	67983447	LTR/ERV1	9707	+	676	67982770	2618
chr16	67980152	68180152	harbor2	chr16	67998033	67999459	LTR/ERV1	10511	+	713	67998746	18594
chr16	67980152	68180152	harbor2	chr16	68030178	68030307	LTR/ERV1	632	+	64	68030242	50090
chr16	67980152	68180152	harbor2	chr16	68031050	68031171	LTR/ERV1	1526	+	60	68031110	50958
chr16	67980152	68180152	harbor2	chr16	68031463	68031662	LTR/ERV1	1526	+	100	68031563	51411
chr16	701121	901121	harbor2	chr16	753382	753654	LTR/ERV1	1294	+	136	753518	52397
chr16	701121	901121	harbor2	chr16	753723	753859	LTR/ERV1	695	+	68	753791	52670
chr16	701121	901121	harbor2	chr16	754162	754367	LTR/ERV1	695	+	102	754264	53143
chr16	701121	901121	harbor2	chr16	754656	754667	LTR/ERV1	695	+	6	754662	53541
chr16	701121	901121	harbor2	chr16	777756	778061	LTR/ERV1	717	+	152	777908	76787
chr16	2870244	3070244	harbor2	chr16	2879667	2880445	LTR/ERV1	3148	+	389	2880056	9812
chr16	2870244	3070244	harbor2	chr16	2907335	2907834	LTR/ERV1	3841	+	250	2907585	37341
chr16	67010349	67210349	harbor2	chr16	67011897	67012057	LTR/ERV1	1877	+	80	67011977	1628
chr16	67010349	67210349	harbor2	chr16	67012358	67012614	LTR/ERV1	1877	+	128	67012486	2137
chr16	456243	656243	harbor2	chr16	483277	484114	LTR/ERV1	4267	+	418	483695	27452
chr16	712066	912066	harbor2	chr16	753382	753654	LTR/ERV1	1294	+	136	753518	41452
chr16	712066	912066	harbor2	chr16	753723	753859	LTR/ERV1	695	+	68	753791	41725
chr16	712066	912066	harbor2	chr16	754162	754367	LTR/ERV1	695	+	102	754264	42198
chr16	712066	912066	harbor2	chr16	754656	754667	LTR/ERV1	695	+	6	754662	42596
chr16	712066	912066	harbor2	chr16	777756	778061	LTR/ERV1	717	+	152	777908	65842
chr16	56508531	56708531	harbor2	chr16	56526989	56527538	LTR/ERV1	2500	+	274	56527263	18732
chr16	56508531	56708531	harbor2	chr16	56540102	56540554	LTR/ERV1	2561	+	226	56540328	31797
chr16	56508531	56708531	harbor2	chr16	56541040	56541195	LTR/ERV1	974	+	78	56541118	32587
chr16	2865147	3065147	harbor2	chr16	2866339	2866728	LTR/ERV1	1403	+	194	2866533	1386
chr16	2865147	3065147	harbor2	chr16	2879667	2880445	LTR/ERV1	3148	+	389	2880056	14909
chr16	2865147	3065147	harbor2	chr16	2907335	2907834	LTR/ERV1	3841	+	250	2907585	42438
chr16	57891927	58091927	harbor2	chr16	57910045	57910363	LTR/ERV1	3218	+	159	57910204	18277
chr16	57891927	58091927	harbor2	chr16	57910674	57910969	LTR/ERV1	3218	+	148	57910822	18895
chr16	74311	274311	harbor2	chr16	74663	75026	LTR/ERV1	2084	+	182	74845	534
chr16	1648243	1848243	harbor2	chr16	1690335	1690523	LTR/ERV1	931	+	94	1690429	42186
chr16	56536591	56736591	harbor2	chr16	56540102	56540554	LTR/ERV1	2561	+	226	56540328	3737
chr16	56536591	56736591	harbor2	chr16	56541040	56541195	LTR/ERV1	974	+	78	56541118	4527
chr16	57884877	58084877	harbor2	chr16	57910045	57910363	LTR/ERV1	3218	+	159	57910204	25327
chr16	57884877	58084877	harbor2	chr16	57910674	57910969	LTR/ERV1	3218	+	148	57910822	25945
chr16	71270097	71470097	harbor2	chr16	71275877	71276275	LTR/ERV1	2687	+	199	71276076	5979
chr16	71270097	71470097	harbor2	chr16	71276755	71277225	LTR/ERV1	1695	+	235	71276990	6893
chr16	71270097	71470097	harbor2	chr16	71324433	71324754	LTR/ERV1	2167	+	160	71324593	54496
chr16	71270097	71470097	harbor2	chr16	71325236	71325373	LTR/ERV1	2167	+	68	71325304	55207
chr16	67010382	67210382	harbor2	chr16	67011897	67012057	LTR/ERV1	1877	+	80	67011977	1595
chr16	67010382	67210382	harbor2	chr16	67012358	67012614	LTR/ERV1	1877	+	128	67012486	2104
chr16	700505	900505	harbor2	chr16	753382	753654	LTR/ERV1	1294	+	136	753518	53013
chr16	700505	900505	harbor2	chr16	753723	753859	LTR/ERV1	695	+	68	753791	53286
chr16	700505	900505	harbor2	chr16	754162	754367	LTR/ERV1	695	+	102	754264	53759
chr16	700505	900505	harbor2	chr16	754656	754667	LTR/ERV1	695	+	6	754662	54157
chr16	700505	900505	harbor2	chr16	777756	778061	LTR/ERV1	717	+	152	777908	77403
chr16	1352047	1552047	harbor2	chr16	1392121	1392435	LTR/ERV1	981	+	157	1392278	40231
chr16	1352047	1552047	harbor2	chr16	1421274	1421531	LTR/ERV1	2750	+	128	1421402	69355
chr16	1352047	1552047	harbor2	chr16	1421826	1421884	LTR/ERV1	2750	+	29	1421855	69808
chr16	1352047	1552047	harbor2	chr16	1422188	1422556	LTR/ERV1	2750	+	184	1422372	70325
chr16	1352047	1552047	harbor2	chr16	1424179	1424351	LTR/ERV1	653	+	86	1424265	72218
chr16	56837249	57037249	harbor2	chr16	56864423	56864885	LTR/ERV1	3639	+	231	56864654	27405
chr16	56831966	57031966	harbor2	chr16	56864423	56864885	LTR/ERV1	3639	+	231	56864654	32688
chr16	1909537	2109537	harbor2	chr16	1943652	1943800	LTR/ERV1	4838	+	74	1943726	34189
chr16	1909537	2109537	harbor2	chr16	1944109	1944737	LTR/ERV1	4838	+	314	1944423	34886
chr16	270155	470155	harbor2	chr16	278988	279415	LTR/ERV1	2416	+	214	279202	9047
chr16	270155	470155	harbor2	chr16	303181	303384	LTR/ERV1	2289	+	102	303283	33128
chr16	270155	470155	harbor2	chr16	303682	303812	LTR/ERV1	2289	+	65	303747	33592
chr16	270155	470155	harbor2	chr16	341083	342390	LTR/ERV1	9339	+	654	341737	71582
chr16	1606151	1806151	harbor2	chr16	1690335	1690523	LTR/ERV1	931	+	94	1690429	84278
chr16	2198925	2398925	harbor2	chr16	2258735	2258831	LTR/ERV1	626	+	48	2258783	59858
chr16	2198925	2398925	harbor2	chr16	2259141	2259607	LTR/ERV1	4147	+	233	2259374	60449
chr16	2198925	2398925	harbor2	chr16	2259901	2260147	LTR/ERV1	4147	+	123	2260024	61099
chr16	2198925	2398925	harbor2	chr16	2260399	2260848	LTR/ERV1	4147	+	224	2260623	61698
chr16	2198925	2398925	harbor2	chr16	2261145	2261551	LTR/ERV1	2406	+	203	2261348	62423
chr16	2198925	2398925	harbor2	chr16	2261552	2262137	LTR/ERV1	3537	+	292	2261844	62919
chr16	67010350	67210350	harbor2	chr16	67011897	67012057	LTR/ERV1	1877	+	80	67011977	1627
chr16	67010350	67210350	harbor2	chr16	67012358	67012614	LTR/ERV1	1877	+	128	67012486	2136
chr16	2687897	2887897	harbor2	chr16	2724745	2725243	LTR/ERV1	1637	+	249	2724994	37097
chr16	2687897	2887897	harbor2	chr16	2731942	2732270	LTR/ERV1	604	+	164	2732106	44209
chr16	2687897	2887897	harbor2	chr16	2781830	2782035	LTR/ERV1	842	+	102	2781932	94035
chr16	2199557	2399557	harbor2	chr16	2258735	2258831	LTR/ERV1	626	+	48	2258783	59226
chr16	2199557	2399557	harbor2	chr16	2259141	2259607	LTR/ERV1	4147	+	233	2259374	59817
chr16	2199557	2399557	harbor2	chr16	2259901	2260147	LTR/ERV1	4147	+	123	2260024	60467
chr16	2199557	2399557	harbor2	chr16	2260399	2260848	LTR/ERV1	4147	+	224	2260623	61066
chr16	2199557	2399557	harbor2	chr16	2261145	2261551	LTR/ERV1	2406	+	203	2261348	61791
chr16	2199557	2399557	harbor2	chr16	2261552	2262137	LTR/ERV1	3537	+	292	2261844	62287
chr16	1	169379	harbor2	chr16	27849	28407	LTR/ERV1	1042	+	279	28128	28127
chr16	1	169379	harbor2	chr16	41012	41496	LTR/ERV1	3445	+	242	41254	41253
chr16	1	169379	harbor2	chr16	41497	42751	LTR/ERV1	5592	+	627	42124	42123
chr16	1	169379	harbor2	chr16	42729	43450	LTR/ERV1	4199	+	360	43089	43088
chr16	1	169379	harbor2	chr16	43897	44027	LTR/ERV1	2023	+	65	43962	43961
chr16	1	169379	harbor2	chr16	44342	44709	LTR/ERV1	2023	+	184	44526	44525
chr16	1	169379	harbor2	chr16	44715	46385	LTR/ERV1	7723	+	835	45550	45549
chr16	1	169379	harbor2	chr16	74663	75026	LTR/ERV1	2084	+	182	74845	74844
chr16	700519	900519	harbor2	chr16	753382	753654	LTR/ERV1	1294	+	136	753518	52999
chr16	700519	900519	harbor2	chr16	753723	753859	LTR/ERV1	695	+	68	753791	53272
chr16	700519	900519	harbor2	chr16	754162	754367	LTR/ERV1	695	+	102	754264	53745
chr16	700519	900519	harbor2	chr16	754656	754667	LTR/ERV1	695	+	6	754662	54143
chr16	700519	900519	harbor2	chr16	777756	778061	LTR/ERV1	717	+	152	777908	77389
chr16	2865121	3065121	harbor2	chr16	2866339	2866728	LTR/ERV1	1403	+	194	2866533	1412
chr16	2865121	3065121	harbor2	chr16	2879667	2880445	LTR/ERV1	3148	+	389	2880056	14935
chr16	2865121	3065121	harbor2	chr16	2907335	2907834	LTR/ERV1	3841	+	250	2907585	42464
chr16	187322	387322	harbor2	chr16	278988	279415	LTR/ERV1	2416	+	214	279202	91880
chr16	57892529	58092529	harbor2	chr16	57910045	57910363	LTR/ERV1	3218	+	159	57910204	17675
chr16	57892529	58092529	harbor2	chr16	57910674	57910969	LTR/ERV1	3218	+	148	57910822	18293
chr16	47360977	47560977	harbor2	chr16	47370155	47370525	LTR/ERV1	1995	+	185	47370340	9363
chr16	47360977	47560977	harbor2	chr16	47370519	47370891	LTR/ERV1	890	+	186	47370705	9728
chr16	47360977	47560977	harbor2	chr16	47374075	47374253	LTR/ERV1	720	+	89	47374164	13187
chr16	47360977	47560977	harbor2	chr16	47388690	47389168	LTR/ERV1	3864	+	239	47388929	27952
chr16	89119693	89319693	harbor2	chr16	89209613	89209819	LTR/ERV1	773	+	103	89209716	90023
chr16	89119693	89319693	harbor2	chr16	89209966	89210126	LTR/ERV1	750	+	80	89210046	90353
chr16	89119693	89319693	harbor2	chr16	89210245	89210366	LTR/ERV1	994	+	60	89210305	90612
chr16	89119693	89319693	harbor2	chr16	89210662	89210872	LTR/ERV1	994	+	105	89210767	91074
chr16	69105091	69305091	harbor2	chr16	69172706	69173080	LTR/ERV1	3935	+	187	69172893	67802
chr16	69105091	69305091	harbor2	chr16	69173385	69173540	LTR/ERV1	3935	+	78	69173463	68372
chr16	2873823	3073823	harbor2	chr16	2879667	2880445	LTR/ERV1	3148	+	389	2880056	6233
chr16	2873823	3073823	harbor2	chr16	2907335	2907834	LTR/ERV1	3841	+	250	2907585	33762
chr16	702916	902916	harbor2	chr16	753382	753654	LTR/ERV1	1294	+	136	753518	50602
chr16	702916	902916	harbor2	chr16	753723	753859	LTR/ERV1	695	+	68	753791	50875
chr16	702916	902916	harbor2	chr16	754162	754367	LTR/ERV1	695	+	102	754264	51348
chr16	702916	902916	harbor2	chr16	754656	754667	LTR/ERV1	695	+	6	754662	51746
chr16	702916	902916	harbor2	chr16	777756	778061	LTR/ERV1	717	+	152	777908	74992
chr16	2868940	3068940	harbor2	chr16	2879667	2880445	LTR/ERV1	3148	+	389	2880056	11116
chr16	2868940	3068940	harbor2	chr16	2907335	2907834	LTR/ERV1	3841	+	250	2907585	38645
chr16	75364243	75564243	harbor2	chr16	75376669	75377149	LTR/ERV1	2564	+	240	75376909	12666
chr16	75364243	75564243	harbor2	chr16	75390257	75390651	LTR/ERV1	1760	+	197	75390454	26211
chr16	75364243	75564243	harbor2	chr16	75419528	75420030	LTR/ERV1	3430	+	251	75419779	55536
chr16	75364243	75564243	harbor2	chr16	75421037	75421376	LTR/ERV1	2186	+	170	75421207	56964
chr16	67399527	67599527	harbor2	chr16	67481516	67482239	LTR/ERV1	1938	+	362	67481878	82351
chr16	67399527	67599527	harbor2	chr16	67490579	67491019	LTR/ERV1	2665	+	220	67490799	91272
chr17	7477694	7677694	harbor2	chr17	7532328	7532759	LTR/ERV1	5191	+	216	7532544	54850
chr17	7477694	7677694	harbor2	chr17	7533046	7533291	LTR/ERV1	5191	+	122	7533168	55474
chr17	7477694	7677694	harbor2	chr17	7533493	7533541	LTR/ERV1	3182	+	24	7533517	55823
chr17	7477694	7677694	harbor2	chr17	7533854	7534348	LTR/ERV1	3182	+	247	7534101	56407
chr17	7477694	7677694	harbor2	chr17	7537191	7537664	LTR/ERV1	912	+	236	7537427	59733
chr17	7477694	7677694	harbor2	chr17	7538473	7539076	LTR/ERV1	2673	+	302	7538775	61081
chr17	7493808	7693808	harbor2	chr17	7532328	7532759	LTR/ERV1	5191	+	216	7532544	38736
chr17	7493808	7693808	harbor2	chr17	7533046	7533291	LTR/ERV1	5191	+	122	7533168	39360
chr17	7493808	7693808	harbor2	chr17	7533493	7533541	LTR/ERV1	3182	+	24	7533517	39709
chr17	7493808	7693808	harbor2	chr17	7533854	7534348	LTR/ERV1	3182	+	247	7534101	40293
chr17	7493808	7693808	harbor2	chr17	7537191	7537664	LTR/ERV1	912	+	236	7537427	43619
chr17	7493808	7693808	harbor2	chr17	7538473	7539076	LTR/ERV1	2673	+	302	7538775	44967
chr17	75009933	75209933	harbor2	chr17	75025088	75025740	LTR/ERV1	4668	+	326	75025414	15481
chr17	75009933	75209933	harbor2	chr17	75085619	75086087	LTR/ERV1	1948	+	234	75085853	75920
chr17	7491992	7691992	harbor2	chr17	7532328	7532759	LTR/ERV1	5191	+	216	7532544	40552
chr17	7491992	7691992	harbor2	chr17	7533046	7533291	LTR/ERV1	5191	+	122	7533168	41176
chr17	7491992	7691992	harbor2	chr17	7533493	7533541	LTR/ERV1	3182	+	24	7533517	41525
chr17	7491992	7691992	harbor2	chr17	7533854	7534348	LTR/ERV1	3182	+	247	7534101	42109
chr17	7491992	7691992	harbor2	chr17	7537191	7537664	LTR/ERV1	912	+	236	7537427	45435
chr17	7491992	7691992	harbor2	chr17	7538473	7539076	LTR/ERV1	2673	+	302	7538775	46783
chr17	7477462	7677462	harbor2	chr17	7532328	7532759	LTR/ERV1	5191	+	216	7532544	55082
chr17	7477462	7677462	harbor2	chr17	7533046	7533291	LTR/ERV1	5191	+	122	7533168	55706
chr17	7477462	7677462	harbor2	chr17	7533493	7533541	LTR/ERV1	3182	+	24	7533517	56055
chr17	7477462	7677462	harbor2	chr17	7533854	7534348	LTR/ERV1	3182	+	247	7534101	56639
chr17	7477462	7677462	harbor2	chr17	7537191	7537664	LTR/ERV1	912	+	236	7537427	59965
chr17	7477462	7677462	harbor2	chr17	7538473	7539076	LTR/ERV1	2673	+	302	7538775	61313
chr17	75010357	75210357	harbor2	chr17	75025088	75025740	LTR/ERV1	4668	+	326	75025414	15057
chr17	75010357	75210357	harbor2	chr17	75085619	75086087	LTR/ERV1	1948	+	234	75085853	75496
chr17	7489435	7689435	harbor2	chr17	7532328	7532759	LTR/ERV1	5191	+	216	7532544	43109
chr17	7489435	7689435	harbor2	chr17	7533046	7533291	LTR/ERV1	5191	+	122	7533168	43733
chr17	7489435	7689435	harbor2	chr17	7533493	7533541	LTR/ERV1	3182	+	24	7533517	44082
chr17	7489435	7689435	harbor2	chr17	7533854	7534348	LTR/ERV1	3182	+	247	7534101	44666
chr17	7489435	7689435	harbor2	chr17	7537191	7537664	LTR/ERV1	912	+	236	7537427	47992
chr17	7489435	7689435	harbor2	chr17	7538473	7539076	LTR/ERV1	2673	+	302	7538775	49340
chr17	7475157	7675157	harbor2	chr17	7532328	7532759	LTR/ERV1	5191	+	216	7532544	57387
chr17	7475157	7675157	harbor2	chr17	7533046	7533291	LTR/ERV1	5191	+	122	7533168	58011
chr17	7475157	7675157	harbor2	chr17	7533493	7533541	LTR/ERV1	3182	+	24	7533517	58360
chr17	7475157	7675157	harbor2	chr17	7533854	7534348	LTR/ERV1	3182	+	247	7534101	58944
chr17	7475157	7675157	harbor2	chr17	7537191	7537664	LTR/ERV1	912	+	236	7537427	62270
chr17	7475157	7675157	harbor2	chr17	7538473	7539076	LTR/ERV1	2673	+	302	7538775	63618
chr17	63524434	63724434	harbor2	chr17	63597335	63597979	LTR/ERV1	2520	+	322	63597657	73223
chr17	79533790	79733790	harbor2	chr17	79574194	79574740	LTR/ERV1	3404	+	273	79574467	40677
chr17	68099330	68299330	harbor2	chr17	68099100	68100615	LTR/ERV1	9162	+	758	68099858	528
chr17	68099330	68299330	harbor2	chr17	68179674	68181122	LTR/ERV1	9439	+	724	68180398	81068
chr17	79696192	79896192	harbor2	chr17	79696529	79697275	LTR/ERV1	4411	+	373	79696902	710
chr17	7462624	7662624	harbor2	chr17	7532328	7532759	LTR/ERV1	5191	+	216	7532544	69920
chr17	7462624	7662624	harbor2	chr17	7533046	7533291	LTR/ERV1	5191	+	122	7533168	70544
chr17	7462624	7662624	harbor2	chr17	7533493	7533541	LTR/ERV1	3182	+	24	7533517	70893
chr17	7462624	7662624	harbor2	chr17	7533854	7534348	LTR/ERV1	3182	+	247	7534101	71477
chr17	7462624	7662624	harbor2	chr17	7537191	7537664	LTR/ERV1	912	+	236	7537427	74803
chr17	7462624	7662624	harbor2	chr17	7538473	7539076	LTR/ERV1	2673	+	302	7538775	76151
chr17	33328761	33528761	harbor2	chr17	33373261	33373678	LTR/ERV1	4151	+	208	33373469	44708
chr17	33328761	33528761	harbor2	chr17	33374297	33374665	LTR/ERV1	4151	+	184	33374481	45720
chr17	7514483	7714483	harbor2	chr17	7532328	7532759	LTR/ERV1	5191	+	216	7532544	18061
chr17	7514483	7714483	harbor2	chr17	7533046	7533291	LTR/ERV1	5191	+	122	7533168	18685
chr17	7514483	7714483	harbor2	chr17	7533493	7533541	LTR/ERV1	3182	+	24	7533517	19034
chr17	7514483	7714483	harbor2	chr17	7533854	7534348	LTR/ERV1	3182	+	247	7534101	19618
chr17	7514483	7714483	harbor2	chr17	7537191	7537664	LTR/ERV1	912	+	236	7537427	22944
chr17	7514483	7714483	harbor2	chr17	7538473	7539076	LTR/ERV1	2673	+	302	7538775	24292
chr17	78924121	79124121	harbor2	chr17	78984493	78984741	LTR/ERV1	1606	+	124	78984617	60496
chr17	78924121	79124121	harbor2	chr17	78985056	78985090	LTR/ERV1	1606	+	17	78985073	60952
chr17	78924121	79124121	harbor2	chr17	78987776	78987939	LTR/ERV1	3259	+	82	78987858	63737
chr17	78924121	79124121	harbor2	chr17	78988242	78988488	LTR/ERV1	3259	+	123	78988365	64244
chr17	78924121	79124121	harbor2	chr17	78988794	78988909	LTR/ERV1	3259	+	58	78988852	64731
chr17	78924121	79124121	harbor2	chr17	79010892	79011346	LTR/ERV1	3091	+	227	79011119	86998
chr17	78924121	79124121	harbor2	chr17	79011645	79012265	LTR/ERV1	4410	+	310	79011955	87834
chr17	78924121	79124121	harbor2	chr17	79012266	79015576	LTR/ERV1	18340	+	1655	79013921	89800
chr17	78924121	79124121	harbor2	chr17	79015885	79016877	LTR/ERV1	18340	+	496	79016381	92260
chr17	78924121	79124121	harbor2	chr17	79017284	79017619	LTR/ERV1	18340	+	168	79017452	93331
chr17	78924121	79124121	harbor2	chr17	79017620	79018141	LTR/ERV1	3106	+	260	79017880	93759
chr17	78924121	79124121	harbor2	chr17	79018517	79018636	LTR/ERV1	739	+	60	79018577	94456
chr17	7473235	7673235	harbor2	chr17	7532328	7532759	LTR/ERV1	5191	+	216	7532544	59309
chr17	7473235	7673235	harbor2	chr17	7533046	7533291	LTR/ERV1	5191	+	122	7533168	59933
chr17	7473235	7673235	harbor2	chr17	7533493	7533541	LTR/ERV1	3182	+	24	7533517	60282
chr17	7473235	7673235	harbor2	chr17	7533854	7534348	LTR/ERV1	3182	+	247	7534101	60866
chr17	7473235	7673235	harbor2	chr17	7537191	7537664	LTR/ERV1	912	+	236	7537427	64192
chr17	7473235	7673235	harbor2	chr17	7538473	7539076	LTR/ERV1	2673	+	302	7538775	65540
chr17	7489456	7689456	harbor2	chr17	7532328	7532759	LTR/ERV1	5191	+	216	7532544	43088
chr17	7489456	7689456	harbor2	chr17	7533046	7533291	LTR/ERV1	5191	+	122	7533168	43712
chr17	7489456	7689456	harbor2	chr17	7533493	7533541	LTR/ERV1	3182	+	24	7533517	44061
chr17	7489456	7689456	harbor2	chr17	7533854	7534348	LTR/ERV1	3182	+	247	7534101	44645
chr17	7489456	7689456	harbor2	chr17	7537191	7537664	LTR/ERV1	912	+	236	7537427	47971
chr17	7489456	7689456	harbor2	chr17	7538473	7539076	LTR/ERV1	2673	+	302	7538775	49319
chr17	76637927	76837927	harbor2	chr17	76640866	76641353	LTR/ERV1	3302	+	244	76641110	3183
chr17	7463026	7663026	harbor2	chr17	7532328	7532759	LTR/ERV1	5191	+	216	7532544	69518
chr17	7463026	7663026	harbor2	chr17	7533046	7533291	LTR/ERV1	5191	+	122	7533168	70142
chr17	7463026	7663026	harbor2	chr17	7533493	7533541	LTR/ERV1	3182	+	24	7533517	70491
chr17	7463026	7663026	harbor2	chr17	7533854	7534348	LTR/ERV1	3182	+	247	7534101	71075
chr17	7463026	7663026	harbor2	chr17	7537191	7537664	LTR/ERV1	912	+	236	7537427	74401
chr17	7463026	7663026	harbor2	chr17	7538473	7539076	LTR/ERV1	2673	+	302	7538775	75749
chr17	76986524	77186524	harbor2	chr17	76995670	76996131	LTR/ERV1	2463	+	230	76995900	9376
chr17	76986524	77186524	harbor2	chr17	76996419	76996559	LTR/ERV1	2463	+	70	76996489	9965
chr17	76986524	77186524	harbor2	chr17	76997213	76997607	LTR/ERV1	1755	+	197	76997410	10886
chr17	76986524	77186524	harbor2	chr17	76997603	76997706	LTR/ERV1	671	+	52	76997655	11131
chr17	76986524	77186524	harbor2	chr17	76998001	76998088	LTR/ERV1	671	+	44	76998045	11521
chr17	76986524	77186524	harbor2	chr17	77003854	77004200	LTR/ERV1	2805	+	173	77004027	17503
chr17	76986524	77186524	harbor2	chr17	77004526	77004609	LTR/ERV1	2805	+	42	77004568	18044
chr17	76986524	77186524	harbor2	chr17	77004908	77005045	LTR/ERV1	2805	+	68	77004976	18452
chr17	76986524	77186524	harbor2	chr17	77045329	77045872	LTR/ERV1	3506	+	272	77045601	59077
chr17	76986524	77186524	harbor2	chr17	77067017	77067356	LTR/ERV1	2480	+	170	77067187	80663
chr17	7514239	7714239	harbor2	chr17	7532328	7532759	LTR/ERV1	5191	+	216	7532544	18305
chr17	7514239	7714239	harbor2	chr17	7533046	7533291	LTR/ERV1	5191	+	122	7533168	18929
chr17	7514239	7714239	harbor2	chr17	7533493	7533541	LTR/ERV1	3182	+	24	7533517	19278
chr17	7514239	7714239	harbor2	chr17	7533854	7534348	LTR/ERV1	3182	+	247	7534101	19862
chr17	7514239	7714239	harbor2	chr17	7537191	7537664	LTR/ERV1	912	+	236	7537427	23188
chr17	7514239	7714239	harbor2	chr17	7538473	7539076	LTR/ERV1	2673	+	302	7538775	24536
chr17	77746448	77946448	harbor2	chr17	77747831	77748443	LTR/ERV1	3600	+	306	77748137	1689
chr17	77746448	77946448	harbor2	chr17	77754361	77754589	LTR/ERV1	927	+	114	77754475	8027
chr17	77746448	77946448	harbor2	chr17	77835133	77835495	LTR/ERV1	1103	+	181	77835314	88866
chr17	76638000	76838000	harbor2	chr17	76640866	76641353	LTR/ERV1	3302	+	244	76641110	3110
chr17	80705801	80905801	harbor2	chr17	80804411	80804602	LTR/ERV1	863	+	96	80804507	98706
chr17	77101168	77301168	harbor2	chr17	77163186	77163471	LTR/ERV1	968	+	142	77163328	62160
chr17	77101168	77301168	harbor2	chr17	77163740	77163896	LTR/ERV1	741	+	78	77163818	62650
chr17	7488100	7688100	harbor2	chr17	7532328	7532759	LTR/ERV1	5191	+	216	7532544	44444
chr17	7488100	7688100	harbor2	chr17	7533046	7533291	LTR/ERV1	5191	+	122	7533168	45068
chr17	7488100	7688100	harbor2	chr17	7533493	7533541	LTR/ERV1	3182	+	24	7533517	45417
chr17	7488100	7688100	harbor2	chr17	7533854	7534348	LTR/ERV1	3182	+	247	7534101	46001
chr17	7488100	7688100	harbor2	chr17	7537191	7537664	LTR/ERV1	912	+	236	7537427	49327
chr17	7488100	7688100	harbor2	chr17	7538473	7539076	LTR/ERV1	2673	+	302	7538775	50675
chr17	7477191	7677191	harbor2	chr17	7532328	7532759	LTR/ERV1	5191	+	216	7532544	55353
chr17	7477191	7677191	harbor2	chr17	7533046	7533291	LTR/ERV1	5191	+	122	7533168	55977
chr17	7477191	7677191	harbor2	chr17	7533493	7533541	LTR/ERV1	3182	+	24	7533517	56326
chr17	7477191	7677191	harbor2	chr17	7533854	7534348	LTR/ERV1	3182	+	247	7534101	56910
chr17	7477191	7677191	harbor2	chr17	7537191	7537664	LTR/ERV1	912	+	236	7537427	60236
chr17	7477191	7677191	harbor2	chr17	7538473	7539076	LTR/ERV1	2673	+	302	7538775	61584
chr17	80315303	80515303	harbor2	chr17	80397328	80397781	LTR/ERV1	3748	+	226	80397554	82251
chr17	80315303	80515303	harbor2	chr17	80397782	80399793	LTR/ERV1	7508	+	1006	80398788	83485
chr17	80315303	80515303	harbor2	chr17	80399794	80400230	LTR/ERV1	3625	+	218	80400012	84709
chr17	80315303	80515303	harbor2	chr17	80400241	80403146	LTR/ERV1	8045	+	1452	80401693	86390
chr17	80315303	80515303	harbor2	chr17	80403181	80403381	LTR/ERV1	8045	+	100	80403281	87978
chr17	80315303	80515303	harbor2	chr17	80403368	80403814	LTR/ERV1	2708	+	223	80403591	88288
chr17	80315303	80515303	harbor2	chr17	80403803	80407762	LTR/ERV1	23016	+	1980	80405783	90480
chr17	80315303	80515303	harbor2	chr17	80407763	80408186	LTR/ERV1	3293	+	212	80407975	92672
chr17	80315303	80515303	harbor2	chr17	80408187	80408936	LTR/ERV1	5046	+	374	80408561	93258
chr17	80315303	80515303	harbor2	chr17	80408952	80412448	LTR/ERV1	28946	+	1748	80410700	95397
chr17	80315303	80515303	harbor2	chr17	80413069	80413516	LTR/ERV1	3587	+	224	80413293	97990
chr17	80315303	80515303	harbor2	chr17	80413692	80414080	LTR/ERV1	1879	+	194	80413886	98583
chr17	80315303	80515303	harbor2	chr17	80412538	80413064	LTR/ERV1	28946	+	263	80412801	97498
chr17	7489503	7689503	harbor2	chr17	7532328	7532759	LTR/ERV1	5191	+	216	7532544	43041
chr17	7489503	7689503	harbor2	chr17	7533046	7533291	LTR/ERV1	5191	+	122	7533168	43665
chr17	7489503	7689503	harbor2	chr17	7533493	7533541	LTR/ERV1	3182	+	24	7533517	44014
chr17	7489503	7689503	harbor2	chr17	7533854	7534348	LTR/ERV1	3182	+	247	7534101	44598
chr17	7489503	7689503	harbor2	chr17	7537191	7537664	LTR/ERV1	912	+	236	7537427	47924
chr17	7489503	7689503	harbor2	chr17	7538473	7539076	LTR/ERV1	2673	+	302	7538775	49272
chr17	7526756	7726756	harbor2	chr17	7532328	7532759	LTR/ERV1	5191	+	216	7532544	5788
chr17	7526756	7726756	harbor2	chr17	7533046	7533291	LTR/ERV1	5191	+	122	7533168	6412
chr17	7526756	7726756	harbor2	chr17	7533493	7533541	LTR/ERV1	3182	+	24	7533517	6761
chr17	7526756	7726756	harbor2	chr17	7533854	7534348	LTR/ERV1	3182	+	247	7534101	7345
chr17	7526756	7726756	harbor2	chr17	7537191	7537664	LTR/ERV1	912	+	236	7537427	10671
chr17	7526756	7726756	harbor2	chr17	7538473	7539076	LTR/ERV1	2673	+	302	7538775	12019
chr17	7461749	7661749	harbor2	chr17	7532328	7532759	LTR/ERV1	5191	+	216	7532544	70795
chr17	7461749	7661749	harbor2	chr17	7533046	7533291	LTR/ERV1	5191	+	122	7533168	71419
chr17	7461749	7661749	harbor2	chr17	7533493	7533541	LTR/ERV1	3182	+	24	7533517	71768
chr17	7461749	7661749	harbor2	chr17	7533854	7534348	LTR/ERV1	3182	+	247	7534101	72352
chr17	7461749	7661749	harbor2	chr17	7537191	7537664	LTR/ERV1	912	+	236	7537427	75678
chr17	7461749	7661749	harbor2	chr17	7538473	7539076	LTR/ERV1	2673	+	302	7538775	77026
chr17	15162691	15362691	harbor2	chr17	15178111	15178655	LTR/ERV1	736	+	272	15178383	15692
chr17	15162691	15362691	harbor2	chr17	15181677	15182133	LTR/ERV1	2506	+	228	15181905	19214
chr17	15162691	15362691	harbor2	chr17	15183107	15183393	LTR/ERV1	2752	+	143	15183250	20559
chr17	15162691	15362691	harbor2	chr17	15183686	15183886	LTR/ERV1	2752	+	100	15183786	21095
chr17	15162691	15362691	harbor2	chr17	15184939	15185468	LTR/ERV1	3392	+	264	15185203	22512
chr17	15162691	15362691	harbor2	chr17	15196578	15197023	LTR/ERV1	2230	+	222	15196800	34109
chr17	15162691	15362691	harbor2	chr17	15216942	15217276	LTR/ERV1	1828	+	167	15217109	54418
chr17	7461773	7661773	harbor2	chr17	7532328	7532759	LTR/ERV1	5191	+	216	7532544	70771
chr17	7461773	7661773	harbor2	chr17	7533046	7533291	LTR/ERV1	5191	+	122	7533168	71395
chr17	7461773	7661773	harbor2	chr17	7533493	7533541	LTR/ERV1	3182	+	24	7533517	71744
chr17	7461773	7661773	harbor2	chr17	7533854	7534348	LTR/ERV1	3182	+	247	7534101	72328
chr17	7461773	7661773	harbor2	chr17	7537191	7537664	LTR/ERV1	912	+	236	7537427	75654
chr17	7461773	7661773	harbor2	chr17	7538473	7539076	LTR/ERV1	2673	+	302	7538775	77002
chr17	79354447	79554447	harbor2	chr17	79446431	79446984	LTR/ERV1	2307	+	276	79446707	92260
chr17	33193427	33393427	harbor2	chr17	33201368	33201747	LTR/ERV1	2739	+	190	33201558	8131
chr17	33193427	33393427	harbor2	chr17	33202048	33202173	LTR/ERV1	2739	+	62	33202110	8683
chr17	76989375	77189375	harbor2	chr17	76995670	76996131	LTR/ERV1	2463	+	230	76995900	6525
chr17	76989375	77189375	harbor2	chr17	76996419	76996559	LTR/ERV1	2463	+	70	76996489	7114
chr17	76989375	77189375	harbor2	chr17	76997213	76997607	LTR/ERV1	1755	+	197	76997410	8035
chr17	76989375	77189375	harbor2	chr17	76997603	76997706	LTR/ERV1	671	+	52	76997655	8280
chr17	76989375	77189375	harbor2	chr17	76998001	76998088	LTR/ERV1	671	+	44	76998045	8670
chr17	76989375	77189375	harbor2	chr17	77003854	77004200	LTR/ERV1	2805	+	173	77004027	14652
chr17	76989375	77189375	harbor2	chr17	77004526	77004609	LTR/ERV1	2805	+	42	77004568	15193
chr17	76989375	77189375	harbor2	chr17	77004908	77005045	LTR/ERV1	2805	+	68	77004976	15601
chr17	76989375	77189375	harbor2	chr17	77045329	77045872	LTR/ERV1	3506	+	272	77045601	56226
chr17	76989375	77189375	harbor2	chr17	77067017	77067356	LTR/ERV1	2480	+	170	77067187	77812
chr17	76637998	76837998	harbor2	chr17	76640866	76641353	LTR/ERV1	3302	+	244	76641110	3112
chr17	76988993	77188993	harbor2	chr17	76995670	76996131	LTR/ERV1	2463	+	230	76995900	6907
chr17	76988993	77188993	harbor2	chr17	76996419	76996559	LTR/ERV1	2463	+	70	76996489	7496
chr17	76988993	77188993	harbor2	chr17	76997213	76997607	LTR/ERV1	1755	+	197	76997410	8417
chr17	76988993	77188993	harbor2	chr17	76997603	76997706	LTR/ERV1	671	+	52	76997655	8662
chr17	76988993	77188993	harbor2	chr17	76998001	76998088	LTR/ERV1	671	+	44	76998045	9052
chr17	76988993	77188993	harbor2	chr17	77003854	77004200	LTR/ERV1	2805	+	173	77004027	15034
chr17	76988993	77188993	harbor2	chr17	77004526	77004609	LTR/ERV1	2805	+	42	77004568	15575
chr17	76988993	77188993	harbor2	chr17	77004908	77005045	LTR/ERV1	2805	+	68	77004976	15983
chr17	76988993	77188993	harbor2	chr17	77045329	77045872	LTR/ERV1	3506	+	272	77045601	56608
chr17	76988993	77188993	harbor2	chr17	77067017	77067356	LTR/ERV1	2480	+	170	77067187	78194
chr17	7463028	7663028	harbor2	chr17	7532328	7532759	LTR/ERV1	5191	+	216	7532544	69516
chr17	7463028	7663028	harbor2	chr17	7533046	7533291	LTR/ERV1	5191	+	122	7533168	70140
chr17	7463028	7663028	harbor2	chr17	7533493	7533541	LTR/ERV1	3182	+	24	7533517	70489
chr17	7463028	7663028	harbor2	chr17	7533854	7534348	LTR/ERV1	3182	+	247	7534101	71073
chr17	7463028	7663028	harbor2	chr17	7537191	7537664	LTR/ERV1	912	+	236	7537427	74399
chr17	7463028	7663028	harbor2	chr17	7538473	7539076	LTR/ERV1	2673	+	302	7538775	75747
chr17	76637250	76837250	harbor2	chr17	76640866	76641353	LTR/ERV1	3302	+	244	76641110	3860
chr17	75009931	75209931	harbor2	chr17	75025088	75025740	LTR/ERV1	4668	+	326	75025414	15483
chr17	75009931	75209931	harbor2	chr17	75085619	75086087	LTR/ERV1	1948	+	234	75085853	75922
chr17	77156768	77356768	harbor2	chr17	77163186	77163471	LTR/ERV1	968	+	142	77163328	6560
chr17	77156768	77356768	harbor2	chr17	77163740	77163896	LTR/ERV1	741	+	78	77163818	7050
chr17	33193168	33393168	harbor2	chr17	33201368	33201747	LTR/ERV1	2739	+	190	33201558	8390
chr17	33193168	33393168	harbor2	chr17	33202048	33202173	LTR/ERV1	2739	+	62	33202110	8942
chr17	76300002	76500002	harbor2	chr17	76357115	76357552	LTR/ERV1	2700	+	218	76357333	57331
chr17	76300002	76500002	harbor2	chr17	76363203	76363462	LTR/ERV1	2360	+	130	76363333	63331
chr17	76300002	76500002	harbor2	chr17	76364055	76364172	LTR/ERV1	2360	+	58	76364113	64111
chr17	76300002	76500002	harbor2	chr17	76364474	76364899	LTR/ERV1	2473	+	212	76364686	64684
chr17	78924099	79124099	harbor2	chr17	78984493	78984741	LTR/ERV1	1606	+	124	78984617	60518
chr17	78924099	79124099	harbor2	chr17	78985056	78985090	LTR/ERV1	1606	+	17	78985073	60974
chr17	78924099	79124099	harbor2	chr17	78987776	78987939	LTR/ERV1	3259	+	82	78987858	63759
chr17	78924099	79124099	harbor2	chr17	78988242	78988488	LTR/ERV1	3259	+	123	78988365	64266
chr17	78924099	79124099	harbor2	chr17	78988794	78988909	LTR/ERV1	3259	+	58	78988852	64753
chr17	78924099	79124099	harbor2	chr17	79010892	79011346	LTR/ERV1	3091	+	227	79011119	87020
chr17	78924099	79124099	harbor2	chr17	79011645	79012265	LTR/ERV1	4410	+	310	79011955	87856
chr17	78924099	79124099	harbor2	chr17	79012266	79015576	LTR/ERV1	18340	+	1655	79013921	89822
chr17	78924099	79124099	harbor2	chr17	79015885	79016877	LTR/ERV1	18340	+	496	79016381	92282
chr17	78924099	79124099	harbor2	chr17	79017284	79017619	LTR/ERV1	18340	+	168	79017452	93353
chr17	78924099	79124099	harbor2	chr17	79017620	79018141	LTR/ERV1	3106	+	260	79017880	93781
chr17	78924099	79124099	harbor2	chr17	79018517	79018636	LTR/ERV1	739	+	60	79018577	94478
chr17	7474761	7674761	harbor2	chr17	7532328	7532759	LTR/ERV1	5191	+	216	7532544	57783
chr17	7474761	7674761	harbor2	chr17	7533046	7533291	LTR/ERV1	5191	+	122	7533168	58407
chr17	7474761	7674761	harbor2	chr17	7533493	7533541	LTR/ERV1	3182	+	24	7533517	58756
chr17	7474761	7674761	harbor2	chr17	7533854	7534348	LTR/ERV1	3182	+	247	7534101	59340
chr17	7474761	7674761	harbor2	chr17	7537191	7537664	LTR/ERV1	912	+	236	7537427	62666
chr17	7474761	7674761	harbor2	chr17	7538473	7539076	LTR/ERV1	2673	+	302	7538775	64014
chr17	81583801	81783801	harbor2	chr17	81656964	81657596	LTR/ERV1	2136	+	316	81657280	73479
chr17	81583801	81783801	harbor2	chr17	81661340	81661435	LTR/ERV1	615	+	48	81661388	77587
chr17	81583801	81783801	harbor2	chr17	81662044	81662250	LTR/ERV1	1212	+	103	81662147	78346
chr17	81583801	81783801	harbor2	chr17	81662630	81662674	LTR/ERV1	1212	+	22	81662652	78851
chr17	81583801	81783801	harbor2	chr17	81662676	81662716	LTR/ERV1	1695	+	20	81662696	78895
chr17	81583801	81783801	harbor2	chr17	81662943	81663400	LTR/ERV1	1695	+	228	81663171	79370
chr17	81583801	81783801	harbor2	chr17	81677781	81678213	LTR/ERV1	2058	+	216	81677997	94196
chr17	81583801	81783801	harbor2	chr17	81678508	81678563	LTR/ERV1	2058	+	28	81678536	94735
chr17	81583801	81783801	harbor2	chr17	81678860	81678894	LTR/ERV1	2058	+	17	81678877	95076
chr17	81583801	81783801	harbor2	chr17	81679184	81679286	LTR/ERV1	2058	+	51	81679235	95434
chr17	68036281	68236281	harbor2	chr17	68051693	68053079	LTR/ERV1	9033	+	693	68052386	16105
chr17	68036281	68236281	harbor2	chr17	68080473	68082166	LTR/ERV1	10293	+	846	68081319	45038
chr17	68036281	68236281	harbor2	chr17	68099100	68100615	LTR/ERV1	9162	+	758	68099858	63577
chr17	75009932	75209932	harbor2	chr17	75025088	75025740	LTR/ERV1	4668	+	326	75025414	15482
chr17	75009932	75209932	harbor2	chr17	75085619	75086087	LTR/ERV1	1948	+	234	75085853	75921
chr17	39657906	39857906	harbor2	chr17	39681399	39681512	LTR/ERV1	1529	+	56	39681455	23549
chr17	39657906	39857906	harbor2	chr17	39681802	39681938	LTR/ERV1	1529	+	68	39681870	23964
chr17	39657906	39857906	harbor2	chr17	39682256	39682455	LTR/ERV1	1529	+	100	39682356	24450
chr17	79690066	79890066	harbor2	chr17	79696529	79697275	LTR/ERV1	4411	+	373	79696902	6836
chr17	76146968	76346968	harbor2	chr17	76177146	76178643	LTR/ERV1	6180	+	748	76177894	30926
chr17	76146968	76346968	harbor2	chr17	76195772	76196222	LTR/ERV1	2248	+	225	76195997	49029
chr17	76637984	76837984	harbor2	chr17	76640866	76641353	LTR/ERV1	3302	+	244	76641110	3126
chr17	7488084	7688084	harbor2	chr17	7532328	7532759	LTR/ERV1	5191	+	216	7532544	44460
chr17	7488084	7688084	harbor2	chr17	7533046	7533291	LTR/ERV1	5191	+	122	7533168	45084
chr17	7488084	7688084	harbor2	chr17	7533493	7533541	LTR/ERV1	3182	+	24	7533517	45433
chr17	7488084	7688084	harbor2	chr17	7533854	7534348	LTR/ERV1	3182	+	247	7534101	46017
chr17	7488084	7688084	harbor2	chr17	7537191	7537664	LTR/ERV1	912	+	236	7537427	49343
chr17	7488084	7688084	harbor2	chr17	7538473	7539076	LTR/ERV1	2673	+	302	7538775	50691
chr17	76638206	76838206	harbor2	chr17	76640866	76641353	LTR/ERV1	3302	+	244	76641110	2904
chr17	7461827	7661827	harbor2	chr17	7532328	7532759	LTR/ERV1	5191	+	216	7532544	70717
chr17	7461827	7661827	harbor2	chr17	7533046	7533291	LTR/ERV1	5191	+	122	7533168	71341
chr17	7461827	7661827	harbor2	chr17	7533493	7533541	LTR/ERV1	3182	+	24	7533517	71690
chr17	7461827	7661827	harbor2	chr17	7533854	7534348	LTR/ERV1	3182	+	247	7534101	72274
chr17	7461827	7661827	harbor2	chr17	7537191	7537664	LTR/ERV1	912	+	236	7537427	75600
chr17	7461827	7661827	harbor2	chr17	7538473	7539076	LTR/ERV1	2673	+	302	7538775	76948
chr17	32776669	32976669	harbor2	chr17	32795628	32796007	LTR/ERV1	2746	+	190	32795818	19149
chr17	82984138	83184138	harbor2	chr17	83029581	83030016	LTR/ERV1	2337	+	218	83029799	45661
chr17	28851871	29051871	harbor2	chr17	28893595	28894064	LTR/ERV1	3843	+	234	28893829	41958
chr17	7588468	7788468	harbor2	chr17	7640714	7642277	LTR/ERV1	11529	+	782	7641496	53028
chr17	76638125	76838125	harbor2	chr17	76640866	76641353	LTR/ERV1	3302	+	244	76641110	2985
chr17	40547830	40747830	harbor2	chr17	40590491	40590709	LTR/ERV1	1398	+	109	40590600	42770
chr17	40547830	40747830	harbor2	chr17	40591139	40591517	LTR/ERV1	2326	+	189	40591328	43498
chr17	40547830	40747830	harbor2	chr17	40591828	40591843	LTR/ERV1	2326	+	8	40591836	44006
chr17	40547830	40747830	harbor2	chr17	40592172	40593110	LTR/ERV1	18176	+	469	40592641	44811
chr17	40547830	40747830	harbor2	chr17	40593229	40593376	LTR/ERV1	18176	+	74	40593303	45473
chr17	40547830	40747830	harbor2	chr17	40593671	40594471	LTR/ERV1	18176	+	400	40594071	46241
chr17	40547830	40747830	harbor2	chr17	40594895	40596202	LTR/ERV1	18176	+	654	40595549	47719
chr17	40547830	40747830	harbor2	chr17	40596203	40596577	LTR/ERV1	2085	+	187	40596390	48560
chr17	60049882	60249882	harbor2	chr17	60129092	60129363	LTR/ERV1	639	+	136	60129228	79346
chr17	39843014	40043014	harbor2	chr17	39917414	39917823	LTR/ERV1	2702	+	204	39917618	74604
chr17	42477293	42677293	harbor2	chr17	42529850	42529960	LTR/ERV1	729	+	55	42529905	52612
chr17	42477293	42677293	harbor2	chr17	42530224	42530299	LTR/ERV1	729	+	38	42530262	52969
chr17	42477293	42677293	harbor2	chr17	42530578	42530736	LTR/ERV1	954	+	79	42530657	53364
chr17	7464666	7664666	harbor2	chr17	7532328	7532759	LTR/ERV1	5191	+	216	7532544	67878
chr17	7464666	7664666	harbor2	chr17	7533046	7533291	LTR/ERV1	5191	+	122	7533168	68502
chr17	7464666	7664666	harbor2	chr17	7533493	7533541	LTR/ERV1	3182	+	24	7533517	68851
chr17	7464666	7664666	harbor2	chr17	7533854	7534348	LTR/ERV1	3182	+	247	7534101	69435
chr17	7464666	7664666	harbor2	chr17	7537191	7537664	LTR/ERV1	912	+	236	7537427	72761
chr17	7464666	7664666	harbor2	chr17	7538473	7539076	LTR/ERV1	2673	+	302	7538775	74109
chr17	7587525	7787525	harbor2	chr17	7640714	7642277	LTR/ERV1	11529	+	782	7641496	53971
chr17	81139059	81339059	harbor2	chr17	81234841	81235306	LTR/ERV1	1836	+	232	81235073	96014
chr17	81139059	81339059	harbor2	chr17	81238279	81238616	LTR/ERV1	1076	+	168	81238447	99388
chr17	76284849	76484849	harbor2	chr17	76357115	76357552	LTR/ERV1	2700	+	218	76357333	72484
chr17	76284849	76484849	harbor2	chr17	76363203	76363462	LTR/ERV1	2360	+	130	76363333	78484
chr17	76284849	76484849	harbor2	chr17	76364055	76364172	LTR/ERV1	2360	+	58	76364113	79264
chr17	76284849	76484849	harbor2	chr17	76364474	76364899	LTR/ERV1	2473	+	212	76364686	79837
chr17	78908254	79108254	harbor2	chr17	78984493	78984741	LTR/ERV1	1606	+	124	78984617	76363
chr17	78908254	79108254	harbor2	chr17	78985056	78985090	LTR/ERV1	1606	+	17	78985073	76819
chr17	78908254	79108254	harbor2	chr17	78987776	78987939	LTR/ERV1	3259	+	82	78987858	79604
chr17	78908254	79108254	harbor2	chr17	78988242	78988488	LTR/ERV1	3259	+	123	78988365	80111
chr17	78908254	79108254	harbor2	chr17	78988794	78988909	LTR/ERV1	3259	+	58	78988852	80598
chr17	61281405	61481405	harbor2	chr17	61284001	61284574	LTR/ERV1	3733	+	286	61284287	2882
chr17	7472460	7672460	harbor2	chr17	7532328	7532759	LTR/ERV1	5191	+	216	7532544	60084
chr17	7472460	7672460	harbor2	chr17	7533046	7533291	LTR/ERV1	5191	+	122	7533168	60708
chr17	7472460	7672460	harbor2	chr17	7533493	7533541	LTR/ERV1	3182	+	24	7533517	61057
chr17	7472460	7672460	harbor2	chr17	7533854	7534348	LTR/ERV1	3182	+	247	7534101	61641
chr17	7472460	7672460	harbor2	chr17	7537191	7537664	LTR/ERV1	912	+	236	7537427	64967
chr17	7472460	7672460	harbor2	chr17	7538473	7539076	LTR/ERV1	2673	+	302	7538775	66315
chr17	76638040	76838040	harbor2	chr17	76640866	76641353	LTR/ERV1	3302	+	244	76641110	3070
chr17	48956358	49156358	harbor2	chr17	48978283	48978431	LTR/ERV1	1010	+	74	48978357	21999
chr17	48956358	49156358	harbor2	chr17	48978512	48978799	LTR/ERV1	3985	+	144	48978656	22298
chr17	48956358	49156358	harbor2	chr17	48979110	48979406	LTR/ERV1	3985	+	148	48979258	22900
chr17	48956358	49156358	harbor2	chr17	48979713	48979748	LTR/ERV1	3985	+	18	48979731	23373
chr17	76637975	76837975	harbor2	chr17	76640866	76641353	LTR/ERV1	3302	+	244	76641110	3135
chr17	7461796	7661796	harbor2	chr17	7532328	7532759	LTR/ERV1	5191	+	216	7532544	70748
chr17	7461796	7661796	harbor2	chr17	7533046	7533291	LTR/ERV1	5191	+	122	7533168	71372
chr17	7461796	7661796	harbor2	chr17	7533493	7533541	LTR/ERV1	3182	+	24	7533517	71721
chr17	7461796	7661796	harbor2	chr17	7533854	7534348	LTR/ERV1	3182	+	247	7534101	72305
chr17	7461796	7661796	harbor2	chr17	7537191	7537664	LTR/ERV1	912	+	236	7537427	75631
chr17	7461796	7661796	harbor2	chr17	7538473	7539076	LTR/ERV1	2673	+	302	7538775	76979
chr17	63512433	63712433	harbor2	chr17	63597335	63597979	LTR/ERV1	2520	+	322	63597657	85224
chr17	7472419	7672419	harbor2	chr17	7532328	7532759	LTR/ERV1	5191	+	216	7532544	60125
chr17	7472419	7672419	harbor2	chr17	7533046	7533291	LTR/ERV1	5191	+	122	7533168	60749
chr17	7472419	7672419	harbor2	chr17	7533493	7533541	LTR/ERV1	3182	+	24	7533517	61098
chr17	7472419	7672419	harbor2	chr17	7533854	7534348	LTR/ERV1	3182	+	247	7534101	61682
chr17	7472419	7672419	harbor2	chr17	7537191	7537664	LTR/ERV1	912	+	236	7537427	65008
chr17	7472419	7672419	harbor2	chr17	7538473	7539076	LTR/ERV1	2673	+	302	7538775	66356
chr17	76768571	76968571	harbor2	chr17	76787671	76787995	LTR/ERV1	1495	+	162	76787833	19262
chr17	76768571	76968571	harbor2	chr17	76789726	76789900	LTR/ERV1	996	+	87	76789813	21242
chr17	76768571	76968571	harbor2	chr17	76802771	76802938	LTR/ERV1	924	+	84	76802855	34284
chr17	76768571	76968571	harbor2	chr17	76803209	76803910	LTR/ERV1	4557	+	350	76803559	34988
chr17	76768571	76968571	harbor2	chr17	76804117	76804154	LTR/ERV1	789	+	18	76804135	35564
chr17	76768571	76968571	harbor2	chr17	76804458	76804564	LTR/ERV1	789	+	53	76804511	35940
chr17	76768571	76968571	harbor2	chr17	76805948	76807489	LTR/ERV1	10935	+	770	76806718	38147
chr17	76768571	76968571	harbor2	chr17	76807980	76808069	LTR/ERV1	1183	+	44	76808024	39453
chr17	76768571	76968571	harbor2	chr17	76808362	76808542	LTR/ERV1	1183	+	90	76808452	39881
chr17	76768571	76968571	harbor2	chr17	76808962	76809032	LTR/ERV1	883	+	35	76808997	40426
chr17	76768571	76968571	harbor2	chr17	76809646	76809743	LTR/ERV1	883	+	48	76809694	41123
chr17	76768571	76968571	harbor2	chr17	76810049	76810185	LTR/ERV1	883	+	68	76810117	41546
chr17	76768571	76968571	harbor2	chr17	76858171	76858473	LTR/ERV1	2781	+	151	76858322	89751
chr17	76768571	76968571	harbor2	chr17	76858787	76859059	LTR/ERV1	2781	+	136	76858923	90352
chr17	76768571	76968571	harbor2	chr17	76860400	76860893	LTR/ERV1	2500	+	246	76860646	92075
chr17	81583800	81783800	harbor2	chr17	81656964	81657596	LTR/ERV1	2136	+	316	81657280	73480
chr17	81583800	81783800	harbor2	chr17	81661340	81661435	LTR/ERV1	615	+	48	81661388	77588
chr17	81583800	81783800	harbor2	chr17	81662044	81662250	LTR/ERV1	1212	+	103	81662147	78347
chr17	81583800	81783800	harbor2	chr17	81662630	81662674	LTR/ERV1	1212	+	22	81662652	78852
chr17	81583800	81783800	harbor2	chr17	81662676	81662716	LTR/ERV1	1695	+	20	81662696	78896
chr17	81583800	81783800	harbor2	chr17	81662943	81663400	LTR/ERV1	1695	+	228	81663171	79371
chr17	81583800	81783800	harbor2	chr17	81677781	81678213	LTR/ERV1	2058	+	216	81677997	94197
chr17	81583800	81783800	harbor2	chr17	81678508	81678563	LTR/ERV1	2058	+	28	81678536	94736
chr17	81583800	81783800	harbor2	chr17	81678860	81678894	LTR/ERV1	2058	+	17	81678877	95077
chr17	81583800	81783800	harbor2	chr17	81679184	81679286	LTR/ERV1	2058	+	51	81679235	95435
chr17	7618194	7818194	harbor2	chr17	7640714	7642277	LTR/ERV1	11529	+	782	7641496	23302
chr17	78989193	79189193	harbor2	chr17	79010892	79011346	LTR/ERV1	3091	+	227	79011119	21926
chr17	78989193	79189193	harbor2	chr17	79011645	79012265	LTR/ERV1	4410	+	310	79011955	22762
chr17	78989193	79189193	harbor2	chr17	79012266	79015576	LTR/ERV1	18340	+	1655	79013921	24728
chr17	78989193	79189193	harbor2	chr17	79015885	79016877	LTR/ERV1	18340	+	496	79016381	27188
chr17	78989193	79189193	harbor2	chr17	79017284	79017619	LTR/ERV1	18340	+	168	79017452	28259
chr17	78989193	79189193	harbor2	chr17	79017620	79018141	LTR/ERV1	3106	+	260	79017880	28687
chr17	78989193	79189193	harbor2	chr17	79018517	79018636	LTR/ERV1	739	+	60	79018577	29384
chr17	62850959	63050959	harbor2	chr17	62880111	62880580	LTR/ERV1	1166	+	234	62880345	29386
chr17	76637901	76837901	harbor2	chr17	76640866	76641353	LTR/ERV1	3302	+	244	76641110	3209
chr17	76771331	76971331	harbor2	chr17	76787671	76787995	LTR/ERV1	1495	+	162	76787833	16502
chr17	76771331	76971331	harbor2	chr17	76789726	76789900	LTR/ERV1	996	+	87	76789813	18482
chr17	76771331	76971331	harbor2	chr17	76802771	76802938	LTR/ERV1	924	+	84	76802855	31524
chr17	76771331	76971331	harbor2	chr17	76803209	76803910	LTR/ERV1	4557	+	350	76803559	32228
chr17	76771331	76971331	harbor2	chr17	76804117	76804154	LTR/ERV1	789	+	18	76804135	32804
chr17	76771331	76971331	harbor2	chr17	76804458	76804564	LTR/ERV1	789	+	53	76804511	33180
chr17	76771331	76971331	harbor2	chr17	76805948	76807489	LTR/ERV1	10935	+	770	76806718	35387
chr17	76771331	76971331	harbor2	chr17	76807980	76808069	LTR/ERV1	1183	+	44	76808024	36693
chr17	76771331	76971331	harbor2	chr17	76808362	76808542	LTR/ERV1	1183	+	90	76808452	37121
chr17	76771331	76971331	harbor2	chr17	76808962	76809032	LTR/ERV1	883	+	35	76808997	37666
chr17	76771331	76971331	harbor2	chr17	76809646	76809743	LTR/ERV1	883	+	48	76809694	38363
chr17	76771331	76971331	harbor2	chr17	76810049	76810185	LTR/ERV1	883	+	68	76810117	38786
chr17	76771331	76971331	harbor2	chr17	76858171	76858473	LTR/ERV1	2781	+	151	76858322	86991
chr17	76771331	76971331	harbor2	chr17	76858787	76859059	LTR/ERV1	2781	+	136	76858923	87592
chr17	76771331	76971331	harbor2	chr17	76860400	76860893	LTR/ERV1	2500	+	246	76860646	89315
chr17	81179270	81379270	harbor2	chr17	81234841	81235306	LTR/ERV1	1836	+	232	81235073	55803
chr17	81179270	81379270	harbor2	chr17	81238279	81238616	LTR/ERV1	1076	+	168	81238447	59177
chr17	78448916	78648916	harbor2	chr17	78508123	78508608	LTR/ERV1	1976	+	242	78508365	59449
chr17	78448916	78648916	harbor2	chr17	78512467	78512659	LTR/ERV1	1471	+	96	78512563	63647
chr17	78448916	78648916	harbor2	chr17	78512968	78513053	LTR/ERV1	1471	+	42	78513010	64094
chr17	78448916	78648916	harbor2	chr17	78513056	78513435	LTR/ERV1	2383	+	190	78513246	64330
chr17	7472691	7672691	harbor2	chr17	7532328	7532759	LTR/ERV1	5191	+	216	7532544	59853
chr17	7472691	7672691	harbor2	chr17	7533046	7533291	LTR/ERV1	5191	+	122	7533168	60477
chr17	7472691	7672691	harbor2	chr17	7533493	7533541	LTR/ERV1	3182	+	24	7533517	60826
chr17	7472691	7672691	harbor2	chr17	7533854	7534348	LTR/ERV1	3182	+	247	7534101	61410
chr17	7472691	7672691	harbor2	chr17	7537191	7537664	LTR/ERV1	912	+	236	7537427	64736
chr17	7472691	7672691	harbor2	chr17	7538473	7539076	LTR/ERV1	2673	+	302	7538775	66084
chr17	8344316	8544316	harbor2	chr17	8380695	8381392	LTR/ERV1	3248	+	348	8381043	36727
chr17	76768569	76968569	harbor2	chr17	76787671	76787995	LTR/ERV1	1495	+	162	76787833	19264
chr17	76768569	76968569	harbor2	chr17	76789726	76789900	LTR/ERV1	996	+	87	76789813	21244
chr17	76768569	76968569	harbor2	chr17	76802771	76802938	LTR/ERV1	924	+	84	76802855	34286
chr17	76768569	76968569	harbor2	chr17	76803209	76803910	LTR/ERV1	4557	+	350	76803559	34990
chr17	76768569	76968569	harbor2	chr17	76804117	76804154	LTR/ERV1	789	+	18	76804135	35566
chr17	76768569	76968569	harbor2	chr17	76804458	76804564	LTR/ERV1	789	+	53	76804511	35942
chr17	76768569	76968569	harbor2	chr17	76805948	76807489	LTR/ERV1	10935	+	770	76806718	38149
chr17	76768569	76968569	harbor2	chr17	76807980	76808069	LTR/ERV1	1183	+	44	76808024	39455
chr17	76768569	76968569	harbor2	chr17	76808362	76808542	LTR/ERV1	1183	+	90	76808452	39883
chr17	76768569	76968569	harbor2	chr17	76808962	76809032	LTR/ERV1	883	+	35	76808997	40428
chr17	76768569	76968569	harbor2	chr17	76809646	76809743	LTR/ERV1	883	+	48	76809694	41125
chr17	76768569	76968569	harbor2	chr17	76810049	76810185	LTR/ERV1	883	+	68	76810117	41548
chr17	76768569	76968569	harbor2	chr17	76858171	76858473	LTR/ERV1	2781	+	151	76858322	89753
chr17	76768569	76968569	harbor2	chr17	76858787	76859059	LTR/ERV1	2781	+	136	76858923	90354
chr17	76768569	76968569	harbor2	chr17	76860400	76860893	LTR/ERV1	2500	+	246	76860646	92077
chr17	7465556	7665556	harbor2	chr17	7532328	7532759	LTR/ERV1	5191	+	216	7532544	66988
chr17	7465556	7665556	harbor2	chr17	7533046	7533291	LTR/ERV1	5191	+	122	7533168	67612
chr17	7465556	7665556	harbor2	chr17	7533493	7533541	LTR/ERV1	3182	+	24	7533517	67961
chr17	7465556	7665556	harbor2	chr17	7533854	7534348	LTR/ERV1	3182	+	247	7534101	68545
chr17	7465556	7665556	harbor2	chr17	7537191	7537664	LTR/ERV1	912	+	236	7537427	71871
chr17	7465556	7665556	harbor2	chr17	7538473	7539076	LTR/ERV1	2673	+	302	7538775	73219
chr17	76637232	76837232	harbor2	chr17	76640866	76641353	LTR/ERV1	3302	+	244	76641110	3878
chr17	81583750	81783750	harbor2	chr17	81656964	81657596	LTR/ERV1	2136	+	316	81657280	73530
chr17	81583750	81783750	harbor2	chr17	81661340	81661435	LTR/ERV1	615	+	48	81661388	77638
chr17	81583750	81783750	harbor2	chr17	81662044	81662250	LTR/ERV1	1212	+	103	81662147	78397
chr17	81583750	81783750	harbor2	chr17	81662630	81662674	LTR/ERV1	1212	+	22	81662652	78902
chr17	81583750	81783750	harbor2	chr17	81662676	81662716	LTR/ERV1	1695	+	20	81662696	78946
chr17	81583750	81783750	harbor2	chr17	81662943	81663400	LTR/ERV1	1695	+	228	81663171	79421
chr17	81583750	81783750	harbor2	chr17	81677781	81678213	LTR/ERV1	2058	+	216	81677997	94247
chr17	81583750	81783750	harbor2	chr17	81678508	81678563	LTR/ERV1	2058	+	28	81678536	94786
chr17	81583750	81783750	harbor2	chr17	81678860	81678894	LTR/ERV1	2058	+	17	81678877	95127
chr17	81583750	81783750	harbor2	chr17	81679184	81679286	LTR/ERV1	2058	+	51	81679235	95485
chr17	44456186	44656186	harbor2	chr17	44510906	44511022	LTR/ERV1	1001	+	58	44510964	54778
chr17	44456186	44656186	harbor2	chr17	44511340	44511435	LTR/ERV1	1001	+	48	44511388	55202
chr17	44456186	44656186	harbor2	chr17	44511479	44511679	LTR/ERV1	1323	+	100	44511579	55393
chr17	44456186	44656186	harbor2	chr17	44511686	44512193	LTR/ERV1	3147	+	254	44511940	55754
chr17	44456186	44656186	harbor2	chr17	44527782	44529218	LTR/ERV1	9960	+	718	44528500	72314
chr17	44456186	44656186	harbor2	chr17	44531845	44531864	LTR/ERV1	1331	+	10	44531855	75669
chr17	44456186	44656186	harbor2	chr17	44532164	44532458	LTR/ERV1	1331	+	147	44532311	76125
chr17	8376092	8576092	harbor2	chr17	8380695	8381392	LTR/ERV1	3248	+	348	8381043	4951
chr18	79580641	79780641	harbor2	chr18	79600981	79601738	LTR/ERV1	5673	+	378	79601359	20718
chr18	79580641	79780641	harbor2	chr18	79639121	79640042	LTR/ERV1	4239	+	460	79639581	58940
chr18	79580641	79780641	harbor2	chr18	79661572	79662022	LTR/ERV1	2065	+	225	79661797	81156
chr18	79580641	79780641	harbor2	chr18	79662102	79662927	LTR/ERV1	4329	+	412	79662514	81873
chr18	79580641	79780641	harbor2	chr18	79662955	79663497	LTR/ERV1	4329	+	271	79663226	82585
chr18	79580641	79780641	harbor2	chr18	79663884	79664091	LTR/ERV1	4329	+	104	79663988	83347
chr18	79580641	79780641	harbor2	chr18	79664584	79664670	LTR/ERV1	582	+	43	79664627	83986
chr18	79580641	79780641	harbor2	chr18	79664809	79665262	LTR/ERV1	3304	+	226	79665035	84394
chr18	79580641	79780641	harbor2	chr18	79665561	79666037	LTR/ERV1	3304	+	238	79665799	85158
chr18	79580641	79780641	harbor2	chr18	79666337	79667667	LTR/ERV1	3072	+	665	79667002	86361
chr18	79580641	79780641	harbor2	chr18	79667953	79668254	LTR/ERV1	1995	+	150	79668103	87462
chr18	79580641	79780641	harbor2	chr18	79668376	79668716	LTR/ERV1	1948	+	170	79668546	87905
chr18	79580641	79780641	harbor2	chr18	79668816	79669115	LTR/ERV1	1205	+	150	79668966	88325
chr18	79580641	79780641	harbor2	chr18	79678159	79678575	LTR/ERV1	1979	+	208	79678367	97726
chr18	76341268	76541268	harbor2	chr18	76387765	76388498	LTR/ERV1	5082	+	366	76388131	46863
chr18	12848395	13048395	harbor2	chr18	12892214	12892355	LTR/ERV1	590	+	70	12892284	43889
chr18	12848395	13048395	harbor2	chr18	12903883	12904397	LTR/ERV1	2721	+	257	12904140	55745
chr18	76338499	76538499	harbor2	chr18	76387765	76388498	LTR/ERV1	5082	+	366	76388131	49632
chr18	78210405	78410405	harbor2	chr18	78214682	78214970	LTR/ERV1	952	+	144	78214826	4421
chr18	12277008	12477008	harbor2	chr18	12283750	12284232	LTR/ERV1	1790	+	241	12283991	6983
chr18	12277008	12477008	harbor2	chr18	12330849	12331025	LTR/ERV1	1016	+	88	12330937	53929
chr18	12277008	12477008	harbor2	chr18	12331338	12331500	LTR/ERV1	1016	+	81	12331419	54411
chr18	12277008	12477008	harbor2	chr18	12334943	12335617	LTR/ERV1	3073	+	337	12335280	58272
chr18	12277008	12477008	harbor2	chr18	12335963	12336659	LTR/ERV1	3027	+	348	12336311	59303
chr18	63267857	63467857	harbor2	chr18	63278327	63278782	LTR/ERV1	1796	+	228	63278555	10698
chr18	8917310	9117310	harbor2	chr18	8914110	8920902	LTR/ERV1	54082	+	3396	8917506	196
chr18	8917310	9117310	harbor2	chr18	8920903	8921365	LTR/ERV1	4041	+	231	8921134	3824
chr18	8917310	9117310	harbor2	chr18	8926850	8927366	LTR/ERV1	1281	+	258	8927108	9798
chr18	8917310	9117310	harbor2	chr18	8933256	8933609	LTR/ERV1	2157	+	176	8933432	16122
chr18	8917310	9117310	harbor2	chr18	8937522	8937923	LTR/ERV1	2658	+	200	8937722	20412
chr18	8917310	9117310	harbor2	chr18	8937924	8938248	LTR/ERV1	2684	+	162	8938086	20776
chr18	8917310	9117310	harbor2	chr18	8938550	8938684	LTR/ERV1	2684	+	67	8938617	21307
chr18	8917310	9117310	harbor2	chr18	8938685	8938804	LTR/ERV1	2658	+	60	8938745	21435
chr18	8917310	9117310	harbor2	chr18	8939216	8939250	LTR/ERV1	2658	+	17	8939233	21923
chr18	8917310	9117310	harbor2	chr18	8940700	8941104	LTR/ERV1	1527	+	202	8940902	23592
chr18	8917310	9117310	harbor2	chr18	8944000	8944368	LTR/ERV1	2443	+	184	8944184	26874
chr18	8917310	9117310	harbor2	chr18	8944633	8944803	LTR/ERV1	2443	+	85	8944718	27408
chr18	8917310	9117310	harbor2	chr18	8954365	8954760	LTR/ERV1	2258	+	198	8954563	37253
chr18	8917310	9117310	harbor2	chr18	8956276	8956970	LTR/ERV1	2605	+	347	8956623	39313
chr18	8917310	9117310	harbor2	chr18	8979677	8980221	LTR/ERV1	3046	+	272	8979949	62639
chr18	8917310	9117310	harbor2	chr18	8995354	8995611	LTR/ERV1	1071	+	128	8995482	78172
chr18	8917310	9117310	harbor2	chr18	8995910	8996058	LTR/ERV1	894	+	74	8995984	78674
chr18	8917310	9117310	harbor2	chr18	8945350	8945965	LTR/ERV1	3873	+	308	8945658	28348
chr18	74439385	74639385	harbor2	chr18	74533555	74534160	LTR/ERV1	1467	+	302	74533857	94472
chr18	79580658	79780658	harbor2	chr18	79600981	79601738	LTR/ERV1	5673	+	378	79601359	20701
chr18	79580658	79780658	harbor2	chr18	79639121	79640042	LTR/ERV1	4239	+	460	79639581	58923
chr18	79580658	79780658	harbor2	chr18	79661572	79662022	LTR/ERV1	2065	+	225	79661797	81139
chr18	79580658	79780658	harbor2	chr18	79662102	79662927	LTR/ERV1	4329	+	412	79662514	81856
chr18	79580658	79780658	harbor2	chr18	79662955	79663497	LTR/ERV1	4329	+	271	79663226	82568
chr18	79580658	79780658	harbor2	chr18	79663884	79664091	LTR/ERV1	4329	+	104	79663988	83330
chr18	79580658	79780658	harbor2	chr18	79664584	79664670	LTR/ERV1	582	+	43	79664627	83969
chr18	79580658	79780658	harbor2	chr18	79664809	79665262	LTR/ERV1	3304	+	226	79665035	84377
chr18	79580658	79780658	harbor2	chr18	79665561	79666037	LTR/ERV1	3304	+	238	79665799	85141
chr18	79580658	79780658	harbor2	chr18	79666337	79667667	LTR/ERV1	3072	+	665	79667002	86344
chr18	79580658	79780658	harbor2	chr18	79667953	79668254	LTR/ERV1	1995	+	150	79668103	87445
chr18	79580658	79780658	harbor2	chr18	79668376	79668716	LTR/ERV1	1948	+	170	79668546	87888
chr18	79580658	79780658	harbor2	chr18	79668816	79669115	LTR/ERV1	1205	+	150	79668966	88308
chr18	79580658	79780658	harbor2	chr18	79678159	79678575	LTR/ERV1	1979	+	208	79678367	97709
chr18	65788461	65988461	harbor2	chr18	65818950	65819498	LTR/ERV1	3515	+	274	65819224	30763
chr18	12196156	12396156	harbor2	chr18	12283750	12284232	LTR/ERV1	1790	+	241	12283991	87835
chr18	65651749	65851749	harbor2	chr18	65651421	65651858	LTR/ERV1	3191	+	218	65651639	110
chr18	65651749	65851749	harbor2	chr18	65669165	65669566	LTR/ERV1	1596	+	200	65669365	17616
chr18	65651749	65851749	harbor2	chr18	65723609	65724038	LTR/ERV1	1682	+	214	65723823	72074
chr18	65651749	65851749	harbor2	chr18	65730082	65730612	LTR/ERV1	3054	+	265	65730347	78598
chr18	24500243	24700243	harbor2	chr18	24515066	24515520	LTR/ERV1	2035	+	227	24515293	15050
chr18	79934431	80134431	harbor2	chr18	79956395	79956839	LTR/ERV1	1998	+	222	79956617	22186
chr18	79934431	80134431	harbor2	chr18	79989149	79989165	LTR/ERV1	571	+	8	79989157	54726
chr18	79934431	80134431	harbor2	chr18	79989410	79989672	LTR/ERV1	571	+	131	79989541	55110
chr18	79934431	80134431	harbor2	chr18	79992495	79993124	LTR/ERV1	3775	+	314	79992809	58378
chr18	79934431	80134431	harbor2	chr18	79993127	79994439	LTR/ERV1	8475	+	656	79993783	59352
chr18	79934431	80134431	harbor2	chr18	79994443	79994542	LTR/ERV1	689	+	50	79994493	60062
chr18	79934431	80134431	harbor2	chr18	79994546	79994644	LTR/ERV1	732	+	49	79994595	60164
chr18	79934431	80134431	harbor2	chr18	79994648	79995820	LTR/ERV1	26150	+	586	79995234	60803
chr18	79934431	80134431	harbor2	chr18	79996128	79996661	LTR/ERV1	26150	+	266	79996394	61963
chr18	79934431	80134431	harbor2	chr18	79996960	79998011	LTR/ERV1	26150	+	526	79997486	63055
chr18	79934431	80134431	harbor2	chr18	79998315	79999253	LTR/ERV1	26150	+	469	79998784	64353
chr18	79934431	80134431	harbor2	chr18	79999558	79999727	LTR/ERV1	26150	+	84	79999642	65211
chr18	79934431	80134431	harbor2	chr18	80002620	80002938	LTR/ERV1	1784	+	159	80002779	68348
chr18	79934431	80134431	harbor2	chr18	80023832	80023990	LTR/ERV1	1231	+	79	80023911	89480
chr18	79934431	80134431	harbor2	chr18	80023991	80027138	LTR/ERV1	57183	+	1574	80025565	91134
chr18	79934431	80134431	harbor2	chr18	80027236	80030683	LTR/ERV1	57183	+	1724	80028960	94529
chr18	79934431	80134431	harbor2	chr18	80030989	80032361	LTR/ERV1	57183	+	686	80031675	97244
chr18	79934431	80134431	harbor2	chr18	80032362	80032557	LTR/ERV1	3408	+	98	80032460	98029
chr18	79934431	80134431	harbor2	chr18	80032852	80033162	LTR/ERV1	3408	+	155	80033007	98576
chr18	27134071	27334071	harbor2	chr18	27225786	27226169	LTR/ERV1	2852	+	192	27225978	91907
chr18	27134071	27334071	harbor2	chr18	27230592	27231051	LTR/ERV1	3767	+	230	27230822	96751
chr18	27134071	27334071	harbor2	chr18	27232260	27232705	LTR/ERV1	3567	+	222	27232482	98411
chr18	63860473	64060473	harbor2	chr18	63878582	63878953	LTR/ERV1	834	+	186	63878768	18295
chr19	17680051	17880051	harbor2	chr19	17711404	17711647	LTR/ERV1	3466	+	122	17711526	31475
chr19	17680051	17880051	harbor2	chr19	17711960	17712138	LTR/ERV1	3466	+	89	17712049	31998
chr19	17680051	17880051	harbor2	chr19	17712451	17712672	LTR/ERV1	3466	+	110	17712561	32510
chr19	10869257	11069257	harbor2	chr19	10939623	10939922	LTR/ERV1	1428	+	150	10939773	70516
chr19	10869257	11069257	harbor2	chr19	10940074	10940210	LTR/ERV1	787	+	68	10940142	70885
chr19	5522877	5722877	harbor2	chr19	5548576	5549016	LTR/ERV1	3815	+	220	5548796	25919
chr19	5522877	5722877	harbor2	chr19	5549017	5551892	LTR/ERV1	15423	+	1438	5550455	27578
chr19	5522877	5722877	harbor2	chr19	5551872	5552016	LTR/ERV1	835	+	72	5551944	29067
chr19	5522877	5722877	harbor2	chr19	5552007	5552168	LTR/ERV1	1037	+	80	5552087	29210
chr19	5522877	5722877	harbor2	chr19	5552161	5552771	LTR/ERV1	4429	+	305	5552466	29589
chr19	5522877	5722877	harbor2	chr19	5552772	5553212	LTR/ERV1	3809	+	220	5552992	30115
chr19	9993299	10193299	harbor2	chr19	10000058	10000276	LTR/ERV1	1118	+	109	10000167	6868
chr19	2800670	3000670	harbor2	chr19	2861434	2861994	LTR/ERV1	6537	+	280	2861714	61044
chr19	2800670	3000670	harbor2	chr19	2862311	2863021	LTR/ERV1	6537	+	355	2862666	61996
chr19	2800670	3000670	harbor2	chr19	2863332	2863471	LTR/ERV1	6537	+	70	2863402	62732
chr19	2800670	3000670	harbor2	chr19	2864202	2864418	LTR/ERV1	1216	+	108	2864310	63640
chr19	2800670	3000670	harbor2	chr19	2865339	2865813	LTR/ERV1	3199	+	237	2865576	64906
chr19	5522866	5722866	harbor2	chr19	5548576	5549016	LTR/ERV1	3815	+	220	5548796	25930
chr19	5522866	5722866	harbor2	chr19	5549017	5551892	LTR/ERV1	15423	+	1438	5550455	27589
chr19	5522866	5722866	harbor2	chr19	5551872	5552016	LTR/ERV1	835	+	72	5551944	29078
chr19	5522866	5722866	harbor2	chr19	5552007	5552168	LTR/ERV1	1037	+	80	5552087	29221
chr19	5522866	5722866	harbor2	chr19	5552161	5552771	LTR/ERV1	4429	+	305	5552466	29600
chr19	5522866	5722866	harbor2	chr19	5552772	5553212	LTR/ERV1	3809	+	220	5552992	30126
chr19	5522868	5722868	harbor2	chr19	5548576	5549016	LTR/ERV1	3815	+	220	5548796	25928
chr19	5522868	5722868	harbor2	chr19	5549017	5551892	LTR/ERV1	15423	+	1438	5550455	27587
chr19	5522868	5722868	harbor2	chr19	5551872	5552016	LTR/ERV1	835	+	72	5551944	29076
chr19	5522868	5722868	harbor2	chr19	5552007	5552168	LTR/ERV1	1037	+	80	5552087	29219
chr19	5522868	5722868	harbor2	chr19	5552161	5552771	LTR/ERV1	4429	+	305	5552466	29598
chr19	5522868	5722868	harbor2	chr19	5552772	5553212	LTR/ERV1	3809	+	220	5552992	30124
chr19	5590893	5790893	harbor2	chr19	5675497	5675810	LTR/ERV1	1837	+	156	5675653	84760
chr19	23499430	23699430	harbor2	chr19	23507385	23507773	LTR/ERV1	2089	+	194	23507579	8149
chr19	23499430	23699430	harbor2	chr19	23511362	23511632	LTR/ERV1	2337	+	135	23511497	12067
chr19	23499430	23699430	harbor2	chr19	23511939	23512153	LTR/ERV1	2337	+	107	23512046	12616
chr19	23499430	23699430	harbor2	chr19	23520080	23520214	LTR/ERV1	811	+	67	23520147	20717
chr19	23499430	23699430	harbor2	chr19	23549493	23549907	LTR/ERV1	2143	+	207	23549700	50270
chr19	23499430	23699430	harbor2	chr19	23549908	23550417	LTR/ERV1	1076	+	254	23550162	50732
chr19	23499430	23699430	harbor2	chr19	23550441	23553364	LTR/ERV1	15718	+	1462	23551903	52473
chr19	23499430	23699430	harbor2	chr19	23553332	23553878	LTR/ERV1	2239	+	273	23553605	54175
chr19	23499430	23699430	harbor2	chr19	23553855	23554044	LTR/ERV1	1189	+	94	23553949	54519
chr19	23499430	23699430	harbor2	chr19	23554096	23554632	LTR/ERV1	3442	+	268	23554364	54934
chr19	23499430	23699430	harbor2	chr19	23554633	23555054	LTR/ERV1	2129	+	210	23554843	55413
chr19	23499430	23699430	harbor2	chr19	23568981	23569385	LTR/ERV1	1762	+	202	23569183	69753
chr19	23499430	23699430	harbor2	chr19	23569671	23569701	LTR/ERV1	1762	+	15	23569686	70256
chr19	23499430	23699430	harbor2	chr19	23570966	23571436	LTR/ERV1	1587	+	235	23571201	71771
chr19	23499430	23699430	harbor2	chr19	23579430	23579624	LTR/ERV1	1397	+	97	23579527	80097
chr19	23499430	23699430	harbor2	chr19	23579926	23580222	LTR/ERV1	1397	+	148	23580074	80644
chr19	5522876	5722876	harbor2	chr19	5548576	5549016	LTR/ERV1	3815	+	220	5548796	25920
chr19	5522876	5722876	harbor2	chr19	5549017	5551892	LTR/ERV1	15423	+	1438	5550455	27579
chr19	5522876	5722876	harbor2	chr19	5551872	5552016	LTR/ERV1	835	+	72	5551944	29068
chr19	5522876	5722876	harbor2	chr19	5552007	5552168	LTR/ERV1	1037	+	80	5552087	29211
chr19	5522876	5722876	harbor2	chr19	5552161	5552771	LTR/ERV1	4429	+	305	5552466	29590
chr19	5522876	5722876	harbor2	chr19	5552772	5553212	LTR/ERV1	3809	+	220	5552992	30116
chr19	5595790	5795790	harbor2	chr19	5675497	5675810	LTR/ERV1	1837	+	156	5675653	79863
chr19	1393190	1593190	harbor2	chr19	1442428	1442896	LTR/ERV1	3133	+	234	1442662	49472
chr19	19676554	19876554	harbor2	chr19	19697161	19697725	LTR/ERV1	3767	+	282	19697443	20889
chr19	19676554	19876554	harbor2	chr19	19698737	19698924	LTR/ERV1	1285	+	94	19698831	22277
chr19	19676554	19876554	harbor2	chr19	19701247	19701427	LTR/ERV1	1147	+	90	19701337	24783
chr19	19676554	19876554	harbor2	chr19	19701741	19701868	LTR/ERV1	1147	+	64	19701805	25251
chr19	19676554	19876554	harbor2	chr19	19709224	19709942	LTR/ERV1	3773	+	359	19709583	33029
chr19	35168139	35368139	harbor2	chr19	35194037	35194522	LTR/ERV1	2524	+	242	35194279	26140
chr19	35168139	35368139	harbor2	chr19	35198143	35198334	LTR/ERV1	1037	+	96	35198239	30100
chr19	35168139	35368139	harbor2	chr19	35214946	35215467	LTR/ERV1	3923	+	260	35215206	47067
chr19	35168139	35368139	harbor2	chr19	35220609	35221116	LTR/ERV1	3036	+	254	35220863	52724
chr19	5522870	5722870	harbor2	chr19	5548576	5549016	LTR/ERV1	3815	+	220	5548796	25926
chr19	5522870	5722870	harbor2	chr19	5549017	5551892	LTR/ERV1	15423	+	1438	5550455	27585
chr19	5522870	5722870	harbor2	chr19	5551872	5552016	LTR/ERV1	835	+	72	5551944	29074
chr19	5522870	5722870	harbor2	chr19	5552007	5552168	LTR/ERV1	1037	+	80	5552087	29217
chr19	5522870	5722870	harbor2	chr19	5552161	5552771	LTR/ERV1	4429	+	305	5552466	29596
chr19	5522870	5722870	harbor2	chr19	5552772	5553212	LTR/ERV1	3809	+	220	5552992	30122
chr19	58419902	58619902	harbor2	chr19	58460025	58460629	LTR/ERV1	1012	+	302	58460327	40425
chr19	58419902	58619902	harbor2	chr19	58460626	58460686	LTR/ERV1	3219	+	30	58460656	40754
chr19	58419902	58619902	harbor2	chr19	58460987	58461867	LTR/ERV1	3219	+	440	58461427	41525
chr19	58419902	58619902	harbor2	chr19	58462175	58462224	LTR/ERV1	3219	+	24	58462199	42297
chr19	58419902	58619902	harbor2	chr19	58488940	58489636	LTR/ERV1	5160	+	348	58489288	69386
chr19	36428735	36628735	harbor2	chr19	36429282	36429465	LTR/ERV1	2700	+	92	36429374	639
chr19	36428735	36628735	harbor2	chr19	36429752	36429972	LTR/ERV1	2700	+	110	36429862	1127
chr19	36428735	36628735	harbor2	chr19	36430279	36430333	LTR/ERV1	2700	+	27	36430306	1571
chr19	36428735	36628735	harbor2	chr19	36436486	36436832	LTR/ERV1	1729	+	173	36436659	7924
chr19	36428735	36628735	harbor2	chr19	36437441	36437634	LTR/ERV1	1729	+	96	36437537	8802
chr19	36428735	36628735	harbor2	chr19	36507441	36507490	LTR/ERV1	790	+	24	36507465	78730
chr19	36428735	36628735	harbor2	chr19	36507789	36507985	LTR/ERV1	790	+	98	36507887	79152
chr19	36428735	36628735	harbor2	chr19	36508300	36508509	LTR/ERV1	1055	+	104	36508404	79669
chr19	36428735	36628735	harbor2	chr19	36509799	36509913	LTR/ERV1	1055	+	57	36509856	81121
chr19	5522873	5722873	harbor2	chr19	5548576	5549016	LTR/ERV1	3815	+	220	5548796	25923
chr19	5522873	5722873	harbor2	chr19	5549017	5551892	LTR/ERV1	15423	+	1438	5550455	27582
chr19	5522873	5722873	harbor2	chr19	5551872	5552016	LTR/ERV1	835	+	72	5551944	29071
chr19	5522873	5722873	harbor2	chr19	5552007	5552168	LTR/ERV1	1037	+	80	5552087	29214
chr19	5522873	5722873	harbor2	chr19	5552161	5552771	LTR/ERV1	4429	+	305	5552466	29593
chr19	5522873	5722873	harbor2	chr19	5552772	5553212	LTR/ERV1	3809	+	220	5552992	30119
chr19	56021004	56221004	harbor2	chr19	56078017	56078243	LTR/ERV1	1152	+	113	56078130	57126
chr19	45369318	45569318	harbor2	chr19	45375084	45375131	LTR/ERV1	1551	+	24	45375108	5790
chr19	45369318	45569318	harbor2	chr19	45375446	45375536	LTR/ERV1	1551	+	45	45375491	6173
chr19	45369318	45569318	harbor2	chr19	45375859	45376092	LTR/ERV1	1551	+	116	45375975	6657
chr19	45369318	45569318	harbor2	chr19	45390230	45390717	LTR/ERV1	3880	+	244	45390474	21156
chr19	18336331	18536331	harbor2	chr19	18336221	18336500	LTR/ERV1	5085	+	140	18336361	30
chr19	5522872	5722872	harbor2	chr19	5548576	5549016	LTR/ERV1	3815	+	220	5548796	25924
chr19	5522872	5722872	harbor2	chr19	5549017	5551892	LTR/ERV1	15423	+	1438	5550455	27583
chr19	5522872	5722872	harbor2	chr19	5551872	5552016	LTR/ERV1	835	+	72	5551944	29072
chr19	5522872	5722872	harbor2	chr19	5552007	5552168	LTR/ERV1	1037	+	80	5552087	29215
chr19	5522872	5722872	harbor2	chr19	5552161	5552771	LTR/ERV1	4429	+	305	5552466	29594
chr19	5522872	5722872	harbor2	chr19	5552772	5553212	LTR/ERV1	3809	+	220	5552992	30120
chr19	5522856	5722856	harbor2	chr19	5548576	5549016	LTR/ERV1	3815	+	220	5548796	25940
chr19	5522856	5722856	harbor2	chr19	5549017	5551892	LTR/ERV1	15423	+	1438	5550455	27599
chr19	5522856	5722856	harbor2	chr19	5551872	5552016	LTR/ERV1	835	+	72	5551944	29088
chr19	5522856	5722856	harbor2	chr19	5552007	5552168	LTR/ERV1	1037	+	80	5552087	29231
chr19	5522856	5722856	harbor2	chr19	5552161	5552771	LTR/ERV1	4429	+	305	5552466	29610
chr19	5522856	5722856	harbor2	chr19	5552772	5553212	LTR/ERV1	3809	+	220	5552992	30136
chr19	5522869	5722869	harbor2	chr19	5548576	5549016	LTR/ERV1	3815	+	220	5548796	25927
chr19	5522869	5722869	harbor2	chr19	5549017	5551892	LTR/ERV1	15423	+	1438	5550455	27586
chr19	5522869	5722869	harbor2	chr19	5551872	5552016	LTR/ERV1	835	+	72	5551944	29075
chr19	5522869	5722869	harbor2	chr19	5552007	5552168	LTR/ERV1	1037	+	80	5552087	29218
chr19	5522869	5722869	harbor2	chr19	5552161	5552771	LTR/ERV1	4429	+	305	5552466	29597
chr19	5522869	5722869	harbor2	chr19	5552772	5553212	LTR/ERV1	3809	+	220	5552992	30123
chr19	1381618	1581618	harbor2	chr19	1442428	1442896	LTR/ERV1	3133	+	234	1442662	61044
chr19	34577590	34777590	harbor2	chr19	34637742	34638149	LTR/ERV1	1032	+	204	34637946	60356
chr19	34577590	34777590	harbor2	chr19	34638533	34639079	LTR/ERV1	1878	+	273	34638806	61216
chr19	34577590	34777590	harbor2	chr19	34641139	34641480	LTR/ERV1	916	+	170	34641309	63719
chr19	34577590	34777590	harbor2	chr19	34641877	34642006	LTR/ERV1	775	+	64	34641941	64351
chr19	34577590	34777590	harbor2	chr19	34642009	34642184	LTR/ERV1	950	+	88	34642097	64507
chr19	34577590	34777590	harbor2	chr19	34654506	34654961	LTR/ERV1	2054	+	228	34654734	77144
chr19	34577590	34777590	harbor2	chr19	34655092	34655711	LTR/ERV1	4059	+	310	34655402	77812
chr19	34577590	34777590	harbor2	chr19	34667499	34667760	LTR/ERV1	1761	+	130	34667629	90039
chr19	34577590	34777590	harbor2	chr19	34675409	34675656	LTR/ERV1	3588	+	124	34675533	97943
chr19	34577590	34777590	harbor2	chr19	34676297	34676685	LTR/ERV1	3588	+	194	34676491	98901
chr19	34577590	34777590	harbor2	chr19	34668011	34669231	LTR/ERV1	8236	+	610	34668621	91031
chr19	49290589	49490589	harbor2	chr19	49303697	49304169	LTR/ERV1	1798	+	236	49303933	13344
chr19	49290589	49490589	harbor2	chr19	49304170	49304482	LTR/ERV1	1789	+	156	49304326	13737
chr19	49290589	49490589	harbor2	chr19	49368647	49369242	LTR/ERV1	3346	+	298	49368945	78356
chr19	19676565	19876565	harbor2	chr19	19697161	19697725	LTR/ERV1	3767	+	282	19697443	20878
chr19	19676565	19876565	harbor2	chr19	19698737	19698924	LTR/ERV1	1285	+	94	19698831	22266
chr19	19676565	19876565	harbor2	chr19	19701247	19701427	LTR/ERV1	1147	+	90	19701337	24772
chr19	19676565	19876565	harbor2	chr19	19701741	19701868	LTR/ERV1	1147	+	64	19701805	25240
chr19	19676565	19876565	harbor2	chr19	19709224	19709942	LTR/ERV1	3773	+	359	19709583	33018
chr19	6273407	6473407	harbor2	chr19	6285805	6287690	LTR/ERV1	7881	+	942	6286747	13340
chr19	6273407	6473407	harbor2	chr19	6287691	6288167	LTR/ERV1	3142	+	238	6287929	14522
chr19	6273407	6473407	harbor2	chr19	6288322	6288366	LTR/ERV1	3142	+	22	6288344	14937
chr19	6273407	6473407	harbor2	chr19	6288648	6288740	LTR/ERV1	3142	+	46	6288694	15287
chr19	6273407	6473407	harbor2	chr19	6288862	6289357	LTR/ERV1	9058	+	248	6289110	15703
chr19	6273407	6473407	harbor2	chr19	6289655	6289846	LTR/ERV1	9058	+	96	6289751	16344
chr19	6273407	6473407	harbor2	chr19	6290460	6291235	LTR/ERV1	9058	+	388	6290848	17441
chr19	6273407	6473407	harbor2	chr19	6291798	6292476	LTR/ERV1	4085	+	339	6292137	18730
chr19	6273407	6473407	harbor2	chr19	6292791	6292960	LTR/ERV1	4085	+	84	6292875	19468
chr19	6273407	6473407	harbor2	chr19	6293022	6293177	LTR/ERV1	795	+	78	6293100	19693
chr19	6273407	6473407	harbor2	chr19	6293180	6293246	LTR/ERV1	2144	+	33	6293213	19806
chr19	6273407	6473407	harbor2	chr19	6293545	6293574	LTR/ERV1	2144	+	14	6293559	20152
chr19	6273407	6473407	harbor2	chr19	6293883	6294319	LTR/ERV1	5269	+	218	6294101	20694
chr19	6273407	6473407	harbor2	chr19	6294652	6295406	LTR/ERV1	5269	+	377	6295029	21622
chr19	6273407	6473407	harbor2	chr19	6295708	6296211	LTR/ERV1	5269	+	252	6295960	22553
chr19	6273407	6473407	harbor2	chr19	6296522	6296744	LTR/ERV1	2325	+	111	6296633	23226
chr19	6273407	6473407	harbor2	chr19	6296800	6296959	LTR/ERV1	1247	+	80	6296880	23473
chr19	6273407	6473407	harbor2	chr19	6297254	6297305	LTR/ERV1	1247	+	26	6297280	23873
chr19	6273407	6473407	harbor2	chr19	6297320	6298831	LTR/ERV1	7198	+	756	6298076	24669
chr19	16057311	16257311	harbor2	chr19	16136440	16137103	LTR/ERV1	4031	+	332	16136772	79461
chr19	48865235	49065235	harbor2	chr19	48882278	48882395	LTR/ERV1	819	+	58	48882336	17101
chr19	48865235	49065235	harbor2	chr19	48883248	48883524	LTR/ERV1	1824	+	138	48883386	18151
chr19	48865235	49065235	harbor2	chr19	48946454	48947628	LTR/ERV1	3620	+	587	48947041	81806
chr19	48865235	49065235	harbor2	chr19	48951695	48952000	LTR/ERV1	1049	+	152	48951847	86612
chr19	51470868	51670868	harbor2	chr19	51547800	51548367	LTR/ERV1	3777	+	284	51548084	77216
chr19	19676581	19876581	harbor2	chr19	19697161	19697725	LTR/ERV1	3767	+	282	19697443	20862
chr19	19676581	19876581	harbor2	chr19	19698737	19698924	LTR/ERV1	1285	+	94	19698831	22250
chr19	19676581	19876581	harbor2	chr19	19701247	19701427	LTR/ERV1	1147	+	90	19701337	24756
chr19	19676581	19876581	harbor2	chr19	19701741	19701868	LTR/ERV1	1147	+	64	19701805	25224
chr19	19676581	19876581	harbor2	chr19	19709224	19709942	LTR/ERV1	3773	+	359	19709583	33002
chr19	19676539	19876539	harbor2	chr19	19697161	19697725	LTR/ERV1	3767	+	282	19697443	20904
chr19	19676539	19876539	harbor2	chr19	19698737	19698924	LTR/ERV1	1285	+	94	19698831	22292
chr19	19676539	19876539	harbor2	chr19	19701247	19701427	LTR/ERV1	1147	+	90	19701337	24798
chr19	19676539	19876539	harbor2	chr19	19701741	19701868	LTR/ERV1	1147	+	64	19701805	25266
chr19	19676539	19876539	harbor2	chr19	19709224	19709942	LTR/ERV1	3773	+	359	19709583	33044
chr19	19676556	19876556	harbor2	chr19	19697161	19697725	LTR/ERV1	3767	+	282	19697443	20887
chr19	19676556	19876556	harbor2	chr19	19698737	19698924	LTR/ERV1	1285	+	94	19698831	22275
chr19	19676556	19876556	harbor2	chr19	19701247	19701427	LTR/ERV1	1147	+	90	19701337	24781
chr19	19676556	19876556	harbor2	chr19	19701741	19701868	LTR/ERV1	1147	+	64	19701805	25249
chr19	19676556	19876556	harbor2	chr19	19709224	19709942	LTR/ERV1	3773	+	359	19709583	33027
chr19	5522842	5722842	harbor2	chr19	5548576	5549016	LTR/ERV1	3815	+	220	5548796	25954
chr19	5522842	5722842	harbor2	chr19	5549017	5551892	LTR/ERV1	15423	+	1438	5550455	27613
chr19	5522842	5722842	harbor2	chr19	5551872	5552016	LTR/ERV1	835	+	72	5551944	29102
chr19	5522842	5722842	harbor2	chr19	5552007	5552168	LTR/ERV1	1037	+	80	5552087	29245
chr19	5522842	5722842	harbor2	chr19	5552161	5552771	LTR/ERV1	4429	+	305	5552466	29624
chr19	5522842	5722842	harbor2	chr19	5552772	5553212	LTR/ERV1	3809	+	220	5552992	30150
chr19	19676482	19876482	harbor2	chr19	19697161	19697725	LTR/ERV1	3767	+	282	19697443	20961
chr19	19676482	19876482	harbor2	chr19	19698737	19698924	LTR/ERV1	1285	+	94	19698831	22349
chr19	19676482	19876482	harbor2	chr19	19701247	19701427	LTR/ERV1	1147	+	90	19701337	24855
chr19	19676482	19876482	harbor2	chr19	19701741	19701868	LTR/ERV1	1147	+	64	19701805	25323
chr19	19676482	19876482	harbor2	chr19	19709224	19709942	LTR/ERV1	3773	+	359	19709583	33101
chr19	1812988	2012988	harbor2	chr19	1903880	1903985	LTR/ERV1	847	+	52	1903932	90944
chr19	1812988	2012988	harbor2	chr19	1904289	1904647	LTR/ERV1	847	+	179	1904468	91480
chr19	1350329	1550329	harbor2	chr19	1442428	1442896	LTR/ERV1	3133	+	234	1442662	92333
chr19	1356152	1556152	harbor2	chr19	1442428	1442896	LTR/ERV1	3133	+	234	1442662	86510
chr19	1413259	1613259	harbor2	chr19	1442428	1442896	LTR/ERV1	3133	+	234	1442662	29403
chr19	19676573	19876573	harbor2	chr19	19697161	19697725	LTR/ERV1	3767	+	282	19697443	20870
chr19	19676573	19876573	harbor2	chr19	19698737	19698924	LTR/ERV1	1285	+	94	19698831	22258
chr19	19676573	19876573	harbor2	chr19	19701247	19701427	LTR/ERV1	1147	+	90	19701337	24764
chr19	19676573	19876573	harbor2	chr19	19701741	19701868	LTR/ERV1	1147	+	64	19701805	25232
chr19	19676573	19876573	harbor2	chr19	19709224	19709942	LTR/ERV1	3773	+	359	19709583	33010
chr19	57145103	57345103	harbor2	chr19	57172534	57172693	LTR/ERV1	1067	+	80	57172614	27511
chr19	57145103	57345103	harbor2	chr19	57172998	57173036	LTR/ERV1	1067	+	19	57173017	27914
chr19	57145103	57345103	harbor2	chr19	57181546	57181759	LTR/ERV1	4102	+	106	57181652	36549
chr19	57145103	57345103	harbor2	chr19	57182059	57182439	LTR/ERV1	4102	+	190	57182249	37146
chr19	57145103	57345103	harbor2	chr19	57187710	57187815	LTR/ERV1	726	+	52	57187762	42659
chr19	57145103	57345103	harbor2	chr19	57187817	57188147	LTR/ERV1	1898	+	165	57187982	42879
chr19	57145103	57345103	harbor2	chr19	57188349	57188639	LTR/ERV1	1333	+	145	57188494	43391
chr19	57145103	57345103	harbor2	chr19	57188802	57188920	LTR/ERV1	3128	+	59	57188861	43758
chr19	57145103	57345103	harbor2	chr19	57189229	57189661	LTR/ERV1	3128	+	216	57189445	44342
chr19	57145103	57345103	harbor2	chr19	57189954	57190017	LTR/ERV1	3128	+	32	57189986	44883
chr19	57145103	57345103	harbor2	chr19	57190020	57190109	LTR/ERV1	666	+	44	57190064	44961
chr19	57145103	57345103	harbor2	chr19	57190110	57190615	LTR/ERV1	2897	+	252	57190362	45259
chr19	57145103	57345103	harbor2	chr19	57241087	57241457	LTR/ERV1	1473	+	185	57241272	96169
chr19	19676564	19876564	harbor2	chr19	19697161	19697725	LTR/ERV1	3767	+	282	19697443	20879
chr19	19676564	19876564	harbor2	chr19	19698737	19698924	LTR/ERV1	1285	+	94	19698831	22267
chr19	19676564	19876564	harbor2	chr19	19701247	19701427	LTR/ERV1	1147	+	90	19701337	24773
chr19	19676564	19876564	harbor2	chr19	19701741	19701868	LTR/ERV1	1147	+	64	19701805	25241
chr19	19676564	19876564	harbor2	chr19	19709224	19709942	LTR/ERV1	3773	+	359	19709583	33019
chr19	5525874	5725874	harbor2	chr19	5548576	5549016	LTR/ERV1	3815	+	220	5548796	22922
chr19	5525874	5725874	harbor2	chr19	5549017	5551892	LTR/ERV1	15423	+	1438	5550455	24581
chr19	5525874	5725874	harbor2	chr19	5551872	5552016	LTR/ERV1	835	+	72	5551944	26070
chr19	5525874	5725874	harbor2	chr19	5552007	5552168	LTR/ERV1	1037	+	80	5552087	26213
chr19	5525874	5725874	harbor2	chr19	5552161	5552771	LTR/ERV1	4429	+	305	5552466	26592
chr19	5525874	5725874	harbor2	chr19	5552772	5553212	LTR/ERV1	3809	+	220	5552992	27118
chr19	19676555	19876555	harbor2	chr19	19697161	19697725	LTR/ERV1	3767	+	282	19697443	20888
chr19	19676555	19876555	harbor2	chr19	19698737	19698924	LTR/ERV1	1285	+	94	19698831	22276
chr19	19676555	19876555	harbor2	chr19	19701247	19701427	LTR/ERV1	1147	+	90	19701337	24782
chr19	19676555	19876555	harbor2	chr19	19701741	19701868	LTR/ERV1	1147	+	64	19701805	25250
chr19	19676555	19876555	harbor2	chr19	19709224	19709942	LTR/ERV1	3773	+	359	19709583	33028
chr19	5581029	5781029	harbor2	chr19	5675497	5675810	LTR/ERV1	1837	+	156	5675653	94624
chr19	19676548	19876548	harbor2	chr19	19697161	19697725	LTR/ERV1	3767	+	282	19697443	20895
chr19	19676548	19876548	harbor2	chr19	19698737	19698924	LTR/ERV1	1285	+	94	19698831	22283
chr19	19676548	19876548	harbor2	chr19	19701247	19701427	LTR/ERV1	1147	+	90	19701337	24789
chr19	19676548	19876548	harbor2	chr19	19701741	19701868	LTR/ERV1	1147	+	64	19701805	25257
chr19	19676548	19876548	harbor2	chr19	19709224	19709942	LTR/ERV1	3773	+	359	19709583	33035
chr19	19676558	19876558	harbor2	chr19	19697161	19697725	LTR/ERV1	3767	+	282	19697443	20885
chr19	19676558	19876558	harbor2	chr19	19698737	19698924	LTR/ERV1	1285	+	94	19698831	22273
chr19	19676558	19876558	harbor2	chr19	19701247	19701427	LTR/ERV1	1147	+	90	19701337	24779
chr19	19676558	19876558	harbor2	chr19	19701741	19701868	LTR/ERV1	1147	+	64	19701805	25247
chr19	19676558	19876558	harbor2	chr19	19709224	19709942	LTR/ERV1	3773	+	359	19709583	33025
chr19	19676589	19876589	harbor2	chr19	19697161	19697725	LTR/ERV1	3767	+	282	19697443	20854
chr19	19676589	19876589	harbor2	chr19	19698737	19698924	LTR/ERV1	1285	+	94	19698831	22242
chr19	19676589	19876589	harbor2	chr19	19701247	19701427	LTR/ERV1	1147	+	90	19701337	24748
chr19	19676589	19876589	harbor2	chr19	19701741	19701868	LTR/ERV1	1147	+	64	19701805	25216
chr19	19676589	19876589	harbor2	chr19	19709224	19709942	LTR/ERV1	3773	+	359	19709583	32994
chr19	1361200	1561200	harbor2	chr19	1442428	1442896	LTR/ERV1	3133	+	234	1442662	81462
chr19	44902158	45102158	harbor2	chr19	44913972	44914427	LTR/ERV1	3524	+	228	44914200	12042
chr19	19676560	19876560	harbor2	chr19	19697161	19697725	LTR/ERV1	3767	+	282	19697443	20883
chr19	19676560	19876560	harbor2	chr19	19698737	19698924	LTR/ERV1	1285	+	94	19698831	22271
chr19	19676560	19876560	harbor2	chr19	19701247	19701427	LTR/ERV1	1147	+	90	19701337	24777
chr19	19676560	19876560	harbor2	chr19	19701741	19701868	LTR/ERV1	1147	+	64	19701805	25245
chr19	19676560	19876560	harbor2	chr19	19709224	19709942	LTR/ERV1	3773	+	359	19709583	33023
chr19	57142619	57342619	harbor2	chr19	57172534	57172693	LTR/ERV1	1067	+	80	57172614	29995
chr19	57142619	57342619	harbor2	chr19	57172998	57173036	LTR/ERV1	1067	+	19	57173017	30398
chr19	57142619	57342619	harbor2	chr19	57181546	57181759	LTR/ERV1	4102	+	106	57181652	39033
chr19	57142619	57342619	harbor2	chr19	57182059	57182439	LTR/ERV1	4102	+	190	57182249	39630
chr19	57142619	57342619	harbor2	chr19	57187710	57187815	LTR/ERV1	726	+	52	57187762	45143
chr19	57142619	57342619	harbor2	chr19	57187817	57188147	LTR/ERV1	1898	+	165	57187982	45363
chr19	57142619	57342619	harbor2	chr19	57188349	57188639	LTR/ERV1	1333	+	145	57188494	45875
chr19	57142619	57342619	harbor2	chr19	57188802	57188920	LTR/ERV1	3128	+	59	57188861	46242
chr19	57142619	57342619	harbor2	chr19	57189229	57189661	LTR/ERV1	3128	+	216	57189445	46826
chr19	57142619	57342619	harbor2	chr19	57189954	57190017	LTR/ERV1	3128	+	32	57189986	47367
chr19	57142619	57342619	harbor2	chr19	57190020	57190109	LTR/ERV1	666	+	44	57190064	47445
chr19	57142619	57342619	harbor2	chr19	57190110	57190615	LTR/ERV1	2897	+	252	57190362	47743
chr19	57142619	57342619	harbor2	chr19	57241087	57241457	LTR/ERV1	1473	+	185	57241272	98653
chr19	6325327	6525327	harbor2	chr19	6389874	6390072	LTR/ERV1	1128	+	99	6389973	64646
chr19	6325327	6525327	harbor2	chr19	6390907	6391033	LTR/ERV1	775	+	63	6390970	65643
chr19	57140879	57340879	harbor2	chr19	57141445	57141481	LTR/ERV1	1803	+	18	57141463	584
chr19	57140879	57340879	harbor2	chr19	57141518	57141617	LTR/ERV1	1803	+	50	57141568	689
chr19	57140879	57340879	harbor2	chr19	57141864	57142137	LTR/ERV1	1803	+	136	57142000	1121
chr19	57140879	57340879	harbor2	chr19	57172534	57172693	LTR/ERV1	1067	+	80	57172614	31735
chr19	57140879	57340879	harbor2	chr19	57172998	57173036	LTR/ERV1	1067	+	19	57173017	32138
chr19	57140879	57340879	harbor2	chr19	57181546	57181759	LTR/ERV1	4102	+	106	57181652	40773
chr19	57140879	57340879	harbor2	chr19	57182059	57182439	LTR/ERV1	4102	+	190	57182249	41370
chr19	57140879	57340879	harbor2	chr19	57187710	57187815	LTR/ERV1	726	+	52	57187762	46883
chr19	57140879	57340879	harbor2	chr19	57187817	57188147	LTR/ERV1	1898	+	165	57187982	47103
chr19	57140879	57340879	harbor2	chr19	57188349	57188639	LTR/ERV1	1333	+	145	57188494	47615
chr19	57140879	57340879	harbor2	chr19	57188802	57188920	LTR/ERV1	3128	+	59	57188861	47982
chr19	57140879	57340879	harbor2	chr19	57189229	57189661	LTR/ERV1	3128	+	216	57189445	48566
chr19	57140879	57340879	harbor2	chr19	57189954	57190017	LTR/ERV1	3128	+	32	57189986	49107
chr19	57140879	57340879	harbor2	chr19	57190020	57190109	LTR/ERV1	666	+	44	57190064	49185
chr19	57140879	57340879	harbor2	chr19	57190110	57190615	LTR/ERV1	2897	+	252	57190362	49483
chr19	44008458	44208458	harbor2	chr19	44050454	44051025	LTR/ERV1	2229	+	286	44050740	42282
chr19	44008458	44208458	harbor2	chr19	44071041	44071520	LTR/ERV1	3483	+	240	44071281	62823
chr19	1353928	1553928	harbor2	chr19	1442428	1442896	LTR/ERV1	3133	+	234	1442662	88734
chr19	48095517	48295517	harbor2	chr19	48140323	48141025	LTR/ERV1	3137	+	351	48140674	45157
chr19	50276756	50476756	harbor2	chr19	50340155	50340701	LTR/ERV1	3803	+	273	50340428	63672
chr19	50276756	50476756	harbor2	chr19	50341007	50341155	LTR/ERV1	3803	+	74	50341081	64325
chr19	50276756	50476756	harbor2	chr19	50374568	50375083	LTR/ERV1	3416	+	258	50374826	98070
chr19	41689213	41889213	harbor2	chr19	41728927	41729274	LTR/ERV1	1294	+	174	41729101	39888
chr19	41689213	41889213	harbor2	chr19	41730434	41731149	LTR/ERV1	5542	+	358	41730792	41579
chr19	41689213	41889213	harbor2	chr19	41731202	41731711	LTR/ERV1	2843	+	254	41731456	42243
chr19	41689213	41889213	harbor2	chr19	41732142	41732412	LTR/ERV1	752	+	135	41732277	43064
chr19	41689213	41889213	harbor2	chr19	41767850	41768062	LTR/ERV1	763	+	106	41767956	78743
chr19	41689213	41889213	harbor2	chr19	41768838	41768941	LTR/ERV1	1627	+	52	41768890	79677
chr19	41689213	41889213	harbor2	chr19	41769245	41770124	LTR/ERV1	1627	+	440	41769685	80472
chr19	41689213	41889213	harbor2	chr19	41770581	41771297	LTR/ERV1	2939	+	358	41770939	81726
chr19	41689213	41889213	harbor2	chr19	41771342	41771925	LTR/ERV1	2274	+	292	41771634	82421
chr19	41689213	41889213	harbor2	chr19	41771968	41772234	LTR/ERV1	1000	+	133	41772101	82888
chr19	41689213	41889213	harbor2	chr19	41729515	41730138	LTR/ERV1	5542	+	312	41729827	40614
chr19	2411940	2611940	harbor2	chr19	2466283	2466324	LTR/ERV1	2162	+	20	2466303	54363
chr19	2411940	2611940	harbor2	chr19	2466617	2466859	LTR/ERV1	2162	+	121	2466738	54798
chr19	2411940	2611940	harbor2	chr19	2467172	2467463	LTR/ERV1	2162	+	146	2467318	55378
chr19	2411940	2611940	harbor2	chr19	2467794	2467916	LTR/ERV1	2162	+	61	2467855	55915
chr19	2411940	2611940	harbor2	chr19	2468381	2468417	LTR/ERV1	641	+	18	2468399	56459
chr19	18494879	18694879	harbor2	chr19	18577268	18577575	LTR/ERV1	1065	+	154	18577422	82543
chr19	18494879	18694879	harbor2	chr19	18577591	18578035	LTR/ERV1	1497	+	222	18577813	82934
chr19	18494879	18694879	harbor2	chr19	18581897	18583776	LTR/ERV1	23217	+	940	18582837	87958
chr19	18494879	18694879	harbor2	chr19	18584075	18584685	LTR/ERV1	23217	+	305	18584380	89501
chr19	18494879	18694879	harbor2	chr19	18586601	18587182	LTR/ERV1	1306	+	290	18586891	92012
chr19	18494879	18694879	harbor2	chr19	18587630	18587911	LTR/ERV1	1140	+	140	18587770	92891
chr19	18494879	18694879	harbor2	chr19	18578706	18581619	LTR/ERV1	23217	+	1456	18580162	85283
chr19	38799487	38999487	harbor2	chr19	38821337	38823305	LTR/ERV1	9317	+	984	38822321	22834
chr19	38799487	38999487	harbor2	chr19	38823306	38827018	LTR/ERV1	22257	+	1856	38825162	25675
chr19	38799487	38999487	harbor2	chr19	38863197	38863556	LTR/ERV1	1105	+	180	38863377	63890
chr19	38799487	38999487	harbor2	chr19	38863867	38863974	LTR/ERV1	1105	+	54	38863921	64434
chr19	38799487	38999487	harbor2	chr19	38864287	38864376	LTR/ERV1	981	+	44	38864331	64844
chr19	49292104	49492104	harbor2	chr19	49303697	49304169	LTR/ERV1	1798	+	236	49303933	11829
chr19	49292104	49492104	harbor2	chr19	49304170	49304482	LTR/ERV1	1789	+	156	49304326	12222
chr19	49292104	49492104	harbor2	chr19	49368647	49369242	LTR/ERV1	3346	+	298	49368945	76841
chr19	5522865	5722865	harbor2	chr19	5548576	5549016	LTR/ERV1	3815	+	220	5548796	25931
chr19	5522865	5722865	harbor2	chr19	5549017	5551892	LTR/ERV1	15423	+	1438	5550455	27590
chr19	5522865	5722865	harbor2	chr19	5551872	5552016	LTR/ERV1	835	+	72	5551944	29079
chr19	5522865	5722865	harbor2	chr19	5552007	5552168	LTR/ERV1	1037	+	80	5552087	29222
chr19	5522865	5722865	harbor2	chr19	5552161	5552771	LTR/ERV1	4429	+	305	5552466	29601
chr19	5522865	5722865	harbor2	chr19	5552772	5553212	LTR/ERV1	3809	+	220	5552992	30127
chr19	1961575	2161575	harbor2	chr19	2003806	2004288	LTR/ERV1	2822	+	241	2004047	42472
chr19	1961575	2161575	harbor2	chr19	2004597	2004653	LTR/ERV1	2822	+	28	2004625	43050
chr19	1961575	2161575	harbor2	chr19	2024555	2024763	LTR/ERV1	1095	+	104	2024659	63084
chr19	5523143	5723143	harbor2	chr19	5548576	5549016	LTR/ERV1	3815	+	220	5548796	25653
chr19	5523143	5723143	harbor2	chr19	5549017	5551892	LTR/ERV1	15423	+	1438	5550455	27312
chr19	5523143	5723143	harbor2	chr19	5551872	5552016	LTR/ERV1	835	+	72	5551944	28801
chr19	5523143	5723143	harbor2	chr19	5552007	5552168	LTR/ERV1	1037	+	80	5552087	28944
chr19	5523143	5723143	harbor2	chr19	5552161	5552771	LTR/ERV1	4429	+	305	5552466	29323
chr19	5523143	5723143	harbor2	chr19	5552772	5553212	LTR/ERV1	3809	+	220	5552992	29849
chr19	19676585	19876585	harbor2	chr19	19697161	19697725	LTR/ERV1	3767	+	282	19697443	20858
chr19	19676585	19876585	harbor2	chr19	19698737	19698924	LTR/ERV1	1285	+	94	19698831	22246
chr19	19676585	19876585	harbor2	chr19	19701247	19701427	LTR/ERV1	1147	+	90	19701337	24752
chr19	19676585	19876585	harbor2	chr19	19701741	19701868	LTR/ERV1	1147	+	64	19701805	25220
chr19	19676585	19876585	harbor2	chr19	19709224	19709942	LTR/ERV1	3773	+	359	19709583	32998
chr19	5522817	5722817	harbor2	chr19	5548576	5549016	LTR/ERV1	3815	+	220	5548796	25979
chr19	5522817	5722817	harbor2	chr19	5549017	5551892	LTR/ERV1	15423	+	1438	5550455	27638
chr19	5522817	5722817	harbor2	chr19	5551872	5552016	LTR/ERV1	835	+	72	5551944	29127
chr19	5522817	5722817	harbor2	chr19	5552007	5552168	LTR/ERV1	1037	+	80	5552087	29270
chr19	5522817	5722817	harbor2	chr19	5552161	5552771	LTR/ERV1	4429	+	305	5552466	29649
chr19	5522817	5722817	harbor2	chr19	5552772	5553212	LTR/ERV1	3809	+	220	5552992	30175
chr19	39408221	39608221	harbor2	chr19	39493404	39493821	LTR/ERV1	2601	+	208	39493612	85391
chr19	56021006	56221006	harbor2	chr19	56078017	56078243	LTR/ERV1	1152	+	113	56078130	57124
chr19	35543573	35743573	harbor2	chr19	35578890	35579252	LTR/ERV1	2511	+	181	35579071	35498
chr19	35543573	35743573	harbor2	chr19	35604596	35604970	LTR/ERV1	1792	+	187	35604783	61210
chr19	35543573	35743573	harbor2	chr19	35604971	35605415	LTR/ERV1	3078	+	222	35605193	61620
chr19	35543573	35743573	harbor2	chr19	35605725	35605975	LTR/ERV1	3078	+	125	35605850	62277
chr19	35543573	35743573	harbor2	chr19	35606347	35606371	LTR/ERV1	3078	+	12	35606359	62786
chr19	35543573	35743573	harbor2	chr19	35628109	35628305	LTR/ERV1	1308	+	98	35628207	84634
chr19	5522852	5722852	harbor2	chr19	5548576	5549016	LTR/ERV1	3815	+	220	5548796	25944
chr19	5522852	5722852	harbor2	chr19	5549017	5551892	LTR/ERV1	15423	+	1438	5550455	27603
chr19	5522852	5722852	harbor2	chr19	5551872	5552016	LTR/ERV1	835	+	72	5551944	29092
chr19	5522852	5722852	harbor2	chr19	5552007	5552168	LTR/ERV1	1037	+	80	5552087	29235
chr19	5522852	5722852	harbor2	chr19	5552161	5552771	LTR/ERV1	4429	+	305	5552466	29614
chr19	5522852	5722852	harbor2	chr19	5552772	5553212	LTR/ERV1	3809	+	220	5552992	30140
chr19	56021023	56221023	harbor2	chr19	56078017	56078243	LTR/ERV1	1152	+	113	56078130	57107
chr19	57180316	57380316	harbor2	chr19	57181546	57181759	LTR/ERV1	4102	+	106	57181652	1336
chr19	57180316	57380316	harbor2	chr19	57182059	57182439	LTR/ERV1	4102	+	190	57182249	1933
chr19	57180316	57380316	harbor2	chr19	57187710	57187815	LTR/ERV1	726	+	52	57187762	7446
chr19	57180316	57380316	harbor2	chr19	57187817	57188147	LTR/ERV1	1898	+	165	57187982	7666
chr19	57180316	57380316	harbor2	chr19	57188349	57188639	LTR/ERV1	1333	+	145	57188494	8178
chr19	57180316	57380316	harbor2	chr19	57188802	57188920	LTR/ERV1	3128	+	59	57188861	8545
chr19	57180316	57380316	harbor2	chr19	57189229	57189661	LTR/ERV1	3128	+	216	57189445	9129
chr19	57180316	57380316	harbor2	chr19	57189954	57190017	LTR/ERV1	3128	+	32	57189986	9670
chr19	57180316	57380316	harbor2	chr19	57190020	57190109	LTR/ERV1	666	+	44	57190064	9748
chr19	57180316	57380316	harbor2	chr19	57190110	57190615	LTR/ERV1	2897	+	252	57190362	10046
chr19	57180316	57380316	harbor2	chr19	57241087	57241457	LTR/ERV1	1473	+	185	57241272	60956
chr19	57180316	57380316	harbor2	chr19	57267561	57268198	LTR/ERV1	3377	+	318	57267879	87563
chr19	57180316	57380316	harbor2	chr19	57268501	57268611	LTR/ERV1	3377	+	55	57268556	88240
chr19	19952301	20152301	harbor2	chr19	19953170	19953372	LTR/ERV1	1313	+	101	19953271	970
chr19	19952301	20152301	harbor2	chr19	19953662	19954016	LTR/ERV1	1313	+	177	19953839	1538
chr19	19952301	20152301	harbor2	chr19	19966687	19967138	LTR/ERV1	2450	+	226	19966913	14612
chr19	19952301	20152301	harbor2	chr19	19999338	19999524	LTR/ERV1	753	+	93	19999431	47130
chr19	19952301	20152301	harbor2	chr19	20038498	20038994	LTR/ERV1	2431	+	248	20038746	86445
chr19	19952301	20152301	harbor2	chr19	20045618	20046114	LTR/ERV1	3887	+	248	20045866	93565
chr19	19952301	20152301	harbor2	chr19	20047947	20048375	LTR/ERV1	1739	+	214	20048161	95860
chr19	19676523	19876523	harbor2	chr19	19697161	19697725	LTR/ERV1	3767	+	282	19697443	20920
chr19	19676523	19876523	harbor2	chr19	19698737	19698924	LTR/ERV1	1285	+	94	19698831	22308
chr19	19676523	19876523	harbor2	chr19	19701247	19701427	LTR/ERV1	1147	+	90	19701337	24814
chr19	19676523	19876523	harbor2	chr19	19701741	19701868	LTR/ERV1	1147	+	64	19701805	25282
chr19	19676523	19876523	harbor2	chr19	19709224	19709942	LTR/ERV1	3773	+	359	19709583	33060
chr19	2115939	2315939	harbor2	chr19	2162915	2163048	LTR/ERV1	998	+	66	2162981	47042
chr19	2115939	2315939	harbor2	chr19	2169666	2169818	LTR/ERV1	770	+	76	2169742	53803
chr19	5522878	5722878	harbor2	chr19	5548576	5549016	LTR/ERV1	3815	+	220	5548796	25918
chr19	5522878	5722878	harbor2	chr19	5549017	5551892	LTR/ERV1	15423	+	1438	5550455	27577
chr19	5522878	5722878	harbor2	chr19	5551872	5552016	LTR/ERV1	835	+	72	5551944	29066
chr19	5522878	5722878	harbor2	chr19	5552007	5552168	LTR/ERV1	1037	+	80	5552087	29209
chr19	5522878	5722878	harbor2	chr19	5552161	5552771	LTR/ERV1	4429	+	305	5552466	29588
chr19	5522878	5722878	harbor2	chr19	5552772	5553212	LTR/ERV1	3809	+	220	5552992	30114
chr19	5523688	5723688	harbor2	chr19	5548576	5549016	LTR/ERV1	3815	+	220	5548796	25108
chr19	5523688	5723688	harbor2	chr19	5549017	5551892	LTR/ERV1	15423	+	1438	5550455	26767
chr19	5523688	5723688	harbor2	chr19	5551872	5552016	LTR/ERV1	835	+	72	5551944	28256
chr19	5523688	5723688	harbor2	chr19	5552007	5552168	LTR/ERV1	1037	+	80	5552087	28399
chr19	5523688	5723688	harbor2	chr19	5552161	5552771	LTR/ERV1	4429	+	305	5552466	28778
chr19	5523688	5723688	harbor2	chr19	5552772	5553212	LTR/ERV1	3809	+	220	5552992	29304
chr19	18841143	19041143	harbor2	chr19	18875562	18875727	LTR/ERV1	882	+	82	18875644	34501
chr19	18841143	19041143	harbor2	chr19	18917279	18917364	LTR/ERV1	3754	+	42	18917321	76178
chr19	18841143	19041143	harbor2	chr19	18917663	18917908	LTR/ERV1	3754	+	122	18917785	76642
chr19	18841143	19041143	harbor2	chr19	18918218	18918469	LTR/ERV1	3754	+	126	18918344	77201
chr19	1414039	1614039	harbor2	chr19	1442428	1442896	LTR/ERV1	3133	+	234	1442662	28623
chr19	1413304	1613304	harbor2	chr19	1442428	1442896	LTR/ERV1	3133	+	234	1442662	29358
chr19	5523194	5723194	harbor2	chr19	5548576	5549016	LTR/ERV1	3815	+	220	5548796	25602
chr19	5523194	5723194	harbor2	chr19	5549017	5551892	LTR/ERV1	15423	+	1438	5550455	27261
chr19	5523194	5723194	harbor2	chr19	5551872	5552016	LTR/ERV1	835	+	72	5551944	28750
chr19	5523194	5723194	harbor2	chr19	5552007	5552168	LTR/ERV1	1037	+	80	5552087	28893
chr19	5523194	5723194	harbor2	chr19	5552161	5552771	LTR/ERV1	4429	+	305	5552466	29272
chr19	5523194	5723194	harbor2	chr19	5552772	5553212	LTR/ERV1	3809	+	220	5552992	29798
chr19	559668	759668	harbor2	chr19	571083	571344	LTR/ERV1	999	+	130	571213	11545
chr19	57180327	57380327	harbor2	chr19	57181546	57181759	LTR/ERV1	4102	+	106	57181652	1325
chr19	57180327	57380327	harbor2	chr19	57182059	57182439	LTR/ERV1	4102	+	190	57182249	1922
chr19	57180327	57380327	harbor2	chr19	57187710	57187815	LTR/ERV1	726	+	52	57187762	7435
chr19	57180327	57380327	harbor2	chr19	57187817	57188147	LTR/ERV1	1898	+	165	57187982	7655
chr19	57180327	57380327	harbor2	chr19	57188349	57188639	LTR/ERV1	1333	+	145	57188494	8167
chr19	57180327	57380327	harbor2	chr19	57188802	57188920	LTR/ERV1	3128	+	59	57188861	8534
chr19	57180327	57380327	harbor2	chr19	57189229	57189661	LTR/ERV1	3128	+	216	57189445	9118
chr19	57180327	57380327	harbor2	chr19	57189954	57190017	LTR/ERV1	3128	+	32	57189986	9659
chr19	57180327	57380327	harbor2	chr19	57190020	57190109	LTR/ERV1	666	+	44	57190064	9737
chr19	57180327	57380327	harbor2	chr19	57190110	57190615	LTR/ERV1	2897	+	252	57190362	10035
chr19	57180327	57380327	harbor2	chr19	57241087	57241457	LTR/ERV1	1473	+	185	57241272	60945
chr19	57180327	57380327	harbor2	chr19	57267561	57268198	LTR/ERV1	3377	+	318	57267879	87552
chr19	57180327	57380327	harbor2	chr19	57268501	57268611	LTR/ERV1	3377	+	55	57268556	88229
chr19	19676599	19876599	harbor2	chr19	19697161	19697725	LTR/ERV1	3767	+	282	19697443	20844
chr19	19676599	19876599	harbor2	chr19	19698737	19698924	LTR/ERV1	1285	+	94	19698831	22232
chr19	19676599	19876599	harbor2	chr19	19701247	19701427	LTR/ERV1	1147	+	90	19701337	24738
chr19	19676599	19876599	harbor2	chr19	19701741	19701868	LTR/ERV1	1147	+	64	19701805	25206
chr19	19676599	19876599	harbor2	chr19	19709224	19709942	LTR/ERV1	3773	+	359	19709583	32984
chr19	19676579	19876579	harbor2	chr19	19697161	19697725	LTR/ERV1	3767	+	282	19697443	20864
chr19	19676579	19876579	harbor2	chr19	19698737	19698924	LTR/ERV1	1285	+	94	19698831	22252
chr19	19676579	19876579	harbor2	chr19	19701247	19701427	LTR/ERV1	1147	+	90	19701337	24758
chr19	19676579	19876579	harbor2	chr19	19701741	19701868	LTR/ERV1	1147	+	64	19701805	25226
chr19	19676579	19876579	harbor2	chr19	19709224	19709942	LTR/ERV1	3773	+	359	19709583	33004
chr19	21364049	21564049	harbor2	chr19	21389642	21390352	LTR/ERV1	4203	+	355	21389997	25948
chr19	21364049	21564049	harbor2	chr19	21462337	21462708	LTR/ERV1	1881	+	186	21462523	98474
chr19	21364049	21564049	harbor2	chr19	21463378	21463449	LTR/ERV1	1881	+	36	21463414	99365
chr19	21364049	21564049	harbor2	chr19	21463005	21463067	LTR/ERV1	1881	+	31	21463036	98987
chr19	58394774	58594774	harbor2	chr19	58460025	58460629	LTR/ERV1	1012	+	302	58460327	65553
chr19	58394774	58594774	harbor2	chr19	58460626	58460686	LTR/ERV1	3219	+	30	58460656	65882
chr19	58394774	58594774	harbor2	chr19	58460987	58461867	LTR/ERV1	3219	+	440	58461427	66653
chr19	58394774	58594774	harbor2	chr19	58462175	58462224	LTR/ERV1	3219	+	24	58462199	67425
chr19	58394774	58594774	harbor2	chr19	58488940	58489636	LTR/ERV1	5160	+	348	58489288	94514
chr19	53779492	53979492	harbor2	chr19	53780548	53780872	LTR/ERV1	963	+	162	53780710	1218
chr19	53779492	53979492	harbor2	chr19	53831404	53831854	LTR/ERV1	3444	+	225	53831629	52137
chr19	53779492	53979492	harbor2	chr19	53831857	53835005	LTR/ERV1	10019	+	1574	53833431	53939
chr19	53779492	53979492	harbor2	chr19	53835000	53835146	LTR/ERV1	834	+	73	53835073	55581
chr19	53779492	53979492	harbor2	chr19	53835137	53835639	LTR/ERV1	3350	+	251	53835388	55896
chr19	53779492	53979492	harbor2	chr19	53835642	53836300	LTR/ERV1	4125	+	329	53835971	56479
chr19	53779492	53979492	harbor2	chr19	53836302	53836519	LTR/ERV1	1355	+	108	53836410	56918
chr19	53779492	53979492	harbor2	chr19	53836518	53836897	LTR/ERV1	2441	+	190	53836708	57216
chr19	53779492	53979492	harbor2	chr19	53836898	53837348	LTR/ERV1	3616	+	225	53837123	57631
chr19	53779492	53979492	harbor2	chr19	53845912	53846067	LTR/ERV1	851	+	78	53845990	66498
chr19	5523154	5723154	harbor2	chr19	5548576	5549016	LTR/ERV1	3815	+	220	5548796	25642
chr19	5523154	5723154	harbor2	chr19	5549017	5551892	LTR/ERV1	15423	+	1438	5550455	27301
chr19	5523154	5723154	harbor2	chr19	5551872	5552016	LTR/ERV1	835	+	72	5551944	28790
chr19	5523154	5723154	harbor2	chr19	5552007	5552168	LTR/ERV1	1037	+	80	5552087	28933
chr19	5523154	5723154	harbor2	chr19	5552161	5552771	LTR/ERV1	4429	+	305	5552466	29312
chr19	5523154	5723154	harbor2	chr19	5552772	5553212	LTR/ERV1	3809	+	220	5552992	29838
chr19	32575222	32775222	harbor2	chr19	32637511	32639028	LTR/ERV1	7304	+	758	32638269	63047
chr19	1373466	1573466	harbor2	chr19	1442428	1442896	LTR/ERV1	3133	+	234	1442662	69196
chr19	5522826	5722826	harbor2	chr19	5548576	5549016	LTR/ERV1	3815	+	220	5548796	25970
chr19	5522826	5722826	harbor2	chr19	5549017	5551892	LTR/ERV1	15423	+	1438	5550455	27629
chr19	5522826	5722826	harbor2	chr19	5551872	5552016	LTR/ERV1	835	+	72	5551944	29118
chr19	5522826	5722826	harbor2	chr19	5552007	5552168	LTR/ERV1	1037	+	80	5552087	29261
chr19	5522826	5722826	harbor2	chr19	5552161	5552771	LTR/ERV1	4429	+	305	5552466	29640
chr19	5522826	5722826	harbor2	chr19	5552772	5553212	LTR/ERV1	3809	+	220	5552992	30166
chr19	39746502	39946502	harbor2	chr19	39756142	39756642	LTR/ERV1	2409	+	250	39756392	9890
chr19	39746502	39946502	harbor2	chr19	39768270	39768586	LTR/ERV1	1963	+	158	39768428	21926
chr19	39746502	39946502	harbor2	chr19	39772200	39772648	LTR/ERV1	1562	+	224	39772424	25922
chr19	32997991	33197991	harbor2	chr19	33035599	33035834	LTR/ERV1	1861	+	118	33035717	37726
chr19	32997991	33197991	harbor2	chr19	33036146	33036186	LTR/ERV1	1861	+	20	33036166	38175
chr19	32997991	33197991	harbor2	chr19	33036456	33037857	LTR/ERV1	10276	+	700	33037156	39165
chr19	48648417	48848417	harbor2	chr19	48682639	48682698	LTR/ERV1	2979	+	30	48682669	34252
chr19	48648417	48848417	harbor2	chr19	48683315	48683862	LTR/ERV1	2979	+	274	48683589	35172
chr19	35168137	35368137	harbor2	chr19	35194037	35194522	LTR/ERV1	2524	+	242	35194279	26142
chr19	35168137	35368137	harbor2	chr19	35198143	35198334	LTR/ERV1	1037	+	96	35198239	30102
chr19	35168137	35368137	harbor2	chr19	35214946	35215467	LTR/ERV1	3923	+	260	35215206	47069
chr19	35168137	35368137	harbor2	chr19	35220609	35221116	LTR/ERV1	3036	+	254	35220863	52726
chr19	5620309	5820309	harbor2	chr19	5675497	5675810	LTR/ERV1	1837	+	156	5675653	55344
chr19	18831516	19031516	harbor2	chr19	18875562	18875727	LTR/ERV1	882	+	82	18875644	44128
chr19	18831516	19031516	harbor2	chr19	18917279	18917364	LTR/ERV1	3754	+	42	18917321	85805
chr19	18831516	19031516	harbor2	chr19	18917663	18917908	LTR/ERV1	3754	+	122	18917785	86269
chr19	18831516	19031516	harbor2	chr19	18918218	18918469	LTR/ERV1	3754	+	126	18918344	86828
chr19	58399501	58599501	harbor2	chr19	58460025	58460629	LTR/ERV1	1012	+	302	58460327	60826
chr19	58399501	58599501	harbor2	chr19	58460626	58460686	LTR/ERV1	3219	+	30	58460656	61155
chr19	58399501	58599501	harbor2	chr19	58460987	58461867	LTR/ERV1	3219	+	440	58461427	61926
chr19	58399501	58599501	harbor2	chr19	58462175	58462224	LTR/ERV1	3219	+	24	58462199	62698
chr19	58399501	58599501	harbor2	chr19	58488940	58489636	LTR/ERV1	5160	+	348	58489288	89787
chr19	1413284	1613284	harbor2	chr19	1442428	1442896	LTR/ERV1	3133	+	234	1442662	29378
chr19	45378520	45578520	harbor2	chr19	45390230	45390717	LTR/ERV1	3880	+	244	45390474	11954
chr19	28840757	29040757	harbor2	chr19	28862299	28862652	LTR/ERV1	1658	+	176	28862475	21718
chr19	28840757	29040757	harbor2	chr19	28880916	28881480	LTR/ERV1	2204	+	282	28881198	40441
chr19	28840757	29040757	harbor2	chr19	28933003	28933467	LTR/ERV1	2460	+	232	28933235	92478
chr19	51827594	52027594	harbor2	chr19	51841026	51841382	LTR/ERV1	1793	+	178	51841204	13610
chr19	51827594	52027594	harbor2	chr19	51892764	51893376	LTR/ERV1	2390	+	306	51893070	65476
chr19	51827594	52027594	harbor2	chr19	51903831	51903863	LTR/ERV1	1095	+	16	51903847	76253
chr19	51827594	52027594	harbor2	chr19	51903864	51904282	LTR/ERV1	2838	+	209	51904073	76479
chr19	51827594	52027594	harbor2	chr19	51904283	51904415	LTR/ERV1	1095	+	66	51904349	76755
chr19	51827594	52027594	harbor2	chr19	51910107	51910483	LTR/ERV1	2282	+	188	51910295	82701
chr19	19676552	19876552	harbor2	chr19	19697161	19697725	LTR/ERV1	3767	+	282	19697443	20891
chr19	19676552	19876552	harbor2	chr19	19698737	19698924	LTR/ERV1	1285	+	94	19698831	22279
chr19	19676552	19876552	harbor2	chr19	19701247	19701427	LTR/ERV1	1147	+	90	19701337	24785
chr19	19676552	19876552	harbor2	chr19	19701741	19701868	LTR/ERV1	1147	+	64	19701805	25253
chr19	19676552	19876552	harbor2	chr19	19709224	19709942	LTR/ERV1	3773	+	359	19709583	33031
chr19	23929751	24129751	harbor2	chr19	23947083	23947517	LTR/ERV1	3698	+	217	23947300	17549
chr19	23929751	24129751	harbor2	chr19	23947540	23947826	LTR/ERV1	2328	+	143	23947683	17932
chr19	23929751	24129751	harbor2	chr19	23947827	23948150	LTR/ERV1	2732	+	162	23947989	18238
chr19	23929751	24129751	harbor2	chr19	23949476	23949692	LTR/ERV1	869	+	108	23949584	19833
chr19	23929751	24129751	harbor2	chr19	24008653	24008886	LTR/ERV1	1192	+	116	24008769	79018
chr19	23929751	24129751	harbor2	chr19	24009203	24009541	LTR/ERV1	1192	+	169	24009372	79621
chr19	23929751	24129751	harbor2	chr19	24019766	24020099	LTR/ERV1	1658	+	166	24019932	90181
chr19	492364	692364	harbor2	chr19	504984	505370	LTR/ERV1	1805	+	193	505177	12813
chr19	492364	692364	harbor2	chr19	571083	571344	LTR/ERV1	999	+	130	571213	78849
chr19	5522874	5722874	harbor2	chr19	5548576	5549016	LTR/ERV1	3815	+	220	5548796	25922
chr19	5522874	5722874	harbor2	chr19	5549017	5551892	LTR/ERV1	15423	+	1438	5550455	27581
chr19	5522874	5722874	harbor2	chr19	5551872	5552016	LTR/ERV1	835	+	72	5551944	29070
chr19	5522874	5722874	harbor2	chr19	5552007	5552168	LTR/ERV1	1037	+	80	5552087	29213
chr19	5522874	5722874	harbor2	chr19	5552161	5552771	LTR/ERV1	4429	+	305	5552466	29592
chr19	5522874	5722874	harbor2	chr19	5552772	5553212	LTR/ERV1	3809	+	220	5552992	30118
chr19	19952302	20152302	harbor2	chr19	19953170	19953372	LTR/ERV1	1313	+	101	19953271	969
chr19	19952302	20152302	harbor2	chr19	19953662	19954016	LTR/ERV1	1313	+	177	19953839	1537
chr19	19952302	20152302	harbor2	chr19	19966687	19967138	LTR/ERV1	2450	+	226	19966913	14611
chr19	19952302	20152302	harbor2	chr19	19999338	19999524	LTR/ERV1	753	+	93	19999431	47129
chr19	19952302	20152302	harbor2	chr19	20038498	20038994	LTR/ERV1	2431	+	248	20038746	86444
chr19	19952302	20152302	harbor2	chr19	20045618	20046114	LTR/ERV1	3887	+	248	20045866	93564
chr19	19952302	20152302	harbor2	chr19	20047947	20048375	LTR/ERV1	1739	+	214	20048161	95859
chr19	19676583	19876583	harbor2	chr19	19697161	19697725	LTR/ERV1	3767	+	282	19697443	20860
chr19	19676583	19876583	harbor2	chr19	19698737	19698924	LTR/ERV1	1285	+	94	19698831	22248
chr19	19676583	19876583	harbor2	chr19	19701247	19701427	LTR/ERV1	1147	+	90	19701337	24754
chr19	19676583	19876583	harbor2	chr19	19701741	19701868	LTR/ERV1	1147	+	64	19701805	25222
chr19	19676583	19876583	harbor2	chr19	19709224	19709942	LTR/ERV1	3773	+	359	19709583	33000
chr19	43363366	43563366	harbor2	chr19	43382950	43383131	LTR/ERV1	2947	+	90	43383040	19674
chr19	43363366	43563366	harbor2	chr19	43383434	43383737	LTR/ERV1	2947	+	152	43383586	20220
chr19	43363366	43563366	harbor2	chr19	43388276	43388887	LTR/ERV1	3199	+	306	43388582	25216
chr19	43363366	43563366	harbor2	chr19	43398839	43399046	LTR/ERV1	727	+	104	43398943	35577
chr19	43363366	43563366	harbor2	chr19	43412858	43413225	LTR/ERV1	3515	+	184	43413042	49676
chr19	43363366	43563366	harbor2	chr19	43413512	43413640	LTR/ERV1	3515	+	64	43413576	50210
chr19	43363366	43563366	harbor2	chr19	43420392	43420770	LTR/ERV1	3166	+	189	43420581	57215
chr19	43363366	43563366	harbor2	chr19	43421062	43421267	LTR/ERV1	3166	+	102	43421164	57798
chr19	43363366	43563366	harbor2	chr19	43421574	43421703	LTR/ERV1	3166	+	64	43421638	58272
chr19	43363366	43563366	harbor2	chr19	43423697	43423960	LTR/ERV1	3171	+	132	43423829	60463
chr19	43363366	43563366	harbor2	chr19	43424291	43424425	LTR/ERV1	3171	+	67	43424358	60992
chr19	43363366	43563366	harbor2	chr19	43424714	43424896	LTR/ERV1	3171	+	91	43424805	61439
chr19	43363366	43563366	harbor2	chr19	43425932	43426466	LTR/ERV1	3406	+	267	43426199	62833
chr19	43363366	43563366	harbor2	chr19	43445526	43445937	LTR/ERV1	1299	+	206	43445732	82366
chr19	43363366	43563366	harbor2	chr19	43448280	43448528	LTR/ERV1	1344	+	124	43448404	85038
chr19	19676557	19876557	harbor2	chr19	19697161	19697725	LTR/ERV1	3767	+	282	19697443	20886
chr19	19676557	19876557	harbor2	chr19	19698737	19698924	LTR/ERV1	1285	+	94	19698831	22274
chr19	19676557	19876557	harbor2	chr19	19701247	19701427	LTR/ERV1	1147	+	90	19701337	24780
chr19	19676557	19876557	harbor2	chr19	19701741	19701868	LTR/ERV1	1147	+	64	19701805	25248
chr19	19676557	19876557	harbor2	chr19	19709224	19709942	LTR/ERV1	3773	+	359	19709583	33026
chr19	13954255	14154255	harbor2	chr19	14009261	14009418	LTR/ERV1	3338	+	78	14009339	55084
chr19	13954255	14154255	harbor2	chr19	14010049	14010300	LTR/ERV1	3338	+	126	14010175	55920
chr19	13954255	14154255	harbor2	chr19	14010598	14010679	LTR/ERV1	3338	+	40	14010638	56383
chr19	13954255	14154255	harbor2	chr19	14010983	14011054	LTR/ERV1	3338	+	36	14011019	56764
chr19	56021025	56221025	harbor2	chr19	56078017	56078243	LTR/ERV1	1152	+	113	56078130	57105
chr19	39542549	39742549	harbor2	chr19	39546714	39547161	LTR/ERV1	2060	+	224	39546938	4389
chr19	1353982	1553982	harbor2	chr19	1442428	1442896	LTR/ERV1	3133	+	234	1442662	88680
chr19	209125	409125	harbor2	chr19	248926	249489	LTR/ERV1	2774	+	282	249208	40083
chr19	209125	409125	harbor2	chr19	249896	250542	LTR/ERV1	3843	+	323	250219	41094
chr19	209125	409125	harbor2	chr19	250843	250895	LTR/ERV1	3843	+	26	250869	41744
chr19	209125	409125	harbor2	chr19	251296	251631	LTR/ERV1	915	+	168	251464	42339
chr19	209125	409125	harbor2	chr19	251757	251970	LTR/ERV1	638	+	106	251863	42738
chr19	209125	409125	harbor2	chr19	253201	253501	LTR/ERV1	1364	+	150	253351	44226
chr19	209125	409125	harbor2	chr19	256874	257318	LTR/ERV1	3028	+	222	257096	47971
chr19	209125	409125	harbor2	chr19	259804	259982	LTR/ERV1	929	+	89	259893	50768
chr19	209125	409125	harbor2	chr19	260066	260323	LTR/ERV1	1615	+	128	260194	51069
chr19	209125	409125	harbor2	chr19	261009	261371	LTR/ERV1	2596	+	181	261190	52065
chr19	209125	409125	harbor2	chr19	264918	265507	LTR/ERV1	4735	+	294	265212	56087
chr19	209125	409125	harbor2	chr19	262136	262375	LTR/ERV1	1219	+	120	262256	53131
chr19	7669079	7869079	harbor2	chr19	7748833	7749280	LTR/ERV1	3196	+	224	7749057	79978
chr19	7669079	7869079	harbor2	chr19	7750163	7750275	LTR/ERV1	3196	+	56	7750219	81140
chr19	7669079	7869079	harbor2	chr19	7751539	7752014	LTR/ERV1	2015	+	238	7751777	82698
chr19	7669079	7869079	harbor2	chr19	7752319	7752448	LTR/ERV1	2015	+	64	7752383	83304
chr19	5524144	5724144	harbor2	chr19	5548576	5549016	LTR/ERV1	3815	+	220	5548796	24652
chr19	5524144	5724144	harbor2	chr19	5549017	5551892	LTR/ERV1	15423	+	1438	5550455	26311
chr19	5524144	5724144	harbor2	chr19	5551872	5552016	LTR/ERV1	835	+	72	5551944	27800
chr19	5524144	5724144	harbor2	chr19	5552007	5552168	LTR/ERV1	1037	+	80	5552087	27943
chr19	5524144	5724144	harbor2	chr19	5552161	5552771	LTR/ERV1	4429	+	305	5552466	28322
chr19	5524144	5724144	harbor2	chr19	5552772	5553212	LTR/ERV1	3809	+	220	5552992	28848
chr19	2356863	2556863	harbor2	chr19	2392568	2393567	LTR/ERV1	5125	+	500	2393068	36205
chr19	51511611	51711611	harbor2	chr19	51547800	51548367	LTR/ERV1	3777	+	284	51548084	36473
chr19	51511611	51711611	harbor2	chr19	51598979	51599473	LTR/ERV1	3173	+	247	51599226	87615
chr19	18583553	18783553	harbor2	chr19	18581897	18583776	LTR/ERV1	23217	+	940	18582837	716
chr19	18583553	18783553	harbor2	chr19	18584075	18584685	LTR/ERV1	23217	+	305	18584380	827
chr19	18583553	18783553	harbor2	chr19	18586601	18587182	LTR/ERV1	1306	+	290	18586891	3338
chr19	18583553	18783553	harbor2	chr19	18587630	18587911	LTR/ERV1	1140	+	140	18587770	4217
chr19	5522863	5722863	harbor2	chr19	5548576	5549016	LTR/ERV1	3815	+	220	5548796	25933
chr19	5522863	5722863	harbor2	chr19	5549017	5551892	LTR/ERV1	15423	+	1438	5550455	27592
chr19	5522863	5722863	harbor2	chr19	5551872	5552016	LTR/ERV1	835	+	72	5551944	29081
chr19	5522863	5722863	harbor2	chr19	5552007	5552168	LTR/ERV1	1037	+	80	5552087	29224
chr19	5522863	5722863	harbor2	chr19	5552161	5552771	LTR/ERV1	4429	+	305	5552466	29603
chr19	5522863	5722863	harbor2	chr19	5552772	5553212	LTR/ERV1	3809	+	220	5552992	30129
chr19	19690415	19890415	harbor2	chr19	19697161	19697725	LTR/ERV1	3767	+	282	19697443	7028
chr19	19690415	19890415	harbor2	chr19	19698737	19698924	LTR/ERV1	1285	+	94	19698831	8416
chr19	19690415	19890415	harbor2	chr19	19701247	19701427	LTR/ERV1	1147	+	90	19701337	10922
chr19	19690415	19890415	harbor2	chr19	19701741	19701868	LTR/ERV1	1147	+	64	19701805	11390
chr19	19690415	19890415	harbor2	chr19	19709224	19709942	LTR/ERV1	3773	+	359	19709583	19168
chr19	48070658	48270658	harbor2	chr19	48140323	48141025	LTR/ERV1	3137	+	351	48140674	70016
chr19	30129779	30329779	harbor2	chr19	30160052	30160580	LTR/ERV1	2946	+	264	30160316	30537
chr19	30129779	30329779	harbor2	chr19	30176414	30177006	LTR/ERV1	3284	+	296	30176710	46931
chr19	58102901	58302901	harbor2	chr19	58148898	58149437	LTR/ERV1	3839	+	270	58149168	46267
chr19	58102901	58302901	harbor2	chr19	58157128	58158413	LTR/ERV1	8079	+	642	58157770	54869
chr19	5620484	5820484	harbor2	chr19	5675497	5675810	LTR/ERV1	1837	+	156	5675653	55169
chr19	10914491	11114491	harbor2	chr19	10939623	10939922	LTR/ERV1	1428	+	150	10939773	25282
chr19	10914491	11114491	harbor2	chr19	10940074	10940210	LTR/ERV1	787	+	68	10940142	25651
chr19	2117209	2317209	harbor2	chr19	2162915	2163048	LTR/ERV1	998	+	66	2162981	45772
chr19	2117209	2317209	harbor2	chr19	2169666	2169818	LTR/ERV1	770	+	76	2169742	52533
chr19	523927	723927	harbor2	chr19	571083	571344	LTR/ERV1	999	+	130	571213	47286
chr19	2130923	2330923	harbor2	chr19	2162915	2163048	LTR/ERV1	998	+	66	2162981	32058
chr19	2130923	2330923	harbor2	chr19	2169666	2169818	LTR/ERV1	770	+	76	2169742	38819
chr19	48865977	49065977	harbor2	chr19	48882278	48882395	LTR/ERV1	819	+	58	48882336	16359
chr19	48865977	49065977	harbor2	chr19	48883248	48883524	LTR/ERV1	1824	+	138	48883386	17409
chr19	48865977	49065977	harbor2	chr19	48946454	48947628	LTR/ERV1	3620	+	587	48947041	81064
chr19	48865977	49065977	harbor2	chr19	48951695	48952000	LTR/ERV1	1049	+	152	48951847	85870
chr19	30131712	30331712	harbor2	chr19	30160052	30160580	LTR/ERV1	2946	+	264	30160316	28604
chr19	30131712	30331712	harbor2	chr19	30176414	30177006	LTR/ERV1	3284	+	296	30176710	44998
chr19	10922845	11122845	harbor2	chr19	10939623	10939922	LTR/ERV1	1428	+	150	10939773	16928
chr19	10922845	11122845	harbor2	chr19	10940074	10940210	LTR/ERV1	787	+	68	10940142	17297
chr19	209526	409526	harbor2	chr19	248926	249489	LTR/ERV1	2774	+	282	249208	39682
chr19	209526	409526	harbor2	chr19	249896	250542	LTR/ERV1	3843	+	323	250219	40693
chr19	209526	409526	harbor2	chr19	250843	250895	LTR/ERV1	3843	+	26	250869	41343
chr19	209526	409526	harbor2	chr19	251296	251631	LTR/ERV1	915	+	168	251464	41938
chr19	209526	409526	harbor2	chr19	251757	251970	LTR/ERV1	638	+	106	251863	42337
chr19	209526	409526	harbor2	chr19	253201	253501	LTR/ERV1	1364	+	150	253351	43825
chr19	209526	409526	harbor2	chr19	256874	257318	LTR/ERV1	3028	+	222	257096	47570
chr19	209526	409526	harbor2	chr19	259804	259982	LTR/ERV1	929	+	89	259893	50367
chr19	209526	409526	harbor2	chr19	260066	260323	LTR/ERV1	1615	+	128	260194	50668
chr19	209526	409526	harbor2	chr19	261009	261371	LTR/ERV1	2596	+	181	261190	51664
chr19	209526	409526	harbor2	chr19	264918	265507	LTR/ERV1	4735	+	294	265212	55686
chr19	209526	409526	harbor2	chr19	262136	262375	LTR/ERV1	1219	+	120	262256	52730
chr19	5591353	5791353	harbor2	chr19	5675497	5675810	LTR/ERV1	1837	+	156	5675653	84300
chr19	1857927	2057927	harbor2	chr19	1903880	1903985	LTR/ERV1	847	+	52	1903932	46005
chr19	1857927	2057927	harbor2	chr19	1904289	1904647	LTR/ERV1	847	+	179	1904468	46541
chr19	19952225	20152225	harbor2	chr19	19953170	19953372	LTR/ERV1	1313	+	101	19953271	1046
chr19	19952225	20152225	harbor2	chr19	19953662	19954016	LTR/ERV1	1313	+	177	19953839	1614
chr19	19952225	20152225	harbor2	chr19	19966687	19967138	LTR/ERV1	2450	+	226	19966913	14688
chr19	19952225	20152225	harbor2	chr19	19999338	19999524	LTR/ERV1	753	+	93	19999431	47206
chr19	19952225	20152225	harbor2	chr19	20038498	20038994	LTR/ERV1	2431	+	248	20038746	86521
chr19	19952225	20152225	harbor2	chr19	20045618	20046114	LTR/ERV1	3887	+	248	20045866	93641
chr19	19952225	20152225	harbor2	chr19	20047947	20048375	LTR/ERV1	1739	+	214	20048161	95936
chr19	11935497	12135497	harbor2	chr19	11991714	11991852	LTR/ERV1	2193	+	69	11991783	56286
chr19	11935497	12135497	harbor2	chr19	11992151	11992462	LTR/ERV1	2193	+	156	11992307	56810
chr19	11935497	12135497	harbor2	chr19	11999595	12000000	LTR/ERV1	1971	+	202	11999797	64300
chr19	11935497	12135497	harbor2	chr19	12000001	12000401	LTR/ERV1	2683	+	200	12000201	64704
chr19	11935497	12135497	harbor2	chr19	12004473	12004665	LTR/ERV1	1327	+	96	12004569	69072
chr19	11935497	12135497	harbor2	chr19	12011169	12011516	LTR/ERV1	1603	+	174	12011343	75846
chr19	11935497	12135497	harbor2	chr19	12011517	12011591	LTR/ERV1	892	+	37	12011554	76057
chr19	11935497	12135497	harbor2	chr19	12011890	12012014	LTR/ERV1	892	+	62	12011952	76455
chr19	11935497	12135497	harbor2	chr19	12014038	12014178	LTR/ERV1	648	+	70	12014108	78611
chr19	11935497	12135497	harbor2	chr19	12034437	12034600	LTR/ERV1	816	+	82	12034519	99022
chr19	11935497	12135497	harbor2	chr19	12034680	12035024	LTR/ERV1	850	+	172	12034852	99355
chr19	19676568	19876568	harbor2	chr19	19697161	19697725	LTR/ERV1	3767	+	282	19697443	20875
chr19	19676568	19876568	harbor2	chr19	19698737	19698924	LTR/ERV1	1285	+	94	19698831	22263
chr19	19676568	19876568	harbor2	chr19	19701247	19701427	LTR/ERV1	1147	+	90	19701337	24769
chr19	19676568	19876568	harbor2	chr19	19701741	19701868	LTR/ERV1	1147	+	64	19701805	25237
chr19	19676568	19876568	harbor2	chr19	19709224	19709942	LTR/ERV1	3773	+	359	19709583	33015
chr19	2785512	2985512	harbor2	chr19	2861434	2861994	LTR/ERV1	6537	+	280	2861714	76202
chr19	2785512	2985512	harbor2	chr19	2862311	2863021	LTR/ERV1	6537	+	355	2862666	77154
chr19	2785512	2985512	harbor2	chr19	2863332	2863471	LTR/ERV1	6537	+	70	2863402	77890
chr19	2785512	2985512	harbor2	chr19	2864202	2864418	LTR/ERV1	1216	+	108	2864310	78798
chr19	2785512	2985512	harbor2	chr19	2865339	2865813	LTR/ERV1	3199	+	237	2865576	80064
chr19	19676566	19876566	harbor2	chr19	19697161	19697725	LTR/ERV1	3767	+	282	19697443	20877
chr19	19676566	19876566	harbor2	chr19	19698737	19698924	LTR/ERV1	1285	+	94	19698831	22265
chr19	19676566	19876566	harbor2	chr19	19701247	19701427	LTR/ERV1	1147	+	90	19701337	24771
chr19	19676566	19876566	harbor2	chr19	19701741	19701868	LTR/ERV1	1147	+	64	19701805	25239
chr19	19676566	19876566	harbor2	chr19	19709224	19709942	LTR/ERV1	3773	+	359	19709583	33017
chr19	19676549	19876549	harbor2	chr19	19697161	19697725	LTR/ERV1	3767	+	282	19697443	20894
chr19	19676549	19876549	harbor2	chr19	19698737	19698924	LTR/ERV1	1285	+	94	19698831	22282
chr19	19676549	19876549	harbor2	chr19	19701247	19701427	LTR/ERV1	1147	+	90	19701337	24788
chr19	19676549	19876549	harbor2	chr19	19701741	19701868	LTR/ERV1	1147	+	64	19701805	25256
chr19	19676549	19876549	harbor2	chr19	19709224	19709942	LTR/ERV1	3773	+	359	19709583	33034
chr19	1350331	1550331	harbor2	chr19	1442428	1442896	LTR/ERV1	3133	+	234	1442662	92331
chr19	11477538	11677538	harbor2	chr19	11563355	11563531	LTR/ERV1	1672	+	88	11563443	85905
chr19	11477538	11677538	harbor2	chr19	11563833	11564039	LTR/ERV1	1672	+	103	11563936	86398
chr19	11477538	11677538	harbor2	chr19	11564336	11564351	LTR/ERV1	700	+	8	11564344	86806
chr19	11477538	11677538	harbor2	chr19	11564647	11564860	LTR/ERV1	1093	+	106	11564753	87215
chr19	45385922	45585922	harbor2	chr19	45390230	45390717	LTR/ERV1	3880	+	244	45390474	4552
chr19	5534518	5734518	harbor2	chr19	5548576	5549016	LTR/ERV1	3815	+	220	5548796	14278
chr19	5534518	5734518	harbor2	chr19	5549017	5551892	LTR/ERV1	15423	+	1438	5550455	15937
chr19	5534518	5734518	harbor2	chr19	5551872	5552016	LTR/ERV1	835	+	72	5551944	17426
chr19	5534518	5734518	harbor2	chr19	5552007	5552168	LTR/ERV1	1037	+	80	5552087	17569
chr19	5534518	5734518	harbor2	chr19	5552161	5552771	LTR/ERV1	4429	+	305	5552466	17948
chr19	5534518	5734518	harbor2	chr19	5552772	5553212	LTR/ERV1	3809	+	220	5552992	18474
chr19	21041960	21241960	harbor2	chr19	21128499	21128747	LTR/ERV1	1787	+	124	21128623	86663
chr19	21041960	21241960	harbor2	chr19	21128748	21129271	LTR/ERV1	4117	+	262	21129010	87050
chr19	21041960	21241960	harbor2	chr19	21129272	21129347	LTR/ERV1	1787	+	38	21129310	87350
chr19	21041960	21241960	harbor2	chr19	21130752	21131084	LTR/ERV1	1891	+	166	21130918	88958
chr19	21041960	21241960	harbor2	chr19	21138943	21139245	LTR/ERV1	1395	+	151	21139094	97134
chr19	21041960	21241960	harbor2	chr19	21135258	21135420	LTR/ERV1	857	+	81	21135339	93379
chr19	19676577	19876577	harbor2	chr19	19697161	19697725	LTR/ERV1	3767	+	282	19697443	20866
chr19	19676577	19876577	harbor2	chr19	19698737	19698924	LTR/ERV1	1285	+	94	19698831	22254
chr19	19676577	19876577	harbor2	chr19	19701247	19701427	LTR/ERV1	1147	+	90	19701337	24760
chr19	19676577	19876577	harbor2	chr19	19701741	19701868	LTR/ERV1	1147	+	64	19701805	25228
chr19	19676577	19876577	harbor2	chr19	19709224	19709942	LTR/ERV1	3773	+	359	19709583	33006
chr19	5578078	5778078	harbor2	chr19	5675497	5675810	LTR/ERV1	1837	+	156	5675653	97575
chr19	19676519	19876519	harbor2	chr19	19697161	19697725	LTR/ERV1	3767	+	282	19697443	20924
chr19	19676519	19876519	harbor2	chr19	19698737	19698924	LTR/ERV1	1285	+	94	19698831	22312
chr19	19676519	19876519	harbor2	chr19	19701247	19701427	LTR/ERV1	1147	+	90	19701337	24818
chr19	19676519	19876519	harbor2	chr19	19701741	19701868	LTR/ERV1	1147	+	64	19701805	25286
chr19	19676519	19876519	harbor2	chr19	19709224	19709942	LTR/ERV1	3773	+	359	19709583	33064
chr19	5522849	5722849	harbor2	chr19	5548576	5549016	LTR/ERV1	3815	+	220	5548796	25947
chr19	5522849	5722849	harbor2	chr19	5549017	5551892	LTR/ERV1	15423	+	1438	5550455	27606
chr19	5522849	5722849	harbor2	chr19	5551872	5552016	LTR/ERV1	835	+	72	5551944	29095
chr19	5522849	5722849	harbor2	chr19	5552007	5552168	LTR/ERV1	1037	+	80	5552087	29238
chr19	5522849	5722849	harbor2	chr19	5552161	5552771	LTR/ERV1	4429	+	305	5552466	29617
chr19	5522849	5722849	harbor2	chr19	5552772	5553212	LTR/ERV1	3809	+	220	5552992	30143
chr19	16276857	16476857	harbor2	chr19	16307295	16307521	LTR/ERV1	1721	+	113	16307408	30551
chr19	16276857	16476857	harbor2	chr19	16307812	16307866	LTR/ERV1	1721	+	27	16307839	30982
chr19	19676542	19876542	harbor2	chr19	19697161	19697725	LTR/ERV1	3767	+	282	19697443	20901
chr19	19676542	19876542	harbor2	chr19	19698737	19698924	LTR/ERV1	1285	+	94	19698831	22289
chr19	19676542	19876542	harbor2	chr19	19701247	19701427	LTR/ERV1	1147	+	90	19701337	24795
chr19	19676542	19876542	harbor2	chr19	19701741	19701868	LTR/ERV1	1147	+	64	19701805	25263
chr19	19676542	19876542	harbor2	chr19	19709224	19709942	LTR/ERV1	3773	+	359	19709583	33041
chr20	2740607	2940607	harbor2	chr20	2800876	2801334	LTR/ERV1	2380	+	229	2801105	60498
chr20	2740607	2940607	harbor2	chr20	2801697	2801873	LTR/ERV1	906	+	88	2801785	61178
chr20	2740607	2940607	harbor2	chr20	2802320	2803218	LTR/ERV1	6051	+	449	2802769	62162
chr20	2740607	2940607	harbor2	chr20	2803522	2803609	LTR/ERV1	6051	+	44	2803566	62959
chr20	2740607	2940607	harbor2	chr20	2803790	2804131	LTR/ERV1	2430	+	170	2803960	63353
chr20	2740607	2940607	harbor2	chr20	2804132	2804576	LTR/ERV1	2256	+	222	2804354	63747
chr20	2740607	2940607	harbor2	chr20	2801335	2801724	LTR/ERV1	2445	+	194	2801529	60922
chr20	31622896	31822896	harbor2	chr20	31662806	31663043	LTR/ERV1	1332	+	118	31662924	40028
chr20	31622896	31822896	harbor2	chr20	31715591	31715831	LTR/ERV1	1566	+	120	31715711	92815
chr20	31622896	31822896	harbor2	chr20	31715996	31716266	LTR/ERV1	1366	+	135	31716131	93235
chr20	61877898	62077898	harbor2	chr20	61914146	61914267	LTR/ERV1	464	+	60	61914206	36308
chr20	61877898	62077898	harbor2	chr20	61914261	61914535	LTR/ERV1	1176	+	137	61914398	36500
chr20	61877898	62077898	harbor2	chr20	61959364	61959712	LTR/ERV1	1251	+	174	61959538	81640
chr20	61877898	62077898	harbor2	chr20	61960128	61960276	LTR/ERV1	712	+	74	61960202	82304
chr20	35442077	35642077	harbor2	chr20	35539745	35540213	LTR/ERV1	2255	+	234	35539979	97902
chr20	50095117	50295117	harbor2	chr20	50173570	50173606	LTR/ERV1	486	+	18	50173588	78471
chr20	50095117	50295117	harbor2	chr20	50173906	50174012	LTR/ERV1	486	+	53	50173959	78842
chr20	36898001	37098001	harbor2	chr20	36960042	36960248	LTR/ERV1	2336	+	103	36960145	62144
chr20	36898001	37098001	harbor2	chr20	36960547	36960723	LTR/ERV1	2336	+	88	36960635	62634
chr20	36898001	37098001	harbor2	chr20	36966491	36966560	LTR/ERV1	607	+	34	36966525	68524
chr20	36898001	37098001	harbor2	chr20	36966865	36967015	LTR/ERV1	607	+	75	36966940	68939
chr20	36898001	37098001	harbor2	chr20	36971267	36971420	LTR/ERV1	2282	+	76	36971343	73342
chr20	36898001	37098001	harbor2	chr20	36971482	36971856	LTR/ERV1	2282	+	187	36971669	73668
chr20	36898001	37098001	harbor2	chr20	36971958	36972059	LTR/ERV1	1335	+	50	36972008	74007
chr20	36898001	37098001	harbor2	chr20	36972351	36972496	LTR/ERV1	1335	+	72	36972423	74422
chr20	36898001	37098001	harbor2	chr20	36982349	36982462	LTR/ERV1	4936	+	56	36982405	84404
chr20	36898001	37098001	harbor2	chr20	36982754	36983286	LTR/ERV1	4936	+	266	36983020	85019
chr20	36898001	37098001	harbor2	chr20	36983582	36984107	LTR/ERV1	4936	+	262	36983844	85843
chr20	36898001	37098001	harbor2	chr20	36984409	36985418	LTR/ERV1	4936	+	504	36984913	86912
chr20	36898001	37098001	harbor2	chr20	36985732	36985916	LTR/ERV1	5238	+	92	36985824	87823
chr20	36898001	37098001	harbor2	chr20	36986213	36986916	LTR/ERV1	5238	+	352	36986565	88564
chr20	36898001	37098001	harbor2	chr20	36987390	36987806	LTR/ERV1	2563	+	208	36987598	89597
chr20	36898001	37098001	harbor2	chr20	36988120	36988183	LTR/ERV1	2563	+	32	36988152	90151
chr20	36898001	37098001	harbor2	chr20	36990298	36990771	LTR/ERV1	3325	+	236	36990534	92533
chr20	24535180	24735180	harbor2	chr20	24563271	24563607	LTR/ERV1	3099	+	168	24563439	28259
chr20	24535180	24735180	harbor2	chr20	24563903	24564074	LTR/ERV1	3099	+	86	24563989	28809
chr20	24535180	24735180	harbor2	chr20	24571812	24572241	LTR/ERV1	2561	+	214	24572026	36846
chr20	24535180	24735180	harbor2	chr20	24604230	24604860	LTR/ERV1	4560	+	315	24604545	69365
chr20	4624774	4824774	harbor2	chr20	4633244	4633788	LTR/ERV1	3052	+	272	4633516	8742
chr20	4624774	4824774	harbor2	chr20	4659776	4660204	LTR/ERV1	3437	+	214	4659990	35216
chr20	4624774	4824774	harbor2	chr20	4661209	4661594	LTR/ERV1	2570	+	192	4661401	36627
chr20	4624774	4824774	harbor2	chr20	4665723	4666438	LTR/ERV1	4385	+	358	4666081	41307
chr20	4624774	4824774	harbor2	chr20	4675852	4676272	LTR/ERV1	2711	+	210	4676062	51288
chr20	1023102	1223102	harbor2	chr20	1083409	1083778	LTR/ERV1	1393	+	184	1083593	60491
chr20	1023102	1223102	harbor2	chr20	1106586	1106997	LTR/ERV1	929	+	206	1106792	83690
chr20	63606959	63806959	harbor2	chr20	63631614	63631716	LTR/ERV1	468	+	51	63631665	24706
chr20	63606959	63806959	harbor2	chr20	63632205	63632316	LTR/ERV1	573	+	56	63632261	25302
chr20	9474281	9674281	harbor2	chr20	9503600	9504522	LTR/ERV1	5367	+	461	9504061	29780
chr20	9474281	9674281	harbor2	chr20	9549603	9550055	LTR/ERV1	2690	+	226	9549829	75548
chr20	62894793	63094793	harbor2	chr20	62989063	62989687	LTR/ERV1	3450	+	312	62989375	94582
chr20	38347847	38547847	harbor2	chr20	38385999	38386404	LTR/ERV1	2304	+	202	38386201	38354
chr20	38347847	38547847	harbor2	chr20	38438821	38439169	LTR/ERV1	502	+	174	38438995	91148
chr20	38347847	38547847	harbor2	chr20	38440390	38440538	LTR/ERV1	487	+	74	38440464	92617
chr20	62024350	62224350	harbor2	chr20	62041971	62042694	LTR/ERV1	4730	+	362	62042333	17983
chr20	35362392	35562392	harbor2	chr20	35362906	35363029	LTR/ERV1	683	+	62	35362968	576
chr20	63438095	63638095	harbor2	chr20	63525171	63525609	LTR/ERV1	3166	+	219	63525390	87295
chr20	63438095	63638095	harbor2	chr20	63525909	63525953	LTR/ERV1	3166	+	22	63525931	87836
chr20	63438095	63638095	harbor2	chr20	63526236	63526407	LTR/ERV1	3166	+	86	63526322	88227
chr20	63438095	63638095	harbor2	chr20	63527024	63527338	LTR/ERV1	3166	+	157	63527181	89086
chr20	1020784	1220784	harbor2	chr20	1083409	1083778	LTR/ERV1	1393	+	184	1083593	62809
chr20	1020784	1220784	harbor2	chr20	1106586	1106997	LTR/ERV1	929	+	206	1106792	86008
chr20	9474416	9674416	harbor2	chr20	9503600	9504522	LTR/ERV1	5367	+	461	9504061	29645
chr20	9474416	9674416	harbor2	chr20	9549603	9550055	LTR/ERV1	2690	+	226	9549829	75413
chr20	35138054	35338054	harbor2	chr20	35156034	35156358	LTR/ERV1	1095	+	162	35156196	18142
chr20	35138054	35338054	harbor2	chr20	35156662	35156783	LTR/ERV1	1095	+	60	35156722	18668
chr20	63732367	63932367	harbor2	chr20	63800379	63801824	LTR/ERV1	10697	+	722	63801101	68734
chr20	11791589	11991589	harbor2	chr20	11791707	11792313	LTR/ERV1	3131	+	303	11792010	421
chr20	11791589	11991589	harbor2	chr20	11823406	11823792	LTR/ERV1	1541	+	193	11823599	32010
chr20	11791589	11991589	harbor2	chr20	11834429	11834968	LTR/ERV1	2281	+	270	11834699	43110
chr20	11791589	11991589	harbor2	chr20	11849613	11850088	LTR/ERV1	2063	+	238	11849851	58262
chr20	63473161	63673161	harbor2	chr20	63525171	63525609	LTR/ERV1	3166	+	219	63525390	52229
chr20	63473161	63673161	harbor2	chr20	63525909	63525953	LTR/ERV1	3166	+	22	63525931	52770
chr20	63473161	63673161	harbor2	chr20	63526236	63526407	LTR/ERV1	3166	+	86	63526322	53161
chr20	63473161	63673161	harbor2	chr20	63527024	63527338	LTR/ERV1	3166	+	157	63527181	54020
chr20	21615735	21815735	harbor2	chr20	21628301	21628800	LTR/ERV1	3485	+	250	21628551	12816
chr20	21615735	21815735	harbor2	chr20	21651235	21651751	LTR/ERV1	4231	+	258	21651493	35758
chr20	21615735	21815735	harbor2	chr20	21651839	21652742	LTR/ERV1	7050	+	452	21652291	36556
chr20	21615735	21815735	harbor2	chr20	21652735	21654384	LTR/ERV1	12476	+	824	21653559	37824
chr20	21615735	21815735	harbor2	chr20	21654385	21656356	LTR/ERV1	15790	+	986	21655371	39636
chr20	21615735	21815735	harbor2	chr20	21656353	21656887	LTR/ERV1	3857	+	267	21656620	40885
chr20	21615735	21815735	harbor2	chr20	21656888	21657407	LTR/ERV1	4316	+	260	21657148	41413
chr20	62707216	62907216	harbor2	chr20	62779658	62779787	LTR/ERV1	2726	+	64	62779722	72506
chr20	62707216	62907216	harbor2	chr20	62780090	62780652	LTR/ERV1	2726	+	281	62780371	73155
chr20	62707216	62907216	harbor2	chr20	62781722	62781940	LTR/ERV1	2997	+	109	62781831	74615
chr20	62707216	62907216	harbor2	chr20	62782293	62782618	LTR/ERV1	2997	+	162	62782455	75239
chr20	4587587	4787587	harbor2	chr20	4633244	4633788	LTR/ERV1	3052	+	272	4633516	45929
chr20	4587587	4787587	harbor2	chr20	4659776	4660204	LTR/ERV1	3437	+	214	4659990	72403
chr20	4587587	4787587	harbor2	chr20	4661209	4661594	LTR/ERV1	2570	+	192	4661401	73814
chr20	4587587	4787587	harbor2	chr20	4665723	4666438	LTR/ERV1	4385	+	358	4666081	78494
chr20	4587587	4787587	harbor2	chr20	4675852	4676272	LTR/ERV1	2711	+	210	4676062	88475
chr21	29261633	29461633	harbor2	chr21	29295194	29295702	LTR/ERV1	2334	+	254	29295448	33815
chr21	29261633	29461633	harbor2	chr21	29359585	29360327	LTR/ERV1	4297	+	371	29359956	98323
chr21	45326953	45526953	harbor2	chr21	45356738	45357300	LTR/ERV1	1776	+	281	45357019	30066
chr21	45326953	45526953	harbor2	chr21	45377225	45377747	LTR/ERV1	2501	+	261	45377486	50533
chr21	45326953	45526953	harbor2	chr21	45400659	45400803	LTR/ERV1	1053	+	72	45400731	73778
chr21	43621046	43821046	harbor2	chr21	43626380	43626775	LTR/ERV1	2090	+	198	43626578	5532
chr21	43621046	43821046	harbor2	chr21	43654039	43654654	LTR/ERV1	2839	+	308	43654347	33301
chr21	43621046	43821046	harbor2	chr21	43711748	43711880	LTR/ERV1	661	+	66	43711814	90768
chr21	43621046	43821046	harbor2	chr21	43713759	43714057	LTR/ERV1	2161	+	149	43713908	92862
chr21	43621046	43821046	harbor2	chr21	43714359	43714402	LTR/ERV1	2161	+	22	43714381	93335
chr21	43621046	43821046	harbor2	chr21	43714688	43714784	LTR/ERV1	2161	+	48	43714736	93690
chr21	43621046	43821046	harbor2	chr21	43715376	43715497	LTR/ERV1	2161	+	60	43715436	94390
chr21	43621046	43821046	harbor2	chr21	43715498	43716246	LTR/ERV1	4718	+	374	43715872	94826
chr21	43621046	43821046	harbor2	chr21	43716247	43716329	LTR/ERV1	2161	+	41	43716288	95242
chr21	43621046	43821046	harbor2	chr21	43712420	43713038	LTR/ERV1	2844	+	309	43712729	91683
chr21	41040652	41240652	harbor2	chr21	41075371	41076441	LTR/ERV1	3630	+	535	41075906	35254
chr21	41040652	41240652	harbor2	chr21	41080637	41081238	LTR/ERV1	4254	+	300	41080937	40285
chr21	41040652	41240652	harbor2	chr21	41136373	41137758	LTR/ERV1	6451	+	692	41137065	96413
chr21	34275890	34475890	harbor2	chr21	34373072	34373731	LTR/ERV1	1058	+	330	34373402	97512
chr21	29199645	29399645	harbor2	chr21	29199070	29199700	LTR/ERV1	4223	+	315	29199385	260
chr21	29199645	29399645	harbor2	chr21	29233053	29233481	LTR/ERV1	2817	+	214	29233267	33622
chr21	29199645	29399645	harbor2	chr21	29233905	29234110	LTR/ERV1	1066	+	102	29234007	34362
chr21	29199645	29399645	harbor2	chr21	29234901	29235324	LTR/ERV1	2241	+	212	29235113	35468
chr21	29199645	29399645	harbor2	chr21	29295194	29295702	LTR/ERV1	2334	+	254	29295448	95803
chr21	44406749	44606749	harbor2	chr21	44471201	44471981	LTR/ERV1	5514	+	390	44471591	64842
chr21	44406749	44606749	harbor2	chr21	44475207	44475796	LTR/ERV1	3440	+	294	44475501	68752
chr21	44406749	44606749	harbor2	chr21	44475873	44476116	LTR/ERV1	5095	+	122	44475995	69246
chr21	44406749	44606749	harbor2	chr21	44476461	44477031	LTR/ERV1	5095	+	285	44476746	69997
chr21	44406749	44606749	harbor2	chr21	44477078	44477482	LTR/ERV1	2406	+	202	44477280	70531
chr21	44406749	44606749	harbor2	chr21	44477477	44477617	LTR/ERV1	754	+	70	44477547	70798
chr21	44406749	44606749	harbor2	chr21	44483327	44483453	LTR/ERV1	4289	+	63	44483390	76641
chr21	44406749	44606749	harbor2	chr21	44485340	44486157	LTR/ERV1	4857	+	408	44485748	78999
chr21	44406749	44606749	harbor2	chr21	44486257	44486763	LTR/ERV1	2935	+	253	44486510	79761
chr21	44406749	44606749	harbor2	chr21	44487936	44490230	LTR/ERV1	15851	+	1147	44489083	82334
chr21	44406749	44606749	harbor2	chr21	44490231	44491111	LTR/ERV1	5043	+	440	44490671	83922
chr21	44406749	44606749	harbor2	chr21	44492510	44493069	LTR/ERV1	3402	+	280	44492790	86041
chr21	44406749	44606749	harbor2	chr21	44493648	44494091	LTR/ERV1	992	+	222	44493870	87121
chr21	44406749	44606749	harbor2	chr21	44496860	44497012	LTR/ERV1	454	+	76	44496936	90187
chr21	44406749	44606749	harbor2	chr21	44497239	44497628	LTR/ERV1	1340	+	194	44497433	90684
chr21	44406749	44606749	harbor2	chr21	44482550	44483021	LTR/ERV1	4289	+	236	44482786	76037
chr21	29201564	29401564	harbor2	chr21	29233053	29233481	LTR/ERV1	2817	+	214	29233267	31703
chr21	29201564	29401564	harbor2	chr21	29233905	29234110	LTR/ERV1	1066	+	102	29234007	32443
chr21	29201564	29401564	harbor2	chr21	29234901	29235324	LTR/ERV1	2241	+	212	29235113	33549
chr21	29201564	29401564	harbor2	chr21	29295194	29295702	LTR/ERV1	2334	+	254	29295448	93884
chr21	14673851	14873851	harbor2	chr21	14700300	14700616	LTR/ERV1	749	+	158	14700458	26607
chr21	44693527	44893527	harbor2	chr21	44740294	44740702	LTR/ERV1	2667	+	204	44740498	46971
chr21	44693527	44893527	harbor2	chr21	44740703	44740849	LTR/ERV1	693	+	73	44740776	47249
chr21	44693527	44893527	harbor2	chr21	44740878	44741320	LTR/ERV1	1661	+	221	44741099	47572
chr21	44693527	44893527	harbor2	chr21	44741938	44742834	LTR/ERV1	3911	+	448	44742386	48859
chr21	44693527	44893527	harbor2	chr21	44745896	44746215	LTR/ERV1	1816	+	160	44746056	52529
chr21	44693527	44893527	harbor2	chr21	44746884	44746982	LTR/ERV1	3079	+	49	44746933	53406
chr21	44693527	44893527	harbor2	chr21	44747499	44747875	LTR/ERV1	3079	+	188	44747687	54160
chr21	44693527	44893527	harbor2	chr21	44742831	44745879	LTR/ERV1	19577	+	1524	44744355	50828
chr21	42596399	42796399	harbor2	chr21	42607804	42607960	LTR/ERV1	1111	+	78	42607882	11483
chr21	42596399	42796399	harbor2	chr21	42608902	42609303	LTR/ERV1	2240	+	200	42609102	12703
chr21	42596399	42796399	harbor2	chr21	42624501	42625103	LTR/ERV1	3087	+	301	42624802	28403
chr21	29248676	29448676	harbor2	chr21	29295194	29295702	LTR/ERV1	2334	+	254	29295448	46772
chr21	44774168	44974168	harbor2	chr21	44823238	44823703	LTR/ERV1	3375	+	232	44823470	49302
chr21	29201041	29401041	harbor2	chr21	29233053	29233481	LTR/ERV1	2817	+	214	29233267	32226
chr21	29201041	29401041	harbor2	chr21	29233905	29234110	LTR/ERV1	1066	+	102	29234007	32966
chr21	29201041	29401041	harbor2	chr21	29234901	29235324	LTR/ERV1	2241	+	212	29235113	34072
chr21	29201041	29401041	harbor2	chr21	29295194	29295702	LTR/ERV1	2334	+	254	29295448	94407
chr21	46090459	46290459	harbor2	chr21	46107240	46108009	LTR/ERV1	5996	+	384	46107624	17165
chr21	46090459	46290459	harbor2	chr21	46165220	46165557	LTR/ERV1	1141	+	168	46165388	74929
chr21	46090459	46290459	harbor2	chr21	46165696	46165864	LTR/ERV1	894	+	84	46165780	75321
chr21	44660270	44860270	harbor2	chr21	44740294	44740702	LTR/ERV1	2667	+	204	44740498	80228
chr21	44660270	44860270	harbor2	chr21	44740703	44740849	LTR/ERV1	693	+	73	44740776	80506
chr21	44660270	44860270	harbor2	chr21	44740878	44741320	LTR/ERV1	1661	+	221	44741099	80829
chr21	44660270	44860270	harbor2	chr21	44741938	44742834	LTR/ERV1	3911	+	448	44742386	82116
chr21	44660270	44860270	harbor2	chr21	44745896	44746215	LTR/ERV1	1816	+	160	44746056	85786
chr21	44660270	44860270	harbor2	chr21	44746884	44746982	LTR/ERV1	3079	+	49	44746933	86663
chr21	44660270	44860270	harbor2	chr21	44747499	44747875	LTR/ERV1	3079	+	188	44747687	87417
chr21	44660270	44860270	harbor2	chr21	44742831	44745879	LTR/ERV1	19577	+	1524	44744355	84085
chr21	45152250	45352250	harbor2	chr21	45161106	45162583	LTR/ERV1	7369	+	738	45161844	9594
chr21	44410571	44610571	harbor2	chr21	44471201	44471981	LTR/ERV1	5514	+	390	44471591	61020
chr21	44410571	44610571	harbor2	chr21	44475207	44475796	LTR/ERV1	3440	+	294	44475501	64930
chr21	44410571	44610571	harbor2	chr21	44475873	44476116	LTR/ERV1	5095	+	122	44475995	65424
chr21	44410571	44610571	harbor2	chr21	44476461	44477031	LTR/ERV1	5095	+	285	44476746	66175
chr21	44410571	44610571	harbor2	chr21	44477078	44477482	LTR/ERV1	2406	+	202	44477280	66709
chr21	44410571	44610571	harbor2	chr21	44477477	44477617	LTR/ERV1	754	+	70	44477547	66976
chr21	44410571	44610571	harbor2	chr21	44483327	44483453	LTR/ERV1	4289	+	63	44483390	72819
chr21	44410571	44610571	harbor2	chr21	44485340	44486157	LTR/ERV1	4857	+	408	44485748	75177
chr21	44410571	44610571	harbor2	chr21	44486257	44486763	LTR/ERV1	2935	+	253	44486510	75939
chr21	44410571	44610571	harbor2	chr21	44487936	44490230	LTR/ERV1	15851	+	1147	44489083	78512
chr21	44410571	44610571	harbor2	chr21	44490231	44491111	LTR/ERV1	5043	+	440	44490671	80100
chr21	44410571	44610571	harbor2	chr21	44492510	44493069	LTR/ERV1	3402	+	280	44492790	82219
chr21	44410571	44610571	harbor2	chr21	44493648	44494091	LTR/ERV1	992	+	222	44493870	83299
chr21	44410571	44610571	harbor2	chr21	44496860	44497012	LTR/ERV1	454	+	76	44496936	86365
chr21	44410571	44610571	harbor2	chr21	44497239	44497628	LTR/ERV1	1340	+	194	44497433	86862
chr21	44410571	44610571	harbor2	chr21	44482550	44483021	LTR/ERV1	4289	+	236	44482786	72215
chr21	42278158	42478158	harbor2	chr21	42329333	42329773	LTR/ERV1	3125	+	220	42329553	51395
chr21	42278158	42478158	harbor2	chr21	42358965	42359401	LTR/ERV1	2320	+	218	42359183	81025
chr21	42278158	42478158	harbor2	chr21	42359747	42359763	LTR/ERV1	2320	+	8	42359755	81597
chr21	42331244	42531244	harbor2	chr21	42358965	42359401	LTR/ERV1	2320	+	218	42359183	27939
chr21	42331244	42531244	harbor2	chr21	42359747	42359763	LTR/ERV1	2320	+	8	42359755	28511
chr21	39009375	39209375	harbor2	chr21	39047462	39047561	LTR/ERV1	479	+	50	39047512	38137
chr21	39009375	39209375	harbor2	chr21	39047876	39048136	LTR/ERV1	479	+	130	39048006	38631
chr21	39009375	39209375	harbor2	chr21	39102224	39102458	LTR/ERV1	2930	+	117	39102341	92966
chr21	39009375	39209375	harbor2	chr21	39102750	39103293	LTR/ERV1	2930	+	272	39103022	93647
chr21	37266105	37466105	harbor2	chr21	37314342	37314457	LTR/ERV1	995	+	58	37314400	48295
chr21	39009691	39209691	harbor2	chr21	39047462	39047561	LTR/ERV1	479	+	50	39047512	37821
chr21	39009691	39209691	harbor2	chr21	39047876	39048136	LTR/ERV1	479	+	130	39048006	38315
chr21	39009691	39209691	harbor2	chr21	39102224	39102458	LTR/ERV1	2930	+	117	39102341	92650
chr21	39009691	39209691	harbor2	chr21	39102750	39103293	LTR/ERV1	2930	+	272	39103022	93331
chr21	44624083	44824083	harbor2	chr21	44652705	44652832	LTR/ERV1	471	+	64	44652769	28686
chr21	44624083	44824083	harbor2	chr21	44653176	44653408	LTR/ERV1	1161	+	116	44653292	29209
chr21	44624083	44824083	harbor2	chr21	44653412	44653534	LTR/ERV1	561	+	61	44653473	29390
chr21	44625363	44825363	harbor2	chr21	44652705	44652832	LTR/ERV1	471	+	64	44652769	27406
chr21	44625363	44825363	harbor2	chr21	44653176	44653408	LTR/ERV1	1161	+	116	44653292	27929
chr21	44625363	44825363	harbor2	chr21	44653412	44653534	LTR/ERV1	561	+	61	44653473	28110
chr21	29200213	29400213	harbor2	chr21	29233053	29233481	LTR/ERV1	2817	+	214	29233267	33054
chr21	29200213	29400213	harbor2	chr21	29233905	29234110	LTR/ERV1	1066	+	102	29234007	33794
chr21	29200213	29400213	harbor2	chr21	29234901	29235324	LTR/ERV1	2241	+	212	29235113	34900
chr21	29200213	29400213	harbor2	chr21	29295194	29295702	LTR/ERV1	2334	+	254	29295448	95235
chr21	39009608	39209608	harbor2	chr21	39047462	39047561	LTR/ERV1	479	+	50	39047512	37904
chr21	39009608	39209608	harbor2	chr21	39047876	39048136	LTR/ERV1	479	+	130	39048006	38398
chr21	39009608	39209608	harbor2	chr21	39102224	39102458	LTR/ERV1	2930	+	117	39102341	92733
chr21	39009608	39209608	harbor2	chr21	39102750	39103293	LTR/ERV1	2930	+	272	39103022	93414
chr21	8347052	8547052	harbor2	chr21	8377806	8377916	LTR/ERV1	798	+	55	8377861	30809
chr21	8347052	8547052	harbor2	chr21	8378032	8378374	LTR/ERV1	2276	+	171	8378203	31151
chr21	8347052	8547052	harbor2	chr21	8413352	8413496	LTR/ERV1	458	+	72	8413424	66372
chr22	44208842	44408842	harbor2	chr22	44259811	44260322	LTR/ERV1	1094	+	256	44260067	51225
chr22	45971904	46171904	harbor2	chr22	45987274	45988215	LTR/ERV1	2720	+	470	45987744	15840
chr22	42989455	43189455	harbor2	chr22	42998657	42999320	LTR/ERV1	3580	+	332	42998989	9534
chr22	42989451	43189451	harbor2	chr22	42998657	42999320	LTR/ERV1	3580	+	332	42998989	9538
chr22	23814127	24014127	harbor2	chr22	23899059	23899335	LTR/ERV1	1302	+	138	23899197	85070
chr22	23814127	24014127	harbor2	chr22	23911523	23911909	LTR/ERV1	2890	+	193	23911716	97589
chr22	23814127	24014127	harbor2	chr22	23911926	23912120	LTR/ERV1	578	+	97	23912023	97896
chr22	23814127	24014127	harbor2	chr22	23912122	23912669	LTR/ERV1	1866	+	274	23912396	98269
chr22	23814127	24014127	harbor2	chr22	23912910	23913264	LTR/ERV1	684	+	177	23913087	98960
chr22	36465130	36665130	harbor2	chr22	36498827	36498930	LTR/ERV1	439	+	52	36498879	33749
chr22	36187355	36387355	harbor2	chr22	36192916	36193369	LTR/ERV1	1212	+	226	36193142	5787
chr22	36187355	36387355	harbor2	chr22	36197713	36198274	LTR/ERV1	1570	+	280	36197993	10638
chr22	36187355	36387355	harbor2	chr22	36198275	36198495	LTR/ERV1	408	+	110	36198385	11030
chr22	36187355	36387355	harbor2	chr22	36210903	36211461	LTR/ERV1	2473	+	279	36211182	23827
chr22	36187355	36387355	harbor2	chr22	36215160	36215777	LTR/ERV1	1740	+	308	36215468	28113
chr22	36187355	36387355	harbor2	chr22	36215797	36215947	LTR/ERV1	532	+	75	36215872	28517
chr22	36187355	36387355	harbor2	chr22	36216030	36216282	LTR/ERV1	1021	+	126	36216156	28801
chr22	36187355	36387355	harbor2	chr22	36216813	36217510	LTR/ERV1	1570	+	348	36217161	29806
chr22	36187355	36387355	harbor2	chr22	36217578	36218035	LTR/ERV1	2568	+	228	36217806	30451
chr22	36187355	36387355	harbor2	chr22	36218979	36219103	LTR/ERV1	636	+	62	36219041	31686
chr22	36187355	36387355	harbor2	chr22	36219123	36219300	LTR/ERV1	671	+	88	36219211	31856
chr22	36187355	36387355	harbor2	chr22	36219610	36219628	LTR/ERV1	572	+	9	36219619	32264
chr22	36187355	36387355	harbor2	chr22	36219738	36220384	LTR/ERV1	3667	+	323	36220061	32706
chr22	36187355	36387355	harbor2	chr22	36220974	36221678	LTR/ERV1	3667	+	352	36221326	33971
chr22	36187355	36387355	harbor2	chr22	36228975	36229427	LTR/ERV1	1044	+	226	36229201	41846
chr22	36187355	36387355	harbor2	chr22	36231845	36232073	LTR/ERV1	619	+	114	36231959	44604
chr22	36187355	36387355	harbor2	chr22	36232074	36232294	LTR/ERV1	408	+	110	36232184	44829
chr22	36187355	36387355	harbor2	chr22	36247481	36248215	LTR/ERV1	1156	+	367	36247848	60493
chr22	36187355	36387355	harbor2	chr22	36248802	36250226	LTR/ERV1	5772	+	712	36249514	62159
chr22	36187355	36387355	harbor2	chr22	36250236	36250718	LTR/ERV1	3997	+	241	36250477	63122
chr22	36187355	36387355	harbor2	chr22	36251116	36251785	LTR/ERV1	2699	+	334	36251450	64095
chr22	36187355	36387355	harbor2	chr22	36276775	36277017	LTR/ERV1	1024	+	121	36276896	89541
chr22	36187355	36387355	harbor2	chr22	36277328	36277487	LTR/ERV1	1024	+	80	36277408	90053
chr22	36407158	36607158	harbor2	chr22	36426959	36427147	LTR/ERV1	4073	+	94	36427053	19895
chr22	36407158	36607158	harbor2	chr22	36427455	36427825	LTR/ERV1	4073	+	185	36427640	20482
chr22	36407158	36607158	harbor2	chr22	36498827	36498930	LTR/ERV1	439	+	52	36498879	91721
chr22	36919396	37119396	harbor2	chr22	36947139	36947745	LTR/ERV1	3716	+	303	36947442	28046
chr22	36919396	37119396	harbor2	chr22	36969444	36969600	LTR/ERV1	719	+	78	36969522	50126
chr22	36919396	37119396	harbor2	chr22	36975644	36976160	LTR/ERV1	2471	+	258	36975902	56506
chr22	36919396	37119396	harbor2	chr22	36976460	36976705	LTR/ERV1	2471	+	122	36976582	57186
chr22	36919396	37119396	harbor2	chr22	36976999	36977547	LTR/ERV1	908	+	274	36977273	57877
chr22	36919396	37119396	harbor2	chr22	36977670	36977769	LTR/ERV1	554	+	50	36977720	58324
chr22	36919396	37119396	harbor2	chr22	36979545	36979664	LTR/ERV1	647	+	60	36979605	60209
chr22	36919396	37119396	harbor2	chr22	36980299	36980373	LTR/ERV1	477	+	37	36980336	60940
chr22	36919396	37119396	harbor2	chr22	36981050	36981479	LTR/ERV1	1385	+	214	36981264	61868
chr22	24171508	24371508	harbor2	chr22	24196426	24196873	LTR/ERV1	1725	+	224	24196650	25142
chr22	24171508	24371508	harbor2	chr22	24201222	24201278	LTR/ERV1	442	+	28	24201250	29742
chr22	24171508	24371508	harbor2	chr22	24201579	24201694	LTR/ERV1	442	+	58	24201637	30129
chr22	24171508	24371508	harbor2	chr22	24202244	24202528	LTR/ERV1	1484	+	142	24202386	30878
chr22	24171508	24371508	harbor2	chr22	24202836	24203006	LTR/ERV1	1484	+	85	24202921	31413
chr22	24171508	24371508	harbor2	chr22	24203160	24203286	LTR/ERV1	833	+	63	24203223	31715
chr22	24171508	24371508	harbor2	chr22	24203944	24204014	LTR/ERV1	436	+	35	24203979	32471
chr22	24171508	24371508	harbor2	chr22	24204015	24204551	LTR/ERV1	4019	+	268	24204283	32775
chr22	24171508	24371508	harbor2	chr22	24204552	24204595	LTR/ERV1	436	+	22	24204574	33066
chr22	24171508	24371508	harbor2	chr22	24204665	24204791	LTR/ERV1	824	+	63	24204728	33220
chr22	24171508	24371508	harbor2	chr22	24205136	24205305	LTR/ERV1	930	+	84	24205220	33712
chr22	24171508	24371508	harbor2	chr22	24217299	24217695	LTR/ERV1	3617	+	198	24217497	45989
chr22	24171508	24371508	harbor2	chr22	24218004	24218217	LTR/ERV1	3617	+	106	24218110	46602
chr22	24171508	24371508	harbor2	chr22	24218459	24218548	LTR/ERV1	3617	+	44	24218503	46995
chr22	24171508	24371508	harbor2	chr22	24221042	24221508	LTR/ERV1	3596	+	233	24221275	49767
chr22	24171508	24371508	harbor2	chr22	24221806	24221897	LTR/ERV1	3596	+	46	24221852	50344
chr22	24171508	24371508	harbor2	chr22	24228314	24228452	LTR/ERV1	565	+	69	24228383	56875
chr22	24171508	24371508	harbor2	chr22	24230632	24230803	LTR/ERV1	868	+	86	24230718	59210
chr22	36355398	36555398	harbor2	chr22	36426959	36427147	LTR/ERV1	4073	+	94	36427053	71655
chr22	36355398	36555398	harbor2	chr22	36427455	36427825	LTR/ERV1	4073	+	185	36427640	72242
chr22	36407144	36607144	harbor2	chr22	36426959	36427147	LTR/ERV1	4073	+	94	36427053	19909
chr22	36407144	36607144	harbor2	chr22	36427455	36427825	LTR/ERV1	4073	+	185	36427640	20496
chr22	36407144	36607144	harbor2	chr22	36498827	36498930	LTR/ERV1	439	+	52	36498879	91735
chr22	19663015	19863015	harbor2	chr22	19667218	19668050	LTR/ERV1	5563	+	416	19667634	4619
chr22	50069670	50269670	harbor2	chr22	50074672	50075098	LTR/ERV1	1948	+	213	50074885	5215
chr22	46291932	46491932	harbor2	chr22	46333167	46333725	LTR/ERV1	1817	+	279	46333446	41514
chr22	46291932	46491932	harbor2	chr22	46334297	46334422	LTR/ERV1	1798	+	62	46334359	42427
chr22	46291932	46491932	harbor2	chr22	46333730	46333993	LTR/ERV1	1798	+	132	46333862	41930
chr22	42989445	43189445	harbor2	chr22	42998657	42999320	LTR/ERV1	3580	+	332	42998989	9544
chr22	19665909	19865909	harbor2	chr22	19667218	19668050	LTR/ERV1	5563	+	416	19667634	1725
chr22	28342388	28542388	harbor2	chr22	28405690	28406105	LTR/ERV1	2320	+	208	28405898	63510
chr22	49860156	50060156	harbor2	chr22	49905301	49905369	LTR/ERV1	447	+	34	49905335	45179
chr22	49860156	50060156	harbor2	chr22	49905794	49905925	LTR/ERV1	447	+	66	49905860	45704
chr22	49860156	50060156	harbor2	chr22	49939162	49939249	LTR/ERV1	2210	+	44	49939206	79050
chr22	49860156	50060156	harbor2	chr22	49939552	49939792	LTR/ERV1	2210	+	120	49939672	79516
chr22	49860156	50060156	harbor2	chr22	49940087	49940258	LTR/ERV1	2210	+	86	49940173	80017
chr22	49860156	50060156	harbor2	chr22	49940571	49940651	LTR/ERV1	2210	+	40	49940611	80455
chr22	49860156	50060156	harbor2	chr22	49940974	49941097	LTR/ERV1	2210	+	62	49941036	80880
chr22	32100450	32300450	harbor2	chr22	32117764	32118227	LTR/ERV1	1896	+	232	32117996	17546
chr22	32100450	32300450	harbor2	chr22	32126246	32126518	LTR/ERV1	1579	+	136	32126382	25932
chr22	32100450	32300450	harbor2	chr22	32126526	32126672	LTR/ERV1	628	+	73	32126599	26149
chr22	32100450	32300450	harbor2	chr22	32126980	32127006	LTR/ERV1	628	+	13	32126993	26543
chr22	32100450	32300450	harbor2	chr22	32127013	32127492	LTR/ERV1	2641	+	240	32127253	26803
chr22	32100450	32300450	harbor2	chr22	32127535	32127919	LTR/ERV1	1238	+	192	32127727	27277
chr22	32100450	32300450	harbor2	chr22	32127926	32127994	LTR/ERV1	533	+	34	32127960	27510
chr22	32100450	32300450	harbor2	chr22	32137454	32137666	LTR/ERV1	1459	+	106	32137560	37110
chr22	32100450	32300450	harbor2	chr22	32137667	32138166	LTR/ERV1	2556	+	250	32137917	37467
chr22	32100450	32300450	harbor2	chr22	32138160	32138244	LTR/ERV1	691	+	42	32138202	37752
chr22	32100450	32300450	harbor2	chr22	32138273	32138354	LTR/ERV1	691	+	40	32138313	37863
chr22	32100450	32300450	harbor2	chr22	32138351	32139805	LTR/ERV1	12452	+	727	32139078	38628
chr22	32100450	32300450	harbor2	chr22	32140316	32140576	LTR/ERV1	12452	+	130	32140446	39996
chr22	37240349	37440349	harbor2	chr22	37250007	37250450	LTR/ERV1	2287	+	222	37250229	9880
chr22	37240349	37440349	harbor2	chr22	37258235	37258312	LTR/ERV1	4957	+	38	37258273	17924
chr22	37240349	37440349	harbor2	chr22	37258622	37259476	LTR/ERV1	4957	+	427	37259049	18700
chr22	44788598	44988598	harbor2	chr22	44850534	44850683	LTR/ERV1	995	+	74	44850608	62010
chr22	44788598	44988598	harbor2	chr22	44850983	44851210	LTR/ERV1	995	+	114	44851097	62499
chr22	23024082	23224082	harbor2	chr22	23023956	23024639	LTR/ERV1	5447	+	342	23024298	216
chr22	23024082	23224082	harbor2	chr22	23024640	23024720	LTR/ERV1	390	+	40	23024680	598
chr22	23024082	23224082	harbor2	chr22	23024719	23025085	LTR/ERV1	10727	+	183	23024902	820
chr22	23024082	23224082	harbor2	chr22	23025397	23025745	LTR/ERV1	10727	+	174	23025571	1489
chr22	23024082	23224082	harbor2	chr22	23026020	23026083	LTR/ERV1	10727	+	32	23026052	1970
chr22	23024082	23224082	harbor2	chr22	23029152	23029348	LTR/ERV1	10727	+	98	23029250	5168
chr22	23024082	23224082	harbor2	chr22	23029822	23030104	LTR/ERV1	1683	+	141	23029963	5881
chr22	23024082	23224082	harbor2	chr22	23030091	23030841	LTR/ERV1	4057	+	375	23030466	6384
chr22	23024082	23224082	harbor2	chr22	23031449	23031666	LTR/ERV1	1315	+	108	23031557	7475
chr22	23024082	23224082	harbor2	chr22	23031671	23032525	LTR/ERV1	5662	+	427	23032098	8016
chr22	23024082	23224082	harbor2	chr22	23035017	23035710	LTR/ERV1	4831	+	346	23035363	11281
chr22	18822922	19022922	harbor2	chr22	18903126	18903555	LTR/ERV1	1073	+	214	18903340	80418
chr22	24928712	25128712	harbor2	chr22	25007523	25007913	LTR/ERV1	2881	+	195	25007718	79006
chr22	24928712	25128712	harbor2	chr22	25008227	25008335	LTR/ERV1	2881	+	54	25008281	79569
chr22	23421907	23621907	harbor2	chr22	23439750	23439983	LTR/ERV1	4447	+	116	23439866	17959
chr22	23421907	23621907	harbor2	chr22	23440281	23440694	LTR/ERV1	4447	+	206	23440487	18580
chr22	23421907	23621907	harbor2	chr22	23489945	23490115	LTR/ERV1	560	+	85	23490030	68123
chr22	42521734	42721734	harbor2	chr22	42529025	42529237	LTR/ERV1	3234	+	106	42529131	7397
chr22	42521734	42721734	harbor2	chr22	42529569	42529924	LTR/ERV1	3234	+	178	42529747	8013
chr22	42521734	42721734	harbor2	chr22	42596871	42596936	LTR/ERV1	421	+	32	42596903	75169
chr22	24153384	24353384	harbor2	chr22	24196426	24196873	LTR/ERV1	1725	+	224	24196650	43266
chr22	24153384	24353384	harbor2	chr22	24201222	24201278	LTR/ERV1	442	+	28	24201250	47866
chr22	24153384	24353384	harbor2	chr22	24201579	24201694	LTR/ERV1	442	+	58	24201637	48253
chr22	24153384	24353384	harbor2	chr22	24202244	24202528	LTR/ERV1	1484	+	142	24202386	49002
chr22	24153384	24353384	harbor2	chr22	24202836	24203006	LTR/ERV1	1484	+	85	24202921	49537
chr22	24153384	24353384	harbor2	chr22	24203160	24203286	LTR/ERV1	833	+	63	24203223	49839
chr22	24153384	24353384	harbor2	chr22	24203944	24204014	LTR/ERV1	436	+	35	24203979	50595
chr22	24153384	24353384	harbor2	chr22	24204015	24204551	LTR/ERV1	4019	+	268	24204283	50899
chr22	24153384	24353384	harbor2	chr22	24204552	24204595	LTR/ERV1	436	+	22	24204574	51190
chr22	24153384	24353384	harbor2	chr22	24204665	24204791	LTR/ERV1	824	+	63	24204728	51344
chr22	24153384	24353384	harbor2	chr22	24205136	24205305	LTR/ERV1	930	+	84	24205220	51836
chr22	24153384	24353384	harbor2	chr22	24217299	24217695	LTR/ERV1	3617	+	198	24217497	64113
chr22	24153384	24353384	harbor2	chr22	24218004	24218217	LTR/ERV1	3617	+	106	24218110	64726
chr22	24153384	24353384	harbor2	chr22	24218459	24218548	LTR/ERV1	3617	+	44	24218503	65119
chr22	24153384	24353384	harbor2	chr22	24221042	24221508	LTR/ERV1	3596	+	233	24221275	67891
chr22	24153384	24353384	harbor2	chr22	24221806	24221897	LTR/ERV1	3596	+	46	24221852	68468
chr22	24153384	24353384	harbor2	chr22	24228314	24228452	LTR/ERV1	565	+	69	24228383	74999
chr22	24153384	24353384	harbor2	chr22	24230632	24230803	LTR/ERV1	868	+	86	24230718	77334
chr22	12715743	12915743	harbor2	chr22	12798121	12798597	LTR/ERV1	2391	+	238	12798359	82616
chr22	12715743	12915743	harbor2	chr22	12798738	12799244	LTR/ERV1	1809	+	253	12798991	83248
chr22	12715743	12915743	harbor2	chr22	12799260	12799999	LTR/ERV1	4103	+	370	12799630	83887
chr22	12715743	12915743	harbor2	chr22	12800000	12800658	LTR/ERV1	4255	+	329	12800329	84586
chr22	12715743	12915743	harbor2	chr22	12800657	12800915	LTR/ERV1	1322	+	129	12800786	85043
chr22	12715743	12915743	harbor2	chr22	12807506	12807947	LTR/ERV1	10179	+	220	12807726	91983
chr22	12715743	12915743	harbor2	chr22	12808235	12808547	LTR/ERV1	10179	+	156	12808391	92648
chr22	12715743	12915743	harbor2	chr22	12808837	12809797	LTR/ERV1	10179	+	480	12809317	93574
chr22	12715743	12915743	harbor2	chr22	12809790	12810184	LTR/ERV1	2392	+	197	12809987	94244
chr22	12715743	12915743	harbor2	chr22	12810889	12810995	LTR/ERV1	2992	+	53	12810942	95199
chr22	12715743	12915743	harbor2	chr22	12811287	12811660	LTR/ERV1	2992	+	186	12811473	95730
chr22	12715743	12915743	harbor2	chr22	12811661	12812059	LTR/ERV1	2266	+	199	12811860	96117
chr22	12715743	12915743	harbor2	chr22	12812141	12812703	LTR/ERV1	3862	+	281	12812422	96679
chr22	46291944	46491944	harbor2	chr22	46333167	46333725	LTR/ERV1	1817	+	279	46333446	41502
chr22	46291944	46491944	harbor2	chr22	46334297	46334422	LTR/ERV1	1798	+	62	46334359	42415
chr22	46291944	46491944	harbor2	chr22	46333730	46333993	LTR/ERV1	1798	+	132	46333862	41918
chr22	24161119	24361119	harbor2	chr22	24196426	24196873	LTR/ERV1	1725	+	224	24196650	35531
chr22	24161119	24361119	harbor2	chr22	24201222	24201278	LTR/ERV1	442	+	28	24201250	40131
chr22	24161119	24361119	harbor2	chr22	24201579	24201694	LTR/ERV1	442	+	58	24201637	40518
chr22	24161119	24361119	harbor2	chr22	24202244	24202528	LTR/ERV1	1484	+	142	24202386	41267
chr22	24161119	24361119	harbor2	chr22	24202836	24203006	LTR/ERV1	1484	+	85	24202921	41802
chr22	24161119	24361119	harbor2	chr22	24203160	24203286	LTR/ERV1	833	+	63	24203223	42104
chr22	24161119	24361119	harbor2	chr22	24203944	24204014	LTR/ERV1	436	+	35	24203979	42860
chr22	24161119	24361119	harbor2	chr22	24204015	24204551	LTR/ERV1	4019	+	268	24204283	43164
chr22	24161119	24361119	harbor2	chr22	24204552	24204595	LTR/ERV1	436	+	22	24204574	43455
chr22	24161119	24361119	harbor2	chr22	24204665	24204791	LTR/ERV1	824	+	63	24204728	43609
chr22	24161119	24361119	harbor2	chr22	24205136	24205305	LTR/ERV1	930	+	84	24205220	44101
chr22	24161119	24361119	harbor2	chr22	24217299	24217695	LTR/ERV1	3617	+	198	24217497	56378
chr22	24161119	24361119	harbor2	chr22	24218004	24218217	LTR/ERV1	3617	+	106	24218110	56991
chr22	24161119	24361119	harbor2	chr22	24218459	24218548	LTR/ERV1	3617	+	44	24218503	57384
chr22	24161119	24361119	harbor2	chr22	24221042	24221508	LTR/ERV1	3596	+	233	24221275	60156
chr22	24161119	24361119	harbor2	chr22	24221806	24221897	LTR/ERV1	3596	+	46	24221852	60733
chr22	24161119	24361119	harbor2	chr22	24228314	24228452	LTR/ERV1	565	+	69	24228383	67264
chr22	24161119	24361119	harbor2	chr22	24230632	24230803	LTR/ERV1	868	+	86	24230718	69599
chr22	38679511	38879511	harbor2	chr22	38772018	38772568	LTR/ERV1	4440	+	275	38772293	92782
chr22	24948900	25148900	harbor2	chr22	25007523	25007913	LTR/ERV1	2881	+	195	25007718	58818
chr22	24948900	25148900	harbor2	chr22	25008227	25008335	LTR/ERV1	2881	+	54	25008281	59381
chr22	23082527	23282527	harbor2	chr22	23143040	23143143	LTR/ERV1	2860	+	52	23143092	60565
chr22	23082527	23282527	harbor2	chr22	23143334	23143808	LTR/ERV1	2860	+	237	23143571	61044
chrX	153388897	153588897	harbor2	chrX	153394556	153394915	LTR/ERV1	975	+	180	153394736	5839
chrX	153388897	153588897	harbor2	chrX	153434774	153435211	LTR/ERV1	1562	+	218	153434992	46095
chrX	153388897	153588897	harbor2	chrX	153435514	153435590	LTR/ERV1	1562	+	38	153435552	46655
chrX	153388897	153588897	harbor2	chrX	153461923	153462077	LTR/ERV1	874	+	77	153462000	73103
chrX	153410219	153610219	harbor2	chrX	153434774	153435211	LTR/ERV1	1562	+	218	153434992	24773
chrX	153410219	153610219	harbor2	chrX	153435514	153435590	LTR/ERV1	1562	+	38	153435552	25333
chrX	153410219	153610219	harbor2	chrX	153461923	153462077	LTR/ERV1	874	+	77	153462000	51781
chrX	72209033	72409033	harbor2	chrX	72213162	72213924	LTR/ERV1	5466	+	381	72213543	4510
chrX	72209033	72409033	harbor2	chrX	72220884	72222595	LTR/ERV1	51873	+	856	72221740	12707
chrX	72209033	72409033	harbor2	chrX	72222896	72223055	LTR/ERV1	51873	+	80	72222976	13943
chrX	72209033	72409033	harbor2	chrX	72223357	72223404	LTR/ERV1	51873	+	24	72223381	14348
chrX	72209033	72409033	harbor2	chrX	72223661	72223709	LTR/ERV1	51873	+	24	72223685	14652
chrX	72209033	72409033	harbor2	chrX	72223767	72224476	LTR/ERV1	51873	+	354	72224121	15088
chrX	72209033	72409033	harbor2	chrX	72224769	72227745	LTR/ERV1	51873	+	1488	72226257	17224
chrX	72209033	72409033	harbor2	chrX	72227746	72228334	LTR/ERV1	5088	+	294	72228040	19007
chrX	72209033	72409033	harbor2	chrX	72228335	72229908	LTR/ERV1	51873	+	786	72229121	20088
chrX	72209033	72409033	harbor2	chrX	72230250	72230604	LTR/ERV1	1964	+	177	72230427	21394
chrX	72209033	72409033	harbor2	chrX	72220391	72220883	LTR/ERV1	2629	+	246	72220637	11604
chrX	18255217	18455217	harbor2	chrX	18273620	18274425	LTR/ERV1	4648	+	402	18274022	18805
chrX	18255217	18455217	harbor2	chrX	18274698	18275242	LTR/ERV1	3007	+	272	18274970	19753
chrX	18255217	18455217	harbor2	chrX	18315528	18315944	LTR/ERV1	1260	+	208	18315736	60519
chrX	153387298	153587298	harbor2	chrX	153394556	153394915	LTR/ERV1	975	+	180	153394736	7438
chrX	153387298	153587298	harbor2	chrX	153434774	153435211	LTR/ERV1	1562	+	218	153434992	47694
chrX	153387298	153587298	harbor2	chrX	153435514	153435590	LTR/ERV1	1562	+	38	153435552	48254
chrX	153387298	153587298	harbor2	chrX	153461923	153462077	LTR/ERV1	874	+	77	153462000	74702
chrX	153370587	153570587	harbor2	chrX	153394556	153394915	LTR/ERV1	975	+	180	153394736	24149
chrX	153370587	153570587	harbor2	chrX	153434774	153435211	LTR/ERV1	1562	+	218	153434992	64405
chrX	153370587	153570587	harbor2	chrX	153435514	153435590	LTR/ERV1	1562	+	38	153435552	64965
chrX	153370587	153570587	harbor2	chrX	153461923	153462077	LTR/ERV1	874	+	77	153462000	91413
chrX	72209054	72409054	harbor2	chrX	72213162	72213924	LTR/ERV1	5466	+	381	72213543	4489
chrX	72209054	72409054	harbor2	chrX	72220884	72222595	LTR/ERV1	51873	+	856	72221740	12686
chrX	72209054	72409054	harbor2	chrX	72222896	72223055	LTR/ERV1	51873	+	80	72222976	13922
chrX	72209054	72409054	harbor2	chrX	72223357	72223404	LTR/ERV1	51873	+	24	72223381	14327
chrX	72209054	72409054	harbor2	chrX	72223661	72223709	LTR/ERV1	51873	+	24	72223685	14631
chrX	72209054	72409054	harbor2	chrX	72223767	72224476	LTR/ERV1	51873	+	354	72224121	15067
chrX	72209054	72409054	harbor2	chrX	72224769	72227745	LTR/ERV1	51873	+	1488	72226257	17203
chrX	72209054	72409054	harbor2	chrX	72227746	72228334	LTR/ERV1	5088	+	294	72228040	18986
chrX	72209054	72409054	harbor2	chrX	72228335	72229908	LTR/ERV1	51873	+	786	72229121	20067
chrX	72209054	72409054	harbor2	chrX	72230250	72230604	LTR/ERV1	1964	+	177	72230427	21373
chrX	72209054	72409054	harbor2	chrX	72220391	72220883	LTR/ERV1	2629	+	246	72220637	11583
chrX	18254719	18454719	harbor2	chrX	18273620	18274425	LTR/ERV1	4648	+	402	18274022	19303
chrX	18254719	18454719	harbor2	chrX	18274698	18275242	LTR/ERV1	3007	+	272	18274970	20251
chrX	18254719	18454719	harbor2	chrX	18315528	18315944	LTR/ERV1	1260	+	208	18315736	61017
chrX	287171	487171	harbor2	chrX	383868	384134	LTR/ERV1	1043	+	133	384001	96830
chrX	287171	487171	harbor2	chrX	384597	384702	LTR/ERV1	1714	+	52	384649	97478
chrX	287171	487171	harbor2	chrX	385007	385305	LTR/ERV1	1714	+	149	385156	97985
