H_chr	H_start	H_end	Harbor	TE_chr	TE_start	TE_end	TE	score	TE_strand	TE_half	TE_middle_pos	TE_dis
chr1	193326713	193526713	harbor1	chr1	193326926	193327315	DNA/TcMar-Tigger	1737	+	194	193327120	407
chr1	193326713	193526713	harbor1	chr1	193338537	193338844	DNA/TcMar-Tigger	1488	+	154	193338691	11978
chr1	193326713	193526713	harbor1	chr1	193366120	193366516	DNA/TcMar-Tigger	758	+	198	193366318	39605
chr1	193326713	193526713	harbor1	chr1	193366826	193366849	DNA/TcMar-Tigger	758	+	12	193366838	40125
chr1	56532729	56732729	harbor1	chr1	56567015	56567295	DNA/TcMar-Tigger	561	+	140	56567155	34426
chr1	56532729	56732729	harbor1	chr1	56602342	56603816	DNA/TcMar-Tigger	9632	+	737	56603079	70350
chr1	56532729	56732729	harbor1	chr1	56603819	56604225	DNA/TcMar-Tigger	2106	+	203	56604022	71293
chr1	2751372	2951372	harbor1	chr1	2781133	2781307	DNA/TcMar-Tigger	690	+	87	2781220	29848
chr1	2751372	2951372	harbor1	chr1	2849989	2850711	DNA/TcMar-Tigger	3113	+	361	2850350	98978
chr1	2751372	2951372	harbor1	chr1	2850862	2851078	DNA/TcMar-Tigger	888	+	108	2850970	99598
chr1	236259460	236459460	harbor1	chr1	236312492	236312765	DNA/TcMar-Tigger	1833	+	136	236312628	53168
chr1	247505213	247705213	harbor1	chr1	247543300	247543552	DNA/TcMar-Tigger	1525	+	126	247543426	38213
chr1	206125916	206325916	harbor1	chr1	206193492	206194716	DNA/TcMar-Tigger	15659	+	612	206194104	68188
chr1	206125916	206325916	harbor1	chr1	206195016	206195219	DNA/TcMar-Tigger	15659	+	102	206195118	69202
chr1	206125916	206325916	harbor1	chr1	206191959	206192897	DNA/TcMar-Tigger	15659	+	469	206192428	66512
chr1	240850481	241050481	harbor1	chr1	240850126	240852503	DNA/TcMar-Tigger	14415	+	1188	240851314	833
chr1	240850481	241050481	harbor1	chr1	240883504	240883795	DNA/TcMar-Tigger	2994	+	146	240883650	33169
chr1	240850481	241050481	harbor1	chr1	240884105	240884449	DNA/TcMar-Tigger	2994	+	172	240884277	33796
chr1	230369077	230569077	harbor1	chr1	230405236	230405641	DNA/TcMar-Tigger	2314	+	202	230405438	36361
chr1	4794226	4994226	harbor1	chr1	4805172	4805605	DNA/TcMar-Tigger	2434	+	216	4805388	11162
chr1	144283332	144483332	harbor1	chr1	144309818	144310049	DNA/TcMar-Tigger	1136	+	116	144309934	26602
chr1	144283332	144483332	harbor1	chr1	144331581	144331950	DNA/TcMar-Tigger	1615	+	184	144331765	48433
chr1	144283332	144483332	harbor1	chr1	144342653	144342993	DNA/TcMar-Tigger	1535	+	170	144342823	59491
chr1	144283332	144483332	harbor1	chr1	144361434	144361669	DNA/TcMar-Tigger	1250	+	118	144361552	78220
chr1	67038643	67238643	harbor1	chr1	67110958	67111183	DNA/TcMar-Tigger	734	+	112	67111070	72427
chr1	67038643	67238643	harbor1	chr1	67111197	67111324	DNA/TcMar-Tigger	430	+	64	67111261	72618
chr1	179157233	179357233	harbor1	chr1	179157508	179157612	DNA/TcMar-Tigger	1293	+	52	179157560	327
chr1	179157233	179357233	harbor1	chr1	179231290	179231598	DNA/TcMar-Tigger	1635	+	154	179231444	74211
chr1	59604000	59804000	harbor1	chr1	59662545	59662888	DNA/TcMar-Tigger	2182	+	172	59662717	58717
chr1	72566007	72766007	harbor1	chr1	72589164	72589614	DNA/TcMar-Tigger	576	+	225	72589389	23382
chr1	72566007	72766007	harbor1	chr1	72639991	72640044	DNA/TcMar-Tigger	14445	+	26	72640017	74010
chr1	72566007	72766007	harbor1	chr1	72640314	72642926	DNA/TcMar-Tigger	14445	+	1306	72641620	75613
chr1	233496035	233696035	harbor1	chr1	233568382	233568606	DNA/TcMar-Tigger	530	+	112	233568494	72459
chr1	233496035	233696035	harbor1	chr1	233570676	233570811	DNA/TcMar-Tigger	638	+	68	233570744	74709
chr1	28884288	29084288	harbor1	chr1	28971487	28971890	DNA/TcMar-Tigger	848	+	202	28971689	87401
chr1	103645883	103845883	harbor1	chr1	103646052	103646233	DNA/TcMar-Tigger	829	+	90	103646142	259
chr1	103645883	103845883	harbor1	chr1	103646300	103646577	DNA/TcMar-Tigger	997	+	138	103646438	555
chr1	103645883	103845883	harbor1	chr1	103740190	103740371	DNA/TcMar-Tigger	829	+	90	103740280	94397
chr1	103645883	103845883	harbor1	chr1	103740438	103740715	DNA/TcMar-Tigger	997	+	138	103740576	94693
chr1	82675227	82875227	harbor1	chr1	82685336	82686528	DNA/TcMar-Tigger	15021	+	596	82685932	10705
chr1	82675227	82875227	harbor1	chr1	82686844	82688214	DNA/TcMar-Tigger	15021	+	685	82687529	12302
chr1	82675227	82875227	harbor1	chr1	82688529	82688639	DNA/TcMar-Tigger	15021	+	55	82688584	13357
chr1	82675227	82875227	harbor1	chr1	82758718	82758938	DNA/TcMar-Tigger	920	+	110	82758828	83601
chr1	82675227	82875227	harbor1	chr1	82768183	82770798	DNA/TcMar-Tigger	15518	+	1308	82769491	94264
chr1	82675227	82875227	harbor1	chr1	82773484	82773562	DNA/TcMar-Tigger	462	+	39	82773523	98296
chr1	214447168	214647168	harbor1	chr1	214474180	214474481	DNA/TcMar-Tigger	547	+	150	214474330	27162
chr1	214447168	214647168	harbor1	chr1	214523314	214523632	DNA/TcMar-Tigger	2067	+	159	214523473	76305
chr1	25316005	25516005	harbor1	chr1	25319728	25319895	DNA/TcMar-Tigger	643	+	84	25319812	3807
chr1	25316005	25516005	harbor1	chr1	25320198	25320235	DNA/TcMar-Tigger	643	+	18	25320216	4211
chr1	233174045	233374045	harbor1	chr1	233229172	233229472	DNA/TcMar-Tigger	779	+	150	233229322	55277
chr1	233174045	233374045	harbor1	chr1	233232186	233232497	DNA/TcMar-Tigger	1827	+	156	233232342	58297
chr1	233174045	233374045	harbor1	chr1	233259891	233260097	DNA/TcMar-Tigger	1182	+	103	233259994	85949
chr1	233174045	233374045	harbor1	chr1	233269187	233269679	DNA/TcMar-Tigger	440	+	246	233269433	95388
chr1	93927525	94127525	harbor1	chr1	93935241	93936081	DNA/TcMar-Tigger	5912	+	420	93935661	8136
chr1	93927525	94127525	harbor1	chr1	93936076	93936406	DNA/TcMar-Tigger	2119	+	165	93936241	8716
chr1	93927525	94127525	harbor1	chr1	93959842	93960077	DNA/TcMar-Tigger	1477	+	118	93959960	32435
chr1	93927525	94127525	harbor1	chr1	93969066	93969895	DNA/TcMar-Tigger	5145	+	414	93969480	41955
chr1	177311812	177511812	harbor1	chr1	177317396	177317733	DNA/TcMar-Tigger	1792	+	168	177317564	5752
chr1	85028211	85228211	harbor1	chr1	85051441	85052095	DNA/TcMar-Tigger	6098	+	327	85051768	23557
chr1	85028211	85228211	harbor1	chr1	85052405	85052471	DNA/TcMar-Tigger	6098	+	33	85052438	24227
chr1	85028211	85228211	harbor1	chr1	85052764	85052993	DNA/TcMar-Tigger	6098	+	114	85052878	24667
chr1	85028211	85228211	harbor1	chr1	85053299	85053590	DNA/TcMar-Tigger	6098	+	146	85053445	25234
chr1	85028211	85228211	harbor1	chr1	85098956	85099140	DNA/TcMar-Tigger	457	+	92	85099048	70837
chr1	64770902	64970902	harbor1	chr1	64790149	64790654	DNA/TcMar-Tigger	2941	+	252	64790401	19499
chr1	64770902	64970902	harbor1	chr1	64790655	64790748	DNA/TcMar-Tigger	587	+	46	64790701	19799
chr1	64770902	64970902	harbor1	chr1	64810814	64811852	DNA/TcMar-Tigger	6451	+	519	64811333	40431
chr1	207860445	208060445	harbor1	chr1	207903600	207904050	DNA/TcMar-Tigger	817	+	225	207903825	43380
chr1	207860445	208060445	harbor1	chr1	207905631	207905977	DNA/TcMar-Tigger	2327	+	173	207905804	45359
chr1	207860445	208060445	harbor1	chr1	207914781	207914947	DNA/TcMar-Tigger	989	+	83	207914864	54419
chr1	207860445	208060445	harbor1	chr1	207921177	207921485	DNA/TcMar-Tigger	1626	+	154	207921331	60886
chr1	65360987	65560987	harbor1	chr1	65407000	65407257	DNA/TcMar-Tigger	1491	+	128	65407128	46141
chr1	65360987	65560987	harbor1	chr1	65407271	65407360	DNA/TcMar-Tigger	503	+	44	65407315	46328
chr1	220494210	220694210	harbor1	chr1	220507835	220508159	DNA/TcMar-Tigger	1486	+	162	220507997	13787
chr1	220494210	220694210	harbor1	chr1	220516889	220519270	DNA/TcMar-Tigger	14910	+	1190	220518079	23869
chr1	220494210	220694210	harbor1	chr1	220589596	220589716	DNA/TcMar-Tigger	425	+	60	220589656	95446
chr1	229486705	229686705	harbor1	chr1	229504732	229504928	DNA/TcMar-Tigger	2678	+	98	229504830	18125
chr1	229486705	229686705	harbor1	chr1	229505153	229505472	DNA/TcMar-Tigger	2678	+	160	229505313	18608
chr1	229486705	229686705	harbor1	chr1	229545733	229545890	DNA/TcMar-Tigger	2608	+	78	229545811	59106
chr1	229486705	229686705	harbor1	chr1	229546189	229546471	DNA/TcMar-Tigger	2608	+	141	229546330	59625
chr1	229486705	229686705	harbor1	chr1	229568065	229568101	DNA/TcMar-Tigger	495	+	18	229568083	81378
chr1	229486705	229686705	harbor1	chr1	229568470	229568525	DNA/TcMar-Tigger	495	+	28	229568498	81793
chr1	229486705	229686705	harbor1	chr1	229568523	229568538	DNA/TcMar-Tigger	767	+	8	229568531	81826
chr1	229486705	229686705	harbor1	chr1	229569180	229569347	DNA/TcMar-Tigger	767	+	84	229569264	82559
chr1	229486705	229686705	harbor1	chr1	229569348	229569488	DNA/TcMar-Tigger	1016	+	70	229569418	82713
chr1	229486705	229686705	harbor1	chr1	229571808	229571891	DNA/TcMar-Tigger	1912	+	42	229571850	85145
chr1	229486705	229686705	harbor1	chr1	229572187	229572459	DNA/TcMar-Tigger	1912	+	136	229572323	85618
chr1	60407136	60607136	harbor1	chr1	60418123	60418638	DNA/TcMar-Tigger	6997	+	258	60418381	11245
chr1	60407136	60607136	harbor1	chr1	60418674	60419358	DNA/TcMar-Tigger	6997	+	342	60419016	11880
chr1	118666573	118866573	harbor1	chr1	118694469	118694625	DNA/TcMar-Tigger	837	+	78	118694547	27974
chr1	118666573	118866573	harbor1	chr1	118697737	118700263	DNA/TcMar-Tigger	14699	+	1263	118699000	32427
chr1	118666573	118866573	harbor1	chr1	118718960	118719162	DNA/TcMar-Tigger	1104	+	101	118719061	52488
chr1	55874565	56074565	harbor1	chr1	55924147	55924472	DNA/TcMar-Tigger	1565	+	162	55924309	49744
chr1	61547258	61747258	harbor1	chr1	61597503	61597710	DNA/TcMar-Tigger	1337	+	104	61597607	50349
chr1	192476602	192676602	harbor1	chr1	192520625	192520886	DNA/TcMar-Tigger	1303	+	130	192520755	44153
chr1	192476602	192676602	harbor1	chr1	192520887	192521110	DNA/TcMar-Tigger	1495	+	112	192520999	44397
chr1	192476602	192676602	harbor1	chr1	192559496	192559728	DNA/TcMar-Tigger	1376	+	116	192559612	83010
chr1	179379132	179579132	harbor1	chr1	179467343	179467642	DNA/TcMar-Tigger	1299	+	150	179467493	88361
chr1	235130086	235330086	harbor1	chr1	235133748	235133859	DNA/TcMar-Tigger	478	+	56	235133804	3718
chr1	235130086	235330086	harbor1	chr1	235193670	235193884	DNA/TcMar-Tigger	1072	+	107	235193777	63691
chr1	35024738	35224738	harbor1	chr1	35034072	35034385	DNA/TcMar-Tigger	1325	+	156	35034228	9490
chr1	35024738	35224738	harbor1	chr1	35065106	35065569	DNA/TcMar-Tigger	2005	+	232	35065338	40600
chr1	235520757	235720757	harbor1	chr1	235533817	235534036	DNA/TcMar-Tigger	1407	+	110	235533927	13170
chr1	235520757	235720757	harbor1	chr1	235534357	235534538	DNA/TcMar-Tigger	1349	+	90	235534447	13690
chr1	235520757	235720757	harbor1	chr1	235534834	235534913	DNA/TcMar-Tigger	1349	+	40	235534874	14117
chr1	118267868	118467868	harbor1	chr1	118276313	118276648	DNA/TcMar-Tigger	1879	+	168	118276481	8613
chr1	66900725	67100725	harbor1	chr1	66922997	66923101	DNA/TcMar-Tigger	446	+	52	66923049	22324
chr1	66900725	67100725	harbor1	chr1	66923099	66923425	DNA/TcMar-Tigger	866	+	163	66923262	22537
chr1	90716908	90916908	harbor1	chr1	90792661	90792798	DNA/TcMar-Tigger	512	+	68	90792729	75821
chr1	108672567	108872567	harbor1	chr1	108677407	108677603	DNA/TcMar-Tigger	1208	+	98	108677505	4938
chr1	108672567	108872567	harbor1	chr1	108679205	108679384	DNA/TcMar-Tigger	553	+	90	108679295	6728
chr1	108672567	108872567	harbor1	chr1	108679516	108679660	DNA/TcMar-Tigger	1008	+	72	108679588	7021
chr1	108672567	108872567	harbor1	chr1	108752354	108752558	DNA/TcMar-Tigger	1142	+	102	108752456	79889
chr1	234606365	234806365	harbor1	chr1	234622605	234622795	DNA/TcMar-Tigger	2143	+	95	234622700	16335
chr1	234606365	234806365	harbor1	chr1	234623090	234623331	DNA/TcMar-Tigger	2143	+	120	234623210	16845
chr1	234606365	234806365	harbor1	chr1	234646230	234646644	DNA/TcMar-Tigger	1021	+	207	234646437	40072
chr1	234606365	234806365	harbor1	chr1	234669122	234669273	DNA/TcMar-Tigger	600	+	76	234669198	62833
chr1	75516586	75716586	harbor1	chr1	75571420	75571807	DNA/TcMar-Tigger	2032	+	194	75571614	55028
chr1	75516586	75716586	harbor1	chr1	75600591	75600940	DNA/TcMar-Tigger	1735	+	174	75600765	84179
chr1	59863231	60063231	harbor1	chr1	59941211	59941935	DNA/TcMar-Tigger	3984	+	362	59941573	78342
chr1	59863231	60063231	harbor1	chr1	59941936	59942103	DNA/TcMar-Tigger	903	+	84	59942020	78789
chr1	30835619	31035619	harbor1	chr1	30861795	30861958	DNA/TcMar-Tigger	4828	+	82	30861877	26258
chr1	30835619	31035619	harbor1	chr1	30862257	30862673	DNA/TcMar-Tigger	4828	+	208	30862465	26846
chr1	30835619	31035619	harbor1	chr1	30862977	30863035	DNA/TcMar-Tigger	4828	+	29	30863006	27387
chr1	30835619	31035619	harbor1	chr1	30863347	30863661	DNA/TcMar-Tigger	4828	+	157	30863504	27885
chr1	30835619	31035619	harbor1	chr1	30863982	30864240	DNA/TcMar-Tigger	4828	+	129	30864111	28492
chr1	74122454	74322454	harbor1	chr1	74145902	74146242	DNA/TcMar-Tigger	1662	+	170	74146072	23618
chr1	165814343	166014343	harbor1	chr1	165863363	165863589	DNA/TcMar-Tigger	481	+	113	165863476	49133
chr1	165814343	166014343	harbor1	chr1	165876182	165876368	DNA/TcMar-Tigger	495	+	93	165876275	61932
chr1	165814343	166014343	harbor1	chr1	165893947	165894217	DNA/TcMar-Tigger	1170	+	135	165894082	79739
chr1	179246732	179446732	harbor1	chr1	179295575	179295720	DNA/TcMar-Tigger	1036	+	72	179295647	48915
chr1	179246732	179446732	harbor1	chr1	179296269	179296397	DNA/TcMar-Tigger	1036	+	64	179296333	49601
chr1	179246732	179446732	harbor1	chr1	179339809	179340092	DNA/TcMar-Tigger	775	+	142	179339951	93219
chr1	187759418	187959418	harbor1	chr1	187775839	187776538	DNA/TcMar-Tigger	4015	+	350	187776189	16771
chr1	225021401	225221401	harbor1	chr1	225047339	225047663	DNA/TcMar-Tigger	1888	+	162	225047501	26100
chr1	94639859	94839859	harbor1	chr1	94680726	94681203	DNA/TcMar-Tigger	1270	+	238	94680964	41105
chr1	94639859	94839859	harbor1	chr1	94681502	94681556	DNA/TcMar-Tigger	1270	+	27	94681529	41670
chr1	49940313	50140313	harbor1	chr1	49953551	49953770	DNA/TcMar-Tigger	1249	+	110	49953661	13348
chr1	49940313	50140313	harbor1	chr1	49972585	49972876	DNA/TcMar-Tigger	1826	+	146	49972731	32418
chr1	49940313	50140313	harbor1	chr1	49978903	49979179	DNA/TcMar-Tigger	5680	+	138	49979041	38728
chr1	49940313	50140313	harbor1	chr1	49979483	49980218	DNA/TcMar-Tigger	5680	+	368	49979851	39538
chr1	49940313	50140313	harbor1	chr1	49980809	49981501	DNA/TcMar-Tigger	2064	+	346	49981155	40842
chr1	49940313	50140313	harbor1	chr1	50019050	50019208	DNA/TcMar-Tigger	537	+	79	50019129	78816
chr1	49940313	50140313	harbor1	chr1	49971090	49971833	DNA/TcMar-Tigger	4276	+	372	49971462	31149
chr1	80182806	80382806	harbor1	chr1	80186834	80186983	DNA/TcMar-Tigger	710	+	74	80186908	4102
chr1	80182806	80382806	harbor1	chr1	80186972	80187279	DNA/TcMar-Tigger	1713	+	154	80187126	4320
chr1	80182806	80382806	harbor1	chr1	80187291	80187841	DNA/TcMar-Tigger	3350	+	275	80187566	4760
chr1	80182806	80382806	harbor1	chr1	80196932	80197571	DNA/TcMar-Tigger	3168	+	320	80197252	14446
chr1	246695878	246895878	harbor1	chr1	246706549	246706682	DNA/TcMar-Tigger	685	+	66	246706615	10737
chr1	246450637	246650637	harbor1	chr1	246525139	246525293	DNA/TcMar-Tigger	867	+	77	246525216	74579
chr1	86700808	86900808	harbor1	chr1	86714709	86714955	DNA/TcMar-Tigger	471	+	123	86714832	14024
chr1	86700808	86900808	harbor1	chr1	86717723	86717880	DNA/TcMar-Tigger	418	+	78	86717801	16993
chr1	86700808	86900808	harbor1	chr1	86727419	86727621	DNA/TcMar-Tigger	1011	+	101	86727520	26712
chr1	107018212	107218212	harbor1	chr1	107094053	107094502	DNA/TcMar-Tigger	2404	+	224	107094277	76065
chr1	171745570	171945570	harbor1	chr1	171748723	171749277	DNA/TcMar-Tigger	5923	+	277	171749000	3430
chr1	171745570	171945570	harbor1	chr1	171749583	171750178	DNA/TcMar-Tigger	5923	+	298	171749881	4311
chr1	202362226	202562226	harbor1	chr1	202407828	202408149	DNA/TcMar-Tigger	1513	+	160	202407988	45762
chr1	80147950	80347950	harbor1	chr1	80186834	80186983	DNA/TcMar-Tigger	710	+	74	80186908	38958
chr1	80147950	80347950	harbor1	chr1	80186972	80187279	DNA/TcMar-Tigger	1713	+	154	80187126	39176
chr1	80147950	80347950	harbor1	chr1	80187291	80187841	DNA/TcMar-Tigger	3350	+	275	80187566	39616
chr1	80147950	80347950	harbor1	chr1	80196932	80197571	DNA/TcMar-Tigger	3168	+	320	80197252	49302
chr1	47314204	47514204	harbor1	chr1	47316976	47317122	DNA/TcMar-Tigger	886	+	73	47317049	2845
chr1	186075651	186275651	harbor1	chr1	186097283	186097493	DNA/TcMar-Tigger	780	+	105	186097388	21737
chr1	240463778	240663778	harbor1	chr1	240466966	240467277	DNA/TcMar-Tigger	710	+	156	240467122	3344
chr1	240463778	240663778	harbor1	chr1	240467566	240467681	DNA/TcMar-Tigger	710	+	58	240467624	3846
chr1	240463778	240663778	harbor1	chr1	240511215	240511468	DNA/TcMar-Tigger	893	+	126	240511341	47563
chr1	240463778	240663778	harbor1	chr1	240511771	240511848	DNA/TcMar-Tigger	893	+	38	240511809	48031
chr1	240463778	240663778	harbor1	chr1	240543916	240544151	DNA/TcMar-Tigger	1637	+	118	240544034	80256
chr1	240463778	240663778	harbor1	chr1	240544447	240544545	DNA/TcMar-Tigger	1637	+	49	240544496	80718
chr1	119735737	119935737	harbor1	chr1	119784738	119785056	DNA/TcMar-Tigger	1211	+	159	119784897	49160
chr1	193664295	193864295	harbor1	chr1	193704353	193704659	DNA/TcMar-Tigger	1345	+	153	193704506	40211
chr1	193664295	193864295	harbor1	chr1	193741475	193741906	DNA/TcMar-Tigger	2114	+	216	193741691	77396
chr1	230981999	231181999	harbor1	chr1	231054634	231054692	DNA/TcMar-Tigger	3574	+	29	231054663	72664
chr1	230981999	231181999	harbor1	chr1	231054996	231055610	DNA/TcMar-Tigger	3574	+	307	231055303	73304
chr1	15129416	15329416	harbor1	chr1	15172652	15172912	DNA/TcMar-Tigger	1386	+	130	15172782	43366
chr1	15129416	15329416	harbor1	chr1	15172928	15173000	DNA/TcMar-Tigger	442	+	36	15172964	43548
chr1	243457451	243657451	harbor1	chr1	243539113	243539532	DNA/TcMar-Tigger	2405	+	210	243539323	81872
chr1	179541365	179741365	harbor1	chr1	179599744	179600152	DNA/TcMar-Tigger	2035	+	204	179599948	58583
chr1	179541365	179741365	harbor1	chr1	179600149	179600572	DNA/TcMar-Tigger	2801	+	212	179600361	58996
chr1	179939717	180139717	harbor1	chr1	180034408	180036795	DNA/TcMar-Tigger	14607	+	1194	180035602	95885
chr1	40991371	41191371	harbor1	chr1	41051100	41052181	DNA/TcMar-Tigger	6536	+	540	41051640	60269
chr1	40991371	41191371	harbor1	chr1	41052527	41052609	DNA/TcMar-Tigger	6536	+	41	41052568	61197
chr1	90017094	90217094	harbor1	chr1	90041526	90042349	DNA/TcMar-Tigger	4665	+	412	90041938	24844
chr1	90017094	90217094	harbor1	chr1	90077558	90077808	DNA/TcMar-Tigger	954	+	125	90077683	60589
chr1	90017094	90217094	harbor1	chr1	90091955	90092379	DNA/TcMar-Tigger	2620	+	212	90092167	75073
chr1	90017094	90217094	harbor1	chr1	90092406	90092806	DNA/TcMar-Tigger	1516	+	200	90092606	75512
chr1	46200334	46400334	harbor1	chr1	46213199	46213483	DNA/TcMar-Tigger	1127	+	142	46213341	13007
chr1	98661384	98861384	harbor1	chr1	98670477	98670770	DNA/TcMar-Tigger	1425	+	146	98670623	9239
chr1	98661384	98861384	harbor1	chr1	98700876	98701086	DNA/TcMar-Tigger	574	+	105	98700981	39597
chr1	98661384	98861384	harbor1	chr1	98721118	98721309	DNA/TcMar-Tigger	1227	+	96	98721214	59830
chr1	207408421	207608421	harbor1	chr1	207503870	207504222	DNA/TcMar-Tigger	2156	+	176	207504046	95625
chr1	148672769	148872769	harbor1	chr1	148724994	148725158	DNA/TcMar-Tigger	445	+	82	148725076	52307
chr1	202385848	202585848	harbor1	chr1	202407828	202408149	DNA/TcMar-Tigger	1513	+	160	202407988	22140
chr1	55993739	56193739	harbor1	chr1	56025755	56026389	DNA/TcMar-Tigger	3007	+	317	56026072	32333
chr1	227762708	227962708	harbor1	chr1	227773273	227773767	DNA/TcMar-Tigger	1782	+	247	227773520	10812
chr1	227762708	227962708	harbor1	chr1	227847502	227847589	DNA/TcMar-Tigger	524	+	44	227847546	84838
chr1	232605632	232805632	harbor1	chr1	232687545	232687601	DNA/TcMar-Tigger	1745	+	28	232687573	81941
chr1	232605632	232805632	harbor1	chr1	232687734	232688023	DNA/TcMar-Tigger	1745	+	144	232687878	82246
chr1	232046476	232246476	harbor1	chr1	232064394	232064762	DNA/TcMar-Tigger	780	+	184	232064578	18102
chr1	232046476	232246476	harbor1	chr1	232113983	232114587	DNA/TcMar-Tigger	3467	+	302	232114285	67809
chr1	101969950	102169950	harbor1	chr1	102041921	102042123	DNA/TcMar-Tigger	1086	+	101	102042022	72072
chr1	85104441	85304441	harbor1	chr1	85170492	85170674	DNA/TcMar-Tigger	946	+	91	85170583	66142
chr1	49016890	49216890	harbor1	chr1	49107158	49107428	DNA/TcMar-Tigger	1430	+	135	49107293	90403
chr1	241728723	241928723	harbor1	chr1	241734832	241734971	DNA/TcMar-Tigger	977	+	70	241734902	6179
chr1	168659160	168859160	harbor1	chr1	168659165	168659576	DNA/TcMar-Tigger	2425	+	206	168659371	211
chr1	168659160	168859160	harbor1	chr1	168662293	168664268	DNA/TcMar-Tigger	11874	+	988	168663281	4121
chr1	73697291	73897291	harbor1	chr1	73775454	73776475	DNA/TcMar-Tigger	4794	+	510	73775964	78673
chr1	73697291	73897291	harbor1	chr1	73792863	73793264	DNA/TcMar-Tigger	1115	+	200	73793063	95772
chr1	73697291	73897291	harbor1	chr1	73793559	73793737	DNA/TcMar-Tigger	1115	+	89	73793648	96357
chr1	38736685	38936685	harbor1	chr1	38827636	38827963	DNA/TcMar-Tigger	1949	+	164	38827800	91115
chr1	71055478	71255478	harbor1	chr1	71060558	71060881	DNA/TcMar-Tigger	1504	+	162	71060720	5242
chr1	71055478	71255478	harbor1	chr1	71077150	71077285	DNA/TcMar-Tigger	727	+	68	71077218	21740
chr1	28184684	28384684	harbor1	chr1	28211282	28211495	DNA/TcMar-Tigger	1362	+	106	28211388	26704
chr1	28184684	28384684	harbor1	chr1	28228540	28228774	DNA/TcMar-Tigger	1151	+	117	28228657	43973
chr1	28184684	28384684	harbor1	chr1	28242810	28243095	DNA/TcMar-Tigger	1817	+	142	28242952	58268
chr1	28184684	28384684	harbor1	chr1	28243228	28243343	DNA/TcMar-Tigger	612	+	58	28243286	58602
chr1	28184684	28384684	harbor1	chr1	28252472	28252601	DNA/TcMar-Tigger	4606	+	64	28252536	67852
chr1	28184684	28384684	harbor1	chr1	28253217	28253685	DNA/TcMar-Tigger	4606	+	234	28253451	68767
chr1	28184684	28384684	harbor1	chr1	28253990	28254156	DNA/TcMar-Tigger	4606	+	83	28254073	69389
chr1	28184684	28384684	harbor1	chr1	28254456	28254590	DNA/TcMar-Tigger	780	+	67	28254523	69839
chr1	28184684	28384684	harbor1	chr1	28254823	28254905	DNA/TcMar-Tigger	588	+	41	28254864	70180
chr1	28184684	28384684	harbor1	chr1	28255308	28255606	DNA/TcMar-Tigger	2155	+	149	28255457	70773
chr1	196591551	196791551	harbor1	chr1	196616196	196616446	DNA/TcMar-Tigger	630	+	125	196616321	24770
chr1	196591551	196791551	harbor1	chr1	196618723	196619025	DNA/TcMar-Tigger	445	+	151	196618874	27323
chr1	196591551	196791551	harbor1	chr1	196657359	196657591	DNA/TcMar-Tigger	1056	+	116	196657475	65924
chr1	184262829	184462829	harbor1	chr1	184263418	184265606	DNA/TcMar-Tigger	14196	+	1094	184264512	1683
chr1	184262829	184462829	harbor1	chr1	184265771	184265918	DNA/TcMar-Tigger	14196	+	74	184265845	3016
chr1	184262829	184462829	harbor1	chr1	184266218	184266332	DNA/TcMar-Tigger	14196	+	57	184266275	3446
chr1	38930014	39130014	harbor1	chr1	38994110	38994302	DNA/TcMar-Tigger	790	+	96	38994206	64192
chr1	234599957	234799957	harbor1	chr1	234622605	234622795	DNA/TcMar-Tigger	2143	+	95	234622700	22743
chr1	234599957	234799957	harbor1	chr1	234623090	234623331	DNA/TcMar-Tigger	2143	+	120	234623210	23253
chr1	234599957	234799957	harbor1	chr1	234646230	234646644	DNA/TcMar-Tigger	1021	+	207	234646437	46480
chr1	234599957	234799957	harbor1	chr1	234669122	234669273	DNA/TcMar-Tigger	600	+	76	234669198	69241
chr1	215993077	216193077	harbor1	chr1	216064583	216064912	DNA/TcMar-Tigger	1916	+	164	216064747	71670
chr1	53922804	54122804	harbor1	chr1	53987914	53987986	DNA/TcMar-Tigger	446	+	36	53987950	65146
chr1	53922804	54122804	harbor1	chr1	53988207	53988539	DNA/TcMar-Tigger	1939	+	166	53988373	65569
chr1	39659410	39859410	harbor1	chr1	39741980	39742251	DNA/TcMar-Tigger	826	+	136	39742116	82706
chr1	39659410	39859410	harbor1	chr1	39742631	39742829	DNA/TcMar-Tigger	557	+	99	39742730	83320
chr1	17385748	17585748	harbor1	chr1	17417828	17418122	DNA/TcMar-Tigger	1018	+	147	17417975	32227
chr1	216212967	216412967	harbor1	chr1	216256510	216256943	DNA/TcMar-Tigger	2241	+	216	216256726	43759
chr1	222042006	222242006	harbor1	chr1	222090675	222090950	DNA/TcMar-Tigger	889	+	138	222090813	48807
chr1	222042006	222242006	harbor1	chr1	222091265	222091354	DNA/TcMar-Tigger	889	+	44	222091309	49303
chr1	222042006	222242006	harbor1	chr1	222092129	222092453	DNA/TcMar-Tigger	672	+	162	222092291	50285
chr1	76437856	76637856	harbor1	chr1	76442276	76442477	DNA/TcMar-Tigger	642	+	100	76442376	4520
chr1	247605058	247805058	harbor1	chr1	247622060	247622565	DNA/TcMar-Tigger	2918	+	252	247622312	17254
chr1	207841180	208041180	harbor1	chr1	207903600	207904050	DNA/TcMar-Tigger	817	+	225	207903825	62645
chr1	207841180	208041180	harbor1	chr1	207905631	207905977	DNA/TcMar-Tigger	2327	+	173	207905804	64624
chr1	207841180	208041180	harbor1	chr1	207914781	207914947	DNA/TcMar-Tigger	989	+	83	207914864	73684
chr1	207841180	208041180	harbor1	chr1	207921177	207921485	DNA/TcMar-Tigger	1626	+	154	207921331	80151
chr1	113153566	113353566	harbor1	chr1	113200810	113201173	DNA/TcMar-Tigger	2115	+	182	113200992	47426
chr1	113153566	113353566	harbor1	chr1	113201234	113201729	DNA/TcMar-Tigger	3801	+	248	113201482	47916
chr1	113153566	113353566	harbor1	chr1	113202085	113202313	DNA/TcMar-Tigger	1101	+	114	113202199	48633
chr1	113153566	113353566	harbor1	chr1	113205170	113205214	DNA/TcMar-Tigger	2759	+	22	113205192	51626
chr1	113153566	113353566	harbor1	chr1	113205532	113205959	DNA/TcMar-Tigger	2759	+	214	113205746	52180
chr1	113153566	113353566	harbor1	chr1	113238971	113239501	DNA/TcMar-Tigger	1581	+	265	113239236	85670
chr1	113153566	113353566	harbor1	chr1	113249897	113250232	DNA/TcMar-Tigger	1985	+	168	113250065	96499
chr1	72901119	73101119	harbor1	chr1	72910723	72910889	DNA/TcMar-Tigger	879	+	83	72910806	9687
chr1	72901119	73101119	harbor1	chr1	72919650	72919801	DNA/TcMar-Tigger	639	+	76	72919726	18607
chr1	72901119	73101119	harbor1	chr1	72973449	72973570	DNA/TcMar-Tigger	467	+	60	72973509	72390
chr1	72901119	73101119	harbor1	chr1	72973579	72973811	DNA/TcMar-Tigger	1470	+	116	72973695	72576
chr1	72901119	73101119	harbor1	chr1	72908658	72908807	DNA/TcMar-Tigger	811	+	74	72908732	7613
chr1	224477029	224677029	harbor1	chr1	224554399	224554574	DNA/TcMar-Tigger	1753	+	88	224554487	77458
chr1	224477029	224677029	harbor1	chr1	224554887	224555104	DNA/TcMar-Tigger	1753	+	108	224554995	77966
chr1	16331144	16531144	harbor1	chr1	16358299	16358395	DNA/TcMar-Tigger	605	+	48	16358347	27203
chr1	63671700	63871700	harbor1	chr1	63741506	63742026	DNA/TcMar-Tigger	3347	+	260	63741766	70066
chr1	155931458	156131458	harbor1	chr1	156005586	156005769	DNA/TcMar-Tigger	2039	+	92	156005678	74220
chr1	155931458	156131458	harbor1	chr1	156006388	156006605	DNA/TcMar-Tigger	2039	+	108	156006496	75038
chr1	155931458	156131458	harbor1	chr1	156026510	156026836	DNA/TcMar-Tigger	1850	+	163	156026673	95215
chr1	82411925	82611925	harbor1	chr1	82463601	82463928	DNA/TcMar-Tigger	1855	+	164	82463765	51840
chr1	168316166	168516166	harbor1	chr1	168329436	168329611	DNA/TcMar-Tigger	6260	+	88	168329524	13358
chr1	168316166	168516166	harbor1	chr1	168329929	168330820	DNA/TcMar-Tigger	6260	+	446	168330375	14209
chr1	168316166	168516166	harbor1	chr1	168357156	168357390	DNA/TcMar-Tigger	1054	+	117	168357273	41107
chr1	168316166	168516166	harbor1	chr1	168365687	168365838	DNA/TcMar-Tigger	427	+	76	168365763	49597
chr1	168316166	168516166	harbor1	chr1	168386250	168386541	DNA/TcMar-Tigger	1520	+	146	168386396	70230
chr1	168316166	168516166	harbor1	chr1	168401588	168401914	DNA/TcMar-Tigger	1569	+	163	168401751	85585
chr1	165883642	166083642	harbor1	chr1	165893947	165894217	DNA/TcMar-Tigger	1170	+	135	165894082	10440
chr1	165883642	166083642	harbor1	chr1	165951844	165952146	DNA/TcMar-Tigger	2177	+	151	165951995	68353
chr1	165883642	166083642	harbor1	chr1	165952451	165952503	DNA/TcMar-Tigger	2177	+	26	165952477	68835
chr1	165883642	166083642	harbor1	chr1	165956365	165956628	DNA/TcMar-Tigger	862	+	132	165956497	72855
chr1	25414738	25614738	harbor1	chr1	25423939	25424304	DNA/TcMar-Tigger	2381	+	182	25424121	9383
chr1	6801081	7001081	harbor1	chr1	6854100	6854507	DNA/TcMar-Tigger	1203	+	204	6854304	53223
chr1	189566158	189766158	harbor1	chr1	189658368	189658896	DNA/TcMar-Tigger	2039	+	264	189658632	92474
chr1	50699189	50899189	harbor1	chr1	50781870	50782546	DNA/TcMar-Tigger	4863	+	338	50782208	83019
chr1	50699189	50899189	harbor1	chr1	50782681	50782941	DNA/TcMar-Tigger	4863	+	130	50782811	83622
chr1	50699189	50899189	harbor1	chr1	50793850	50794088	DNA/TcMar-Tigger	1307	+	119	50793969	94780
chr1	176908923	177108923	harbor1	chr1	176923471	176923787	DNA/TcMar-Tigger	1644	+	158	176923629	14706
chr1	80893542	81093542	harbor1	chr1	80953948	80954301	DNA/TcMar-Tigger	1438	+	176	80954124	60582
chr1	107028936	107228936	harbor1	chr1	107094053	107094502	DNA/TcMar-Tigger	2404	+	224	107094277	65341
chr1	107028936	107228936	harbor1	chr1	107118545	107119079	DNA/TcMar-Tigger	2841	+	267	107118812	89876
chr1	17023977	17223977	harbor1	chr1	17025823	17026052	DNA/TcMar-Tigger	1408	+	114	17025937	1960
chr1	2780000	2980000	harbor1	chr1	2781133	2781307	DNA/TcMar-Tigger	690	+	87	2781220	1220
chr1	2780000	2980000	harbor1	chr1	2849989	2850711	DNA/TcMar-Tigger	3113	+	361	2850350	70350
chr1	2780000	2980000	harbor1	chr1	2850862	2851078	DNA/TcMar-Tigger	888	+	108	2850970	70970
chr1	163652398	163852398	harbor1	chr1	163660358	163660546	DNA/TcMar-Tigger	945	+	94	163660452	8054
chr1	163652398	163852398	harbor1	chr1	163736070	163736289	DNA/TcMar-Tigger	1218	+	110	163736180	83782
chr1	163652398	163852398	harbor1	chr1	163659653	163659799	DNA/TcMar-Tigger	945	+	73	163659726	7328
chr1	209267998	209467998	harbor1	chr1	209276552	209277142	DNA/TcMar-Tigger	4365	+	295	209276847	8849
chr1	209267998	209467998	harbor1	chr1	209277453	209277539	DNA/TcMar-Tigger	4365	+	43	209277496	9498
chr1	144908369	145108369	harbor1	chr1	144987640	144988040	DNA/TcMar-Tigger	861	+	200	144987840	79471
chr1	65456012	65656012	harbor1	chr1	65474449	65474725	DNA/TcMar-Tigger	939	+	138	65474587	18575
chr1	65456012	65656012	harbor1	chr1	65475030	65475213	DNA/TcMar-Tigger	939	+	92	65475122	19110
chr1	65456012	65656012	harbor1	chr1	65500396	65500822	DNA/TcMar-Tigger	2289	+	213	65500609	44597
chr1	64581908	64781908	harbor1	chr1	64612621	64613333	DNA/TcMar-Tigger	4781	+	356	64612977	31069
chr1	64581908	64781908	harbor1	chr1	64613394	64613526	DNA/TcMar-Tigger	737	+	66	64613460	31552
chr1	64581908	64781908	harbor1	chr1	64641344	64641628	DNA/TcMar-Tigger	470	+	142	64641486	59578
chr1	64581908	64781908	harbor1	chr1	64672379	64672688	DNA/TcMar-Tigger	1806	+	154	64672533	90625
chr1	190853712	191053712	harbor1	chr1	190903601	190904627	DNA/TcMar-Tigger	4793	+	513	190904114	50402
chr1	190853712	191053712	harbor1	chr1	190948062	190948152	DNA/TcMar-Tigger	420	+	45	190948107	94395
chr1	190853712	191053712	harbor1	chr1	190948205	190949378	DNA/TcMar-Tigger	5825	+	586	190948791	95079
chr1	8064362	8264362	harbor1	chr1	8108761	8109591	DNA/TcMar-Tigger	15761	+	415	8109176	44814
chr1	8064362	8264362	harbor1	chr1	8111647	8111830	DNA/TcMar-Tigger	15761	+	92	8111739	47377
chr1	8064362	8264362	harbor1	chr1	8109889	8111362	DNA/TcMar-Tigger	15761	+	736	8110625	46263
chr1	64527976	64727976	harbor1	chr1	64612621	64613333	DNA/TcMar-Tigger	4781	+	356	64612977	85001
chr1	64527976	64727976	harbor1	chr1	64613394	64613526	DNA/TcMar-Tigger	737	+	66	64613460	85484
chr1	240926295	241126295	harbor1	chr1	241006711	241006907	DNA/TcMar-Tigger	1787	+	98	241006809	80514
chr1	240926295	241126295	harbor1	chr1	241007217	241007537	DNA/TcMar-Tigger	1787	+	160	241007377	81082
chr1	73345949	73545949	harbor1	chr1	73386838	73387243	DNA/TcMar-Tigger	1699	+	202	73387040	41091
chr1	73345949	73545949	harbor1	chr1	73444424	73444721	DNA/TcMar-Tigger	1028	+	148	73444572	98623
chr1	73345949	73545949	harbor1	chr1	73444748	73444831	DNA/TcMar-Tigger	1028	+	42	73444790	98841
chr1	73345949	73545949	harbor1	chr1	73383441	73383966	DNA/TcMar-Tigger	2302	+	262	73383703	37754
chr1	117182262	117382262	harbor1	chr1	117192902	117193245	DNA/TcMar-Tigger	1426	+	172	117193074	10812
chr1	209716267	209916267	harbor1	chr1	209724916	209725253	DNA/TcMar-Tigger	703	+	168	209725084	8817
chr1	209716267	209916267	harbor1	chr1	209776432	209776723	DNA/TcMar-Tigger	453	+	146	209776578	60311
chr1	69341619	69541619	harbor1	chr1	69342178	69342517	DNA/TcMar-Tigger	1916	+	170	69342348	729
chr1	69341619	69541619	harbor1	chr1	69403191	69403526	DNA/TcMar-Tigger	1823	+	168	69403359	61740
chr1	160416622	160616622	harbor1	chr1	160486026	160486268	DNA/TcMar-Tigger	1347	+	121	160486147	69525
chr1	11670734	11870734	harbor1	chr1	11727699	11727764	DNA/TcMar-Tigger	1776	+	32	11727731	56997
chr1	11670734	11870734	harbor1	chr1	11728098	11728424	DNA/TcMar-Tigger	1776	+	163	11728261	57527
chr1	242162182	242362182	harbor1	chr1	242209348	242209809	DNA/TcMar-Tigger	5498	+	230	242209578	47396
chr1	242162182	242362182	harbor1	chr1	242210091	242210317	DNA/TcMar-Tigger	5498	+	113	242210204	48022
chr1	242162182	242362182	harbor1	chr1	242210869	242211187	DNA/TcMar-Tigger	5498	+	159	242211028	48846
chr1	242162182	242362182	harbor1	chr1	242216794	242217340	DNA/TcMar-Tigger	8952	+	273	242217067	54885
chr1	242162182	242362182	harbor1	chr1	242217635	242218438	DNA/TcMar-Tigger	8952	+	402	242218037	55855
chr1	44843895	45043895	harbor1	chr1	44934884	44935501	DNA/TcMar-Tigger	1199	+	308	44935192	91297
chr1	44843895	45043895	harbor1	chr1	44935801	44935882	DNA/TcMar-Tigger	1199	+	40	44935841	91946
chr1	82454501	82654501	harbor1	chr1	82463601	82463928	DNA/TcMar-Tigger	1855	+	164	82463765	9264
chr1	82454501	82654501	harbor1	chr1	82534848	82535086	DNA/TcMar-Tigger	1402	+	119	82534967	80466
chr1	82454501	82654501	harbor1	chr1	82535645	82535734	DNA/TcMar-Tigger	591	+	44	82535689	81188
chr1	44151458	44351458	harbor1	chr1	44206370	44206471	DNA/TcMar-Tigger	653	+	50	44206420	54962
chr1	40991263	41191263	harbor1	chr1	41051100	41052181	DNA/TcMar-Tigger	6536	+	540	41051640	60377
chr1	40991263	41191263	harbor1	chr1	41052527	41052609	DNA/TcMar-Tigger	6536	+	41	41052568	61305
chr1	246719106	246919106	harbor1	chr1	246805099	246805410	DNA/TcMar-Tigger	1198	+	156	246805255	86149
chr1	25890385	26090385	harbor1	chr1	25958150	25958577	DNA/TcMar-Tigger	562	+	214	25958364	67979
chr1	25890385	26090385	harbor1	chr1	25973726	25973996	DNA/TcMar-Tigger	632	+	135	25973861	83476
chr1	88560581	88760581	harbor1	chr1	88644076	88644482	DNA/TcMar-Tigger	1535	+	203	88644279	83698
chr1	88560581	88760581	harbor1	chr1	88644764	88645017	DNA/TcMar-Tigger	1535	+	126	88644890	84309
chr1	88560581	88760581	harbor1	chr1	88657728	88657785	DNA/TcMar-Tigger	585	+	28	88657756	97175
chr1	88560581	88760581	harbor1	chr1	88658038	88658170	DNA/TcMar-Tigger	585	+	66	88658104	97523
chr1	165274943	165474943	harbor1	chr1	165283067	165283407	DNA/TcMar-Tigger	1959	+	170	165283237	8294
chr1	216396949	216596949	harbor1	chr1	216402399	216402828	DNA/TcMar-Tigger	2279	+	214	216402613	5664
chr1	216396949	216596949	harbor1	chr1	216450696	216451542	DNA/TcMar-Tigger	4418	+	423	216451119	54170
chr1	165907007	166107007	harbor1	chr1	165951844	165952146	DNA/TcMar-Tigger	2177	+	151	165951995	44988
chr1	165907007	166107007	harbor1	chr1	165952451	165952503	DNA/TcMar-Tigger	2177	+	26	165952477	45470
chr1	165907007	166107007	harbor1	chr1	165956365	165956628	DNA/TcMar-Tigger	862	+	132	165956497	49490
chr1	165907007	166107007	harbor1	chr1	165984590	165986971	DNA/TcMar-Tigger	16128	+	1190	165985780	78773
chr1	185302696	185502696	harbor1	chr1	185319432	185319588	DNA/TcMar-Tigger	1951	+	78	185319510	16814
chr1	185302696	185502696	harbor1	chr1	185319893	185320062	DNA/TcMar-Tigger	1951	+	84	185319977	17281
chr1	90126780	90326780	harbor1	chr1	90182632	90182827	DNA/TcMar-Tigger	554	+	98	90182730	55950
chr1	108874438	109074438	harbor1	chr1	108958204	108958597	DNA/TcMar-Tigger	2208	+	196	108958400	83962
chr1	108874438	109074438	harbor1	chr1	108959386	108959518	DNA/TcMar-Tigger	831	+	66	108959452	85014
chr1	108874438	109074438	harbor1	chr1	108959506	108959725	DNA/TcMar-Tigger	1212	+	110	108959616	85178
chr1	115023293	115223293	harbor1	chr1	115040431	115040656	DNA/TcMar-Tigger	1084	+	112	115040543	17250
chr1	115023293	115223293	harbor1	chr1	115047693	115047828	DNA/TcMar-Tigger	834	+	68	115047761	24468
chr1	115023293	115223293	harbor1	chr1	115066849	115067010	DNA/TcMar-Tigger	587	+	80	115066929	43636
chr1	115023293	115223293	harbor1	chr1	115090951	115091423	DNA/TcMar-Tigger	859	+	236	115091187	67894
chr1	243260514	243460514	harbor1	chr1	243300820	243301965	DNA/TcMar-Tigger	17140	+	572	243301392	40878
chr1	243260514	243460514	harbor1	chr1	243304085	243304153	DNA/TcMar-Tigger	17140	+	34	243304119	43605
chr1	243260514	243460514	harbor1	chr1	243325913	243326106	DNA/TcMar-Tigger	507	+	96	243326009	65495
chr1	243260514	243460514	harbor1	chr1	243326311	243326807	DNA/TcMar-Tigger	921	+	248	243326559	66045
chr1	243260514	243460514	harbor1	chr1	243302271	243303790	DNA/TcMar-Tigger	17140	+	760	243303031	42517
chr1	33130703	33330703	harbor1	chr1	33186018	33186523	DNA/TcMar-Tigger	2868	+	252	33186270	55567
chr1	66637003	66837003	harbor1	chr1	66710455	66711260	DNA/TcMar-Tigger	1480	+	402	66710857	73854
chr1	247863749	248063749	harbor1	chr1	247948552	247948806	DNA/TcMar-Tigger	1376	+	127	247948679	84930
chr1	247863749	248063749	harbor1	chr1	247962098	247962637	DNA/TcMar-Tigger	651	+	270	247962368	98619
chr1	108719431	108919431	harbor1	chr1	108752354	108752558	DNA/TcMar-Tigger	1142	+	102	108752456	33025
chr1	75177820	75377820	harbor1	chr1	75207698	75208158	DNA/TcMar-Tigger	3694	+	230	75207928	30108
chr1	75177820	75377820	harbor1	chr1	75208458	75208717	DNA/TcMar-Tigger	3694	+	130	75208588	30768
chr1	75177820	75377820	harbor1	chr1	75224063	75224617	DNA/TcMar-Tigger	6360	+	277	75224340	46520
chr1	75177820	75377820	harbor1	chr1	75224736	75225420	DNA/TcMar-Tigger	6360	+	342	75225078	47258
chr1	7395	207395	harbor1	chr1	80712	80804	DNA/TcMar-Tigger	1018	+	46	80758	73363
chr1	7395	207395	harbor1	chr1	81097	81231	DNA/TcMar-Tigger	1018	+	67	81164	73769
chr1	7395	207395	harbor1	chr1	81232	81691	DNA/TcMar-Tigger	2382	+	230	81462	74067
chr1	234961020	235161020	harbor1	chr1	235057325	235057536	DNA/TcMar-Tigger	603	+	106	235057431	96411
chr1	231241357	231441357	harbor1	chr1	231248685	231249018	DNA/TcMar-Tigger	1918	+	166	231248851	7494
chr1	231241357	231441357	harbor1	chr1	231287751	231287965	DNA/TcMar-Tigger	1083	+	107	231287858	46501
chr1	231241357	231441357	harbor1	chr1	231316826	231316895	DNA/TcMar-Tigger	417	+	34	231316860	75503
chr1	231241357	231441357	harbor1	chr1	231316894	231317285	DNA/TcMar-Tigger	1712	+	196	231317090	75733
chr1	231241357	231441357	harbor1	chr1	231318207	231318308	DNA/TcMar-Tigger	467	+	50	231318257	76900
chr1	231241357	231441357	harbor1	chr1	231329244	231329563	DNA/TcMar-Tigger	1659	+	160	231329404	88047
chr1	18061130	18261130	harbor1	chr1	18088683	18088979	DNA/TcMar-Tigger	942	+	148	18088831	27701
chr1	54878262	55078262	harbor1	chr1	54971015	54971215	DNA/TcMar-Tigger	566	+	100	54971115	92853
chr1	54878262	55078262	harbor1	chr1	54971859	54972162	DNA/TcMar-Tigger	964	+	152	54972011	93749
chr1	213119578	213319578	harbor1	chr1	213128801	213128866	DNA/TcMar-Tigger	425	+	32	213128833	9255
chr1	213119578	213319578	harbor1	chr1	213138236	213138347	DNA/TcMar-Tigger	459	+	56	213138292	18714
chr1	213119578	213319578	harbor1	chr1	213142669	213142976	DNA/TcMar-Tigger	1703	+	154	213142823	23245
chr1	189641690	189841690	harbor1	chr1	189658368	189658896	DNA/TcMar-Tigger	2039	+	264	189658632	16942
chr1	189641690	189841690	harbor1	chr1	189668480	189669069	DNA/TcMar-Tigger	3331	+	294	189668774	27084
chr1	189641690	189841690	harbor1	chr1	189705383	189705710	DNA/TcMar-Tigger	1818	+	164	189705547	63857
chr1	189641690	189841690	harbor1	chr1	189706030	189706382	DNA/TcMar-Tigger	1639	+	176	189706206	64516
chr1	189641690	189841690	harbor1	chr1	189707792	189708207	DNA/TcMar-Tigger	1846	+	208	189708000	66310
chr1	189641690	189841690	harbor1	chr1	189721028	189721378	DNA/TcMar-Tigger	2037	+	175	189721203	79513
chr1	108896613	109096613	harbor1	chr1	108958204	108958597	DNA/TcMar-Tigger	2208	+	196	108958400	61787
chr1	108896613	109096613	harbor1	chr1	108959386	108959518	DNA/TcMar-Tigger	831	+	66	108959452	62839
chr1	108896613	109096613	harbor1	chr1	108959506	108959725	DNA/TcMar-Tigger	1212	+	110	108959616	63003
chr1	108896613	109096613	harbor1	chr1	108986087	108986220	DNA/TcMar-Tigger	704	+	66	108986153	89540
chr1	100186916	100386916	harbor1	chr1	100207160	100207240	DNA/TcMar-Tigger	462	+	40	100207200	20284
chr1	100186916	100386916	harbor1	chr1	100208163	100208383	DNA/TcMar-Tigger	1348	+	110	100208273	21357
chr1	100186916	100386916	harbor1	chr1	100232038	100232291	DNA/TcMar-Tigger	1396	+	126	100232164	45248
chr1	100186916	100386916	harbor1	chr1	100282629	100282805	DNA/TcMar-Tigger	1443	+	88	100282717	95801
chr1	100186916	100386916	harbor1	chr1	100283096	100283160	DNA/TcMar-Tigger	1443	+	32	100283128	96212
chr1	100186916	100386916	harbor1	chr1	100283461	100283542	DNA/TcMar-Tigger	1443	+	40	100283501	96585
chr1	88961134	89161134	harbor1	chr1	88975674	88975752	DNA/TcMar-Tigger	5945	+	39	88975713	14579
chr1	88961134	89161134	harbor1	chr1	88976047	88976077	DNA/TcMar-Tigger	5945	+	15	88976062	14928
chr1	88961134	89161134	harbor1	chr1	88976369	88977020	DNA/TcMar-Tigger	5945	+	326	88976695	15561
chr1	88961134	89161134	harbor1	chr1	88977638	88978043	DNA/TcMar-Tigger	5945	+	202	88977840	16706
chr1	186223348	186423348	harbor1	chr1	186277757	186278027	DNA/TcMar-Tigger	806	+	135	186277892	54544
chr1	74488833	74688833	harbor1	chr1	74499436	74499643	DNA/TcMar-Tigger	1192	+	104	74499540	10707
chr1	74488833	74688833	harbor1	chr1	74558779	74558899	DNA/TcMar-Tigger	685	+	60	74558839	70006
chr1	74488833	74688833	harbor1	chr1	74558878	74559556	DNA/TcMar-Tigger	3432	+	339	74559217	70384
chr1	56585265	56785265	harbor1	chr1	56602342	56603816	DNA/TcMar-Tigger	9632	+	737	56603079	17814
chr1	56585265	56785265	harbor1	chr1	56603819	56604225	DNA/TcMar-Tigger	2106	+	203	56604022	18757
chr1	56585265	56785265	harbor1	chr1	56679735	56680170	DNA/TcMar-Tigger	2482	+	218	56679953	94688
chr1	44480989	44680989	harbor1	chr1	44492866	44492928	DNA/TcMar-Tigger	411	+	31	44492897	11908
chr1	44480989	44680989	harbor1	chr1	44493072	44493233	DNA/TcMar-Tigger	1863	+	80	44493152	12163
chr1	44480989	44680989	harbor1	chr1	44493551	44493672	DNA/TcMar-Tigger	1863	+	60	44493611	12622
chr1	67190858	67390858	harbor1	chr1	67213501	67213815	DNA/TcMar-Tigger	1587	+	157	67213658	22800
chr1	101379637	101579637	harbor1	chr1	101455963	101456125	DNA/TcMar-Tigger	654	+	81	101456044	76407
chr1	55790704	55990704	harbor1	chr1	55863367	55864769	DNA/TcMar-Tigger	6832	+	701	55864068	73364
chr1	55790704	55990704	harbor1	chr1	55868576	55868837	DNA/TcMar-Tigger	546	+	130	55868706	78002
chr1	112505649	112705649	harbor1	chr1	112568001	112568205	DNA/TcMar-Tigger	620	+	102	112568103	62454
chr1	224340079	224540079	harbor1	chr1	224354437	224355038	DNA/TcMar-Tigger	5054	+	300	224354737	14658
chr1	224340079	224540079	harbor1	chr1	224355344	224355572	DNA/TcMar-Tigger	5054	+	114	224355458	15379
chr1	224340079	224540079	harbor1	chr1	224355571	224355858	DNA/TcMar-Tigger	1862	+	144	224355715	15636
chr1	210248530	210448530	harbor1	chr1	210271508	210272021	DNA/TcMar-Tigger	2837	+	256	210271764	23234
chr1	210248530	210448530	harbor1	chr1	210344274	210344487	DNA/TcMar-Tigger	1021	+	106	210344380	95850
chr1	210248530	210448530	harbor1	chr1	210345149	210345776	DNA/TcMar-Tigger	3773	+	314	210345463	96933
chr1	202931084	203131084	harbor1	chr1	203010356	203010573	DNA/TcMar-Tigger	1210	+	108	203010464	79380
chr1	202931084	203131084	harbor1	chr1	203019063	203019268	DNA/TcMar-Tigger	1200	+	102	203019165	88081
chr1	75750929	75950929	harbor1	chr1	75771620	75771962	DNA/TcMar-Tigger	2056	+	171	75771791	20862
chr1	42260145	42460145	harbor1	chr1	42276469	42276658	DNA/TcMar-Tigger	780	+	94	42276563	16418
chr1	42260145	42460145	harbor1	chr1	42344938	42345330	DNA/TcMar-Tigger	1860	+	196	42345134	84989
chr1	42260145	42460145	harbor1	chr1	42357325	42357653	DNA/TcMar-Tigger	850	+	164	42357489	97344
chr1	168367675	168567675	harbor1	chr1	168386250	168386541	DNA/TcMar-Tigger	1520	+	146	168386396	18721
chr1	168367675	168567675	harbor1	chr1	168401588	168401914	DNA/TcMar-Tigger	1569	+	163	168401751	34076
chr1	56660058	56860058	harbor1	chr1	56679735	56680170	DNA/TcMar-Tigger	2482	+	218	56679953	19895
chr1	56660058	56860058	harbor1	chr1	56739599	56739955	DNA/TcMar-Tigger	2025	+	178	56739777	79719
chr1	56660058	56860058	harbor1	chr1	56756419	56756630	DNA/TcMar-Tigger	538	+	106	56756525	96467
chr1	3847357	4047357	harbor1	chr1	3849919	3850195	DNA/TcMar-Tigger	1332	+	138	3850057	2700
chr1	3847357	4047357	harbor1	chr1	3873361	3873477	DNA/TcMar-Tigger	1259	+	58	3873419	26062
chr1	3847357	4047357	harbor1	chr1	3873779	3873903	DNA/TcMar-Tigger	1259	+	62	3873841	26484
chr1	198681529	198881529	harbor1	chr1	198702136	198702271	DNA/TcMar-Tigger	444	+	68	198702204	20675
chr1	198681529	198881529	harbor1	chr1	198709141	198709506	DNA/TcMar-Tigger	1478	+	182	198709323	27794
chr1	198681529	198881529	harbor1	chr1	198778955	198779120	DNA/TcMar-Tigger	778	+	82	198779037	97508
chr1	198681529	198881529	harbor1	chr1	198779110	198779306	DNA/TcMar-Tigger	1223	+	98	198779208	97679
chr1	214556209	214756209	harbor1	chr1	214583633	214584474	DNA/TcMar-Tigger	6313	+	420	214584053	27844
chr1	214556209	214756209	harbor1	chr1	214584767	214584952	DNA/TcMar-Tigger	6313	+	92	214584859	28650
chr1	214556209	214756209	harbor1	chr1	214622847	214622929	DNA/TcMar-Tigger	2005	+	41	214622888	66679
chr1	214556209	214756209	harbor1	chr1	214623217	214623483	DNA/TcMar-Tigger	2005	+	133	214623350	67141
chr1	55236310	55436310	harbor1	chr1	55255308	55255807	DNA/TcMar-Tigger	2256	+	250	55255558	19248
chr1	55236310	55436310	harbor1	chr1	55279812	55281792	DNA/TcMar-Tigger	13116	+	990	55280802	44492
chr1	55236310	55436310	harbor1	chr1	55281881	55282282	DNA/TcMar-Tigger	13116	+	200	55282081	45771
chr1	55236310	55436310	harbor1	chr1	55329748	55330353	DNA/TcMar-Tigger	2139	+	302	55330050	93740
chr1	211863063	212063063	harbor1	chr1	211896547	211896648	DNA/TcMar-Tigger	483	+	50	211896597	33534
chr1	211863063	212063063	harbor1	chr1	211896775	211897002	DNA/TcMar-Tigger	1642	+	114	211896889	33826
chr1	211863063	212063063	harbor1	chr1	211897007	211897628	DNA/TcMar-Tigger	3260	+	310	211897317	34254
chr1	211863063	212063063	harbor1	chr1	211897770	211898192	DNA/TcMar-Tigger	2264	+	211	211897981	34918
chr1	26872073	27072073	harbor1	chr1	26929172	26929291	DNA/TcMar-Tigger	1019	+	60	26929232	57159
chr1	26872073	27072073	harbor1	chr1	26929424	26929638	DNA/TcMar-Tigger	1019	+	107	26929531	57458
chr2	195754584	195954584	harbor1	chr2	195775419	195775650	DNA/TcMar-Tigger	467	+	116	195775535	20951
chr2	163940225	164140225	harbor1	chr2	163939624	163940235	DNA/TcMar-Tigger	3189	+	306	163939930	295
chr2	163940225	164140225	harbor1	chr2	163978443	163979213	DNA/TcMar-Tigger	3854	+	385	163978828	38603
chr2	163940225	164140225	harbor1	chr2	163979494	163979574	DNA/TcMar-Tigger	3854	+	40	163979534	39309
chr2	239159133	239359133	harbor1	chr2	239233300	239233532	DNA/TcMar-Tigger	1101	+	116	239233416	74283
chr2	130910460	131110460	harbor1	chr2	130912815	130913132	DNA/TcMar-Tigger	1829	+	158	130912973	2513
chr2	130910460	131110460	harbor1	chr2	130960076	130960579	DNA/TcMar-Tigger	2232	+	252	130960328	49868
chr2	130910460	131110460	harbor1	chr2	130997713	130997863	DNA/TcMar-Tigger	948	+	75	130997788	87328
chr2	130910460	131110460	harbor1	chr2	130997936	130998220	DNA/TcMar-Tigger	1206	+	142	130998078	87618
chr2	130910460	131110460	harbor1	chr2	130999560	130999690	DNA/TcMar-Tigger	571	+	65	130999625	89165
chr2	74265851	74465851	harbor1	chr2	74285277	74285507	DNA/TcMar-Tigger	1131	+	115	74285392	19541
chr2	74265851	74465851	harbor1	chr2	74333400	74333705	DNA/TcMar-Tigger	1162	+	152	74333552	67701
chr2	123280433	123480433	harbor1	chr2	123340387	123340790	DNA/TcMar-Tigger	2164	+	202	123340589	60156
chr2	123280433	123480433	harbor1	chr2	123363105	123363519	DNA/TcMar-Tigger	2092	+	207	123363312	82879
chr2	123280433	123480433	harbor1	chr2	123363541	123363737	DNA/TcMar-Tigger	893	+	98	123363639	83206
chr2	123280433	123480433	harbor1	chr2	123369758	123370094	DNA/TcMar-Tigger	1736	+	168	123369926	89493
chr2	9601477	9801477	harbor1	chr2	9604512	9604778	DNA/TcMar-Tigger	838	+	133	9604645	3168
chr2	42421341	42621341	harbor1	chr2	42448594	42448707	DNA/TcMar-Tigger	1176	+	56	42448650	27309
chr2	42421341	42621341	harbor1	chr2	42449002	42449135	DNA/TcMar-Tigger	1176	+	66	42449068	27727
chr2	42421341	42621341	harbor1	chr2	42465995	42466123	DNA/TcMar-Tigger	1713	+	64	42466059	44718
chr2	42421341	42621341	harbor1	chr2	42466433	42466656	DNA/TcMar-Tigger	1713	+	112	42466545	45204
chr2	202190276	202390276	harbor1	chr2	202289304	202289603	DNA/TcMar-Tigger	1301	+	150	202289454	99178
chr2	43870685	44070685	harbor1	chr2	43891323	43893726	DNA/TcMar-Tigger	13355	+	1202	43892525	21840
chr2	5327766	5527766	harbor1	chr2	5346412	5346692	DNA/TcMar-Tigger	754	+	140	5346552	18786
chr2	34728845	34928845	harbor1	chr2	34783843	34783981	DNA/TcMar-Tigger	540	+	69	34783912	55067
chr2	34728845	34928845	harbor1	chr2	34785001	34785808	DNA/TcMar-Tigger	3523	+	404	34785405	56560
chr2	34728845	34928845	harbor1	chr2	34786301	34786572	DNA/TcMar-Tigger	1081	+	136	34786437	57592
chr2	34728845	34928845	harbor1	chr2	34798455	34798811	DNA/TcMar-Tigger	1361	+	178	34798633	69788
chr2	34728845	34928845	harbor1	chr2	34817714	34818028	DNA/TcMar-Tigger	1570	+	157	34817871	89026
chr2	42870195	43070195	harbor1	chr2	42900314	42900528	DNA/TcMar-Tigger	484	+	107	42900421	30226
chr2	42870195	43070195	harbor1	chr2	42941161	42941512	DNA/TcMar-Tigger	1846	+	176	42941337	71142
chr2	47026092	47226092	harbor1	chr2	47114570	47114697	DNA/TcMar-Tigger	463	+	64	47114634	88542
chr2	113826643	114026643	harbor1	chr2	113870428	113871070	DNA/TcMar-Tigger	3621	+	321	113870749	44106
chr2	113826643	114026643	harbor1	chr2	113883995	113884326	DNA/TcMar-Tigger	1813	+	166	113884161	57518
chr2	113826643	114026643	harbor1	chr2	113914033	113914330	DNA/TcMar-Tigger	635	+	148	113914181	87538
chr2	113826643	114026643	harbor1	chr2	113914644	113914805	DNA/TcMar-Tigger	635	+	80	113914724	88081
chr2	193084609	193284609	harbor1	chr2	193171722	193172681	DNA/TcMar-Tigger	5356	+	480	193172202	87593
chr2	193084609	193284609	harbor1	chr2	193172696	193172889	DNA/TcMar-Tigger	879	+	96	193172792	88183
chr2	193084609	193284609	harbor1	chr2	193173473	193173680	DNA/TcMar-Tigger	1098	+	104	193173577	88968
chr2	25802089	26002089	harbor1	chr2	25861720	25861798	DNA/TcMar-Tigger	421	+	39	25861759	59670
chr2	71309543	71509543	harbor1	chr2	71344979	71345292	DNA/TcMar-Tigger	1528	+	156	71345135	35592
chr2	71309543	71509543	harbor1	chr2	71357813	71357925	DNA/TcMar-Tigger	609	+	56	71357869	48326
chr2	71309543	71509543	harbor1	chr2	71358788	71358915	DNA/TcMar-Tigger	762	+	64	71358852	49309
chr2	71309543	71509543	harbor1	chr2	71358910	71359125	DNA/TcMar-Tigger	1045	+	108	71359018	49475
chr2	71309543	71509543	harbor1	chr2	71379228	71379755	DNA/TcMar-Tigger	2716	+	264	71379492	69949
chr2	71309543	71509543	harbor1	chr2	71379857	71379996	DNA/TcMar-Tigger	1508	+	70	71379927	70384
chr2	197224648	197424648	harbor1	chr2	197244883	197244992	DNA/TcMar-Tigger	1205	+	54	197244937	20289
chr2	197224648	197424648	harbor1	chr2	197245286	197245485	DNA/TcMar-Tigger	1358	+	100	197245386	20738
chr2	136206040	136406040	harbor1	chr2	136220627	136222991	DNA/TcMar-Tigger	15483	+	1182	136221809	15769
chr2	31894075	32094075	harbor1	chr2	31946502	31946579	DNA/TcMar-Tigger	1681	+	38	31946540	52465
chr2	31894075	32094075	harbor1	chr2	31946855	31947122	DNA/TcMar-Tigger	1681	+	134	31946989	52914
chr2	119632942	119832942	harbor1	chr2	119649195	119649273	DNA/TcMar-Tigger	432	+	39	119649234	16292
chr2	119632942	119832942	harbor1	chr2	119649342	119649421	DNA/TcMar-Tigger	506	+	40	119649382	16440
chr2	179842190	180042190	harbor1	chr2	179910361	179910604	DNA/TcMar-Tigger	618	+	122	179910483	68293
chr2	210185676	210385676	harbor1	chr2	210219667	210219959	DNA/TcMar-Tigger	1421	+	146	210219813	34137
chr2	172205691	172405691	harbor1	chr2	172260645	172260974	DNA/TcMar-Tigger	1895	+	164	172260809	55118
chr2	29092604	29292604	harbor1	chr2	29166629	29167216	DNA/TcMar-Tigger	1170	+	294	29166923	74319
chr2	144139152	144339152	harbor1	chr2	144142841	144143256	DNA/TcMar-Tigger	2369	+	208	144143049	3897
chr2	73007748	73207748	harbor1	chr2	73024794	73025024	DNA/TcMar-Tigger	830	+	115	73024909	17161
chr2	73007748	73207748	harbor1	chr2	73026443	73026715	DNA/TcMar-Tigger	6522	+	136	73026579	18831
chr2	73007748	73207748	harbor1	chr2	73027027	73027652	DNA/TcMar-Tigger	6522	+	312	73027339	19591
chr2	73007748	73207748	harbor1	chr2	73027962	73028238	DNA/TcMar-Tigger	6522	+	138	73028100	20352
chr2	73007748	73207748	harbor1	chr2	73098211	73098419	DNA/TcMar-Tigger	1072	+	104	73098315	90567
chr2	68585632	68785632	harbor1	chr2	68619342	68619698	DNA/TcMar-Tigger	1818	+	178	68619520	33888
chr2	68585632	68785632	harbor1	chr2	68639526	68639855	DNA/TcMar-Tigger	2143	+	164	68639690	54058
chr2	175396127	175596127	harbor1	chr2	175466295	175466538	DNA/TcMar-Tigger	968	+	122	175466417	70290
chr2	175396127	175596127	harbor1	chr2	175481384	175481646	DNA/TcMar-Tigger	610	+	131	175481515	85388
chr2	27549027	27749027	harbor1	chr2	27637687	27637904	DNA/TcMar-Tigger	1280	+	108	27637795	88768
chr2	186224083	186424083	harbor1	chr2	186261152	186261359	DNA/TcMar-Tigger	1343	+	104	186261256	37173
chr2	186224083	186424083	harbor1	chr2	186261936	186262075	DNA/TcMar-Tigger	757	+	70	186262006	37923
chr2	42217672	42417672	harbor1	chr2	42219200	42219436	DNA/TcMar-Tigger	1311	+	118	42219318	1646
chr2	42217672	42417672	harbor1	chr2	42220183	42221403	DNA/TcMar-Tigger	7143	+	610	42220793	3121
chr2	42217672	42417672	harbor1	chr2	42227589	42227937	DNA/TcMar-Tigger	1837	+	174	42227763	10091
chr2	42217672	42417672	harbor1	chr2	42228234	42228346	DNA/TcMar-Tigger	1837	+	56	42228290	10618
chr2	42217672	42417672	harbor1	chr2	42268113	42268412	DNA/TcMar-Tigger	901	+	150	42268263	50591
chr2	42217672	42417672	harbor1	chr2	42280398	42280702	DNA/TcMar-Tigger	1562	+	152	42280550	62878
chr2	42217672	42417672	harbor1	chr2	42237876	42238259	DNA/TcMar-Tigger	2386	+	192	42238068	20396
chr2	60560764	60760764	harbor1	chr2	60616645	60616850	DNA/TcMar-Tigger	6688	+	102	60616747	55983
chr2	60560764	60760764	harbor1	chr2	60617143	60617700	DNA/TcMar-Tigger	6688	+	278	60617421	56657
chr2	60560764	60760764	harbor1	chr2	60618018	60618464	DNA/TcMar-Tigger	6688	+	223	60618241	57477
chr2	126189980	126389980	harbor1	chr2	126242015	126242184	DNA/TcMar-Tigger	464	+	84	126242099	52119
chr2	126189980	126389980	harbor1	chr2	126242180	126242354	DNA/TcMar-Tigger	484	+	87	126242267	52287
chr2	126189980	126389980	harbor1	chr2	126280677	126283041	DNA/TcMar-Tigger	14456	+	1182	126281859	91879
chr2	57474039	57674039	harbor1	chr2	57490990	57491307	DNA/TcMar-Tigger	1729	+	158	57491148	17109
chr2	57474039	57674039	harbor1	chr2	57517506	57517757	DNA/TcMar-Tigger	1456	+	126	57517632	43593
chr2	113499345	113699345	harbor1	chr2	113531696	113532046	DNA/TcMar-Tigger	2174	+	175	113531871	32526
chr2	38135666	38335666	harbor1	chr2	38152604	38153236	DNA/TcMar-Tigger	3277	+	316	38152920	17254
chr2	38135666	38335666	harbor1	chr2	38185497	38185778	DNA/TcMar-Tigger	699	+	140	38185637	49971
chr2	133408711	133608711	harbor1	chr2	133484538	133484870	DNA/TcMar-Tigger	1679	+	166	133484704	75993
chr2	59807800	60007800	harbor1	chr2	59868199	59868379	DNA/TcMar-Tigger	1006	+	90	59868289	60489
chr2	193242813	193442813	harbor1	chr2	193319789	193320113	DNA/TcMar-Tigger	1868	+	162	193319951	77138
chr2	135188054	135388054	harbor1	chr2	135279768	135279948	DNA/TcMar-Tigger	435	+	90	135279858	91804
chr2	129053548	129253548	harbor1	chr2	129106620	129107170	DNA/TcMar-Tigger	2694	+	275	129106895	53347
chr2	129053548	129253548	harbor1	chr2	129114689	129114830	DNA/TcMar-Tigger	1061	+	70	129114759	61211
chr2	129053548	129253548	harbor1	chr2	129115125	129115356	DNA/TcMar-Tigger	1061	+	116	129115241	61693
chr2	130997773	131197773	harbor1	chr2	130997713	130997863	DNA/TcMar-Tigger	948	+	75	130997788	15
chr2	130997773	131197773	harbor1	chr2	130997936	130998220	DNA/TcMar-Tigger	1206	+	142	130998078	305
chr2	130997773	131197773	harbor1	chr2	130999560	130999690	DNA/TcMar-Tigger	571	+	65	130999625	1852
chr2	85148037	85348037	harbor1	chr2	85207658	85207926	DNA/TcMar-Tigger	1644	+	134	85207792	59755
chr2	85148037	85348037	harbor1	chr2	85208206	85208291	DNA/TcMar-Tigger	1644	+	42	85208248	60211
chr2	134175196	134375196	harbor1	chr2	134178929	134179531	DNA/TcMar-Tigger	2996	+	301	134179230	4034
chr2	51238493	51438493	harbor1	chr2	51248555	51249097	DNA/TcMar-Tigger	1008	+	271	51248826	10333
chr2	32320790	32520790	harbor1	chr2	32375587	32375780	DNA/TcMar-Tigger	956	+	96	32375683	54893
chr2	78536330	78736330	harbor1	chr2	78630254	78630445	DNA/TcMar-Tigger	437	+	96	78630350	94020
chr2	78536330	78736330	harbor1	chr2	78630959	78631041	DNA/TcMar-Tigger	470	+	41	78631000	94670
chr2	156906539	157106539	harbor1	chr2	156915380	156915456	DNA/TcMar-Tigger	459	+	38	156915418	8879
chr2	215896575	216096575	harbor1	chr2	215944288	215944527	DNA/TcMar-Tigger	426	+	120	215944408	47833
chr2	153839918	154039918	harbor1	chr2	153858453	153858744	DNA/TcMar-Tigger	1331	+	146	153858599	18681
chr2	153839918	154039918	harbor1	chr2	153859033	153859136	DNA/TcMar-Tigger	1331	+	52	153859085	19167
chr2	153839918	154039918	harbor1	chr2	153936087	153936345	DNA/TcMar-Tigger	847	+	129	153936216	96298
chr2	219019894	219219894	harbor1	chr2	219083971	219083994	DNA/TcMar-Tigger	453	+	12	219083983	64089
chr2	219019894	219219894	harbor1	chr2	219084305	219084371	DNA/TcMar-Tigger	453	+	33	219084338	64444
chr2	219019894	219219894	harbor1	chr2	219096985	219097267	DNA/TcMar-Tigger	1537	+	141	219097126	77232
chr2	163954190	164154190	harbor1	chr2	163978443	163979213	DNA/TcMar-Tigger	3854	+	385	163978828	24638
chr2	163954190	164154190	harbor1	chr2	163979494	163979574	DNA/TcMar-Tigger	3854	+	40	163979534	25344
chr2	176713923	176913923	harbor1	chr2	176721223	176721360	DNA/TcMar-Tigger	484	+	68	176721291	7368
chr2	221552791	221752791	harbor1	chr2	221556663	221556988	DNA/TcMar-Tigger	1214	+	162	221556825	4034
chr2	132259605	132459605	harbor1	chr2	132301581	132301679	DNA/TcMar-Tigger	452	+	49	132301630	42025
chr2	132259605	132459605	harbor1	chr2	132301743	132301993	DNA/TcMar-Tigger	1395	+	125	132301868	42263
chr2	32742019	32942019	harbor1	chr2	32757453	32757610	DNA/TcMar-Tigger	875	+	78	32757531	15512
chr2	32742019	32942019	harbor1	chr2	32757599	32757691	DNA/TcMar-Tigger	1090	+	46	32757645	15626
chr2	32742019	32942019	harbor1	chr2	32758001	32758116	DNA/TcMar-Tigger	1090	+	58	32758059	16040
chr2	32742019	32942019	harbor1	chr2	32772397	32772764	DNA/TcMar-Tigger	1770	+	184	32772581	30562
chr2	32742019	32942019	harbor1	chr2	32814576	32814915	DNA/TcMar-Tigger	1973	+	170	32814746	72727
chr2	51998752	52198752	harbor1	chr2	52053388	52053589	DNA/TcMar-Tigger	1149	+	100	52053488	54736
chr2	51998752	52198752	harbor1	chr2	52067313	52067507	DNA/TcMar-Tigger	1720	+	97	52067410	68658
chr2	51998752	52198752	harbor1	chr2	52067552	52067655	DNA/TcMar-Tigger	1720	+	52	52067604	68852
chr2	136701314	136901314	harbor1	chr2	136742168	136742605	DNA/TcMar-Tigger	1835	+	218	136742386	41072
chr2	175304281	175504281	harbor1	chr2	175316770	175317141	DNA/TcMar-Tigger	2052	+	186	175316956	12675
chr2	69307949	69507949	harbor1	chr2	69317145	69317308	DNA/TcMar-Tigger	540	+	82	69317227	9278
chr2	69307949	69507949	harbor1	chr2	69317604	69317633	DNA/TcMar-Tigger	540	+	14	69317618	9669
chr2	69307949	69507949	harbor1	chr2	69318525	69318680	DNA/TcMar-Tigger	814	+	78	69318603	10654
chr2	69307949	69507949	harbor1	chr2	69318693	69318795	DNA/TcMar-Tigger	559	+	51	69318744	10795
chr2	193116264	193316264	harbor1	chr2	193171722	193172681	DNA/TcMar-Tigger	5356	+	480	193172202	55938
chr2	193116264	193316264	harbor1	chr2	193172696	193172889	DNA/TcMar-Tigger	879	+	96	193172792	56528
chr2	193116264	193316264	harbor1	chr2	193173473	193173680	DNA/TcMar-Tigger	1098	+	104	193173577	57313
chr2	35496028	35696028	harbor1	chr2	35542963	35543286	DNA/TcMar-Tigger	1234	+	162	35543125	47097
chr2	26984661	27184661	harbor1	chr2	27020916	27021249	DNA/TcMar-Tigger	1676	+	166	27021082	36421
chr2	119697662	119897662	harbor1	chr2	119772376	119772533	DNA/TcMar-Tigger	632	+	78	119772454	74792
chr2	119697662	119897662	harbor1	chr2	119772839	119772986	DNA/TcMar-Tigger	632	+	74	119772913	75251
chr2	119697662	119897662	harbor1	chr2	119773283	119773455	DNA/TcMar-Tigger	16410	+	86	119773369	75707
chr2	119697662	119897662	harbor1	chr2	119773767	119774744	DNA/TcMar-Tigger	16410	+	488	119774255	76593
chr2	119697662	119897662	harbor1	chr2	119775034	119775802	DNA/TcMar-Tigger	16410	+	384	119775418	77756
chr2	119697662	119897662	harbor1	chr2	119775855	119776186	DNA/TcMar-Tigger	16410	+	166	119776021	78359
chr2	119697662	119897662	harbor1	chr2	119776474	119776956	DNA/TcMar-Tigger	16410	+	241	119776715	79053
chr2	101511528	101711528	harbor1	chr2	101599746	101599826	DNA/TcMar-Tigger	567	+	40	101599786	88258
chr2	101511528	101711528	harbor1	chr2	101600285	101600345	DNA/TcMar-Tigger	567	+	30	101600315	88787
chr2	42985673	43185673	harbor1	chr2	43022729	43023163	DNA/TcMar-Tigger	684	+	217	43022946	37273
chr2	42985673	43185673	harbor1	chr2	43034182	43034311	DNA/TcMar-Tigger	598	+	64	43034246	48573
chr2	42985673	43185673	harbor1	chr2	43034573	43034850	DNA/TcMar-Tigger	1572	+	138	43034711	49038
chr2	42985673	43185673	harbor1	chr2	43035324	43035574	DNA/TcMar-Tigger	1437	+	125	43035449	49776
chr2	127197970	127397970	harbor1	chr2	127198557	127198901	DNA/TcMar-Tigger	2004	+	172	127198729	759
chr2	154017467	154217467	harbor1	chr2	154071543	154072370	DNA/TcMar-Tigger	3599	+	414	154071957	54490
chr2	154017467	154217467	harbor1	chr2	154105298	154105649	DNA/TcMar-Tigger	1705	+	176	154105474	88007
chr2	229075680	229275680	harbor1	chr2	229166522	229166682	DNA/TcMar-Tigger	494	+	80	229166602	90922
chr2	171918945	172118945	harbor1	chr2	171944469	171944654	DNA/TcMar-Tigger	688	+	92	171944561	25616
chr2	97556787	97756787	harbor1	chr2	97566733	97566756	DNA/TcMar-Tigger	2824	+	12	97566745	9958
chr2	97556787	97756787	harbor1	chr2	97567591	97568256	DNA/TcMar-Tigger	2824	+	332	97567923	11136
chr2	68201057	68401057	harbor1	chr2	68210769	68210929	DNA/TcMar-Tigger	896	+	80	68210849	9792
chr2	68201057	68401057	harbor1	chr2	68215313	68215392	DNA/TcMar-Tigger	420	+	40	68215353	14296
chr2	68201057	68401057	harbor1	chr2	68239912	68240146	DNA/TcMar-Tigger	1314	+	117	68240029	38972
chr2	68201057	68401057	harbor1	chr2	68275386	68275685	DNA/TcMar-Tigger	1561	+	150	68275536	74479
chr2	54712240	54912240	harbor1	chr2	54718648	54718865	DNA/TcMar-Tigger	1383	+	108	54718756	6516
chr2	29297023	29497023	harbor1	chr2	29393831	29394167	DNA/TcMar-Tigger	1175	+	168	29393999	96976
chr2	86119671	86319671	harbor1	chr2	86178690	86178779	DNA/TcMar-Tigger	1684	+	44	86178734	59063
chr2	86119671	86319671	harbor1	chr2	86179098	86179358	DNA/TcMar-Tigger	1684	+	130	86179228	59557
chr2	86119671	86319671	harbor1	chr2	86203033	86203077	DNA/TcMar-Tigger	1486	+	22	86203055	83384
chr2	86119671	86319671	harbor1	chr2	86203385	86203627	DNA/TcMar-Tigger	1486	+	121	86203506	83835
chr2	196352248	196552248	harbor1	chr2	196356320	196356940	DNA/TcMar-Tigger	2503	+	310	196356630	4382
chr2	196352248	196552248	harbor1	chr2	196423929	196426321	DNA/TcMar-Tigger	15311	+	1196	196425125	72877
chr2	196352248	196552248	harbor1	chr2	196447313	196447775	DNA/TcMar-Tigger	1392	+	231	196447544	95296
chr2	196352248	196552248	harbor1	chr2	196448074	196448281	DNA/TcMar-Tigger	1392	+	104	196448178	95930
chr2	139121758	139321758	harbor1	chr2	139126972	139128282	DNA/TcMar-Tigger	7802	+	655	139127627	5869
chr2	139121758	139321758	harbor1	chr2	139157489	139157836	DNA/TcMar-Tigger	1681	+	174	139157663	35905
chr2	171794890	171994890	harbor1	chr2	171801542	171801903	DNA/TcMar-Tigger	2163	+	180	171801722	6832
chr2	239906963	240106963	harbor1	chr2	239926322	239926774	DNA/TcMar-Tigger	4188	+	226	239926548	19585
chr2	239906963	240106963	harbor1	chr2	239978598	239978857	DNA/TcMar-Tigger	872	+	130	239978728	71765
chr2	239906963	240106963	harbor1	chr2	239999874	239999998	DNA/TcMar-Tigger	473	+	62	239999936	92973
chr2	239906963	240106963	harbor1	chr2	240000001	240000486	DNA/TcMar-Tigger	2594	+	242	240000243	93280
chr2	239906963	240106963	harbor1	chr2	240000478	240000978	DNA/TcMar-Tigger	2970	+	250	240000728	93765
chr2	239906963	240106963	harbor1	chr2	239927136	239927507	DNA/TcMar-Tigger	4188	+	186	239927322	20359
chr2	96196591	96396591	harbor1	chr2	96215881	96216008	DNA/TcMar-Tigger	717	+	64	96215945	19354
chr2	96196591	96396591	harbor1	chr2	96216257	96216448	DNA/TcMar-Tigger	1231	+	96	96216353	19762
chr2	116604199	116804199	harbor1	chr2	116682321	116682434	DNA/TcMar-Tigger	644	+	56	116682377	78178
chr2	116604199	116804199	harbor1	chr2	116682437	116683237	DNA/TcMar-Tigger	4081	+	400	116682837	78638
chr2	116604199	116804199	harbor1	chr2	116699732	116700087	DNA/TcMar-Tigger	1890	+	178	116699910	95711
chr2	69014801	69214801	harbor1	chr2	69046985	69047216	DNA/TcMar-Tigger	1339	+	116	69047101	32300
chr2	69014801	69214801	harbor1	chr2	69059650	69059834	DNA/TcMar-Tigger	835	+	92	69059742	44941
chr2	69014801	69214801	harbor1	chr2	69057277	69059481	DNA/TcMar-Tigger	13892	+	1102	69058379	43578
chr2	133978193	134178193	harbor1	chr2	133999242	133999484	DNA/TcMar-Tigger	746	+	121	133999363	21170
chr2	221920783	222120783	harbor1	chr2	222015289	222015440	DNA/TcMar-Tigger	446	+	76	222015365	94582
chr2	131471511	131671511	harbor1	chr2	131472522	131472818	DNA/TcMar-Tigger	1310	+	148	131472670	1159
chr2	123099682	123299682	harbor1	chr2	123171698	123172035	DNA/TcMar-Tigger	966	+	168	123171866	72184
chr2	189580564	189780564	harbor1	chr2	189599998	189600238	DNA/TcMar-Tigger	553	+	120	189600118	19554
chr2	189580564	189780564	harbor1	chr2	189614353	189614678	DNA/TcMar-Tigger	1246	+	162	189614515	33951
chr2	189580564	189780564	harbor1	chr2	189634925	189635276	DNA/TcMar-Tigger	1943	+	176	189635101	54537
chr2	189580564	189780564	harbor1	chr2	189646276	189646531	DNA/TcMar-Tigger	548	+	128	189646404	65840
chr2	189580564	189780564	harbor1	chr2	189646577	189646929	DNA/TcMar-Tigger	817	+	176	189646753	66189
chr2	189580564	189780564	harbor1	chr2	189672119	189672238	DNA/TcMar-Tigger	643	+	60	189672179	91615
chr2	102979449	103179449	harbor1	chr2	102997250	102997586	DNA/TcMar-Tigger	2069	+	168	102997418	17969
chr2	23166736	23366736	harbor1	chr2	23263092	23263258	DNA/TcMar-Tigger	1021	+	83	23263175	96439
chr2	180210023	180410023	harbor1	chr2	180259054	180259387	DNA/TcMar-Tigger	1686	+	166	180259220	49197
chr2	153027578	153227578	harbor1	chr2	153039149	153039278	DNA/TcMar-Tigger	489	+	64	153039213	11635
chr2	153027578	153227578	harbor1	chr2	153056725	153057063	DNA/TcMar-Tigger	1754	+	169	153056894	29316
chr2	153027578	153227578	harbor1	chr2	153058961	153059168	DNA/TcMar-Tigger	862	+	104	153059065	31487
chr2	97660687	97860687	harbor1	chr2	97706133	97706700	DNA/TcMar-Tigger	2747	+	284	97706417	45730
chr2	97660687	97860687	harbor1	chr2	97721218	97721410	DNA/TcMar-Tigger	2691	+	96	97721314	60627
chr2	97660687	97860687	harbor1	chr2	97721731	97721767	DNA/TcMar-Tigger	2691	+	18	97721749	61062
chr2	97660687	97860687	harbor1	chr2	97722381	97722764	DNA/TcMar-Tigger	2143	+	192	97722573	61886
chr2	1932616	2132616	harbor1	chr2	2012558	2013078	DNA/TcMar-Tigger	2108	+	260	2012818	80202
chr2	169264857	169464857	harbor1	chr2	169305712	169306080	DNA/TcMar-Tigger	1895	+	184	169305896	41039
chr2	186156725	186356725	harbor1	chr2	186163279	186163838	DNA/TcMar-Tigger	2700	+	280	186163559	6834
chr2	186156725	186356725	harbor1	chr2	186169184	186169280	DNA/TcMar-Tigger	479	+	48	186169232	12507
chr2	135552252	135752252	harbor1	chr2	135575041	135575226	DNA/TcMar-Tigger	771	+	92	135575133	22881
chr2	135552252	135752252	harbor1	chr2	135575482	135575517	DNA/TcMar-Tigger	771	+	18	135575500	23248
chr2	51308644	51508644	harbor1	chr2	51406742	51406871	DNA/TcMar-Tigger	849	+	64	51406806	98162
chr2	230923629	231123629	harbor1	chr2	230982507	230982606	DNA/TcMar-Tigger	1381	+	50	230982557	58928
chr2	230923629	231123629	harbor1	chr2	230982891	230982916	DNA/TcMar-Tigger	1381	+	12	230982903	59274
chr2	230923629	231123629	harbor1	chr2	230983222	230983435	DNA/TcMar-Tigger	1381	+	106	230983328	59699
chr2	161896896	162096896	harbor1	chr2	161942017	161942299	DNA/TcMar-Tigger	523	+	141	161942158	45262
chr2	161896896	162096896	harbor1	chr2	161967047	161967883	DNA/TcMar-Tigger	4888	+	418	161967465	70569
chr2	161896896	162096896	harbor1	chr2	161996606	161996916	DNA/TcMar-Tigger	1679	+	155	161996761	99865
chr2	179500518	179700518	harbor1	chr2	179599058	179599164	DNA/TcMar-Tigger	526	+	53	179599111	98593
chr2	237167582	237367582	harbor1	chr2	237215294	237215394	DNA/TcMar-Tigger	502	+	50	237215344	47762
chr2	237167582	237367582	harbor1	chr2	237215393	237215837	DNA/TcMar-Tigger	5819	+	222	237215615	48033
chr2	237167582	237367582	harbor1	chr2	237216142	237216643	DNA/TcMar-Tigger	5819	+	250	237216392	48810
chr2	237167582	237367582	harbor1	chr2	237266339	237266776	DNA/TcMar-Tigger	2534	+	218	237266557	98975
chr2	229902204	230102204	harbor1	chr2	229946473	229946735	DNA/TcMar-Tigger	459	+	131	229946604	44400
chr2	117164905	117364905	harbor1	chr2	117245830	117246006	DNA/TcMar-Tigger	656	+	88	117245918	81013
chr2	3334893	3534893	harbor1	chr2	3351780	3352039	DNA/TcMar-Tigger	1313	+	130	3351910	17017
chr2	3334893	3534893	harbor1	chr2	3352458	3352714	DNA/TcMar-Tigger	2426	+	128	3352586	17693
chr2	3334893	3534893	harbor1	chr2	3353010	3353255	DNA/TcMar-Tigger	2426	+	122	3353132	18239
chr2	3334893	3534893	harbor1	chr2	3415116	3415396	DNA/TcMar-Tigger	1504	+	140	3415256	80363
chr2	3334893	3534893	harbor1	chr2	3416016	3416056	DNA/TcMar-Tigger	1504	+	20	3416036	81143
chr2	218987074	219187074	harbor1	chr2	219083971	219083994	DNA/TcMar-Tigger	453	+	12	219083983	96909
chr2	218987074	219187074	harbor1	chr2	219084305	219084371	DNA/TcMar-Tigger	453	+	33	219084338	97264
chr2	125467540	125667540	harbor1	chr2	125477934	125478212	DNA/TcMar-Tigger	1385	+	139	125478073	10533
chr2	125467540	125667540	harbor1	chr2	125479698	125479803	DNA/TcMar-Tigger	1385	+	52	125479750	12210
chr2	18668350	18868350	harbor1	chr2	18699490	18699987	DNA/TcMar-Tigger	2552	+	248	18699738	31388
chr2	18668350	18868350	harbor1	chr2	18699988	18700076	DNA/TcMar-Tigger	497	+	44	18700032	31682
chr2	18668350	18868350	harbor1	chr2	18764266	18764697	DNA/TcMar-Tigger	2304	+	216	18764482	96132
chr2	148754121	148954121	harbor1	chr2	148755475	148755748	DNA/TcMar-Tigger	1603	+	136	148755611	1490
chr2	96692602	96892602	harbor1	chr2	96708058	96708523	DNA/TcMar-Tigger	3040	+	232	96708290	15688
chr2	204903500	205103500	harbor1	chr2	204964223	204964591	DNA/TcMar-Tigger	1023	+	184	204964407	60907
chr2	204903500	205103500	harbor1	chr2	204964670	204964789	DNA/TcMar-Tigger	426	+	60	204964730	61230
chr2	116428871	116628871	harbor1	chr2	116501518	116501860	DNA/TcMar-Tigger	1934	+	171	116501689	72818
chr2	29361405	29561405	harbor1	chr2	29393831	29394167	DNA/TcMar-Tigger	1175	+	168	29393999	32594
chr2	29361405	29561405	harbor1	chr2	29414602	29414734	DNA/TcMar-Tigger	465	+	66	29414668	53263
chr2	40631039	40831039	harbor1	chr2	40631577	40631779	DNA/TcMar-Tigger	1227	+	101	40631678	639
chr2	205975460	206175460	harbor1	chr2	206055692	206056027	DNA/TcMar-Tigger	2158	+	168	206055860	80400
chr2	205975460	206175460	harbor1	chr2	206057116	206057270	DNA/TcMar-Tigger	535	+	77	206057193	81733
chr2	205975460	206175460	harbor1	chr2	206069142	206069459	DNA/TcMar-Tigger	1616	+	158	206069300	93840
chr2	109368384	109568384	harbor1	chr2	109424425	109425885	DNA/TcMar-Tigger	16086	+	730	109425155	56771
chr2	109368384	109568384	harbor1	chr2	109426209	109426978	DNA/TcMar-Tigger	16086	+	384	109426593	58209
chr2	109368384	109568384	harbor1	chr2	109427267	109427466	DNA/TcMar-Tigger	16086	+	100	109427367	58983
chr2	191746117	191946117	harbor1	chr2	191804187	191804796	DNA/TcMar-Tigger	3350	+	304	191804491	58374
chr2	32630991	32830991	harbor1	chr2	32635850	32636083	DNA/TcMar-Tigger	468	+	116	32635966	4975
chr2	32630991	32830991	harbor1	chr2	32681495	32681846	DNA/TcMar-Tigger	1791	+	176	32681671	50680
chr2	32630991	32830991	harbor1	chr2	32690026	32690177	DNA/TcMar-Tigger	514	+	76	32690102	59111
chr2	32630991	32830991	harbor1	chr2	32703554	32703807	DNA/TcMar-Tigger	653	+	126	32703680	72689
chr2	32630991	32830991	harbor1	chr2	32704170	32704183	DNA/TcMar-Tigger	653	+	6	32704176	73185
chr2	32630991	32830991	harbor1	chr2	32708066	32708304	DNA/TcMar-Tigger	2184	+	119	32708185	77194
chr2	32630991	32830991	harbor1	chr2	32708608	32708655	DNA/TcMar-Tigger	2184	+	24	32708632	77641
chr2	32630991	32830991	harbor1	chr2	32708862	32709043	DNA/TcMar-Tigger	2184	+	90	32708952	77961
chr2	204850530	205050530	harbor1	chr2	204863453	204863690	DNA/TcMar-Tigger	554	+	118	204863571	13041
chr2	204850530	205050530	harbor1	chr2	204876888	204876976	DNA/TcMar-Tigger	502	+	44	204876932	26402
chr2	204850530	205050530	harbor1	chr2	204877414	204877568	DNA/TcMar-Tigger	623	+	77	204877491	26961
chr2	196610425	196810425	harbor1	chr2	196628107	196628199	DNA/TcMar-Tigger	1675	+	46	196628153	17728
chr2	196610425	196810425	harbor1	chr2	196628476	196628723	DNA/TcMar-Tigger	1675	+	124	196628600	18175
chr2	196610425	196810425	harbor1	chr2	196633474	196633888	DNA/TcMar-Tigger	2653	+	207	196633681	23256
chr2	196610425	196810425	harbor1	chr2	196634185	196634412	DNA/TcMar-Tigger	2653	+	114	196634299	23874
chr2	196610425	196810425	harbor1	chr2	196649287	196649654	DNA/TcMar-Tigger	1273	+	184	196649471	39046
chr2	196610425	196810425	harbor1	chr2	196682602	196682803	DNA/TcMar-Tigger	1057	+	100	196682702	72277
chr3	27090827	27290827	harbor1	chr3	27149308	27150869	DNA/TcMar-Tigger	9553	+	780	27150088	59261
chr3	27090827	27290827	harbor1	chr3	27157341	27158142	DNA/TcMar-Tigger	5032	+	400	27157741	66914
chr3	27090827	27290827	harbor1	chr3	27189214	27189445	DNA/TcMar-Tigger	429	+	116	27189330	98503
chr3	13369420	13569420	harbor1	chr3	13440432	13440720	DNA/TcMar-Tigger	1538	+	144	13440576	71156
chr3	95883953	96083953	harbor1	chr3	95898840	95899169	DNA/TcMar-Tigger	1569	+	164	95899004	15051
chr3	95883953	96083953	harbor1	chr3	95904373	95904477	DNA/TcMar-Tigger	609	+	52	95904425	20472
chr3	95883953	96083953	harbor1	chr3	95966965	95967015	DNA/TcMar-Tigger	1401	+	25	95966990	83037
chr3	95883953	96083953	harbor1	chr3	95967310	95967581	DNA/TcMar-Tigger	1401	+	136	95967446	83493
chr3	73186653	73386653	harbor1	chr3	73283379	73283567	DNA/TcMar-Tigger	1062	+	94	73283473	96820
chr3	170830118	171030118	harbor1	chr3	170903940	170904116	DNA/TcMar-Tigger	481	+	88	170904028	73910
chr3	85468218	85668218	harbor1	chr3	85468182	85468730	DNA/TcMar-Tigger	2711	+	274	85468456	238
chr3	85468218	85668218	harbor1	chr3	85497928	85498626	DNA/TcMar-Tigger	3115	+	349	85498277	30059
chr3	85468218	85668218	harbor1	chr3	85498630	85498869	DNA/TcMar-Tigger	1166	+	120	85498750	30532
chr3	2801402	3001402	harbor1	chr3	2802193	2802764	DNA/TcMar-Tigger	2548	+	286	2802479	1077
chr3	2801402	3001402	harbor1	chr3	2844801	2845151	DNA/TcMar-Tigger	1132	+	175	2844976	43574
chr3	180215742	180415742	harbor1	chr3	180263702	180264061	DNA/TcMar-Tigger	2135	+	180	180263882	48140
chr3	167140906	167340906	harbor1	chr3	167239340	167239770	DNA/TcMar-Tigger	2207	+	215	167239555	98649
chr3	148235898	148435898	harbor1	chr3	148260827	148261158	DNA/TcMar-Tigger	1790	+	166	148260993	25095
chr3	148235898	148435898	harbor1	chr3	148313300	148313360	DNA/TcMar-Tigger	396	+	30	148313330	77432
chr3	148235898	148435898	harbor1	chr3	148315755	148316279	DNA/TcMar-Tigger	2399	+	262	148316017	80119
chr3	85960814	86160814	harbor1	chr3	85990117	85990477	DNA/TcMar-Tigger	2173	+	180	85990297	29483
chr3	78175664	78375664	harbor1	chr3	78193163	78193476	DNA/TcMar-Tigger	1024	+	156	78193319	17655
chr3	78175664	78375664	harbor1	chr3	78199712	78200051	DNA/TcMar-Tigger	1668	+	170	78199882	24218
chr3	78241197	78441197	harbor1	chr3	78280816	78281006	DNA/TcMar-Tigger	669	+	95	78280911	39714
chr3	78241197	78441197	harbor1	chr3	78290183	78290507	DNA/TcMar-Tigger	1545	+	162	78290345	49148
chr3	78241197	78441197	harbor1	chr3	78304625	78304748	DNA/TcMar-Tigger	562	+	62	78304687	63490
chr3	78241197	78441197	harbor1	chr3	78304737	78304974	DNA/TcMar-Tigger	1430	+	118	78304855	63658
chr3	6696378	6896378	harbor1	chr3	6729990	6730152	DNA/TcMar-Tigger	878	+	81	6730071	33693
chr3	6696378	6896378	harbor1	chr3	6730535	6730717	DNA/TcMar-Tigger	878	+	91	6730626	34248
chr3	6696378	6896378	harbor1	chr3	6754155	6754508	DNA/TcMar-Tigger	1909	+	176	6754331	57953
chr3	187483700	187683700	harbor1	chr3	187568649	187569239	DNA/TcMar-Tigger	3378	+	295	187568944	85244
chr3	127734383	127934383	harbor1	chr3	127833267	127833310	DNA/TcMar-Tigger	474	+	22	127833289	98906
chr3	127734383	127934383	harbor1	chr3	127833837	127834019	DNA/TcMar-Tigger	474	+	91	127833928	99545
chr3	98572522	98772522	harbor1	chr3	98578959	98579386	DNA/TcMar-Tigger	2118	+	214	98579173	6651
chr3	61604058	61804058	harbor1	chr3	61631278	61631606	DNA/TcMar-Tigger	1858	+	164	61631442	27384
chr3	168329466	168529466	harbor1	chr3	168376284	168376668	DNA/TcMar-Tigger	646	+	192	168376476	47010
chr3	178024200	178224200	harbor1	chr3	178079157	178079384	DNA/TcMar-Tigger	844	+	114	178079271	55071
chr3	177329771	177529771	harbor1	chr3	177398683	177399195	DNA/TcMar-Tigger	3022	+	256	177398939	69168
chr3	177329771	177529771	harbor1	chr3	177399497	177399608	DNA/TcMar-Tigger	3022	+	56	177399553	69782
chr3	177329771	177529771	harbor1	chr3	177420849	177421025	DNA/TcMar-Tigger	747	+	88	177420937	91166
chr3	148748364	148948364	harbor1	chr3	148771282	148771631	DNA/TcMar-Tigger	1739	+	174	148771456	23092
chr3	188690527	188890527	harbor1	chr3	188754102	188754511	DNA/TcMar-Tigger	555	+	204	188754306	63779
chr3	188690527	188890527	harbor1	chr3	188754719	188754878	DNA/TcMar-Tigger	499	+	80	188754799	64272
chr3	188690527	188890527	harbor1	chr3	188754873	188755344	DNA/TcMar-Tigger	698	+	236	188755109	64582
chr3	188690527	188890527	harbor1	chr3	188789103	188789283	DNA/TcMar-Tigger	1130	+	90	188789193	98666
chr3	22629002	22829002	harbor1	chr3	22713958	22714480	DNA/TcMar-Tigger	2864	+	261	22714219	85217
chr3	163065342	163265342	harbor1	chr3	163071066	163071513	DNA/TcMar-Tigger	2127	+	224	163071290	5948
chr3	76534770	76734770	harbor1	chr3	76552091	76552316	DNA/TcMar-Tigger	1523	+	112	76552203	17433
chr3	76534770	76734770	harbor1	chr3	76630078	76630632	DNA/TcMar-Tigger	2964	+	277	76630355	95585
chr3	172006451	172206451	harbor1	chr3	172028825	172029064	DNA/TcMar-Tigger	5430	+	120	172028945	22494
chr3	172006451	172206451	harbor1	chr3	172030115	172030918	DNA/TcMar-Tigger	5430	+	402	172030517	24066
chr3	172006451	172206451	harbor1	chr3	172090696	172091052	DNA/TcMar-Tigger	1912	+	178	172090874	84423
chr3	146369564	146569564	harbor1	chr3	146394599	146394726	DNA/TcMar-Tigger	655	+	64	146394663	25099
chr3	146369564	146569564	harbor1	chr3	146395117	146395135	DNA/TcMar-Tigger	655	+	9	146395126	25562
chr3	146369564	146569564	harbor1	chr3	146424583	146425431	DNA/TcMar-Tigger	4037	+	424	146425007	55443
chr3	146369564	146569564	harbor1	chr3	146426433	146426970	DNA/TcMar-Tigger	674	+	268	146426701	57137
chr3	111054285	111254285	harbor1	chr3	111100355	111100618	DNA/TcMar-Tigger	1586	+	132	111100487	46202
chr3	111054285	111254285	harbor1	chr3	111114748	111114995	DNA/TcMar-Tigger	1145	+	124	111114872	60587
chr3	99346211	99546211	harbor1	chr3	99388338	99388424	DNA/TcMar-Tigger	394	+	43	99388381	42170
chr3	99346211	99546211	harbor1	chr3	99408559	99408655	DNA/TcMar-Tigger	499	+	48	99408607	62396
chr3	30117745	30317745	harbor1	chr3	30139279	30139540	DNA/TcMar-Tigger	1421	+	130	30139409	21664
chr3	30117745	30317745	harbor1	chr3	30159981	30161167	DNA/TcMar-Tigger	6571	+	593	30160574	42829
chr3	30117745	30317745	harbor1	chr3	30203542	30203814	DNA/TcMar-Tigger	786	+	136	30203678	85933
chr3	188280595	188480595	harbor1	chr3	188324807	188324906	DNA/TcMar-Tigger	502	+	50	188324857	44262
chr3	115167125	115367125	harbor1	chr3	115213533	115215704	DNA/TcMar-Tigger	13799	+	1086	115214619	47494
chr3	115167125	115367125	harbor1	chr3	115216353	115216560	DNA/TcMar-Tigger	13799	+	104	115216457	49332
chr3	115167125	115367125	harbor1	chr3	115216860	115216997	DNA/TcMar-Tigger	13799	+	68	115216928	49803
chr3	44662630	44862630	harbor1	chr3	44748209	44748306	DNA/TcMar-Tigger	653	+	48	44748257	85627
chr3	44662630	44862630	harbor1	chr3	44748310	44748526	DNA/TcMar-Tigger	1425	+	108	44748418	85788
chr3	44662630	44862630	harbor1	chr3	44756662	44756968	DNA/TcMar-Tigger	1459	+	153	44756815	94185
chr3	44662630	44862630	harbor1	chr3	44758032	44758103	DNA/TcMar-Tigger	477	+	36	44758068	95438
chr3	17160529	17360529	harbor1	chr3	17194233	17194557	DNA/TcMar-Tigger	623	+	162	17194395	33866
chr3	17160529	17360529	harbor1	chr3	17196827	17197366	DNA/TcMar-Tigger	2558	+	270	17197097	36568
chr3	17160529	17360529	harbor1	chr3	17197667	17197744	DNA/TcMar-Tigger	2558	+	38	17197705	37176
chr3	17160529	17360529	harbor1	chr3	17212200	17213363	DNA/TcMar-Tigger	6544	+	582	17212782	52253
chr3	17160529	17360529	harbor1	chr3	17225502	17225519	DNA/TcMar-Tigger	1262	+	8	17225510	64981
chr3	17160529	17360529	harbor1	chr3	17225862	17226049	DNA/TcMar-Tigger	1262	+	94	17225956	65427
chr3	17160529	17360529	harbor1	chr3	17253818	17254024	DNA/TcMar-Tigger	1095	+	103	17253921	93392
chr3	18858148	19058148	harbor1	chr3	18883297	18884312	DNA/TcMar-Tigger	5906	+	508	18883805	25657
chr3	18858148	19058148	harbor1	chr3	18900454	18900694	DNA/TcMar-Tigger	1571	+	120	18900574	42426
chr3	169792947	169992947	harbor1	chr3	169846179	169846369	DNA/TcMar-Tigger	1588	+	95	169846274	53327
chr3	169792947	169992947	harbor1	chr3	169846667	169846983	DNA/TcMar-Tigger	1588	+	158	169846825	53878
chr3	106333449	106533449	harbor1	chr3	106417130	106418175	DNA/TcMar-Tigger	6145	+	522	106417652	84203
chr3	106333449	106533449	harbor1	chr3	106422471	106422544	DNA/TcMar-Tigger	455	+	36	106422507	89058
chr3	120420998	120620998	harbor1	chr3	120467484	120467670	DNA/TcMar-Tigger	474	+	93	120467577	46579
chr3	62270200	62470200	harbor1	chr3	62314143	62314233	DNA/TcMar-Tigger	516	+	45	62314188	43988
chr3	127118619	127318619	harbor1	chr3	127200494	127201187	DNA/TcMar-Tigger	2316	+	346	127200840	82221
chr3	65366094	65566094	harbor1	chr3	65384240	65384461	DNA/TcMar-Tigger	1639	+	110	65384350	18256
chr3	65366094	65566094	harbor1	chr3	65384763	65384780	DNA/TcMar-Tigger	1639	+	8	65384771	18677
chr3	65366094	65566094	harbor1	chr3	65384809	65384924	DNA/TcMar-Tigger	1639	+	58	65384867	18773
chr3	65366094	65566094	harbor1	chr3	65451213	65451440	DNA/TcMar-Tigger	417	+	114	65451327	85233
chr3	65366094	65566094	harbor1	chr3	65452000	65452073	DNA/TcMar-Tigger	417	+	36	65452036	85942
chr3	115434438	115634438	harbor1	chr3	115476350	115476693	DNA/TcMar-Tigger	1969	+	172	115476522	42084
chr3	9547620	9747620	harbor1	chr3	9607829	9607978	DNA/TcMar-Tigger	1697	+	74	9607903	60283
chr3	9547620	9747620	harbor1	chr3	9608273	9608294	DNA/TcMar-Tigger	1697	+	10	9608283	60663
chr3	9547620	9747620	harbor1	chr3	9609583	9609703	DNA/TcMar-Tigger	1697	+	60	9609643	62023
chr3	19419056	19619056	harbor1	chr3	19462956	19463240	DNA/TcMar-Tigger	1687	+	142	19463098	44042
chr3	19419056	19619056	harbor1	chr3	19465125	19465924	DNA/TcMar-Tigger	9163	+	400	19465525	46469
chr3	19419056	19619056	harbor1	chr3	19466226	19466649	DNA/TcMar-Tigger	9163	+	212	19466438	47382
chr3	19419056	19619056	harbor1	chr3	19466961	19467153	DNA/TcMar-Tigger	9163	+	96	19467057	48001
chr3	43067022	43267022	harbor1	chr3	43100176	43100469	DNA/TcMar-Tigger	1292	+	146	43100322	33300
chr3	43067022	43267022	harbor1	chr3	43138681	43139013	DNA/TcMar-Tigger	1752	+	166	43138847	71825
chr3	38667832	38867832	harbor1	chr3	38689574	38690505	DNA/TcMar-Tigger	6991	+	466	38690040	22208
chr3	38667832	38867832	harbor1	chr3	38690810	38691054	DNA/TcMar-Tigger	6991	+	122	38690932	23100
chr3	195300274	195500274	harbor1	chr3	195352043	195352381	DNA/TcMar-Tigger	1997	+	169	195352212	51938
chr3	106161167	106361167	harbor1	chr3	106184996	106185316	DNA/TcMar-Tigger	1427	+	160	106185156	23989
chr3	106161167	106361167	harbor1	chr3	106195844	106195968	DNA/TcMar-Tigger	409	+	62	106195906	34739
chr3	110428521	110628521	harbor1	chr3	110475555	110476110	DNA/TcMar-Tigger	1151	+	278	110475833	47312
chr3	110428521	110628521	harbor1	chr3	110481089	110483438	DNA/TcMar-Tigger	13262	+	1174	110482263	53742
chr3	110428521	110628521	harbor1	chr3	110518064	110518176	DNA/TcMar-Tigger	515	+	56	110518120	89599
chr3	132010545	132210545	harbor1	chr3	132085853	132086055	DNA/TcMar-Tigger	1197	+	101	132085954	75409
chr3	44992868	45192868	harbor1	chr3	45044614	45044740	DNA/TcMar-Tigger	4659	+	63	45044677	51809
chr3	44992868	45192868	harbor1	chr3	45045051	45045954	DNA/TcMar-Tigger	4659	+	452	45045503	52635
chr3	44992868	45192868	harbor1	chr3	45066437	45066501	DNA/TcMar-Tigger	466	+	32	45066469	73601
chr3	124261308	124461308	harbor1	chr3	124300970	124301250	DNA/TcMar-Tigger	432	+	140	124301110	39802
chr3	87105672	87305672	harbor1	chr3	87114457	87114791	DNA/TcMar-Tigger	1706	+	167	87114624	8952
chr3	53724841	53924841	harbor1	chr3	53736946	53737018	DNA/TcMar-Tigger	1292	+	36	53736982	12141
chr3	53724841	53924841	harbor1	chr3	53737287	53737516	DNA/TcMar-Tigger	1292	+	114	53737401	12560
chr3	67013546	67213546	harbor1	chr3	67021642	67021965	DNA/TcMar-Tigger	1740	+	162	67021804	8258
chr3	67013546	67213546	harbor1	chr3	67107246	67107824	DNA/TcMar-Tigger	2798	+	289	67107535	93989
chr3	155283974	155483974	harbor1	chr3	155310857	155311070	DNA/TcMar-Tigger	1143	+	106	155310963	26989
chr3	155283974	155483974	harbor1	chr3	155311343	155311676	DNA/TcMar-Tigger	1143	+	166	155311509	27535
chr3	155283974	155483974	harbor1	chr3	155357949	155358225	DNA/TcMar-Tigger	1281	+	138	155358087	74113
chr3	134055029	134255029	harbor1	chr3	134094645	134094746	DNA/TcMar-Tigger	625	+	50	134094695	39666
chr3	134055029	134255029	harbor1	chr3	134113248	134113664	DNA/TcMar-Tigger	2382	+	208	134113456	58427
chr3	157799820	157999820	harbor1	chr3	157831918	157832112	DNA/TcMar-Tigger	502	+	97	157832015	32195
chr3	56851451	57051451	harbor1	chr3	56942174	56943632	DNA/TcMar-Tigger	12578	+	729	56942903	91452
chr3	56851451	57051451	harbor1	chr3	56944200	56944564	DNA/TcMar-Tigger	10879	+	182	56944382	92931
chr3	56851451	57051451	harbor1	chr3	56944879	56945132	DNA/TcMar-Tigger	10879	+	126	56945005	93554
chr3	148140118	148340118	harbor1	chr3	148158231	148158876	DNA/TcMar-Tigger	3503	+	322	148158553	18435
chr3	148140118	148340118	harbor1	chr3	148159949	148159972	DNA/TcMar-Tigger	3503	+	12	148159961	19843
chr3	148140118	148340118	harbor1	chr3	148160535	148161254	DNA/TcMar-Tigger	4224	+	360	148160895	20777
chr3	148140118	148340118	harbor1	chr3	148161374	148161817	DNA/TcMar-Tigger	2799	+	222	148161596	21478
chr3	148140118	148340118	harbor1	chr3	148160293	148160542	DNA/TcMar-Tigger	1511	+	124	148160417	20299
chr3	78712788	78912788	harbor1	chr3	78723054	78723443	DNA/TcMar-Tigger	1556	+	194	78723248	10460
chr3	59089818	59289818	harbor1	chr3	59162637	59162874	DNA/TcMar-Tigger	441	+	118	59162755	72937
chr3	59089818	59289818	harbor1	chr3	59168415	59169867	DNA/TcMar-Tigger	14557	+	726	59169141	79323
chr3	59089818	59289818	harbor1	chr3	59170533	59171316	DNA/TcMar-Tigger	14557	+	392	59170925	81107
chr3	116679548	116879548	harbor1	chr3	116763701	116764417	DNA/TcMar-Tigger	573	+	358	116764059	84511
chr3	116679548	116879548	harbor1	chr3	116775344	116775929	DNA/TcMar-Tigger	2298	+	292	116775636	96088
chr3	164200804	164400804	harbor1	chr3	164282656	164283143	DNA/TcMar-Tigger	2488	+	244	164282900	82096
chr3	32837966	33037966	harbor1	chr3	32847907	32848110	DNA/TcMar-Tigger	1165	+	102	32848009	10043
chr3	32837966	33037966	harbor1	chr3	32854900	32855208	DNA/TcMar-Tigger	1816	+	154	32855054	17088
chr3	175930496	176130496	harbor1	chr3	175971834	175972012	DNA/TcMar-Tigger	932	+	89	175971923	41427
chr3	175930496	176130496	harbor1	chr3	176024911	176025218	DNA/TcMar-Tigger	1209	+	154	176025065	94569
chr3	184393792	184593792	harbor1	chr3	184462250	184462314	DNA/TcMar-Tigger	437	+	32	184462282	68490
chr3	184393792	184593792	harbor1	chr3	184462477	184462639	DNA/TcMar-Tigger	1412	+	81	184462558	68766
chr3	184393792	184593792	harbor1	chr3	184462939	184463038	DNA/TcMar-Tigger	1412	+	50	184462989	69197
chr3	180562876	180762876	harbor1	chr3	180596372	180596713	DNA/TcMar-Tigger	1597	+	170	180596542	33666
chr3	180562876	180762876	harbor1	chr3	180617093	180618237	DNA/TcMar-Tigger	6779	+	572	180617665	54789
chr3	104833518	105033518	harbor1	chr3	104852148	104852351	DNA/TcMar-Tigger	1092	+	102	104852250	18732
chr3	175637784	175837784	harbor1	chr3	175690223	175690985	DNA/TcMar-Tigger	1119	+	381	175690604	52820
chr3	71340676	71540676	harbor1	chr3	71378328	71378924	DNA/TcMar-Tigger	2624	+	298	71378626	37950
chr3	185276513	185476513	harbor1	chr3	185289526	185289630	DNA/TcMar-Tigger	402	+	52	185289578	13065
chr3	107446626	107646626	harbor1	chr3	107500253	107500400	DNA/TcMar-Tigger	475	+	74	107500327	53701
chr3	107446626	107646626	harbor1	chr3	107532952	107533262	DNA/TcMar-Tigger	1120	+	155	107533107	86481
chr3	140425080	140625080	harbor1	chr3	140457822	140458228	DNA/TcMar-Tigger	586	+	203	140458025	32945
chr3	140425080	140625080	harbor1	chr3	140503247	140503593	DNA/TcMar-Tigger	2077	+	173	140503420	78340
chr3	167770839	167970839	harbor1	chr3	167786827	167786929	DNA/TcMar-Tigger	548	+	51	167786878	16039
chr3	191384361	191584361	harbor1	chr3	191417837	191417934	DNA/TcMar-Tigger	492	+	48	191417885	33524
chr3	191384361	191584361	harbor1	chr3	191417923	191420093	DNA/TcMar-Tigger	13593	+	1085	191419008	34647
chr3	191384361	191584361	harbor1	chr3	191458715	191459287	DNA/TcMar-Tigger	3135	+	286	191459001	74640
chr3	191384361	191584361	harbor1	chr3	191463484	191463569	DNA/TcMar-Tigger	486	+	42	191463526	79165
chr3	43722216	43922216	harbor1	chr3	43754731	43754946	DNA/TcMar-Tigger	1067	+	108	43754839	32623
chr3	41915219	42115219	harbor1	chr3	41986192	41986388	DNA/TcMar-Tigger	1360	+	98	41986290	71071
chr3	1956276	2156276	harbor1	chr3	1957146	1957262	DNA/TcMar-Tigger	613	+	58	1957204	928
chr3	1956276	2156276	harbor1	chr3	1958469	1958793	DNA/TcMar-Tigger	2102	+	162	1958631	2355
chr3	1956276	2156276	harbor1	chr3	2047470	2047657	DNA/TcMar-Tigger	418	+	94	2047564	91288
chr3	1956276	2156276	harbor1	chr3	2047680	2048249	DNA/TcMar-Tigger	1394	+	284	2047964	91688
chr3	64601660	64801660	harbor1	chr3	64623887	64624003	DNA/TcMar-Tigger	463	+	58	64623945	22285
chr3	64601660	64801660	harbor1	chr3	64624488	64624876	DNA/TcMar-Tigger	800	+	194	64624682	23022
chr3	64601660	64801660	harbor1	chr3	64652797	64653128	DNA/TcMar-Tigger	1717	+	166	64652963	51303
chr3	64601660	64801660	harbor1	chr3	64660402	64661117	DNA/TcMar-Tigger	3932	+	358	64660760	59100
chr3	64601660	64801660	harbor1	chr3	64662780	64663098	DNA/TcMar-Tigger	1467	+	159	64662939	61279
chr3	64601660	64801660	harbor1	chr3	64672855	64673149	DNA/TcMar-Tigger	1291	+	147	64673002	71342
chr3	39331501	39531501	harbor1	chr3	39333401	39334123	DNA/TcMar-Tigger	5041	+	361	39333762	2261
chr3	39331501	39531501	harbor1	chr3	39334165	39334406	DNA/TcMar-Tigger	1522	+	120	39334285	2784
chr3	39331501	39531501	harbor1	chr3	39337298	39337501	DNA/TcMar-Tigger	1145	+	102	39337400	5899
chr3	39331501	39531501	harbor1	chr3	39338538	39338724	DNA/TcMar-Tigger	881	+	93	39338631	7130
chr3	115276941	115476941	harbor1	chr3	115293825	115294134	DNA/TcMar-Tigger	1676	+	154	115293979	17038
chr3	115276941	115476941	harbor1	chr3	115321541	115321776	DNA/TcMar-Tigger	748	+	118	115321659	44718
chr3	120079912	120279912	harbor1	chr3	120103566	120103897	DNA/TcMar-Tigger	613	+	166	120103732	23820
chr3	120079912	120279912	harbor1	chr3	120138610	120139011	DNA/TcMar-Tigger	15124	+	200	120138810	58898
chr3	120079912	120279912	harbor1	chr3	120139321	120140074	DNA/TcMar-Tigger	15124	+	376	120139697	59785
chr3	120079912	120279912	harbor1	chr3	120141693	120142790	DNA/TcMar-Tigger	15124	+	548	120142241	62329
chr3	120079912	120279912	harbor1	chr3	120143136	120143222	DNA/TcMar-Tigger	15124	+	43	120143179	63267
chr3	148245382	148445382	harbor1	chr3	148260827	148261158	DNA/TcMar-Tigger	1790	+	166	148260993	15611
chr3	148245382	148445382	harbor1	chr3	148313300	148313360	DNA/TcMar-Tigger	396	+	30	148313330	67948
chr3	148245382	148445382	harbor1	chr3	148315755	148316279	DNA/TcMar-Tigger	2399	+	262	148316017	70635
chr3	143883951	144083951	harbor1	chr3	143885423	143885637	DNA/TcMar-Tigger	540	+	107	143885530	1579
chr3	71599523	71799523	harbor1	chr3	71635175	71635756	DNA/TcMar-Tigger	3009	+	290	71635465	35942
chr3	71599523	71799523	harbor1	chr3	71650965	71651218	DNA/TcMar-Tigger	835	+	126	71651091	51568
chr3	2208237	2408237	harbor1	chr3	2207941	2209059	DNA/TcMar-Tigger	6373	+	559	2208500	263
chr3	26127294	26327294	harbor1	chr3	26153890	26154211	DNA/TcMar-Tigger	757	+	160	26154050	26756
chr3	26127294	26327294	harbor1	chr3	26157259	26157543	DNA/TcMar-Tigger	1612	+	142	26157401	30107
chr3	195890869	196090869	harbor1	chr3	195963784	195963996	DNA/TcMar-Tigger	1045	+	106	195963890	73021
chr3	177802793	178002793	harbor1	chr3	177898083	177898280	DNA/TcMar-Tigger	681	+	98	177898181	95388
chr3	177802793	178002793	harbor1	chr3	177900126	177900234	DNA/TcMar-Tigger	599	+	54	177900180	97387
chr3	56183057	56383057	harbor1	chr3	56189792	56190227	DNA/TcMar-Tigger	469	+	218	56190010	6953
chr3	56183057	56383057	harbor1	chr3	56227200	56227317	DNA/TcMar-Tigger	431	+	58	56227258	44201
chr3	56183057	56383057	harbor1	chr3	56244072	56245156	DNA/TcMar-Tigger	3214	+	542	56244614	61557
chr3	56183057	56383057	harbor1	chr3	56268067	56268402	DNA/TcMar-Tigger	1952	+	168	56268235	85178
chr3	56183057	56383057	harbor1	chr3	56269442	56269918	DNA/TcMar-Tigger	535	+	238	56269680	86623
chr3	56183057	56383057	harbor1	chr3	56262316	56262845	DNA/TcMar-Tigger	979	+	264	56262580	79523
chr3	126091217	126291217	harbor1	chr3	126188261	126188438	DNA/TcMar-Tigger	1043	+	88	126188349	97132
chr3	112534884	112734884	harbor1	chr3	112601965	112603244	DNA/TcMar-Tigger	13831	+	640	112602605	67721
chr3	112534884	112734884	harbor1	chr3	112603581	112604642	DNA/TcMar-Tigger	13831	+	530	112604111	69227
chr3	197033481	197233481	harbor1	chr3	197132299	197132561	DNA/TcMar-Tigger	1009	+	131	197132430	98949
chr3	2880676	3080676	harbor1	chr3	2923785	2923958	DNA/TcMar-Tigger	497	+	86	2923871	43195
chr3	2880676	3080676	harbor1	chr3	2948530	2948875	DNA/TcMar-Tigger	599	+	172	2948702	68026
chr3	2880676	3080676	harbor1	chr3	2979459	2979582	DNA/TcMar-Tigger	460	+	62	2979521	98845
chr4	167327796	167527796	harbor1	chr4	167340985	167341352	DNA/TcMar-Tigger	1880	+	184	167341169	13373
chr4	167327796	167527796	harbor1	chr4	167352837	167353092	DNA/TcMar-Tigger	1051	+	128	167352965	25169
chr4	167327796	167527796	harbor1	chr4	167353092	167353188	DNA/TcMar-Tigger	466	+	48	167353140	25344
chr4	167327796	167527796	harbor1	chr4	167393709	167393954	DNA/TcMar-Tigger	1037	+	122	167393831	66035
chr4	167327796	167527796	harbor1	chr4	167394721	167394883	DNA/TcMar-Tigger	1012	+	81	167394802	67006
chr4	87152883	87352883	harbor1	chr4	87192448	87192620	DNA/TcMar-Tigger	793	+	86	87192534	39651
chr4	87152883	87352883	harbor1	chr4	87212628	87212977	DNA/TcMar-Tigger	1555	+	174	87212802	59919
chr4	87152883	87352883	harbor1	chr4	87234079	87234157	DNA/TcMar-Tigger	6096	+	39	87234118	81235
chr4	87152883	87352883	harbor1	chr4	87234452	87235522	DNA/TcMar-Tigger	6096	+	535	87234987	82104
chr4	117755301	117955301	harbor1	chr4	117801214	117802186	DNA/TcMar-Tigger	6106	+	486	117801700	46399
chr4	117755301	117955301	harbor1	chr4	117802241	117802347	DNA/TcMar-Tigger	6106	+	53	117802294	46993
chr4	117755301	117955301	harbor1	chr4	117837388	117837627	DNA/TcMar-Tigger	993	+	120	117837508	82207
chr4	117755301	117955301	harbor1	chr4	117845454	117847818	DNA/TcMar-Tigger	13970	+	1182	117846636	91335
chr4	84576701	84776701	harbor1	chr4	84580665	84580935	DNA/TcMar-Tigger	1347	+	135	84580800	4099
chr4	84576701	84776701	harbor1	chr4	84610640	84610951	DNA/TcMar-Tigger	1437	+	156	84610796	34095
chr4	84576701	84776701	harbor1	chr4	84629288	84629641	DNA/TcMar-Tigger	2001	+	176	84629464	52763
chr4	81360392	81560392	harbor1	chr4	81428562	81428678	DNA/TcMar-Tigger	696	+	58	81428620	68228
chr4	81360392	81560392	harbor1	chr4	81428787	81428871	DNA/TcMar-Tigger	590	+	42	81428829	68437
chr4	81360392	81560392	harbor1	chr4	81428360	81428570	DNA/TcMar-Tigger	1252	+	105	81428465	68073
chr4	182489796	182689796	harbor1	chr4	182494266	182494576	DNA/TcMar-Tigger	1619	+	155	182494421	4625
chr4	103346054	103546054	harbor1	chr4	103421832	103422068	DNA/TcMar-Tigger	1425	+	118	103421950	75896
chr4	103346054	103546054	harbor1	chr4	103443413	103443766	DNA/TcMar-Tigger	2066	+	176	103443589	97535
chr4	103346054	103546054	harbor1	chr4	103443918	103444076	DNA/TcMar-Tigger	4529	+	79	103443997	97943
chr4	103346054	103546054	harbor1	chr4	103444411	103444715	DNA/TcMar-Tigger	4529	+	152	103444563	98509
chr4	103346054	103546054	harbor1	chr4	103445233	103445628	DNA/TcMar-Tigger	4529	+	198	103445431	99377
chr4	53204913	53404913	harbor1	chr4	53206029	53206369	DNA/TcMar-Tigger	1703	+	170	53206199	1286
chr4	53204913	53404913	harbor1	chr4	53206347	53206806	DNA/TcMar-Tigger	2065	+	230	53206577	1664
chr4	53204913	53404913	harbor1	chr4	53209728	53210049	DNA/TcMar-Tigger	1180	+	160	53209888	4975
chr4	53204913	53404913	harbor1	chr4	53281236	53281408	DNA/TcMar-Tigger	590	+	86	53281322	76409
chr4	127025380	127225380	harbor1	chr4	127060723	127060956	DNA/TcMar-Tigger	1275	+	116	127060839	35459
chr4	122433307	122633307	harbor1	chr4	122446794	122447033	DNA/TcMar-Tigger	1288	+	120	122446914	13607
chr4	122433307	122633307	harbor1	chr4	122471427	122473167	DNA/TcMar-Tigger	10663	+	870	122472297	38990
chr4	122433307	122633307	harbor1	chr4	122473339	122473678	DNA/TcMar-Tigger	1911	+	170	122473509	40202
chr4	122433307	122633307	harbor1	chr4	122473687	122473809	DNA/TcMar-Tigger	646	+	61	122473748	40441
chr4	66816175	67016175	harbor1	chr4	66900105	66900411	DNA/TcMar-Tigger	1691	+	153	66900258	84083
chr4	66816175	67016175	harbor1	chr4	66900772	66901379	DNA/TcMar-Tigger	2403	+	304	66901076	84901
chr4	173923504	174123504	harbor1	chr4	173962542	173962608	DNA/TcMar-Tigger	422	+	33	173962575	39071
chr4	173923504	174123504	harbor1	chr4	173962599	173962946	DNA/TcMar-Tigger	1884	+	174	173962773	39269
chr4	173923504	174123504	harbor1	chr4	173969036	173969133	DNA/TcMar-Tigger	574	+	48	173969084	45580
chr4	74189706	74389706	harbor1	chr4	74218902	74219234	DNA/TcMar-Tigger	1201	+	166	74219068	29362
chr4	74189706	74389706	harbor1	chr4	74258417	74258642	DNA/TcMar-Tigger	1051	+	112	74258529	68823
chr4	74189706	74389706	harbor1	chr4	74284172	74284369	DNA/TcMar-Tigger	1194	+	98	74284270	94564
chr4	74189706	74389706	harbor1	chr4	74285356	74285512	DNA/TcMar-Tigger	670	+	78	74285434	95728
chr4	74189706	74389706	harbor1	chr4	74285593	74285789	DNA/TcMar-Tigger	1056	+	98	74285691	95985
chr4	33702504	33902504	harbor1	chr4	33793301	33793713	DNA/TcMar-Tigger	2135	+	206	33793507	91003
chr4	172651186	172851186	harbor1	chr4	172740416	172741000	DNA/TcMar-Tigger	2576	+	292	172740708	89522
chr4	3428470	3628470	harbor1	chr4	3524727	3524883	DNA/TcMar-Tigger	518	+	78	3524805	96335
chr4	174662017	174862017	harbor1	chr4	174700202	174700493	DNA/TcMar-Tigger	1622	+	146	174700348	38331
chr4	174662017	174862017	harbor1	chr4	174700489	174702474	DNA/TcMar-Tigger	12521	+	992	174701481	39464
chr4	22340424	22540424	harbor1	chr4	22412409	22412622	DNA/TcMar-Tigger	1236	+	106	22412515	72091
chr4	22340424	22540424	harbor1	chr4	22431762	22432024	DNA/TcMar-Tigger	1436	+	131	22431893	91469
chr4	88909884	89109884	harbor1	chr4	88955985	88956476	DNA/TcMar-Tigger	2844	+	246	88956231	46347
chr4	88909884	89109884	harbor1	chr4	88976506	88977073	DNA/TcMar-Tigger	3586	+	284	88976790	66906
chr4	14977091	15177091	harbor1	chr4	14996178	14997553	DNA/TcMar-Tigger	13716	+	688	14996866	19775
chr4	14977091	15177091	harbor1	chr4	14997815	14998914	DNA/TcMar-Tigger	13716	+	550	14998365	21274
chr4	55042820	55242820	harbor1	chr4	55112148	55112523	DNA/TcMar-Tigger	2585	+	188	55112336	69516
chr4	55042820	55242820	harbor1	chr4	55112830	55112917	DNA/TcMar-Tigger	2585	+	44	55112874	70054
chr4	70728805	70928805	harbor1	chr4	70740833	70741028	DNA/TcMar-Tigger	797	+	98	70740931	12126
chr4	70728805	70928805	harbor1	chr4	70797419	70797562	DNA/TcMar-Tigger	623	+	72	70797491	68686
chr4	70728805	70928805	harbor1	chr4	70797871	70797998	DNA/TcMar-Tigger	623	+	64	70797935	69130
chr4	136325228	136525228	harbor1	chr4	136370537	136370683	DNA/TcMar-Tigger	651	+	73	136370610	45382
chr4	103536203	103736203	harbor1	chr4	103553194	103553513	DNA/TcMar-Tigger	1389	+	160	103553354	17151
chr4	171028070	171228070	harbor1	chr4	171103925	171103966	DNA/TcMar-Tigger	5580	+	20	171103945	75875
chr4	171028070	171228070	harbor1	chr4	171104264	171105255	DNA/TcMar-Tigger	5580	+	496	171104760	76690
chr4	171028070	171228070	harbor1	chr4	171105252	171105326	DNA/TcMar-Tigger	1656	+	37	171105289	77219
chr4	171028070	171228070	harbor1	chr4	171105702	171105907	DNA/TcMar-Tigger	1656	+	102	171105804	77734
chr4	171028070	171228070	harbor1	chr4	171106214	171106330	DNA/TcMar-Tigger	1656	+	58	171106272	78202
chr4	171028070	171228070	harbor1	chr4	171124827	171125066	DNA/TcMar-Tigger	1478	+	120	171124947	96877
chr4	164239654	164439654	harbor1	chr4	164319053	164319392	DNA/TcMar-Tigger	2046	+	170	164319223	79569
chr4	164239654	164439654	harbor1	chr4	164333272	164335306	DNA/TcMar-Tigger	14328	+	1017	164334289	94635
chr4	164239654	164439654	harbor1	chr4	164335605	164335903	DNA/TcMar-Tigger	14328	+	149	164335754	96100
chr4	71190398	71390398	harbor1	chr4	71190892	71191256	DNA/TcMar-Tigger	1958	+	182	71191074	676
chr4	71190398	71390398	harbor1	chr4	71192293	71192576	DNA/TcMar-Tigger	451	+	142	71192435	2037
chr4	71190398	71390398	harbor1	chr4	71212854	71213189	DNA/TcMar-Tigger	1920	+	168	71213022	22624
chr4	71190398	71390398	harbor1	chr4	71219069	71219303	DNA/TcMar-Tigger	1531	+	117	71219186	28788
chr4	71190398	71390398	harbor1	chr4	71219302	71220188	DNA/TcMar-Tigger	5477	+	443	71219745	29347
chr4	71190398	71390398	harbor1	chr4	71220189	71220464	DNA/TcMar-Tigger	1656	+	138	71220327	29929
chr4	111728081	111928081	harbor1	chr4	111781611	111782138	DNA/TcMar-Tigger	3052	+	264	111781875	53794
chr4	111728081	111928081	harbor1	chr4	111782150	111782234	DNA/TcMar-Tigger	496	+	42	111782192	54111
chr4	145326562	145526562	harbor1	chr4	145360850	145362921	DNA/TcMar-Tigger	14356	+	1036	145361886	35324
chr4	145326562	145526562	harbor1	chr4	145363226	145363400	DNA/TcMar-Tigger	14356	+	87	145363313	36751
chr4	145326562	145526562	harbor1	chr4	145363763	145363896	DNA/TcMar-Tigger	705	+	66	145363829	37267
chr4	145326562	145526562	harbor1	chr4	145418040	145418378	DNA/TcMar-Tigger	1975	+	169	145418209	91647
chr4	630657	830657	harbor1	chr4	652627	652832	DNA/TcMar-Tigger	724	+	102	652729	22072
chr4	630657	830657	harbor1	chr4	728427	728609	DNA/TcMar-Tigger	675	+	91	728518	97861
chr4	99524279	99724279	harbor1	chr4	99528900	99528988	DNA/TcMar-Tigger	439	+	44	99528944	4665
chr4	99524279	99724279	harbor1	chr4	99551360	99552576	DNA/TcMar-Tigger	6817	+	608	99551968	27689
chr4	99524279	99724279	harbor1	chr4	99617972	99618310	DNA/TcMar-Tigger	1193	+	169	99618141	93862
chr4	135566888	135766888	harbor1	chr4	135574115	135574238	DNA/TcMar-Tigger	805	+	62	135574177	7289
chr4	16404468	16604468	harbor1	chr4	16423223	16423624	DNA/TcMar-Tigger	643	+	200	16423423	18955
chr4	16404468	16604468	harbor1	chr4	16424036	16424052	DNA/TcMar-Tigger	643	+	8	16424044	19576
chr4	16404468	16604468	harbor1	chr4	16470368	16470693	DNA/TcMar-Tigger	1618	+	162	16470530	66062
chr4	44527873	44727873	harbor1	chr4	44534770	44535079	DNA/TcMar-Tigger	1384	+	154	44534924	7051
chr4	32934290	33134290	harbor1	chr4	32942436	32942631	DNA/TcMar-Tigger	9218	+	98	32942534	8244
chr4	32934290	33134290	harbor1	chr4	32942928	32943243	DNA/TcMar-Tigger	9218	+	158	32943086	8796
chr4	32934290	33134290	harbor1	chr4	32943567	32944795	DNA/TcMar-Tigger	9479	+	614	32944181	9891
chr4	32934290	33134290	harbor1	chr4	32944790	32945402	DNA/TcMar-Tigger	2758	+	306	32945096	10806
chr4	32934290	33134290	harbor1	chr4	33023432	33023772	DNA/TcMar-Tigger	1660	+	170	33023602	89312
chr4	12388433	12588433	harbor1	chr4	12415733	12416092	DNA/TcMar-Tigger	1854	+	180	12415913	27480
chr4	27699988	27899988	harbor1	chr4	27776662	27778094	DNA/TcMar-Tigger	13615	+	716	27777378	77390
chr4	27699988	27899988	harbor1	chr4	27778205	27779231	DNA/TcMar-Tigger	13615	+	513	27778718	78730
chr4	37503265	37703265	harbor1	chr4	37526557	37527538	DNA/TcMar-Tigger	7131	+	490	37527047	23782
chr4	37503265	37703265	harbor1	chr4	37527842	37528037	DNA/TcMar-Tigger	7131	+	98	37527940	24675
chr4	134887308	135087308	harbor1	chr4	134910402	134910744	DNA/TcMar-Tigger	1660	+	171	134910573	23265
chr4	134887308	135087308	harbor1	chr4	134938904	134939767	DNA/TcMar-Tigger	4935	+	432	134939336	52028
chr4	134887308	135087308	harbor1	chr4	134939760	134939957	DNA/TcMar-Tigger	1371	+	98	134939858	52550
chr4	134887308	135087308	harbor1	chr4	134939962	134940314	DNA/TcMar-Tigger	2115	+	176	134940138	52830
chr5	167109941	167309941	harbor1	chr5	167196625	167196936	DNA/TcMar-Tigger	1060	+	156	167196781	86840
chr5	114406406	114606406	harbor1	chr5	114455117	114457505	DNA/TcMar-Tigger	14222	+	1194	114456311	49905
chr5	44727948	44927948	harbor1	chr5	44795257	44795565	DNA/TcMar-Tigger	798	+	154	44795411	67463
chr5	44727948	44927948	harbor1	chr5	44796076	44796232	DNA/TcMar-Tigger	798	+	78	44796154	68206
chr5	148364371	148564371	harbor1	chr5	148436342	148436573	DNA/TcMar-Tigger	1205	+	116	148436458	72087
chr5	95433082	95633082	harbor1	chr5	95479508	95479675	DNA/TcMar-Tigger	1408	+	84	95479592	46510
chr5	95433082	95633082	harbor1	chr5	95479715	95479794	DNA/TcMar-Tigger	1408	+	40	95479755	46673
chr5	581088	781088	harbor1	chr5	645404	645932	DNA/TcMar-Tigger	1736	+	264	645668	64580
chr5	50410718	50610718	harbor1	chr5	50510157	50510494	DNA/TcMar-Tigger	4388	+	168	50510325	99607
chr5	112039980	112239980	harbor1	chr5	112074303	112074552	DNA/TcMar-Tigger	1076	+	124	112074427	34447
chr5	112039980	112239980	harbor1	chr5	112080186	112080558	DNA/TcMar-Tigger	2368	+	186	112080372	40392
chr5	112039980	112239980	harbor1	chr5	112080556	112080822	DNA/TcMar-Tigger	1555	+	133	112080689	40709
chr5	112039980	112239980	harbor1	chr5	112105705	112106276	DNA/TcMar-Tigger	3304	+	286	112105991	66011
chr5	112039980	112239980	harbor1	chr5	112106798	112107076	DNA/TcMar-Tigger	1428	+	139	112106937	66957
chr5	70055089	70255089	harbor1	chr5	70084796	70085253	DNA/TcMar-Tigger	3273	+	228	70085024	29935
chr5	70055089	70255089	harbor1	chr5	70085543	70085744	DNA/TcMar-Tigger	3273	+	100	70085643	30554
chr5	70055089	70255089	harbor1	chr5	70092157	70092518	DNA/TcMar-Tigger	2415	+	180	70092337	37248
chr5	96307567	96507567	harbor1	chr5	96376131	96376431	DNA/TcMar-Tigger	6309	+	150	96376281	68714
chr5	96307567	96507567	harbor1	chr5	96376740	96377713	DNA/TcMar-Tigger	6309	+	486	96377226	69659
chr5	52580682	52780682	harbor1	chr5	52635669	52635778	DNA/TcMar-Tigger	656	+	54	52635723	55041
chr5	113279058	113479058	harbor1	chr5	113283791	113284152	DNA/TcMar-Tigger	1986	+	180	113283971	4913
chr5	113279058	113479058	harbor1	chr5	113296824	113297110	DNA/TcMar-Tigger	1072	+	143	113296967	17909
chr5	96180165	96380165	harbor1	chr5	96215532	96215601	DNA/TcMar-Tigger	468	+	34	96215566	35401
chr5	96180165	96380165	harbor1	chr5	96215600	96215823	DNA/TcMar-Tigger	2438	+	112	96215712	35547
chr5	96180165	96380165	harbor1	chr5	96216108	96216335	DNA/TcMar-Tigger	2438	+	114	96216222	36057
chr5	104760047	104960047	harbor1	chr5	104768338	104768875	DNA/TcMar-Tigger	2036	+	268	104768606	8559
chr5	7109963	7309963	harbor1	chr5	7120966	7121312	DNA/TcMar-Tigger	1979	+	173	7121139	11176
chr5	15139137	15339137	harbor1	chr5	15149198	15149554	DNA/TcMar-Tigger	487	+	178	15149376	10239
chr5	51549445	51749445	harbor1	chr5	51598077	51598705	DNA/TcMar-Tigger	6212	+	314	51598391	48946
chr5	51549445	51749445	harbor1	chr5	51599016	51599588	DNA/TcMar-Tigger	6212	+	286	51599302	49857
chr5	95975372	96175372	harbor1	chr5	96021887	96022227	DNA/TcMar-Tigger	1804	+	170	96022057	46685
chr5	22925057	23125057	harbor1	chr5	23007087	23007416	DNA/TcMar-Tigger	1904	+	164	23007251	82194
chr5	22925057	23125057	harbor1	chr5	23003131	23003368	DNA/TcMar-Tigger	1126	+	118	23003249	78192
chr5	99621094	99821094	harbor1	chr5	99650341	99650571	DNA/TcMar-Tigger	1214	+	115	99650456	29362
chr5	99621094	99821094	harbor1	chr5	99650567	99651144	DNA/TcMar-Tigger	3486	+	288	99650855	29761
chr5	75317080	75517080	harbor1	chr5	75340456	75340689	DNA/TcMar-Tigger	1433	+	116	75340572	23492
chr5	75317080	75517080	harbor1	chr5	75405678	75405931	DNA/TcMar-Tigger	841	+	126	75405804	88724
chr5	112373528	112573528	harbor1	chr5	112405476	112405673	DNA/TcMar-Tigger	618	+	98	112405574	32046
chr5	157245832	157445832	harbor1	chr5	157258044	157258340	DNA/TcMar-Tigger	3079	+	148	157258192	12360
chr5	157245832	157445832	harbor1	chr5	157258668	157258997	DNA/TcMar-Tigger	3079	+	164	157258832	13000
chr5	33444330	33644330	harbor1	chr5	33486288	33486465	DNA/TcMar-Tigger	653	+	88	33486376	42046
chr5	60655448	60855448	harbor1	chr5	60706306	60706493	DNA/TcMar-Tigger	498	+	94	60706400	50952
chr5	60655448	60855448	harbor1	chr5	60718804	60719176	DNA/TcMar-Tigger	2168	+	186	60718990	63542
chr5	111051662	111251662	harbor1	chr5	111095534	111095763	DNA/TcMar-Tigger	1238	+	114	111095648	43986
chr5	111051662	111251662	harbor1	chr5	111100849	111101165	DNA/TcMar-Tigger	1275	+	158	111101007	49345
chr5	119385142	119585142	harbor1	chr5	119467607	119467836	DNA/TcMar-Tigger	1225	+	114	119467721	82579
chr5	2800473	3000473	harbor1	chr5	2821927	2822272	DNA/TcMar-Tigger	1889	+	172	2822099	21626
chr5	2800473	3000473	harbor1	chr5	2817913	2818229	DNA/TcMar-Tigger	1170	+	158	2818071	17598
chr5	41759133	41959133	harbor1	chr5	41821314	41821453	DNA/TcMar-Tigger	431	+	70	41821384	62251
chr5	41759133	41959133	harbor1	chr5	41858913	41859305	DNA/TcMar-Tigger	2195	+	196	41859109	99976
chr5	98711181	98911181	harbor1	chr5	98732790	98733439	DNA/TcMar-Tigger	3115	+	324	98733114	21933
chr5	66900052	67100052	harbor1	chr5	66930319	66930655	DNA/TcMar-Tigger	813	+	168	66930487	30435
chr5	66900052	67100052	harbor1	chr5	66928547	66928708	DNA/TcMar-Tigger	503	+	80	66928627	28575
chr5	99495896	99695896	harbor1	chr5	99520925	99521228	DNA/TcMar-Tigger	1589	+	152	99521077	25181
chr5	99495896	99695896	harbor1	chr5	99529689	99530145	DNA/TcMar-Tigger	2044	+	228	99529917	34021
chr5	99495896	99695896	harbor1	chr5	99530450	99530598	DNA/TcMar-Tigger	2044	+	74	99530524	34628
chr5	55663692	55863692	harbor1	chr5	55689788	55689870	DNA/TcMar-Tigger	436	+	41	55689829	26137
chr5	65814010	66014010	harbor1	chr5	65876600	65876824	DNA/TcMar-Tigger	1380	+	112	65876712	62702
chr5	65814010	66014010	harbor1	chr5	65877308	65878823	DNA/TcMar-Tigger	10806	+	758	65878066	64056
chr5	65814010	66014010	harbor1	chr5	65879118	65879254	DNA/TcMar-Tigger	10806	+	68	65879186	65176
chr5	65814010	66014010	harbor1	chr5	65879507	65879979	DNA/TcMar-Tigger	3763	+	236	65879743	65733
chr5	65814010	66014010	harbor1	chr5	65880294	65880424	DNA/TcMar-Tigger	3763	+	65	65880359	66349
chr5	65814010	66014010	harbor1	chr5	65906278	65906445	DNA/TcMar-Tigger	498	+	84	65906362	92352
chr5	65814010	66014010	harbor1	chr5	65906656	65906798	DNA/TcMar-Tigger	498	+	71	65906727	92717
chr5	42277158	42477158	harbor1	chr5	42325745	42326122	DNA/TcMar-Tigger	1233	+	188	42325933	48775
chr5	42277158	42477158	harbor1	chr5	42360185	42360368	DNA/TcMar-Tigger	589	+	92	42360277	83119
chr5	143816291	144016291	harbor1	chr5	143894679	143895596	DNA/TcMar-Tigger	5795	+	458	143895137	78846
chr5	144083314	144283314	harbor1	chr5	144157942	144158295	DNA/TcMar-Tigger	594	+	176	144158118	74804
chr5	69485737	69685737	harbor1	chr5	69565515	69565828	DNA/TcMar-Tigger	1874	+	156	69565671	79934
chr5	69485737	69685737	harbor1	chr5	69573798	69574217	DNA/TcMar-Tigger	1868	+	210	69574008	88271
chr5	69485737	69685737	harbor1	chr5	69574218	69574827	DNA/TcMar-Tigger	9330	+	304	69574522	88785
chr5	69485737	69685737	harbor1	chr5	69575135	69575418	DNA/TcMar-Tigger	9330	+	142	69575277	89540
chr5	69485737	69685737	harbor1	chr5	69575718	69575817	DNA/TcMar-Tigger	9330	+	50	69575768	90031
chr5	69485737	69685737	harbor1	chr5	69576122	69576736	DNA/TcMar-Tigger	9330	+	307	69576429	90692
chr5	69485737	69685737	harbor1	chr5	69577040	69577415	DNA/TcMar-Tigger	2483	+	188	69577228	91491
chr5	69485737	69685737	harbor1	chr5	69577689	69577822	DNA/TcMar-Tigger	2483	+	66	69577755	92018
chr5	69485737	69685737	harbor1	chr5	69577812	69577842	DNA/TcMar-Tigger	737	+	15	69577827	92090
chr5	69485737	69685737	harbor1	chr5	69577843	69578159	DNA/TcMar-Tigger	1700	+	158	69578001	92264
chr5	69485737	69685737	harbor1	chr5	69578160	69578245	DNA/TcMar-Tigger	737	+	42	69578202	92465
chr5	19031826	19231826	harbor1	chr5	19064524	19065067	DNA/TcMar-Tigger	2880	+	272	19064796	32970
chr5	19031826	19231826	harbor1	chr5	19096967	19097034	DNA/TcMar-Tigger	13564	+	34	19097001	65175
chr5	19031826	19231826	harbor1	chr5	19097348	19099672	DNA/TcMar-Tigger	13564	+	1162	19098510	66684
chr5	121653930	121853930	harbor1	chr5	121717780	121718039	DNA/TcMar-Tigger	613	+	130	121717910	63980
chr5	121653930	121853930	harbor1	chr5	121730720	121731062	DNA/TcMar-Tigger	2031	+	171	121730891	76961
chr5	167474443	167674443	harbor1	chr5	167563615	167564001	DNA/TcMar-Tigger	1944	+	193	167563808	89365
chr5	128832174	129032174	harbor1	chr5	128831739	128832792	DNA/TcMar-Tigger	7203	+	526	128832265	91
chr5	128832174	129032174	harbor1	chr5	128833133	128833306	DNA/TcMar-Tigger	5693	+	86	128833219	1045
chr5	115531756	115731756	harbor1	chr5	115577354	115577425	DNA/TcMar-Tigger	486	+	36	115577390	45634
chr5	17635028	17835028	harbor1	chr5	17684344	17684945	DNA/TcMar-Tigger	2865	+	300	17684644	49616
chr5	17635028	17835028	harbor1	chr5	17713296	17714064	DNA/TcMar-Tigger	3783	+	384	17713680	78652
chr5	17635028	17835028	harbor1	chr5	17716069	17716188	DNA/TcMar-Tigger	561	+	60	17716129	81101
chr5	32051944	32251944	harbor1	chr5	32136648	32136854	DNA/TcMar-Tigger	1103	+	103	32136751	84807
chr5	32051944	32251944	harbor1	chr5	32139219	32139421	DNA/TcMar-Tigger	1305	+	101	32139320	87376
chr5	37872064	38072064	harbor1	chr5	37873913	37874318	DNA/TcMar-Tigger	765	+	202	37874115	2051
chr5	37872064	38072064	harbor1	chr5	37955832	37956455	DNA/TcMar-Tigger	6797	+	312	37956144	84080
chr5	37872064	38072064	harbor1	chr5	37956751	37957320	DNA/TcMar-Tigger	6797	+	284	37957035	84971
chr5	145621028	145821028	harbor1	chr5	145648880	145649015	DNA/TcMar-Tigger	668	+	68	145648948	27920
chr5	145621028	145821028	harbor1	chr5	145649016	145649337	DNA/TcMar-Tigger	920	+	160	145649176	28148
chr5	145621028	145821028	harbor1	chr5	145649338	145649573	DNA/TcMar-Tigger	1407	+	118	145649456	28428
chr5	145857003	146057003	harbor1	chr5	145944082	145944311	DNA/TcMar-Tigger	1359	+	114	145944196	87193
chr5	65171456	65371456	harbor1	chr5	65183265	65183590	DNA/TcMar-Tigger	1895	+	162	65183427	11971
chr5	65171456	65371456	harbor1	chr5	65194179	65194573	DNA/TcMar-Tigger	2172	+	197	65194376	22920
chr5	118381448	118581448	harbor1	chr5	118418015	118418257	DNA/TcMar-Tigger	1082	+	121	118418136	36688
chr5	63242813	63442813	harbor1	chr5	63261055	63261411	DNA/TcMar-Tigger	3445	+	178	63261233	18420
chr5	63242813	63442813	harbor1	chr5	63261722	63261983	DNA/TcMar-Tigger	3445	+	130	63261852	19039
chr5	63242813	63442813	harbor1	chr5	63333130	63333948	DNA/TcMar-Tigger	4567	+	409	63333539	90726
chr5	63242813	63442813	harbor1	chr5	63337376	63337610	DNA/TcMar-Tigger	1249	+	117	63337493	94680
chr5	13694257	13894257	harbor1	chr5	13752409	13752722	DNA/TcMar-Tigger	1640	+	156	13752565	58308
chr5	13694257	13894257	harbor1	chr5	13791163	13791322	DNA/TcMar-Tigger	456	+	80	13791243	96986
chr5	112236126	112436126	harbor1	chr5	112241574	112241772	DNA/TcMar-Tigger	1053	+	99	112241673	5547
chr5	112236126	112436126	harbor1	chr5	112246210	112246437	DNA/TcMar-Tigger	2145	+	114	112246324	10198
chr5	112236126	112436126	harbor1	chr5	112247021	112247139	DNA/TcMar-Tigger	2145	+	59	112247080	10954
chr5	52930151	53130151	harbor1	chr5	53019281	53019531	DNA/TcMar-Tigger	2534	+	125	53019406	89255
chr5	52930151	53130151	harbor1	chr5	53019826	53020094	DNA/TcMar-Tigger	2534	+	134	53019960	89809
chr5	17685819	17885819	harbor1	chr5	17713296	17714064	DNA/TcMar-Tigger	3783	+	384	17713680	27861
chr5	17685819	17885819	harbor1	chr5	17716069	17716188	DNA/TcMar-Tigger	561	+	60	17716129	30310
chr5	130990269	131190269	harbor1	chr5	131025316	131026376	DNA/TcMar-Tigger	6476	+	530	131025846	35577
chr5	130990269	131190269	harbor1	chr5	131053647	131054008	DNA/TcMar-Tigger	2084	+	180	131053827	63558
chr5	130990269	131190269	harbor1	chr5	131071396	131071886	DNA/TcMar-Tigger	1510	+	245	131071641	81372
chr5	107909962	108109962	harbor1	chr5	107971034	107971627	DNA/TcMar-Tigger	2038	+	296	107971330	61368
chr5	131721269	131921269	harbor1	chr5	131748159	131748411	DNA/TcMar-Tigger	6805	+	126	131748285	27016
chr5	131721269	131921269	harbor1	chr5	131748725	131749384	DNA/TcMar-Tigger	6805	+	330	131749055	27786
chr5	131721269	131921269	harbor1	chr5	131749692	131749981	DNA/TcMar-Tigger	6805	+	144	131749836	28567
chr5	131721269	131921269	harbor1	chr5	131780409	131780460	DNA/TcMar-Tigger	9610	+	26	131780435	59166
chr5	131721269	131921269	harbor1	chr5	131780495	131781875	DNA/TcMar-Tigger	9610	+	690	131781185	59916
chr5	131721269	131921269	harbor1	chr5	131782182	131782266	DNA/TcMar-Tigger	9610	+	42	131782224	60955
chr5	131721269	131921269	harbor1	chr5	131782592	131782839	DNA/TcMar-Tigger	9610	+	124	131782716	61447
chr5	131721269	131921269	harbor1	chr5	131782971	131783160	DNA/TcMar-Tigger	882	+	94	131783065	61796
chr5	131721269	131921269	harbor1	chr5	131792623	131792921	DNA/TcMar-Tigger	1381	+	149	131792772	71503
chr5	116224122	116424122	harbor1	chr5	116233108	116233441	DNA/TcMar-Tigger	1788	+	166	116233274	9152
chr5	116224122	116424122	harbor1	chr5	116248209	116248490	DNA/TcMar-Tigger	540	+	140	116248349	24227
chr5	116224122	116424122	harbor1	chr5	116248808	116249140	DNA/TcMar-Tigger	556	+	166	116248974	24852
chr5	116224122	116424122	harbor1	chr5	116287036	116287236	DNA/TcMar-Tigger	839	+	100	116287136	63014
chr5	149875079	150075079	harbor1	chr5	149877764	149877983	DNA/TcMar-Tigger	1057	+	110	149877874	2795
chr5	24059798	24259798	harbor1	chr5	24098221	24098421	DNA/TcMar-Tigger	876	+	100	24098321	38523
chr5	24059798	24259798	harbor1	chr5	24098422	24098569	DNA/TcMar-Tigger	941	+	74	24098496	38698
chr5	137122856	137322856	harbor1	chr5	137188262	137190643	DNA/TcMar-Tigger	15747	+	1190	137189452	66596
chr5	112647473	112847473	harbor1	chr5	112698525	112698689	DNA/TcMar-Tigger	1025	+	82	112698607	51134
chr5	112647473	112847473	harbor1	chr5	112698690	112699023	DNA/TcMar-Tigger	1764	+	166	112698856	51383
chr5	112647473	112847473	harbor1	chr5	112699024	112699167	DNA/TcMar-Tigger	1025	+	72	112699096	51623
chr5	33107989	33307989	harbor1	chr5	33162971	33163079	DNA/TcMar-Tigger	505	+	54	33163025	55036
chr5	33107989	33307989	harbor1	chr5	33207291	33208334	DNA/TcMar-Tigger	6782	+	522	33207813	99824
chr5	107669862	107869862	harbor1	chr5	107713840	107714011	DNA/TcMar-Tigger	427	+	86	107713926	44064
chr5	14631793	14831793	harbor1	chr5	14649596	14649913	DNA/TcMar-Tigger	1527	+	158	14649754	17961
chr5	14631793	14831793	harbor1	chr5	14682340	14682495	DNA/TcMar-Tigger	1087	+	78	14682418	50625
chr5	32301632	32501632	harbor1	chr5	32372419	32372545	DNA/TcMar-Tigger	627	+	63	32372482	70850
chr5	32301632	32501632	harbor1	chr5	32391257	32391356	DNA/TcMar-Tigger	573	+	50	32391307	89675
chr5	32301632	32501632	harbor1	chr5	32395574	32395959	DNA/TcMar-Tigger	2214	+	192	32395766	94134
chr5	32301632	32501632	harbor1	chr5	32396227	32396288	DNA/TcMar-Tigger	2214	+	30	32396257	94625
chr5	32301632	32501632	harbor1	chr5	32391004	32391259	DNA/TcMar-Tigger	1078	+	128	32391132	89500
chr5	50283460	50483460	harbor1	chr5	50321925	50322479	DNA/TcMar-Tigger	3231	+	277	50322202	38742
chr5	50283460	50483460	harbor1	chr5	50322479	50323711	DNA/TcMar-Tigger	7647	+	616	50323095	39635
chr5	50283460	50483460	harbor1	chr5	50324566	50325049	DNA/TcMar-Tigger	2808	+	242	50324808	41348
chr5	162383375	162583375	harbor1	chr5	162383856	162384066	DNA/TcMar-Tigger	1156	+	105	162383961	586
chr5	162383375	162583375	harbor1	chr5	162417353	162417458	DNA/TcMar-Tigger	515	+	52	162417405	34030
chr5	162383375	162583375	harbor1	chr5	162418837	162419272	DNA/TcMar-Tigger	2529	+	218	162419055	35680
chr5	162383375	162583375	harbor1	chr5	162419266	162419386	DNA/TcMar-Tigger	519	+	60	162419326	35951
chr5	162383375	162583375	harbor1	chr5	162437815	162438116	DNA/TcMar-Tigger	1457	+	150	162437965	54590
chr5	162383375	162583375	harbor1	chr5	162438318	162440446	DNA/TcMar-Tigger	12195	+	1064	162439382	56007
chr5	162383375	162583375	harbor1	chr5	162449489	162449573	DNA/TcMar-Tigger	1844	+	42	162449531	66156
chr5	162383375	162583375	harbor1	chr5	162449901	162450172	DNA/TcMar-Tigger	1844	+	136	162450037	66662
chr5	91003990	91203990	harbor1	chr5	91034186	91034476	DNA/TcMar-Tigger	738	+	145	91034331	30341
chr5	91003990	91203990	harbor1	chr5	91037788	91038118	DNA/TcMar-Tigger	1981	+	165	91037953	33963
chr5	91003990	91203990	harbor1	chr5	91049818	91049917	DNA/TcMar-Tigger	502	+	50	91049868	45878
chr5	91003990	91203990	harbor1	chr5	91051238	91051537	DNA/TcMar-Tigger	1802	+	150	91051388	47398
chr5	75524268	75724268	harbor1	chr5	75582152	75582373	DNA/TcMar-Tigger	451	+	110	75582262	57994
chr5	43382296	43582296	harbor1	chr5	43477960	43478041	DNA/TcMar-Tigger	452	+	40	43478000	95704
chr5	27068287	27268287	harbor1	chr5	27163642	27164265	DNA/TcMar-Tigger	3224	+	312	27163954	95667
chr5	27068287	27268287	harbor1	chr5	27166543	27166825	DNA/TcMar-Tigger	1612	+	141	27166684	98397
chr5	27068287	27268287	harbor1	chr5	27164494	27164767	DNA/TcMar-Tigger	1527	+	136	27164630	96343
chr5	94389696	94589696	harbor1	chr5	94412790	94412956	DNA/TcMar-Tigger	965	+	83	94412873	23177
chr5	94389696	94589696	harbor1	chr5	94413250	94413320	DNA/TcMar-Tigger	965	+	35	94413285	23589
chr6	148689440	148889440	harbor1	chr6	148689887	148690486	DNA/TcMar-Tigger	1987	+	300	148690187	747
chr6	148689440	148889440	harbor1	chr6	148713787	148714126	DNA/TcMar-Tigger	1717	+	170	148713957	24517
chr6	148689440	148889440	harbor1	chr6	148777444	148777548	DNA/TcMar-Tigger	1838	+	52	148777496	88056
chr6	148689440	148889440	harbor1	chr6	148777854	148778093	DNA/TcMar-Tigger	2008	+	120	148777974	88534
chr6	148689440	148889440	harbor1	chr6	148780152	148780280	DNA/TcMar-Tigger	14877	+	64	148780216	90776
chr6	148689440	148889440	harbor1	chr6	148780734	148782454	DNA/TcMar-Tigger	14877	+	860	148781594	92154
chr6	148689440	148889440	harbor1	chr6	148782753	148783358	DNA/TcMar-Tigger	14877	+	302	148783055	93615
chr6	36703408	36903408	harbor1	chr6	36783933	36784169	DNA/TcMar-Tigger	701	+	118	36784051	80643
chr6	89407233	89607233	harbor1	chr6	89445057	89445260	DNA/TcMar-Tigger	3551	+	102	89445159	37926
chr6	89407233	89607233	harbor1	chr6	89445877	89446070	DNA/TcMar-Tigger	3551	+	96	89445973	38740
chr6	89407233	89607233	harbor1	chr6	89446373	89446600	DNA/TcMar-Tigger	3551	+	114	89446487	39254
chr6	89407233	89607233	harbor1	chr6	89447272	89447681	DNA/TcMar-Tigger	8054	+	204	89447476	40243
chr6	89407233	89607233	harbor1	chr6	89447986	89448152	DNA/TcMar-Tigger	8054	+	83	89448069	40836
chr6	89407233	89607233	harbor1	chr6	89448453	89448748	DNA/TcMar-Tigger	8054	+	148	89448601	41368
chr6	89407233	89607233	harbor1	chr6	89449056	89449426	DNA/TcMar-Tigger	8054	+	185	89449241	42008
chr6	89407233	89607233	harbor1	chr6	89449853	89450054	DNA/TcMar-Tigger	3318	+	100	89449953	42720
chr6	89407233	89607233	harbor1	chr6	89450332	89450511	DNA/TcMar-Tigger	3318	+	90	89450422	43189
chr6	89407233	89607233	harbor1	chr6	89450802	89451001	DNA/TcMar-Tigger	3318	+	100	89450902	43669
chr6	89407233	89607233	harbor1	chr6	89481296	89481517	DNA/TcMar-Tigger	1221	+	110	89481406	74173
chr6	89407233	89607233	harbor1	chr6	89486149	89486464	DNA/TcMar-Tigger	1952	+	158	89486307	79074
chr6	8867257	9067257	harbor1	chr6	8947022	8947494	DNA/TcMar-Tigger	608	+	236	8947258	80001
chr6	8867257	9067257	harbor1	chr6	8963062	8963157	DNA/TcMar-Tigger	609	+	48	8963110	95853
chr6	8867257	9067257	harbor1	chr6	8963496	8963658	DNA/TcMar-Tigger	2658	+	81	8963577	96320
chr6	8867257	9067257	harbor1	chr6	8963697	8964037	DNA/TcMar-Tigger	2658	+	170	8963867	96610
chr6	73491115	73691115	harbor1	chr6	73499715	73499938	DNA/TcMar-Tigger	703	+	112	73499827	8712
chr6	15243281	15443281	harbor1	chr6	15251563	15251699	DNA/TcMar-Tigger	493	+	68	15251631	8350
chr6	29529982	29729982	harbor1	chr6	29566123	29566622	DNA/TcMar-Tigger	5558	+	250	29566373	36391
chr6	29529982	29729982	harbor1	chr6	29566924	29567434	DNA/TcMar-Tigger	5558	+	255	29567179	37197
chr6	29529982	29729982	harbor1	chr6	29595305	29595441	DNA/TcMar-Tigger	5634	+	68	29595373	65391
chr6	29529982	29729982	harbor1	chr6	29595699	29595717	DNA/TcMar-Tigger	5634	+	9	29595708	65726
chr6	29529982	29729982	harbor1	chr6	29596852	29596928	DNA/TcMar-Tigger	5634	+	38	29596890	66908
chr6	29529982	29729982	harbor1	chr6	29597193	29597971	DNA/TcMar-Tigger	5634	+	389	29597582	67600
chr6	153930576	154130576	harbor1	chr6	153993747	153994776	DNA/TcMar-Tigger	5034	+	514	153994261	63685
chr6	150209265	150409265	harbor1	chr6	150212658	150212938	DNA/TcMar-Tigger	1678	+	140	150212798	3533
chr6	135973440	136173440	harbor1	chr6	136016894	136017117	DNA/TcMar-Tigger	455	+	112	136017006	43566
chr6	96030095	96230095	harbor1	chr6	96056839	96057176	DNA/TcMar-Tigger	1665	+	168	96057007	26912
chr6	96030095	96230095	harbor1	chr6	96094105	96094557	DNA/TcMar-Tigger	2307	+	226	96094331	64236
chr6	96030095	96230095	harbor1	chr6	96094557	96094646	DNA/TcMar-Tigger	495	+	44	96094601	64506
chr6	96030095	96230095	harbor1	chr6	96118342	96119510	DNA/TcMar-Tigger	6804	+	584	96118926	88831
chr6	153428299	153628299	harbor1	chr6	153484355	153484773	DNA/TcMar-Tigger	1896	+	209	153484564	56265
chr6	153428299	153628299	harbor1	chr6	153496417	153498691	DNA/TcMar-Tigger	13678	+	1137	153497554	69255
chr6	160738745	160938745	harbor1	chr6	160760138	160760288	DNA/TcMar-Tigger	855	+	75	160760213	21468
chr6	160738745	160938745	harbor1	chr6	160760679	160760722	DNA/TcMar-Tigger	855	+	22	160760701	21956
chr6	131788799	131988799	harbor1	chr6	131844198	131845043	DNA/TcMar-Tigger	4667	+	422	131844620	55821
chr6	131788799	131988799	harbor1	chr6	131845331	131845440	DNA/TcMar-Tigger	4667	+	54	131845385	56586
chr6	7224375	7424375	harbor1	chr6	7320219	7320433	DNA/TcMar-Tigger	1072	+	107	7320326	95951
chr6	7224375	7424375	harbor1	chr6	7320726	7320822	DNA/TcMar-Tigger	1072	+	48	7320774	96399
chr6	152968030	153168030	harbor1	chr6	152974607	152974814	DNA/TcMar-Tigger	1027	+	104	152974711	6681
chr6	152968030	153168030	harbor1	chr6	153013035	153014516	DNA/TcMar-Tigger	15061	+	740	153013775	45745
chr6	152968030	153168030	harbor1	chr6	153014818	153015657	DNA/TcMar-Tigger	15061	+	420	153015238	47208
chr6	152968030	153168030	harbor1	chr6	153015953	153016066	DNA/TcMar-Tigger	15061	+	56	153016009	47979
chr6	98276776	98476776	harbor1	chr6	98292559	98292694	DNA/TcMar-Tigger	511	+	68	98292627	15851
chr6	110637617	110837617	harbor1	chr6	110659444	110659849	DNA/TcMar-Tigger	538	+	202	110659646	22029
chr6	110637617	110837617	harbor1	chr6	110673937	110674620	DNA/TcMar-Tigger	14362	+	342	110674279	36662
chr6	110637617	110837617	harbor1	chr6	110674924	110675345	DNA/TcMar-Tigger	14362	+	210	110675134	37517
chr6	110637617	110837617	harbor1	chr6	110675653	110676898	DNA/TcMar-Tigger	14362	+	622	110676275	38658
chr6	25022521	25222521	harbor1	chr6	25055229	25055299	DNA/TcMar-Tigger	1222	+	35	25055264	32743
chr6	25022521	25222521	harbor1	chr6	25055601	25055850	DNA/TcMar-Tigger	1222	+	124	25055725	33204
chr6	25022521	25222521	harbor1	chr6	25115428	25115770	DNA/TcMar-Tigger	1764	+	171	25115599	93078
chr6	62461566	62661566	harbor1	chr6	62479290	62479465	DNA/TcMar-Tigger	1011	+	88	62479378	17812
chr6	117895445	118095445	harbor1	chr6	117957603	117958796	DNA/TcMar-Tigger	7478	+	596	117958199	62754
chr6	161082136	161282136	harbor1	chr6	161179568	161179946	DNA/TcMar-Tigger	2372	+	189	161179757	97621
chr6	113165636	113365636	harbor1	chr6	113211291	113211530	DNA/TcMar-Tigger	467	+	120	113211411	45775
chr6	113165636	113365636	harbor1	chr6	113218136	113218407	DNA/TcMar-Tigger	463	+	136	113218272	52636
chr6	6379237	6579237	harbor1	chr6	6407427	6408484	DNA/TcMar-Tigger	4680	+	528	6407955	28718
chr6	6379237	6579237	harbor1	chr6	6408652	6408999	DNA/TcMar-Tigger	2087	+	174	6408826	29589
chr6	6379237	6579237	harbor1	chr6	6455945	6458324	DNA/TcMar-Tigger	15957	+	1190	6457135	77898
chr6	163648038	163848038	harbor1	chr6	163684673	163684975	DNA/TcMar-Tigger	1003	+	151	163684824	36786
chr6	163648038	163848038	harbor1	chr6	163685037	163685200	DNA/TcMar-Tigger	415	+	82	163685119	37081
chr6	73413880	73613880	harbor1	chr6	73434253	73434326	DNA/TcMar-Tigger	428	+	36	73434289	20409
chr6	73413880	73613880	harbor1	chr6	73499715	73499938	DNA/TcMar-Tigger	703	+	112	73499827	85947
chr6	80477025	80677025	harbor1	chr6	80491891	80492259	DNA/TcMar-Tigger	1790	+	184	80492075	15050
chr6	80477025	80677025	harbor1	chr6	80501345	80501355	DNA/TcMar-Tigger	13276	+	5	80501350	24325
chr6	80477025	80677025	harbor1	chr6	80501653	80503880	DNA/TcMar-Tigger	13276	+	1114	80502767	25742
chr6	80477025	80677025	harbor1	chr6	80551818	80552091	DNA/TcMar-Tigger	1506	+	136	80551954	74929
chr6	80477025	80677025	harbor1	chr6	80552438	80552531	DNA/TcMar-Tigger	1506	+	46	80552484	75459
chr6	108788723	108988723	harbor1	chr6	108802208	108802418	DNA/TcMar-Tigger	1285	+	105	108802313	13590
chr6	108788723	108988723	harbor1	chr6	108878524	108878857	DNA/TcMar-Tigger	433	+	166	108878690	89967
chr6	158230624	158430624	harbor1	chr6	158263172	158263583	DNA/TcMar-Tigger	982	+	206	158263378	32754
chr6	158230624	158430624	harbor1	chr6	158266657	158266846	DNA/TcMar-Tigger	907	+	94	158266751	36127
chr6	158230624	158430624	harbor1	chr6	158318687	158318721	DNA/TcMar-Tigger	682	+	17	158318704	88080
chr6	158230624	158430624	harbor1	chr6	158319045	158319321	DNA/TcMar-Tigger	682	+	138	158319183	88559
chr6	158230624	158430624	harbor1	chr6	158323813	158324008	DNA/TcMar-Tigger	822	+	98	158323911	93287
chr6	158230624	158430624	harbor1	chr6	158326812	158327051	DNA/TcMar-Tigger	956	+	120	158326932	96308
chr6	165141769	165341769	harbor1	chr6	165208463	165209255	DNA/TcMar-Tigger	3769	+	396	165208859	67090
chr6	71573459	71773459	harbor1	chr6	71669471	71670719	DNA/TcMar-Tigger	7344	+	624	71670095	96636
chr6	71573459	71773459	harbor1	chr6	71670728	71671485	DNA/TcMar-Tigger	4512	+	378	71671106	97647
chr6	88558850	88758850	harbor1	chr6	88648961	88649154	DNA/TcMar-Tigger	1112	+	96	88649057	90207
chr6	57448002	57648002	harbor1	chr6	57541391	57541647	DNA/TcMar-Tigger	1062	+	128	57541519	93517
chr6	57448002	57648002	harbor1	chr6	57540436	57541251	DNA/TcMar-Tigger	4942	+	408	57540844	92842
chr6	117523503	117723503	harbor1	chr6	117523285	117523620	DNA/TcMar-Tigger	557	+	168	117523453	50
chr6	152454466	152654466	harbor1	chr6	152490031	152490326	DNA/TcMar-Tigger	1167	+	148	152490179	35713
chr6	152454466	152654466	harbor1	chr6	152530496	152530623	DNA/TcMar-Tigger	3485	+	64	152530560	76094
chr6	152454466	152654466	harbor1	chr6	152530923	152531463	DNA/TcMar-Tigger	3485	+	270	152531193	76727
chr6	152454466	152654466	harbor1	chr6	152543627	152544015	DNA/TcMar-Tigger	1640	+	194	152543821	89355
chr6	152454466	152654466	harbor1	chr6	152550643	152550894	DNA/TcMar-Tigger	1144	+	126	152550769	96303
chr6	50922904	51122904	harbor1	chr6	50948561	50949416	DNA/TcMar-Tigger	13807	+	428	50948989	26085
chr6	50922904	51122904	harbor1	chr6	50949727	50950983	DNA/TcMar-Tigger	13807	+	628	50950355	27451
chr6	81785581	81985581	harbor1	chr6	81862133	81862395	DNA/TcMar-Tigger	1369	+	131	81862264	76683
chr6	81785581	81985581	harbor1	chr6	81862396	81862498	DNA/TcMar-Tigger	482	+	51	81862447	76866
chr6	161034486	161234486	harbor1	chr6	161036770	161036968	DNA/TcMar-Tigger	973	+	99	161036869	2383
chr6	60875370	61075370	harbor1	chr6	60875908	60876054	DNA/TcMar-Tigger	801	+	73	60875981	611
chr6	60875370	61075370	harbor1	chr6	60876179	60876688	DNA/TcMar-Tigger	4474	+	254	60876433	1063
chr6	60875370	61075370	harbor1	chr6	60876993	60877221	DNA/TcMar-Tigger	4474	+	114	60877107	1737
chr6	60875370	61075370	harbor1	chr6	60937110	60937779	DNA/TcMar-Tigger	2749	+	334	60937444	62074
chr6	98759920	98959920	harbor1	chr6	98759625	98761835	DNA/TcMar-Tigger	14265	+	1105	98760730	810
chr6	98759920	98959920	harbor1	chr6	98762004	98762094	DNA/TcMar-Tigger	1079	+	45	98762049	2129
chr6	98759920	98959920	harbor1	chr6	98762387	98762506	DNA/TcMar-Tigger	1079	+	60	98762447	2527
chr6	109462889	109662889	harbor1	chr6	109485608	109485782	DNA/TcMar-Tigger	2989	+	87	109485695	22806
chr6	109462889	109662889	harbor1	chr6	109486091	109486362	DNA/TcMar-Tigger	2989	+	136	109486227	23338
chr6	109462889	109662889	harbor1	chr6	109561951	109562163	DNA/TcMar-Tigger	1170	+	106	109562057	99168
chr6	140403	340403	harbor1	chr6	165265	165455	DNA/TcMar-Tigger	648	+	95	165360	24957
chr6	140403	340403	harbor1	chr6	185740	186009	DNA/TcMar-Tigger	768	+	134	185874	45471
chr6	140403	340403	harbor1	chr6	207053	207273	DNA/TcMar-Tigger	1104	+	110	207163	66760
chr6	167063438	167263438	harbor1	chr6	167113089	167113495	DNA/TcMar-Tigger	934	+	203	167113292	49854
chr6	113974501	114174501	harbor1	chr6	114050338	114051552	DNA/TcMar-Tigger	7644	+	607	114050945	76444
chr6	123235712	123435712	harbor1	chr6	123262567	123265015	DNA/TcMar-Tigger	12964	+	1224	123263791	28079
chr6	123235712	123435712	harbor1	chr6	123309621	123311046	DNA/TcMar-Tigger	14907	+	712	123310333	74621
chr6	123235712	123435712	harbor1	chr6	123311416	123312669	DNA/TcMar-Tigger	14907	+	626	123312042	76330
chr6	45111403	45311403	harbor1	chr6	45148368	45148917	DNA/TcMar-Tigger	2340	+	274	45148642	37239
chr6	45111403	45311403	harbor1	chr6	45163913	45164117	DNA/TcMar-Tigger	1181	+	102	45164015	52612
chr6	45111403	45311403	harbor1	chr6	45164371	45164464	DNA/TcMar-Tigger	515	+	46	45164417	53014
chr6	45111403	45311403	harbor1	chr6	45187854	45188573	DNA/TcMar-Tigger	4129	+	360	45188214	76811
chr6	45111403	45311403	harbor1	chr6	45207569	45208444	DNA/TcMar-Tigger	13224	+	438	45208007	96604
chr6	45111403	45311403	harbor1	chr6	45208750	45210122	DNA/TcMar-Tigger	13224	+	686	45209436	98033
chr6	45111403	45311403	harbor1	chr6	45210742	45210869	DNA/TcMar-Tigger	13224	+	64	45210806	99403
chr6	5624982	5824982	harbor1	chr6	5654740	5655173	DNA/TcMar-Tigger	2416	+	216	5654956	29974
chr6	25548072	25748072	harbor1	chr6	25587915	25588230	DNA/TcMar-Tigger	1296	+	158	25588073	40001
chr6	25548072	25748072	harbor1	chr6	25608182	25608490	DNA/TcMar-Tigger	1540	+	154	25608336	60264
chr6	82976216	83176216	harbor1	chr6	82981547	82981770	DNA/TcMar-Tigger	459	+	112	82981659	5443
chr6	82976216	83176216	harbor1	chr6	83074448	83074714	DNA/TcMar-Tigger	1520	+	133	83074581	98365
chr6	453657	653657	harbor1	chr6	496975	497361	DNA/TcMar-Tigger	1055	+	193	497168	43511
chr6	453657	653657	harbor1	chr6	512220	512633	DNA/TcMar-Tigger	1985	+	206	512426	58769
chr6	453657	653657	harbor1	chr6	530759	531057	DNA/TcMar-Tigger	1701	+	149	530908	77251
chr6	453657	653657	harbor1	chr6	538655	538731	DNA/TcMar-Tigger	432	+	38	538693	85036
chr6	453657	653657	harbor1	chr6	546496	546928	DNA/TcMar-Tigger	2432	+	216	546712	93055
chr6	30123827	30323827	harbor1	chr6	30135451	30135554	DNA/TcMar-Tigger	446	+	52	30135503	11676
chr6	24247705	24447705	harbor1	chr6	24347397	24347709	DNA/TcMar-Tigger	1260	+	156	24347553	99848
chr6	138798632	138998632	harbor1	chr6	138834013	138834310	DNA/TcMar-Tigger	569	+	148	138834161	35529
chr6	138798632	138998632	harbor1	chr6	138897363	138897520	DNA/TcMar-Tigger	704	+	78	138897441	98809
chr6	7229988	7429988	harbor1	chr6	7320219	7320433	DNA/TcMar-Tigger	1072	+	107	7320326	90338
chr6	7229988	7429988	harbor1	chr6	7320726	7320822	DNA/TcMar-Tigger	1072	+	48	7320774	90786
chr6	125933489	126133489	harbor1	chr6	126008537	126008734	DNA/TcMar-Tigger	1182	+	98	126008635	75146
chr6	125933489	126133489	harbor1	chr6	126008754	126008862	DNA/TcMar-Tigger	717	+	54	126008808	75319
chr6	125933489	126133489	harbor1	chr6	126017908	126018082	DNA/TcMar-Tigger	692	+	87	126017995	84506
chr6	125933489	126133489	harbor1	chr6	126018150	126018463	DNA/TcMar-Tigger	692	+	156	126018306	84817
chr6	125933489	126133489	harbor1	chr6	126019804	126020820	DNA/TcMar-Tigger	2244	+	508	126020312	86823
chr6	125933489	126133489	harbor1	chr6	126023282	126023367	DNA/TcMar-Tigger	1110	+	42	126023324	89835
chr6	125933489	126133489	harbor1	chr6	126023676	126024044	DNA/TcMar-Tigger	1110	+	184	126023860	90371
chr6	107600402	107800402	harbor1	chr6	107650353	107650980	DNA/TcMar-Tigger	16517	+	314	107650667	50265
chr6	107600402	107800402	harbor1	chr6	107651284	107653071	DNA/TcMar-Tigger	16517	+	894	107652178	51776
chr6	24052026	24252026	harbor1	chr6	24125570	24125895	DNA/TcMar-Tigger	1847	+	162	24125732	73706
chr6	83311936	83511936	harbor1	chr6	83314250	83314336	DNA/TcMar-Tigger	634	+	43	83314293	2357
chr6	83311936	83511936	harbor1	chr6	83314334	83314745	DNA/TcMar-Tigger	2279	+	206	83314540	2604
chr6	135902251	136102251	harbor1	chr6	135912215	135912536	DNA/TcMar-Tigger	1486	+	160	135912375	10124
chr6	135902251	136102251	harbor1	chr6	135922085	135922537	DNA/TcMar-Tigger	567	+	226	135922311	20060
chr6	85001241	85201241	harbor1	chr6	85025757	85026493	DNA/TcMar-Tigger	4883	+	368	85026125	24884
chr6	85001241	85201241	harbor1	chr6	85026474	85026771	DNA/TcMar-Tigger	1838	+	148	85026622	25381
chr6	85001241	85201241	harbor1	chr6	85079493	85079625	DNA/TcMar-Tigger	2224	+	66	85079559	78318
chr6	85001241	85201241	harbor1	chr6	85079916	85080273	DNA/TcMar-Tigger	2224	+	178	85080094	78853
chr6	70568469	70768469	harbor1	chr6	70618593	70618824	DNA/TcMar-Tigger	11512	+	116	70618709	50240
chr6	70568469	70768469	harbor1	chr6	70619110	70620231	DNA/TcMar-Tigger	11512	+	560	70619670	51201
chr6	70568469	70768469	harbor1	chr6	70620486	70620954	DNA/TcMar-Tigger	11512	+	234	70620720	52251
chr6	134023350	134223350	harbor1	chr6	134032026	134032254	DNA/TcMar-Tigger	527	+	114	134032140	8790
chr6	134023350	134223350	harbor1	chr6	134120513	134120676	DNA/TcMar-Tigger	6797	+	82	134120595	97245
chr6	134023350	134223350	harbor1	chr6	134120972	134121217	DNA/TcMar-Tigger	6797	+	122	134121094	97744
chr6	134023350	134223350	harbor1	chr6	134121525	134121900	DNA/TcMar-Tigger	6797	+	188	134121713	98363
chr6	134023350	134223350	harbor1	chr6	134122545	134123010	DNA/TcMar-Tigger	6797	+	232	134122777	99427
chr6	132818469	133018469	harbor1	chr6	132847618	132847946	DNA/TcMar-Tigger	1029	+	164	132847782	29313
chr6	5304745	5504745	harbor1	chr6	5342150	5342408	DNA/TcMar-Tigger	528	+	129	5342279	37534
chr6	5304745	5504745	harbor1	chr6	5355874	5356166	DNA/TcMar-Tigger	3030	+	146	5356020	51275
chr6	5304745	5504745	harbor1	chr6	5356504	5356832	DNA/TcMar-Tigger	3030	+	164	5356668	51923
chr6	5304745	5504745	harbor1	chr6	5394242	5394537	DNA/TcMar-Tigger	1344	+	148	5394390	89645
chr6	80418666	80618666	harbor1	chr6	80491891	80492259	DNA/TcMar-Tigger	1790	+	184	80492075	73409
chr6	80418666	80618666	harbor1	chr6	80501345	80501355	DNA/TcMar-Tigger	13276	+	5	80501350	82684
chr6	80418666	80618666	harbor1	chr6	80501653	80503880	DNA/TcMar-Tigger	13276	+	1114	80502767	84101
chr6	144538617	144738617	harbor1	chr6	144560734	144560964	DNA/TcMar-Tigger	576	+	115	144560849	22232
chr6	144538617	144738617	harbor1	chr6	144575485	144575790	DNA/TcMar-Tigger	1541	+	152	144575637	37020
chr6	144538617	144738617	harbor1	chr6	144599795	144601999	DNA/TcMar-Tigger	13377	+	1102	144600897	62280
chr6	144538617	144738617	harbor1	chr6	144602878	144603019	DNA/TcMar-Tigger	876	+	70	144602948	64331
chr6	117765525	117965525	harbor1	chr6	117824335	117824917	DNA/TcMar-Tigger	3345	+	291	117824626	59101
chr6	117765525	117965525	harbor1	chr6	117825353	117826381	DNA/TcMar-Tigger	6029	+	514	117825867	60342
chr6	624018	824018	harbor1	chr6	652798	654517	DNA/TcMar-Tigger	13894	+	860	653658	29640
chr6	624018	824018	harbor1	chr6	691268	691336	DNA/TcMar-Tigger	415	+	34	691302	67284
chr6	624018	824018	harbor1	chr6	691326	691730	DNA/TcMar-Tigger	2207	+	202	691528	67510
chr6	624018	824018	harbor1	chr6	654834	655496	DNA/TcMar-Tigger	13894	+	331	655165	31147
chr6	38756841	38956841	harbor1	chr6	38828377	38828707	DNA/TcMar-Tigger	2065	+	165	38828542	71701
chr6	87126938	87326938	harbor1	chr6	87193143	87193265	DNA/TcMar-Tigger	1308	+	61	87193204	66266
chr6	87126938	87326938	harbor1	chr6	87193557	87193700	DNA/TcMar-Tigger	1308	+	72	87193629	66691
chr6	87126938	87326938	harbor1	chr6	87193685	87193916	DNA/TcMar-Tigger	1382	+	116	87193801	66863
chr6	87126938	87326938	harbor1	chr6	87202744	87203047	DNA/TcMar-Tigger	1424	+	152	87202896	75958
chr6	72960915	73160915	harbor1	chr6	72964677	72964940	DNA/TcMar-Tigger	840	+	132	72964809	3894
chr6	72960915	73160915	harbor1	chr6	72965100	72965492	DNA/TcMar-Tigger	2034	+	196	72965296	4381
chr6	72960915	73160915	harbor1	chr6	73019215	73019396	DNA/TcMar-Tigger	675	+	90	73019305	58390
chr6	102727206	102927206	harbor1	chr6	102815247	102815730	DNA/TcMar-Tigger	3330	+	242	102815489	88283
chr6	102727206	102927206	harbor1	chr6	102816093	102816295	DNA/TcMar-Tigger	3330	+	101	102816194	88988
chr6	124139224	124339224	harbor1	chr6	124216312	124216967	DNA/TcMar-Tigger	2251	+	328	124216640	77416
chr6	79479490	79679490	harbor1	chr6	79549385	79549634	DNA/TcMar-Tigger	1486	+	124	79549509	70019
chr6	150923271	151123271	harbor1	chr6	150938821	150939146	DNA/TcMar-Tigger	901	+	162	150938983	15712
chr6	150923271	151123271	harbor1	chr6	150998511	150998694	DNA/TcMar-Tigger	1826	+	92	150998603	75332
chr6	150923271	151123271	harbor1	chr6	150998997	150999176	DNA/TcMar-Tigger	1826	+	90	150999087	75816
chr6	3909859	4109859	harbor1	chr6	3935031	3935137	DNA/TcMar-Tigger	416	+	53	3935084	25225
chr6	3909859	4109859	harbor1	chr6	3935129	3935323	DNA/TcMar-Tigger	976	+	97	3935226	25367
chr6	67565228	67765228	harbor1	chr6	67646103	67648242	DNA/TcMar-Tigger	12737	+	1070	67647173	81945
chr6	67565228	67765228	harbor1	chr6	67648598	67648776	DNA/TcMar-Tigger	12737	+	89	67648687	83459
chr6	154531721	154731721	harbor1	chr6	154538549	154539219	DNA/TcMar-Tigger	1381	+	335	154538884	7163
chr6	157849752	158049752	harbor1	chr6	157881025	157883369	DNA/TcMar-Tigger	16338	+	1172	157882197	32445
chr6	60935073	61135073	harbor1	chr6	60937110	60937779	DNA/TcMar-Tigger	2749	+	334	60937444	2371
chr6	38459905	38659905	harbor1	chr6	38501204	38501431	DNA/TcMar-Tigger	1420	+	114	38501318	41413
chr6	38459905	38659905	harbor1	chr6	38544044	38544339	DNA/TcMar-Tigger	1258	+	148	38544192	84287
chr6	38459905	38659905	harbor1	chr6	38546450	38546659	DNA/TcMar-Tigger	2409	+	104	38546554	86649
chr6	38459905	38659905	harbor1	chr6	38546967	38547237	DNA/TcMar-Tigger	2409	+	135	38547102	87197
chr6	51677616	51877616	harbor1	chr6	51717096	51717141	DNA/TcMar-Tigger	1677	+	22	51717118	39502
chr6	51677616	51877616	harbor1	chr6	51717427	51717736	DNA/TcMar-Tigger	1677	+	154	51717581	39965
chr6	51677616	51877616	harbor1	chr6	51734622	51734988	DNA/TcMar-Tigger	1494	+	183	51734805	57189
chr6	79664104	79864104	harbor1	chr6	79672616	79672715	DNA/TcMar-Tigger	621	+	50	79672666	8562
chr6	79664104	79864104	harbor1	chr6	79725933	79726158	DNA/TcMar-Tigger	1333	+	112	79726045	61941
chr6	73764002	73964002	harbor1	chr6	73809550	73809762	DNA/TcMar-Tigger	742	+	106	73809656	45654
chr6	81385411	81585411	harbor1	chr6	81395767	81398100	DNA/TcMar-Tigger	13361	+	1166	81396933	11522
chr6	81385411	81585411	harbor1	chr6	81410626	81410952	DNA/TcMar-Tigger	1430	+	163	81410789	25378
chr6	81385411	81585411	harbor1	chr6	81417783	81418266	DNA/TcMar-Tigger	1075	+	242	81418025	32614
chr6	81385411	81585411	harbor1	chr6	81448085	81448337	DNA/TcMar-Tigger	494	+	126	81448211	62800
chr6	81385411	81585411	harbor1	chr6	81448650	81448679	DNA/TcMar-Tigger	494	+	14	81448664	63253
chr6	19972286	20172286	harbor1	chr6	20071782	20072042	DNA/TcMar-Tigger	1575	+	130	20071912	99626
chr6	19972286	20172286	harbor1	chr6	20072046	20072143	DNA/TcMar-Tigger	594	+	48	20072094	99808
chr6	134979173	135179173	harbor1	chr6	134985558	134985790	DNA/TcMar-Tigger	1472	+	116	134985674	6501
chr6	134979173	135179173	harbor1	chr6	134992251	134992522	DNA/TcMar-Tigger	1645	+	136	134992387	13214
chr6	134979173	135179173	harbor1	chr6	134992533	134993245	DNA/TcMar-Tigger	4070	+	356	134992889	13716
chr6	134979173	135179173	harbor1	chr6	135005217	135005545	DNA/TcMar-Tigger	1001	+	164	135005381	26208
chr6	134979173	135179173	harbor1	chr6	135013737	135014055	DNA/TcMar-Tigger	725	+	159	135013896	34723
chr6	134979173	135179173	harbor1	chr6	135030790	135031411	DNA/TcMar-Tigger	3028	+	310	135031100	51927
chr6	134979173	135179173	harbor1	chr6	135043109	135043398	DNA/TcMar-Tigger	475	+	144	135043253	64080
chr6	133830762	134030762	harbor1	chr6	133915217	133915485	DNA/TcMar-Tigger	894	+	134	133915351	84589
chr6	133830762	134030762	harbor1	chr6	133918027	133918352	DNA/TcMar-Tigger	1779	+	162	133918189	87427
chr6	24462613	24662613	harbor1	chr6	24477151	24477437	DNA/TcMar-Tigger	746	+	143	24477294	14681
chr6	24462613	24662613	harbor1	chr6	24477760	24477914	DNA/TcMar-Tigger	746	+	77	24477837	15224
chr6	116222704	116422704	harbor1	chr6	116240229	116240528	DNA/TcMar-Tigger	1145	+	150	116240379	17675
chr6	116222704	116422704	harbor1	chr6	116266881	116267689	DNA/TcMar-Tigger	6954	+	404	116267285	44581
chr6	116222704	116422704	harbor1	chr6	116268047	116268478	DNA/TcMar-Tigger	6954	+	216	116268263	45559
chr6	71821092	72021092	harbor1	chr6	71919989	71920214	DNA/TcMar-Tigger	444	+	112	71920101	99009
chr6	17775647	17975647	harbor1	chr6	17866956	17867361	DNA/TcMar-Tigger	1120	+	202	17867158	91511
chr6	44752213	44952213	harbor1	chr6	44771757	44772060	DNA/TcMar-Tigger	594	+	152	44771909	19696
chr6	143240959	143440959	harbor1	chr6	143241719	143242038	DNA/TcMar-Tigger	1744	+	160	143241879	920
chr6	90455076	90655076	harbor1	chr6	90495862	90496012	DNA/TcMar-Tigger	611	+	75	90495937	40861
chr6	90455076	90655076	harbor1	chr6	90496009	90496275	DNA/TcMar-Tigger	1392	+	133	90496142	41066
chr6	108006476	108206476	harbor1	chr6	108099426	108099723	DNA/TcMar-Tigger	1803	+	148	108099574	93098
chr6	30666475	30866475	harbor1	chr6	30725538	30725762	DNA/TcMar-Tigger	917	+	112	30725650	59175
chr6	153623845	153823845	harbor1	chr6	153633594	153633800	DNA/TcMar-Tigger	1207	+	103	153633697	9852
chr6	153623845	153823845	harbor1	chr6	153647070	153647375	DNA/TcMar-Tigger	1539	+	152	153647222	23377
chr6	153623845	153823845	harbor1	chr6	153654353	153654461	DNA/TcMar-Tigger	1166	+	54	153654407	30562
chr6	153623845	153823845	harbor1	chr6	153654741	153654971	DNA/TcMar-Tigger	1166	+	115	153654856	31011
chr6	153623845	153823845	harbor1	chr6	153678243	153678521	DNA/TcMar-Tigger	1527	+	139	153678382	54537
chr6	131760859	131960859	harbor1	chr6	131844198	131845043	DNA/TcMar-Tigger	4667	+	422	131844620	83761
chr6	131760859	131960859	harbor1	chr6	131845331	131845440	DNA/TcMar-Tigger	4667	+	54	131845385	84526
chr6	70051944	70251944	harbor1	chr6	70090225	70090563	DNA/TcMar-Tigger	1794	+	169	70090394	38450
chr6	70051944	70251944	harbor1	chr6	70099253	70099609	DNA/TcMar-Tigger	2317	+	178	70099431	47487
chr6	55954141	56154141	harbor1	chr6	55978903	55979191	DNA/TcMar-Tigger	941	+	144	55979047	24906
chr6	55954141	56154141	harbor1	chr6	56051416	56051761	DNA/TcMar-Tigger	1629	+	172	56051588	97447
chr6	20769308	20969308	harbor1	chr6	20866993	20867294	DNA/TcMar-Tigger	475	+	150	20867143	97835
chr6	8255098	8455098	harbor1	chr6	8307408	8307640	DNA/TcMar-Tigger	1249	+	116	8307524	52426
chr6	19440348	19640348	harbor1	chr6	19493517	19493837	DNA/TcMar-Tigger	1400	+	160	19493677	53329
chr6	19440348	19640348	harbor1	chr6	19512009	19512198	DNA/TcMar-Tigger	910	+	94	19512103	71755
chr6	19440348	19640348	harbor1	chr6	19512425	19512645	DNA/TcMar-Tigger	1281	+	110	19512535	72187
chr6	19440348	19640348	harbor1	chr6	19533236	19533575	DNA/TcMar-Tigger	1671	+	170	19533406	93058
chr6	19440348	19640348	harbor1	chr6	19513292	19513520	DNA/TcMar-Tigger	1110	+	114	19513406	73058
chr6	60410334	60610334	harbor1	chr6	60433305	60434120	DNA/TcMar-Tigger	4942	+	408	60433713	23379
chr6	60410334	60610334	harbor1	chr6	60434260	60434517	DNA/TcMar-Tigger	1040	+	128	60434388	24054
chr6	60410334	60610334	harbor1	chr6	60465894	60466144	DNA/TcMar-Tigger	1443	+	125	60466019	55685
chr6	159247284	159447284	harbor1	chr6	159282876	159283102	DNA/TcMar-Tigger	1122	+	113	159282989	35705
chr6	159247284	159447284	harbor1	chr6	159283714	159283821	DNA/TcMar-Tigger	596	+	54	159283768	36484
chr6	98075041	98275041	harbor1	chr6	98110252	98110358	DNA/TcMar-Tigger	506	+	53	98110305	35264
chr6	64629114	64829114	harbor1	chr6	64718048	64718662	DNA/TcMar-Tigger	2402	+	307	64718355	89241
chr6	166643222	166843222	harbor1	chr6	166704913	166705067	DNA/TcMar-Tigger	506	+	77	166704990	61768
chr6	166643222	166843222	harbor1	chr6	166727904	166728208	DNA/TcMar-Tigger	1480	+	152	166728056	84834
chr7	29150227	29350227	harbor1	chr7	29153358	29153572	DNA/TcMar-Tigger	2605	+	107	29153465	3238
chr7	29150227	29350227	harbor1	chr7	29153870	29154103	DNA/TcMar-Tigger	2605	+	116	29153986	3759
chr7	29150227	29350227	harbor1	chr7	29183809	29184126	DNA/TcMar-Tigger	1305	+	158	29183967	33740
chr7	29150227	29350227	harbor1	chr7	29228228	29228540	DNA/TcMar-Tigger	1698	+	156	29228384	78157
chr7	1736607	1936607	harbor1	chr7	1779535	1779842	DNA/TcMar-Tigger	4101	+	154	1779689	43082
chr7	1736607	1936607	harbor1	chr7	1780146	1780380	DNA/TcMar-Tigger	4101	+	117	1780263	43656
chr7	1736607	1936607	harbor1	chr7	1780690	1781001	DNA/TcMar-Tigger	4101	+	156	1780846	44239
chr7	1736607	1936607	harbor1	chr7	1781291	1781673	DNA/TcMar-Tigger	4101	+	191	1781482	44875
chr7	1736607	1936607	harbor1	chr7	1831090	1831716	DNA/TcMar-Tigger	3365	+	313	1831403	94796
chr7	1736607	1936607	harbor1	chr7	1831729	1832651	DNA/TcMar-Tigger	7259	+	461	1832190	95583
chr7	1736607	1936607	harbor1	chr7	1832932	1833283	DNA/TcMar-Tigger	7259	+	176	1833108	96501
chr7	94137973	94337973	harbor1	chr7	94198410	94198761	DNA/TcMar-Tigger	1786	+	176	94198586	60613
chr7	72221260	72421260	harbor1	chr7	72230833	72231112	DNA/TcMar-Tigger	1355	+	140	72230973	9713
chr7	72221260	72421260	harbor1	chr7	72231634	72231785	DNA/TcMar-Tigger	912	+	76	72231710	10450
chr7	72221260	72421260	harbor1	chr7	72311023	72311464	DNA/TcMar-Tigger	2536	+	220	72311243	89983
chr7	80204926	80404926	harbor1	chr7	80211888	80212109	DNA/TcMar-Tigger	1060	+	110	80211998	7072
chr7	1735810	1935810	harbor1	chr7	1779535	1779842	DNA/TcMar-Tigger	4101	+	154	1779689	43879
chr7	1735810	1935810	harbor1	chr7	1780146	1780380	DNA/TcMar-Tigger	4101	+	117	1780263	44453
chr7	1735810	1935810	harbor1	chr7	1780690	1781001	DNA/TcMar-Tigger	4101	+	156	1780846	45036
chr7	1735810	1935810	harbor1	chr7	1781291	1781673	DNA/TcMar-Tigger	4101	+	191	1781482	45672
chr7	1735810	1935810	harbor1	chr7	1831090	1831716	DNA/TcMar-Tigger	3365	+	313	1831403	95593
chr7	1735810	1935810	harbor1	chr7	1831729	1832651	DNA/TcMar-Tigger	7259	+	461	1832190	96380
chr7	1735810	1935810	harbor1	chr7	1832932	1833283	DNA/TcMar-Tigger	7259	+	176	1833108	97298
chr7	112003637	112203637	harbor1	chr7	112036619	112036652	DNA/TcMar-Tigger	2178	+	16	112036635	32998
chr7	112003637	112203637	harbor1	chr7	112036961	112037362	DNA/TcMar-Tigger	2178	+	200	112037161	33524
chr7	140849259	141049259	harbor1	chr7	140902796	140902886	DNA/TcMar-Tigger	601	+	45	140902841	53582
chr7	140849259	141049259	harbor1	chr7	140902880	140902920	DNA/TcMar-Tigger	6600	+	20	140902900	53641
chr7	140849259	141049259	harbor1	chr7	140903226	140904340	DNA/TcMar-Tigger	6600	+	557	140903783	54524
chr7	140849259	141049259	harbor1	chr7	140902029	140902650	DNA/TcMar-Tigger	3399	+	310	140902339	53080
chr7	65736488	65936488	harbor1	chr7	65814358	65814452	DNA/TcMar-Tigger	474	+	47	65814405	77917
chr7	65736488	65936488	harbor1	chr7	65835926	65836035	DNA/TcMar-Tigger	559	+	54	65835980	99492
chr7	67644948	67844948	harbor1	chr7	67732058	67732521	DNA/TcMar-Tigger	1296	+	232	67732290	87342
chr7	109307046	109507046	harbor1	chr7	109358506	109358830	DNA/TcMar-Tigger	1535	+	162	109358668	51622
chr7	109307046	109507046	harbor1	chr7	109378800	109381201	DNA/TcMar-Tigger	13718	+	1200	109380000	72954
chr7	47137398	47337398	harbor1	chr7	47235162	47235606	DNA/TcMar-Tigger	2305	+	222	47235384	97986
chr7	126403725	126603725	harbor1	chr7	126439313	126439825	DNA/TcMar-Tigger	6196	+	256	126439569	35844
chr7	126403725	126603725	harbor1	chr7	126439858	126440131	DNA/TcMar-Tigger	6196	+	136	126439994	36269
chr7	126403725	126603725	harbor1	chr7	126440435	126440834	DNA/TcMar-Tigger	6196	+	200	126440635	36910
chr7	126403725	126603725	harbor1	chr7	126462377	126462581	DNA/TcMar-Tigger	440	+	102	126462479	58754
chr7	23889592	24089592	harbor1	chr7	23890326	23890423	DNA/TcMar-Tigger	583	+	48	23890374	782
chr7	23889592	24089592	harbor1	chr7	23891188	23891309	DNA/TcMar-Tigger	455	+	60	23891248	1656
chr7	23889592	24089592	harbor1	chr7	23897385	23897978	DNA/TcMar-Tigger	7046	+	296	23897681	8089
chr7	23889592	24089592	harbor1	chr7	23898288	23898905	DNA/TcMar-Tigger	7046	+	308	23898596	9004
chr7	894837	1094837	harbor1	chr7	966690	967191	DNA/TcMar-Tigger	1984	+	250	966940	72103
chr7	7322911	7522911	harbor1	chr7	7366995	7367331	DNA/TcMar-Tigger	2060	+	168	7367163	44252
chr7	7322911	7522911	harbor1	chr7	7384385	7384713	DNA/TcMar-Tigger	1937	+	164	7384549	61638
chr7	103200055	103400055	harbor1	chr7	103202943	103204116	DNA/TcMar-Tigger	6679	+	586	103203529	3474
chr7	103200055	103400055	harbor1	chr7	103232358	103232675	DNA/TcMar-Tigger	1359	+	158	103232516	32461
chr7	103200055	103400055	harbor1	chr7	103241310	103241604	DNA/TcMar-Tigger	584	+	147	103241457	41402
chr7	81996945	82196945	harbor1	chr7	82027609	82027802	DNA/TcMar-Tigger	983	+	96	82027705	30760
chr7	81996945	82196945	harbor1	chr7	82027858	82029462	DNA/TcMar-Tigger	10010	+	802	82028660	31715
chr7	21472595	21672595	harbor1	chr7	21492370	21492575	DNA/TcMar-Tigger	966	+	102	21492472	19877
chr7	21472595	21672595	harbor1	chr7	21498216	21498400	DNA/TcMar-Tigger	888	+	92	21498308	25713
chr7	21472595	21672595	harbor1	chr7	21520032	21520223	DNA/TcMar-Tigger	485	+	96	21520128	47533
chr7	150218205	150418205	harbor1	chr7	150251860	150252040	DNA/TcMar-Tigger	658	+	90	150251950	33745
chr7	150218205	150418205	harbor1	chr7	150267232	150267778	DNA/TcMar-Tigger	2785	+	273	150267505	49300
chr7	150218205	150418205	harbor1	chr7	150274216	150274350	DNA/TcMar-Tigger	614	+	67	150274283	56078
chr7	150218205	150418205	harbor1	chr7	150274335	150274547	DNA/TcMar-Tigger	1100	+	106	150274441	56236
chr7	154463106	154663106	harbor1	chr7	154473548	154474040	DNA/TcMar-Tigger	638	+	246	154473794	10688
chr7	154463106	154663106	harbor1	chr7	154558477	154558819	DNA/TcMar-Tigger	1969	+	171	154558648	95542
chr7	91655850	91855850	harbor1	chr7	91719626	91719951	DNA/TcMar-Tigger	1679	+	162	91719788	63938
chr7	133667089	133867089	harbor1	chr7	133705488	133705566	DNA/TcMar-Tigger	479	+	39	133705527	38438
chr7	133667089	133867089	harbor1	chr7	133714542	133714832	DNA/TcMar-Tigger	1306	+	145	133714687	47598
chr7	133667089	133867089	harbor1	chr7	133734597	133734844	DNA/TcMar-Tigger	1304	+	124	133734721	67632
chr7	56526456	56726456	harbor1	chr7	56528322	56528621	DNA/TcMar-Tigger	1236	+	150	56528472	2016
chr7	16541080	16741080	harbor1	chr7	16541188	16541514	DNA/TcMar-Tigger	499	+	163	16541351	271
chr7	38792830	38992830	harbor1	chr7	38811816	38812125	DNA/TcMar-Tigger	1481	+	154	38811970	19140
chr7	38792830	38992830	harbor1	chr7	38858619	38859758	DNA/TcMar-Tigger	7020	+	570	38859189	66359
chr7	7265837	7465837	harbor1	chr7	7275068	7275378	DNA/TcMar-Tigger	584	+	155	7275223	9386
chr7	127202488	127402488	harbor1	chr7	127275500	127275645	DNA/TcMar-Tigger	813	+	72	127275572	73084
chr7	127202488	127402488	harbor1	chr7	127275869	127277257	DNA/TcMar-Tigger	8343	+	694	127276563	74075
chr7	127202488	127402488	harbor1	chr7	127278311	127279517	DNA/TcMar-Tigger	7883	+	603	127278914	76426
chr7	104136121	104336121	harbor1	chr7	104186155	104186413	DNA/TcMar-Tigger	1122	+	129	104186284	50163
chr7	104136121	104336121	harbor1	chr7	104206720	104207039	DNA/TcMar-Tigger	1952	+	160	104206880	70759
chr7	104136121	104336121	harbor1	chr7	104221222	104221547	DNA/TcMar-Tigger	1076	+	162	104221384	85263
chr7	38457527	38657527	harbor1	chr7	38461930	38462353	DNA/TcMar-Tigger	1951	+	212	38462142	4615
chr7	26718798	26918798	harbor1	chr7	26795879	26796919	DNA/TcMar-Tigger	6093	+	520	26796399	77601
chr7	26718798	26918798	harbor1	chr7	26805821	26806283	DNA/TcMar-Tigger	2817	+	231	26806052	87254
chr7	26718798	26918798	harbor1	chr7	26806529	26806916	DNA/TcMar-Tigger	2460	+	194	26806723	87925
chr7	26718798	26918798	harbor1	chr7	26806914	26807246	DNA/TcMar-Tigger	5080	+	166	26807080	88282
chr7	26718798	26918798	harbor1	chr7	26807616	26808081	DNA/TcMar-Tigger	5080	+	232	26807848	89050
chr7	132182744	132382744	harbor1	chr7	132219706	132220055	DNA/TcMar-Tigger	1929	+	174	132219880	37136
chr7	132182744	132382744	harbor1	chr7	132237805	132238400	DNA/TcMar-Tigger	3063	+	298	132238103	55359
chr7	17766358	17966358	harbor1	chr7	17801962	17802307	DNA/TcMar-Tigger	1851	+	172	17802134	35776
chr7	17766358	17966358	harbor1	chr7	17817173	17817607	DNA/TcMar-Tigger	641	+	217	17817390	51032
chr7	17766358	17966358	harbor1	chr7	17854412	17856130	DNA/TcMar-Tigger	9242	+	859	17855271	88913
chr7	94087816	94287816	harbor1	chr7	94131550	94131889	DNA/TcMar-Tigger	1958	+	170	94131720	43904
chr7	11693908	11893908	harbor1	chr7	11735308	11735641	DNA/TcMar-Tigger	1758	+	166	11735474	41566
chr7	134981139	135181139	harbor1	chr7	134983847	134983935	DNA/TcMar-Tigger	466	+	44	134983891	2752
chr7	134981139	135181139	harbor1	chr7	134984013	134984339	DNA/TcMar-Tigger	1960	+	163	134984176	3037
chr7	94763305	94963305	harbor1	chr7	94801936	94802232	DNA/TcMar-Tigger	6512	+	148	94802084	38779
chr7	94763305	94963305	harbor1	chr7	94802493	94803405	DNA/TcMar-Tigger	6512	+	456	94802949	39644
chr7	94763305	94963305	harbor1	chr7	94823948	94824642	DNA/TcMar-Tigger	2979	+	347	94824295	60990
chr7	86998990	87198990	harbor1	chr7	87013778	87014388	DNA/TcMar-Tigger	2740	+	305	87014083	15093
chr7	72629958	72829958	harbor1	chr7	72661449	72661765	DNA/TcMar-Tigger	469	+	158	72661607	31649
chr7	72629958	72829958	harbor1	chr7	72672577	72672750	DNA/TcMar-Tigger	814	+	86	72672663	42705
chr7	72629958	72829958	harbor1	chr7	72693725	72693948	DNA/TcMar-Tigger	1369	+	112	72693837	63879
chr7	72629958	72829958	harbor1	chr7	72694267	72694349	DNA/TcMar-Tigger	1369	+	41	72694308	64350
chr7	72629958	72829958	harbor1	chr7	72699520	72699643	DNA/TcMar-Tigger	611	+	62	72699582	69624
chr7	72629958	72829958	harbor1	chr7	72699950	72700115	DNA/TcMar-Tigger	611	+	82	72700032	70074
chr7	8361108	8561108	harbor1	chr7	8414202	8416536	DNA/TcMar-Tigger	14825	+	1167	8415369	54261
chr7	8361108	8561108	harbor1	chr7	8424467	8424772	DNA/TcMar-Tigger	1118	+	152	8424619	63511
chr7	158329298	158529298	harbor1	chr7	158416481	158416959	DNA/TcMar-Tigger	1139	+	239	158416720	87422
chr7	112955357	113155357	harbor1	chr7	113000168	113000270	DNA/TcMar-Tigger	522	+	51	113000219	44862
chr7	47384860	47584860	harbor1	chr7	47412698	47412940	DNA/TcMar-Tigger	763	+	121	47412819	27959
chr7	47384860	47584860	harbor1	chr7	47461579	47461803	DNA/TcMar-Tigger	560	+	112	47461691	76831
chr7	47384860	47584860	harbor1	chr7	47462417	47462574	DNA/TcMar-Tigger	857	+	78	47462495	77635
chr7	8357451	8557451	harbor1	chr7	8414202	8416536	DNA/TcMar-Tigger	14825	+	1167	8415369	57918
chr7	8357451	8557451	harbor1	chr7	8424467	8424772	DNA/TcMar-Tigger	1118	+	152	8424619	67168
chr7	3449448	3649448	harbor1	chr7	3484258	3484472	DNA/TcMar-Tigger	1184	+	107	3484365	34917
chr7	3449448	3649448	harbor1	chr7	3505609	3505889	DNA/TcMar-Tigger	993	+	140	3505749	56301
chr7	3449448	3649448	harbor1	chr7	3524935	3525240	DNA/TcMar-Tigger	1112	+	152	3525087	75639
chr7	18397336	18597336	harbor1	chr7	18411220	18411377	DNA/TcMar-Tigger	1817	+	78	18411298	13962
chr7	18397336	18597336	harbor1	chr7	18411674	18411817	DNA/TcMar-Tigger	1817	+	72	18411746	14410
chr7	18397336	18597336	harbor1	chr7	18412128	18412199	DNA/TcMar-Tigger	1817	+	36	18412164	14828
chr7	66085610	66285610	harbor1	chr7	66102100	66102266	DNA/TcMar-Tigger	1080	+	83	66102183	16573
chr7	66085610	66285610	harbor1	chr7	66102579	66102628	DNA/TcMar-Tigger	1080	+	24	66102603	16993
chr7	66085610	66285610	harbor1	chr7	66120734	66120911	DNA/TcMar-Tigger	739	+	88	66120822	35212
chr7	66085610	66285610	harbor1	chr7	66160639	66160965	DNA/TcMar-Tigger	1862	+	163	66160802	75192
chr7	8579975	8779975	harbor1	chr7	8600824	8601154	DNA/TcMar-Tigger	1762	+	165	8600989	21014
chr7	8579975	8779975	harbor1	chr7	8650781	8650971	DNA/TcMar-Tigger	478	+	95	8650876	70901
chr7	90742581	90942581	harbor1	chr7	90789425	90789721	DNA/TcMar-Tigger	1125	+	148	90789573	46992
chr7	48401025	48601025	harbor1	chr7	48407120	48407191	DNA/TcMar-Tigger	1006	+	36	48407156	6131
chr7	48401025	48601025	harbor1	chr7	48407486	48407565	DNA/TcMar-Tigger	1006	+	40	48407526	6501
chr7	48401025	48601025	harbor1	chr7	48407819	48408005	DNA/TcMar-Tigger	1006	+	93	48407912	6887
chr7	35087352	35287352	harbor1	chr7	35105180	35105418	DNA/TcMar-Tigger	1402	+	119	35105299	17947
chr7	35087352	35287352	harbor1	chr7	35106673	35107386	DNA/TcMar-Tigger	4239	+	356	35107029	19677
chr7	35087352	35287352	harbor1	chr7	35139594	35139910	DNA/TcMar-Tigger	1292	+	158	35139752	52400
chr7	35087352	35287352	harbor1	chr7	35148540	35148862	DNA/TcMar-Tigger	525	+	161	35148701	61349
chr7	35087352	35287352	harbor1	chr7	35110413	35111586	DNA/TcMar-Tigger	6542	+	586	35110999	23647
chr7	154500976	154700976	harbor1	chr7	154558477	154558819	DNA/TcMar-Tigger	1969	+	171	154558648	57672
chr7	154500976	154700976	harbor1	chr7	154564689	154565346	DNA/TcMar-Tigger	2763	+	328	154565017	64041
chr7	52222140	52422140	harbor1	chr7	52279437	52279730	DNA/TcMar-Tigger	1191	+	146	52279583	57443
chr7	52222140	52422140	harbor1	chr7	52279718	52280047	DNA/TcMar-Tigger	1332	+	164	52279882	57742
chr7	1815240	2015240	harbor1	chr7	1831090	1831716	DNA/TcMar-Tigger	3365	+	313	1831403	16163
chr7	1815240	2015240	harbor1	chr7	1831729	1832651	DNA/TcMar-Tigger	7259	+	461	1832190	16950
chr7	1815240	2015240	harbor1	chr7	1832932	1833283	DNA/TcMar-Tigger	7259	+	176	1833108	17868
chr7	1815240	2015240	harbor1	chr7	1891173	1891243	DNA/TcMar-Tigger	2145	+	35	1891208	75968
chr7	1815240	2015240	harbor1	chr7	1891548	1891576	DNA/TcMar-Tigger	2145	+	14	1891562	76322
chr7	1815240	2015240	harbor1	chr7	1891881	1892365	DNA/TcMar-Tigger	2145	+	242	1892123	76883
chr7	35848454	36048454	harbor1	chr7	35853980	35854213	DNA/TcMar-Tigger	1387	+	116	35854096	5642
chr7	35848454	36048454	harbor1	chr7	35884221	35884447	DNA/TcMar-Tigger	1288	+	113	35884334	35880
chr7	35848454	36048454	harbor1	chr7	35893504	35893630	DNA/TcMar-Tigger	698	+	63	35893567	45113
chr7	35848454	36048454	harbor1	chr7	35901301	35901593	DNA/TcMar-Tigger	558	+	146	35901447	52993
chr7	759406	959406	harbor1	chr7	775632	775738	DNA/TcMar-Tigger	445	+	53	775685	16279
chr7	759406	959406	harbor1	chr7	775794	776008	DNA/TcMar-Tigger	954	+	107	775901	16495
chr7	44753	244753	harbor1	chr7	136007	136118	DNA/TcMar-Tigger	943	+	56	136063	91310
chr7	44753	244753	harbor1	chr7	136736	137106	DNA/TcMar-Tigger	943	+	185	136921	92168
chr7	92154591	92354591	harbor1	chr7	92203326	92203481	DNA/TcMar-Tigger	465	+	78	92203404	48813
chr7	92154591	92354591	harbor1	chr7	92203711	92203917	DNA/TcMar-Tigger	518	+	103	92203814	49223
chr7	28930734	29130734	harbor1	chr7	28949621	28950100	DNA/TcMar-Tigger	3199	+	240	28949861	19127
chr7	28930734	29130734	harbor1	chr7	28950381	28950566	DNA/TcMar-Tigger	3199	+	92	28950473	19739
chr7	123012852	123212852	harbor1	chr7	123029413	123029720	DNA/TcMar-Tigger	468	+	154	123029567	16715
chr7	16965530	17165530	harbor1	chr7	16971698	16972536	DNA/TcMar-Tigger	4156	+	419	16972117	6587
chr7	45691810	45891810	harbor1	chr7	45735154	45735249	DNA/TcMar-Tigger	464	+	48	45735202	43392
chr7	45691810	45891810	harbor1	chr7	45735251	45735960	DNA/TcMar-Tigger	3793	+	354	45735605	43795
chr7	45691810	45891810	harbor1	chr7	45752534	45752823	DNA/TcMar-Tigger	1399	+	144	45752678	60868
chr7	45691810	45891810	harbor1	chr7	45789258	45789365	DNA/TcMar-Tigger	449	+	54	45789312	97502
chr7	3608445	3808445	harbor1	chr7	3621858	3622175	DNA/TcMar-Tigger	1637	+	158	3622016	13571
chr7	3608445	3808445	harbor1	chr7	3662729	3662970	DNA/TcMar-Tigger	1389	+	120	3662849	54404
chr7	53726217	53926217	harbor1	chr7	53816240	53818951	DNA/TcMar-Tigger	13641	+	1356	53817596	91379
chr7	53726217	53926217	harbor1	chr7	53819263	53819405	DNA/TcMar-Tigger	13641	+	71	53819334	93117
chr7	53726217	53926217	harbor1	chr7	53738019	53740384	DNA/TcMar-Tigger	13080	+	1182	53739201	12984
chr7	27039437	27239437	harbor1	chr7	27077423	27077458	DNA/TcMar-Tigger	738	+	18	27077441	38004
chr7	27039437	27239437	harbor1	chr7	27077755	27077892	DNA/TcMar-Tigger	738	+	68	27077823	38386
chr7	27039437	27239437	harbor1	chr7	27078740	27079157	DNA/TcMar-Tigger	2589	+	208	27078948	39511
chr7	60889279	61089279	harbor1	chr7	60944786	60945125	DNA/TcMar-Tigger	1510	+	170	60944956	55677
chr8	53052913	53252913	harbor1	chr8	53143647	53143990	DNA/TcMar-Tigger	1707	+	172	53143819	90906
chr8	80359532	80559532	harbor1	chr8	80409513	80409659	DNA/TcMar-Tigger	566	+	73	80409586	50054
chr8	7382295	7582295	harbor1	chr8	7387777	7388052	DNA/TcMar-Tigger	1331	+	138	7387915	5620
chr8	7382295	7582295	harbor1	chr8	7410208	7410519	DNA/TcMar-Tigger	1396	+	156	7410364	28069
chr8	81144167	81344167	harbor1	chr8	81144765	81144840	DNA/TcMar-Tigger	413	+	38	81144803	636
chr8	81144167	81344167	harbor1	chr8	81145033	81145232	DNA/TcMar-Tigger	1191	+	100	81145133	966
chr8	81144167	81344167	harbor1	chr8	81159799	81159896	DNA/TcMar-Tigger	446	+	48	81159847	15680
chr8	81144167	81344167	harbor1	chr8	81163259	81163588	DNA/TcMar-Tigger	1810	+	164	81163423	19256
chr8	143157069	143357069	harbor1	chr8	143199125	143199196	DNA/TcMar-Tigger	408	+	36	143199161	42092
chr8	95873295	96073295	harbor1	chr8	95938905	95939590	DNA/TcMar-Tigger	3379	+	342	95939247	65952
chr8	68305416	68505416	harbor1	chr8	68342495	68342992	DNA/TcMar-Tigger	2708	+	248	68342743	37327
chr8	68305416	68505416	harbor1	chr8	68342992	68343078	DNA/TcMar-Tigger	425	+	43	68343035	37619
chr8	68305416	68505416	harbor1	chr8	68353663	68353983	DNA/TcMar-Tigger	1840	+	160	68353823	48407
chr8	108673175	108873175	harbor1	chr8	108740478	108740708	DNA/TcMar-Tigger	1464	+	115	108740593	67418
chr8	106608567	106808567	harbor1	chr8	106662907	106663125	DNA/TcMar-Tigger	1008	+	109	106663016	54449
chr8	42581424	42781424	harbor1	chr8	42614970	42615324	DNA/TcMar-Tigger	1966	+	177	42615147	33723
chr8	42581424	42781424	harbor1	chr8	42643308	42643982	DNA/TcMar-Tigger	17078	+	337	42643645	62221
chr8	42581424	42781424	harbor1	chr8	42644587	42646045	DNA/TcMar-Tigger	17078	+	729	42645316	63892
chr8	42581424	42781424	harbor1	chr8	42646332	42646707	DNA/TcMar-Tigger	17078	+	188	42646520	65096
chr8	42581424	42781424	harbor1	chr8	42647013	42647145	DNA/TcMar-Tigger	17078	+	66	42647079	65655
chr8	42581424	42781424	harbor1	chr8	42647508	42647565	DNA/TcMar-Tigger	17078	+	28	42647536	66112
chr8	123333555	123533555	harbor1	chr8	123339485	123339562	DNA/TcMar-Tigger	448	+	38	123339523	5968
chr8	123333555	123533555	harbor1	chr8	123363160	123363493	DNA/TcMar-Tigger	787	+	166	123363326	29771
chr8	50252282	50452282	harbor1	chr8	50346107	50347684	DNA/TcMar-Tigger	9318	+	788	50346895	94613
chr8	31986489	32186489	harbor1	chr8	32024460	32024729	DNA/TcMar-Tigger	803	+	134	32024594	38105
chr8	16596200	16796200	harbor1	chr8	16687066	16687427	DNA/TcMar-Tigger	2281	+	180	16687246	91046
chr8	93366430	93566430	harbor1	chr8	93379912	93380655	DNA/TcMar-Tigger	6108	+	372	93380284	13854
chr8	93366430	93566430	harbor1	chr8	93382914	93383365	DNA/TcMar-Tigger	6108	+	226	93383140	16710
chr8	93366430	93566430	harbor1	chr8	93433654	93434098	DNA/TcMar-Tigger	533	+	222	93433876	67446
chr8	38279257	38479257	harbor1	chr8	38284829	38285040	DNA/TcMar-Tigger	562	+	106	38284935	5678
chr8	38279257	38479257	harbor1	chr8	38304915	38305101	DNA/TcMar-Tigger	495	+	93	38305008	25751
chr8	60985163	61185163	harbor1	chr8	61015972	61016308	DNA/TcMar-Tigger	1873	+	168	61016140	30977
chr8	60985163	61185163	harbor1	chr8	61055106	61055482	DNA/TcMar-Tigger	544	+	188	61055294	70131
chr8	18746100	18946100	harbor1	chr8	18804163	18804408	DNA/TcMar-Tigger	855	+	122	18804285	58185
chr8	107532019	107732019	harbor1	chr8	107617416	107617776	DNA/TcMar-Tigger	2463	+	180	107617596	85577
chr8	88035418	88235418	harbor1	chr8	88079200	88079524	DNA/TcMar-Tigger	1873	+	162	88079362	43944
chr8	88035418	88235418	harbor1	chr8	88096054	88096285	DNA/TcMar-Tigger	641	+	116	88096170	60752
chr8	88035418	88235418	harbor1	chr8	88104398	88104926	DNA/TcMar-Tigger	2460	+	264	88104662	69244
chr8	88035418	88235418	harbor1	chr8	88104901	88105156	DNA/TcMar-Tigger	1489	+	128	88105029	69611
chr8	48081195	48281195	harbor1	chr8	48151227	48151715	DNA/TcMar-Tigger	3240	+	244	48151471	70276
chr8	48081195	48281195	harbor1	chr8	48152020	48152193	DNA/TcMar-Tigger	3240	+	86	48152106	70911
chr8	103469150	103669150	harbor1	chr8	103475075	103475423	DNA/TcMar-Tigger	2089	+	174	103475249	6099
chr8	60037889	60237889	harbor1	chr8	60038132	60039139	DNA/TcMar-Tigger	3341	+	504	60038636	747
chr8	60037889	60237889	harbor1	chr8	60106664	60106889	DNA/TcMar-Tigger	1217	+	112	60106776	68887
chr8	60037889	60237889	harbor1	chr8	60106891	60107262	DNA/TcMar-Tigger	3720	+	186	60107077	69188
chr8	60037889	60237889	harbor1	chr8	60107425	60107741	DNA/TcMar-Tigger	3720	+	158	60107583	69694
chr8	60037889	60237889	harbor1	chr8	60120830	60121194	DNA/TcMar-Tigger	1702	+	182	60121012	83123
chr8	131035135	131235135	harbor1	chr8	131089289	131091499	DNA/TcMar-Tigger	14784	+	1105	131090394	55259
chr8	131035135	131235135	harbor1	chr8	131091792	131091967	DNA/TcMar-Tigger	14784	+	88	131091880	56745
chr8	1909559	2109559	harbor1	chr8	1954048	1954093	DNA/TcMar-Tigger	1139	+	22	1954070	44511
chr8	1909559	2109559	harbor1	chr8	1954352	1954533	DNA/TcMar-Tigger	1139	+	90	1954442	44883
chr8	1909559	2109559	harbor1	chr8	1975330	1975656	DNA/TcMar-Tigger	1289	+	163	1975493	65934
chr8	1909559	2109559	harbor1	chr8	1998056	1998250	DNA/TcMar-Tigger	813	+	97	1998153	88594
chr8	26034626	26234626	harbor1	chr8	26105023	26105429	DNA/TcMar-Tigger	2321	+	203	26105226	70600
chr8	26034626	26234626	harbor1	chr8	26105701	26105738	DNA/TcMar-Tigger	2321	+	18	26105719	71093
chr8	26034626	26234626	harbor1	chr8	26105935	26106338	DNA/TcMar-Tigger	2412	+	202	26106137	71511
chr8	26034626	26234626	harbor1	chr8	26123198	26123682	DNA/TcMar-Tigger	1368	+	242	26123440	88814
chr8	83160013	83360013	harbor1	chr8	83177045	83177409	DNA/TcMar-Tigger	742	+	182	83177227	17214
chr8	83160013	83360013	harbor1	chr8	83211798	83212159	DNA/TcMar-Tigger	1833	+	180	83211978	51965
chr8	43308959	43508959	harbor1	chr8	43343963	43344270	DNA/TcMar-Tigger	1228	+	154	43344117	35158
chr8	53733167	53933167	harbor1	chr8	53762780	53763212	DNA/TcMar-Tigger	2530	+	216	53762996	29829
chr8	132702980	132902980	harbor1	chr8	132716557	132716713	DNA/TcMar-Tigger	836	+	78	132716635	13655
chr8	132702980	132902980	harbor1	chr8	132719263	132719579	DNA/TcMar-Tigger	1594	+	158	132719421	16441
chr8	92738631	92938631	harbor1	chr8	92772449	92772593	DNA/TcMar-Tigger	513	+	72	92772521	33890
chr8	92738631	92938631	harbor1	chr8	92774868	92774982	DNA/TcMar-Tigger	489	+	57	92774925	36294
chr8	4797392	4997392	harbor1	chr8	4848307	4848542	DNA/TcMar-Tigger	5849	+	118	4848425	51033
chr8	4797392	4997392	harbor1	chr8	4848844	4849861	DNA/TcMar-Tigger	5849	+	508	4849352	51960
chr8	85103874	85303874	harbor1	chr8	85131109	85131374	DNA/TcMar-Tigger	609	+	132	85131241	27367
chr8	13809575	14009575	harbor1	chr8	13816516	13816854	DNA/TcMar-Tigger	810	+	169	13816685	7110
chr8	102866764	103066764	harbor1	chr8	102867922	102868058	DNA/TcMar-Tigger	786	+	68	102867990	1226
chr8	102866764	103066764	harbor1	chr8	102883101	102883205	DNA/TcMar-Tigger	513	+	52	102883153	16389
chr8	132045470	132245470	harbor1	chr8	132088234	132088544	DNA/TcMar-Tigger	667	+	155	132088389	42919
chr8	57760947	57960947	harbor1	chr8	57763555	57763896	DNA/TcMar-Tigger	1854	+	170	57763725	2778
chr8	57760947	57960947	harbor1	chr8	57796110	57798477	DNA/TcMar-Tigger	14924	+	1184	57797294	36347
chr8	9154827	9354827	harbor1	chr8	9169470	9169782	DNA/TcMar-Tigger	1337	+	156	9169626	14799
chr8	90525	290525	harbor1	chr8	129037	129494	DNA/TcMar-Tigger	2203	+	228	129265	38740
chr8	116564836	116764836	harbor1	chr8	116575203	116575540	DNA/TcMar-Tigger	1904	+	168	116575371	10535
chr8	116564836	116764836	harbor1	chr8	116636139	116636228	DNA/TcMar-Tigger	2385	+	44	116636183	71347
chr8	116564836	116764836	harbor1	chr8	116636363	116636721	DNA/TcMar-Tigger	2385	+	179	116636542	71706
chr8	81184443	81384443	harbor1	chr8	81247616	81247988	DNA/TcMar-Tigger	1027	+	186	81247802	63359
chr8	81184443	81384443	harbor1	chr8	81248832	81251516	DNA/TcMar-Tigger	16639	+	1342	81250174	65731
chr8	81184443	81384443	harbor1	chr8	81265933	81266271	DNA/TcMar-Tigger	1919	+	169	81266102	81659
chr8	31463973	31663973	harbor1	chr8	31467990	31468069	DNA/TcMar-Tigger	508	+	40	31468030	4057
chr8	31463973	31663973	harbor1	chr8	31468060	31469204	DNA/TcMar-Tigger	7603	+	572	31468632	4659
chr8	55984809	56184809	harbor1	chr8	56022893	56023019	DNA/TcMar-Tigger	6306	+	63	56022956	38147
chr8	55984809	56184809	harbor1	chr8	56023313	56023407	DNA/TcMar-Tigger	6306	+	47	56023360	38551
chr8	55984809	56184809	harbor1	chr8	56023705	56024586	DNA/TcMar-Tigger	6306	+	440	56024145	39336
chr8	55984809	56184809	harbor1	chr8	56034102	56034490	DNA/TcMar-Tigger	444	+	194	56034296	49487
chr8	55984809	56184809	harbor1	chr8	56041089	56041188	DNA/TcMar-Tigger	4532	+	50	56041139	56330
chr8	55984809	56184809	harbor1	chr8	56041469	56042114	DNA/TcMar-Tigger	4532	+	322	56041791	56982
chr8	55984809	56184809	harbor1	chr8	56049282	56049488	DNA/TcMar-Tigger	435	+	103	56049385	64576
chr8	55984809	56184809	harbor1	chr8	56056462	56057076	DNA/TcMar-Tigger	3854	+	307	56056769	71960
chr8	55984809	56184809	harbor1	chr8	56057397	56057540	DNA/TcMar-Tigger	3854	+	72	56057469	72660
chr8	55984809	56184809	harbor1	chr8	56058050	56058339	DNA/TcMar-Tigger	1227	+	144	56058194	73385
chr8	55984809	56184809	harbor1	chr8	56058650	56058702	DNA/TcMar-Tigger	1227	+	26	56058676	73867
chr8	55984809	56184809	harbor1	chr8	56069791	56070108	DNA/TcMar-Tigger	1713	+	158	56069949	85140
chr8	55984809	56184809	harbor1	chr8	56079450	56079767	DNA/TcMar-Tigger	1572	+	158	56079608	94799
chr8	140009245	140209245	harbor1	chr8	140065139	140066221	DNA/TcMar-Tigger	6669	+	541	140065680	56435
chr8	121835500	122035500	harbor1	chr8	121868221	121868562	DNA/TcMar-Tigger	2044	+	170	121868391	32891
chr8	111717210	111917210	harbor1	chr8	111767504	111767848	DNA/TcMar-Tigger	2184	+	172	111767676	50466
chr8	63898571	64098571	harbor1	chr8	63911739	63912049	DNA/TcMar-Tigger	1690	+	155	63911894	13323
chr8	23334792	23534792	harbor1	chr8	23408463	23408822	DNA/TcMar-Tigger	6604	+	180	23408643	73851
chr8	23334792	23534792	harbor1	chr8	23409132	23409716	DNA/TcMar-Tigger	6604	+	292	23409424	74632
chr8	23334792	23534792	harbor1	chr8	23410023	23410293	DNA/TcMar-Tigger	6604	+	135	23410158	75366
chr8	16306633	16506633	harbor1	chr8	16355651	16356000	DNA/TcMar-Tigger	1643	+	174	16355825	49192
chr8	16306633	16506633	harbor1	chr8	16395858	16396072	DNA/TcMar-Tigger	592	+	107	16395965	89332
chr8	93712207	93912207	harbor1	chr8	93800366	93800504	DNA/TcMar-Tigger	690	+	69	93800435	88228
chr8	68350672	68550672	harbor1	chr8	68353663	68353983	DNA/TcMar-Tigger	1840	+	160	68353823	3151
chr8	68350672	68550672	harbor1	chr8	68408610	68408779	DNA/TcMar-Tigger	6930	+	84	68408694	58022
chr8	68350672	68550672	harbor1	chr8	68409087	68410113	DNA/TcMar-Tigger	6930	+	513	68409600	58928
chr8	68350672	68550672	harbor1	chr8	68410378	68410587	DNA/TcMar-Tigger	1008	+	104	68410482	59810
chr8	91785182	91985182	harbor1	chr8	91833677	91833742	DNA/TcMar-Tigger	451	+	32	91833709	48527
chr8	91785182	91985182	harbor1	chr8	91833770	91833938	DNA/TcMar-Tigger	451	+	84	91833854	48672
chr8	91785182	91985182	harbor1	chr8	91879755	91880263	DNA/TcMar-Tigger	2557	+	254	91880009	94827
chr8	91785182	91985182	harbor1	chr8	91880255	91880367	DNA/TcMar-Tigger	501	+	56	91880311	95129
chr8	88358154	88558154	harbor1	chr8	88450458	88451116	DNA/TcMar-Tigger	15978	+	329	88450787	92633
chr8	88358154	88558154	harbor1	chr8	88453487	88454000	DNA/TcMar-Tigger	15978	+	256	88453743	95589
chr8	88358154	88558154	harbor1	chr8	88454295	88455786	DNA/TcMar-Tigger	15978	+	746	88455041	96887
chr8	78952035	79152035	harbor1	chr8	78966938	78967977	DNA/TcMar-Tigger	5661	+	520	78967458	15423
chr8	78952035	79152035	harbor1	chr8	79040118	79040455	DNA/TcMar-Tigger	996	+	168	79040286	88251
chr8	77387935	77587935	harbor1	chr8	77415227	77416095	DNA/TcMar-Tigger	12531	+	434	77415661	27726
chr8	77387935	77587935	harbor1	chr8	77416406	77416838	DNA/TcMar-Tigger	12531	+	216	77416622	28687
chr8	77387935	77587935	harbor1	chr8	77417122	77418288	DNA/TcMar-Tigger	12531	+	583	77417705	29770
chr8	62486179	62686179	harbor1	chr8	62522146	62523368	DNA/TcMar-Tigger	7201	+	611	62522757	36578
chr8	128341596	128541596	harbor1	chr8	128368094	128368364	DNA/TcMar-Tigger	893	+	135	128368229	26633
chr8	128341596	128541596	harbor1	chr8	128401038	128401289	DNA/TcMar-Tigger	1170	+	126	128401164	59568
chr8	3736271	3936271	harbor1	chr8	3816279	3816525	DNA/TcMar-Tigger	1169	+	123	3816402	80131
chr8	3736271	3936271	harbor1	chr8	3816791	3816877	DNA/TcMar-Tigger	453	+	43	3816834	80563
chr8	93294409	93494409	harbor1	chr8	93304596	93305039	DNA/TcMar-Tigger	2363	+	222	93304818	10409
chr8	93294409	93494409	harbor1	chr8	93308858	93309107	DNA/TcMar-Tigger	504	+	124	93308982	14573
chr8	93294409	93494409	harbor1	chr8	93319239	93319422	DNA/TcMar-Tigger	2108	+	92	93319331	24922
chr8	93294409	93494409	harbor1	chr8	93319954	93320124	DNA/TcMar-Tigger	2108	+	85	93320039	25630
chr8	93294409	93494409	harbor1	chr8	93379912	93380655	DNA/TcMar-Tigger	6108	+	372	93380284	85875
chr8	93294409	93494409	harbor1	chr8	93382914	93383365	DNA/TcMar-Tigger	6108	+	226	93383140	88731
chr8	79008310	79208310	harbor1	chr8	79040118	79040455	DNA/TcMar-Tigger	996	+	168	79040286	31976
chr8	103375333	103575333	harbor1	chr8	103390463	103391048	DNA/TcMar-Tigger	3880	+	292	103390755	15422
chr8	103375333	103575333	harbor1	chr8	103475075	103475423	DNA/TcMar-Tigger	2089	+	174	103475249	99916
chr8	57857640	58057640	harbor1	chr8	57881326	57881757	DNA/TcMar-Tigger	2398	+	216	57881542	23902
chr8	57857640	58057640	harbor1	chr8	57910405	57910736	DNA/TcMar-Tigger	533	+	166	57910571	52931
chr8	111330827	111530827	harbor1	chr8	111393620	111393816	DNA/TcMar-Tigger	3790	+	98	111393718	62891
chr8	111330827	111530827	harbor1	chr8	111394391	111394882	DNA/TcMar-Tigger	3790	+	246	111394637	63810
chr8	19440273	19640273	harbor1	chr8	19460169	19460498	DNA/TcMar-Tigger	1324	+	164	19460333	20060
chr8	19440273	19640273	harbor1	chr8	19483892	19484409	DNA/TcMar-Tigger	1779	+	258	19484150	43877
chr8	135881308	136081308	harbor1	chr8	135949030	135949388	DNA/TcMar-Tigger	2091	+	179	135949209	67901
chr8	135881308	136081308	harbor1	chr8	135957639	135959716	DNA/TcMar-Tigger	13396	+	1038	135958677	77369
chr8	135881308	136081308	harbor1	chr8	135960034	135960358	DNA/TcMar-Tigger	13396	+	162	135960196	78888
chr8	135881308	136081308	harbor1	chr8	135937834	135938558	DNA/TcMar-Tigger	3541	+	362	135938196	56888
chr8	73540645	73740645	harbor1	chr8	73547926	73548135	DNA/TcMar-Tigger	1324	+	104	73548030	7385
chr8	73540645	73740645	harbor1	chr8	73555467	73555837	DNA/TcMar-Tigger	1145	+	185	73555652	15007
chr8	73540645	73740645	harbor1	chr8	73564690	73565125	DNA/TcMar-Tigger	5008	+	218	73564908	24263
chr8	73540645	73740645	harbor1	chr8	73565501	73565947	DNA/TcMar-Tigger	5008	+	223	73565724	25079
chr8	1334703	1534703	harbor1	chr8	1353280	1353637	DNA/TcMar-Tigger	1936	+	178	1353458	18755
chr8	131825492	132025492	harbor1	chr8	131922303	131922530	DNA/TcMar-Tigger	882	+	114	131922417	96925
chr8	50273379	50473379	harbor1	chr8	50346107	50347684	DNA/TcMar-Tigger	9318	+	788	50346895	73516
chr8	76303631	76503631	harbor1	chr8	76357173	76357420	DNA/TcMar-Tigger	684	+	124	76357297	53666
chr8	52734076	52934076	harbor1	chr8	52790226	52790452	DNA/TcMar-Tigger	912	+	113	52790339	56263
chr8	52734076	52934076	harbor1	chr8	52823528	52824415	DNA/TcMar-Tigger	3888	+	444	52823972	89896
chr8	17454242	17654242	harbor1	chr8	17482100	17483334	DNA/TcMar-Tigger	7431	+	617	17482717	28475
chr8	17454242	17654242	harbor1	chr8	17483335	17483394	DNA/TcMar-Tigger	440	+	30	17483365	29123
chr8	17454242	17654242	harbor1	chr8	17492137	17492453	DNA/TcMar-Tigger	1581	+	158	17492295	38053
chr8	29874083	30074083	harbor1	chr8	29935922	29937071	DNA/TcMar-Tigger	6495	+	574	29936496	62413
chr8	29874083	30074083	harbor1	chr8	29962632	29962714	DNA/TcMar-Tigger	1957	+	41	29962673	88590
chr8	29874083	30074083	harbor1	chr8	29963020	29963286	DNA/TcMar-Tigger	1957	+	133	29963153	89070
chr8	84654187	84854187	harbor1	chr8	84744862	84745064	DNA/TcMar-Tigger	1910	+	101	84744963	90776
chr8	84654187	84854187	harbor1	chr8	84745100	84745495	DNA/TcMar-Tigger	1910	+	198	84745298	91111
chr8	104035103	104235103	harbor1	chr8	104037826	104038102	DNA/TcMar-Tigger	1611	+	138	104037964	2861
chr8	104035103	104235103	harbor1	chr8	104068995	104069335	DNA/TcMar-Tigger	1851	+	170	104069165	34062
chr8	104035103	104235103	harbor1	chr8	104119627	104119905	DNA/TcMar-Tigger	641	+	139	104119766	84663
chr8	76446295	76646295	harbor1	chr8	76473565	76473914	DNA/TcMar-Tigger	1805	+	174	76473739	27444
chr8	17133482	17333482	harbor1	chr8	17205889	17206523	DNA/TcMar-Tigger	3409	+	317	17206206	72724
chr8	17133482	17333482	harbor1	chr8	17228488	17228575	DNA/TcMar-Tigger	483	+	44	17228532	95050
chr8	135118460	135318460	harbor1	chr8	135170053	135170311	DNA/TcMar-Tigger	719	+	129	135170182	51722
chr8	135118460	135318460	harbor1	chr8	135175854	135176113	DNA/TcMar-Tigger	1395	+	130	135175984	57524
chr8	135118460	135318460	harbor1	chr8	135176111	135176210	DNA/TcMar-Tigger	490	+	50	135176161	57701
chr8	62628898	62828898	harbor1	chr8	62629920	62630257	DNA/TcMar-Tigger	1769	+	168	62630088	1190
chr8	77528539	77728539	harbor1	chr8	77543295	77543382	DNA/TcMar-Tigger	599	+	44	77543339	14800
chr8	77528539	77728539	harbor1	chr8	77543380	77543472	DNA/TcMar-Tigger	450	+	46	77543426	14887
chr8	77528539	77728539	harbor1	chr8	77543638	77544391	DNA/TcMar-Tigger	3796	+	376	77544014	15475
chr8	144654869	144854869	harbor1	chr8	144657986	144658103	DNA/TcMar-Tigger	553	+	58	144658044	3175
chr8	144654869	144854869	harbor1	chr8	144658575	144658671	DNA/TcMar-Tigger	521	+	48	144658623	3754
chr8	111763340	111963340	harbor1	chr8	111767504	111767848	DNA/TcMar-Tigger	2184	+	172	111767676	4336
chr8	117678044	117878044	harbor1	chr8	117684079	117684438	DNA/TcMar-Tigger	2123	+	180	117684259	6215
chr8	117678044	117878044	harbor1	chr8	117736315	117736447	DNA/TcMar-Tigger	736	+	66	117736381	58337
chr8	110659949	110859949	harbor1	chr8	110668628	110669838	DNA/TcMar-Tigger	7008	+	605	110669233	9284
chr8	110659949	110859949	harbor1	chr8	110669848	110670807	DNA/TcMar-Tigger	5324	+	480	110670328	10379
chr8	110659949	110859949	harbor1	chr8	110676649	110676952	DNA/TcMar-Tigger	1511	+	152	110676801	16852
chr8	110659949	110859949	harbor1	chr8	110740575	110740869	DNA/TcMar-Tigger	1818	+	147	110740722	80773
chr8	110659949	110859949	harbor1	chr8	110743171	110743560	DNA/TcMar-Tigger	1242	+	194	110743365	83416
chr8	83516724	83716724	harbor1	chr8	83528597	83529291	DNA/TcMar-Tigger	2180	+	347	83528944	12220
chr8	60773684	60973684	harbor1	chr8	60824297	60824516	DNA/TcMar-Tigger	1266	+	110	60824407	50723
chr8	60773684	60973684	harbor1	chr8	60845506	60845605	DNA/TcMar-Tigger	445	+	50	60845556	71872
chr8	32578405	32778405	harbor1	chr8	32660091	32660308	DNA/TcMar-Tigger	1276	+	108	32660199	81794
chr8	109624787	109824787	harbor1	chr8	109700259	109700693	DNA/TcMar-Tigger	2554	+	217	109700476	75689
chr8	29643995	29843995	harbor1	chr8	29697681	29698266	DNA/TcMar-Tigger	3011	+	292	29697973	53978
chr8	76928466	77128466	harbor1	chr8	76946456	76947385	DNA/TcMar-Tigger	7629	+	464	76946920	18454
chr8	76928466	77128466	harbor1	chr8	76947508	76948061	DNA/TcMar-Tigger	7629	+	276	76947784	19318
chr8	76928466	77128466	harbor1	chr8	76948055	76948799	DNA/TcMar-Tigger	5249	+	372	76948427	19961
chr8	76928466	77128466	harbor1	chr8	76949100	76949229	DNA/TcMar-Tigger	5249	+	64	76949164	20698
chr8	76928466	77128466	harbor1	chr8	76990983	76991114	DNA/TcMar-Tigger	739	+	66	76991049	62583
chr8	52026599	52226599	harbor1	chr8	52037377	52037712	DNA/TcMar-Tigger	2004	+	168	52037545	10946
chr8	52026599	52226599	harbor1	chr8	52081933	52082142	DNA/TcMar-Tigger	1630	+	104	52082037	55438
chr8	52026599	52226599	harbor1	chr8	52082461	52082615	DNA/TcMar-Tigger	1630	+	77	52082538	55939
chr8	52026599	52226599	harbor1	chr8	52115390	52115731	DNA/TcMar-Tigger	1418	+	170	52115560	88961
chr8	92157200	92357200	harbor1	chr8	92198349	92199390	DNA/TcMar-Tigger	6070	+	520	92198869	41669
chr8	20032794	20232794	harbor1	chr8	20070930	20071204	DNA/TcMar-Tigger	1079	+	137	20071067	38273
chr8	20032794	20232794	harbor1	chr8	20071703	20072011	DNA/TcMar-Tigger	1773	+	154	20071857	39063
chr8	20032794	20232794	harbor1	chr8	20078970	20079675	DNA/TcMar-Tigger	3771	+	352	20079322	46528
chr8	20032794	20232794	harbor1	chr8	20098606	20098852	DNA/TcMar-Tigger	447	+	123	20098729	65935
chr8	101294461	101494461	harbor1	chr8	101351994	101352326	DNA/TcMar-Tigger	2041	+	166	101352160	57699
chr8	54682124	54882124	harbor1	chr8	54739224	54739310	DNA/TcMar-Tigger	463	+	43	54739267	57143
chr8	54682124	54882124	harbor1	chr8	54739767	54740442	DNA/TcMar-Tigger	6549	+	338	54740105	57981
chr8	54682124	54882124	harbor1	chr8	54740741	54740761	DNA/TcMar-Tigger	6549	+	10	54740751	58627
chr8	54682124	54882124	harbor1	chr8	54741050	54741641	DNA/TcMar-Tigger	6549	+	296	54741346	59222
chr8	54682124	54882124	harbor1	chr8	54751342	54751579	DNA/TcMar-Tigger	1259	+	118	54751460	69336
chr8	54682124	54882124	harbor1	chr8	54773895	54774172	DNA/TcMar-Tigger	432	+	138	54774033	91909
chr8	54682124	54882124	harbor1	chr8	54775950	54776208	DNA/TcMar-Tigger	906	+	129	54776079	93955
chr8	54682124	54882124	harbor1	chr8	54776483	54776578	DNA/TcMar-Tigger	906	+	48	54776531	94407
chr8	54682124	54882124	harbor1	chr8	54780522	54780836	DNA/TcMar-Tigger	1836	+	157	54780679	98555
chr8	104428048	104628048	harbor1	chr8	104455955	104456289	DNA/TcMar-Tigger	1915	+	167	104456122	28074
chr8	104428048	104628048	harbor1	chr8	104509283	104509965	DNA/TcMar-Tigger	4008	+	341	104509624	81576
chr8	104428048	104628048	harbor1	chr8	104510612	104510735	DNA/TcMar-Tigger	428	+	62	104510674	82626
chr8	104428048	104628048	harbor1	chr8	104515297	104515730	DNA/TcMar-Tigger	1028	+	216	104515513	87465
chr8	104428048	104628048	harbor1	chr8	104521176	104521335	DNA/TcMar-Tigger	476	+	80	104521256	93208
chr8	104428048	104628048	harbor1	chr8	104523110	104523965	DNA/TcMar-Tigger	5812	+	428	104523538	95490
chr8	104428048	104628048	harbor1	chr8	104524266	104524450	DNA/TcMar-Tigger	5812	+	92	104524358	96310
chr8	88643334	88843334	harbor1	chr8	88678119	88679126	DNA/TcMar-Tigger	5307	+	504	88678623	35289
chr8	88643334	88843334	harbor1	chr8	88711357	88711591	DNA/TcMar-Tigger	1131	+	117	88711474	68140
chr8	88643334	88843334	harbor1	chr8	88721132	88721306	DNA/TcMar-Tigger	591	+	87	88721219	77885
chr8	3478227	3678227	harbor1	chr8	3491683	3491818	DNA/TcMar-Tigger	719	+	68	3491751	13524
chr8	3478227	3678227	harbor1	chr8	3492391	3492915	DNA/TcMar-Tigger	719	+	262	3492653	14426
chr8	11429778	11629778	harbor1	chr8	11499071	11499394	DNA/TcMar-Tigger	1735	+	162	11499233	69455
chr8	77857681	78057681	harbor1	chr8	77870994	77871330	DNA/TcMar-Tigger	2095	+	168	77871162	13481
chr8	140997045	141197045	harbor1	chr8	140996114	140997657	DNA/TcMar-Tigger	12041	+	772	140996886	159
chr8	140997045	141197045	harbor1	chr8	140997951	140998050	DNA/TcMar-Tigger	12041	+	50	140998001	956
chr8	140997045	141197045	harbor1	chr8	141033631	141033962	DNA/TcMar-Tigger	1414	+	166	141033797	36752
chr8	138055735	138255735	harbor1	chr8	138064320	138064518	DNA/TcMar-Tigger	1003	+	99	138064419	8684
chr8	138055735	138255735	harbor1	chr8	138064521	138064666	DNA/TcMar-Tigger	707	+	72	138064593	8858
chr8	20069818	20269818	harbor1	chr8	20070930	20071204	DNA/TcMar-Tigger	1079	+	137	20071067	1249
chr8	20069818	20269818	harbor1	chr8	20071703	20072011	DNA/TcMar-Tigger	1773	+	154	20071857	2039
chr8	20069818	20269818	harbor1	chr8	20078970	20079675	DNA/TcMar-Tigger	3771	+	352	20079322	9504
chr8	20069818	20269818	harbor1	chr8	20098606	20098852	DNA/TcMar-Tigger	447	+	123	20098729	28911
chr8	20069818	20269818	harbor1	chr8	20161284	20161606	DNA/TcMar-Tigger	1335	+	161	20161445	91627
chr8	21177681	21377681	harbor1	chr8	21182364	21182634	DNA/TcMar-Tigger	458	+	135	21182499	4818
chr8	42859941	43059941	harbor1	chr8	42877882	42878040	DNA/TcMar-Tigger	916	+	79	42877961	18020
chr8	42859941	43059941	harbor1	chr8	42878077	42879370	DNA/TcMar-Tigger	12456	+	646	42878723	18782
chr8	42859941	43059941	harbor1	chr8	42879971	42880490	DNA/TcMar-Tigger	12456	+	260	42880231	20290
chr8	42859941	43059941	harbor1	chr8	42880783	42881110	DNA/TcMar-Tigger	12456	+	164	42880947	21006
chr8	42859941	43059941	harbor1	chr8	42899861	42900073	DNA/TcMar-Tigger	478	+	106	42899967	40026
chr8	42859941	43059941	harbor1	chr8	42955125	42955380	DNA/TcMar-Tigger	1008	+	128	42955253	95312
chr8	41187673	41387673	harbor1	chr8	41239088	41239398	DNA/TcMar-Tigger	1487	+	155	41239243	51570
chr8	41187673	41387673	harbor1	chr8	41238475	41238693	DNA/TcMar-Tigger	1346	+	109	41238584	50911
chr8	137611141	137811141	harbor1	chr8	137678158	137678491	DNA/TcMar-Tigger	1124	+	166	137678324	67183
chr8	137611141	137811141	harbor1	chr8	137679939	137680167	DNA/TcMar-Tigger	661	+	114	137680053	68912
chr8	82878747	83078747	harbor1	chr8	82959620	82959794	DNA/TcMar-Tigger	459	+	87	82959707	80960
chr8	122786357	122986357	harbor1	chr8	122815437	122815805	DNA/TcMar-Tigger	4258	+	184	122815621	29264
chr8	122786357	122986357	harbor1	chr8	122816099	122816418	DNA/TcMar-Tigger	4258	+	160	122816259	29902
chr8	119194882	119394882	harbor1	chr8	119268986	119269276	DNA/TcMar-Tigger	594	+	145	119269131	74249
chr8	35569946	35769946	harbor1	chr8	35587996	35588330	DNA/TcMar-Tigger	959	+	167	35588163	18217
chr8	97500299	97700299	harbor1	chr8	97555216	97555551	DNA/TcMar-Tigger	1404	+	168	97555384	55085
chr8	75529986	75729986	harbor1	chr8	75531596	75531885	DNA/TcMar-Tigger	825	+	144	75531740	1754
chr8	75529986	75729986	harbor1	chr8	75537094	75537229	DNA/TcMar-Tigger	713	+	68	75537162	7176
chr8	75529986	75729986	harbor1	chr8	75537545	75537970	DNA/TcMar-Tigger	713	+	212	75537757	7771
chr8	99593960	99793960	harbor1	chr8	99650798	99651129	DNA/TcMar-Tigger	1847	+	166	99650964	57004
chr8	87611523	87811523	harbor1	chr8	87694054	87694365	DNA/TcMar-Tigger	723	+	156	87694210	82687
chr8	114077220	114277220	harbor1	chr8	114137520	114137665	DNA/TcMar-Tigger	842	+	72	114137592	60372
chr8	114077220	114277220	harbor1	chr8	114173600	114173889	DNA/TcMar-Tigger	1307	+	144	114173744	96524
chr8	143355294	143555294	harbor1	chr8	143453965	143454073	DNA/TcMar-Tigger	1830	+	54	143454019	98725
chr8	143355294	143555294	harbor1	chr8	143454391	143454402	DNA/TcMar-Tigger	1830	+	6	143454397	99103
chr8	143355294	143555294	harbor1	chr8	143454711	143455008	DNA/TcMar-Tigger	1830	+	148	143454859	99565
chr8	1042909	1242909	harbor1	chr8	1050219	1050578	DNA/TcMar-Tigger	1690	+	180	1050399	7490
chr8	1042909	1242909	harbor1	chr8	1099914	1100120	DNA/TcMar-Tigger	1236	+	103	1100017	57108
chr8	1042909	1242909	harbor1	chr8	1128393	1128675	DNA/TcMar-Tigger	1072	+	141	1128534	85625
chr8	86417115	86617115	harbor1	chr8	86472213	86472393	DNA/TcMar-Tigger	1016	+	90	86472303	55188
chr8	86417115	86617115	harbor1	chr8	86472379	86473092	DNA/TcMar-Tigger	3784	+	356	86472735	55620
chr8	86417115	86617115	harbor1	chr8	86493610	86493957	DNA/TcMar-Tigger	2104	+	174	86493784	76669
chr8	43125137	43325137	harbor1	chr8	43164275	43164371	DNA/TcMar-Tigger	681	+	48	43164323	39186
chr8	43125137	43325137	harbor1	chr8	43165107	43165654	DNA/TcMar-Tigger	15571	+	274	43165381	40244
chr8	43125137	43325137	harbor1	chr8	43165964	43167698	DNA/TcMar-Tigger	15571	+	867	43166831	41694
chr8	139275775	139475775	harbor1	chr8	139328756	139329096	DNA/TcMar-Tigger	2053	+	170	139328926	53151
chr8	97567744	97767744	harbor1	chr8	97648983	97649205	DNA/TcMar-Tigger	1041	+	111	97649094	81350
chr9	3878977	4078977	harbor1	chr9	3925401	3925967	DNA/TcMar-Tigger	2746	+	283	3925684	46707
chr9	41505391	41705391	harbor1	chr9	41590596	41592627	DNA/TcMar-Tigger	14075	+	1016	41591612	86221
chr9	41505391	41705391	harbor1	chr9	41592931	41593255	DNA/TcMar-Tigger	14075	+	162	41593093	87702
chr9	41505391	41705391	harbor1	chr9	41593928	41594142	DNA/TcMar-Tigger	742	+	107	41594035	88644
chr9	121277845	121477845	harbor1	chr9	121291168	121291389	DNA/TcMar-Tigger	1036	+	110	121291278	13433
chr9	121277845	121477845	harbor1	chr9	121344683	121344967	DNA/TcMar-Tigger	592	+	142	121344825	66980
chr9	74190838	74390838	harbor1	chr9	74287550	74288118	DNA/TcMar-Tigger	1442	+	284	74287834	96996
chr9	32537660	32737660	harbor1	chr9	32564327	32564443	DNA/TcMar-Tigger	619	+	58	32564385	26725
chr9	32537660	32737660	harbor1	chr9	32567271	32567349	DNA/TcMar-Tigger	2038	+	39	32567310	29650
chr9	32537660	32737660	harbor1	chr9	32567625	32567934	DNA/TcMar-Tigger	2038	+	154	32567779	30119
chr9	32537660	32737660	harbor1	chr9	32568066	32568641	DNA/TcMar-Tigger	3575	+	288	32568354	30694
chr9	32537660	32737660	harbor1	chr9	32569049	32569211	DNA/TcMar-Tigger	1627	+	81	32569130	31470
chr9	32537660	32737660	harbor1	chr9	32569816	32570027	DNA/TcMar-Tigger	1627	+	106	32569922	32262
chr9	32537660	32737660	harbor1	chr9	32576495	32576657	DNA/TcMar-Tigger	1243	+	81	32576576	38916
chr9	32537660	32737660	harbor1	chr9	32577243	32577319	DNA/TcMar-Tigger	1243	+	38	32577281	39621
chr9	32537660	32737660	harbor1	chr9	32577760	32577847	DNA/TcMar-Tigger	1243	+	44	32577804	40144
chr9	123320832	123520832	harbor1	chr9	123409318	123409518	DNA/TcMar-Tigger	1152	+	100	123409418	88586
chr9	67017542	67217542	harbor1	chr9	67034728	67034893	DNA/TcMar-Tigger	458	+	82	67034810	17268
chr9	67017542	67217542	harbor1	chr9	67035186	67035225	DNA/TcMar-Tigger	458	+	20	67035206	17664
chr9	67017542	67217542	harbor1	chr9	67114370	67114679	DNA/TcMar-Tigger	604	+	154	67114524	96982
chr9	75220553	75420553	harbor1	chr9	75268790	75269192	DNA/TcMar-Tigger	2426	+	201	75268991	48438
chr9	75220553	75420553	harbor1	chr9	75278504	75278861	DNA/TcMar-Tigger	2169	+	178	75278682	58129
chr9	75220553	75420553	harbor1	chr9	75297190	75298314	DNA/TcMar-Tigger	4302	+	562	75297752	77199
chr9	72449973	72649973	harbor1	chr9	72458193	72458521	DNA/TcMar-Tigger	1195	+	164	72458357	8384
chr9	72449973	72649973	harbor1	chr9	72458533	72458880	DNA/TcMar-Tigger	862	+	174	72458707	8734
chr9	72449973	72649973	harbor1	chr9	72518756	72519304	DNA/TcMar-Tigger	835	+	274	72519030	69057
chr9	72449973	72649973	harbor1	chr9	72528869	72529217	DNA/TcMar-Tigger	1354	+	174	72529043	79070
chr9	85797048	85997048	harbor1	chr9	85813345	85813648	DNA/TcMar-Tigger	1552	+	152	85813497	16449
chr9	85797048	85997048	harbor1	chr9	85872899	85873229	DNA/TcMar-Tigger	2499	+	165	85873064	76016
chr9	85797048	85997048	harbor1	chr9	85873543	85873648	DNA/TcMar-Tigger	2499	+	52	85873595	76547
chr9	85797048	85997048	harbor1	chr9	85874377	85874404	DNA/TcMar-Tigger	2499	+	14	85874391	77343
chr9	6948458	7148458	harbor1	chr9	7009786	7010056	DNA/TcMar-Tigger	1332	+	135	7009921	61463
chr9	6948458	7148458	harbor1	chr9	7010064	7010189	DNA/TcMar-Tigger	754	+	62	7010126	61668
chr9	6948458	7148458	harbor1	chr9	7041094	7041425	DNA/TcMar-Tigger	1994	+	166	7041260	92802
chr9	76643690	76843690	harbor1	chr9	76652727	76652952	DNA/TcMar-Tigger	1281	+	112	76652839	9149
chr9	105625987	105825987	harbor1	chr9	105671807	105672201	DNA/TcMar-Tigger	1694	+	197	105672004	46017
chr9	105625987	105825987	harbor1	chr9	105708145	105708463	DNA/TcMar-Tigger	1211	+	159	105708304	82317
chr9	105625987	105825987	harbor1	chr9	105716599	105717048	DNA/TcMar-Tigger	2107	+	224	105716823	90836
chr9	7862446	8062446	harbor1	chr9	7923395	7923754	DNA/TcMar-Tigger	1602	+	180	7923575	61129
chr9	31297537	31497537	harbor1	chr9	31324369	31324495	DNA/TcMar-Tigger	563	+	63	31324432	26895
chr9	31297537	31497537	harbor1	chr9	31324498	31325254	DNA/TcMar-Tigger	4590	+	378	31324876	27339
chr9	31297537	31497537	harbor1	chr9	31325609	31325745	DNA/TcMar-Tigger	4590	+	68	31325677	28140
chr9	31297537	31497537	harbor1	chr9	31340548	31340890	DNA/TcMar-Tigger	1789	+	171	31340719	43182
chr9	66799737	66999737	harbor1	chr9	66817139	66817685	DNA/TcMar-Tigger	2490	+	273	66817412	17675
chr9	14383528	14583528	harbor1	chr9	14416141	14416241	DNA/TcMar-Tigger	540	+	50	14416191	32663
chr9	14383528	14583528	harbor1	chr9	14416245	14416885	DNA/TcMar-Tigger	5412	+	320	14416565	33037
chr9	14383528	14583528	harbor1	chr9	14417191	14417453	DNA/TcMar-Tigger	5412	+	131	14417322	33794
chr9	32971609	33171609	harbor1	chr9	32994498	32994728	DNA/TcMar-Tigger	1519	+	115	32994613	23004
chr9	32971609	33171609	harbor1	chr9	32994734	32995605	DNA/TcMar-Tigger	5790	+	436	32995170	23561
chr9	32971609	33171609	harbor1	chr9	32995909	32996223	DNA/TcMar-Tigger	1914	+	157	32996066	24457
chr9	32971609	33171609	harbor1	chr9	33032383	33032581	DNA/TcMar-Tigger	728	+	99	33032482	60873
chr9	32971609	33171609	harbor1	chr9	33040972	33041278	DNA/TcMar-Tigger	1270	+	153	33041125	69516
chr9	62360984	62560984	harbor1	chr9	62379704	62380029	DNA/TcMar-Tigger	1737	+	162	62379866	18882
chr9	41349679	41549679	harbor1	chr9	41405784	41406109	DNA/TcMar-Tigger	1828	+	162	41405946	56267
chr9	41349679	41549679	harbor1	chr9	41421880	41422128	DNA/TcMar-Tigger	842	+	124	41422004	72325
chr9	131943014	132143014	harbor1	chr9	131985414	131986353	DNA/TcMar-Tigger	6597	+	470	131985884	42870
chr9	131943014	132143014	harbor1	chr9	131986481	131986726	DNA/TcMar-Tigger	6597	+	122	131986603	43589
chr9	131943014	132143014	harbor1	chr9	131988345	131988636	DNA/TcMar-Tigger	1883	+	146	131988491	45477
chr9	131943014	132143014	harbor1	chr9	131988777	131988926	DNA/TcMar-Tigger	781	+	74	131988851	45837
chr9	131943014	132143014	harbor1	chr9	131993691	131994264	DNA/TcMar-Tigger	3618	+	286	131993977	50963
chr9	131943014	132143014	harbor1	chr9	131996658	131997063	DNA/TcMar-Tigger	2372	+	202	131996860	53846
chr9	131943014	132143014	harbor1	chr9	132027606	132027892	DNA/TcMar-Tigger	1194	+	143	132027749	84735
chr9	8361865	8561865	harbor1	chr9	8433088	8433975	DNA/TcMar-Tigger	5675	+	444	8433532	71667
chr9	8361865	8561865	harbor1	chr9	8434281	8434523	DNA/TcMar-Tigger	5675	+	121	8434402	72537
chr9	109934915	110134915	harbor1	chr9	110007365	110007670	DNA/TcMar-Tigger	737	+	152	110007517	72602
chr9	122915368	123115368	harbor1	chr9	122923808	122924140	DNA/TcMar-Tigger	2137	+	166	122923974	8606
chr9	122915368	123115368	harbor1	chr9	122969037	122969378	DNA/TcMar-Tigger	2138	+	170	122969207	53839
chr9	41143441	41343441	harbor1	chr9	41178003	41178555	DNA/TcMar-Tigger	12858	+	276	41178279	34838
chr9	41143441	41343441	harbor1	chr9	41178866	41180168	DNA/TcMar-Tigger	12858	+	651	41179517	36076
chr9	41143441	41343441	harbor1	chr9	41180330	41180444	DNA/TcMar-Tigger	691	+	57	41180387	36946
chr9	41143441	41343441	harbor1	chr9	41181832	41182059	DNA/TcMar-Tigger	1472	+	114	41181946	38505
chr9	26039697	26239697	harbor1	chr9	26131475	26131602	DNA/TcMar-Tigger	761	+	64	26131539	91842
chr9	26039697	26239697	harbor1	chr9	26133961	26134298	DNA/TcMar-Tigger	1812	+	168	26134129	94432
chr9	130699865	130899865	harbor1	chr9	130738529	130738657	DNA/TcMar-Tigger	659	+	64	130738593	38728
chr9	130699865	130899865	harbor1	chr9	130738656	130738792	DNA/TcMar-Tigger	707	+	68	130738724	38859
chr9	17040571	17240571	harbor1	chr9	17041379	17041758	DNA/TcMar-Tigger	1186	+	190	17041569	998
chr9	17040571	17240571	harbor1	chr9	17068139	17068256	DNA/TcMar-Tigger	399	+	58	17068197	27626
chr9	17040571	17240571	harbor1	chr9	17068555	17068686	DNA/TcMar-Tigger	399	+	66	17068621	28050
chr9	17040571	17240571	harbor1	chr9	17084711	17085233	DNA/TcMar-Tigger	2933	+	261	17084972	44401
chr9	17040571	17240571	harbor1	chr9	17086849	17086921	DNA/TcMar-Tigger	1624	+	36	17086885	46314
chr9	17040571	17240571	harbor1	chr9	17087214	17087467	DNA/TcMar-Tigger	1624	+	126	17087340	46769
chr9	17040571	17240571	harbor1	chr9	17111948	17112105	DNA/TcMar-Tigger	797	+	78	17112026	71455
chr9	17040571	17240571	harbor1	chr9	17112095	17112311	DNA/TcMar-Tigger	1316	+	108	17112203	71632
chr9	17040571	17240571	harbor1	chr9	17137846	17138138	DNA/TcMar-Tigger	571	+	146	17137992	97421
chr9	97571228	97771228	harbor1	chr9	97601729	97601961	DNA/TcMar-Tigger	1304	+	116	97601845	30617
chr9	97571228	97771228	harbor1	chr9	97619307	97619506	DNA/TcMar-Tigger	887	+	100	97619407	48179
chr9	97571228	97771228	harbor1	chr9	97619642	97619868	DNA/TcMar-Tigger	1057	+	113	97619755	48527
chr9	86211152	86411152	harbor1	chr9	86267856	86268687	DNA/TcMar-Tigger	4609	+	416	86268272	57120
chr9	86211152	86411152	harbor1	chr9	86271116	86271419	DNA/TcMar-Tigger	1218	+	152	86271268	60116
chr9	18536499	18736499	harbor1	chr9	18548074	18548715	DNA/TcMar-Tigger	3306	+	320	18548394	11895
chr9	63860389	64060389	harbor1	chr9	63865660	63865907	DNA/TcMar-Tigger	1342	+	124	63865784	5395
chr9	63860389	64060389	harbor1	chr9	63866178	63866620	DNA/TcMar-Tigger	1342	+	221	63866399	6010
chr9	93869689	94069689	harbor1	chr9	93890425	93890567	DNA/TcMar-Tigger	414	+	71	93890496	20807
chr9	101133813	101333813	harbor1	chr9	101224607	101224914	DNA/TcMar-Tigger	1335	+	154	101224761	90948
chr9	101133813	101333813	harbor1	chr9	101224917	101225139	DNA/TcMar-Tigger	1288	+	111	101225028	91215
chr9	23810440	24010440	harbor1	chr9	23816573	23816937	DNA/TcMar-Tigger	1845	+	182	23816755	6315
chr9	40090947	40290947	harbor1	chr9	40180586	40180774	DNA/TcMar-Tigger	452	+	94	40180680	89733
chr9	72955879	73155879	harbor1	chr9	72994924	72995677	DNA/TcMar-Tigger	4986	+	376	72995300	39421
chr9	72955879	73155879	harbor1	chr9	72995697	72995888	DNA/TcMar-Tigger	1050	+	96	72995793	39914
chr9	190239	390239	harbor1	chr9	221310	221529	DNA/TcMar-Tigger	1411	+	110	221420	31181
chr9	190239	390239	harbor1	chr9	270769	270950	DNA/TcMar-Tigger	531	+	90	270859	80620
chr9	190239	390239	harbor1	chr9	283247	283400	DNA/TcMar-Tigger	1868	+	76	283323	93084
chr9	190239	390239	harbor1	chr9	283752	283925	DNA/TcMar-Tigger	1868	+	86	283838	93599
chr9	70857209	71057209	harbor1	chr9	70907118	70907560	DNA/TcMar-Tigger	2937	+	221	70907339	50130
chr9	70857209	71057209	harbor1	chr9	70908083	70908305	DNA/TcMar-Tigger	2937	+	111	70908194	50985
chr9	76870660	77070660	harbor1	chr9	76871146	76871476	DNA/TcMar-Tigger	1929	+	165	76871311	651
chr9	86317097	86517097	harbor1	chr9	86316803	86317161	DNA/TcMar-Tigger	1132	+	179	86316982	115
chr9	27651942	27851942	harbor1	chr9	27652570	27653792	DNA/TcMar-Tigger	7230	+	611	27653181	1239
chr9	105410405	105610405	harbor1	chr9	105473335	105473692	DNA/TcMar-Tigger	679	+	178	105473513	63108
chr9	79499148	79699148	harbor1	chr9	79509770	79509854	DNA/TcMar-Tigger	1571	+	42	79509812	10664
chr9	79499148	79699148	harbor1	chr9	79510149	79510382	DNA/TcMar-Tigger	1571	+	116	79510265	11117
chr9	120887399	121087399	harbor1	chr9	120887677	120887764	DNA/TcMar-Tigger	514	+	44	120887721	322
chr9	120887399	121087399	harbor1	chr9	120887763	120887848	DNA/TcMar-Tigger	400	+	42	120887805	406
chr9	120887399	121087399	harbor1	chr9	120923903	120924219	DNA/TcMar-Tigger	958	+	158	120924061	36662
chr9	120887399	121087399	harbor1	chr9	120977091	120977446	DNA/TcMar-Tigger	2406	+	178	120977269	89870
chr9	106248553	106448553	harbor1	chr9	106305517	106306063	DNA/TcMar-Tigger	1355	+	273	106305790	57237
chr9	78886424	79086424	harbor1	chr9	78920545	78920901	DNA/TcMar-Tigger	1446	+	178	78920723	34299
chr9	97328355	97528355	harbor1	chr9	97425271	97425608	DNA/TcMar-Tigger	2168	+	168	97425439	97084
chr9	112346402	112546402	harbor1	chr9	112412026	112412224	DNA/TcMar-Tigger	1147	+	99	112412125	65723
chr9	67164397	67364397	harbor1	chr9	67230959	67231050	DNA/TcMar-Tigger	1543	+	46	67231005	66608
chr9	67164397	67364397	harbor1	chr9	67231382	67231637	DNA/TcMar-Tigger	1543	+	128	67231510	67113
chr9	26456896	26656896	harbor1	chr9	26527286	26527484	DNA/TcMar-Tigger	411	+	99	26527385	70489
chr9	124240361	124440361	harbor1	chr9	124278003	124278332	DNA/TcMar-Tigger	1535	+	164	124278167	37806
chr9	93111564	93311564	harbor1	chr9	93172278	93172556	DNA/TcMar-Tigger	1023	+	139	93172417	60853
chr9	65698429	65898429	harbor1	chr9	65725034	65725240	DNA/TcMar-Tigger	1182	+	103	65725137	26708
chr9	74556853	74756853	harbor1	chr9	74593490	74594054	DNA/TcMar-Tigger	846	+	282	74593772	36919
chr9	74556853	74756853	harbor1	chr9	74579867	74580180	DNA/TcMar-Tigger	1576	+	156	74580023	23170
chr9	73721646	73921646	harbor1	chr9	73724039	73724530	DNA/TcMar-Tigger	2422	+	246	73724285	2639
chr9	73721646	73921646	harbor1	chr9	73782202	73782685	DNA/TcMar-Tigger	2131	+	242	73782444	60798
chr9	27511039	27711039	harbor1	chr9	27568570	27568703	DNA/TcMar-Tigger	645	+	66	27568636	57597
chr9	27511039	27711039	harbor1	chr9	27568697	27569193	DNA/TcMar-Tigger	2628	+	248	27568945	57906
chr9	27511039	27711039	harbor1	chr9	27569237	27569676	DNA/TcMar-Tigger	2832	+	220	27569457	58418
chr9	120415038	120615038	harbor1	chr9	120505057	120507296	DNA/TcMar-Tigger	14910	+	1120	120506177	91139
chr9	30261974	30461974	harbor1	chr9	30316956	30318166	DNA/TcMar-Tigger	6499	+	605	30317561	55587
chr9	30261974	30461974	harbor1	chr9	30318816	30319297	DNA/TcMar-Tigger	2707	+	240	30319056	57082
chr9	13314251	13514251	harbor1	chr9	13324564	13324890	DNA/TcMar-Tigger	1347	+	163	13324727	10476
chr9	106781833	106981833	harbor1	chr9	106782813	106782915	DNA/TcMar-Tigger	624	+	51	106782864	1031
chr9	106781833	106981833	harbor1	chr9	106782917	106783661	DNA/TcMar-Tigger	4284	+	372	106783289	1456
chr9	106781833	106981833	harbor1	chr9	106850137	106850583	DNA/TcMar-Tigger	2211	+	223	106850360	68527
chr9	108540714	108740714	harbor1	chr9	108622362	108622823	DNA/TcMar-Tigger	1503	+	230	108622592	81878
chr9	118902974	119102974	harbor1	chr9	118981026	118981333	DNA/TcMar-Tigger	1253	+	154	118981180	78206
chr9	118902974	119102974	harbor1	chr9	118947517	118948099	DNA/TcMar-Tigger	3160	+	291	118947808	44834
chr9	113858073	114058073	harbor1	chr9	113860976	113861116	DNA/TcMar-Tigger	492	+	70	113861046	2973
chr9	113858073	114058073	harbor1	chr9	113916681	113916917	DNA/TcMar-Tigger	831	+	118	113916799	58726
chr9	123686554	123886554	harbor1	chr9	123720722	123720904	DNA/TcMar-Tigger	429	+	91	123720813	34259
chr9	123686554	123886554	harbor1	chr9	123755588	123755907	DNA/TcMar-Tigger	2067	+	160	123755748	69194
chr9	123686554	123886554	harbor1	chr9	123756212	123756306	DNA/TcMar-Tigger	2067	+	47	123756259	69705
chr9	65508840	65708840	harbor1	chr9	65521316	65521627	DNA/TcMar-Tigger	1523	+	156	65521472	12632
chr9	65508840	65708840	harbor1	chr9	65583478	65583891	DNA/TcMar-Tigger	2027	+	206	65583684	74844
chr9	93089236	93289236	harbor1	chr9	93172278	93172556	DNA/TcMar-Tigger	1023	+	139	93172417	83181
chr9	119951073	120151073	harbor1	chr9	119990786	119991087	DNA/TcMar-Tigger	1570	+	150	119990936	39863
chr9	94045412	94245412	harbor1	chr9	94056240	94056391	DNA/TcMar-Tigger	425	+	76	94056316	10904
chr9	20513613	20713613	harbor1	chr9	20575371	20575437	DNA/TcMar-Tigger	396	+	33	20575404	61791
chr9	100146880	100346880	harbor1	chr9	100171128	100171492	DNA/TcMar-Tigger	1818	+	182	100171310	24430
chr9	100146880	100346880	harbor1	chr9	100221715	100222032	DNA/TcMar-Tigger	1895	+	158	100221873	74993
chr9	72678200	72878200	harbor1	chr9	72697077	72697228	DNA/TcMar-Tigger	428	+	76	72697153	18953
chr9	98099239	98299239	harbor1	chr9	98183546	98183677	DNA/TcMar-Tigger	1259	+	66	98183612	84373
chr9	98099239	98299239	harbor1	chr9	98183966	98184167	DNA/TcMar-Tigger	1259	+	100	98184066	84827
chr9	108937191	109137191	harbor1	chr9	108940065	108940300	DNA/TcMar-Tigger	1021	+	118	108940183	2992
chr9	39493110	39693110	harbor1	chr9	39561457	39561774	DNA/TcMar-Tigger	1601	+	158	39561615	68505
chr9	39493110	39693110	harbor1	chr9	39562633	39562684	DNA/TcMar-Tigger	1601	+	26	39562659	69549
chr9	108657153	108857153	harbor1	chr9	108664982	108665334	DNA/TcMar-Tigger	559	+	176	108665158	8005
chr9	108657153	108857153	harbor1	chr9	108702091	108702438	DNA/TcMar-Tigger	1606	+	174	108702265	45112
chr9	11326079	11526079	harbor1	chr9	11338307	11338615	DNA/TcMar-Tigger	1467	+	154	11338461	12382
chr9	11326079	11526079	harbor1	chr9	11357010	11357398	DNA/TcMar-Tigger	500	+	194	11357204	31125
chr9	11326079	11526079	harbor1	chr9	11358261	11358364	DNA/TcMar-Tigger	520	+	52	11358313	32234
chr9	11326079	11526079	harbor1	chr9	11358375	11358942	DNA/TcMar-Tigger	3107	+	284	11358659	32580
chr9	11326079	11526079	harbor1	chr9	11378812	11379155	DNA/TcMar-Tigger	1563	+	172	11378984	52905
chr9	9228833	9428833	harbor1	chr9	9312395	9313231	DNA/TcMar-Tigger	4596	+	418	9312813	83980
chr9	9228833	9428833	harbor1	chr9	9322689	9322889	DNA/TcMar-Tigger	618	+	100	9322789	93956
chr9	82655761	82855761	harbor1	chr9	82673006	82673761	DNA/TcMar-Tigger	3822	+	378	82673384	17623
chr9	63594163	63794163	harbor1	chr9	63608740	63608953	DNA/TcMar-Tigger	1166	+	106	63608846	14683
chr9	63594163	63794163	harbor1	chr9	63667074	63667663	DNA/TcMar-Tigger	2966	+	294	63667368	73205
chr9	63594163	63794163	harbor1	chr9	63676966	63677307	DNA/TcMar-Tigger	497	+	170	63677136	82973
chr9	128642363	128842363	harbor1	chr9	128644670	128645068	DNA/TcMar-Tigger	6226	+	199	128644869	2506
chr9	128642363	128842363	harbor1	chr9	128645644	128646203	DNA/TcMar-Tigger	6226	+	280	128645924	3561
chr9	128642363	128842363	harbor1	chr9	128646507	128646701	DNA/TcMar-Tigger	6226	+	97	128646604	4241
chr9	128642363	128842363	harbor1	chr9	128696697	128696967	DNA/TcMar-Tigger	605	+	135	128696832	54469
chr9	79993953	80193953	harbor1	chr9	80039020	80039516	DNA/TcMar-Tigger	584	+	248	80039268	45315
chr9	6838994	7038994	harbor1	chr9	6849901	6850242	DNA/TcMar-Tigger	1731	+	170	6850071	11077
chr9	124251548	124451548	harbor1	chr9	124278003	124278332	DNA/TcMar-Tigger	1535	+	164	124278167	26619
chr9	14161184	14361184	harbor1	chr9	14224467	14224796	DNA/TcMar-Tigger	1662	+	164	14224631	63447
chr9	14161184	14361184	harbor1	chr9	14259141	14259309	DNA/TcMar-Tigger	562	+	84	14259225	98041
chr9	109147291	109347291	harbor1	chr9	109172548	109172848	DNA/TcMar-Tigger	1117	+	150	109172698	25407
chr9	447793	647793	harbor1	chr9	454202	454497	DNA/TcMar-Tigger	1556	+	148	454350	6557
chr9	447793	647793	harbor1	chr9	482813	483273	DNA/TcMar-Tigger	2454	+	230	483043	35250
chr9	447793	647793	harbor1	chr9	487174	487525	DNA/TcMar-Tigger	2223	+	176	487350	39557
chr9	31039427	31239427	harbor1	chr9	31062638	31063029	DNA/TcMar-Tigger	1651	+	196	31062834	23407
chr9	31039427	31239427	harbor1	chr9	31109452	31110044	DNA/TcMar-Tigger	3135	+	296	31109748	70321
chr9	31039427	31239427	harbor1	chr9	31118613	31119209	DNA/TcMar-Tigger	2963	+	298	31118911	79484
chr9	77307523	77507523	harbor1	chr9	77342248	77342370	DNA/TcMar-Tigger	589	+	61	77342309	34786
chr9	77307523	77507523	harbor1	chr9	77342365	77342794	DNA/TcMar-Tigger	2779	+	214	77342579	35056
chr9	77307523	77507523	harbor1	chr9	77401748	77402059	DNA/TcMar-Tigger	1583	+	156	77401904	94381
chr9	119394101	119594101	harbor1	chr9	119467208	119468389	DNA/TcMar-Tigger	6317	+	590	119467798	73697
chr9	112822031	113022031	harbor1	chr9	112822650	112823091	DNA/TcMar-Tigger	1600	+	220	112822870	839
chr9	112822031	113022031	harbor1	chr9	112823170	112823295	DNA/TcMar-Tigger	804	+	62	112823232	1201
chr9	112822031	113022031	harbor1	chr9	112828171	112828500	DNA/TcMar-Tigger	2005	+	164	112828335	6304
chr9	112822031	113022031	harbor1	chr9	112852316	112852523	DNA/TcMar-Tigger	1054	+	104	112852420	30389
chr9	112822031	113022031	harbor1	chr9	112907984	112908291	DNA/TcMar-Tigger	1201	+	154	112908138	86107
chr9	13144466	13344466	harbor1	chr9	13160703	13160830	DNA/TcMar-Tigger	1887	+	64	13160767	16301
chr9	13144466	13344466	harbor1	chr9	13160871	13161065	DNA/TcMar-Tigger	1887	+	97	13160968	16502
chr9	13144466	13344466	harbor1	chr9	13222906	13223204	DNA/TcMar-Tigger	1193	+	149	13223055	78589
chr9	13144466	13344466	harbor1	chr9	13225140	13225310	DNA/TcMar-Tigger	838	+	85	13225225	80759
chr9	13144466	13344466	harbor1	chr9	13225446	13225798	DNA/TcMar-Tigger	2248	+	176	13225622	81156
chr9	24632905	24832905	harbor1	chr9	24681676	24681748	DNA/TcMar-Tigger	397	+	36	24681712	48807
chr9	131695081	131895081	harbor1	chr9	131721651	131721972	DNA/TcMar-Tigger	1916	+	160	131721811	26730
chr9	131695081	131895081	harbor1	chr9	131723995	131724205	DNA/TcMar-Tigger	598	+	105	131724100	29019
chr9	31249949	31449949	harbor1	chr9	31324369	31324495	DNA/TcMar-Tigger	563	+	63	31324432	74483
chr9	31249949	31449949	harbor1	chr9	31324498	31325254	DNA/TcMar-Tigger	4590	+	378	31324876	74927
chr9	31249949	31449949	harbor1	chr9	31325609	31325745	DNA/TcMar-Tigger	4590	+	68	31325677	75728
chr9	31249949	31449949	harbor1	chr9	31340548	31340890	DNA/TcMar-Tigger	1789	+	171	31340719	90770
chr9	41143431	41343431	harbor1	chr9	41178003	41178555	DNA/TcMar-Tigger	12858	+	276	41178279	34848
chr9	41143431	41343431	harbor1	chr9	41178866	41180168	DNA/TcMar-Tigger	12858	+	651	41179517	36086
chr9	41143431	41343431	harbor1	chr9	41180330	41180444	DNA/TcMar-Tigger	691	+	57	41180387	36956
chr9	41143431	41343431	harbor1	chr9	41181832	41182059	DNA/TcMar-Tigger	1472	+	114	41181946	38515
chr9	80880506	81080506	harbor1	chr9	80907442	80907797	DNA/TcMar-Tigger	1722	+	178	80907620	27114
chr9	80880506	81080506	harbor1	chr9	80950676	80951029	DNA/TcMar-Tigger	1385	+	176	80950852	70346
chr9	62866671	63066671	harbor1	chr9	62896328	62896857	DNA/TcMar-Tigger	2869	+	264	62896592	29921
chr9	32301727	32501727	harbor1	chr9	32304697	32304932	DNA/TcMar-Tigger	1346	+	118	32304815	3088
chr9	95355105	95555105	harbor1	chr9	95392962	95393231	DNA/TcMar-Tigger	1526	+	134	95393096	37991
chr9	95355105	95555105	harbor1	chr9	95393230	95393318	DNA/TcMar-Tigger	573	+	44	95393274	38169
chr9	95355105	95555105	harbor1	chr9	95414982	95415075	DNA/TcMar-Tigger	503	+	46	95415028	59923
chr9	95355105	95555105	harbor1	chr9	95415110	95415195	DNA/TcMar-Tigger	492	+	42	95415152	60047
chr9	474364	674364	harbor1	chr9	482813	483273	DNA/TcMar-Tigger	2454	+	230	483043	8679
chr9	474364	674364	harbor1	chr9	487174	487525	DNA/TcMar-Tigger	2223	+	176	487350	12986
chr9	10057263	10257263	harbor1	chr9	10145319	10145702	DNA/TcMar-Tigger	2325	+	192	10145511	88248
chr9	88019469	88219469	harbor1	chr9	88030017	88030039	DNA/TcMar-Tigger	1215	+	11	88030028	10559
chr9	88019469	88219469	harbor1	chr9	88030324	88030564	DNA/TcMar-Tigger	1215	+	120	88030444	10975
chr9	88019469	88219469	harbor1	chr9	88030552	88030686	DNA/TcMar-Tigger	800	+	67	88030619	11150
chr9	75813361	76013361	harbor1	chr9	75871893	75872303	DNA/TcMar-Tigger	1619	+	205	75872098	58737
chr9	75813361	76013361	harbor1	chr9	75882439	75882760	DNA/TcMar-Tigger	1514	+	160	75882599	69238
chr9	75813361	76013361	harbor1	chr9	75898087	75898309	DNA/TcMar-Tigger	584	+	111	75898198	84837
chr9	76830450	77030450	harbor1	chr9	76871146	76871476	DNA/TcMar-Tigger	1929	+	165	76871311	40861
chr9	115314293	115514293	harbor1	chr9	115314617	115314800	DNA/TcMar-Tigger	825	+	92	115314709	416
chr9	26135317	26335317	harbor1	chr9	26179886	26180156	DNA/TcMar-Tigger	542	+	135	26180021	44704
chr9	25089687	25289687	harbor1	chr9	25136580	25136933	DNA/TcMar-Tigger	1851	+	176	25136756	47069
chr9	26046237	26246237	harbor1	chr9	26131475	26131602	DNA/TcMar-Tigger	761	+	64	26131539	85302
chr9	26046237	26246237	harbor1	chr9	26133961	26134298	DNA/TcMar-Tigger	1812	+	168	26134129	87892
chr9	94328521	94528521	harbor1	chr9	94407751	94408048	DNA/TcMar-Tigger	1483	+	148	94407899	79378
chr9	94328521	94528521	harbor1	chr9	94408228	94408333	DNA/TcMar-Tigger	427	+	52	94408280	79759
chr9	94328521	94528521	harbor1	chr9	94408334	94408410	DNA/TcMar-Tigger	455	+	38	94408372	79851
chr9	83911096	84111096	harbor1	chr9	83912145	83912277	DNA/TcMar-Tigger	408	+	66	83912211	1115
chr9	83911096	84111096	harbor1	chr9	84000226	84000464	DNA/TcMar-Tigger	1220	+	119	84000345	89249
chr9	83911096	84111096	harbor1	chr9	84000467	84000556	DNA/TcMar-Tigger	433	+	44	84000511	89415
chr9	72928890	73128890	harbor1	chr9	72994924	72995677	DNA/TcMar-Tigger	4986	+	376	72995300	66410
chr9	72928890	73128890	harbor1	chr9	72995697	72995888	DNA/TcMar-Tigger	1050	+	96	72995793	66903
chr9	108094146	108294146	harbor1	chr9	108114473	108114854	DNA/TcMar-Tigger	1986	+	190	108114663	20517
chr9	108094146	108294146	harbor1	chr9	108170435	108170519	DNA/TcMar-Tigger	532	+	42	108170477	76331
chr9	108094146	108294146	harbor1	chr9	108170683	108170925	DNA/TcMar-Tigger	1598	+	121	108170804	76658
chr9	108094146	108294146	harbor1	chr9	108175026	108175340	DNA/TcMar-Tigger	940	+	157	108175183	81037
chr9	69667227	69867227	harbor1	chr9	69719631	69721985	DNA/TcMar-Tigger	15501	+	1177	69720808	53581
chr9	111742767	111942767	harbor1	chr9	111743278	111743829	DNA/TcMar-Tigger	2941	+	276	111743554	787
chr9	111742767	111942767	harbor1	chr9	111763961	111764458	DNA/TcMar-Tigger	2333	+	248	111764209	21442
chr9	111742767	111942767	harbor1	chr9	111786457	111786503	DNA/TcMar-Tigger	1551	+	23	111786480	43713
chr9	111742767	111942767	harbor1	chr9	111786529	111786785	DNA/TcMar-Tigger	1551	+	128	111786657	43890
chr9	111742767	111942767	harbor1	chr9	111788410	111788494	DNA/TcMar-Tigger	452	+	42	111788452	45685
chr9	111742767	111942767	harbor1	chr9	111790951	111791302	DNA/TcMar-Tigger	1717	+	176	111791127	48360
chr9	111742767	111942767	harbor1	chr9	111786783	111788064	DNA/TcMar-Tigger	7844	+	640	111787423	44656
chr9	9084854	9284854	harbor1	chr9	9139209	9139410	DNA/TcMar-Tigger	1016	+	100	9139309	54455
chr9	432916	632916	harbor1	chr9	454202	454497	DNA/TcMar-Tigger	1556	+	148	454350	21434
chr9	432916	632916	harbor1	chr9	482813	483273	DNA/TcMar-Tigger	2454	+	230	483043	50127
chr9	432916	632916	harbor1	chr9	487174	487525	DNA/TcMar-Tigger	2223	+	176	487350	54434
chr9	12780629	12980629	harbor1	chr9	12877164	12877815	DNA/TcMar-Tigger	3970	+	326	12877490	96861
chr9	12780629	12980629	harbor1	chr9	12877812	12878059	DNA/TcMar-Tigger	1227	+	124	12877936	97307
chr9	74478044	74678044	harbor1	chr9	74537733	74538307	DNA/TcMar-Tigger	3384	+	287	74538020	59976
chr9	60722568	60922568	harbor1	chr9	60762115	60762356	DNA/TcMar-Tigger	1089	+	120	60762235	39667
chr9	60722568	60922568	harbor1	chr9	60762591	60762988	DNA/TcMar-Tigger	2414	+	198	60762789	40221
chr9	91546426	91746426	harbor1	chr9	91551780	91552097	DNA/TcMar-Tigger	1431	+	158	91551938	5512
chr9	91546426	91746426	harbor1	chr9	91556982	91557253	DNA/TcMar-Tigger	665	+	136	91557118	10692
chr9	91546426	91746426	harbor1	chr9	91592825	91593098	DNA/TcMar-Tigger	1684	+	136	91592961	46535
chr9	91546426	91746426	harbor1	chr9	91593387	91593435	DNA/TcMar-Tigger	1684	+	24	91593411	46985
chr9	91546426	91746426	harbor1	chr9	91620905	91621131	DNA/TcMar-Tigger	1221	+	113	91621018	74592
chr9	113481905	113681905	harbor1	chr9	113547735	113548050	DNA/TcMar-Tigger	669	+	158	113547893	65988
chr9	105298239	105498239	harbor1	chr9	105342124	105342383	DNA/TcMar-Tigger	1416	+	130	105342254	44015
chr9	105298239	105498239	harbor1	chr9	105342383	105342477	DNA/TcMar-Tigger	551	+	47	105342430	44191
chr9	116109417	116309417	harbor1	chr9	116127656	116127848	DNA/TcMar-Tigger	1054	+	96	116127752	18335
chr9	20992485	21192485	harbor1	chr9	21078252	21078584	DNA/TcMar-Tigger	1082	+	166	21078418	85933
chr9	20992485	21192485	harbor1	chr9	21088630	21089400	DNA/TcMar-Tigger	5019	+	385	21089015	96530
chr9	17836564	18036564	harbor1	chr9	17927512	17927839	DNA/TcMar-Tigger	1790	+	164	17927676	91112
chr9	63056402	63256402	harbor1	chr9	63111621	63111821	DNA/TcMar-Tigger	1128	+	100	63111721	55319
chr9	63056402	63256402	harbor1	chr9	63147769	63147945	DNA/TcMar-Tigger	916	+	88	63147857	91455
chr9	12488388	12688388	harbor1	chr9	12523602	12525157	DNA/TcMar-Tigger	9829	+	778	12524380	35992
chr9	23772158	23972158	harbor1	chr9	23791982	23792348	DNA/TcMar-Tigger	1931	+	183	23792165	20007
chr9	23772158	23972158	harbor1	chr9	23816573	23816937	DNA/TcMar-Tigger	1845	+	182	23816755	44597
chr9	103556930	103756930	harbor1	chr9	103604279	103605344	DNA/TcMar-Tigger	4263	+	532	103604811	47881
chr9	103556930	103756930	harbor1	chr9	103622500	103622937	DNA/TcMar-Tigger	2511	+	218	103622718	65788
chr9	64654454	64854454	harbor1	chr9	64732718	64733033	DNA/TcMar-Tigger	1394	+	158	64732876	78422
chr9	112735163	112935163	harbor1	chr9	112822650	112823091	DNA/TcMar-Tigger	1600	+	220	112822870	87707
chr9	112735163	112935163	harbor1	chr9	112823170	112823295	DNA/TcMar-Tigger	804	+	62	112823232	88069
chr9	112735163	112935163	harbor1	chr9	112828171	112828500	DNA/TcMar-Tigger	2005	+	164	112828335	93172
chr9	14323030	14523030	harbor1	chr9	14416141	14416241	DNA/TcMar-Tigger	540	+	50	14416191	93161
chr9	14323030	14523030	harbor1	chr9	14416245	14416885	DNA/TcMar-Tigger	5412	+	320	14416565	93535
chr9	14323030	14523030	harbor1	chr9	14417191	14417453	DNA/TcMar-Tigger	5412	+	131	14417322	94292
chr9	3155861	3355861	harbor1	chr9	3182907	3183014	DNA/TcMar-Tigger	476	+	54	3182961	27100
chr9	105467404	105667404	harbor1	chr9	105473335	105473692	DNA/TcMar-Tigger	679	+	178	105473513	6109
chr9	105467404	105667404	harbor1	chr9	105550435	105550626	DNA/TcMar-Tigger	491	+	96	105550531	83127
chr9	105467404	105667404	harbor1	chr9	105555420	105555938	DNA/TcMar-Tigger	1056	+	259	105555679	88275
chr9	75434788	75634788	harbor1	chr9	75473393	75473547	DNA/TcMar-Tigger	798	+	77	75473470	38682
chr9	75434788	75634788	harbor1	chr9	75473537	75473741	DNA/TcMar-Tigger	841	+	102	75473639	38851
chr9	75434788	75634788	harbor1	chr9	75520721	75521196	DNA/TcMar-Tigger	1260	+	238	75520959	86171
chr9	98084017	98284017	harbor1	chr9	98183546	98183677	DNA/TcMar-Tigger	1259	+	66	98183612	99595
chr9	5555290	5755290	harbor1	chr9	5646338	5646482	DNA/TcMar-Tigger	465	+	72	5646410	91120
chr9	5555290	5755290	harbor1	chr9	5646479	5646738	DNA/TcMar-Tigger	1375	+	130	5646609	91319
chr9	60723286	60923286	harbor1	chr9	60762115	60762356	DNA/TcMar-Tigger	1089	+	120	60762235	38949
chr9	60723286	60923286	harbor1	chr9	60762591	60762988	DNA/TcMar-Tigger	2414	+	198	60762789	39503
chr9	68215703	68415703	harbor1	chr9	68290963	68291170	DNA/TcMar-Tigger	1219	+	104	68291067	75364
chr9	37236790	37436790	harbor1	chr9	37299855	37300092	DNA/TcMar-Tigger	1255	+	118	37299973	63183
chr9	117301944	117501944	harbor1	chr9	117396261	117396508	DNA/TcMar-Tigger	2028	+	124	117396385	94441
chr9	117301944	117501944	harbor1	chr9	117397279	117397771	DNA/TcMar-Tigger	2028	+	246	117397525	95581
chr9	75741255	75941255	harbor1	chr9	75747393	75747487	DNA/TcMar-Tigger	419	+	47	75747440	6185
chr9	75741255	75941255	harbor1	chr9	75803123	75803530	DNA/TcMar-Tigger	2151	+	204	75803327	62072
chr9	75741255	75941255	harbor1	chr9	75803648	75803862	DNA/TcMar-Tigger	1170	+	107	75803755	62500
chr9	37541398	37741398	harbor1	chr9	37582262	37582458	DNA/TcMar-Tigger	414	+	98	37582360	40962
chr9	105618764	105818764	harbor1	chr9	105671807	105672201	DNA/TcMar-Tigger	1694	+	197	105672004	53240
chr9	105618764	105818764	harbor1	chr9	105708145	105708463	DNA/TcMar-Tigger	1211	+	159	105708304	89540
chr9	105618764	105818764	harbor1	chr9	105716599	105717048	DNA/TcMar-Tigger	2107	+	224	105716823	98059
chr9	109821310	110021310	harbor1	chr9	109829919	109830269	DNA/TcMar-Tigger	560	+	175	109830094	8784
chr9	83038004	83238004	harbor1	chr9	83046289	83046466	DNA/TcMar-Tigger	523	+	88	83046377	8373
chr9	8915027	9115027	harbor1	chr9	8997216	8999635	DNA/TcMar-Tigger	15018	+	1210	8998426	83399
chr9	5897981	6097981	harbor1	chr9	5932394	5932698	DNA/TcMar-Tigger	1750	+	152	5932546	34565
chr9	5897981	6097981	harbor1	chr9	5942190	5942386	DNA/TcMar-Tigger	565	+	98	5942288	44307
chr9	5897981	6097981	harbor1	chr9	5965391	5965710	DNA/TcMar-Tigger	572	+	160	5965551	67570
chr9	77720294	77920294	harbor1	chr9	77759513	77759742	DNA/TcMar-Tigger	419	+	114	77759627	39333
chr9	77720294	77920294	harbor1	chr9	77763490	77763610	DNA/TcMar-Tigger	442	+	60	77763550	43256
chr9	77720294	77920294	harbor1	chr9	77777220	77777331	DNA/TcMar-Tigger	409	+	56	77777276	56982
chr9	69483863	69683863	harbor1	chr9	69487821	69488575	DNA/TcMar-Tigger	1249	+	377	69488198	4335
chr9	69483863	69683863	harbor1	chr9	69518168	69518356	DNA/TcMar-Tigger	1075	+	94	69518262	34399
chr9	62370764	62570764	harbor1	chr9	62379704	62380029	DNA/TcMar-Tigger	1737	+	162	62379866	9102
chr9	95957197	96157197	harbor1	chr9	95962800	95962882	DNA/TcMar-Tigger	403	+	41	95962841	5644
chr9	95957197	96157197	harbor1	chr9	95995545	95996949	DNA/TcMar-Tigger	8724	+	702	95996247	39050
chr9	95957197	96157197	harbor1	chr9	95997088	95997553	DNA/TcMar-Tigger	3098	+	232	95997320	40123
chr9	95957197	96157197	harbor1	chr9	95997550	95997676	DNA/TcMar-Tigger	611	+	63	95997613	40416
chr9	17948640	18148640	harbor1	chr9	17955455	17955730	DNA/TcMar-Tigger	1427	+	138	17955593	6953
chr9	17948640	18148640	harbor1	chr9	17955705	17955908	DNA/TcMar-Tigger	945	+	102	17955807	7167
chr9	28274486	28474486	harbor1	chr9	28277040	28277521	DNA/TcMar-Tigger	7883	+	240	28277280	2794
chr9	28274486	28474486	harbor1	chr9	28360926	28361430	DNA/TcMar-Tigger	2562	+	252	28361178	86692
chr9	28274486	28474486	harbor1	chr9	28277859	28279742	DNA/TcMar-Tigger	14361	+	942	28278801	4315
chr9	79489472	79689472	harbor1	chr9	79509770	79509854	DNA/TcMar-Tigger	1571	+	42	79509812	20340
chr9	79489472	79689472	harbor1	chr9	79510149	79510382	DNA/TcMar-Tigger	1571	+	116	79510265	20793
chr9	104583925	104783925	harbor1	chr9	104612803	104613089	DNA/TcMar-Tigger	1673	+	143	104612946	29021
chr9	20309483	20509483	harbor1	chr9	20357568	20357896	DNA/TcMar-Tigger	537	+	164	20357732	48249
chr9	20309483	20509483	harbor1	chr9	20370164	20370516	DNA/TcMar-Tigger	14732	+	176	20370340	60857
chr9	20309483	20509483	harbor1	chr9	20370806	20372392	DNA/TcMar-Tigger	14732	+	793	20371599	62116
chr9	20309483	20509483	harbor1	chr9	20372708	20373034	DNA/TcMar-Tigger	14732	+	163	20372871	63388
chr9	80077245	80277245	harbor1	chr9	80152976	80153405	DNA/TcMar-Tigger	1031	+	214	80153190	75945
chr9	28470617	28670617	harbor1	chr9	28513861	28514819	DNA/TcMar-Tigger	5996	+	479	28514340	43723
chr9	28470617	28670617	harbor1	chr9	28514835	28515204	DNA/TcMar-Tigger	2544	+	184	28515019	44402
chr9	28470617	28670617	harbor1	chr9	28515506	28515540	DNA/TcMar-Tigger	2544	+	17	28515523	44906
chr9	28470617	28670617	harbor1	chr9	28515539	28516248	DNA/TcMar-Tigger	4271	+	354	28515893	45276
chr9	69810002	70010002	harbor1	chr9	69824301	69824913	DNA/TcMar-Tigger	2934	+	306	69824607	14605
chr9	69810002	70010002	harbor1	chr9	69858167	69858800	DNA/TcMar-Tigger	3249	+	316	69858483	48481
chr9	69810002	70010002	harbor1	chr9	69885903	69886640	DNA/TcMar-Tigger	3998	+	368	69886271	76269
chr9	69810002	70010002	harbor1	chr9	69899986	69900049	DNA/TcMar-Tigger	408	+	32	69900018	90016
chr9	75592951	75792951	harbor1	chr9	75662053	75664469	DNA/TcMar-Tigger	14486	+	1208	75663261	70310
chr9	98110314	98310314	harbor1	chr9	98183546	98183677	DNA/TcMar-Tigger	1259	+	66	98183612	73298
chr9	98110314	98310314	harbor1	chr9	98183966	98184167	DNA/TcMar-Tigger	1259	+	100	98184066	73752
chr9	40293644	40493644	harbor1	chr9	40372376	40373517	DNA/TcMar-Tigger	5898	+	570	40372946	79302
chr9	86651377	86851377	harbor1	chr9	86703439	86704643	DNA/TcMar-Tigger	6579	+	602	86704041	52664
chr9	63405485	63605485	harbor1	chr9	63408700	63409015	DNA/TcMar-Tigger	1403	+	158	63408858	3373
chr9	112259390	112459390	harbor1	chr9	112311219	112311444	DNA/TcMar-Tigger	1142	+	112	112311331	51941
chr9	112259390	112459390	harbor1	chr9	112311445	112311646	DNA/TcMar-Tigger	658	+	100	112311545	52155
chr9	112259390	112459390	harbor1	chr9	112313867	112314206	DNA/TcMar-Tigger	1535	+	170	112314037	54647
chr9	80110499	80310499	harbor1	chr9	80152976	80153405	DNA/TcMar-Tigger	1031	+	214	80153190	42691
chr9	103553360	103753360	harbor1	chr9	103604279	103605344	DNA/TcMar-Tigger	4263	+	532	103604811	51451
chr9	103553360	103753360	harbor1	chr9	103622500	103622937	DNA/TcMar-Tigger	2511	+	218	103622718	69358
chr9	1497790	1697790	harbor1	chr9	1519697	1520027	DNA/TcMar-Tigger	540	+	165	1519862	22072
chr9	3683116	3883116	harbor1	chr9	3782473	3782749	DNA/TcMar-Tigger	1708	+	138	3782611	99495
chr9	89317707	89517707	harbor1	chr9	89329934	89330134	DNA/TcMar-Tigger	1083	+	100	89330034	12327
chr9	28829925	29029925	harbor1	chr9	28835131	28835429	DNA/TcMar-Tigger	682	+	149	28835280	5355
chr9	28829925	29029925	harbor1	chr9	28844737	28844942	DNA/TcMar-Tigger	456	+	102	28844839	14914
chr9	28829925	29029925	harbor1	chr9	28914532	28914773	DNA/TcMar-Tigger	1131	+	120	28914652	84727
chr9	28829925	29029925	harbor1	chr9	28928424	28928522	DNA/TcMar-Tigger	616	+	49	28928473	98548
chr9	118526340	118726340	harbor1	chr9	118590321	118590901	DNA/TcMar-Tigger	6456	+	290	118590611	64271
chr9	118526340	118726340	harbor1	chr9	118591230	118591924	DNA/TcMar-Tigger	6456	+	347	118591577	65237
chr9	118526340	118726340	harbor1	chr9	118599919	118600262	DNA/TcMar-Tigger	1933	+	172	118600091	73751
chr9	123365555	123565555	harbor1	chr9	123409318	123409518	DNA/TcMar-Tigger	1152	+	100	123409418	43863
chr9	29831035	30031035	harbor1	chr9	29871061	29871442	DNA/TcMar-Tigger	1600	+	190	29871251	40216
chr9	14132865	14332865	harbor1	chr9	14224467	14224796	DNA/TcMar-Tigger	1662	+	164	14224631	91766
chr9	40029931	40229931	harbor1	chr9	40071077	40071665	DNA/TcMar-Tigger	2995	+	294	40071371	41440
chr9	13788704	13988704	harbor1	chr9	13788957	13789179	DNA/TcMar-Tigger	918	+	111	13789068	364
chr9	13788704	13988704	harbor1	chr9	13871557	13871712	DNA/TcMar-Tigger	881	+	78	13871635	82931
chr9	13788704	13988704	harbor1	chr9	13871702	13871904	DNA/TcMar-Tigger	1112	+	101	13871803	83099
chr9	88967479	89167479	harbor1	chr9	89016312	89016388	DNA/TcMar-Tigger	412	+	38	89016350	48871
chr9	88967479	89167479	harbor1	chr9	89061624	89061882	DNA/TcMar-Tigger	1369	+	129	89061753	94274
chr9	88967479	89167479	harbor1	chr9	89061882	89061981	DNA/TcMar-Tigger	593	+	50	89061932	94453
chr9	10143963	10343963	harbor1	chr9	10145319	10145702	DNA/TcMar-Tigger	2325	+	192	10145511	1548
chr9	10143963	10343963	harbor1	chr9	10224657	10225095	DNA/TcMar-Tigger	2511	+	219	10224876	80913
chr9	80827037	81027037	harbor1	chr9	80907442	80907797	DNA/TcMar-Tigger	1722	+	178	80907620	80583
chr9	9100607	9300607	harbor1	chr9	9139209	9139410	DNA/TcMar-Tigger	1016	+	100	9139309	38702
chr9	82872493	83072493	harbor1	chr9	82874149	82876196	DNA/TcMar-Tigger	17000	+	1024	82875173	2680
chr9	82872493	83072493	harbor1	chr9	82876474	82877159	DNA/TcMar-Tigger	17000	+	342	82876816	4323
chr9	82872493	83072493	harbor1	chr9	82909288	82909484	DNA/TcMar-Tigger	870	+	98	82909386	36893
chr9	71431147	71631147	harbor1	chr9	71453159	71453724	DNA/TcMar-Tigger	981	+	282	71453441	22294
chr9	71431147	71631147	harbor1	chr9	71491440	71491980	DNA/TcMar-Tigger	3061	+	270	71491710	60563
chr9	81299449	81499449	harbor1	chr9	81300140	81300212	DNA/TcMar-Tigger	9716	+	36	81300176	727
chr9	81299449	81499449	harbor1	chr9	81300531	81302095	DNA/TcMar-Tigger	9716	+	782	81301313	1864
chr9	81299449	81499449	harbor1	chr9	81302178	81302234	DNA/TcMar-Tigger	626	+	28	81302206	2757
chr9	81299449	81499449	harbor1	chr9	81302524	81302614	DNA/TcMar-Tigger	626	+	45	81302569	3120
chr9	81299449	81499449	harbor1	chr9	81303740	81303862	DNA/TcMar-Tigger	759	+	61	81303801	4352
chr10	46426123	46626123	harbor1	chr10	46428169	46429313	DNA/TcMar-Tigger	6729	+	572	46428741	2618
chr10	46426123	46626123	harbor1	chr10	46512377	46512715	DNA/TcMar-Tigger	616	+	169	46512546	86423
chr10	114102790	114302790	harbor1	chr10	114151466	114152069	DNA/TcMar-Tigger	3597	+	302	114151768	48978
chr10	114102790	114302790	harbor1	chr10	114152353	114152494	DNA/TcMar-Tigger	3597	+	70	114152423	49633
chr10	100027665	100227665	harbor1	chr10	100039823	100039912	DNA/TcMar-Tigger	1210	+	44	100039867	12202
chr10	100027665	100227665	harbor1	chr10	100040198	100040424	DNA/TcMar-Tigger	1210	+	113	100040311	12646
chr10	100027665	100227665	harbor1	chr10	100071590	100071929	DNA/TcMar-Tigger	2160	+	170	100071760	44095
chr10	31157405	31357405	harbor1	chr10	31199049	31199492	DNA/TcMar-Tigger	2811	+	222	31199271	41866
chr10	31157405	31357405	harbor1	chr10	31202515	31202858	DNA/TcMar-Tigger	1854	+	172	31202687	45282
chr10	79031335	79231335	harbor1	chr10	79032575	79032862	DNA/TcMar-Tigger	2480	+	144	79032719	1384
chr10	79031335	79231335	harbor1	chr10	79033396	79033609	DNA/TcMar-Tigger	2480	+	106	79033502	2167
chr10	79031335	79231335	harbor1	chr10	79033915	79034064	DNA/TcMar-Tigger	2480	+	74	79033989	2654
chr10	98403249	98603249	harbor1	chr10	98422782	98422901	DNA/TcMar-Tigger	498	+	60	98422842	19593
chr10	98403249	98603249	harbor1	chr10	98437418	98437758	DNA/TcMar-Tigger	1890	+	170	98437588	34339
chr10	100039454	100239454	harbor1	chr10	100039823	100039912	DNA/TcMar-Tigger	1210	+	44	100039867	413
chr10	100039454	100239454	harbor1	chr10	100040198	100040424	DNA/TcMar-Tigger	1210	+	113	100040311	857
chr10	100039454	100239454	harbor1	chr10	100071590	100071929	DNA/TcMar-Tigger	2160	+	170	100071760	32306
chr10	100039454	100239454	harbor1	chr10	100138160	100138452	DNA/TcMar-Tigger	1900	+	146	100138306	98852
chr10	100039454	100239454	harbor1	chr10	100138876	100138985	DNA/TcMar-Tigger	552	+	54	100138930	99476
chr10	74003451	74203451	harbor1	chr10	74006560	74006895	DNA/TcMar-Tigger	1880	+	168	74006728	3277
chr10	74003451	74203451	harbor1	chr10	74023160	74023474	DNA/TcMar-Tigger	1852	+	157	74023317	19866
chr10	74003451	74203451	harbor1	chr10	74035751	74036084	DNA/TcMar-Tigger	2008	+	166	74035917	32466
chr10	81140489	81340489	harbor1	chr10	81176572	81176872	DNA/TcMar-Tigger	1463	+	150	81176722	36233
chr10	81140489	81340489	harbor1	chr10	81208761	81209045	DNA/TcMar-Tigger	1052	+	142	81208903	68414
chr10	81140489	81340489	harbor1	chr10	81230669	81232247	DNA/TcMar-Tigger	9417	+	789	81231458	90969
chr10	129934313	130134313	harbor1	chr10	130008386	130008576	DNA/TcMar-Tigger	900	+	95	130008481	74168
chr10	33601166	33801166	harbor1	chr10	33635396	33635737	DNA/TcMar-Tigger	1958	+	170	33635566	34400
chr10	33601166	33801166	harbor1	chr10	33698866	33699199	DNA/TcMar-Tigger	2093	+	166	33699032	97866
chr10	113654605	113854605	harbor1	chr10	113701262	113701299	DNA/TcMar-Tigger	11680	+	18	113701280	46675
chr10	113654605	113854605	harbor1	chr10	113701615	113703583	DNA/TcMar-Tigger	11680	+	984	113702599	47994
chr10	113654605	113854605	harbor1	chr10	113703820	113704280	DNA/TcMar-Tigger	2656	+	230	113704050	49445
chr10	94017149	94217149	harbor1	chr10	94033018	94033220	DNA/TcMar-Tigger	911	+	101	94033119	15970
chr10	94017149	94217149	harbor1	chr10	94068324	94068618	DNA/TcMar-Tigger	1305	+	147	94068471	51322
chr10	94017149	94217149	harbor1	chr10	94077920	94078185	DNA/TcMar-Tigger	787	+	132	94078052	60903
chr10	88994270	89194270	harbor1	chr10	89004734	89005175	DNA/TcMar-Tigger	702	+	220	89004954	10684
chr10	88994270	89194270	harbor1	chr10	89005203	89005379	DNA/TcMar-Tigger	702	+	88	89005291	11021
chr10	62186273	62386273	harbor1	chr10	62235467	62235845	DNA/TcMar-Tigger	1833	+	189	62235656	49383
chr10	62186273	62386273	harbor1	chr10	62250515	62250624	DNA/TcMar-Tigger	1588	+	54	62250569	64296
chr10	62186273	62386273	harbor1	chr10	62250931	62251120	DNA/TcMar-Tigger	1588	+	94	62251025	64752
chr10	62186273	62386273	harbor1	chr10	62251118	62251456	DNA/TcMar-Tigger	1984	+	169	62251287	65014
chr10	62186273	62386273	harbor1	chr10	62283182	62283484	DNA/TcMar-Tigger	427	+	151	62283333	97060
chr10	17443424	17643424	harbor1	chr10	17457343	17457598	DNA/TcMar-Tigger	471	+	128	17457471	14047
chr10	51994090	52194090	harbor1	chr10	52021991	52022336	DNA/TcMar-Tigger	1712	+	172	52022163	28073
chr10	113443729	113643729	harbor1	chr10	113506299	113506383	DNA/TcMar-Tigger	497	+	42	113506341	62612
chr10	113443729	113643729	harbor1	chr10	113506379	113506507	DNA/TcMar-Tigger	764	+	64	113506443	62714
chr10	61325394	61525394	harbor1	chr10	61335906	61336440	DNA/TcMar-Tigger	2986	+	267	61336173	10779
chr10	61325394	61525394	harbor1	chr10	61336434	61336565	DNA/TcMar-Tigger	646	+	66	61336500	11106
chr10	9597269	9797269	harbor1	chr10	9598955	9599374	DNA/TcMar-Tigger	2188	+	210	9599165	1896
chr10	9597269	9797269	harbor1	chr10	9666430	9666757	DNA/TcMar-Tigger	1771	+	164	9666594	69325
chr10	70151641	70351641	harbor1	chr10	70162682	70163236	DNA/TcMar-Tigger	2387	+	277	70162959	11318
chr10	70151641	70351641	harbor1	chr10	70163247	70163528	DNA/TcMar-Tigger	1665	+	140	70163387	11746
chr10	70151641	70351641	harbor1	chr10	70164747	70165019	DNA/TcMar-Tigger	6940	+	136	70164883	13242
chr10	70151641	70351641	harbor1	chr10	70165290	70166249	DNA/TcMar-Tigger	6940	+	480	70165770	14129
chr10	117399857	117599857	harbor1	chr10	117418512	117418851	DNA/TcMar-Tigger	2124	+	170	117418682	18825
chr10	117399857	117599857	harbor1	chr10	117471146	117471334	DNA/TcMar-Tigger	703	+	94	117471240	71383
chr10	59736820	59936820	harbor1	chr10	59739741	59739811	DNA/TcMar-Tigger	5610	+	35	59739776	2956
chr10	59736820	59936820	harbor1	chr10	59740106	59740757	DNA/TcMar-Tigger	5610	+	326	59740432	3612
chr10	59736820	59936820	harbor1	chr10	59741098	59741361	DNA/TcMar-Tigger	5610	+	132	59741230	4410
chr10	59736820	59936820	harbor1	chr10	59809686	59809885	DNA/TcMar-Tigger	1302	+	100	59809786	72966
chr10	59736820	59936820	harbor1	chr10	59818451	59819270	DNA/TcMar-Tigger	4338	+	410	59818861	82041
chr10	26420839	26620839	harbor1	chr10	26427041	26427106	DNA/TcMar-Tigger	1117	+	32	26427073	6234
chr10	26420839	26620839	harbor1	chr10	26427418	26427557	DNA/TcMar-Tigger	1117	+	70	26427488	6649
chr10	26420839	26620839	harbor1	chr10	26427716	26427970	DNA/TcMar-Tigger	1685	+	127	26427843	7004
chr10	26420839	26620839	harbor1	chr10	26433756	26433949	DNA/TcMar-Tigger	2371	+	96	26433852	13013
chr10	26420839	26620839	harbor1	chr10	26434252	26434487	DNA/TcMar-Tigger	2371	+	118	26434370	13531
chr10	26420839	26620839	harbor1	chr10	26436853	26436992	DNA/TcMar-Tigger	806	+	70	26436923	16084
chr10	26420839	26620839	harbor1	chr10	26470075	26470254	DNA/TcMar-Tigger	2088	+	90	26470165	49326
chr10	26420839	26620839	harbor1	chr10	26470559	26470742	DNA/TcMar-Tigger	2088	+	92	26470651	49812
chr10	26420839	26620839	harbor1	chr10	26504220	26504359	DNA/TcMar-Tigger	511	+	70	26504290	83451
chr10	80545960	80745960	harbor1	chr10	80596903	80597232	DNA/TcMar-Tigger	1359	+	164	80597067	51107
chr10	88328642	88528642	harbor1	chr10	88359924	88360145	DNA/TcMar-Tigger	646	+	110	88360034	31392
chr10	88328642	88528642	harbor1	chr10	88375273	88375395	DNA/TcMar-Tigger	448	+	61	88375334	46692
chr10	84080576	84280576	harbor1	chr10	84145150	84145372	DNA/TcMar-Tigger	969	+	111	84145261	64685
chr10	117391959	117591959	harbor1	chr10	117418512	117418851	DNA/TcMar-Tigger	2124	+	170	117418682	26723
chr10	117391959	117591959	harbor1	chr10	117471146	117471334	DNA/TcMar-Tigger	703	+	94	117471240	79281
chr10	14752039	14952039	harbor1	chr10	14783107	14783404	DNA/TcMar-Tigger	1400	+	148	14783255	31216
chr10	14752039	14952039	harbor1	chr10	14810415	14810561	DNA/TcMar-Tigger	430	+	73	14810488	58449
chr10	14752039	14952039	harbor1	chr10	14820336	14820444	DNA/TcMar-Tigger	933	+	54	14820390	68351
chr10	14752039	14952039	harbor1	chr10	14820742	14820773	DNA/TcMar-Tigger	933	+	16	14820758	68719
chr10	14752039	14952039	harbor1	chr10	14821462	14821555	DNA/TcMar-Tigger	933	+	46	14821508	69469
chr10	77340129	77540129	harbor1	chr10	77391377	77391590	DNA/TcMar-Tigger	457	+	106	77391483	51354
chr10	50304683	50504683	harbor1	chr10	50345614	50345840	DNA/TcMar-Tigger	1265	+	113	50345727	41044
chr10	50304683	50504683	harbor1	chr10	50395328	50395973	DNA/TcMar-Tigger	1683	+	322	50395650	90967
chr10	44101592	44301592	harbor1	chr10	44118740	44119789	DNA/TcMar-Tigger	5887	+	524	44119264	17672
chr10	90253430	90453430	harbor1	chr10	90330664	90331060	DNA/TcMar-Tigger	1106	+	198	90330862	77432
chr10	90253430	90453430	harbor1	chr10	90351393	90351721	DNA/TcMar-Tigger	1726	+	164	90351557	98127
chr10	112096015	112296015	harbor1	chr10	112154130	112154344	DNA/TcMar-Tigger	1285	+	107	112154237	58222
chr10	111343389	111543389	harbor1	chr10	111408017	111408222	DNA/TcMar-Tigger	940	+	102	111408119	64730
chr10	91344346	91544346	harbor1	chr10	91416353	91416664	DNA/TcMar-Tigger	1529	+	156	91416509	72163
chr10	102842779	103042779	harbor1	chr10	102856126	102856270	DNA/TcMar-Tigger	1655	+	72	102856198	13419
chr10	102842779	103042779	harbor1	chr10	102856403	102856823	DNA/TcMar-Tigger	1655	+	210	102856613	13834
chr10	97226320	97426320	harbor1	chr10	97237334	97237588	DNA/TcMar-Tigger	7224	+	127	97237461	11141
chr10	97226320	97426320	harbor1	chr10	97237901	97238208	DNA/TcMar-Tigger	7224	+	154	97238055	11735
chr10	97226320	97426320	harbor1	chr10	97253796	97253886	DNA/TcMar-Tigger	567	+	45	97253841	27521
chr10	97226320	97426320	harbor1	chr10	97253881	97253974	DNA/TcMar-Tigger	580	+	46	97253927	27607
chr10	97226320	97426320	harbor1	chr10	97257925	97258138	DNA/TcMar-Tigger	1259	+	106	97258031	31711
chr10	97226320	97426320	harbor1	chr10	97238518	97239194	DNA/TcMar-Tigger	7224	+	338	97238856	12536
chr10	16446858	16646858	harbor1	chr10	16467097	16467427	DNA/TcMar-Tigger	1885	+	165	16467262	20404
chr10	16446858	16646858	harbor1	chr10	16473549	16473776	DNA/TcMar-Tigger	490	+	114	16473663	26805
chr10	16446858	16646858	harbor1	chr10	16474147	16474461	DNA/TcMar-Tigger	663	+	157	16474304	27446
chr10	85094795	85294795	harbor1	chr10	85165343	85165685	DNA/TcMar-Tigger	2056	+	171	85165514	70719
chr10	70157152	70357152	harbor1	chr10	70162682	70163236	DNA/TcMar-Tigger	2387	+	277	70162959	5807
chr10	70157152	70357152	harbor1	chr10	70163247	70163528	DNA/TcMar-Tigger	1665	+	140	70163387	6235
chr10	70157152	70357152	harbor1	chr10	70164747	70165019	DNA/TcMar-Tigger	6940	+	136	70164883	7731
chr10	70157152	70357152	harbor1	chr10	70165290	70166249	DNA/TcMar-Tigger	6940	+	480	70165770	8618
chr10	536693	736693	harbor1	chr10	539262	539564	DNA/TcMar-Tigger	1229	+	151	539413	2720
chr10	105381625	105581625	harbor1	chr10	105455199	105456757	DNA/TcMar-Tigger	9630	+	779	105455978	74353
chr10	94046067	94246067	harbor1	chr10	94068324	94068618	DNA/TcMar-Tigger	1305	+	147	94068471	22404
chr10	94046067	94246067	harbor1	chr10	94077920	94078185	DNA/TcMar-Tigger	787	+	132	94078052	31985
chr10	43109005	43309005	harbor1	chr10	43131515	43131650	DNA/TcMar-Tigger	726	+	68	43131583	22578
chr10	43109005	43309005	harbor1	chr10	43131648	43131865	DNA/TcMar-Tigger	1023	+	108	43131756	22751
chr10	43997448	44197448	harbor1	chr10	44075577	44075807	DNA/TcMar-Tigger	1361	+	115	44075692	78244
chr10	19595073	19795073	harbor1	chr10	19602041	19602154	DNA/TcMar-Tigger	586	+	56	19602097	7024
chr10	19595073	19795073	harbor1	chr10	19603685	19604247	DNA/TcMar-Tigger	3497	+	281	19603966	8893
chr10	19595073	19795073	harbor1	chr10	19604385	19604728	DNA/TcMar-Tigger	2087	+	172	19604557	9484
chr10	19595073	19795073	harbor1	chr10	19604760	19604927	DNA/TcMar-Tigger	859	+	84	19604844	9771
chr10	73353531	73553531	harbor1	chr10	73418291	73418485	DNA/TcMar-Tigger	699	+	97	73418388	64857
chr10	73353531	73553531	harbor1	chr10	73421370	73421444	DNA/TcMar-Tigger	544	+	37	73421407	67876
chr10	73353531	73553531	harbor1	chr10	73421438	73421555	DNA/TcMar-Tigger	660	+	58	73421496	67965
chr10	76755875	76955875	harbor1	chr10	76770371	76770599	DNA/TcMar-Tigger	6502	+	114	76770485	14610
chr10	76755875	76955875	harbor1	chr10	76770848	76771793	DNA/TcMar-Tigger	6502	+	472	76771320	15445
chr10	133075670	133275670	harbor1	chr10	133118260	133118357	DNA/TcMar-Tigger	852	+	48	133118308	42638
chr10	133075670	133275670	harbor1	chr10	133118773	133118856	DNA/TcMar-Tigger	852	+	42	133118815	43145
chr10	54937281	55137281	harbor1	chr10	54970530	54970772	DNA/TcMar-Tigger	964	+	121	54970651	33370
chr10	24735189	24935189	harbor1	chr10	24787159	24787238	DNA/TcMar-Tigger	6369	+	40	24787199	52010
chr10	24735189	24935189	harbor1	chr10	24787554	24788107	DNA/TcMar-Tigger	6369	+	276	24787830	52641
chr10	24735189	24935189	harbor1	chr10	24788406	24788713	DNA/TcMar-Tigger	6369	+	154	24788560	53371
chr10	24735189	24935189	harbor1	chr10	24789048	24789323	DNA/TcMar-Tigger	6369	+	138	24789186	53997
chr10	24735189	24935189	harbor1	chr10	24796076	24796241	DNA/TcMar-Tigger	464	+	82	24796158	60969
chr10	24735189	24935189	harbor1	chr10	24822879	24823187	DNA/TcMar-Tigger	1473	+	154	24823033	87844
chr10	89968694	90168694	harbor1	chr10	89976039	89976410	DNA/TcMar-Tigger	1138	+	186	89976225	7531
chr10	33743943	33943943	harbor1	chr10	33754087	33754816	DNA/TcMar-Tigger	4484	+	364	33754451	10508
chr10	33743943	33943943	harbor1	chr10	33784329	33786515	DNA/TcMar-Tigger	15234	+	1093	33785422	41479
chr10	33743943	33943943	harbor1	chr10	33786817	33787010	DNA/TcMar-Tigger	15234	+	96	33786913	42970
chr10	93121417	93321417	harbor1	chr10	93126834	93127339	DNA/TcMar-Tigger	1109	+	252	93127086	5669
chr10	5390021	5590021	harbor1	chr10	5436675	5436986	DNA/TcMar-Tigger	435	+	156	5436831	46810
chr10	72463387	72663387	harbor1	chr10	72463601	72463994	DNA/TcMar-Tigger	2154	+	196	72463797	410
chr10	72463387	72663387	harbor1	chr10	72464515	72464718	DNA/TcMar-Tigger	1012	+	102	72464617	1230
chr10	72463387	72663387	harbor1	chr10	72549985	72550185	DNA/TcMar-Tigger	1145	+	100	72550085	86698
chr10	72463387	72663387	harbor1	chr10	72550175	72550472	DNA/TcMar-Tigger	1963	+	148	72550323	86936
chr10	102700332	102900332	harbor1	chr10	102795035	102795370	DNA/TcMar-Tigger	1727	+	168	102795203	94871
chr10	102700332	102900332	harbor1	chr10	102796007	102796143	DNA/TcMar-Tigger	479	+	68	102796075	95743
chr10	50423010	50623010	harbor1	chr10	50429190	50429513	DNA/TcMar-Tigger	1794	+	162	50429352	6342
chr10	48543230	48743230	harbor1	chr10	48616047	48616200	DNA/TcMar-Tigger	767	+	76	48616123	72893
chr10	48543230	48743230	harbor1	chr10	48616182	48616373	DNA/TcMar-Tigger	904	+	96	48616278	73048
chr10	120014118	120214118	harbor1	chr10	120029842	120030160	DNA/TcMar-Tigger	1710	+	159	120030001	15883
chr10	120014118	120214118	harbor1	chr10	120088389	120089993	DNA/TcMar-Tigger	13640	+	802	120089191	75073
chr10	120014118	120214118	harbor1	chr10	120090275	120090919	DNA/TcMar-Tigger	13640	+	322	120090597	76479
chr10	74774083	74974083	harbor1	chr10	74816127	74816264	DNA/TcMar-Tigger	650	+	68	74816195	42112
chr10	74774083	74974083	harbor1	chr10	74816270	74816377	DNA/TcMar-Tigger	549	+	54	74816324	42241
chr10	74774083	74974083	harbor1	chr10	74816547	74816735	DNA/TcMar-Tigger	1186	+	94	74816641	42558
chr10	74774083	74974083	harbor1	chr10	74865900	74866127	DNA/TcMar-Tigger	1264	+	114	74866014	91931
chr10	48615587	48815587	harbor1	chr10	48616047	48616200	DNA/TcMar-Tigger	767	+	76	48616123	536
chr10	48615587	48815587	harbor1	chr10	48616182	48616373	DNA/TcMar-Tigger	904	+	96	48616278	691
chr10	27597691	27797691	harbor1	chr10	27622305	27622618	DNA/TcMar-Tigger	1317	+	156	27622461	24770
chr10	27597691	27797691	harbor1	chr10	27680992	27681164	DNA/TcMar-Tigger	6724	+	86	27681078	83387
chr10	27597691	27797691	harbor1	chr10	27681474	27681639	DNA/TcMar-Tigger	6724	+	82	27681556	83865
chr10	27597691	27797691	harbor1	chr10	27681938	27682551	DNA/TcMar-Tigger	6724	+	306	27682244	84553
chr10	27597691	27797691	harbor1	chr10	27683222	27683507	DNA/TcMar-Tigger	6724	+	142	27683364	85673
chr10	72521546	72721546	harbor1	chr10	72549985	72550185	DNA/TcMar-Tigger	1145	+	100	72550085	28539
chr10	72521546	72721546	harbor1	chr10	72550175	72550472	DNA/TcMar-Tigger	1963	+	148	72550323	28777
chr10	72521546	72721546	harbor1	chr10	72575437	72575931	DNA/TcMar-Tigger	9199	+	247	72575684	54138
chr10	72521546	72721546	harbor1	chr10	72576249	72577229	DNA/TcMar-Tigger	9199	+	490	72576739	55193
chr10	72521546	72721546	harbor1	chr10	72577527	72578265	DNA/TcMar-Tigger	9199	+	369	72577896	56350
chr10	72521546	72721546	harbor1	chr10	72578565	72578597	DNA/TcMar-Tigger	9199	+	16	72578581	57035
chr10	72521546	72721546	harbor1	chr10	72578905	72579066	DNA/TcMar-Tigger	9199	+	80	72578985	57439
chr10	72521546	72721546	harbor1	chr10	72579475	72579573	DNA/TcMar-Tigger	495	+	49	72579524	57978
chr10	72521546	72721546	harbor1	chr10	72579568	72580000	DNA/TcMar-Tigger	2293	+	216	72579784	58238
chr10	72521546	72721546	harbor1	chr10	72599341	72599644	DNA/TcMar-Tigger	1509	+	152	72599493	77947
chr10	72521546	72721546	harbor1	chr10	72599872	72600009	DNA/TcMar-Tigger	716	+	68	72599940	78394
chr10	72521546	72721546	harbor1	chr10	72600310	72600366	DNA/TcMar-Tigger	1699	+	28	72600338	78792
chr10	72521546	72721546	harbor1	chr10	72600677	72600896	DNA/TcMar-Tigger	1699	+	110	72600787	79241
chr10	72521546	72721546	harbor1	chr10	72605634	72605821	DNA/TcMar-Tigger	1054	+	94	72605728	84182
chr10	27345177	27545177	harbor1	chr10	27402358	27402970	DNA/TcMar-Tigger	3481	+	306	27402664	57487
chr10	112334921	112534921	harbor1	chr10	112405351	112405480	DNA/TcMar-Tigger	776	+	64	112405415	70494
chr10	57342966	57542966	harbor1	chr10	57370853	57371195	DNA/TcMar-Tigger	1039	+	171	57371024	28058
chr10	62567016	62767016	harbor1	chr10	62634098	62634716	DNA/TcMar-Tigger	1935	+	309	62634407	67391
chr10	62567016	62767016	harbor1	chr10	62641101	62641417	DNA/TcMar-Tigger	1743	+	158	62641259	74243
chr10	7695061	7895061	harbor1	chr10	7714900	7715029	DNA/TcMar-Tigger	430	+	64	7714964	19903
chr10	7695061	7895061	harbor1	chr10	7760541	7760854	DNA/TcMar-Tigger	2061	+	156	7760697	65636
chr10	7695061	7895061	harbor1	chr10	7761518	7761729	DNA/TcMar-Tigger	1857	+	106	7761624	66563
chr10	7695061	7895061	harbor1	chr10	7762029	7762161	DNA/TcMar-Tigger	1857	+	66	7762095	67034
chr10	7695061	7895061	harbor1	chr10	7779518	7779825	DNA/TcMar-Tigger	1803	+	154	7779672	84611
chr10	127331303	127531303	harbor1	chr10	127344921	127345205	DNA/TcMar-Tigger	1375	+	142	127345063	13760
chr10	37525092	37725092	harbor1	chr10	37569663	37569986	DNA/TcMar-Tigger	1139	+	162	37569825	44733
chr10	37525092	37725092	harbor1	chr10	37593369	37593637	DNA/TcMar-Tigger	1696	+	134	37593503	68411
chr10	73401935	73601935	harbor1	chr10	73418291	73418485	DNA/TcMar-Tigger	699	+	97	73418388	16453
chr10	73401935	73601935	harbor1	chr10	73421370	73421444	DNA/TcMar-Tigger	544	+	37	73421407	19472
chr10	73401935	73601935	harbor1	chr10	73421438	73421555	DNA/TcMar-Tigger	660	+	58	73421496	19561
chr10	125302923	125502923	harbor1	chr10	125349777	125350282	DNA/TcMar-Tigger	1075	+	252	125350029	47106
chr10	132866766	133066766	harbor1	chr10	132869910	132871979	DNA/TcMar-Tigger	11661	+	1034	132870944	4178
chr10	132866766	133066766	harbor1	chr10	132871986	132872186	DNA/TcMar-Tigger	930	+	100	132872086	5320
chr10	127100103	127300103	harbor1	chr10	127150459	127151076	DNA/TcMar-Tigger	759	+	308	127150767	50664
chr10	127100103	127300103	harbor1	chr10	127159613	127160205	DNA/TcMar-Tigger	653	+	296	127159909	59806
chr10	75996392	76196392	harbor1	chr10	76082029	76082260	DNA/TcMar-Tigger	1107	+	116	76082145	85753
chr10	84880834	85080834	harbor1	chr10	84913780	84915186	DNA/TcMar-Tigger	7579	+	703	84914483	33649
chr10	84880834	85080834	harbor1	chr10	84915178	84915685	DNA/TcMar-Tigger	3454	+	254	84915432	34598
chr10	84880834	85080834	harbor1	chr10	84916001	84916201	DNA/TcMar-Tigger	3454	+	100	84916101	35267
chr10	120030496	120230496	harbor1	chr10	120088389	120089993	DNA/TcMar-Tigger	13640	+	802	120089191	58695
chr10	120030496	120230496	harbor1	chr10	120090275	120090919	DNA/TcMar-Tigger	13640	+	322	120090597	60101
chr10	63036774	63236774	harbor1	chr10	63095294	63095627	DNA/TcMar-Tigger	2111	+	166	63095460	58686
chr10	99362546	99562546	harbor1	chr10	99446569	99446770	DNA/TcMar-Tigger	1224	+	100	99446669	84123
chr10	126713630	126913630	harbor1	chr10	126805024	126805383	DNA/TcMar-Tigger	787	+	180	126805204	91574
chr10	91474620	91674620	harbor1	chr10	91572191	91572367	DNA/TcMar-Tigger	447	+	88	91572279	97659
chr10	91474620	91674620	harbor1	chr10	91572366	91572589	DNA/TcMar-Tigger	425	+	112	91572478	97858
chr10	91474620	91674620	harbor1	chr10	91572894	91572922	DNA/TcMar-Tigger	425	+	14	91572908	98288
chr10	110101184	110301184	harbor1	chr10	110188389	110188718	DNA/TcMar-Tigger	1976	+	164	110188553	87369
chr10	62294258	62494258	harbor1	chr10	62316187	62316387	DNA/TcMar-Tigger	1238	+	100	62316287	22029
chr10	62294258	62494258	harbor1	chr10	62360863	62361280	DNA/TcMar-Tigger	2157	+	208	62361071	66813
chr10	62294258	62494258	harbor1	chr10	62380195	62380584	DNA/TcMar-Tigger	1819	+	194	62380389	86131
chr10	124872982	125072982	harbor1	chr10	124948025	124948447	DNA/TcMar-Tigger	2445	+	211	124948236	75254
chr10	25852535	26052535	harbor1	chr10	25905559	25905883	DNA/TcMar-Tigger	1614	+	162	25905721	53186
chr10	72584277	72784277	harbor1	chr10	72599341	72599644	DNA/TcMar-Tigger	1509	+	152	72599493	15216
chr10	72584277	72784277	harbor1	chr10	72599872	72600009	DNA/TcMar-Tigger	716	+	68	72599940	15663
chr10	72584277	72784277	harbor1	chr10	72600310	72600366	DNA/TcMar-Tigger	1699	+	28	72600338	16061
chr10	72584277	72784277	harbor1	chr10	72600677	72600896	DNA/TcMar-Tigger	1699	+	110	72600787	16510
chr10	72584277	72784277	harbor1	chr10	72605634	72605821	DNA/TcMar-Tigger	1054	+	94	72605728	21451
chr11	67285670	67485670	harbor1	chr11	67329675	67329761	DNA/TcMar-Tigger	11274	+	43	67329718	44048
chr11	67285670	67485670	harbor1	chr11	67330074	67330346	DNA/TcMar-Tigger	11274	+	136	67330210	44540
chr11	67285670	67485670	harbor1	chr11	67330664	67331383	DNA/TcMar-Tigger	11274	+	360	67331024	45354
chr11	67285670	67485670	harbor1	chr11	67331685	67331765	DNA/TcMar-Tigger	11274	+	40	67331725	46055
chr11	67285670	67485670	harbor1	chr11	67332091	67332431	DNA/TcMar-Tigger	11274	+	170	67332261	46591
chr11	67285670	67485670	harbor1	chr11	67332731	67333439	DNA/TcMar-Tigger	11274	+	354	67333085	47415
chr11	67285670	67485670	harbor1	chr11	67333924	67334166	DNA/TcMar-Tigger	7992	+	121	67334045	48375
chr11	75213457	75413457	harbor1	chr11	75256646	75257209	DNA/TcMar-Tigger	2971	+	282	75256928	43471
chr11	14344595	14544595	harbor1	chr11	14370329	14370564	DNA/TcMar-Tigger	1678	+	118	14370447	25852
chr11	14344595	14544595	harbor1	chr11	14404300	14404580	DNA/TcMar-Tigger	3347	+	140	14404440	59845
chr11	14344595	14544595	harbor1	chr11	14404876	14404944	DNA/TcMar-Tigger	3347	+	34	14404910	60315
chr11	14344595	14544595	harbor1	chr11	14405544	14405755	DNA/TcMar-Tigger	3347	+	106	14405650	61055
chr11	14344595	14544595	harbor1	chr11	14405851	14405894	DNA/TcMar-Tigger	3347	+	22	14405873	61278
chr11	14344595	14544595	harbor1	chr11	14406238	14406508	DNA/TcMar-Tigger	1983	+	135	14406373	61778
chr11	14344595	14544595	harbor1	chr11	14439739	14439960	DNA/TcMar-Tigger	2668	+	110	14439849	95254
chr11	14344595	14544595	harbor1	chr11	14440271	14440503	DNA/TcMar-Tigger	2668	+	116	14440387	95792
chr11	125420387	125620387	harbor1	chr11	125488102	125488394	DNA/TcMar-Tigger	1572	+	146	125488248	67861
chr11	125420387	125620387	harbor1	chr11	125490292	125490528	DNA/TcMar-Tigger	932	+	118	125490410	70023
chr11	31370717	31570717	harbor1	chr11	31461474	31461833	DNA/TcMar-Tigger	2357	+	180	31461654	90937
chr11	7599749	7799749	harbor1	chr11	7690532	7691182	DNA/TcMar-Tigger	3134	+	325	7690857	91108
chr11	21489651	21689651	harbor1	chr11	21563459	21563767	DNA/TcMar-Tigger	1203	+	154	21563613	73962
chr11	112863382	113063382	harbor1	chr11	112875325	112875509	DNA/TcMar-Tigger	418	+	92	112875417	12035
chr11	112863382	113063382	harbor1	chr11	112903812	112903960	DNA/TcMar-Tigger	2205	+	74	112903886	40504
chr11	112863382	113063382	harbor1	chr11	112904252	112904482	DNA/TcMar-Tigger	2205	+	115	112904367	40985
chr11	93458650	93658650	harbor1	chr11	93511382	93512206	DNA/TcMar-Tigger	4153	+	412	93511794	53144
chr11	93458650	93658650	harbor1	chr11	93512209	93512800	DNA/TcMar-Tigger	3271	+	296	93512505	53855
chr11	95474112	95674112	harbor1	chr11	95506075	95506404	DNA/TcMar-Tigger	1975	+	164	95506239	32127
chr11	95474112	95674112	harbor1	chr11	95506396	95506545	DNA/TcMar-Tigger	860	+	74	95506470	32358
chr11	102350638	102550638	harbor1	chr11	102358235	102358468	DNA/TcMar-Tigger	1411	+	116	102358351	7713
chr11	102350638	102550638	harbor1	chr11	102388682	102388936	DNA/TcMar-Tigger	729	+	127	102388809	38171
chr11	102350638	102550638	harbor1	chr11	102424009	102424169	DNA/TcMar-Tigger	612	+	80	102424089	73451
chr11	99627574	99827574	harbor1	chr11	99631790	99632125	DNA/TcMar-Tigger	1817	+	168	99631958	4384
chr11	99627574	99827574	harbor1	chr11	99637963	99638033	DNA/TcMar-Tigger	445	+	35	99637998	10424
chr11	99627574	99827574	harbor1	chr11	99640592	99640853	DNA/TcMar-Tigger	1410	+	130	99640722	13148
chr11	99627574	99827574	harbor1	chr11	99652786	99652910	DNA/TcMar-Tigger	519	+	62	99652848	25274
chr11	99627574	99827574	harbor1	chr11	99679274	99681720	DNA/TcMar-Tigger	11585	+	1223	99680497	52923
chr11	96663549	96863549	harbor1	chr11	96718790	96721440	DNA/TcMar-Tigger	15306	+	1325	96720115	56566
chr11	96663549	96863549	harbor1	chr11	96721736	96721794	DNA/TcMar-Tigger	15306	+	29	96721765	58216
chr11	122497329	122697329	harbor1	chr11	122502872	122503208	DNA/TcMar-Tigger	2096	+	168	122503040	5711
chr11	39682468	39882468	harbor1	chr11	39690596	39693265	DNA/TcMar-Tigger	14940	+	1334	39691930	9462
chr11	71997262	72197262	harbor1	chr11	72030570	72030802	DNA/TcMar-Tigger	397	+	116	72030686	33424
chr11	71997262	72197262	harbor1	chr11	72053743	72054071	DNA/TcMar-Tigger	1748	+	164	72053907	56645
chr11	25792580	25992580	harbor1	chr11	25852857	25853118	DNA/TcMar-Tigger	548	+	130	25852987	60407
chr11	81704916	81904916	harbor1	chr11	81769822	81769941	DNA/TcMar-Tigger	1047	+	60	81769882	64966
chr11	81704916	81904916	harbor1	chr11	81770405	81770438	DNA/TcMar-Tigger	1047	+	16	81770421	65505
chr11	81704916	81904916	harbor1	chr11	81770881	81771041	DNA/TcMar-Tigger	1047	+	80	81770961	66045
chr11	81704916	81904916	harbor1	chr11	81773691	81773932	DNA/TcMar-Tigger	1373	+	120	81773811	68895
chr11	81704916	81904916	harbor1	chr11	81783102	81783310	DNA/TcMar-Tigger	1172	+	104	81783206	78290
chr11	104346183	104546183	harbor1	chr11	104351978	104352306	DNA/TcMar-Tigger	1872	+	164	104352142	5959
chr11	104346183	104546183	harbor1	chr11	104383216	104383485	DNA/TcMar-Tigger	801	+	134	104383350	37167
chr11	104346183	104546183	harbor1	chr11	104415904	104416138	DNA/TcMar-Tigger	1167	+	117	104416021	69838
chr11	10368191	10568191	harbor1	chr11	10464810	10464922	DNA/TcMar-Tigger	462	+	56	10464866	96675
chr11	10368191	10568191	harbor1	chr11	10403749	10404966	DNA/TcMar-Tigger	7311	+	608	10404357	36166
chr11	58105506	58305506	harbor1	chr11	58150494	58150951	DNA/TcMar-Tigger	2557	+	228	58150722	45216
chr11	107394482	107594482	harbor1	chr11	107422164	107422384	DNA/TcMar-Tigger	954	+	110	107422274	27792
chr11	107394482	107594482	harbor1	chr11	107425291	107425618	DNA/TcMar-Tigger	1534	+	164	107425455	30973
chr11	30576231	30776231	harbor1	chr11	30630306	30630624	DNA/TcMar-Tigger	1483	+	159	30630465	54234
chr11	30576231	30776231	harbor1	chr11	30653749	30654090	DNA/TcMar-Tigger	2170	+	170	30653919	77688
chr11	77853047	78053047	harbor1	chr11	77944658	77944920	DNA/TcMar-Tigger	1319	+	131	77944789	91742
chr11	114355628	114555628	harbor1	chr11	114427741	114428080	DNA/TcMar-Tigger	2095	+	170	114427911	72283
chr11	114355628	114555628	harbor1	chr11	114448917	114449183	DNA/TcMar-Tigger	605	+	133	114449050	93422
chr11	114355628	114555628	harbor1	chr11	114451258	114451729	DNA/TcMar-Tigger	2275	+	236	114451494	95866
chr11	30278673	30478673	harbor1	chr11	30333294	30334208	DNA/TcMar-Tigger	12894	+	457	30333751	55078
chr11	30278673	30478673	harbor1	chr11	30334514	30335858	DNA/TcMar-Tigger	12894	+	672	30335186	56513
chr11	30278673	30478673	harbor1	chr11	30337028	30338072	DNA/TcMar-Tigger	3938	+	522	30337550	58877
chr11	26126501	26326501	harbor1	chr11	26131291	26131782	DNA/TcMar-Tigger	955	+	246	26131537	5036
chr11	55702672	55902672	harbor1	chr11	55705190	55705312	DNA/TcMar-Tigger	485	+	61	55705251	2579
chr11	55702672	55902672	harbor1	chr11	55705991	55706206	DNA/TcMar-Tigger	1192	+	108	55706099	3427
chr11	55702672	55902672	harbor1	chr11	55746845	55747447	DNA/TcMar-Tigger	3018	+	301	55747146	44474
chr11	55702672	55902672	harbor1	chr11	55753530	55754090	DNA/TcMar-Tigger	2339	+	280	55753810	51138
chr11	55702672	55902672	harbor1	chr11	55786116	55786683	DNA/TcMar-Tigger	2285	+	284	55786400	83728
chr11	55702672	55902672	harbor1	chr11	55801355	55801544	DNA/TcMar-Tigger	932	+	94	55801449	98777
chr11	76821425	77021425	harbor1	chr11	76831407	76831668	DNA/TcMar-Tigger	1077	+	130	76831537	10112
chr11	76821425	77021425	harbor1	chr11	76831825	76832249	DNA/TcMar-Tigger	1342	+	212	76832037	10612
chr11	7398923	7598923	harbor1	chr11	7398695	7401435	DNA/TcMar-Tigger	15501	+	1370	7400065	1142
chr11	7398923	7598923	harbor1	chr11	7416475	7416789	DNA/TcMar-Tigger	1523	+	157	7416632	17709
chr11	7398923	7598923	harbor1	chr11	7478985	7479241	DNA/TcMar-Tigger	497	+	128	7479113	80190
chr11	89310322	89510322	harbor1	chr11	89345309	89345552	DNA/TcMar-Tigger	1283	+	122	89345431	35109
chr11	89310322	89510322	harbor1	chr11	89350792	89351829	DNA/TcMar-Tigger	11869	+	518	89351310	40988
chr11	89310322	89510322	harbor1	chr11	89352270	89352814	DNA/TcMar-Tigger	11869	+	272	89352542	42220
chr11	89310322	89510322	harbor1	chr11	89353098	89353668	DNA/TcMar-Tigger	11869	+	285	89353383	43061
chr11	89310322	89510322	harbor1	chr11	89374186	89374450	DNA/TcMar-Tigger	486	+	132	89374318	63996
chr11	14353441	14553441	harbor1	chr11	14370329	14370564	DNA/TcMar-Tigger	1678	+	118	14370447	17006
chr11	14353441	14553441	harbor1	chr11	14404300	14404580	DNA/TcMar-Tigger	3347	+	140	14404440	50999
chr11	14353441	14553441	harbor1	chr11	14404876	14404944	DNA/TcMar-Tigger	3347	+	34	14404910	51469
chr11	14353441	14553441	harbor1	chr11	14405544	14405755	DNA/TcMar-Tigger	3347	+	106	14405650	52209
chr11	14353441	14553441	harbor1	chr11	14405851	14405894	DNA/TcMar-Tigger	3347	+	22	14405873	52432
chr11	14353441	14553441	harbor1	chr11	14406238	14406508	DNA/TcMar-Tigger	1983	+	135	14406373	52932
chr11	14353441	14553441	harbor1	chr11	14439739	14439960	DNA/TcMar-Tigger	2668	+	110	14439849	86408
chr11	14353441	14553441	harbor1	chr11	14440271	14440503	DNA/TcMar-Tigger	2668	+	116	14440387	86946
chr11	107310238	107510238	harbor1	chr11	107340927	107341290	DNA/TcMar-Tigger	1573	+	182	107341109	30871
chr11	107310238	107510238	harbor1	chr11	107385594	107386104	DNA/TcMar-Tigger	2739	+	255	107385849	75611
chr11	130235908	130435908	harbor1	chr11	130264771	130265229	DNA/TcMar-Tigger	11844	+	229	130265000	29092
chr11	130235908	130435908	harbor1	chr11	130265477	130266965	DNA/TcMar-Tigger	11844	+	744	130266221	30313
chr11	130235908	130435908	harbor1	chr11	130267280	130267410	DNA/TcMar-Tigger	763	+	65	130267345	31437
chr11	130235908	130435908	harbor1	chr11	130267699	130267781	DNA/TcMar-Tigger	1150	+	41	130267740	31832
chr11	130235908	130435908	harbor1	chr11	130268091	130268111	DNA/TcMar-Tigger	1150	+	10	130268101	32193
chr11	130235908	130435908	harbor1	chr11	130268237	130268457	DNA/TcMar-Tigger	1150	+	110	130268347	32439
chr11	130235908	130435908	harbor1	chr11	130308027	130308287	DNA/TcMar-Tigger	1792	+	130	130308157	72249
chr11	2586496	2786496	harbor1	chr11	2595368	2595450	DNA/TcMar-Tigger	392	+	41	2595409	8913
chr11	2586496	2786496	harbor1	chr11	2595446	2596084	DNA/TcMar-Tigger	4251	+	319	2595765	9269
chr11	2586496	2786496	harbor1	chr11	2677034	2677779	DNA/TcMar-Tigger	1120	+	372	2677406	90910
chr11	108876011	109076011	harbor1	chr11	108881479	108881822	DNA/TcMar-Tigger	2002	+	172	108881651	5640
chr11	108876011	109076011	harbor1	chr11	108903414	108903776	DNA/TcMar-Tigger	1556	+	181	108903595	27584
chr11	108876011	109076011	harbor1	chr11	108947849	108948563	DNA/TcMar-Tigger	4391	+	357	108948206	72195
chr11	4313331	4513331	harbor1	chr11	4340237	4340276	DNA/TcMar-Tigger	605	+	20	4340257	26926
chr11	4313331	4513331	harbor1	chr11	4340570	4340632	DNA/TcMar-Tigger	605	+	31	4340601	27270
chr11	4313331	4513331	harbor1	chr11	4340746	4340767	DNA/TcMar-Tigger	3609	+	10	4340756	27425
chr11	4313331	4513331	harbor1	chr11	4341077	4341820	DNA/TcMar-Tigger	3609	+	372	4341449	28118
chr11	66712144	66912144	harbor1	chr11	66771870	66772167	DNA/TcMar-Tigger	1922	+	148	66772018	59874
chr11	118442766	118642766	harbor1	chr11	118488785	118488988	DNA/TcMar-Tigger	1835	+	102	118488887	46121
chr11	118442766	118642766	harbor1	chr11	118489253	118489383	DNA/TcMar-Tigger	1835	+	65	118489318	46552
chr11	95476904	95676904	harbor1	chr11	95506075	95506404	DNA/TcMar-Tigger	1975	+	164	95506239	29335
chr11	95476904	95676904	harbor1	chr11	95506396	95506545	DNA/TcMar-Tigger	860	+	74	95506470	29566
chr11	101981020	102181020	harbor1	chr11	101982760	101985282	DNA/TcMar-Tigger	16612	+	1261	101984021	3001
chr11	101981020	102181020	harbor1	chr11	101985582	101985711	DNA/TcMar-Tigger	16612	+	64	101985646	4626
chr11	111504747	111704747	harbor1	chr11	111520603	111520837	DNA/TcMar-Tigger	1237	+	117	111520720	15973
chr11	111504747	111704747	harbor1	chr11	111520837	111521036	DNA/TcMar-Tigger	1235	+	100	111520937	16190
chr11	111504747	111704747	harbor1	chr11	111522697	111522841	DNA/TcMar-Tigger	2849	+	72	111522769	18022
chr11	111504747	111704747	harbor1	chr11	111523087	111523566	DNA/TcMar-Tigger	2849	+	240	111523327	18580
chr11	111504747	111704747	harbor1	chr11	111567205	111567362	DNA/TcMar-Tigger	1442	+	78	111567283	62536
chr11	111504747	111704747	harbor1	chr11	111567657	111567779	DNA/TcMar-Tigger	1442	+	61	111567718	62971
chr11	127052771	127252771	harbor1	chr11	127060333	127060417	DNA/TcMar-Tigger	598	+	42	127060375	7604
chr11	127052771	127252771	harbor1	chr11	127060510	127060643	DNA/TcMar-Tigger	726	+	66	127060576	7805
chr11	127052771	127252771	harbor1	chr11	127121071	127121863	DNA/TcMar-Tigger	4382	+	396	127121467	68696
chr11	513500	713500	harbor1	chr11	513459	513714	DNA/TcMar-Tigger	1502	+	128	513587	87
chr11	513500	713500	harbor1	chr11	513846	513981	DNA/TcMar-Tigger	963	+	68	513914	414
chr11	513500	713500	harbor1	chr11	514581	514837	DNA/TcMar-Tigger	963	+	128	514709	1209
chr11	129394922	129594922	harbor1	chr11	129418868	129419456	DNA/TcMar-Tigger	3374	+	294	129419162	24240
chr11	25136854	25336854	harbor1	chr11	25226639	25227003	DNA/TcMar-Tigger	1516	+	182	25226821	89967
chr11	134739164	134939164	harbor1	chr11	134796036	134796142	DNA/TcMar-Tigger	1463	+	53	134796089	56925
chr11	134739164	134939164	harbor1	chr11	134796460	134796702	DNA/TcMar-Tigger	1463	+	121	134796581	57417
chr11	59944807	60144807	harbor1	chr11	59970492	59970830	DNA/TcMar-Tigger	936	+	169	59970661	25854
chr11	59944807	60144807	harbor1	chr11	60004801	60005639	DNA/TcMar-Tigger	4878	+	419	60005220	60413
chr11	59944807	60144807	harbor1	chr11	60010999	60011253	DNA/TcMar-Tigger	1686	+	127	60011126	66319
chr11	29062375	29262375	harbor1	chr11	29062979	29064092	DNA/TcMar-Tigger	6128	+	556	29063535	1160
chr11	29062375	29262375	harbor1	chr11	29064174	29064271	DNA/TcMar-Tigger	478	+	48	29064222	1847
chr11	29062375	29262375	harbor1	chr11	29084650	29085036	DNA/TcMar-Tigger	2038	+	193	29084843	22468
chr11	29062375	29262375	harbor1	chr11	29118929	29119256	DNA/TcMar-Tigger	1700	+	164	29119093	56718
chr11	118190620	118390620	harbor1	chr11	118282216	118282375	DNA/TcMar-Tigger	892	+	80	118282296	91676
chr11	118190620	118390620	harbor1	chr11	118283443	118284403	DNA/TcMar-Tigger	16486	+	480	118283923	93303
chr11	118190620	118390620	harbor1	chr11	118284714	118284725	DNA/TcMar-Tigger	16486	+	6	118284720	94100
chr11	118190620	118390620	harbor1	chr11	118285179	118285493	DNA/TcMar-Tigger	16486	+	157	118285336	94716
chr11	118190620	118390620	harbor1	chr11	118285805	118286760	DNA/TcMar-Tigger	16486	+	478	118286283	95663
chr11	118190620	118390620	harbor1	chr11	118287068	118287285	DNA/TcMar-Tigger	16486	+	108	118287176	96556
chr11	88388387	88588387	harbor1	chr11	88470637	88470893	DNA/TcMar-Tigger	1546	+	128	88470765	82378
chr11	41359916	41559916	harbor1	chr11	41397162	41397657	DNA/TcMar-Tigger	2732	+	248	41397410	37494
chr11	41359916	41559916	harbor1	chr11	41411623	41412470	DNA/TcMar-Tigger	4473	+	424	41412047	52131
chr11	41359916	41559916	harbor1	chr11	41444178	41444518	DNA/TcMar-Tigger	1820	+	170	41444348	84432
chr11	2565977	2765977	harbor1	chr11	2595368	2595450	DNA/TcMar-Tigger	392	+	41	2595409	29432
chr11	2565977	2765977	harbor1	chr11	2595446	2596084	DNA/TcMar-Tigger	4251	+	319	2595765	29788
chr11	42090385	42290385	harbor1	chr11	42177358	42177546	DNA/TcMar-Tigger	1029	+	94	42177452	87067
chr11	103502317	103702317	harbor1	chr11	103523210	103523366	DNA/TcMar-Tigger	729	+	78	103523288	20971
chr11	103502317	103702317	harbor1	chr11	103523434	103524152	DNA/TcMar-Tigger	3613	+	359	103523793	21476
chr11	103502317	103702317	harbor1	chr11	103539261	103539631	DNA/TcMar-Tigger	877	+	185	103539446	37129
chr11	131460042	131660042	harbor1	chr11	131527910	131528120	DNA/TcMar-Tigger	1066	+	105	131528015	67973
chr11	39686893	39886893	harbor1	chr11	39690596	39693265	DNA/TcMar-Tigger	14940	+	1334	39691930	5037
chr11	121963765	122163765	harbor1	chr11	122035413	122035719	DNA/TcMar-Tigger	865	+	153	122035566	71801
chr11	121963765	122163765	harbor1	chr11	122062911	122063059	DNA/TcMar-Tigger	549	+	74	122062985	99220
chr11	103477047	103677047	harbor1	chr11	103523210	103523366	DNA/TcMar-Tigger	729	+	78	103523288	46241
chr11	103477047	103677047	harbor1	chr11	103523434	103524152	DNA/TcMar-Tigger	3613	+	359	103523793	46746
chr11	103477047	103677047	harbor1	chr11	103539261	103539631	DNA/TcMar-Tigger	877	+	185	103539446	62399
chr11	66138353	66338353	harbor1	chr11	66194615	66194784	DNA/TcMar-Tigger	438	+	84	66194699	56346
chr11	6780138	6980138	harbor1	chr11	6821202	6821541	DNA/TcMar-Tigger	1827	+	170	6821372	41234
chr11	89538689	89738689	harbor1	chr11	89623814	89624054	DNA/TcMar-Tigger	767	+	120	89623934	85245
chr11	131462723	131662723	harbor1	chr11	131527910	131528120	DNA/TcMar-Tigger	1066	+	105	131528015	65292
chr11	94321756	94521756	harbor1	chr11	94377534	94377888	DNA/TcMar-Tigger	2230	+	177	94377711	55955
chr11	107138502	107338502	harbor1	chr11	107146269	107146591	DNA/TcMar-Tigger	1580	+	161	107146430	7928
chr11	107138502	107338502	harbor1	chr11	107164286	107164388	DNA/TcMar-Tigger	566	+	51	107164337	25835
chr11	118357495	118557495	harbor1	chr11	118358410	118358730	DNA/TcMar-Tigger	1792	+	160	118358570	1075
chr11	15716278	15916278	harbor1	chr11	15745733	15745944	DNA/TcMar-Tigger	909	+	106	15745839	29561
chr11	85608148	85808148	harbor1	chr11	85619961	85622403	DNA/TcMar-Tigger	14929	+	1221	85621182	13034
chr11	13740596	13940596	harbor1	chr11	13771858	13772125	DNA/TcMar-Tigger	692	+	134	13771992	31396
chr11	13740596	13940596	harbor1	chr11	13814296	13814684	DNA/TcMar-Tigger	2245	+	194	13814490	73894
chr11	13740596	13940596	harbor1	chr11	13814891	13814968	DNA/TcMar-Tigger	402	+	38	13814929	74333
chr11	63516977	63716977	harbor1	chr11	63555368	63555416	DNA/TcMar-Tigger	920	+	24	63555392	38415
chr11	63516977	63716977	harbor1	chr11	63555719	63555858	DNA/TcMar-Tigger	920	+	70	63555789	38812
chr11	83147528	83347528	harbor1	chr11	83226826	83227022	DNA/TcMar-Tigger	1126	+	98	83226924	79396
chr11	83147528	83347528	harbor1	chr11	83246118	83246455	DNA/TcMar-Tigger	1392	+	168	83246286	98758
chr11	95438969	95638969	harbor1	chr11	95448971	95449296	DNA/TcMar-Tigger	1928	+	162	95449133	10164
chr11	95438969	95638969	harbor1	chr11	95506075	95506404	DNA/TcMar-Tigger	1975	+	164	95506239	67270
chr11	95438969	95638969	harbor1	chr11	95506396	95506545	DNA/TcMar-Tigger	860	+	74	95506470	67501
chr11	88374871	88574871	harbor1	chr11	88470637	88470893	DNA/TcMar-Tigger	1546	+	128	88470765	95894
chr11	17145391	17345391	harbor1	chr11	17149004	17149238	DNA/TcMar-Tigger	1313	+	117	17149121	3730
chr11	17145391	17345391	harbor1	chr11	17149350	17149487	DNA/TcMar-Tigger	757	+	68	17149418	4027
chr11	17145391	17345391	harbor1	chr11	17183187	17183393	DNA/TcMar-Tigger	923	+	103	17183290	37899
chr11	17145391	17345391	harbor1	chr11	17183701	17183744	DNA/TcMar-Tigger	923	+	22	17183723	38332
chr11	17145391	17345391	harbor1	chr11	17184180	17184652	DNA/TcMar-Tigger	5102	+	236	17184416	39025
chr11	17145391	17345391	harbor1	chr11	17184944	17185460	DNA/TcMar-Tigger	5102	+	258	17185202	39811
chr11	17145391	17345391	harbor1	chr11	17185461	17185550	DNA/TcMar-Tigger	506	+	44	17185505	40114
chr11	100696789	100896789	harbor1	chr11	100780391	100780526	DNA/TcMar-Tigger	429	+	68	100780459	83670
chr11	100696789	100896789	harbor1	chr11	100795981	100796758	DNA/TcMar-Tigger	13535	+	388	100796369	99580
chr11	108145695	108345695	harbor1	chr11	108175040	108175368	DNA/TcMar-Tigger	2086	+	164	108175204	29509
chr11	108145695	108345695	harbor1	chr11	108184840	108184987	DNA/TcMar-Tigger	533	+	74	108184914	39219
chr11	108145695	108345695	harbor1	chr11	108216956	108217550	DNA/TcMar-Tigger	3608	+	297	108217253	71558
chr11	9554511	9754511	harbor1	chr11	9604024	9604116	DNA/TcMar-Tigger	392	+	46	9604070	49559
chr11	120980118	121180118	harbor1	chr11	121057539	121057861	DNA/TcMar-Tigger	1850	+	161	121057700	77582
chr11	89964595	90164595	harbor1	chr11	89967693	89967784	DNA/TcMar-Tigger	1058	+	46	89967739	3144
chr11	89964595	90164595	harbor1	chr11	89968080	89968317	DNA/TcMar-Tigger	1058	+	118	89968198	3603
chr11	89964595	90164595	harbor1	chr11	90003893	90004596	DNA/TcMar-Tigger	2748	+	352	90004245	39650
chr11	89964595	90164595	harbor1	chr11	90004599	90004694	DNA/TcMar-Tigger	525	+	48	90004647	40052
chr11	89964595	90164595	harbor1	chr11	90008005	90008112	DNA/TcMar-Tigger	557	+	54	90008059	43464
chr11	89964595	90164595	harbor1	chr11	90021280	90021347	DNA/TcMar-Tigger	384	+	34	90021314	56719
chr11	89964595	90164595	harbor1	chr11	90021332	90021770	DNA/TcMar-Tigger	1930	+	219	90021551	56956
chr11	89964595	90164595	harbor1	chr11	90031438	90031548	DNA/TcMar-Tigger	402	+	55	90031493	66898
chr11	89964595	90164595	harbor1	chr11	90033380	90033661	DNA/TcMar-Tigger	1565	+	140	90033520	68925
chr11	89964595	90164595	harbor1	chr11	90033976	90034026	DNA/TcMar-Tigger	1565	+	25	90034001	69406
chr11	133897656	134097656	harbor1	chr11	133921810	133921989	DNA/TcMar-Tigger	539	+	90	133921900	24244
chr11	20341874	20541874	harbor1	chr11	20398657	20398912	DNA/TcMar-Tigger	1583	+	128	20398785	56911
chr11	20341874	20541874	harbor1	chr11	20414438	20414866	DNA/TcMar-Tigger	1548	+	214	20414652	72778
chr11	106664915	106864915	harbor1	chr11	106707871	106708078	DNA/TcMar-Tigger	1045	+	104	106707975	43060
chr11	106664915	106864915	harbor1	chr11	106748959	106749294	DNA/TcMar-Tigger	1860	+	168	106749127	84212
chr11	111150438	111350438	harbor1	chr11	111191478	111191525	DNA/TcMar-Tigger	15005	+	24	111191502	41064
chr11	111150438	111350438	harbor1	chr11	111191834	111194186	DNA/TcMar-Tigger	15005	+	1176	111193010	42572
chr11	111150438	111350438	harbor1	chr11	111241562	111241682	DNA/TcMar-Tigger	825	+	60	111241622	91184
chr11	111150438	111350438	harbor1	chr11	111242809	111243115	DNA/TcMar-Tigger	1855	+	153	111242962	92524
chr11	56697911	56897911	harbor1	chr11	56715621	56716788	DNA/TcMar-Tigger	6277	+	584	56716205	18294
chr11	80011438	80211438	harbor1	chr11	80078072	80078171	DNA/TcMar-Tigger	480	+	50	80078122	66684
chr11	80011438	80211438	harbor1	chr11	80079249	80079590	DNA/TcMar-Tigger	1829	+	170	80079419	67981
chr11	80011438	80211438	harbor1	chr11	80093048	80093209	DNA/TcMar-Tigger	581	+	80	80093128	81690
chr11	74732599	74932599	harbor1	chr11	74771271	74771433	DNA/TcMar-Tigger	1348	+	81	74771352	38753
chr11	74732599	74932599	harbor1	chr11	74771718	74771770	DNA/TcMar-Tigger	1348	+	26	74771744	39145
chr11	74732599	74932599	harbor1	chr11	74771908	74772044	DNA/TcMar-Tigger	1348	+	68	74771976	39377
chr11	74732599	74932599	harbor1	chr11	74792343	74792405	DNA/TcMar-Tigger	461	+	31	74792374	59775
chr11	74732599	74932599	harbor1	chr11	74793301	74793588	DNA/TcMar-Tigger	642	+	144	74793445	60846
chr11	74732599	74932599	harbor1	chr11	74803964	74804802	DNA/TcMar-Tigger	4841	+	419	74804383	71784
chr11	74732599	74932599	harbor1	chr11	74805733	74805969	DNA/TcMar-Tigger	1166	+	118	74805851	73252
chr11	74732599	74932599	harbor1	chr11	74792700	74792986	DNA/TcMar-Tigger	461	+	143	74792843	60244
chr11	9234763	9434763	harbor1	chr11	9243407	9243606	DNA/TcMar-Tigger	2409	+	100	9243507	8744
chr11	9234763	9434763	harbor1	chr11	9243900	9244137	DNA/TcMar-Tigger	2409	+	118	9244018	9255
chr11	124337303	124537303	harbor1	chr11	124344757	124345751	DNA/TcMar-Tigger	12934	+	497	124345254	7951
chr11	124337303	124537303	harbor1	chr11	124346062	124347141	DNA/TcMar-Tigger	12934	+	540	124346602	9299
chr11	124337303	124537303	harbor1	chr11	124427847	124427993	DNA/TcMar-Tigger	685	+	73	124427920	90617
chr11	69096292	69296292	harbor1	chr11	69124774	69125061	DNA/TcMar-Tigger	1225	+	144	69124918	28626
chr11	69096292	69296292	harbor1	chr11	69168436	69168727	DNA/TcMar-Tigger	1354	+	146	69168582	72290
chr11	69096292	69296292	harbor1	chr11	69169023	69169258	DNA/TcMar-Tigger	933	+	118	69169141	72849
chr11	83020976	83220976	harbor1	chr11	83093904	83094098	DNA/TcMar-Tigger	651	+	97	83094001	73025
chr11	94913229	95113229	harbor1	chr11	94950371	94950562	DNA/TcMar-Tigger	1202	+	96	94950467	37238
chr11	46701651	46901651	harbor1	chr11	46787798	46788235	DNA/TcMar-Tigger	2573	+	218	46788016	86365
chr11	43029780	43229780	harbor1	chr11	43082586	43082915	DNA/TcMar-Tigger	1847	+	164	43082750	52970
chr11	89717674	89917674	harbor1	chr11	89738617	89738967	DNA/TcMar-Tigger	1787	+	175	89738792	21118
chr11	89717674	89917674	harbor1	chr11	89765973	89766121	DNA/TcMar-Tigger	615	+	74	89766047	48373
chr11	89717674	89917674	harbor1	chr11	89771971	89772415	DNA/TcMar-Tigger	1997	+	222	89772193	54519
chr11	89717674	89917674	harbor1	chr11	89776177	89776267	DNA/TcMar-Tigger	1067	+	45	89776222	58548
chr11	89717674	89917674	harbor1	chr11	89776557	89776796	DNA/TcMar-Tigger	1067	+	120	89776677	59003
chr11	123804540	124004540	harbor1	chr11	123897802	123898148	DNA/TcMar-Tigger	1955	+	173	123897975	93435
chr11	123804540	124004540	harbor1	chr11	123902979	123903308	DNA/TcMar-Tigger	1748	+	164	123903143	98603
chr11	6773256	6973256	harbor1	chr11	6821202	6821541	DNA/TcMar-Tigger	1827	+	170	6821372	48116
chr11	125974239	126174239	harbor1	chr11	125987003	125987626	DNA/TcMar-Tigger	783	+	312	125987315	13076
chr11	125974239	126174239	harbor1	chr11	126052449	126052540	DNA/TcMar-Tigger	980	+	46	126052495	78256
chr11	125974239	126174239	harbor1	chr11	126052853	126053052	DNA/TcMar-Tigger	980	+	100	126052953	78714
chr11	84683124	84883124	harbor1	chr11	84749365	84749704	DNA/TcMar-Tigger	2011	+	170	84749535	66411
chr11	49707120	49907120	harbor1	chr11	49752137	49754254	DNA/TcMar-Tigger	12181	+	1058	49753195	46075
chr11	49707120	49907120	harbor1	chr11	49791583	49791721	DNA/TcMar-Tigger	600	+	69	49791652	84532
chr11	49707120	49907120	harbor1	chr11	49799259	49801779	DNA/TcMar-Tigger	13696	+	1260	49800519	93399
chr11	89153096	89353096	harbor1	chr11	89189865	89191085	DNA/TcMar-Tigger	6361	+	610	89190475	37379
chr11	77855610	78055610	harbor1	chr11	77944658	77944920	DNA/TcMar-Tigger	1319	+	131	77944789	89179
chr11	95721650	95921650	harbor1	chr11	95740360	95740441	DNA/TcMar-Tigger	479	+	40	95740400	18750
chr11	95721650	95921650	harbor1	chr11	95740440	95740754	DNA/TcMar-Tigger	1821	+	157	95740597	18947
chr11	95721650	95921650	harbor1	chr11	95755911	95756080	DNA/TcMar-Tigger	451	+	84	95755995	34345
chr11	95721650	95921650	harbor1	chr11	95782259	95782500	DNA/TcMar-Tigger	1301	+	120	95782379	60729
chr11	95721650	95921650	harbor1	chr11	95783689	95784012	DNA/TcMar-Tigger	1652	+	162	95783851	62201
chr11	95721650	95921650	harbor1	chr11	95784439	95784586	DNA/TcMar-Tigger	1652	+	74	95784513	62863
chr11	95721650	95921650	harbor1	chr11	95784887	95785025	DNA/TcMar-Tigger	592	+	69	95784956	63306
chr11	95721650	95921650	harbor1	chr11	95785036	95785328	DNA/TcMar-Tigger	1341	+	146	95785182	63532
chr11	95027815	95227815	harbor1	chr11	95063305	95064334	DNA/TcMar-Tigger	5838	+	514	95063819	36004
chr11	17240056	17440056	harbor1	chr11	17309839	17310117	DNA/TcMar-Tigger	920	+	139	17309978	69922
chr11	32256513	32456513	harbor1	chr11	32340903	32341041	DNA/TcMar-Tigger	486	+	69	32340972	84459
chr11	74867983	75067983	harbor1	chr11	74926376	74926679	DNA/TcMar-Tigger	580	+	152	74926528	58545
chr11	12286716	12486716	harbor1	chr11	12347660	12347773	DNA/TcMar-Tigger	1106	+	56	12347716	61000
chr11	12286716	12486716	harbor1	chr11	12348414	12348514	DNA/TcMar-Tigger	1106	+	50	12348464	61748
chr11	31962740	32162740	harbor1	chr11	32049064	32049395	DNA/TcMar-Tigger	1368	+	166	32049230	86490
chr11	31962740	32162740	harbor1	chr11	32059850	32060066	DNA/TcMar-Tigger	606	+	108	32059958	97218
chr11	31962740	32162740	harbor1	chr11	32060918	32060960	DNA/TcMar-Tigger	606	+	21	32060939	98199
chr11	9018191	9218191	harbor1	chr11	9023158	9023390	DNA/TcMar-Tigger	986	+	116	9023274	5083
chr11	14582869	14782869	harbor1	chr11	14603643	14603792	DNA/TcMar-Tigger	570	+	74	14603717	20848
chr11	14582869	14782869	harbor1	chr11	14681172	14681245	DNA/TcMar-Tigger	427	+	36	14681208	98339
chr11	2501603	2701603	harbor1	chr11	2595368	2595450	DNA/TcMar-Tigger	392	+	41	2595409	93806
chr11	2501603	2701603	harbor1	chr11	2595446	2596084	DNA/TcMar-Tigger	4251	+	319	2595765	94162
chr11	25378601	25578601	harbor1	chr11	25451915	25452027	DNA/TcMar-Tigger	6466	+	56	25451971	73370
chr11	25378601	25578601	harbor1	chr11	25452332	25453401	DNA/TcMar-Tigger	6466	+	534	25452866	74265
chr11	25378601	25578601	harbor1	chr11	25453776	25453830	DNA/TcMar-Tigger	6466	+	27	25453803	75202
chr11	47771432	47971432	harbor1	chr11	47799842	47799971	DNA/TcMar-Tigger	923	+	64	47799906	28474
chr11	47771432	47971432	harbor1	chr11	47800265	47800301	DNA/TcMar-Tigger	923	+	18	47800283	28851
chr11	103797045	103997045	harbor1	chr11	103809130	103809350	DNA/TcMar-Tigger	803	+	110	103809240	12195
chr11	103797045	103997045	harbor1	chr11	103872765	103872961	DNA/TcMar-Tigger	1091	+	98	103872863	75818
chr11	103797045	103997045	harbor1	chr11	103873092	103873686	DNA/TcMar-Tigger	3173	+	297	103873389	76344
chr11	103797045	103997045	harbor1	chr11	103874228	103874623	DNA/TcMar-Tigger	1960	+	198	103874426	77381
chr11	109724655	109924655	harbor1	chr11	109791092	109792613	DNA/TcMar-Tigger	9275	+	760	109791852	67197
chr11	109724655	109924655	harbor1	chr11	109792624	109793045	DNA/TcMar-Tigger	3229	+	210	109792834	68179
chr11	109724655	109924655	harbor1	chr11	109793232	109793596	DNA/TcMar-Tigger	3229	+	182	109793414	68759
chr11	9135891	9335891	harbor1	chr11	9153822	9154022	DNA/TcMar-Tigger	664	+	100	9153922	18031
chr11	9135891	9335891	harbor1	chr11	9154005	9154127	DNA/TcMar-Tigger	482	+	61	9154066	18175
chr11	9135891	9335891	harbor1	chr11	9154370	9154495	DNA/TcMar-Tigger	482	+	62	9154432	18541
chr11	9135891	9335891	harbor1	chr11	9198021	9198332	DNA/TcMar-Tigger	1437	+	156	9198177	62286
chr11	9135891	9335891	harbor1	chr11	9198633	9198788	DNA/TcMar-Tigger	1437	+	78	9198711	62820
chr11	9135891	9335891	harbor1	chr11	9199079	9199191	DNA/TcMar-Tigger	1437	+	56	9199135	63244
chr11	123475973	123675973	harbor1	chr11	123515340	123515501	DNA/TcMar-Tigger	839	+	80	123515420	39447
chr11	125208254	125408254	harbor1	chr11	125249374	125249719	DNA/TcMar-Tigger	1954	+	172	125249546	41292
chr11	29635974	29835974	harbor1	chr11	29673055	29673420	DNA/TcMar-Tigger	2119	+	182	29673237	37263
chr11	113746120	113946120	harbor1	chr11	113752394	113753021	DNA/TcMar-Tigger	13011	+	314	113752708	6588
chr11	113746120	113946120	harbor1	chr11	113753303	113753394	DNA/TcMar-Tigger	13011	+	46	113753349	7229
chr11	113746120	113946120	harbor1	chr11	113754492	113754620	DNA/TcMar-Tigger	13011	+	64	113754556	8436
chr11	113746120	113946120	harbor1	chr11	113754941	113756084	DNA/TcMar-Tigger	13011	+	572	113755513	9393
chr11	113746120	113946120	harbor1	chr11	113797338	113797565	DNA/TcMar-Tigger	1216	+	114	113797452	51332
chr11	113746120	113946120	harbor1	chr11	113753705	113754202	DNA/TcMar-Tigger	13011	+	248	113753953	7833
chr11	11088926	11288926	harbor1	chr11	11120586	11121170	DNA/TcMar-Tigger	3596	+	292	11120878	31952
chr11	106062763	106262763	harbor1	chr11	106080084	106080340	DNA/TcMar-Tigger	851	+	128	106080212	17449
chr11	106062763	106262763	harbor1	chr11	106092654	106093008	DNA/TcMar-Tigger	1972	+	177	106092831	30068
chr11	109175385	109375385	harbor1	chr11	109247104	109247695	DNA/TcMar-Tigger	3551	+	296	109247400	72015
chr11	109175385	109375385	harbor1	chr11	109247992	109248109	DNA/TcMar-Tigger	3551	+	58	109248050	72665
chr11	10446664	10646664	harbor1	chr11	10464810	10464922	DNA/TcMar-Tigger	462	+	56	10464866	18202
chr11	80368797	80568797	harbor1	chr11	80419457	80420628	DNA/TcMar-Tigger	6678	+	586	80420043	51246
chr11	20604955	20804955	harbor1	chr11	20677363	20677708	DNA/TcMar-Tigger	1011	+	172	20677535	72580
chr11	30235927	30435927	harbor1	chr11	30333294	30334208	DNA/TcMar-Tigger	12894	+	457	30333751	97824
chr11	30235927	30435927	harbor1	chr11	30334514	30335858	DNA/TcMar-Tigger	12894	+	672	30335186	99259
chr11	83901266	84101266	harbor1	chr11	83981904	83983103	DNA/TcMar-Tigger	6546	+	600	83982504	81238
chr11	9375860	9575860	harbor1	chr11	9375784	9375958	DNA/TcMar-Tigger	656	+	87	9375871	11
chr11	132239446	132439446	harbor1	chr11	132240870	132241226	DNA/TcMar-Tigger	2388	+	178	132241048	1602
chr11	5384615	5584615	harbor1	chr11	5410459	5410555	DNA/TcMar-Tigger	514	+	48	5410507	25892
chr11	5384615	5584615	harbor1	chr11	5410528	5411483	DNA/TcMar-Tigger	5156	+	478	5411006	26391
chr11	5384615	5584615	harbor1	chr11	5419377	5419704	DNA/TcMar-Tigger	1429	+	164	5419541	34926
chr11	7813040	8013040	harbor1	chr11	7845936	7846276	DNA/TcMar-Tigger	2173	+	170	7846106	33066
chr11	75168679	75368679	harbor1	chr11	75256646	75257209	DNA/TcMar-Tigger	2971	+	282	75256928	88249
chr11	127350412	127550412	harbor1	chr11	127372690	127373047	DNA/TcMar-Tigger	2326	+	178	127372868	22456
chr11	127350412	127550412	harbor1	chr11	127381408	127381539	DNA/TcMar-Tigger	561	+	66	127381474	31062
chr11	9538801	9738801	harbor1	chr11	9549771	9550444	DNA/TcMar-Tigger	4188	+	336	9550107	11306
chr11	9538801	9738801	harbor1	chr11	9604024	9604116	DNA/TcMar-Tigger	392	+	46	9604070	65269
chr11	18238699	18438699	harbor1	chr11	18337531	18337784	DNA/TcMar-Tigger	493	+	126	18337657	98958
chr11	95914558	96114558	harbor1	chr11	95925907	95926198	DNA/TcMar-Tigger	1281	+	146	95926053	11495
chr11	95914558	96114558	harbor1	chr11	95959499	95959636	DNA/TcMar-Tigger	841	+	68	95959567	45009
chr11	95914558	96114558	harbor1	chr11	95959636	95959990	DNA/TcMar-Tigger	2182	+	177	95959813	45255
chr11	95914558	96114558	harbor1	chr11	95959985	95960075	DNA/TcMar-Tigger	599	+	45	95960030	45472
chr11	95914558	96114558	harbor1	chr11	95982740	95983292	DNA/TcMar-Tigger	5808	+	276	95983016	68458
chr11	95914558	96114558	harbor1	chr11	95983704	95984343	DNA/TcMar-Tigger	5808	+	320	95984024	69466
chr11	111999346	112199346	harbor1	chr11	112056879	112057784	DNA/TcMar-Tigger	5740	+	452	112057331	57985
chr11	111999346	112199346	harbor1	chr11	112057787	112058067	DNA/TcMar-Tigger	1701	+	140	112057927	58581
chr11	18275911	18475911	harbor1	chr11	18337531	18337784	DNA/TcMar-Tigger	493	+	126	18337657	61746
chr11	18267351	18467351	harbor1	chr11	18337531	18337784	DNA/TcMar-Tigger	493	+	126	18337657	70306
chr11	85876108	86076108	harbor1	chr11	85894197	85894351	DNA/TcMar-Tigger	535	+	77	85894274	18166
chr11	85876108	86076108	harbor1	chr11	85923129	85923476	DNA/TcMar-Tigger	2148	+	174	85923303	47195
chr11	85876108	86076108	harbor1	chr11	85973330	85973664	DNA/TcMar-Tigger	1402	+	167	85973497	97389
chr11	65446051	65646051	harbor1	chr11	65495319	65495371	DNA/TcMar-Tigger	1116	+	26	65495345	49294
chr11	65446051	65646051	harbor1	chr11	65495684	65495920	DNA/TcMar-Tigger	1116	+	118	65495802	49751
chr11	65446051	65646051	harbor1	chr11	65527316	65527457	DNA/TcMar-Tigger	1250	+	70	65527386	81335
chr11	65446051	65646051	harbor1	chr11	65527754	65527853	DNA/TcMar-Tigger	1250	+	50	65527804	81753
chr11	101771192	101971192	harbor1	chr11	101833499	101835904	DNA/TcMar-Tigger	13961	+	1202	101834701	63509
chr11	8162192	8362192	harbor1	chr11	8188640	8188721	DNA/TcMar-Tigger	489	+	40	8188680	26488
chr11	8162192	8362192	harbor1	chr11	8188727	8189236	DNA/TcMar-Tigger	3715	+	254	8188981	26789
chr11	44566246	44766246	harbor1	chr11	44608606	44608815	DNA/TcMar-Tigger	615	+	104	44608710	42464
chr11	44566246	44766246	harbor1	chr11	44641202	44641606	DNA/TcMar-Tigger	1736	+	202	44641404	75158
chr11	87861723	88061723	harbor1	chr11	87921156	87921539	DNA/TcMar-Tigger	2028	+	192	87921348	59625
chr11	87861723	88061723	harbor1	chr11	87931384	87931659	DNA/TcMar-Tigger	558	+	138	87931522	69799
chr11	87861723	88061723	harbor1	chr11	87953407	87953755	DNA/TcMar-Tigger	1284	+	174	87953581	91858
chr11	87861723	88061723	harbor1	chr11	87957976	87958369	DNA/TcMar-Tigger	2076	+	196	87958172	96449
chr11	69936563	70136563	harbor1	chr11	70002097	70002169	DNA/TcMar-Tigger	1560	+	36	70002133	65570
chr11	69936563	70136563	harbor1	chr11	70002489	70002695	DNA/TcMar-Tigger	1560	+	103	70002592	66029
chr11	104703064	104903064	harbor1	chr11	104796782	104797049	DNA/TcMar-Tigger	711	+	134	104796916	93852
chr11	85906126	86106126	harbor1	chr11	85923129	85923476	DNA/TcMar-Tigger	2148	+	174	85923303	17177
chr11	85906126	86106126	harbor1	chr11	85973330	85973664	DNA/TcMar-Tigger	1402	+	167	85973497	67371
chr11	85906126	86106126	harbor1	chr11	85980026	85980228	DNA/TcMar-Tigger	897	+	101	85980127	74001
chr11	85906126	86106126	harbor1	chr11	85980460	85980550	DNA/TcMar-Tigger	457	+	45	85980505	74379
chr11	104394103	104594103	harbor1	chr11	104415904	104416138	DNA/TcMar-Tigger	1167	+	117	104416021	21918
chr11	104394103	104594103	harbor1	chr11	104456631	104456905	DNA/TcMar-Tigger	1507	+	137	104456768	62665
chr11	104394103	104594103	harbor1	chr11	104456958	104457786	DNA/TcMar-Tigger	4976	+	414	104457372	63269
chr11	99067646	99267646	harbor1	chr11	99085748	99085884	DNA/TcMar-Tigger	648	+	68	99085816	18170
chr11	99067646	99267646	harbor1	chr11	99085882	99086004	DNA/TcMar-Tigger	725	+	61	99085943	18297
chr11	84881492	85081492	harbor1	chr11	84884732	84885138	DNA/TcMar-Tigger	1913	+	203	84884935	3443
chr11	84881492	85081492	harbor1	chr11	84896632	84896965	DNA/TcMar-Tigger	1529	+	166	84896798	15306
chr11	84881492	85081492	harbor1	chr11	84926710	84927011	DNA/TcMar-Tigger	670	+	150	84926860	45368
chr11	61038779	61238779	harbor1	chr11	61108264	61108501	DNA/TcMar-Tigger	647	+	118	61108382	69603
chr11	61038779	61238779	harbor1	chr11	61109199	61109330	DNA/TcMar-Tigger	567	+	66	61109265	70486
chr11	37701605	37901605	harbor1	chr11	37738952	37739184	DNA/TcMar-Tigger	559	+	116	37739068	37463
chr11	130590810	130790810	harbor1	chr11	130595055	130595271	DNA/TcMar-Tigger	1273	+	108	130595163	4353
chr11	130590810	130790810	harbor1	chr11	130615063	130617526	DNA/TcMar-Tigger	15184	+	1232	130616295	25485
chr11	125523757	125723757	harbor1	chr11	125607003	125607368	DNA/TcMar-Tigger	2369	+	182	125607185	83428
chr11	125523757	125723757	harbor1	chr11	125615420	125615700	DNA/TcMar-Tigger	1409	+	140	125615560	91803
chr11	27928269	28128269	harbor1	chr11	27993896	27996282	DNA/TcMar-Tigger	14978	+	1193	27995089	66820
chr11	27928269	28128269	harbor1	chr11	28015139	28015437	DNA/TcMar-Tigger	1612	+	149	28015288	87019
chr11	27928269	28128269	harbor1	chr11	28017601	28018164	DNA/TcMar-Tigger	2274	+	282	28017883	89614
chr11	82433722	82633722	harbor1	chr11	82513365	82513661	DNA/TcMar-Tigger	1520	+	148	82513513	79791
chr11	82433722	82633722	harbor1	chr11	82530318	82530539	DNA/TcMar-Tigger	734	+	110	82530428	96706
chr11	82433722	82633722	harbor1	chr11	82532492	82532938	DNA/TcMar-Tigger	845	+	223	82532715	98993
chr11	106429639	106629639	harbor1	chr11	106516950	106517269	DNA/TcMar-Tigger	1258	+	160	106517110	87471
chr11	14518134	14718134	harbor1	chr11	14543680	14543884	DNA/TcMar-Tigger	1059	+	102	14543782	25648
chr11	14518134	14718134	harbor1	chr11	14567532	14568166	DNA/TcMar-Tigger	3657	+	317	14567849	49715
chr11	14518134	14718134	harbor1	chr11	14603643	14603792	DNA/TcMar-Tigger	570	+	74	14603717	85583
chr11	74281987	74481987	harbor1	chr11	74368945	74369750	DNA/TcMar-Tigger	5205	+	402	74369347	87360
chr11	74281987	74481987	harbor1	chr11	74370047	74370336	DNA/TcMar-Tigger	5205	+	144	74370191	88204
chr11	66437089	66637089	harbor1	chr11	66499463	66499487	DNA/TcMar-Tigger	1061	+	12	66499475	62386
chr11	66437089	66637089	harbor1	chr11	66499787	66500000	DNA/TcMar-Tigger	1061	+	106	66499893	62804
chr11	112077533	112277533	harbor1	chr11	112171036	112171384	DNA/TcMar-Tigger	2014	+	174	112171210	93677
chr11	131470084	131670084	harbor1	chr11	131527910	131528120	DNA/TcMar-Tigger	1066	+	105	131528015	57931
chr11	37039267	37239267	harbor1	chr11	37095492	37096526	DNA/TcMar-Tigger	5630	+	517	37096009	56742
chr11	93147205	93347205	harbor1	chr11	93203719	93204688	DNA/TcMar-Tigger	5721	+	484	93204203	56998
chr11	93147205	93347205	harbor1	chr11	93204990	93205052	DNA/TcMar-Tigger	5721	+	31	93205021	57816
chr11	100699795	100899795	harbor1	chr11	100780391	100780526	DNA/TcMar-Tigger	429	+	68	100780459	80664
chr11	100699795	100899795	harbor1	chr11	100795981	100796758	DNA/TcMar-Tigger	13535	+	388	100796369	96574
chr11	100699795	100899795	harbor1	chr11	100797067	100798773	DNA/TcMar-Tigger	13535	+	853	100797920	98125
chr11	21664253	21864253	harbor1	chr11	21719774	21719912	DNA/TcMar-Tigger	430	+	69	21719843	55590
chr11	130897120	131097120	harbor1	chr11	130927976	130928333	DNA/TcMar-Tigger	2201	+	178	130928154	31034
chr11	130897120	131097120	harbor1	chr11	130945901	130946506	DNA/TcMar-Tigger	3227	+	302	130946203	49083
chr11	16089545	16289545	harbor1	chr11	16134439	16134886	DNA/TcMar-Tigger	2876	+	224	16134663	45118
chr11	16089545	16289545	harbor1	chr11	16134882	16136028	DNA/TcMar-Tigger	8650	+	573	16135455	45910
chr11	16089545	16289545	harbor1	chr11	16136280	16136408	DNA/TcMar-Tigger	8650	+	64	16136344	46799
chr11	16089545	16289545	harbor1	chr11	16136736	16136851	DNA/TcMar-Tigger	8650	+	58	16136794	47249
chr11	10075016	10275016	harbor1	chr11	10121708	10122408	DNA/TcMar-Tigger	3907	+	350	10122058	47042
chr11	10075016	10275016	harbor1	chr11	10122503	10122727	DNA/TcMar-Tigger	459	+	112	10122615	47599
chr11	24871415	25071415	harbor1	chr11	24920997	24921050	DNA/TcMar-Tigger	741	+	26	24921023	49608
chr11	24871415	25071415	harbor1	chr11	24921683	24921836	DNA/TcMar-Tigger	741	+	76	24921759	50344
chr11	99426326	99626326	harbor1	chr11	99510565	99510770	DNA/TcMar-Tigger	969	+	102	99510667	84341
chr11	99426326	99626326	harbor1	chr11	99510748	99511135	DNA/TcMar-Tigger	2097	+	194	99510942	84616
chr11	99426326	99626326	harbor1	chr11	99511839	99512392	DNA/TcMar-Tigger	2870	+	276	99512115	85789
chr11	99426326	99626326	harbor1	chr11	99512472	99514852	DNA/TcMar-Tigger	14108	+	1190	99513662	87336
chr11	41932777	42132777	harbor1	chr11	41991839	41992432	DNA/TcMar-Tigger	3169	+	296	41992135	59358
chr11	84827260	85027260	harbor1	chr11	84884732	84885138	DNA/TcMar-Tigger	1913	+	203	84884935	57675
chr11	84827260	85027260	harbor1	chr11	84896632	84896965	DNA/TcMar-Tigger	1529	+	166	84896798	69538
chr11	84827260	85027260	harbor1	chr11	84926710	84927011	DNA/TcMar-Tigger	670	+	150	84926860	99600
chr11	101819670	102019670	harbor1	chr11	101833499	101835904	DNA/TcMar-Tigger	13961	+	1202	101834701	15031
chr11	36393814	36593814	harbor1	chr11	36407618	36407811	DNA/TcMar-Tigger	401	+	96	36407714	13900
chr11	36393814	36593814	harbor1	chr11	36423937	36424363	DNA/TcMar-Tigger	1019	+	213	36424150	30336
chr11	111615877	111815877	harbor1	chr11	111627266	111627577	DNA/TcMar-Tigger	1764	+	156	111627422	11545
chr11	43874803	44074803	harbor1	chr11	43876786	43877109	DNA/TcMar-Tigger	1811	+	162	43876948	2145
chr11	122003914	122203914	harbor1	chr11	122035413	122035719	DNA/TcMar-Tigger	865	+	153	122035566	31652
chr11	122003914	122203914	harbor1	chr11	122062911	122063059	DNA/TcMar-Tigger	549	+	74	122062985	59071
chr11	10748739	10948739	harbor1	chr11	10818585	10818845	DNA/TcMar-Tigger	2125	+	130	10818715	69976
chr11	10748739	10948739	harbor1	chr11	10819298	10819510	DNA/TcMar-Tigger	2125	+	106	10819404	70665
chr11	43313433	43513433	harbor1	chr11	43402580	43402774	DNA/TcMar-Tigger	1091	+	97	43402677	89244
chr11	43313433	43513433	harbor1	chr11	43412568	43412801	DNA/TcMar-Tigger	1408	+	116	43412684	99251
chr11	39900897	40100897	harbor1	chr11	39935072	39936430	DNA/TcMar-Tigger	7010	+	679	39935751	34854
chr11	39900897	40100897	harbor1	chr11	39936926	39937833	DNA/TcMar-Tigger	5497	+	454	39937380	36483
chr11	39900897	40100897	harbor1	chr11	39955202	39955361	DNA/TcMar-Tigger	595	+	80	39955282	54385
chr11	127802337	128002337	harbor1	chr11	127834869	127835627	DNA/TcMar-Tigger	4598	+	379	127835248	32911
chr11	101922535	102122535	harbor1	chr11	101982760	101985282	DNA/TcMar-Tigger	16612	+	1261	101984021	61486
chr11	101922535	102122535	harbor1	chr11	101985582	101985711	DNA/TcMar-Tigger	16612	+	64	101985646	63111
chr11	19057301	19257301	harbor1	chr11	19128902	19129051	DNA/TcMar-Tigger	757	+	74	19128976	71675
chr11	95758688	95958688	harbor1	chr11	95782259	95782500	DNA/TcMar-Tigger	1301	+	120	95782379	23691
chr11	95758688	95958688	harbor1	chr11	95783689	95784012	DNA/TcMar-Tigger	1652	+	162	95783851	25163
chr11	95758688	95958688	harbor1	chr11	95784439	95784586	DNA/TcMar-Tigger	1652	+	74	95784513	25825
chr11	95758688	95958688	harbor1	chr11	95784887	95785025	DNA/TcMar-Tigger	592	+	69	95784956	26268
chr11	95758688	95958688	harbor1	chr11	95785036	95785328	DNA/TcMar-Tigger	1341	+	146	95785182	26494
chr11	95758688	95958688	harbor1	chr11	95823314	95824082	DNA/TcMar-Tigger	4676	+	384	95823698	65010
chr11	95758688	95958688	harbor1	chr11	95824259	95825593	DNA/TcMar-Tigger	10077	+	667	95824926	66238
chr11	95758688	95958688	harbor1	chr11	95825872	95826354	DNA/TcMar-Tigger	10077	+	241	95826113	67425
chr11	95758688	95958688	harbor1	chr11	95826609	95826682	DNA/TcMar-Tigger	10077	+	36	95826645	67957
chr11	95758688	95958688	harbor1	chr11	95844353	95844563	DNA/TcMar-Tigger	972	+	105	95844458	85770
chr12	104538620	104738620	harbor1	chr12	104586433	104587000	DNA/TcMar-Tigger	1559	+	284	104586717	48097
chr12	104538620	104738620	harbor1	chr12	104619821	104620012	DNA/TcMar-Tigger	474	+	96	104619917	81297
chr12	19104507	19304507	harbor1	chr12	19165861	19166013	DNA/TcMar-Tigger	691	+	76	19165937	61430
chr12	100983460	101183460	harbor1	chr12	101037409	101037628	DNA/TcMar-Tigger	506	+	110	101037519	54059
chr12	100983460	101183460	harbor1	chr12	101064704	101065248	DNA/TcMar-Tigger	3144	+	272	101064976	81516
chr12	34153109	34353109	harbor1	chr12	34153679	34153977	DNA/TcMar-Tigger	1660	+	149	34153828	719
chr12	77103330	77303330	harbor1	chr12	77113171	77113340	DNA/TcMar-Tigger	1005	+	84	77113255	9925
chr12	77103330	77303330	harbor1	chr12	77113648	77113754	DNA/TcMar-Tigger	1005	+	53	77113701	10371
chr12	99489484	99689484	harbor1	chr12	99508858	99510863	DNA/TcMar-Tigger	12930	+	1002	99509860	20376
chr12	99489484	99689484	harbor1	chr12	99513065	99513398	DNA/TcMar-Tigger	2029	+	166	99513231	23747
chr12	99489484	99689484	harbor1	chr12	99587290	99587583	DNA/TcMar-Tigger	739	+	146	99587436	97952
chr12	20794026	20994026	harbor1	chr12	20813281	20813911	DNA/TcMar-Tigger	2621	+	315	20813596	19570
chr12	20794026	20994026	harbor1	chr12	20856433	20856554	DNA/TcMar-Tigger	988	+	60	20856493	62467
chr12	20794026	20994026	harbor1	chr12	20856858	20856958	DNA/TcMar-Tigger	988	+	50	20856908	62882
chr12	20794026	20994026	harbor1	chr12	20865542	20868170	DNA/TcMar-Tigger	13606	+	1314	20866856	72830
chr12	20794026	20994026	harbor1	chr12	20868281	20868374	DNA/TcMar-Tigger	541	+	46	20868327	74301
chr12	111484386	111684386	harbor1	chr12	111560251	111560454	DNA/TcMar-Tigger	1142	+	102	111560353	75967
chr12	111484386	111684386	harbor1	chr12	111565208	111565429	DNA/TcMar-Tigger	1094	+	110	111565318	80932
chr12	111484386	111684386	harbor1	chr12	111565500	111565713	DNA/TcMar-Tigger	1135	+	106	111565606	81220
chr12	111484386	111684386	harbor1	chr12	111566012	111566150	DNA/TcMar-Tigger	3285	+	69	111566081	81695
chr12	111484386	111684386	harbor1	chr12	111566466	111566633	DNA/TcMar-Tigger	3285	+	84	111566550	82164
chr12	111484386	111684386	harbor1	chr12	111566938	111567218	DNA/TcMar-Tigger	3285	+	140	111567078	82692
chr12	111484386	111684386	harbor1	chr12	111578216	111578654	DNA/TcMar-Tigger	2475	+	219	111578435	94049
chr12	38387296	38587296	harbor1	chr12	38407587	38407985	DNA/TcMar-Tigger	1896	+	199	38407786	20490
chr12	38387296	38587296	harbor1	chr12	38416339	38416615	DNA/TcMar-Tigger	1128	+	138	38416477	29181
chr12	2870363	3070363	harbor1	chr12	2969118	2969447	DNA/TcMar-Tigger	1945	+	164	2969282	98919
chr12	5329102	5529102	harbor1	chr12	5330084	5330326	DNA/TcMar-Tigger	1242	+	121	5330205	1103
chr12	5329102	5529102	harbor1	chr12	5330328	5330548	DNA/TcMar-Tigger	1367	+	110	5330438	1336
chr12	22561062	22761062	harbor1	chr12	22598688	22599012	DNA/TcMar-Tigger	1690	+	162	22598850	37788
chr12	22561062	22761062	harbor1	chr12	22636608	22636875	DNA/TcMar-Tigger	1576	+	134	22636742	75680
chr12	11852236	12052236	harbor1	chr12	11893528	11893794	DNA/TcMar-Tigger	1642	+	133	11893661	41425
chr12	11852236	12052236	harbor1	chr12	11893843	11893952	DNA/TcMar-Tigger	1642	+	54	11893897	41661
chr12	24591619	24791619	harbor1	chr12	24615287	24615609	DNA/TcMar-Tigger	1568	+	161	24615448	23829
chr12	24591619	24791619	harbor1	chr12	24668638	24669833	DNA/TcMar-Tigger	6866	+	598	24669236	77617
chr12	24591619	24791619	harbor1	chr12	24676170	24676446	DNA/TcMar-Tigger	1108	+	138	24676308	84689
chr12	31794778	31994778	harbor1	chr12	31893235	31893319	DNA/TcMar-Tigger	564	+	42	31893277	98499
chr12	101339660	101539660	harbor1	chr12	101341516	101341624	DNA/TcMar-Tigger	1449	+	54	101341570	1910
chr12	101339660	101539660	harbor1	chr12	101341930	101342150	DNA/TcMar-Tigger	1449	+	110	101342040	2380
chr12	101339660	101539660	harbor1	chr12	101420447	101420770	DNA/TcMar-Tigger	2140	+	162	101420609	80949
chr12	101339660	101539660	harbor1	chr12	101421373	101421429	DNA/TcMar-Tigger	2140	+	28	101421401	81741
chr12	101339660	101539660	harbor1	chr12	101421555	101421627	DNA/TcMar-Tigger	520	+	36	101421591	81931
chr12	81370162	81570162	harbor1	chr12	81386791	81387399	DNA/TcMar-Tigger	2224	+	304	81387095	16933
chr12	102425755	102625755	harbor1	chr12	102435046	102435192	DNA/TcMar-Tigger	661	+	73	102435119	9364
chr12	102425755	102625755	harbor1	chr12	102476143	102476313	DNA/TcMar-Tigger	437	+	85	102476228	50473
chr12	80764436	80964436	harbor1	chr12	80819030	80819252	DNA/TcMar-Tigger	1163	+	111	80819141	54705
chr12	80764436	80964436	harbor1	chr12	80819927	80820128	DNA/TcMar-Tigger	498	+	100	80820027	55591
chr12	16175546	16375546	harbor1	chr12	16228547	16228980	DNA/TcMar-Tigger	2488	+	216	16228763	53217
chr12	79437177	79637177	harbor1	chr12	79528618	79528829	DNA/TcMar-Tigger	1210	+	106	79528724	91547
chr12	95785092	95985092	harbor1	chr12	95793536	95793812	DNA/TcMar-Tigger	510	+	138	95793674	8582
chr12	95785092	95985092	harbor1	chr12	95871189	95871487	DNA/TcMar-Tigger	1522	+	149	95871338	86246
chr12	131958755	132158755	harbor1	chr12	131996970	131997089	DNA/TcMar-Tigger	881	+	60	131997030	38275
chr12	131958755	132158755	harbor1	chr12	131997839	131997909	DNA/TcMar-Tigger	881	+	35	131997874	39119
chr12	131958755	132158755	harbor1	chr12	132003275	132003482	DNA/TcMar-Tigger	1220	+	104	132003379	44624
chr12	77027429	77227429	harbor1	chr12	77062921	77063613	DNA/TcMar-Tigger	3816	+	346	77063267	35838
chr12	77027429	77227429	harbor1	chr12	77113171	77113340	DNA/TcMar-Tigger	1005	+	84	77113255	85826
chr12	77027429	77227429	harbor1	chr12	77113648	77113754	DNA/TcMar-Tigger	1005	+	53	77113701	86272
chr12	56517245	56717245	harbor1	chr12	56575915	56576055	DNA/TcMar-Tigger	1141	+	70	56575985	58740
chr12	56517245	56717245	harbor1	chr12	56576359	56576457	DNA/TcMar-Tigger	1141	+	49	56576408	59163
chr12	56517245	56717245	harbor1	chr12	56576458	56576555	DNA/TcMar-Tigger	711	+	48	56576506	59261
chr12	13928905	14128905	harbor1	chr12	13997191	13997560	DNA/TcMar-Tigger	2141	+	184	13997375	68470
chr12	32290100	32490100	harbor1	chr12	32315667	32315853	DNA/TcMar-Tigger	2032	+	93	32315760	25660
chr12	32290100	32490100	harbor1	chr12	32316154	32316281	DNA/TcMar-Tigger	2032	+	64	32316218	26118
chr12	32290100	32490100	harbor1	chr12	32316601	32316671	DNA/TcMar-Tigger	2032	+	35	32316636	26536
chr12	61338506	61538506	harbor1	chr12	61411506	61412046	DNA/TcMar-Tigger	1224	+	270	61411776	73270
chr12	87889665	88089665	harbor1	chr12	87892410	87892604	DNA/TcMar-Tigger	451	+	97	87892507	2842
chr12	108361043	108561043	harbor1	chr12	108394870	108395204	DNA/TcMar-Tigger	1219	+	167	108395037	33994
chr12	46058399	46258399	harbor1	chr12	46066208	46066733	DNA/TcMar-Tigger	2821	+	262	46066470	8071
chr12	46058399	46258399	harbor1	chr12	46133647	46133997	DNA/TcMar-Tigger	2027	+	175	46133822	75423
chr12	46058399	46258399	harbor1	chr12	46155995	46156065	DNA/TcMar-Tigger	450	+	35	46156030	97631
chr12	124732339	124932339	harbor1	chr12	124787882	124788124	DNA/TcMar-Tigger	1387	+	121	124788003	55664
chr12	128407263	128607263	harbor1	chr12	128430530	128431550	DNA/TcMar-Tigger	14629	+	510	128431040	23777
chr12	128407263	128607263	harbor1	chr12	128431825	128433002	DNA/TcMar-Tigger	14629	+	588	128432413	25150
chr12	128407263	128607263	harbor1	chr12	128433046	128433280	DNA/TcMar-Tigger	14629	+	117	128433163	25900
chr12	81374628	81574628	harbor1	chr12	81386791	81387399	DNA/TcMar-Tigger	2224	+	304	81387095	12467
chr12	61965814	62165814	harbor1	chr12	62038434	62038646	DNA/TcMar-Tigger	1174	+	106	62038540	72726
chr12	61965814	62165814	harbor1	chr12	62060259	62061544	DNA/TcMar-Tigger	6509	+	642	62060901	95087
chr12	29920234	30120234	harbor1	chr12	29980457	29980972	DNA/TcMar-Tigger	1394	+	258	29980715	60481
chr12	29920234	30120234	harbor1	chr12	29981555	29981726	DNA/TcMar-Tigger	481	+	86	29981641	61407
chr12	128863198	129063198	harbor1	chr12	128865446	128865540	DNA/TcMar-Tigger	926	+	47	128865493	2295
chr12	128863198	129063198	harbor1	chr12	128865850	128866046	DNA/TcMar-Tigger	1116	+	98	128865948	2750
chr12	25068913	25268913	harbor1	chr12	25107217	25107448	DNA/TcMar-Tigger	1302	+	116	25107333	38420
chr12	67448011	67648011	harbor1	chr12	67455240	67455861	DNA/TcMar-Tigger	3868	+	310	67455550	7539
chr12	67448011	67648011	harbor1	chr12	67486311	67486664	DNA/TcMar-Tigger	2021	+	176	67486487	38476
chr12	67448011	67648011	harbor1	chr12	67522640	67522973	DNA/TcMar-Tigger	1921	+	166	67522806	74795
chr12	98035455	98235455	harbor1	chr12	98097264	98097593	DNA/TcMar-Tigger	1561	+	164	98097428	61973
chr12	98035455	98235455	harbor1	chr12	98131091	98131268	DNA/TcMar-Tigger	1063	+	88	98131179	95724
chr12	43917586	44117586	harbor1	chr12	43969916	43970297	DNA/TcMar-Tigger	2315	+	190	43970106	52520
chr12	43917586	44117586	harbor1	chr12	43970588	43970749	DNA/TcMar-Tigger	2315	+	80	43970668	53082
chr12	90596177	90796177	harbor1	chr12	90624398	90625268	DNA/TcMar-Tigger	4771	+	435	90624833	28656
chr12	90596177	90796177	harbor1	chr12	90690667	90691199	DNA/TcMar-Tigger	2812	+	266	90690933	94756
chr12	90596177	90796177	harbor1	chr12	90691195	90691304	DNA/TcMar-Tigger	749	+	54	90691249	95072
chr12	44443450	44643450	harbor1	chr12	44444658	44444885	DNA/TcMar-Tigger	565	+	114	44444772	1322
chr12	44443450	44643450	harbor1	chr12	44514351	44514700	DNA/TcMar-Tigger	1689	+	174	44514525	71075
chr13	103686728	103886728	harbor1	chr13	103755953	103758265	DNA/TcMar-Tigger	13175	+	1156	103757109	70381
chr13	81517976	81717976	harbor1	chr13	81523359	81523794	DNA/TcMar-Tigger	2325	+	218	81523577	5601
chr13	81517976	81717976	harbor1	chr13	81610218	81610412	DNA/TcMar-Tigger	890	+	97	81610315	92339
chr13	81517976	81717976	harbor1	chr13	81610406	81610582	DNA/TcMar-Tigger	890	+	88	81610494	92518
chr13	81517976	81717976	harbor1	chr13	81611145	81611575	DNA/TcMar-Tigger	2165	+	215	81611360	93384
chr13	106769575	106969575	harbor1	chr13	106776820	106777071	DNA/TcMar-Tigger	1370	+	126	106776946	7371
chr13	106769575	106969575	harbor1	chr13	106849179	106849519	DNA/TcMar-Tigger	1830	+	170	106849349	79774
chr13	50456224	50656224	harbor1	chr13	50495313	50495445	DNA/TcMar-Tigger	516	+	66	50495379	39155
chr13	50456224	50656224	harbor1	chr13	50495503	50495801	DNA/TcMar-Tigger	1025	+	149	50495652	39428
chr13	50456224	50656224	harbor1	chr13	50498907	50498988	DNA/TcMar-Tigger	1972	+	40	50498947	42723
chr13	50456224	50656224	harbor1	chr13	50499283	50499539	DNA/TcMar-Tigger	1972	+	128	50499411	43187
chr13	50456224	50656224	harbor1	chr13	50553326	50553770	DNA/TcMar-Tigger	2464	+	222	50553548	97324
chr13	50456224	50656224	harbor1	chr13	50553773	50554376	DNA/TcMar-Tigger	3733	+	302	50554075	97851
chr13	40336910	40536910	harbor1	chr13	40396497	40396705	DNA/TcMar-Tigger	828	+	104	40396601	59691
chr13	40336910	40536910	harbor1	chr13	40423572	40423886	DNA/TcMar-Tigger	1434	+	157	40423729	86819
chr13	50465187	50665187	harbor1	chr13	50495313	50495445	DNA/TcMar-Tigger	516	+	66	50495379	30192
chr13	50465187	50665187	harbor1	chr13	50495503	50495801	DNA/TcMar-Tigger	1025	+	149	50495652	30465
chr13	50465187	50665187	harbor1	chr13	50498907	50498988	DNA/TcMar-Tigger	1972	+	40	50498947	33760
chr13	50465187	50665187	harbor1	chr13	50499283	50499539	DNA/TcMar-Tigger	1972	+	128	50499411	34224
chr13	50465187	50665187	harbor1	chr13	50553326	50553770	DNA/TcMar-Tigger	2464	+	222	50553548	88361
chr13	50465187	50665187	harbor1	chr13	50553773	50554376	DNA/TcMar-Tigger	3733	+	302	50554075	88888
chr13	50465187	50665187	harbor1	chr13	50556358	50557694	DNA/TcMar-Tigger	7896	+	668	50557026	91839
chr13	84171787	84371787	harbor1	chr13	84256533	84256823	DNA/TcMar-Tigger	586	+	145	84256678	84891
chr13	77237996	77437996	harbor1	chr13	77287487	77287596	DNA/TcMar-Tigger	413	+	54	77287541	49545
chr13	77237996	77437996	harbor1	chr13	77287960	77288119	DNA/TcMar-Tigger	652	+	80	77288040	50044
chr13	103694818	103894818	harbor1	chr13	103755953	103758265	DNA/TcMar-Tigger	13175	+	1156	103757109	62291
chr13	60240675	60440675	harbor1	chr13	60257908	60258259	DNA/TcMar-Tigger	1789	+	176	60258084	17409
chr13	60240675	60440675	harbor1	chr13	60293536	60293853	DNA/TcMar-Tigger	1758	+	158	60293694	53019
chr13	60240675	60440675	harbor1	chr13	60338192	60338646	DNA/TcMar-Tigger	2688	+	227	60338419	97744
chr13	85776756	85976756	harbor1	chr13	85807623	85807799	DNA/TcMar-Tigger	631	+	88	85807711	30955
chr13	85776756	85976756	harbor1	chr13	85808658	85808843	DNA/TcMar-Tigger	1091	+	92	85808750	31994
chr13	85776756	85976756	harbor1	chr13	85810854	85811536	DNA/TcMar-Tigger	2763	+	341	85811195	34439
chr13	85776756	85976756	harbor1	chr13	85834904	85834997	DNA/TcMar-Tigger	427	+	46	85834950	58194
chr13	27585286	27785286	harbor1	chr13	27596059	27596393	DNA/TcMar-Tigger	1860	+	167	27596226	10940
chr13	27585286	27785286	harbor1	chr13	27676302	27677320	DNA/TcMar-Tigger	5791	+	509	27676811	91525
chr13	27585286	27785286	harbor1	chr13	27677600	27677655	DNA/TcMar-Tigger	5791	+	28	27677628	92342
chr13	31887553	32087553	harbor1	chr13	31889431	31889496	DNA/TcMar-Tigger	1855	+	32	31889463	1910
chr13	31887553	32087553	harbor1	chr13	31889911	31890195	DNA/TcMar-Tigger	1855	+	142	31890053	2500
chr13	31887553	32087553	harbor1	chr13	31916219	31916333	DNA/TcMar-Tigger	785	+	57	31916276	28723
chr13	31887553	32087553	harbor1	chr13	31940326	31940828	DNA/TcMar-Tigger	1478	+	251	31940577	53024
chr13	19678694	19878694	harbor1	chr13	19679536	19679776	DNA/TcMar-Tigger	1273	+	120	19679656	962
chr13	19678694	19878694	harbor1	chr13	19715462	19715610	DNA/TcMar-Tigger	857	+	74	19715536	36842
chr13	19678694	19878694	harbor1	chr13	19716047	19716233	DNA/TcMar-Tigger	1163	+	93	19716140	37446
chr13	19678694	19878694	harbor1	chr13	19731331	19731407	DNA/TcMar-Tigger	719	+	38	19731369	52675
chr13	19678694	19878694	harbor1	chr13	19731710	19731872	DNA/TcMar-Tigger	719	+	81	19731791	53097
chr13	19678694	19878694	harbor1	chr13	19775384	19775598	DNA/TcMar-Tigger	1177	+	107	19775491	96797
chr13	31069298	31269298	harbor1	chr13	31081757	31081995	DNA/TcMar-Tigger	906	+	119	31081876	12578
chr13	31069298	31269298	harbor1	chr13	31094060	31094167	DNA/TcMar-Tigger	604	+	54	31094114	24816
chr13	31069298	31269298	harbor1	chr13	31132375	31132606	DNA/TcMar-Tigger	516	+	116	31132491	63193
chr13	57278223	57478223	harbor1	chr13	57346800	57347141	DNA/TcMar-Tigger	1397	+	170	57346970	68747
chr13	57278223	57478223	harbor1	chr13	57347137	57347274	DNA/TcMar-Tigger	738	+	68	57347205	68982
chr13	88101788	88301788	harbor1	chr13	88110888	88111332	DNA/TcMar-Tigger	2278	+	222	88111110	9322
chr13	88101788	88301788	harbor1	chr13	88111324	88111830	DNA/TcMar-Tigger	2046	+	253	88111577	9789
chr13	107368824	107568824	harbor1	chr13	107401012	107401276	DNA/TcMar-Tigger	1241	+	132	107401144	32320
chr13	107368824	107568824	harbor1	chr13	107401275	107401370	DNA/TcMar-Tigger	429	+	48	107401323	32499
chr13	107368824	107568824	harbor1	chr13	107416323	107416760	DNA/TcMar-Tigger	2515	+	218	107416541	47717
chr13	20762374	20962374	harbor1	chr13	20835738	20836175	DNA/TcMar-Tigger	2373	+	218	20835956	73582
chr13	26706345	26906345	harbor1	chr13	26706851	26707191	DNA/TcMar-Tigger	1946	+	170	26707021	676
chr13	26706345	26906345	harbor1	chr13	26775647	26775703	DNA/TcMar-Tigger	903	+	28	26775675	69330
chr13	26706345	26906345	harbor1	chr13	26775999	26776188	DNA/TcMar-Tigger	903	+	94	26776093	69748
chr13	26706345	26906345	harbor1	chr13	26780177	26780482	DNA/TcMar-Tigger	994	+	152	26780329	73984
chr13	61797422	61997422	harbor1	chr13	61888860	61889200	DNA/TcMar-Tigger	1535	+	170	61889030	91608
chr14	86839072	87039072	harbor1	chr14	86867647	86867958	DNA/TcMar-Tigger	869	+	156	86867803	28731
chr14	86839072	87039072	harbor1	chr14	86931118	86931705	DNA/TcMar-Tigger	6111	+	294	86931412	92340
chr14	86839072	87039072	harbor1	chr14	86932004	86932663	DNA/TcMar-Tigger	6111	+	330	86932334	93262
chr14	45694355	45894355	harbor1	chr14	45722645	45723533	DNA/TcMar-Tigger	9863	+	444	45723089	28734
chr14	45694355	45894355	harbor1	chr14	45723831	45723857	DNA/TcMar-Tigger	9863	+	13	45723844	29489
chr14	45694355	45894355	harbor1	chr14	45723885	45724718	DNA/TcMar-Tigger	9863	+	416	45724301	29946
chr14	50497871	50697871	harbor1	chr14	50575996	50576353	DNA/TcMar-Tigger	2166	+	178	50576174	78303
chr14	90701718	90901718	harbor1	chr14	90704855	90705120	DNA/TcMar-Tigger	521	+	132	90704987	3269
chr14	90701718	90901718	harbor1	chr14	90707194	90707869	DNA/TcMar-Tigger	8676	+	338	90707532	5814
chr14	90701718	90901718	harbor1	chr14	90708171	90708812	DNA/TcMar-Tigger	8676	+	320	90708491	6773
chr14	90701718	90901718	harbor1	chr14	90710072	90710929	DNA/TcMar-Tigger	5837	+	428	90710500	8782
chr14	88641441	88841441	harbor1	chr14	88643332	88643605	DNA/TcMar-Tigger	1225	+	136	88643468	2027
chr14	88641441	88841441	harbor1	chr14	88692012	88692092	DNA/TcMar-Tigger	1757	+	40	88692052	50611
chr14	88641441	88841441	harbor1	chr14	88692390	88692661	DNA/TcMar-Tigger	1757	+	136	88692526	51085
chr14	88641441	88841441	harbor1	chr14	88728092	88728302	DNA/TcMar-Tigger	1649	+	105	88728197	86756
chr14	88641441	88841441	harbor1	chr14	88728735	88728853	DNA/TcMar-Tigger	1649	+	59	88728794	87353
chr14	88641441	88841441	harbor1	chr14	88739281	88739440	DNA/TcMar-Tigger	655	+	80	88739361	97920
chr14	95785244	95985244	harbor1	chr14	95785513	95785838	DNA/TcMar-Tigger	1344	+	162	95785675	431
chr14	92550386	92750386	harbor1	chr14	92583489	92583685	DNA/TcMar-Tigger	490	+	98	92583587	33201
chr14	92550386	92750386	harbor1	chr14	92584060	92584205	DNA/TcMar-Tigger	815	+	72	92584132	33746
chr14	47228817	47428817	harbor1	chr14	47244842	47245016	DNA/TcMar-Tigger	2021	+	87	47244929	16112
chr14	47228817	47428817	harbor1	chr14	47245286	47245510	DNA/TcMar-Tigger	2021	+	112	47245398	16581
chr14	33335062	33535062	harbor1	chr14	33378913	33379218	DNA/TcMar-Tigger	1697	+	152	33379065	44003
chr14	100289417	100489417	harbor1	chr14	100363133	100363290	DNA/TcMar-Tigger	449	+	78	100363211	73794
chr14	85133911	85333911	harbor1	chr14	85208473	85209617	DNA/TcMar-Tigger	5821	+	572	85209045	75134
chr14	28306415	28506415	harbor1	chr14	28364739	28365107	DNA/TcMar-Tigger	1613	+	184	28364923	58508
chr14	28306415	28506415	harbor1	chr14	28399386	28399481	DNA/TcMar-Tigger	463	+	48	28399434	93019
chr14	72010851	72210851	harbor1	chr14	72011611	72011824	DNA/TcMar-Tigger	1169	+	106	72011717	866
chr14	72010851	72210851	harbor1	chr14	72034851	72035074	DNA/TcMar-Tigger	1153	+	112	72034963	24112
chr14	72010851	72210851	harbor1	chr14	72035076	72035180	DNA/TcMar-Tigger	603	+	52	72035128	24277
chr14	72010851	72210851	harbor1	chr14	72050685	72050925	DNA/TcMar-Tigger	1317	+	120	72050805	39954
chr14	84534303	84734303	harbor1	chr14	84596982	84597226	DNA/TcMar-Tigger	842	+	122	84597104	62801
chr14	84534303	84734303	harbor1	chr14	84603662	84603985	DNA/TcMar-Tigger	1458	+	162	84603824	69521
chr14	84534303	84734303	harbor1	chr14	84628951	84629176	DNA/TcMar-Tigger	477	+	112	84629063	94760
chr14	79998865	80198865	harbor1	chr14	80034738	80035741	DNA/TcMar-Tigger	5030	+	502	80035240	36375
chr14	79998865	80198865	harbor1	chr14	80050278	80050617	DNA/TcMar-Tigger	1903	+	170	80050448	51583
chr14	79998865	80198865	harbor1	chr14	80094845	80095181	DNA/TcMar-Tigger	1901	+	168	80095013	96148
chr14	44383951	44583951	harbor1	chr14	44444759	44445070	DNA/TcMar-Tigger	1374	+	156	44444915	60964
chr14	75086592	75286592	harbor1	chr14	75105348	75105728	DNA/TcMar-Tigger	1024	+	190	75105538	18946
chr14	75086592	75286592	harbor1	chr14	75150463	75150766	DNA/TcMar-Tigger	1882	+	152	75150615	64023
chr14	39691917	39891917	harbor1	chr14	39758561	39758884	DNA/TcMar-Tigger	1670	+	162	39758723	66806
chr14	39691917	39891917	harbor1	chr14	39769750	39769944	DNA/TcMar-Tigger	1223	+	97	39769847	77930
chr14	39691917	39891917	harbor1	chr14	39774968	39775059	DNA/TcMar-Tigger	505	+	46	39775014	83097
chr14	91191240	91391240	harbor1	chr14	91225238	91225641	DNA/TcMar-Tigger	2284	+	202	91225440	34200
chr14	91191240	91391240	harbor1	chr14	91226869	91226977	DNA/TcMar-Tigger	1781	+	54	91226923	35683
chr14	91191240	91391240	harbor1	chr14	91227289	91227505	DNA/TcMar-Tigger	1781	+	108	91227397	36157
chr14	25037602	25237602	harbor1	chr14	25072084	25072449	DNA/TcMar-Tigger	638	+	182	25072266	34664
chr14	25037602	25237602	harbor1	chr14	25072465	25072677	DNA/TcMar-Tigger	627	+	106	25072571	34969
chr14	24256088	24456088	harbor1	chr14	24351154	24351354	DNA/TcMar-Tigger	1177	+	100	24351254	95166
chr14	24256088	24456088	harbor1	chr14	24351544	24351615	DNA/TcMar-Tigger	452	+	36	24351580	95492
chr14	65752844	65952844	harbor1	chr14	65788554	65788897	DNA/TcMar-Tigger	2261	+	172	65788726	35882
chr14	95003267	95203267	harbor1	chr14	95083057	95083179	DNA/TcMar-Tigger	1399	+	61	95083118	79851
chr14	95003267	95203267	harbor1	chr14	95083474	95083585	DNA/TcMar-Tigger	1399	+	56	95083530	80263
chr14	95003267	95203267	harbor1	chr14	95083866	95083953	DNA/TcMar-Tigger	1399	+	44	95083910	80643
chr14	84504713	84704713	harbor1	chr14	84529019	84529450	DNA/TcMar-Tigger	2127	+	216	84529235	24522
chr14	84504713	84704713	harbor1	chr14	84596982	84597226	DNA/TcMar-Tigger	842	+	122	84597104	92391
chr14	84504713	84704713	harbor1	chr14	84603662	84603985	DNA/TcMar-Tigger	1458	+	162	84603824	99111
chr14	44219092	44419092	harbor1	chr14	44316869	44317087	DNA/TcMar-Tigger	913	+	109	44316978	97886
chr14	44219092	44419092	harbor1	chr14	44317084	44317310	DNA/TcMar-Tigger	1417	+	113	44317197	98105
chr14	44219092	44419092	harbor1	chr14	44317656	44317798	DNA/TcMar-Tigger	759	+	71	44317727	98635
chr14	67764800	67964800	harbor1	chr14	67774027	67774197	DNA/TcMar-Tigger	519	+	85	67774112	9312
chr14	67764800	67964800	harbor1	chr14	67774756	67774842	DNA/TcMar-Tigger	421	+	43	67774799	9999
chr14	53528894	53728894	harbor1	chr14	53592284	53592598	DNA/TcMar-Tigger	609	+	157	53592441	63547
chr14	53528894	53728894	harbor1	chr14	53600858	53601092	DNA/TcMar-Tigger	505	+	117	53600975	72081
chr14	70671528	70871528	harbor1	chr14	70763254	70763534	DNA/TcMar-Tigger	3432	+	140	70763394	91866
chr14	70671528	70871528	harbor1	chr14	70763832	70763903	DNA/TcMar-Tigger	3432	+	36	70763868	92340
chr14	70671528	70871528	harbor1	chr14	70764210	70764428	DNA/TcMar-Tigger	3432	+	109	70764319	92791
chr14	70671528	70871528	harbor1	chr14	70764531	70764548	DNA/TcMar-Tigger	2965	+	8	70764539	93011
chr14	70671528	70871528	harbor1	chr14	70764863	70765047	DNA/TcMar-Tigger	2965	+	92	70764955	93427
chr14	70671528	70871528	harbor1	chr14	70765337	70765652	DNA/TcMar-Tigger	2965	+	158	70765495	93967
chr14	70671528	70871528	harbor1	chr14	70765813	70765933	DNA/TcMar-Tigger	717	+	60	70765873	94345
chr14	26240929	26440929	harbor1	chr14	26331390	26331956	DNA/TcMar-Tigger	3171	+	283	26331673	90744
chr14	26240929	26440929	harbor1	chr14	26332757	26333015	DNA/TcMar-Tigger	1156	+	129	26332886	91957
chr14	26240929	26440929	harbor1	chr14	26335379	26335670	DNA/TcMar-Tigger	1858	+	146	26335525	94596
chr14	55407632	55607632	harbor1	chr14	55485096	55485238	DNA/TcMar-Tigger	1467	+	71	55485167	77535
chr14	55407632	55607632	harbor1	chr14	55485535	55485656	DNA/TcMar-Tigger	1467	+	60	55485595	77963
chr14	20030960	20230960	harbor1	chr14	20121784	20122099	DNA/TcMar-Tigger	811	+	158	20121942	90982
chr14	101566414	101766414	harbor1	chr14	101569738	101569957	DNA/TcMar-Tigger	1012	+	110	101569848	3434
chr14	101566414	101766414	harbor1	chr14	101575985	101576076	DNA/TcMar-Tigger	1159	+	46	101576031	9617
chr14	101566414	101766414	harbor1	chr14	101576372	101576582	DNA/TcMar-Tigger	1159	+	105	101576477	10063
chr14	101566414	101766414	harbor1	chr14	101654667	101656262	DNA/TcMar-Tigger	15881	+	798	101655465	89051
chr14	101566414	101766414	harbor1	chr14	101656553	101657012	DNA/TcMar-Tigger	15881	+	230	101656783	90369
chr14	101566414	101766414	harbor1	chr14	101657317	101657641	DNA/TcMar-Tigger	15881	+	162	101657479	91065
chr14	101566414	101766414	harbor1	chr14	101660536	101660863	DNA/TcMar-Tigger	1953	+	164	101660700	94286
chr14	58823702	59023702	harbor1	chr14	58912518	58912628	DNA/TcMar-Tigger	701	+	55	58912573	88871
chr14	58823702	59023702	harbor1	chr14	58912630	58913361	DNA/TcMar-Tigger	4244	+	366	58912996	89294
chr14	88339182	88539182	harbor1	chr14	88341164	88341595	DNA/TcMar-Tigger	2522	+	216	88341380	2198
chr14	88339182	88539182	harbor1	chr14	88346443	88346799	DNA/TcMar-Tigger	1950	+	178	88346621	7439
chr14	88339182	88539182	harbor1	chr14	88430882	88431087	DNA/TcMar-Tigger	1061	+	102	88430984	91802
chr14	84253716	84453716	harbor1	chr14	84339356	84339800	DNA/TcMar-Tigger	2185	+	222	84339578	85862
chr14	67363483	67563483	harbor1	chr14	67374099	67374316	DNA/TcMar-Tigger	1368	+	108	67374207	10724
chr14	67363483	67563483	harbor1	chr14	67386303	67386554	DNA/TcMar-Tigger	561	+	126	67386429	22946
chr14	67363483	67563483	harbor1	chr14	67460398	67460423	DNA/TcMar-Tigger	506	+	12	67460410	96927
chr14	67363483	67563483	harbor1	chr14	67460726	67460901	DNA/TcMar-Tigger	506	+	88	67460814	97331
chr14	103412962	103612962	harbor1	chr14	103420671	103421378	DNA/TcMar-Tigger	2297	+	354	103421025	8063
chr14	81914270	82114270	harbor1	chr14	81952108	81952156	DNA/TcMar-Tigger	3009	+	24	81952132	37862
chr14	81914270	82114270	harbor1	chr14	81954796	81955379	DNA/TcMar-Tigger	3009	+	292	81955088	40818
chr14	81914270	82114270	harbor1	chr14	81978330	81978774	DNA/TcMar-Tigger	1509	+	222	81978552	64282
chr14	81914270	82114270	harbor1	chr14	81979014	81979134	DNA/TcMar-Tigger	1509	+	60	81979074	64804
chr14	81914270	82114270	harbor1	chr14	81988156	81989226	DNA/TcMar-Tigger	6351	+	535	81988691	74421
chr14	23071503	23271503	harbor1	chr14	23149739	23150068	DNA/TcMar-Tigger	1939	+	164	23149903	78400
chr14	103499765	103699765	harbor1	chr14	103579983	103580090	DNA/TcMar-Tigger	687	+	54	103580037	80272
chr14	103499765	103699765	harbor1	chr14	103581103	103581195	DNA/TcMar-Tigger	511	+	46	103581149	81384
chr14	40223085	40423085	harbor1	chr14	40315245	40317470	DNA/TcMar-Tigger	13863	+	1112	40316357	93272
chr14	40223085	40423085	harbor1	chr14	40317819	40317981	DNA/TcMar-Tigger	13863	+	81	40317900	94815
chr14	93944237	94144237	harbor1	chr14	94013557	94013627	DNA/TcMar-Tigger	437	+	35	94013592	69355
chr14	93944237	94144237	harbor1	chr14	94014173	94014367	DNA/TcMar-Tigger	1074	+	97	94014270	70033
chr14	89554168	89754168	harbor1	chr14	89571027	89571226	DNA/TcMar-Tigger	437	+	100	89571127	16959
chr14	89554168	89754168	harbor1	chr14	89571529	89571540	DNA/TcMar-Tigger	437	+	6	89571535	17367
chr14	89554168	89754168	harbor1	chr14	89636426	89636807	DNA/TcMar-Tigger	1986	+	190	89636616	82448
chr14	78351073	78551073	harbor1	chr14	78367987	78368156	DNA/TcMar-Tigger	449	+	84	78368071	16998
chr14	19244827	19444827	harbor1	chr14	19286603	19286804	DNA/TcMar-Tigger	1421	+	100	19286703	41876
chr14	19244827	19444827	harbor1	chr14	19288135	19288244	DNA/TcMar-Tigger	706	+	54	19288189	43362
chr14	19244827	19444827	harbor1	chr14	19289708	19290351	DNA/TcMar-Tigger	2906	+	322	19290030	45203
chr14	19244827	19444827	harbor1	chr14	19293144	19293625	DNA/TcMar-Tigger	2983	+	240	19293384	48557
chr14	19244827	19444827	harbor1	chr14	19293758	19293834	DNA/TcMar-Tigger	2983	+	38	19293796	48969
chr14	19244827	19444827	harbor1	chr14	19293966	19294081	DNA/TcMar-Tigger	2983	+	58	19294024	49197
chr14	54854988	55054988	harbor1	chr14	54891003	54891098	DNA/TcMar-Tigger	3881	+	48	54891051	36063
chr14	54854988	55054988	harbor1	chr14	54891710	54892323	DNA/TcMar-Tigger	3881	+	306	54892016	37028
chr14	54355858	54555858	harbor1	chr14	54382278	54382683	DNA/TcMar-Tigger	14138	+	202	54382480	26622
chr14	54355858	54555858	harbor1	chr14	54382990	54383340	DNA/TcMar-Tigger	14138	+	175	54383165	27307
chr14	54355858	54555858	harbor1	chr14	54383644	54385136	DNA/TcMar-Tigger	14138	+	746	54384390	28532
chr14	54355858	54555858	harbor1	chr14	54385153	54385341	DNA/TcMar-Tigger	698	+	94	54385247	29389
chr14	54355858	54555858	harbor1	chr14	54413201	54413621	DNA/TcMar-Tigger	697	+	210	54413411	57553
chr14	54355858	54555858	harbor1	chr14	54415010	54415224	DNA/TcMar-Tigger	572	+	107	54415117	59259
chr14	54355858	54555858	harbor1	chr14	54422454	54422791	DNA/TcMar-Tigger	2104	+	168	54422622	66764
chr14	89628980	89828980	harbor1	chr14	89636426	89636807	DNA/TcMar-Tigger	1986	+	190	89636616	7636
chr14	98109503	98309503	harbor1	chr14	98174445	98174742	DNA/TcMar-Tigger	922	+	148	98174593	65090
chr14	98109503	98309503	harbor1	chr14	98195311	98195652	DNA/TcMar-Tigger	1312	+	170	98195481	85978
chr14	65049969	65249969	harbor1	chr14	65050960	65051254	DNA/TcMar-Tigger	500	+	147	65051107	1138
chr14	53274795	53474795	harbor1	chr14	53356837	53357983	DNA/TcMar-Tigger	6141	+	573	53357410	82615
chr14	105216678	105416678	harbor1	chr14	105297664	105297714	DNA/TcMar-Tigger	1341	+	25	105297689	81011
chr14	105216678	105416678	harbor1	chr14	105298022	105298215	DNA/TcMar-Tigger	1341	+	96	105298118	81440
chr14	68352781	68552781	harbor1	chr14	68405880	68406095	DNA/TcMar-Tigger	436	+	108	68405988	53207
chr14	54172065	54372065	harbor1	chr14	54267483	54267719	DNA/TcMar-Tigger	714	+	118	54267601	95536
chr14	99760514	99960514	harbor1	chr14	99780625	99780964	DNA/TcMar-Tigger	1962	+	170	99780795	20281
chr14	99760514	99960514	harbor1	chr14	99809620	99809972	DNA/TcMar-Tigger	618	+	176	99809796	49282
chr14	99760514	99960514	harbor1	chr14	99828170	99828605	DNA/TcMar-Tigger	2286	+	218	99828388	67874
chr14	99760514	99960514	harbor1	chr14	99829028	99829134	DNA/TcMar-Tigger	624	+	53	99829081	68567
chr14	36891476	37091476	harbor1	chr14	36924779	36924970	DNA/TcMar-Tigger	1135	+	96	36924875	33399
chr14	36891476	37091476	harbor1	chr14	36971996	36972339	DNA/TcMar-Tigger	2124	+	172	36972168	80692
chr14	58340777	58540777	harbor1	chr14	58356596	58356699	DNA/TcMar-Tigger	2157	+	52	58356648	15871
chr14	58340777	58540777	harbor1	chr14	58356999	58357349	DNA/TcMar-Tigger	2157	+	175	58357174	16397
chr14	104887600	105087600	harbor1	chr14	104917371	104917581	DNA/TcMar-Tigger	1144	+	105	104917476	29876
chr14	104887600	105087600	harbor1	chr14	104918258	104918329	DNA/TcMar-Tigger	420	+	36	104918294	30694
chr14	104887600	105087600	harbor1	chr14	104960238	104960576	DNA/TcMar-Tigger	1939	+	169	104960407	72807
chr14	75465146	75665146	harbor1	chr14	75505655	75506001	DNA/TcMar-Tigger	968	+	173	75505828	40682
chr14	43077792	43277792	harbor1	chr14	43134186	43134277	DNA/TcMar-Tigger	437	+	46	43134232	56440
chr14	43077792	43277792	harbor1	chr14	43164879	43165894	DNA/TcMar-Tigger	6184	+	508	43165387	87595
chr14	60034637	60234637	harbor1	chr14	60054119	60054726	DNA/TcMar-Tigger	758	+	304	60054423	19786
chr14	60034637	60234637	harbor1	chr14	60059121	60059344	DNA/TcMar-Tigger	1525	+	112	60059233	24596
chr14	60034637	60234637	harbor1	chr14	60059345	60060460	DNA/TcMar-Tigger	12609	+	558	60059903	25266
chr14	60034637	60234637	harbor1	chr14	60060762	60061623	DNA/TcMar-Tigger	12609	+	430	60061192	26555
chr14	60034637	60234637	harbor1	chr14	60116404	60117503	DNA/TcMar-Tigger	6771	+	550	60116954	82317
chr14	74177464	74377464	harbor1	chr14	74255782	74256090	DNA/TcMar-Tigger	684	+	154	74255936	78472
chr14	102438758	102638758	harbor1	chr14	102451437	102451722	DNA/TcMar-Tigger	653	+	142	102451579	12821
chr14	82254737	82454737	harbor1	chr14	82271263	82272096	DNA/TcMar-Tigger	4509	+	416	82271679	16942
chr14	82254737	82454737	harbor1	chr14	82272726	82273032	DNA/TcMar-Tigger	1858	+	153	82272879	18142
chr14	82254737	82454737	harbor1	chr14	82296313	82296374	DNA/TcMar-Tigger	1449	+	30	82296343	41606
chr14	82254737	82454737	harbor1	chr14	82296748	82297017	DNA/TcMar-Tigger	1449	+	134	82296882	42145
chr14	85055988	85255988	harbor1	chr14	85062117	85063668	DNA/TcMar-Tigger	12071	+	776	85062893	6905
chr14	85055988	85255988	harbor1	chr14	85064119	85064604	DNA/TcMar-Tigger	12071	+	242	85064361	8373
chr14	85055988	85255988	harbor1	chr14	85065169	85065439	DNA/TcMar-Tigger	1487	+	135	85065304	9316
chr14	85055988	85255988	harbor1	chr14	85127377	85127719	DNA/TcMar-Tigger	1864	+	171	85127548	71560
chr14	54877183	55077183	harbor1	chr14	54891003	54891098	DNA/TcMar-Tigger	3881	+	48	54891051	13868
chr14	54877183	55077183	harbor1	chr14	54891710	54892323	DNA/TcMar-Tigger	3881	+	306	54892016	14833
chr14	43326571	43526571	harbor1	chr14	43353256	43353516	DNA/TcMar-Tigger	1503	+	130	43353386	26815
chr14	43326571	43526571	harbor1	chr14	43354088	43354155	DNA/TcMar-Tigger	1503	+	34	43354122	27551
chr14	88552685	88752685	harbor1	chr14	88584194	88585005	DNA/TcMar-Tigger	4345	+	406	88584600	31915
chr14	88552685	88752685	harbor1	chr14	88585004	88585109	DNA/TcMar-Tigger	521	+	52	88585056	32371
chr14	88552685	88752685	harbor1	chr14	88643332	88643605	DNA/TcMar-Tigger	1225	+	136	88643468	90783
chr14	91172117	91372117	harbor1	chr14	91225238	91225641	DNA/TcMar-Tigger	2284	+	202	91225440	53323
chr14	91172117	91372117	harbor1	chr14	91226869	91226977	DNA/TcMar-Tigger	1781	+	54	91226923	54806
chr14	91172117	91372117	harbor1	chr14	91227289	91227505	DNA/TcMar-Tigger	1781	+	108	91227397	55280
chr14	35461700	35661700	harbor1	chr14	35480205	35480471	DNA/TcMar-Tigger	1715	+	133	35480338	18638
chr14	35461700	35661700	harbor1	chr14	35480465	35480578	DNA/TcMar-Tigger	805	+	56	35480521	18821
chr14	35461700	35661700	harbor1	chr14	35514294	35514577	DNA/TcMar-Tigger	1469	+	142	35514436	52736
chr14	63234170	63434170	harbor1	chr14	63310140	63310447	DNA/TcMar-Tigger	1777	+	154	63310294	76124
chr15	39807874	40007874	harbor1	chr15	39862522	39863053	DNA/TcMar-Tigger	2806	+	266	39862788	54914
chr15	39807874	40007874	harbor1	chr15	39863312	39863924	DNA/TcMar-Tigger	2603	+	306	39863618	55744
chr15	39807874	40007874	harbor1	chr15	39902939	39903245	DNA/TcMar-Tigger	1723	+	153	39903092	95218
chr15	93697932	93897932	harbor1	chr15	93719380	93719730	DNA/TcMar-Tigger	1827	+	175	93719555	21623
chr15	93697932	93897932	harbor1	chr15	93720041	93720605	DNA/TcMar-Tigger	3118	+	282	93720323	22391
chr15	61023704	61223704	harbor1	chr15	61082119	61082206	DNA/TcMar-Tigger	681	+	44	61082163	58459
chr15	61023704	61223704	harbor1	chr15	61082509	61082664	DNA/TcMar-Tigger	681	+	78	61082587	58883
chr15	61023704	61223704	harbor1	chr15	61109908	61110116	DNA/TcMar-Tigger	2820	+	104	61110012	86308
chr15	61023704	61223704	harbor1	chr15	61110408	61110695	DNA/TcMar-Tigger	2820	+	144	61110552	86848
chr15	52886198	53086198	harbor1	chr15	52946197	52946882	DNA/TcMar-Tigger	1906	+	342	52946539	60341
chr15	25837206	26037206	harbor1	chr15	25898845	25899438	DNA/TcMar-Tigger	6075	+	296	25899141	61935
chr15	25837206	26037206	harbor1	chr15	25899738	25900400	DNA/TcMar-Tigger	6075	+	331	25900069	62863
chr15	25837206	26037206	harbor1	chr15	25911047	25911204	DNA/TcMar-Tigger	464	+	78	25911125	73919
chr15	32828153	33028153	harbor1	chr15	32868083	32868224	DNA/TcMar-Tigger	643	+	70	32868153	40000
chr15	32828153	33028153	harbor1	chr15	32868233	32868292	DNA/TcMar-Tigger	429	+	30	32868263	40110
chr15	32828153	33028153	harbor1	chr15	32868385	32868568	DNA/TcMar-Tigger	1172	+	92	32868477	40324
chr15	32828153	33028153	harbor1	chr15	32876644	32876963	DNA/TcMar-Tigger	674	+	160	32876804	48651
chr15	67665317	67865317	harbor1	chr15	67714699	67714931	DNA/TcMar-Tigger	1133	+	116	67714815	49498
chr15	38841766	39041766	harbor1	chr15	38867846	38868088	DNA/TcMar-Tigger	1320	+	121	38867967	26201
chr15	38841766	39041766	harbor1	chr15	38900834	38901173	DNA/TcMar-Tigger	1088	+	170	38901004	59238
chr15	22437894	22637894	harbor1	chr15	22532028	22532363	DNA/TcMar-Tigger	1634	+	168	22532196	94302
chr15	22894596	23094596	harbor1	chr15	22930468	22930592	DNA/TcMar-Tigger	488	+	62	22930530	35934
chr15	22894596	23094596	harbor1	chr15	22930565	22930980	DNA/TcMar-Tigger	2223	+	208	22930773	36177
chr15	22894596	23094596	harbor1	chr15	22931784	22932113	DNA/TcMar-Tigger	1715	+	164	22931948	37352
chr15	22894596	23094596	harbor1	chr15	22950523	22950802	DNA/TcMar-Tigger	1214	+	140	22950663	56067
chr15	22894596	23094596	harbor1	chr15	22950813	22951089	DNA/TcMar-Tigger	946	+	138	22950951	56355
chr15	22894596	23094596	harbor1	chr15	22965428	22965665	DNA/TcMar-Tigger	1172	+	118	22965546	70950
chr15	22894596	23094596	harbor1	chr15	22974871	22975233	DNA/TcMar-Tigger	2004	+	181	22975052	80456
chr15	22894596	23094596	harbor1	chr15	22976488	22976812	DNA/TcMar-Tigger	1392	+	162	22976650	82054
chr15	62262512	62462512	harbor1	chr15	62277967	62278174	DNA/TcMar-Tigger	1053	+	104	62278071	15559
chr15	62262512	62462512	harbor1	chr15	62278423	62278517	DNA/TcMar-Tigger	562	+	47	62278470	15958
chr15	72036199	72236199	harbor1	chr15	72094315	72094503	DNA/TcMar-Tigger	15860	+	94	72094409	58210
chr15	72036199	72236199	harbor1	chr15	72094814	72095797	DNA/TcMar-Tigger	15860	+	492	72095306	59107
chr15	72036199	72236199	harbor1	chr15	72096356	72097604	DNA/TcMar-Tigger	15860	+	624	72096980	60781
chr15	72036199	72236199	harbor1	chr15	72103995	72104392	DNA/TcMar-Tigger	2681	+	198	72104193	67994
chr15	49688648	49888648	harbor1	chr15	49696524	49697585	DNA/TcMar-Tigger	6206	+	530	49697054	8406
chr15	49688648	49888648	harbor1	chr15	49697593	49697732	DNA/TcMar-Tigger	814	+	70	49697663	9015
chr15	49688648	49888648	harbor1	chr15	49697733	49697829	DNA/TcMar-Tigger	576	+	48	49697781	9133
chr15	29624672	29824672	harbor1	chr15	29660757	29660995	DNA/TcMar-Tigger	1447	+	119	29660876	36204
chr15	29624672	29824672	harbor1	chr15	29683196	29683529	DNA/TcMar-Tigger	1933	+	166	29683362	58690
chr15	29624672	29824672	harbor1	chr15	29684323	29684641	DNA/TcMar-Tigger	1043	+	159	29684482	59810
chr15	29624672	29824672	harbor1	chr15	29691617	29691661	DNA/TcMar-Tigger	1125	+	22	29691639	66967
chr15	29624672	29824672	harbor1	chr15	29691949	29691971	DNA/TcMar-Tigger	1125	+	11	29691960	67288
chr15	29624672	29824672	harbor1	chr15	29692273	29692497	DNA/TcMar-Tigger	1125	+	112	29692385	67713
chr15	29624672	29824672	harbor1	chr15	29706387	29706569	DNA/TcMar-Tigger	785	+	91	29706478	81806
chr15	61209020	61409020	harbor1	chr15	61265575	61265744	DNA/TcMar-Tigger	496	+	84	61265659	56639
chr15	46632857	46832857	harbor1	chr15	46648252	46648771	DNA/TcMar-Tigger	1029	+	260	46648512	15655
chr15	46632857	46832857	harbor1	chr15	46726544	46726889	DNA/TcMar-Tigger	1463	+	172	46726716	93859
chr15	28598269	28798269	harbor1	chr15	28627237	28627572	DNA/TcMar-Tigger	1623	+	168	28627405	29136
chr15	67627180	67827180	harbor1	chr15	67714699	67714931	DNA/TcMar-Tigger	1133	+	116	67714815	87635
chr15	84300251	84500251	harbor1	chr15	84347548	84347720	DNA/TcMar-Tigger	896	+	86	84347634	47383
chr15	26215569	26415569	harbor1	chr15	26236244	26236346	DNA/TcMar-Tigger	667	+	51	26236295	20726
chr15	26215569	26415569	harbor1	chr15	26236613	26236749	DNA/TcMar-Tigger	834	+	68	26236681	21112
chr15	26215569	26415569	harbor1	chr15	26281985	26282222	DNA/TcMar-Tigger	1311	+	118	26282103	66534
chr15	96836054	97036054	harbor1	chr15	96840757	96842782	DNA/TcMar-Tigger	11100	+	1012	96841769	5715
chr15	96836054	97036054	harbor1	chr15	96843094	96843435	DNA/TcMar-Tigger	11100	+	170	96843264	7210
chr15	96836054	97036054	harbor1	chr15	96843862	96844060	DNA/TcMar-Tigger	708	+	99	96843961	7907
chr15	96836054	97036054	harbor1	chr15	96855112	96855917	DNA/TcMar-Tigger	3616	+	402	96855514	19460
chr15	45379160	45579160	harbor1	chr15	45422939	45423043	DNA/TcMar-Tigger	1347	+	52	45422991	43831
chr15	45379160	45579160	harbor1	chr15	45423340	45423577	DNA/TcMar-Tigger	1347	+	118	45423458	44298
chr15	45379160	45579160	harbor1	chr15	45424888	45424944	DNA/TcMar-Tigger	937	+	28	45424916	45756
chr15	45379160	45579160	harbor1	chr15	45425204	45425364	DNA/TcMar-Tigger	937	+	80	45425284	46124
chr15	45379160	45579160	harbor1	chr15	45425526	45425773	DNA/TcMar-Tigger	1216	+	124	45425650	46490
chr15	32860486	33060486	harbor1	chr15	32868083	32868224	DNA/TcMar-Tigger	643	+	70	32868153	7667
chr15	32860486	33060486	harbor1	chr15	32868233	32868292	DNA/TcMar-Tigger	429	+	30	32868263	7777
chr15	32860486	33060486	harbor1	chr15	32868385	32868568	DNA/TcMar-Tigger	1172	+	92	32868477	7991
chr15	32860486	33060486	harbor1	chr15	32876644	32876963	DNA/TcMar-Tigger	674	+	160	32876804	16318
chr15	32860486	33060486	harbor1	chr15	32942976	32943188	DNA/TcMar-Tigger	934	+	106	32943082	82596
chr15	62260779	62460779	harbor1	chr15	62277967	62278174	DNA/TcMar-Tigger	1053	+	104	62278071	17292
chr15	62260779	62460779	harbor1	chr15	62278423	62278517	DNA/TcMar-Tigger	562	+	47	62278470	17691
chr15	95403544	95603544	harbor1	chr15	95427675	95427978	DNA/TcMar-Tigger	1050	+	152	95427827	24283
chr15	95403544	95603544	harbor1	chr15	95444667	95444992	DNA/TcMar-Tigger	1880	+	162	95444829	41285
chr15	95403544	95603544	harbor1	chr15	95461036	95461323	DNA/TcMar-Tigger	605	+	144	95461180	57636
chr15	47804796	48004796	harbor1	chr15	47827696	47827888	DNA/TcMar-Tigger	1049	+	96	47827792	22996
chr15	86911759	87111759	harbor1	chr15	86970802	86971112	DNA/TcMar-Tigger	1232	+	155	86970957	59198
chr15	86911759	87111759	harbor1	chr15	86982507	86982925	DNA/TcMar-Tigger	2406	+	209	86982716	70957
chr15	68399907	68599907	harbor1	chr15	68436977	68437214	DNA/TcMar-Tigger	521	+	118	68437095	37188
chr15	26646883	26846883	harbor1	chr15	26708097	26708140	DNA/TcMar-Tigger	464	+	22	26708119	61236
chr15	55067203	55267203	harbor1	chr15	55150144	55150386	DNA/TcMar-Tigger	772	+	121	55150265	83062
chr15	51964115	52164115	harbor1	chr15	52010989	52011242	DNA/TcMar-Tigger	1259	+	126	52011115	47000
chr15	51964115	52164115	harbor1	chr15	52011373	52011754	DNA/TcMar-Tigger	2467	+	190	52011563	47448
chr15	32325787	32525787	harbor1	chr15	32332929	32333163	DNA/TcMar-Tigger	1519	+	117	32333046	7259
chr15	32325787	32525787	harbor1	chr15	32337126	32337291	DNA/TcMar-Tigger	681	+	82	32337208	11421
chr15	30790215	30990215	harbor1	chr15	30824292	30824550	DNA/TcMar-Tigger	506	+	129	30824421	34206
chr15	31697797	31897797	harbor1	chr15	31720265	31720401	DNA/TcMar-Tigger	3370	+	68	31720333	22536
chr15	31697797	31897797	harbor1	chr15	31720698	31721169	DNA/TcMar-Tigger	3370	+	236	31720934	23137
chr15	31697797	31897797	harbor1	chr15	31728941	31729262	DNA/TcMar-Tigger	1668	+	160	31729101	31304
chr15	71034183	71234183	harbor1	chr15	71057526	71058162	DNA/TcMar-Tigger	2844	+	318	71057844	23661
chr15	71034183	71234183	harbor1	chr15	71066002	71066229	DNA/TcMar-Tigger	567	+	114	71066116	31933
chr15	100135993	100335993	harbor1	chr15	100156380	100156896	DNA/TcMar-Tigger	1133	+	258	100156638	20645
chr15	100135993	100335993	harbor1	chr15	100157263	100157440	DNA/TcMar-Tigger	1133	+	88	100157351	21358
chr15	100135993	100335993	harbor1	chr15	100163183	100163449	DNA/TcMar-Tigger	469	+	133	100163316	27323
chr15	28147447	28347447	harbor1	chr15	28179318	28180411	DNA/TcMar-Tigger	5130	+	546	28179864	32417
chr15	28147447	28347447	harbor1	chr15	28180672	28180997	DNA/TcMar-Tigger	1869	+	162	28180834	33387
chr15	28147447	28347447	harbor1	chr15	28209199	28209334	DNA/TcMar-Tigger	935	+	68	28209267	61820
chr15	28147447	28347447	harbor1	chr15	28209643	28209794	DNA/TcMar-Tigger	935	+	76	28209719	62272
chr15	66634386	66834386	harbor1	chr15	66643134	66643478	DNA/TcMar-Tigger	2263	+	172	66643306	8920
chr15	70377454	70577454	harbor1	chr15	70424260	70424592	DNA/TcMar-Tigger	1910	+	166	70424426	46972
chr15	50193765	50393765	harbor1	chr15	50204041	50204180	DNA/TcMar-Tigger	616	+	70	50204111	10346
chr15	50193765	50393765	harbor1	chr15	50256184	50256378	DNA/TcMar-Tigger	515	+	97	50256281	62516
chr15	50193765	50393765	harbor1	chr15	50289145	50289356	DNA/TcMar-Tigger	501	+	106	50289251	95486
chr15	23390412	23590412	harbor1	chr15	23460099	23460291	DNA/TcMar-Tigger	960	+	96	23460195	69783
chr15	23390412	23590412	harbor1	chr15	23473310	23473519	DNA/TcMar-Tigger	1116	+	104	23473414	83002
chr15	41628899	41828899	harbor1	chr15	41635737	41635970	DNA/TcMar-Tigger	1287	+	116	41635853	6954
chr15	41628899	41828899	harbor1	chr15	41636858	41636943	DNA/TcMar-Tigger	521	+	42	41636900	8001
chr15	41628899	41828899	harbor1	chr15	41671159	41671272	DNA/TcMar-Tigger	432	+	56	41671215	42316
chr15	25595729	25795729	harbor1	chr15	25608121	25608447	DNA/TcMar-Tigger	1277	+	163	25608284	12555
chr15	88382779	88582779	harbor1	chr15	88402575	88402964	DNA/TcMar-Tigger	948	+	194	88402769	19990
chr15	88382779	88582779	harbor1	chr15	88427461	88427847	DNA/TcMar-Tigger	1252	+	193	88427654	44875
chr15	88382779	88582779	harbor1	chr15	88453401	88453640	DNA/TcMar-Tigger	856	+	120	88453521	70742
chr15	88382779	88582779	harbor1	chr15	88456871	88457204	DNA/TcMar-Tigger	1907	+	166	88457037	74258
chr15	34133561	34333561	harbor1	chr15	34201772	34202106	DNA/TcMar-Tigger	1977	+	167	34201939	68378
chr15	59109086	59309086	harbor1	chr15	59157404	59157523	DNA/TcMar-Tigger	678	+	60	59157464	48378
chr15	59109086	59309086	harbor1	chr15	59157519	59157887	DNA/TcMar-Tigger	543	+	184	59157703	48617
chr15	98781995	98981995	harbor1	chr15	98784635	98784949	DNA/TcMar-Tigger	1118	+	157	98784792	2797
chr15	84616295	84816295	harbor1	chr15	84698786	84698927	DNA/TcMar-Tigger	777	+	70	84698856	82561
chr15	61231030	61431030	harbor1	chr15	61265575	61265744	DNA/TcMar-Tigger	496	+	84	61265659	34629
chr15	53213587	53413587	harbor1	chr15	53267444	53267798	DNA/TcMar-Tigger	1894	+	177	53267621	54034
chr15	61327399	61527399	harbor1	chr15	61396658	61397831	DNA/TcMar-Tigger	5723	+	586	61397244	69845
chr15	53760444	53960444	harbor1	chr15	53845877	53846231	DNA/TcMar-Tigger	2100	+	177	53846054	85610
chr15	83247805	83447805	harbor1	chr15	83307231	83307469	DNA/TcMar-Tigger	732	+	119	83307350	59545
chr15	40191474	40391474	harbor1	chr15	40229091	40229193	DNA/TcMar-Tigger	1793	+	51	40229142	37668
chr15	40191474	40391474	harbor1	chr15	40229493	40229726	DNA/TcMar-Tigger	1793	+	116	40229609	38135
chr15	73429778	73629778	harbor1	chr15	73475349	73475455	DNA/TcMar-Tigger	513	+	53	73475402	45624
chr15	73429778	73629778	harbor1	chr15	73475448	73476180	DNA/TcMar-Tigger	2532	+	366	73475814	46036
chr15	58747345	58947345	harbor1	chr15	58819765	58819983	DNA/TcMar-Tigger	565	+	109	58819874	72529
chr15	58747345	58947345	harbor1	chr15	58830364	58830588	DNA/TcMar-Tigger	1315	+	112	58830476	83131
chr15	25522424	25722424	harbor1	chr15	25537346	25537488	DNA/TcMar-Tigger	769	+	71	25537417	14993
chr15	25522424	25722424	harbor1	chr15	25560679	25560997	DNA/TcMar-Tigger	1818	+	159	25560838	38414
chr15	25522424	25722424	harbor1	chr15	25572864	25573209	DNA/TcMar-Tigger	2404	+	172	25573036	50612
chr15	25522424	25722424	harbor1	chr15	25593596	25594753	DNA/TcMar-Tigger	5742	+	578	25594174	71750
chr15	25522424	25722424	harbor1	chr15	25608121	25608447	DNA/TcMar-Tigger	1277	+	163	25608284	85860
chr15	55409019	55609019	harbor1	chr15	55488684	55488807	DNA/TcMar-Tigger	521	+	62	55488746	79727
chr15	55409019	55609019	harbor1	chr15	55489112	55489213	DNA/TcMar-Tigger	521	+	50	55489162	80143
chr16	79247025	79447025	harbor1	chr16	79324279	79324519	DNA/TcMar-Tigger	1240	+	120	79324399	77374
chr16	33446658	33646658	harbor1	chr16	33455870	33456064	DNA/TcMar-Tigger	1161	+	97	33455967	9309
chr16	22635333	22835333	harbor1	chr16	22699706	22699863	DNA/TcMar-Tigger	775	+	78	22699784	64451
chr16	22635333	22835333	harbor1	chr16	22700727	22700872	DNA/TcMar-Tigger	733	+	72	22700799	65466
chr16	22635333	22835333	harbor1	chr16	22727706	22728015	DNA/TcMar-Tigger	1967	+	154	22727860	92527
chr16	7268393	7468393	harbor1	chr16	7293103	7293406	DNA/TcMar-Tigger	1601	+	152	7293255	24862
chr16	7268393	7468393	harbor1	chr16	7299896	7299970	DNA/TcMar-Tigger	447	+	37	7299933	31540
chr16	7268393	7468393	harbor1	chr16	7336758	7337086	DNA/TcMar-Tigger	1266	+	164	7336922	68529
chr16	75376610	75576610	harbor1	chr16	75433679	75434907	DNA/TcMar-Tigger	15719	+	614	75434293	57683
chr16	75376610	75576610	harbor1	chr16	75435212	75436389	DNA/TcMar-Tigger	15719	+	588	75435800	59190
chr16	75376610	75576610	harbor1	chr16	75436679	75436965	DNA/TcMar-Tigger	15719	+	143	75436822	60212
chr16	34572314	34772314	harbor1	chr16	34634250	34634590	DNA/TcMar-Tigger	1438	+	170	34634420	62106
chr16	22426060	22626060	harbor1	chr16	22476049	22476387	DNA/TcMar-Tigger	2161	+	169	22476218	50158
chr16	60559730	60759730	harbor1	chr16	60618721	60619025	DNA/TcMar-Tigger	1396	+	152	60618873	59143
chr16	60559730	60759730	harbor1	chr16	60625886	60626243	DNA/TcMar-Tigger	1540	+	178	60626064	66334
chr16	46484095	46684095	harbor1	chr16	46532538	46532580	DNA/TcMar-Tigger	3560	+	21	46532559	48464
chr16	46484095	46684095	harbor1	chr16	46532952	46533402	DNA/TcMar-Tigger	3560	+	225	46533177	49082
chr16	46484095	46684095	harbor1	chr16	46533902	46534101	DNA/TcMar-Tigger	3560	+	100	46534002	49907
chr16	46484095	46684095	harbor1	chr16	46544193	46545520	DNA/TcMar-Tigger	8059	+	664	46544857	60762
chr16	46484095	46684095	harbor1	chr16	46552786	46553203	DNA/TcMar-Tigger	1978	+	208	46552994	68899
chr16	5114311	5314311	harbor1	chr16	5182471	5182808	DNA/TcMar-Tigger	1921	+	168	5182639	68328
chr16	85575754	85775754	harbor1	chr16	85666812	85667125	DNA/TcMar-Tigger	1647	+	156	85666968	91214
chr16	12963667	13163667	harbor1	chr16	13014611	13014849	DNA/TcMar-Tigger	427	+	119	13014730	51063
chr16	12963667	13163667	harbor1	chr16	13031723	13031996	DNA/TcMar-Tigger	1465	+	136	13031859	68192
chr16	12963667	13163667	harbor1	chr16	13032437	13032608	DNA/TcMar-Tigger	867	+	86	13032523	68856
chr16	19695567	19895567	harbor1	chr16	19716687	19716852	DNA/TcMar-Tigger	1543	+	82	19716769	21202
chr16	19695567	19895567	harbor1	chr16	19717143	19717279	DNA/TcMar-Tigger	1543	+	68	19717211	21644
chr16	22238360	22438360	harbor1	chr16	22283345	22283489	DNA/TcMar-Tigger	517	+	72	22283417	45057
chr16	22238360	22438360	harbor1	chr16	22310111	22310272	DNA/TcMar-Tigger	559	+	80	22310191	71831
chr16	22238360	22438360	harbor1	chr16	22310587	22310654	DNA/TcMar-Tigger	2080	+	34	22310621	72261
chr16	22238360	22438360	harbor1	chr16	22310930	22310960	DNA/TcMar-Tigger	2080	+	15	22310945	72585
chr16	22238360	22438360	harbor1	chr16	22311269	22311478	DNA/TcMar-Tigger	2171	+	104	22311373	73013
chr16	22238360	22438360	harbor1	chr16	22311796	22312033	DNA/TcMar-Tigger	2171	+	118	22311914	73554
chr16	53346291	53546291	harbor1	chr16	53427631	53427735	DNA/TcMar-Tigger	1725	+	52	53427683	81392
chr16	53346291	53546291	harbor1	chr16	53428035	53428232	DNA/TcMar-Tigger	1725	+	98	53428133	81842
chr16	47592841	47792841	harbor1	chr16	47599930	47600104	DNA/TcMar-Tigger	452	+	87	47600017	7176
chr16	47592841	47792841	harbor1	chr16	47658514	47658808	DNA/TcMar-Tigger	1749	+	147	47658661	65820
chr16	76752033	76952033	harbor1	chr16	76822274	76822521	DNA/TcMar-Tigger	1129	+	124	76822398	70365
chr16	46554760	46754760	harbor1	chr16	46611001	46611756	DNA/TcMar-Tigger	4673	+	378	46611379	56619
chr16	46554760	46754760	harbor1	chr16	46614963	46615391	DNA/TcMar-Tigger	2580	+	214	46615177	60417
chr16	22356315	22556315	harbor1	chr16	22404745	22405010	DNA/TcMar-Tigger	779	+	132	22404877	48562
chr16	22356315	22556315	harbor1	chr16	22405152	22405353	DNA/TcMar-Tigger	518	+	100	22405252	48937
chr16	22356315	22556315	harbor1	chr16	22405664	22405811	DNA/TcMar-Tigger	518	+	74	22405738	49423
chr16	86325797	86525797	harbor1	chr16	86421982	86422238	DNA/TcMar-Tigger	1360	+	128	86422110	96313
chr16	69470699	69670699	harbor1	chr16	69492714	69492814	DNA/TcMar-Tigger	1762	+	50	69492764	22065
chr16	69470699	69670699	harbor1	chr16	69493116	69493340	DNA/TcMar-Tigger	1762	+	112	69493228	22529
chr16	69470699	69670699	harbor1	chr16	69546347	69546469	DNA/TcMar-Tigger	802	+	61	69546408	75709
chr16	69470699	69670699	harbor1	chr16	69546624	69546844	DNA/TcMar-Tigger	2171	+	110	69546734	76035
chr16	69470699	69670699	harbor1	chr16	69547145	69547174	DNA/TcMar-Tigger	2171	+	14	69547159	76460
chr16	69470699	69670699	harbor1	chr16	69547463	69547647	DNA/TcMar-Tigger	2171	+	92	69547555	76856
chr16	24378321	24578321	harbor1	chr16	24470460	24470617	DNA/TcMar-Tigger	1179	+	78	24470538	92217
chr16	24378321	24578321	harbor1	chr16	24470753	24470922	DNA/TcMar-Tigger	1307	+	84	24470837	92516
chr16	24378321	24578321	harbor1	chr16	24471235	24471317	DNA/TcMar-Tigger	1307	+	41	24471276	92955
chr16	73146230	73346230	harbor1	chr16	73225819	73226140	DNA/TcMar-Tigger	708	+	160	73225979	79749
chr16	73146230	73346230	harbor1	chr16	73226186	73226468	DNA/TcMar-Tigger	634	+	141	73226327	80097
chr16	60761616	60961616	harbor1	chr16	60776904	60777064	DNA/TcMar-Tigger	990	+	80	60776984	15368
chr16	60761616	60961616	harbor1	chr16	60777383	60777432	DNA/TcMar-Tigger	990	+	24	60777407	15791
chr16	60761616	60961616	harbor1	chr16	60777432	60777580	DNA/TcMar-Tigger	707	+	74	60777506	15890
chr16	57534438	57734438	harbor1	chr16	57611082	57611392	DNA/TcMar-Tigger	1808	+	155	57611237	76799
chr16	54927919	55127919	harbor1	chr16	54945490	54945843	DNA/TcMar-Tigger	1632	+	176	54945666	17747
chr16	19458511	19658511	harbor1	chr16	19515089	19515420	DNA/TcMar-Tigger	1001	+	166	19515255	56744
chr16	19458511	19658511	harbor1	chr16	19519483	19519629	DNA/TcMar-Tigger	789	+	73	19519556	61045
chr16	19458511	19658511	harbor1	chr16	19544369	19544701	DNA/TcMar-Tigger	1952	+	166	19544535	86024
chr16	19964926	20164926	harbor1	chr16	19977720	19978149	DNA/TcMar-Tigger	2656	+	214	19977934	13008
chr16	19964926	20164926	harbor1	chr16	20029550	20030039	DNA/TcMar-Tigger	1573	+	244	20029794	64868
chr16	19640207	19840207	harbor1	chr16	19689013	19689037	DNA/TcMar-Tigger	984	+	12	19689025	48818
chr16	19640207	19840207	harbor1	chr16	19689572	19689774	DNA/TcMar-Tigger	984	+	101	19689673	49466
chr16	19640207	19840207	harbor1	chr16	19689776	19689881	DNA/TcMar-Tigger	711	+	52	19689828	49621
chr16	19640207	19840207	harbor1	chr16	19716687	19716852	DNA/TcMar-Tigger	1543	+	82	19716769	76562
chr16	19640207	19840207	harbor1	chr16	19717143	19717279	DNA/TcMar-Tigger	1543	+	68	19717211	77004
chr16	11854572	12054572	harbor1	chr16	11858283	11858546	DNA/TcMar-Tigger	1520	+	132	11858415	3843
chr16	11854572	12054572	harbor1	chr16	11858992	11859255	DNA/TcMar-Tigger	1785	+	132	11859124	4552
chr16	11854572	12054572	harbor1	chr16	11859809	11859832	DNA/TcMar-Tigger	2873	+	12	11859821	5249
chr16	11854572	12054572	harbor1	chr16	11860452	11861176	DNA/TcMar-Tigger	2873	+	362	11860814	6242
chr16	62953994	63153994	harbor1	chr16	62956498	62956581	DNA/TcMar-Tigger	1480	+	42	62956540	2546
chr16	62953994	63153994	harbor1	chr16	62956877	62957128	DNA/TcMar-Tigger	1480	+	126	62957003	3009
chr16	62953994	63153994	harbor1	chr16	63051963	63052304	DNA/TcMar-Tigger	2085	+	170	63052133	98139
chr16	52976712	53176712	harbor1	chr16	53003951	53004038	DNA/TcMar-Tigger	1964	+	44	53003995	27283
chr16	52976712	53176712	harbor1	chr16	53004353	53004598	DNA/TcMar-Tigger	1964	+	122	53004475	27763
chr16	52976712	53176712	harbor1	chr16	53057694	53058114	DNA/TcMar-Tigger	2512	+	210	53057904	81192
chr16	52976712	53176712	harbor1	chr16	53058419	53058470	DNA/TcMar-Tigger	2512	+	26	53058445	81733
chr16	52976712	53176712	harbor1	chr16	53059783	53059892	DNA/TcMar-Tigger	618	+	54	53059837	83125
chr16	47954153	48154153	harbor1	chr16	47964108	47964219	DNA/TcMar-Tigger	690	+	56	47964164	10011
chr16	47954153	48154153	harbor1	chr16	47964211	47964944	DNA/TcMar-Tigger	4393	+	366	47964577	10424
chr16	52168599	52368599	harbor1	chr16	52267874	52268223	DNA/TcMar-Tigger	1911	+	174	52268048	99449
chr16	80804404	81004404	harbor1	chr16	80827879	80828200	DNA/TcMar-Tigger	1721	+	160	80828039	23635
chr16	16432962	16632962	harbor1	chr16	16444664	16445090	DNA/TcMar-Tigger	2477	+	213	16444877	11915
chr16	25660670	25860670	harbor1	chr16	25669342	25669441	DNA/TcMar-Tigger	14968	+	50	25669392	8722
chr16	25660670	25860670	harbor1	chr16	25669731	25672017	DNA/TcMar-Tigger	14968	+	1143	25670874	10204
chr16	25660670	25860670	harbor1	chr16	25706847	25707525	DNA/TcMar-Tigger	2631	+	339	25707186	46516
chr16	25660670	25860670	harbor1	chr16	25757371	25757589	DNA/TcMar-Tigger	1271	+	109	25757480	96810
chr16	75218417	75418417	harbor1	chr16	75286148	75286342	DNA/TcMar-Tigger	1308	+	97	75286245	67828
chr16	75218417	75418417	harbor1	chr16	75297924	75298280	DNA/TcMar-Tigger	1817	+	178	75298102	79685
chr16	4927022	5127022	harbor1	chr16	4998843	4999322	DNA/TcMar-Tigger	1970	+	240	4999083	72061
chr16	62899051	63099051	harbor1	chr16	62914872	62915153	DNA/TcMar-Tigger	1435	+	140	62915012	15961
chr16	62899051	63099051	harbor1	chr16	62956498	62956581	DNA/TcMar-Tigger	1480	+	42	62956540	57489
chr16	62899051	63099051	harbor1	chr16	62956877	62957128	DNA/TcMar-Tigger	1480	+	126	62957003	57952
chr16	61960995	62160995	harbor1	chr16	61973039	61973108	DNA/TcMar-Tigger	462	+	34	61973073	12078
chr16	61960995	62160995	harbor1	chr16	61973092	61973520	DNA/TcMar-Tigger	2163	+	214	61973306	12311
chr16	61960995	62160995	harbor1	chr16	62015037	62015378	DNA/TcMar-Tigger	1923	+	170	62015207	54212
chr16	28237824	28437824	harbor1	chr16	28238406	28238494	DNA/TcMar-Tigger	1129	+	44	28238450	626
chr16	28237824	28437824	harbor1	chr16	28238792	28238802	DNA/TcMar-Tigger	1129	+	5	28238797	973
chr16	28237824	28437824	harbor1	chr16	28239118	28239320	DNA/TcMar-Tigger	1129	+	101	28239219	1395
chr16	4799741	4999741	harbor1	chr16	4827935	4828030	DNA/TcMar-Tigger	554	+	48	4827983	28242
chr16	4799741	4999741	harbor1	chr16	4828020	4828080	DNA/TcMar-Tigger	680	+	30	4828050	28309
chr16	4799741	4999741	harbor1	chr16	4828368	4828517	DNA/TcMar-Tigger	680	+	74	4828442	28701
chr16	4799741	4999741	harbor1	chr16	4852219	4852568	DNA/TcMar-Tigger	644	+	174	4852393	52652
chr16	4799741	4999741	harbor1	chr16	4867291	4867506	DNA/TcMar-Tigger	1134	+	108	4867399	67658
chr16	17201124	17401124	harbor1	chr16	17254141	17254405	DNA/TcMar-Tigger	2107	+	132	17254273	53149
chr16	17201124	17401124	harbor1	chr16	17254695	17254897	DNA/TcMar-Tigger	2107	+	101	17254796	53672
chr16	66745289	66945289	harbor1	chr16	66771508	66771577	DNA/TcMar-Tigger	491	+	34	66771542	26253
chr16	66745289	66945289	harbor1	chr16	66837212	66837562	DNA/TcMar-Tigger	1825	+	175	66837387	92098
chr16	30050244	30250244	harbor1	chr16	30119649	30119794	DNA/TcMar-Tigger	432	+	72	30119721	69477
chr16	30050244	30250244	harbor1	chr16	30130766	30130941	DNA/TcMar-Tigger	890	+	88	30130854	80610
chr16	19692850	19892850	harbor1	chr16	19716687	19716852	DNA/TcMar-Tigger	1543	+	82	19716769	23919
chr16	19692850	19892850	harbor1	chr16	19717143	19717279	DNA/TcMar-Tigger	1543	+	68	19717211	24361
chr16	30436882	30636882	harbor1	chr16	30452136	30452463	DNA/TcMar-Tigger	1671	+	164	30452300	15418
chr16	46472164	46672164	harbor1	chr16	46532538	46532580	DNA/TcMar-Tigger	3560	+	21	46532559	60395
chr16	46472164	46672164	harbor1	chr16	46532952	46533402	DNA/TcMar-Tigger	3560	+	225	46533177	61013
chr16	46472164	46672164	harbor1	chr16	46533902	46534101	DNA/TcMar-Tigger	3560	+	100	46534002	61838
chr16	46472164	46672164	harbor1	chr16	46544193	46545520	DNA/TcMar-Tigger	8059	+	664	46544857	72693
chr16	46472164	46672164	harbor1	chr16	46552786	46553203	DNA/TcMar-Tigger	1978	+	208	46552994	80830
chr16	72406897	72606897	harbor1	chr16	72411372	72411437	DNA/TcMar-Tigger	1844	+	32	72411404	4507
chr16	72406897	72606897	harbor1	chr16	72411733	72412393	DNA/TcMar-Tigger	1844	+	330	72412063	5166
chr16	77628976	77828976	harbor1	chr16	77712456	77712584	DNA/TcMar-Tigger	755	+	64	77712520	83544
chr16	53312008	53512008	harbor1	chr16	53328094	53328274	DNA/TcMar-Tigger	631	+	90	53328184	16176
chr16	53312008	53512008	harbor1	chr16	53328575	53328643	DNA/TcMar-Tigger	631	+	34	53328609	16601
chr16	23538564	23738564	harbor1	chr16	23543753	23544072	DNA/TcMar-Tigger	1948	+	160	23543913	5349
chr16	7270986	7470986	harbor1	chr16	7293103	7293406	DNA/TcMar-Tigger	1601	+	152	7293255	22269
chr16	7270986	7470986	harbor1	chr16	7299896	7299970	DNA/TcMar-Tigger	447	+	37	7299933	28947
chr16	7270986	7470986	harbor1	chr16	7336758	7337086	DNA/TcMar-Tigger	1266	+	164	7336922	65936
chr16	28643972	28843972	harbor1	chr16	28719230	28719504	DNA/TcMar-Tigger	1474	+	137	28719367	75395
chr16	66749036	66949036	harbor1	chr16	66771508	66771577	DNA/TcMar-Tigger	491	+	34	66771542	22506
chr16	66749036	66949036	harbor1	chr16	66837212	66837562	DNA/TcMar-Tigger	1825	+	175	66837387	88351
chr16	82651258	82851258	harbor1	chr16	82664929	82665545	DNA/TcMar-Tigger	2941	+	308	82665237	13979
chr16	7029483	7229483	harbor1	chr16	7059614	7060102	DNA/TcMar-Tigger	1491	+	244	7059858	30375
chr16	7029483	7229483	harbor1	chr16	7060323	7060498	DNA/TcMar-Tigger	462	+	88	7060411	30928
chr16	7029483	7229483	harbor1	chr16	7063636	7063986	DNA/TcMar-Tigger	1429	+	175	7063811	34328
chr16	64346121	64546121	harbor1	chr16	64429312	64429516	DNA/TcMar-Tigger	1318	+	102	64429414	83293
chr16	33301098	33501098	harbor1	chr16	33357099	33357293	DNA/TcMar-Tigger	1161	+	97	33357196	56098
chr16	65842735	66042735	harbor1	chr16	65861705	65862050	DNA/TcMar-Tigger	1883	+	172	65861877	19142
chr16	65842735	66042735	harbor1	chr16	65892677	65892767	DNA/TcMar-Tigger	452	+	45	65892722	49987
chr16	65842735	66042735	harbor1	chr16	65911200	65912068	DNA/TcMar-Tigger	3617	+	434	65911634	68899
chr16	65842735	66042735	harbor1	chr16	65924134	65924585	DNA/TcMar-Tigger	2329	+	226	65924360	81625
chr16	55791274	55991274	harbor1	chr16	55864295	55864612	DNA/TcMar-Tigger	1172	+	158	55864453	73179
chr16	55791274	55991274	harbor1	chr16	55864916	55864926	DNA/TcMar-Tigger	1172	+	5	55864921	73647
chr16	55791274	55991274	harbor1	chr16	55865229	55865699	DNA/TcMar-Tigger	1172	+	235	55865464	74190
chr16	830178	1030178	harbor1	chr16	864305	864641	DNA/TcMar-Tigger	1586	+	168	864473	34295
chr16	24722355	24922355	harbor1	chr16	24812469	24812793	DNA/TcMar-Tigger	1492	+	162	24812631	90276
chr16	53073087	53273087	harbor1	chr16	53125183	53125218	DNA/TcMar-Tigger	2161	+	18	53125201	52114
chr16	53073087	53273087	harbor1	chr16	53125535	53125908	DNA/TcMar-Tigger	2161	+	186	53125721	52634
chr16	66527450	66727450	harbor1	chr16	66540962	66541287	DNA/TcMar-Tigger	1855	+	162	66541124	13674
chr16	17878368	18078368	harbor1	chr16	17882454	17882817	DNA/TcMar-Tigger	3100	+	182	17882636	4268
chr16	17878368	18078368	harbor1	chr16	17883122	17883420	DNA/TcMar-Tigger	3100	+	149	17883271	4903
chr16	60532826	60732826	harbor1	chr16	60618721	60619025	DNA/TcMar-Tigger	1396	+	152	60618873	86047
chr16	60532826	60732826	harbor1	chr16	60625886	60626243	DNA/TcMar-Tigger	1540	+	178	60626064	93238
chr16	84270862	84470862	harbor1	chr16	84320005	84320364	DNA/TcMar-Tigger	2277	+	180	84320185	49323
chr16	84270862	84470862	harbor1	chr16	84327094	84327191	DNA/TcMar-Tigger	1244	+	48	84327142	56280
chr16	84270862	84470862	harbor1	chr16	84327499	84327617	DNA/TcMar-Tigger	1244	+	59	84327558	56696
chr16	63465982	63665982	harbor1	chr16	63529627	63529932	DNA/TcMar-Tigger	1727	+	152	63529779	63797
chr16	13545688	13745688	harbor1	chr16	13556698	13557019	DNA/TcMar-Tigger	1211	+	160	13556858	11170
chr17	16615146	16815146	harbor1	chr17	16618585	16618997	DNA/TcMar-Tigger	2303	+	206	16618791	3645
chr17	54213243	54413243	harbor1	chr17	54260375	54260704	DNA/TcMar-Tigger	1703	+	164	54260539	47296
chr17	53704825	53904825	harbor1	chr17	53750039	53750281	DNA/TcMar-Tigger	998	+	121	53750160	45335
chr17	53704825	53904825	harbor1	chr17	53752067	53752302	DNA/TcMar-Tigger	1360	+	118	53752185	47360
chr17	53704825	53904825	harbor1	chr17	53769730	53770378	DNA/TcMar-Tigger	2860	+	324	53770054	65229
chr17	53704825	53904825	harbor1	chr17	53797731	53798914	DNA/TcMar-Tigger	4759	+	592	53798323	93498
chr17	80795155	80995155	harbor1	chr17	80835537	80835854	DNA/TcMar-Tigger	1747	+	158	80835695	40540
chr17	28001894	28201894	harbor1	chr17	28037537	28037651	DNA/TcMar-Tigger	1788	+	57	28037594	35700
chr17	28001894	28201894	harbor1	chr17	28037925	28038139	DNA/TcMar-Tigger	1788	+	107	28038032	36138
chr17	28001894	28201894	harbor1	chr17	28038437	28038471	DNA/TcMar-Tigger	1788	+	17	28038454	36560
chr17	28001894	28201894	harbor1	chr17	28085376	28085457	DNA/TcMar-Tigger	1421	+	40	28085416	83522
chr17	28001894	28201894	harbor1	chr17	28085759	28086050	DNA/TcMar-Tigger	1421	+	146	28085905	84011
chr17	44697409	44897409	harbor1	chr17	44793922	44794151	DNA/TcMar-Tigger	967	+	114	44794036	96627
chr17	62375578	62575578	harbor1	chr17	62384744	62385102	DNA/TcMar-Tigger	2280	+	179	62384923	9345
chr17	62375578	62575578	harbor1	chr17	62432983	62433099	DNA/TcMar-Tigger	533	+	58	62433041	57463
chr17	62375578	62575578	harbor1	chr17	62435433	62435858	DNA/TcMar-Tigger	2094	+	212	62435645	60067
chr17	42176876	42376876	harbor1	chr17	42256534	42256577	DNA/TcMar-Tigger	904	+	22	42256556	79680
chr17	42176876	42376876	harbor1	chr17	42256889	42257042	DNA/TcMar-Tigger	904	+	76	42256965	80089
chr17	42176876	42376876	harbor1	chr17	42266967	42267676	DNA/TcMar-Tigger	7285	+	354	42267321	90445
chr17	42176876	42376876	harbor1	chr17	42267983	42268501	DNA/TcMar-Tigger	7285	+	259	42268242	91366
chr17	60270176	60470176	harbor1	chr17	60295402	60295921	DNA/TcMar-Tigger	2190	+	260	60295662	25486
chr17	60270176	60470176	harbor1	chr17	60301919	60302104	DNA/TcMar-Tigger	1468	+	92	60302011	31835
chr17	60270176	60470176	harbor1	chr17	60302447	60302584	DNA/TcMar-Tigger	1468	+	68	60302515	32339
chr17	60270176	60470176	harbor1	chr17	60319809	60320006	DNA/TcMar-Tigger	967	+	98	60319907	49731
chr17	60270176	60470176	harbor1	chr17	60358089	60358291	DNA/TcMar-Tigger	628	+	101	60358190	88014
chr17	60270176	60470176	harbor1	chr17	60367157	60367226	DNA/TcMar-Tigger	1627	+	34	60367191	97015
chr17	60270176	60470176	harbor1	chr17	60367821	60368100	DNA/TcMar-Tigger	1627	+	140	60367961	97785
chr17	18529767	18729767	harbor1	chr17	18529659	18529863	DNA/TcMar-Tigger	903	+	102	18529761	6
chr17	18529767	18729767	harbor1	chr17	18612757	18612849	DNA/TcMar-Tigger	585	+	46	18612803	83036
chr17	18529767	18729767	harbor1	chr17	18621361	18621796	DNA/TcMar-Tigger	2268	+	218	18621579	91812
chr17	66329241	66529241	harbor1	chr17	66420379	66420721	DNA/TcMar-Tigger	1803	+	171	66420550	91309
chr17	50923982	51123982	harbor1	chr17	50981077	50981163	DNA/TcMar-Tigger	547	+	43	50981120	57138
chr17	50923982	51123982	harbor1	chr17	50981221	50981386	DNA/TcMar-Tigger	1047	+	82	50981303	57321
chr17	50923982	51123982	harbor1	chr17	50989105	50989440	DNA/TcMar-Tigger	1992	+	168	50989273	65291
chr17	46059641	46259641	harbor1	chr17	46090691	46091784	DNA/TcMar-Tigger	5704	+	546	46091237	31596
chr17	46059641	46259641	harbor1	chr17	46092135	46092231	DNA/TcMar-Tigger	5704	+	48	46092183	32542
chr17	46059641	46259641	harbor1	chr17	46122582	46123098	DNA/TcMar-Tigger	9882	+	258	46122840	63199
chr17	46059641	46259641	harbor1	chr17	46123392	46124117	DNA/TcMar-Tigger	9882	+	362	46123754	64113
chr17	46059641	46259641	harbor1	chr17	46124250	46125479	DNA/TcMar-Tigger	9882	+	614	46124864	65223
chr17	46059641	46259641	harbor1	chr17	46138127	46138262	DNA/TcMar-Tigger	627	+	68	46138195	78554
chr17	46059641	46259641	harbor1	chr17	46138273	46138575	DNA/TcMar-Tigger	1558	+	151	46138424	78783
chr17	63774640	63974640	harbor1	chr17	63798502	63798622	DNA/TcMar-Tigger	636	+	60	63798562	23922
chr17	39948885	40148885	harbor1	chr17	39998227	39998275	DNA/TcMar-Tigger	3245	+	24	39998251	49366
chr17	39948885	40148885	harbor1	chr17	39998580	39998801	DNA/TcMar-Tigger	3245	+	110	39998690	49805
chr17	39948885	40148885	harbor1	chr17	39999097	39999274	DNA/TcMar-Tigger	3245	+	88	39999185	50300
chr17	39948885	40148885	harbor1	chr17	39999590	39999750	DNA/TcMar-Tigger	3245	+	80	39999670	50785
chr17	39948885	40148885	harbor1	chr17	40000288	40000966	DNA/TcMar-Tigger	4690	+	339	40000627	51742
chr17	39948885	40148885	harbor1	chr17	40001108	40001387	DNA/TcMar-Tigger	1619	+	140	40001248	52363
chr17	39948885	40148885	harbor1	chr17	40002165	40002302	DNA/TcMar-Tigger	837	+	68	40002233	53348
chr17	39948885	40148885	harbor1	chr17	40002428	40002659	DNA/TcMar-Tigger	2019	+	116	40002544	53659
chr17	39948885	40148885	harbor1	chr17	40002976	40003072	DNA/TcMar-Tigger	2019	+	48	40003024	54139
chr17	39948885	40148885	harbor1	chr17	40003385	40003446	DNA/TcMar-Tigger	2019	+	30	40003415	54530
chr17	39948885	40148885	harbor1	chr17	40003498	40003643	DNA/TcMar-Tigger	1791	+	72	40003570	54685
chr17	39948885	40148885	harbor1	chr17	40003953	40004044	DNA/TcMar-Tigger	1791	+	46	40003999	55114
chr17	39948885	40148885	harbor1	chr17	40004340	40004450	DNA/TcMar-Tigger	1791	+	55	40004395	55510
chr17	22311968	22511968	harbor1	chr17	22313095	22313393	DNA/TcMar-Tigger	1559	+	149	22313244	1276
chr17	22311968	22511968	harbor1	chr17	22341228	22341516	DNA/TcMar-Tigger	1562	+	144	22341372	29404
chr17	15828419	16028419	harbor1	chr17	15830931	15830996	DNA/TcMar-Tigger	3689	+	32	15830963	2544
chr17	15828419	16028419	harbor1	chr17	15831270	15832107	DNA/TcMar-Tigger	3689	+	418	15831688	3269
chr17	15828419	16028419	harbor1	chr17	15885992	15886182	DNA/TcMar-Tigger	923	+	95	15886087	57668
chr17	15828419	16028419	harbor1	chr17	15903073	15903383	DNA/TcMar-Tigger	777	+	155	15903228	74809
chr17	64339005	64539005	harbor1	chr17	64409501	64409687	DNA/TcMar-Tigger	532	+	93	64409594	70589
chr17	1190416	1390416	harbor1	chr17	1200082	1200267	DNA/TcMar-Tigger	746	+	92	1200174	9758
chr17	1190416	1390416	harbor1	chr17	1200383	1200522	DNA/TcMar-Tigger	746	+	70	1200453	10037
chr17	1190416	1390416	harbor1	chr17	1204515	1204735	DNA/TcMar-Tigger	945	+	110	1204625	14209
chr17	20994147	21194147	harbor1	chr17	21031990	21032326	DNA/TcMar-Tigger	1822	+	168	21032158	38011
chr17	20994147	21194147	harbor1	chr17	21034418	21034911	DNA/TcMar-Tigger	2245	+	246	21034664	40517
chr17	62380581	62580581	harbor1	chr17	62384744	62385102	DNA/TcMar-Tigger	2280	+	179	62384923	4342
chr17	62380581	62580581	harbor1	chr17	62432983	62433099	DNA/TcMar-Tigger	533	+	58	62433041	52460
chr17	62380581	62580581	harbor1	chr17	62435433	62435858	DNA/TcMar-Tigger	2094	+	212	62435645	55064
chr17	51818734	52018734	harbor1	chr17	51824869	51825343	DNA/TcMar-Tigger	1143	+	237	51825106	6372
chr17	51818734	52018734	harbor1	chr17	51843795	51844587	DNA/TcMar-Tigger	1484	+	396	51844191	25457
chr17	79648872	79848872	harbor1	chr17	79655462	79655688	DNA/TcMar-Tigger	636	+	113	79655575	6703
chr17	79648872	79848872	harbor1	chr17	79717124	79717300	DNA/TcMar-Tigger	1230	+	88	79717212	68340
chr17	79648872	79848872	harbor1	chr17	79717603	79717716	DNA/TcMar-Tigger	1230	+	56	79717659	68787
chr17	79648872	79848872	harbor1	chr17	79718018	79718095	DNA/TcMar-Tigger	1230	+	38	79718056	69184
chr17	74282093	74482093	harbor1	chr17	74288082	74288425	DNA/TcMar-Tigger	1988	+	172	74288254	6161
chr17	74282093	74482093	harbor1	chr17	74374247	74374569	DNA/TcMar-Tigger	568	+	161	74374408	92315
chr17	65239108	65439108	harbor1	chr17	65248669	65248875	DNA/TcMar-Tigger	1150	+	103	65248772	9664
chr17	65239108	65439108	harbor1	chr17	65248875	65249028	DNA/TcMar-Tigger	845	+	76	65248951	9843
chr17	65239108	65439108	harbor1	chr17	65334083	65334563	DNA/TcMar-Tigger	2975	+	240	65334323	95215
chr17	41609907	41809907	harbor1	chr17	41661906	41662033	DNA/TcMar-Tigger	1417	+	64	41661970	52063
chr17	41609907	41809907	harbor1	chr17	41662325	41662515	DNA/TcMar-Tigger	1417	+	95	41662420	52513
chr17	41609907	41809907	harbor1	chr17	41692793	41692988	DNA/TcMar-Tigger	1150	+	98	41692891	82984
chr17	38362250	38562250	harbor1	chr17	38372056	38372822	DNA/TcMar-Tigger	4451	+	383	38372439	10189
chr17	38362250	38562250	harbor1	chr17	38373134	38373938	DNA/TcMar-Tigger	7801	+	402	38373536	11286
chr17	38362250	38562250	harbor1	chr17	38374228	38374255	DNA/TcMar-Tigger	7801	+	14	38374242	11992
chr17	38362250	38562250	harbor1	chr17	38374517	38374976	DNA/TcMar-Tigger	7801	+	230	38374747	12497
chr17	38362250	38562250	harbor1	chr17	38375218	38375652	DNA/TcMar-Tigger	1966	+	217	38375435	13185
chr17	38362250	38562250	harbor1	chr17	38376804	38377132	DNA/TcMar-Tigger	1994	+	164	38376968	14718
chr17	38362250	38562250	harbor1	chr17	38377255	38377482	DNA/TcMar-Tigger	1498	+	114	38377369	15119
chr17	38362250	38562250	harbor1	chr17	38409167	38409458	DNA/TcMar-Tigger	556	+	146	38409313	47063
chr17	76601103	76801103	harbor1	chr17	76650043	76650188	DNA/TcMar-Tigger	659	+	72	76650115	49012
chr17	76601103	76801103	harbor1	chr17	76695203	76695352	DNA/TcMar-Tigger	537	+	74	76695277	94174
chr17	22247596	22447596	harbor1	chr17	22313095	22313393	DNA/TcMar-Tigger	1559	+	149	22313244	65648
chr17	22247596	22447596	harbor1	chr17	22341228	22341516	DNA/TcMar-Tigger	1562	+	144	22341372	93776
chr17	37824940	38024940	harbor1	chr17	37859219	37859403	DNA/TcMar-Tigger	1044	+	92	37859311	34371
chr17	37824940	38024940	harbor1	chr17	37888228	37888387	DNA/TcMar-Tigger	827	+	80	37888308	63368
chr17	37824940	38024940	harbor1	chr17	37888743	37889138	DNA/TcMar-Tigger	2212	+	198	37888941	64001
chr17	21309297	21509297	harbor1	chr17	21394196	21394500	DNA/TcMar-Tigger	1750	+	152	21394348	85051
chr17	27600363	27800363	harbor1	chr17	27675214	27675551	DNA/TcMar-Tigger	1965	+	168	27675382	75019
chr17	7988100	8188100	harbor1	chr17	8023177	8023467	DNA/TcMar-Tigger	1110	+	145	8023322	35222
chr17	7988100	8188100	harbor1	chr17	8077900	8078104	DNA/TcMar-Tigger	1126	+	102	8078002	89902
chr17	7988100	8188100	harbor1	chr17	8078854	8078894	DNA/TcMar-Tigger	683	+	20	8078874	90774
chr17	7988100	8188100	harbor1	chr17	8079196	8079295	DNA/TcMar-Tigger	683	+	50	8079246	91146
chr17	7988100	8188100	harbor1	chr17	8082935	8083162	DNA/TcMar-Tigger	539	+	114	8083049	94949
chr17	15867466	16067466	harbor1	chr17	15885992	15886182	DNA/TcMar-Tigger	923	+	95	15886087	18621
chr17	15867466	16067466	harbor1	chr17	15903073	15903383	DNA/TcMar-Tigger	777	+	155	15903228	35762
chr17	15867466	16067466	harbor1	chr17	15955097	15955333	DNA/TcMar-Tigger	1213	+	118	15955215	87749
chr17	15867466	16067466	harbor1	chr17	15965994	15966135	DNA/TcMar-Tigger	524	+	70	15966064	98598
chr17	62318828	62518828	harbor1	chr17	62384744	62385102	DNA/TcMar-Tigger	2280	+	179	62384923	66095
chr17	42394291	42594291	harbor1	chr17	42417098	42417171	DNA/TcMar-Tigger	1893	+	36	42417134	22843
chr17	42394291	42594291	harbor1	chr17	42417475	42417701	DNA/TcMar-Tigger	1893	+	113	42417588	23297
chr17	42394291	42594291	harbor1	chr17	42435496	42435728	DNA/TcMar-Tigger	1327	+	116	42435612	41321
chr17	42394291	42594291	harbor1	chr17	42417955	42418222	DNA/TcMar-Tigger	1893	+	134	42418089	23798
chr17	68287479	68487479	harbor1	chr17	68379953	68380179	DNA/TcMar-Tigger	2494	+	113	68380066	92587
chr17	68287479	68487479	harbor1	chr17	68380569	68380803	DNA/TcMar-Tigger	2494	+	117	68380686	93207
chr17	36508762	36708762	harbor1	chr17	36520469	36520908	DNA/TcMar-Tigger	1811	+	220	36520689	11927
chr17	36508762	36708762	harbor1	chr17	36566032	36566377	DNA/TcMar-Tigger	571	+	172	36566204	57442
chr17	36508762	36708762	harbor1	chr17	36566694	36566754	DNA/TcMar-Tigger	571	+	30	36566724	57962
chr17	36508762	36708762	harbor1	chr17	36574122	36574402	DNA/TcMar-Tigger	1650	+	140	36574262	65500
chr17	70075526	70275526	harbor1	chr17	70083397	70083734	DNA/TcMar-Tigger	2006	+	168	70083565	8039
chr17	70075526	70275526	harbor1	chr17	70146813	70147136	DNA/TcMar-Tigger	1439	+	162	70146975	71449
chr17	70075526	70275526	harbor1	chr17	70165509	70165814	DNA/TcMar-Tigger	498	+	152	70165661	90135
chr17	28390360	28590360	harbor1	chr17	28431355	28431633	DNA/TcMar-Tigger	1295	+	139	28431494	41134
chr17	28390360	28590360	harbor1	chr17	28446846	28447231	DNA/TcMar-Tigger	2375	+	192	28447038	56678
chr17	9545139	9745139	harbor1	chr17	9612780	9613131	DNA/TcMar-Tigger	2176	+	176	9612956	67817
chr17	31913259	32113259	harbor1	chr17	32002355	32002688	DNA/TcMar-Tigger	1853	+	166	32002521	89262
chr17	31913259	32113259	harbor1	chr17	32004833	32005043	DNA/TcMar-Tigger	1162	+	105	32004938	91679
chr17	63994936	64194936	harbor1	chr17	64012626	64012882	DNA/TcMar-Tigger	1326	+	128	64012754	17818
chr17	63994936	64194936	harbor1	chr17	64050378	64050892	DNA/TcMar-Tigger	908	+	257	64050635	55699
chr17	63994936	64194936	harbor1	chr17	64089359	64089590	DNA/TcMar-Tigger	1524	+	116	64089475	94539
chr17	49314948	49514948	harbor1	chr17	49322160	49322465	DNA/TcMar-Tigger	1391	+	152	49322312	7364
chr17	49314948	49514948	harbor1	chr17	49325903	49326061	DNA/TcMar-Tigger	849	+	79	49325982	11034
chr17	13672687	13872687	harbor1	chr17	13687763	13688184	DNA/TcMar-Tigger	2343	+	210	13687973	15286
chr17	13672687	13872687	harbor1	chr17	13692585	13693246	DNA/TcMar-Tigger	2849	+	330	13692915	20228
chr17	13672687	13872687	harbor1	chr17	13693248	13693490	DNA/TcMar-Tigger	1193	+	121	13693369	20682
chr17	13672687	13872687	harbor1	chr17	13708304	13708428	DNA/TcMar-Tigger	544	+	62	13708366	35679
chr17	13672687	13872687	harbor1	chr17	13712779	13713033	DNA/TcMar-Tigger	624	+	127	13712906	40219
chr17	76257157	76457157	harbor1	chr17	76309626	76309835	DNA/TcMar-Tigger	830	+	104	76309730	52573
chr17	76257157	76457157	harbor1	chr17	76320371	76320423	DNA/TcMar-Tigger	4099	+	26	76320397	63240
chr17	76257157	76457157	harbor1	chr17	76320710	76320776	DNA/TcMar-Tigger	4099	+	33	76320743	63586
chr17	76257157	76457157	harbor1	chr17	76321083	76321282	DNA/TcMar-Tigger	4099	+	100	76321183	64026
chr17	76257157	76457157	harbor1	chr17	76321494	76322114	DNA/TcMar-Tigger	4099	+	310	76321804	64647
chr17	76257157	76457157	harbor1	chr17	76322421	76322547	DNA/TcMar-Tigger	834	+	63	76322484	65327
chr17	76257157	76457157	harbor1	chr17	76323358	76323863	DNA/TcMar-Tigger	2944	+	252	76323610	66453
chr17	76257157	76457157	harbor1	chr17	76324160	76324195	DNA/TcMar-Tigger	2944	+	18	76324178	67021
chr17	76257157	76457157	harbor1	chr17	76324615	76324708	DNA/TcMar-Tigger	615	+	46	76324661	67504
chr17	76257157	76457157	harbor1	chr17	76325483	76325598	DNA/TcMar-Tigger	1787	+	58	76325541	68384
chr17	76257157	76457157	harbor1	chr17	76325906	76326118	DNA/TcMar-Tigger	1787	+	106	76326012	68855
chr17	76257157	76457157	harbor1	chr17	76331350	76331690	DNA/TcMar-Tigger	1151	+	170	76331520	74363
chr17	63920891	64120891	harbor1	chr17	64012626	64012882	DNA/TcMar-Tigger	1326	+	128	64012754	91863
chr17	31519438	31719438	harbor1	chr17	31520127	31520332	DNA/TcMar-Tigger	1309	+	102	31520229	791
chr17	31519438	31719438	harbor1	chr17	31570050	31570270	DNA/TcMar-Tigger	824	+	110	31570160	50722
chr17	31519438	31719438	harbor1	chr17	31576403	31576737	DNA/TcMar-Tigger	2072	+	167	31576570	57132
chr17	31519438	31719438	harbor1	chr17	31603087	31603280	DNA/TcMar-Tigger	1143	+	96	31603183	83745
chr17	77654730	77854730	harbor1	chr17	77717412	77717737	DNA/TcMar-Tigger	1689	+	162	77717574	62844
chr17	77654730	77854730	harbor1	chr17	77722577	77722953	DNA/TcMar-Tigger	1829	+	188	77722765	68035
chr17	77654730	77854730	harbor1	chr17	77743097	77743361	DNA/TcMar-Tigger	636	+	132	77743229	88499
chr17	77654730	77854730	harbor1	chr17	77743657	77743900	DNA/TcMar-Tigger	636	+	122	77743779	89049
chr17	62239078	62439078	harbor1	chr17	62276492	62276817	DNA/TcMar-Tigger	1583	+	162	62276654	37576
chr17	62239078	62439078	harbor1	chr17	62315307	62315585	DNA/TcMar-Tigger	1284	+	139	62315446	76368
chr17	77334167	77534167	harbor1	chr17	77347669	77348020	DNA/TcMar-Tigger	1988	+	176	77347845	13678
chr17	77334167	77534167	harbor1	chr17	77417453	77417693	DNA/TcMar-Tigger	481	+	120	77417573	83406
chr17	45835176	46035176	harbor1	chr17	45842083	45842561	DNA/TcMar-Tigger	1351	+	239	45842322	7146
chr17	5232216	5432216	harbor1	chr17	5251112	5251153	DNA/TcMar-Tigger	1386	+	20	5251132	18916
chr17	5232216	5432216	harbor1	chr17	5251776	5252018	DNA/TcMar-Tigger	1386	+	121	5251897	19681
chr17	5232216	5432216	harbor1	chr17	5294418	5294620	DNA/TcMar-Tigger	1301	+	101	5294519	62303
chr17	14988060	15188060	harbor1	chr17	15027340	15027548	DNA/TcMar-Tigger	536	+	104	15027444	39384
chr17	60064482	60264482	harbor1	chr17	60082226	60082306	DNA/TcMar-Tigger	3222	+	40	60082266	17784
chr17	60064482	60264482	harbor1	chr17	60082608	60083097	DNA/TcMar-Tigger	3222	+	244	60082852	18370
chr17	60001909	60201909	harbor1	chr17	60019913	60020250	DNA/TcMar-Tigger	1783	+	168	60020081	18172
chr17	60001909	60201909	harbor1	chr17	60082226	60082306	DNA/TcMar-Tigger	3222	+	40	60082266	80357
chr17	60001909	60201909	harbor1	chr17	60082608	60083097	DNA/TcMar-Tigger	3222	+	244	60082852	80943
chr17	70012207	70212207	harbor1	chr17	70065608	70066090	DNA/TcMar-Tigger	1396	+	241	70065849	53642
chr17	70012207	70212207	harbor1	chr17	70083397	70083734	DNA/TcMar-Tigger	2006	+	168	70083565	71358
chr17	31109216	31309216	harbor1	chr17	31136388	31136926	DNA/TcMar-Tigger	3341	+	269	31136657	27441
chr17	31109216	31309216	harbor1	chr17	31151065	31151365	DNA/TcMar-Tigger	1444	+	150	31151215	41999
chr17	41509090	41709090	harbor1	chr17	41561564	41561933	DNA/TcMar-Tigger	2592	+	184	41561748	52658
chr17	41509090	41709090	harbor1	chr17	41562230	41562572	DNA/TcMar-Tigger	2592	+	171	41562401	53311
chr17	68469331	68669331	harbor1	chr17	68534340	68534976	DNA/TcMar-Tigger	3015	+	318	68534658	65327
chr17	56314698	56514698	harbor1	chr17	56365614	56366869	DNA/TcMar-Tigger	6084	+	628	56366242	51544
chr17	68343436	68543436	harbor1	chr17	68379953	68380179	DNA/TcMar-Tigger	2494	+	113	68380066	36630
chr17	68343436	68543436	harbor1	chr17	68380569	68380803	DNA/TcMar-Tigger	2494	+	117	68380686	37250
chr17	68343436	68543436	harbor1	chr17	68393157	68393584	DNA/TcMar-Tigger	2863	+	214	68393371	49935
chr17	68343436	68543436	harbor1	chr17	68393898	68393944	DNA/TcMar-Tigger	2863	+	23	68393921	50485
chr17	68343436	68543436	harbor1	chr17	68394122	68394322	DNA/TcMar-Tigger	1781	+	100	68394222	50786
chr17	68343436	68543436	harbor1	chr17	68394652	68394750	DNA/TcMar-Tigger	1781	+	49	68394701	51265
chr17	17337177	17537177	harbor1	chr17	17373386	17373448	DNA/TcMar-Tigger	2285	+	31	17373417	36240
chr17	17337177	17537177	harbor1	chr17	17373759	17374168	DNA/TcMar-Tigger	2285	+	204	17373963	36786
chr17	17337177	17537177	harbor1	chr17	17374326	17375635	DNA/TcMar-Tigger	11709	+	654	17374980	37803
chr17	17337177	17537177	harbor1	chr17	17375928	17376529	DNA/TcMar-Tigger	11709	+	300	17376228	39051
chr17	58440404	58640404	harbor1	chr17	58465878	58466213	DNA/TcMar-Tigger	1941	+	168	58466046	25642
chr17	74247114	74447114	harbor1	chr17	74256963	74257220	DNA/TcMar-Tigger	932	+	128	74257091	9977
chr17	74247114	74447114	harbor1	chr17	74288082	74288425	DNA/TcMar-Tigger	1988	+	172	74288254	41140
chr17	6438927	6638927	harbor1	chr17	6475546	6475800	DNA/TcMar-Tigger	678	+	127	6475673	36746
chr17	80819292	81019292	harbor1	chr17	80835537	80835854	DNA/TcMar-Tigger	1747	+	158	80835695	16403
chr17	67537581	67737581	harbor1	chr17	67588328	67588594	DNA/TcMar-Tigger	1519	+	133	67588461	50880
chr17	67537581	67737581	harbor1	chr17	67588600	67588699	DNA/TcMar-Tigger	484	+	50	67588650	51069
chr17	66400066	66600066	harbor1	chr17	66420379	66420721	DNA/TcMar-Tigger	1803	+	171	66420550	20484
chr17	37827468	38027468	harbor1	chr17	37859219	37859403	DNA/TcMar-Tigger	1044	+	92	37859311	31843
chr17	37827468	38027468	harbor1	chr17	37888228	37888387	DNA/TcMar-Tigger	827	+	80	37888308	60840
chr17	37827468	38027468	harbor1	chr17	37888743	37889138	DNA/TcMar-Tigger	2212	+	198	37888941	61473
chr17	41266533	41466533	harbor1	chr17	41331027	41331181	DNA/TcMar-Tigger	920	+	77	41331104	64571
chr17	61800855	62000855	harbor1	chr17	61873478	61873749	DNA/TcMar-Tigger	482	+	136	61873614	72759
chr17	55134541	55334541	harbor1	chr17	55179519	55179933	DNA/TcMar-Tigger	1968	+	207	55179726	45185
chr17	50978138	51178138	harbor1	chr17	50981077	50981163	DNA/TcMar-Tigger	547	+	43	50981120	2982
chr17	50978138	51178138	harbor1	chr17	50981221	50981386	DNA/TcMar-Tigger	1047	+	82	50981303	3165
chr17	50978138	51178138	harbor1	chr17	50989105	50989440	DNA/TcMar-Tigger	1992	+	168	50989273	11135
chr17	50978138	51178138	harbor1	chr17	51027517	51028704	DNA/TcMar-Tigger	6761	+	594	51028111	49973
chr17	79585079	79785079	harbor1	chr17	79595789	79595930	DNA/TcMar-Tigger	490	+	70	79595859	10780
chr17	79585079	79785079	harbor1	chr17	79655462	79655688	DNA/TcMar-Tigger	636	+	113	79655575	70496
chr17	14162247	14362247	harbor1	chr17	14165196	14166612	DNA/TcMar-Tigger	13060	+	708	14165904	3657
chr17	14162247	14362247	harbor1	chr17	14166918	14167515	DNA/TcMar-Tigger	13060	+	298	14167216	4969
chr17	14162247	14362247	harbor1	chr17	14253469	14253821	DNA/TcMar-Tigger	1940	+	176	14253645	91398
chr17	75164071	75364071	harbor1	chr17	75197926	75198030	DNA/TcMar-Tigger	630	+	52	75197978	33907
chr17	53552486	53752486	harbor1	chr17	53626921	53627267	DNA/TcMar-Tigger	541	+	173	53627094	74608
chr17	70923628	71123628	harbor1	chr17	70962462	70962853	DNA/TcMar-Tigger	2517	+	196	70962658	39030
chr17	70923628	71123628	harbor1	chr17	70963156	70963232	DNA/TcMar-Tigger	2517	+	38	70963194	39566
chr17	61689302	61889302	harbor1	chr17	61708166	61708415	DNA/TcMar-Tigger	1207	+	124	61708290	18988
chr17	61689302	61889302	harbor1	chr17	61708414	61708512	DNA/TcMar-Tigger	592	+	49	61708463	19161
chr17	61689302	61889302	harbor1	chr17	61712994	61713524	DNA/TcMar-Tigger	4227	+	265	61713259	23957
chr17	61689302	61889302	harbor1	chr17	61713817	61714643	DNA/TcMar-Tigger	4227	+	413	61714230	24928
chr17	61689302	61889302	harbor1	chr17	61720469	61720775	DNA/TcMar-Tigger	1629	+	153	61720622	31320
chr17	68842126	69042126	harbor1	chr17	68857598	68859962	DNA/TcMar-Tigger	14106	+	1182	68858780	16654
chr17	68842126	69042126	harbor1	chr17	68871636	68872024	DNA/TcMar-Tigger	6450	+	194	68871830	29704
chr17	68842126	69042126	harbor1	chr17	68872588	68873436	DNA/TcMar-Tigger	6450	+	424	68873012	30886
chr17	68842126	69042126	harbor1	chr17	68896368	68897091	DNA/TcMar-Tigger	4084	+	362	68896730	54604
chr17	48588965	48788965	harbor1	chr17	48669850	48669926	DNA/TcMar-Tigger	1753	+	38	48669888	80923
chr17	48588965	48788965	harbor1	chr17	48670222	48670493	DNA/TcMar-Tigger	1753	+	136	48670358	81393
chr17	48588965	48788965	harbor1	chr17	48684432	48684712	DNA/TcMar-Tigger	913	+	140	48684572	95607
chr17	41546946	41746946	harbor1	chr17	41561564	41561933	DNA/TcMar-Tigger	2592	+	184	41561748	14802
chr17	41546946	41746946	harbor1	chr17	41562230	41562572	DNA/TcMar-Tigger	2592	+	171	41562401	15455
chr17	46051927	46251927	harbor1	chr17	46090691	46091784	DNA/TcMar-Tigger	5704	+	546	46091237	39310
chr17	46051927	46251927	harbor1	chr17	46092135	46092231	DNA/TcMar-Tigger	5704	+	48	46092183	40256
chr17	46051927	46251927	harbor1	chr17	46122582	46123098	DNA/TcMar-Tigger	9882	+	258	46122840	70913
chr17	46051927	46251927	harbor1	chr17	46123392	46124117	DNA/TcMar-Tigger	9882	+	362	46123754	71827
chr17	46051927	46251927	harbor1	chr17	46124250	46125479	DNA/TcMar-Tigger	9882	+	614	46124864	72937
chr17	46051927	46251927	harbor1	chr17	46138127	46138262	DNA/TcMar-Tigger	627	+	68	46138195	86268
chr17	46051927	46251927	harbor1	chr17	46138273	46138575	DNA/TcMar-Tigger	1558	+	151	46138424	86497
chr17	45782149	45982149	harbor1	chr17	45802363	45802681	DNA/TcMar-Tigger	771	+	159	45802522	20373
chr17	45782149	45982149	harbor1	chr17	45802703	45802901	DNA/TcMar-Tigger	584	+	99	45802802	20653
chr17	45782149	45982149	harbor1	chr17	45842083	45842561	DNA/TcMar-Tigger	1351	+	239	45842322	60173
chr17	69439185	69639185	harbor1	chr17	69472344	69472699	DNA/TcMar-Tigger	3269	+	178	69472522	33337
chr17	69439185	69639185	harbor1	chr17	69473007	69473237	DNA/TcMar-Tigger	3269	+	115	69473122	33937
chr17	69439185	69639185	harbor1	chr17	69479269	69479587	DNA/TcMar-Tigger	1711	+	159	69479428	40243
chr17	39271552	39471552	harbor1	chr17	39349608	39349654	DNA/TcMar-Tigger	522	+	23	39349631	78079
chr17	39271552	39471552	harbor1	chr17	39349952	39350007	DNA/TcMar-Tigger	522	+	28	39349980	78428
chr17	39271552	39471552	harbor1	chr17	39353302	39353594	DNA/TcMar-Tigger	1533	+	146	39353448	81896
chr17	36094304	36294304	harbor1	chr17	36109126	36109210	DNA/TcMar-Tigger	1138	+	42	36109168	14864
chr17	36094304	36294304	harbor1	chr17	36109495	36109746	DNA/TcMar-Tigger	1138	+	126	36109621	15317
chr17	36094304	36294304	harbor1	chr17	36128831	36130901	DNA/TcMar-Tigger	15154	+	1035	36129866	35562
chr17	36094304	36294304	harbor1	chr17	36131210	36131551	DNA/TcMar-Tigger	15154	+	170	36131380	37076
chr17	36094304	36294304	harbor1	chr17	36177412	36177748	DNA/TcMar-Tigger	1666	+	168	36177580	83276
chr17	52760920	52960920	harbor1	chr17	52792076	52792207	DNA/TcMar-Tigger	724	+	66	52792142	31222
chr17	52760920	52960920	harbor1	chr17	52792202	52792298	DNA/TcMar-Tigger	531	+	48	52792250	31330
chr17	52760920	52960920	harbor1	chr17	52847524	52847832	DNA/TcMar-Tigger	1513	+	154	52847678	86758
chr17	52760920	52960920	harbor1	chr17	52857361	52857625	DNA/TcMar-Tigger	702	+	132	52857493	96573
chr17	70747224	70947224	harbor1	chr17	70836353	70836781	DNA/TcMar-Tigger	2571	+	214	70836567	89343
chr17	76113394	76313394	harbor1	chr17	76164877	76165196	DNA/TcMar-Tigger	1834	+	160	76165037	51643
chr17	75866579	76066579	harbor1	chr17	75869250	75869495	DNA/TcMar-Tigger	1181	+	122	75869372	2793
chr17	57085617	57285617	harbor1	chr17	57178745	57179096	DNA/TcMar-Tigger	1241	+	176	57178921	93304
chr17	31089625	31289625	harbor1	chr17	31136388	31136926	DNA/TcMar-Tigger	3341	+	269	31136657	47032
chr17	31089625	31289625	harbor1	chr17	31151065	31151365	DNA/TcMar-Tigger	1444	+	150	31151215	61590
chr17	48814031	49014031	harbor1	chr17	48896085	48896424	DNA/TcMar-Tigger	2223	+	170	48896255	82224
chr17	59677740	59877740	harbor1	chr17	59702737	59703032	DNA/TcMar-Tigger	1685	+	148	59702885	25145
chr17	59677740	59877740	harbor1	chr17	59703324	59703396	DNA/TcMar-Tigger	1685	+	36	59703360	25620
chr17	29912854	30112854	harbor1	chr17	29950050	29950260	DNA/TcMar-Tigger	2311	+	105	29950155	37301
chr17	29912854	30112854	harbor1	chr17	29950346	29950389	DNA/TcMar-Tigger	2311	+	22	29950368	37514
chr17	29912854	30112854	harbor1	chr17	29950674	29950911	DNA/TcMar-Tigger	2311	+	118	29950792	37938
chr17	65644230	65844230	harbor1	chr17	65700815	65700941	DNA/TcMar-Tigger	481	+	63	65700878	56648
chr17	65644230	65844230	harbor1	chr17	65702409	65702644	DNA/TcMar-Tigger	1577	+	118	65702527	58297
chr17	65644230	65844230	harbor1	chr17	65703008	65703118	DNA/TcMar-Tigger	1577	+	55	65703063	58833
chr17	65644230	65844230	harbor1	chr17	65733854	65734071	DNA/TcMar-Tigger	602	+	108	65733962	89732
chr17	4311366	4511366	harbor1	chr17	4347320	4347462	DNA/TcMar-Tigger	2508	+	71	4347391	36025
chr17	4311366	4511366	harbor1	chr17	4347776	4348082	DNA/TcMar-Tigger	2508	+	153	4347929	36563
chr17	4311366	4511366	harbor1	chr17	4357054	4357469	DNA/TcMar-Tigger	1357	+	208	4357262	45896
chr17	12561571	12761571	harbor1	chr17	12618564	12618914	DNA/TcMar-Tigger	2244	+	175	12618739	57168
chr17	60332500	60532500	harbor1	chr17	60358089	60358291	DNA/TcMar-Tigger	628	+	101	60358190	25690
chr17	60332500	60532500	harbor1	chr17	60367157	60367226	DNA/TcMar-Tigger	1627	+	34	60367191	34691
chr17	60332500	60532500	harbor1	chr17	60367821	60368100	DNA/TcMar-Tigger	1627	+	140	60367961	35461
chr17	60332500	60532500	harbor1	chr17	60375202	60375385	DNA/TcMar-Tigger	939	+	92	60375294	42794
chr17	51463380	51663380	harbor1	chr17	51532275	51532545	DNA/TcMar-Tigger	504	+	135	51532410	69030
chr17	83003262	83203262	harbor1	chr17	83061352	83061632	DNA/TcMar-Tigger	1392	+	140	83061492	58230
chr17	28224012	28424012	harbor1	chr17	28261312	28261491	DNA/TcMar-Tigger	945	+	90	28261402	37390
chr17	2470299	2670299	harbor1	chr17	2494384	2494551	DNA/TcMar-Tigger	882	+	84	2494468	24169
chr17	2470299	2670299	harbor1	chr17	2494942	2495067	DNA/TcMar-Tigger	1501	+	62	2495004	24705
chr17	2470299	2670299	harbor1	chr17	2495353	2495414	DNA/TcMar-Tigger	1501	+	30	2495383	25084
chr17	2470299	2670299	harbor1	chr17	2495718	2495823	DNA/TcMar-Tigger	1501	+	52	2495770	25471
chr17	2470299	2670299	harbor1	chr17	2534920	2535030	DNA/TcMar-Tigger	980	+	55	2534975	64676
chr17	2470299	2670299	harbor1	chr17	2535625	2535696	DNA/TcMar-Tigger	980	+	36	2535661	65362
chr17	2470299	2670299	harbor1	chr17	2538465	2538701	DNA/TcMar-Tigger	1509	+	118	2538583	68284
chr17	47565416	47765416	harbor1	chr17	47592684	47592756	DNA/TcMar-Tigger	1353	+	36	47592720	27304
chr17	47565416	47765416	harbor1	chr17	47592984	47593175	DNA/TcMar-Tigger	1353	+	96	47593080	27664
chr17	80770485	80970485	harbor1	chr17	80793117	80793318	DNA/TcMar-Tigger	1082	+	100	80793217	22732
chr17	80770485	80970485	harbor1	chr17	80835537	80835854	DNA/TcMar-Tigger	1747	+	158	80835695	65210
chr17	79997673	80197673	harbor1	chr17	80071547	80071831	DNA/TcMar-Tigger	1624	+	142	80071689	74016
chr17	79997673	80197673	harbor1	chr17	80072136	80072218	DNA/TcMar-Tigger	1624	+	41	80072177	74504
chr17	79997673	80197673	harbor1	chr17	80072932	80072984	DNA/TcMar-Tigger	3481	+	26	80072958	75285
chr17	79997673	80197673	harbor1	chr17	80073282	80073693	DNA/TcMar-Tigger	3481	+	206	80073488	75815
chr17	79997673	80197673	harbor1	chr17	80073986	80074224	DNA/TcMar-Tigger	3481	+	119	80074105	76432
chr17	79997673	80197673	harbor1	chr17	80074637	80074926	DNA/TcMar-Tigger	1628	+	144	80074781	77108
chr17	79997673	80197673	harbor1	chr17	80075831	80076293	DNA/TcMar-Tigger	3664	+	231	80076062	78389
chr17	79997673	80197673	harbor1	chr17	80076597	80076742	DNA/TcMar-Tigger	3664	+	72	80076669	78996
chr17	79997673	80197673	harbor1	chr17	80077036	80077205	DNA/TcMar-Tigger	3664	+	84	80077120	79447
chr17	34883363	35083363	harbor1	chr17	34904161	34904553	DNA/TcMar-Tigger	1843	+	196	34904357	20994
chr17	9659677	9859677	harbor1	chr17	9717458	9717801	DNA/TcMar-Tigger	2517	+	172	9717630	57953
chr17	9659677	9859677	harbor1	chr17	9718096	9718308	DNA/TcMar-Tigger	2517	+	106	9718202	58525
chr18	12920129	13120129	harbor1	chr18	12951020	12951304	DNA/TcMar-Tigger	1073	+	142	12951162	31033
chr18	12920129	13120129	harbor1	chr18	12959484	12959643	DNA/TcMar-Tigger	473	+	80	12959564	39435
chr18	12920129	13120129	harbor1	chr18	13006307	13006512	DNA/TcMar-Tigger	1052	+	102	13006409	86280
chr18	12920129	13120129	harbor1	chr18	13009447	13009550	DNA/TcMar-Tigger	476	+	52	13009499	89370
chr18	12920129	13120129	harbor1	chr18	13009844	13009888	DNA/TcMar-Tigger	476	+	22	13009866	89737
chr18	12920129	13120129	harbor1	chr18	13010166	13010428	DNA/TcMar-Tigger	476	+	131	13010297	90168
chr18	29311900	29511900	harbor1	chr18	29392646	29393157	DNA/TcMar-Tigger	496	+	256	29392902	81002
chr18	38869184	39069184	harbor1	chr18	38876343	38876565	DNA/TcMar-Tigger	544	+	111	38876454	7270
chr18	38869184	39069184	harbor1	chr18	38945636	38946934	DNA/TcMar-Tigger	6524	+	649	38946285	77101
chr18	38869184	39069184	harbor1	chr18	38946932	38947443	DNA/TcMar-Tigger	2788	+	256	38947188	78004
chr18	38869184	39069184	harbor1	chr18	38952016	38952277	DNA/TcMar-Tigger	553	+	130	38952146	82962
chr18	68229855	68429855	harbor1	chr18	68229734	68230162	DNA/TcMar-Tigger	2496	+	214	68229948	93
chr18	68229855	68429855	harbor1	chr18	68299473	68299662	DNA/TcMar-Tigger	1139	+	94	68299567	69712
chr18	68229855	68429855	harbor1	chr18	68314431	68314949	DNA/TcMar-Tigger	1840	+	259	68314690	84835
chr18	33053002	33253002	harbor1	chr18	33121797	33122130	DNA/TcMar-Tigger	1588	+	166	33121963	68961
chr18	33053002	33253002	harbor1	chr18	33133952	33134217	DNA/TcMar-Tigger	624	+	132	33134084	81082
chr18	78021010	78221010	harbor1	chr18	78048035	78048327	DNA/TcMar-Tigger	955	+	146	78048181	27171
chr18	78021010	78221010	harbor1	chr18	78048750	78048907	DNA/TcMar-Tigger	652	+	78	78048828	27818
chr18	78021010	78221010	harbor1	chr18	78099254	78099589	DNA/TcMar-Tigger	1580	+	168	78099422	78412
chr18	11266757	11466757	harbor1	chr18	11335929	11336222	DNA/TcMar-Tigger	1374	+	146	11336075	69318
chr18	74230086	74430086	harbor1	chr18	74240992	74241158	DNA/TcMar-Tigger	1017	+	83	74241075	10989
chr18	74230086	74430086	harbor1	chr18	74241464	74241854	DNA/TcMar-Tigger	1017	+	195	74241659	11573
chr18	74230086	74430086	harbor1	chr18	74270530	74270818	DNA/TcMar-Tigger	1529	+	144	74270674	40588
chr18	74230086	74430086	harbor1	chr18	74271772	74271964	DNA/TcMar-Tigger	506	+	96	74271868	41782
chr18	74230086	74430086	harbor1	chr18	74272528	74272565	DNA/TcMar-Tigger	506	+	18	74272546	42460
chr18	74230086	74430086	harbor1	chr18	74323705	74324584	DNA/TcMar-Tigger	5396	+	440	74324145	94059
chr18	65962324	66162324	harbor1	chr18	65983463	65983717	DNA/TcMar-Tigger	1343	+	127	65983590	21266
chr18	65962324	66162324	harbor1	chr18	65985096	65985413	DNA/TcMar-Tigger	1183	+	158	65985254	22930
chr18	38819398	39019398	harbor1	chr18	38876343	38876565	DNA/TcMar-Tigger	544	+	111	38876454	57056
chr18	32445372	32645372	harbor1	chr18	32519264	32519414	DNA/TcMar-Tigger	418	+	75	32519339	73967
chr18	27839434	28039434	harbor1	chr18	27839419	27840851	DNA/TcMar-Tigger	14392	+	716	27840135	701
chr18	27839434	28039434	harbor1	chr18	27841169	27842108	DNA/TcMar-Tigger	14392	+	470	27841639	2205
chr18	27839434	28039434	harbor1	chr18	27881312	27881607	DNA/TcMar-Tigger	1339	+	148	27881460	42026
chr18	27839434	28039434	harbor1	chr18	27881605	27882046	DNA/TcMar-Tigger	2218	+	220	27881825	42391
chr18	27839434	28039434	harbor1	chr18	27915475	27916735	DNA/TcMar-Tigger	6701	+	630	27916105	76671
chr18	5545803	5745803	harbor1	chr18	5587347	5587580	DNA/TcMar-Tigger	1544	+	116	5587463	41660
chr18	5545803	5745803	harbor1	chr18	5617982	5618178	DNA/TcMar-Tigger	500	+	98	5618080	72277
chr18	8952490	9152490	harbor1	chr18	8984700	8984832	DNA/TcMar-Tigger	1414	+	66	8984766	32276
chr18	8952490	9152490	harbor1	chr18	8985145	8985326	DNA/TcMar-Tigger	1414	+	90	8985235	32745
chr18	8952490	9152490	harbor1	chr18	9008381	9008704	DNA/TcMar-Tigger	1528	+	162	9008543	56053
chr18	39197398	39397398	harbor1	chr18	39286748	39287075	DNA/TcMar-Tigger	1895	+	164	39286912	89514
chr18	8917045	9117045	harbor1	chr18	8984700	8984832	DNA/TcMar-Tigger	1414	+	66	8984766	67721
chr18	8917045	9117045	harbor1	chr18	8985145	8985326	DNA/TcMar-Tigger	1414	+	90	8985235	68190
chr18	8917045	9117045	harbor1	chr18	9008381	9008704	DNA/TcMar-Tigger	1528	+	162	9008543	91498
chr18	26296030	26496030	harbor1	chr18	26343635	26343854	DNA/TcMar-Tigger	1296	+	110	26343745	47715
chr18	26296030	26496030	harbor1	chr18	26362793	26363126	DNA/TcMar-Tigger	1312	+	166	26362959	66929
chr18	43264325	43464325	harbor1	chr18	43308164	43308796	DNA/TcMar-Tigger	3219	+	316	43308480	44155
chr18	24111369	24311369	harbor1	chr18	24118955	24119085	DNA/TcMar-Tigger	443	+	65	24119020	7651
chr18	24111369	24311369	harbor1	chr18	24167495	24167799	DNA/TcMar-Tigger	1779	+	152	24167647	56278
chr18	24111369	24311369	harbor1	chr18	24174357	24174587	DNA/TcMar-Tigger	1401	+	115	24174472	63103
chr18	22524482	22724482	harbor1	chr18	22615507	22616927	DNA/TcMar-Tigger	8814	+	710	22616217	91735
chr18	22524482	22724482	harbor1	chr18	22622360	22623121	DNA/TcMar-Tigger	6376	+	380	22622740	98258
chr18	22524482	22724482	harbor1	chr18	22623569	22623767	DNA/TcMar-Tigger	6376	+	99	22623668	99186
chr18	70185300	70385300	harbor1	chr18	70186262	70186446	DNA/TcMar-Tigger	726	+	92	70186354	1054
chr18	70185300	70385300	harbor1	chr18	70217159	70217368	DNA/TcMar-Tigger	1022	+	104	70217263	31963
chr18	70185300	70385300	harbor1	chr18	70245208	70245516	DNA/TcMar-Tigger	1649	+	154	70245362	60062
chr18	70185300	70385300	harbor1	chr18	70284878	70285213	DNA/TcMar-Tigger	1752	+	168	70285046	99746
chr18	13469288	13669288	harbor1	chr18	13490227	13490473	DNA/TcMar-Tigger	1012	+	123	13490350	21062
chr18	13469288	13669288	harbor1	chr18	13506579	13506788	DNA/TcMar-Tigger	1570	+	104	13506683	37395
chr18	13469288	13669288	harbor1	chr18	13506941	13507175	DNA/TcMar-Tigger	15796	+	117	13507058	37770
chr18	13469288	13669288	harbor1	chr18	13507638	13509020	DNA/TcMar-Tigger	15796	+	691	13508329	39041
chr18	13469288	13669288	harbor1	chr18	13509331	13510124	DNA/TcMar-Tigger	15796	+	396	13509727	40439
chr18	62706206	62906206	harbor1	chr18	62731018	62731225	DNA/TcMar-Tigger	14608	+	104	62731122	24916
chr18	62706206	62906206	harbor1	chr18	62731333	62733529	DNA/TcMar-Tigger	14608	+	1098	62732431	26225
chr18	62706206	62906206	harbor1	chr18	62736681	62736860	DNA/TcMar-Tigger	492	+	90	62736771	30565
chr18	62706206	62906206	harbor1	chr18	62738062	62738139	DNA/TcMar-Tigger	480	+	38	62738100	31894
chr18	62706206	62906206	harbor1	chr18	62738407	62738622	DNA/TcMar-Tigger	1010	+	108	62738515	32309
chr19	13229049	13429049	harbor1	chr19	13260959	13261189	DNA/TcMar-Tigger	804	+	115	13261074	32025
chr19	28680532	28880532	harbor1	chr19	28712467	28713302	DNA/TcMar-Tigger	4309	+	418	28712885	32353
chr19	47633082	47833082	harbor1	chr19	47635957	47636212	DNA/TcMar-Tigger	1552	+	128	47636085	3003
chr19	47633082	47833082	harbor1	chr19	47654951	47655243	DNA/TcMar-Tigger	2625	+	146	47655097	22015
chr19	47633082	47833082	harbor1	chr19	47655549	47655570	DNA/TcMar-Tigger	2625	+	10	47655559	22477
chr19	47633082	47833082	harbor1	chr19	47655884	47655952	DNA/TcMar-Tigger	2625	+	34	47655918	22836
chr19	47633082	47833082	harbor1	chr19	47656267	47656587	DNA/TcMar-Tigger	2625	+	160	47656427	23345
chr19	47633082	47833082	harbor1	chr19	47668249	47668485	DNA/TcMar-Tigger	2979	+	118	47668367	35285
chr19	47633082	47833082	harbor1	chr19	47668790	47668837	DNA/TcMar-Tigger	2979	+	24	47668814	35732
chr19	47633082	47833082	harbor1	chr19	47669098	47669108	DNA/TcMar-Tigger	2979	+	5	47669103	36021
chr19	47633082	47833082	harbor1	chr19	47669138	47669473	DNA/TcMar-Tigger	2979	+	168	47669306	36224
chr19	32748745	32948745	harbor1	chr19	32748657	32748977	DNA/TcMar-Tigger	656	+	160	32748817	72
chr19	4597641	4797641	harbor1	chr19	4616094	4616163	DNA/TcMar-Tigger	873	+	34	4616128	18487
chr19	4597641	4797641	harbor1	chr19	4616276	4616465	DNA/TcMar-Tigger	873	+	94	4616370	18729
chr19	4597641	4797641	harbor1	chr19	4617379	4617413	DNA/TcMar-Tigger	873	+	17	4617396	19755
chr19	18939928	19139928	harbor1	chr19	18969258	18969286	DNA/TcMar-Tigger	2164	+	14	18969272	29344
chr19	18939928	19139928	harbor1	chr19	18969596	18970075	DNA/TcMar-Tigger	2164	+	240	18969836	29908
chr19	48798436	48998436	harbor1	chr19	48893933	48894036	DNA/TcMar-Tigger	1167	+	52	48893985	95549
chr19	48798436	48998436	harbor1	chr19	48894313	48894360	DNA/TcMar-Tigger	1167	+	24	48894337	95901
chr19	48798436	48998436	harbor1	chr19	48894659	48894847	DNA/TcMar-Tigger	1167	+	94	48894753	96317
chr19	33576001	33776001	harbor1	chr19	33587853	33589137	DNA/TcMar-Tigger	8780	+	642	33588495	12494
chr19	33576001	33776001	harbor1	chr19	33589701	33589879	DNA/TcMar-Tigger	1241	+	89	33589790	13789
chr19	33576001	33776001	harbor1	chr19	33590479	33591494	DNA/TcMar-Tigger	6663	+	508	33590987	14986
chr19	46550329	46750329	harbor1	chr19	46615228	46615434	DNA/TcMar-Tigger	1195	+	103	46615331	65002
chr19	42350617	42550617	harbor1	chr19	42361348	42361665	DNA/TcMar-Tigger	1006	+	158	42361506	10889
chr19	42350617	42550617	harbor1	chr19	42414584	42414949	DNA/TcMar-Tigger	8371	+	182	42414766	64149
chr19	42350617	42550617	harbor1	chr19	42415261	42415529	DNA/TcMar-Tigger	8371	+	134	42415395	64778
chr19	42350617	42550617	harbor1	chr19	42415826	42416060	DNA/TcMar-Tigger	8371	+	117	42415943	65326
chr19	42350617	42550617	harbor1	chr19	42416355	42416910	DNA/TcMar-Tigger	8371	+	278	42416633	66016
chr19	42350617	42550617	harbor1	chr19	42417220	42417243	DNA/TcMar-Tigger	8371	+	12	42417232	66615
chr19	42350617	42550617	harbor1	chr19	42417684	42417985	DNA/TcMar-Tigger	8371	+	150	42417834	67217
chr19	42350617	42550617	harbor1	chr19	42418283	42418830	DNA/TcMar-Tigger	8371	+	274	42418557	67940
chr19	37488524	37688524	harbor1	chr19	37546605	37547201	DNA/TcMar-Tigger	3304	+	298	37546903	58379
chr19	37488524	37688524	harbor1	chr19	37572250	37572524	DNA/TcMar-Tigger	1185	+	137	37572387	83863
chr19	29637375	29837375	harbor1	chr19	29701654	29701799	DNA/TcMar-Tigger	660	+	72	29701726	64351
chr19	29637375	29837375	harbor1	chr19	29701788	29701997	DNA/TcMar-Tigger	1082	+	104	29701892	64517
chr19	7986721	8186721	harbor1	chr19	8015425	8015629	DNA/TcMar-Tigger	1892	+	102	8015527	28806
chr19	7986721	8186721	harbor1	chr19	8015932	8016098	DNA/TcMar-Tigger	1892	+	83	8016015	29294
chr19	18048813	18248813	harbor1	chr19	18086277	18086406	DNA/TcMar-Tigger	780	+	64	18086341	37528
chr19	43346850	43546850	harbor1	chr19	43371834	43372177	DNA/TcMar-Tigger	1805	+	172	43372006	25156
chr19	9921042	10121042	harbor1	chr19	9924582	9924882	DNA/TcMar-Tigger	1589	+	150	9924732	3690
chr19	57212762	57412762	harbor1	chr19	57286094	57286511	DNA/TcMar-Tigger	2394	+	208	57286302	73540
chr19	32818777	33018777	harbor1	chr19	32907890	32908171	DNA/TcMar-Tigger	1732	+	140	32908030	89253
chr19	49003460	49203460	harbor1	chr19	49012540	49012756	DNA/TcMar-Tigger	1833	+	108	49012648	9188
chr19	49003460	49203460	harbor1	chr19	49013369	49013632	DNA/TcMar-Tigger	1833	+	132	49013501	10041
chr19	49003460	49203460	harbor1	chr19	49013939	49014122	DNA/TcMar-Tigger	1833	+	92	49014031	10571
chr19	49003460	49203460	harbor1	chr19	49091009	49091090	DNA/TcMar-Tigger	1071	+	40	49091049	87589
chr19	49003460	49203460	harbor1	chr19	49091387	49091619	DNA/TcMar-Tigger	1071	+	116	49091503	88043
chr19	14847645	15047645	harbor1	chr19	14930011	14930212	DNA/TcMar-Tigger	1302	+	100	14930111	82466
chr19	14847645	15047645	harbor1	chr19	14947404	14947490	DNA/TcMar-Tigger	2953	+	43	14947447	99802
chr19	43816361	44016361	harbor1	chr19	43862930	43863544	DNA/TcMar-Tigger	4581	+	307	43863237	46876
chr19	43816361	44016361	harbor1	chr19	43863806	43864018	DNA/TcMar-Tigger	4581	+	106	43863912	47551
chr19	41185565	41385565	harbor1	chr19	41282625	41282677	DNA/TcMar-Tigger	5928	+	26	41282651	97086
chr19	41185565	41385565	harbor1	chr19	41282994	41283278	DNA/TcMar-Tigger	5928	+	142	41283136	97571
chr19	41185565	41385565	harbor1	chr19	41283893	41284383	DNA/TcMar-Tigger	5928	+	245	41284138	98573
chr19	41185565	41385565	harbor1	chr19	41284670	41284716	DNA/TcMar-Tigger	5928	+	23	41284693	99128
chr19	41185565	41385565	harbor1	chr19	41285014	41285274	DNA/TcMar-Tigger	5928	+	130	41285144	99579
chr19	13329899	13529899	harbor1	chr19	13374971	13375505	DNA/TcMar-Tigger	8255	+	267	13375238	45339
chr19	13329899	13529899	harbor1	chr19	13375815	13376544	DNA/TcMar-Tigger	8255	+	364	13376179	46280
chr19	13329899	13529899	harbor1	chr19	13377264	13377373	DNA/TcMar-Tigger	1754	+	54	13377318	47419
chr19	13329899	13529899	harbor1	chr19	13377663	13377847	DNA/TcMar-Tigger	1754	+	92	13377755	47856
chr19	13329899	13529899	harbor1	chr19	13378004	13378645	DNA/TcMar-Tigger	5162	+	320	13378324	48425
chr19	13329899	13529899	harbor1	chr19	13379275	13379467	DNA/TcMar-Tigger	5162	+	96	13379371	49472
chr19	13329899	13529899	harbor1	chr19	13418772	13418890	DNA/TcMar-Tigger	1762	+	59	13418831	88932
chr19	13329899	13529899	harbor1	chr19	13419170	13419391	DNA/TcMar-Tigger	1762	+	110	13419280	89381
chr19	6593652	6793652	harbor1	chr19	6631919	6632149	DNA/TcMar-Tigger	1345	+	115	6632034	38382
chr19	6593652	6793652	harbor1	chr19	6682553	6683438	DNA/TcMar-Tigger	4502	+	442	6682995	89343
chr19	6593652	6793652	harbor1	chr19	6683751	6683812	DNA/TcMar-Tigger	4502	+	30	6683781	90129
chr19	6593652	6793652	harbor1	chr19	6684120	6684240	DNA/TcMar-Tigger	4502	+	60	6684180	90528
chr19	53541112	53741112	harbor1	chr19	53551606	53551928	DNA/TcMar-Tigger	1268	+	161	53551767	10655
chr19	53541112	53741112	harbor1	chr19	53577968	53578694	DNA/TcMar-Tigger	2966	+	363	53578331	37219
chr19	27904266	28104266	harbor1	chr19	27922122	27922433	DNA/TcMar-Tigger	1030	+	156	27922278	18012
chr19	45777478	45977478	harbor1	chr19	45833741	45833875	DNA/TcMar-Tigger	1414	+	67	45833808	56330
chr19	45777478	45977478	harbor1	chr19	45834484	45834671	DNA/TcMar-Tigger	1414	+	94	45834578	57100
chr19	56634216	56834216	harbor1	chr19	56700483	56700613	DNA/TcMar-Tigger	982	+	65	56700548	66332
chr19	56634216	56834216	harbor1	chr19	56700916	56700987	DNA/TcMar-Tigger	982	+	36	56700952	66736
chr19	56634216	56834216	harbor1	chr19	56700979	56701195	DNA/TcMar-Tigger	1837	+	108	56701087	66871
chr19	56634216	56834216	harbor1	chr19	56701486	56701601	DNA/TcMar-Tigger	1837	+	58	56701544	67328
chr19	34785756	34985756	harbor1	chr19	34787899	34788236	DNA/TcMar-Tigger	1984	+	168	34788067	2311
chr19	34785756	34985756	harbor1	chr19	34830747	34831077	DNA/TcMar-Tigger	1898	+	165	34830912	45156
chr19	7261748	7461748	harbor1	chr19	7296988	7297025	DNA/TcMar-Tigger	4567	+	18	7297006	35258
chr19	7261748	7461748	harbor1	chr19	7297287	7297448	DNA/TcMar-Tigger	4567	+	80	7297367	35619
chr19	7261748	7461748	harbor1	chr19	7297731	7298360	DNA/TcMar-Tigger	4567	+	314	7298045	36297
chr19	7261748	7461748	harbor1	chr19	7298548	7298600	DNA/TcMar-Tigger	1067	+	26	7298574	36826
chr19	7261748	7461748	harbor1	chr19	7298914	7299104	DNA/TcMar-Tigger	1067	+	95	7299009	37261
chr19	54651349	54851349	harbor1	chr19	54736985	54737208	DNA/TcMar-Tigger	1217	+	112	54737097	85748
chr19	54651349	54851349	harbor1	chr19	54737517	54737612	DNA/TcMar-Tigger	1217	+	48	54737565	86216
chr19	109669	309669	harbor1	chr19	122304	122396	DNA/TcMar-Tigger	1033	+	46	122350	12681
chr19	109669	309669	harbor1	chr19	122689	122823	DNA/TcMar-Tigger	1033	+	67	122756	13087
chr19	109669	309669	harbor1	chr19	122824	123283	DNA/TcMar-Tigger	2350	+	230	123054	13385
chr19	36954576	37154576	harbor1	chr19	37003044	37003217	DNA/TcMar-Tigger	789	+	86	37003130	48554
chr19	36954576	37154576	harbor1	chr19	37037798	37037914	DNA/TcMar-Tigger	776	+	58	37037856	83280
chr19	44666740	44866740	harbor1	chr19	44687632	44687893	DNA/TcMar-Tigger	1549	+	130	44687762	21022
chr19	47807980	48007980	harbor1	chr19	47811304	47811496	DNA/TcMar-Tigger	1030	+	96	47811400	3420
chr19	47807980	48007980	harbor1	chr19	47811796	47811845	DNA/TcMar-Tigger	1030	+	24	47811820	3840
chr19	36683880	36883880	harbor1	chr19	36746140	36746373	DNA/TcMar-Tigger	1196	+	116	36746256	62376
chr19	58290198	58490198	harbor1	chr19	58329614	58329871	DNA/TcMar-Tigger	1496	+	128	58329742	39544
chr19	12219877	12419877	harbor1	chr19	12271733	12271964	DNA/TcMar-Tigger	1027	+	116	12271849	51972
chr19	12219877	12419877	harbor1	chr19	12275141	12275366	DNA/TcMar-Tigger	1702	+	112	12275253	55376
chr19	12219877	12419877	harbor1	chr19	12275664	12275860	DNA/TcMar-Tigger	1702	+	98	12275762	55885
chr19	12219877	12419877	harbor1	chr19	12314363	12315393	DNA/TcMar-Tigger	1608	+	515	12314878	95001
chr19	12219877	12419877	harbor1	chr19	12316983	12317147	DNA/TcMar-Tigger	861	+	82	12317065	97188
chr19	49208529	49408529	harbor1	chr19	49269602	49270035	DNA/TcMar-Tigger	2428	+	216	49269818	61289
chr19	6610290	6810290	harbor1	chr19	6631919	6632149	DNA/TcMar-Tigger	1345	+	115	6632034	21744
chr19	6610290	6810290	harbor1	chr19	6682553	6683438	DNA/TcMar-Tigger	4502	+	442	6682995	72705
chr19	6610290	6810290	harbor1	chr19	6683751	6683812	DNA/TcMar-Tigger	4502	+	30	6683781	73491
chr19	6610290	6810290	harbor1	chr19	6684120	6684240	DNA/TcMar-Tigger	4502	+	60	6684180	73890
chr19	31597309	31797309	harbor1	chr19	31686661	31686994	DNA/TcMar-Tigger	1833	+	166	31686827	89518
chr19	18039067	18239067	harbor1	chr19	18086277	18086406	DNA/TcMar-Tigger	780	+	64	18086341	47274
chr19	14367157	14567157	harbor1	chr19	14438115	14438322	DNA/TcMar-Tigger	1177	+	104	14438219	71062
chr19	44798684	44998684	harbor1	chr19	44823565	44823696	DNA/TcMar-Tigger	698	+	66	44823631	24947
chr19	34470481	34670481	harbor1	chr19	34523103	34523439	DNA/TcMar-Tigger	1450	+	168	34523271	52790
chr19	14123185	14323185	harbor1	chr19	14124499	14124968	DNA/TcMar-Tigger	2968	+	234	14124733	1548
chr19	14123185	14323185	harbor1	chr19	14125257	14125442	DNA/TcMar-Tigger	2968	+	92	14125349	2164
chr19	14123185	14323185	harbor1	chr19	14173395	14173540	DNA/TcMar-Tigger	766	+	72	14173467	50282
chr19	57996467	58196467	harbor1	chr19	57997145	57997384	DNA/TcMar-Tigger	657	+	120	57997265	798
chr19	57996467	58196467	harbor1	chr19	58064320	58064599	DNA/TcMar-Tigger	2451	+	140	58064460	67993
chr19	57996467	58196467	harbor1	chr19	58064902	58065039	DNA/TcMar-Tigger	2451	+	68	58064970	68503
chr19	29691537	29891537	harbor1	chr19	29701654	29701799	DNA/TcMar-Tigger	660	+	72	29701726	10189
chr19	29691537	29891537	harbor1	chr19	29701788	29701997	DNA/TcMar-Tigger	1082	+	104	29701892	10355
chr19	57077720	57277720	harbor1	chr19	57105128	57105458	DNA/TcMar-Tigger	2684	+	165	57105293	27573
chr19	57077720	57277720	harbor1	chr19	57105796	57106047	DNA/TcMar-Tigger	2684	+	126	57105922	28202
chr19	57077720	57277720	harbor1	chr19	57146642	57146854	DNA/TcMar-Tigger	2168	+	106	57146748	69028
chr19	57077720	57277720	harbor1	chr19	57147161	57147318	DNA/TcMar-Tigger	2168	+	78	57147239	69519
chr19	57077720	57277720	harbor1	chr19	57147450	57147866	DNA/TcMar-Tigger	2454	+	208	57147658	69938
chr19	57077720	57277720	harbor1	chr19	57147998	57148133	DNA/TcMar-Tigger	779	+	68	57148066	70346
chr19	57077720	57277720	harbor1	chr19	57151977	57152382	DNA/TcMar-Tigger	2594	+	202	57152179	74459
chr19	57077720	57277720	harbor1	chr19	57152548	57152644	DNA/TcMar-Tigger	905	+	48	57152596	74876
chr19	57077720	57277720	harbor1	chr19	57153080	57153195	DNA/TcMar-Tigger	905	+	58	57153138	75418
chr19	43351328	43551328	harbor1	chr19	43371834	43372177	DNA/TcMar-Tigger	1805	+	172	43372006	20678
chr19	18041970	18241970	harbor1	chr19	18086277	18086406	DNA/TcMar-Tigger	780	+	64	18086341	44371
chr19	37610805	37810805	harbor1	chr19	37640036	37640380	DNA/TcMar-Tigger	663	+	172	37640208	29403
chr19	37610805	37810805	harbor1	chr19	37645941	37646164	DNA/TcMar-Tigger	1193	+	112	37646053	35248
chr19	37610805	37810805	harbor1	chr19	37683505	37683785	DNA/TcMar-Tigger	3296	+	140	37683645	72840
chr19	37610805	37810805	harbor1	chr19	37682933	37683204	DNA/TcMar-Tigger	3296	+	136	37683069	72264
chr19	38892955	39092955	harbor1	chr19	38970558	38970818	DNA/TcMar-Tigger	853	+	130	38970688	77733
chr19	38892955	39092955	harbor1	chr19	38971116	38971178	DNA/TcMar-Tigger	853	+	31	38971147	78192
chr19	13825237	14025237	harbor1	chr19	13910932	13911079	DNA/TcMar-Tigger	1136	+	74	13911006	85769
chr19	13825237	14025237	harbor1	chr19	13911233	13911352	DNA/TcMar-Tigger	1136	+	60	13911293	86056
chr19	37537304	37737304	harbor1	chr19	37546605	37547201	DNA/TcMar-Tigger	3304	+	298	37546903	9599
chr19	37537304	37737304	harbor1	chr19	37572250	37572524	DNA/TcMar-Tigger	1185	+	137	37572387	35083
chr19	43932333	44132333	harbor1	chr19	44020574	44020800	DNA/TcMar-Tigger	1131	+	113	44020687	88354
chr19	13606051	13806051	harbor1	chr19	13699778	13699908	DNA/TcMar-Tigger	730	+	65	13699843	93792
chr19	36433990	36633990	harbor1	chr19	36512920	36513251	DNA/TcMar-Tigger	1871	+	166	36513086	79096
chr19	43368148	43568148	harbor1	chr19	43371834	43372177	DNA/TcMar-Tigger	1805	+	172	43372006	3858
chr19	34018656	34218656	harbor1	chr19	34024761	34024926	DNA/TcMar-Tigger	1178	+	82	34024843	6187
chr19	34018656	34218656	harbor1	chr19	34073952	34074251	DNA/TcMar-Tigger	1578	+	150	34074102	55446
chr19	34018656	34218656	harbor1	chr19	34075536	34075699	DNA/TcMar-Tigger	3393	+	82	34075618	56962
chr19	34018656	34218656	harbor1	chr19	34076457	34076839	DNA/TcMar-Tigger	3393	+	191	34076648	57992
chr19	34018656	34218656	harbor1	chr19	34092076	34092466	DNA/TcMar-Tigger	2450	+	195	34092271	73615
chr19	34018656	34218656	harbor1	chr19	34099316	34101175	DNA/TcMar-Tigger	12048	+	930	34100246	81590
chr19	34018656	34218656	harbor1	chr19	34101492	34101526	DNA/TcMar-Tigger	12048	+	17	34101509	82853
chr19	34018656	34218656	harbor1	chr19	34101825	34102208	DNA/TcMar-Tigger	12048	+	192	34102017	83361
chr19	34018656	34218656	harbor1	chr19	34102505	34102768	DNA/TcMar-Tigger	4570	+	132	34102637	83981
chr19	44787958	44987958	harbor1	chr19	44823565	44823696	DNA/TcMar-Tigger	698	+	66	44823631	35673
chr19	7288126	7488126	harbor1	chr19	7296988	7297025	DNA/TcMar-Tigger	4567	+	18	7297006	8880
chr19	7288126	7488126	harbor1	chr19	7297287	7297448	DNA/TcMar-Tigger	4567	+	80	7297367	9241
chr19	7288126	7488126	harbor1	chr19	7297731	7298360	DNA/TcMar-Tigger	4567	+	314	7298045	9919
chr19	7288126	7488126	harbor1	chr19	7298548	7298600	DNA/TcMar-Tigger	1067	+	26	7298574	10448
chr19	7288126	7488126	harbor1	chr19	7298914	7299104	DNA/TcMar-Tigger	1067	+	95	7299009	10883
chr19	14378182	14578182	harbor1	chr19	14438115	14438322	DNA/TcMar-Tigger	1177	+	104	14438219	60037
chr19	34537840	34737840	harbor1	chr19	34606586	34606925	DNA/TcMar-Tigger	1595	+	170	34606756	68916
chr19	16284182	16484182	harbor1	chr19	16351951	16352004	DNA/TcMar-Tigger	1065	+	26	16351977	67795
chr19	16284182	16484182	harbor1	chr19	16352301	16352451	DNA/TcMar-Tigger	1065	+	75	16352376	68194
chr19	12353663	12553663	harbor1	chr19	12354739	12354951	DNA/TcMar-Tigger	911	+	106	12354845	1182
chr19	12353663	12553663	harbor1	chr19	12377156	12377276	DNA/TcMar-Tigger	1447	+	60	12377216	23553
chr19	12353663	12553663	harbor1	chr19	12377545	12377956	DNA/TcMar-Tigger	1447	+	206	12377751	24088
chr19	12353663	12553663	harbor1	chr19	12378088	12378702	DNA/TcMar-Tigger	1447	+	307	12378395	24732
chr19	12353663	12553663	harbor1	chr19	12379113	12379361	DNA/TcMar-Tigger	1089	+	124	12379237	25574
chr19	12353663	12553663	harbor1	chr19	12382728	12382938	DNA/TcMar-Tigger	1699	+	105	12382833	29170
chr19	12353663	12553663	harbor1	chr19	12383256	12383464	DNA/TcMar-Tigger	1699	+	104	12383360	29697
chr19	12353663	12553663	harbor1	chr19	12388587	12389558	DNA/TcMar-Tigger	1221	+	486	12389073	35410
chr19	12353663	12553663	harbor1	chr19	12390083	12390322	DNA/TcMar-Tigger	1184	+	120	12390203	36540
chr19	12353663	12553663	harbor1	chr19	12392774	12393199	DNA/TcMar-Tigger	1727	+	212	12392986	39323
chr19	12353663	12553663	harbor1	chr19	12428123	12429054	DNA/TcMar-Tigger	1116	+	466	12428589	74926
chr19	12353663	12553663	harbor1	chr19	12429773	12430012	DNA/TcMar-Tigger	1152	+	120	12429893	76230
chr19	12353663	12553663	harbor1	chr19	12432548	12432973	DNA/TcMar-Tigger	1724	+	212	12432760	79097
chr19	57637711	57837711	harbor1	chr19	57677182	57677564	DNA/TcMar-Tigger	1555	+	191	57677373	39662
chr19	57637711	57837711	harbor1	chr19	57677543	57677771	DNA/TcMar-Tigger	1038	+	114	57677657	39946
chr19	919167	1119167	harbor1	chr19	958547	958622	DNA/TcMar-Tigger	843	+	38	958585	39418
chr19	919167	1119167	harbor1	chr19	958903	959139	DNA/TcMar-Tigger	843	+	118	959021	39854
chr19	16466261	16666261	harbor1	chr19	16489878	16490114	DNA/TcMar-Tigger	1330	+	118	16489996	23735
chr19	28061962	28261962	harbor1	chr19	28083098	28083354	DNA/TcMar-Tigger	998	+	128	28083226	21264
chr19	28061962	28261962	harbor1	chr19	28084215	28084310	DNA/TcMar-Tigger	998	+	48	28084263	22301
chr19	57094178	57294178	harbor1	chr19	57105128	57105458	DNA/TcMar-Tigger	2684	+	165	57105293	11115
chr19	57094178	57294178	harbor1	chr19	57105796	57106047	DNA/TcMar-Tigger	2684	+	126	57105922	11744
chr19	57094178	57294178	harbor1	chr19	57146642	57146854	DNA/TcMar-Tigger	2168	+	106	57146748	52570
chr19	57094178	57294178	harbor1	chr19	57147161	57147318	DNA/TcMar-Tigger	2168	+	78	57147239	53061
chr19	57094178	57294178	harbor1	chr19	57147450	57147866	DNA/TcMar-Tigger	2454	+	208	57147658	53480
chr19	57094178	57294178	harbor1	chr19	57147998	57148133	DNA/TcMar-Tigger	779	+	68	57148066	53888
chr19	57094178	57294178	harbor1	chr19	57151977	57152382	DNA/TcMar-Tigger	2594	+	202	57152179	58001
chr19	57094178	57294178	harbor1	chr19	57152548	57152644	DNA/TcMar-Tigger	905	+	48	57152596	58418
chr19	57094178	57294178	harbor1	chr19	57153080	57153195	DNA/TcMar-Tigger	905	+	58	57153138	58960
chr19	55504323	55704323	harbor1	chr19	55552663	55552846	DNA/TcMar-Tigger	694	+	92	55552755	48432
chr19	55504323	55704323	harbor1	chr19	55553322	55553594	DNA/TcMar-Tigger	1232	+	136	55553458	49135
chr19	41614482	41814482	harbor1	chr19	41689568	41690004	DNA/TcMar-Tigger	2119	+	218	41689786	75304
chr19	41614482	41814482	harbor1	chr19	41712924	41713024	DNA/TcMar-Tigger	1160	+	50	41712974	98492
chr19	41614482	41814482	harbor1	chr19	41713332	41713488	DNA/TcMar-Tigger	1160	+	78	41713410	98928
chr19	12353459	12553459	harbor1	chr19	12354739	12354951	DNA/TcMar-Tigger	911	+	106	12354845	1386
chr19	12353459	12553459	harbor1	chr19	12377156	12377276	DNA/TcMar-Tigger	1447	+	60	12377216	23757
chr19	12353459	12553459	harbor1	chr19	12377545	12377956	DNA/TcMar-Tigger	1447	+	206	12377751	24292
chr19	12353459	12553459	harbor1	chr19	12378088	12378702	DNA/TcMar-Tigger	1447	+	307	12378395	24936
chr19	12353459	12553459	harbor1	chr19	12379113	12379361	DNA/TcMar-Tigger	1089	+	124	12379237	25778
chr19	12353459	12553459	harbor1	chr19	12382728	12382938	DNA/TcMar-Tigger	1699	+	105	12382833	29374
chr19	12353459	12553459	harbor1	chr19	12383256	12383464	DNA/TcMar-Tigger	1699	+	104	12383360	29901
chr19	12353459	12553459	harbor1	chr19	12388587	12389558	DNA/TcMar-Tigger	1221	+	486	12389073	35614
chr19	12353459	12553459	harbor1	chr19	12390083	12390322	DNA/TcMar-Tigger	1184	+	120	12390203	36744
chr19	12353459	12553459	harbor1	chr19	12392774	12393199	DNA/TcMar-Tigger	1727	+	212	12392986	39527
chr19	12353459	12553459	harbor1	chr19	12428123	12429054	DNA/TcMar-Tigger	1116	+	466	12428589	75130
chr19	12353459	12553459	harbor1	chr19	12429773	12430012	DNA/TcMar-Tigger	1152	+	120	12429893	76434
chr19	12353459	12553459	harbor1	chr19	12432548	12432973	DNA/TcMar-Tigger	1724	+	212	12432760	79301
chr19	12262919	12462919	harbor1	chr19	12271733	12271964	DNA/TcMar-Tigger	1027	+	116	12271849	8930
chr19	12262919	12462919	harbor1	chr19	12275141	12275366	DNA/TcMar-Tigger	1702	+	112	12275253	12334
chr19	12262919	12462919	harbor1	chr19	12275664	12275860	DNA/TcMar-Tigger	1702	+	98	12275762	12843
chr19	12262919	12462919	harbor1	chr19	12314363	12315393	DNA/TcMar-Tigger	1608	+	515	12314878	51959
chr19	12262919	12462919	harbor1	chr19	12316983	12317147	DNA/TcMar-Tigger	861	+	82	12317065	54146
chr19	12262919	12462919	harbor1	chr19	12321748	12322039	DNA/TcMar-Tigger	1630	+	146	12321894	58975
chr19	12262919	12462919	harbor1	chr19	12322354	12322484	DNA/TcMar-Tigger	1630	+	65	12322419	59500
chr19	12262919	12462919	harbor1	chr19	12352177	12352222	DNA/TcMar-Tigger	1889	+	22	12352199	89280
chr19	12262919	12462919	harbor1	chr19	12352505	12352891	DNA/TcMar-Tigger	1889	+	193	12352698	89779
chr19	12262919	12462919	harbor1	chr19	12354739	12354951	DNA/TcMar-Tigger	911	+	106	12354845	91926
chr19	14354986	14554986	harbor1	chr19	14438115	14438322	DNA/TcMar-Tigger	1177	+	104	14438219	83233
chr19	9176991	9376991	harbor1	chr19	9192772	9192976	DNA/TcMar-Tigger	987	+	102	9192874	15883
chr19	9176991	9376991	harbor1	chr19	9206544	9206746	DNA/TcMar-Tigger	983	+	101	9206645	29654
chr19	9176991	9376991	harbor1	chr19	9252335	9252537	DNA/TcMar-Tigger	772	+	101	9252436	75445
chr19	9176991	9376991	harbor1	chr19	9270288	9270413	DNA/TcMar-Tigger	2703	+	62	9270350	93359
chr19	9176991	9376991	harbor1	chr19	9271544	9271758	DNA/TcMar-Tigger	2703	+	107	9271651	94660
chr19	9176991	9376991	harbor1	chr19	9272158	9272380	DNA/TcMar-Tigger	2703	+	111	9272269	95278
chr19	9176991	9376991	harbor1	chr19	9272531	9273094	DNA/TcMar-Tigger	3079	+	282	9272813	95822
chr19	14235230	14435230	harbor1	chr19	14306041	14306349	DNA/TcMar-Tigger	1818	+	154	14306195	70965
chr19	34610698	34810698	harbor1	chr19	34708367	34708724	DNA/TcMar-Tigger	1599	+	178	34708545	97847
chr19	32092140	32292140	harbor1	chr19	32098428	32098874	DNA/TcMar-Tigger	2253	+	223	32098651	6511
chr19	44308673	44508673	harbor1	chr19	44330105	44330332	DNA/TcMar-Tigger	1397	+	114	44330219	21546
chr19	44308673	44508673	harbor1	chr19	44364593	44364881	DNA/TcMar-Tigger	868	+	144	44364737	56064
chr19	24149632	24349632	harbor1	chr19	24171958	24172114	DNA/TcMar-Tigger	788	+	78	24172036	22404
chr19	24149632	24349632	harbor1	chr19	24172419	24172704	DNA/TcMar-Tigger	788	+	142	24172561	22929
chr19	32463962	32663962	harbor1	chr19	32484717	32485155	DNA/TcMar-Tigger	1194	+	219	32484936	20974
chr19	32463962	32663962	harbor1	chr19	32527501	32528036	DNA/TcMar-Tigger	2867	+	268	32527769	63807
chr19	32463962	32663962	harbor1	chr19	32546462	32546521	DNA/TcMar-Tigger	1815	+	30	32546492	82530
chr19	32463962	32663962	harbor1	chr19	32546843	32547135	DNA/TcMar-Tigger	1815	+	146	32546989	83027
chr19	47087876	47287876	harbor1	chr19	47163289	47163445	DNA/TcMar-Tigger	1081	+	78	47163367	75491
chr19	47087876	47287876	harbor1	chr19	47163748	47163791	DNA/TcMar-Tigger	1081	+	22	47163770	75894
chr19	47087876	47287876	harbor1	chr19	47185248	47185295	DNA/TcMar-Tigger	881	+	24	47185272	97396
chr19	47087876	47287876	harbor1	chr19	47186270	47186406	DNA/TcMar-Tigger	881	+	68	47186338	98462
chr19	47087876	47287876	harbor1	chr19	47185902	47185959	DNA/TcMar-Tigger	881	+	28	47185930	98054
chr19	37681819	37881819	harbor1	chr19	37683505	37683785	DNA/TcMar-Tigger	3296	+	140	37683645	1826
chr19	37681819	37881819	harbor1	chr19	37682933	37683204	DNA/TcMar-Tigger	3296	+	136	37683069	1250
chr19	16396516	16596516	harbor1	chr19	16431871	16432102	DNA/TcMar-Tigger	1116	+	116	16431987	35471
chr19	16396516	16596516	harbor1	chr19	16489878	16490114	DNA/TcMar-Tigger	1330	+	118	16489996	93480
chr19	34655958	34855958	harbor1	chr19	34708367	34708724	DNA/TcMar-Tigger	1599	+	178	34708545	52587
chr19	34655958	34855958	harbor1	chr19	34755526	34755743	DNA/TcMar-Tigger	825	+	108	34755634	99676
chr19	16230796	16430796	harbor1	chr19	16230698	16230818	DNA/TcMar-Tigger	1051	+	60	16230758	38
chr19	16230796	16430796	harbor1	chr19	16239925	16240241	DNA/TcMar-Tigger	1732	+	158	16240083	9287
chr19	23918914	24118914	harbor1	chr19	23967958	23968403	DNA/TcMar-Tigger	1339	+	222	23968180	49266
chr19	12185509	12385509	harbor1	chr19	12271733	12271964	DNA/TcMar-Tigger	1027	+	116	12271849	86340
chr19	12185509	12385509	harbor1	chr19	12275141	12275366	DNA/TcMar-Tigger	1702	+	112	12275253	89744
chr19	12185509	12385509	harbor1	chr19	12275664	12275860	DNA/TcMar-Tigger	1702	+	98	12275762	90253
chr19	2380446	2580446	harbor1	chr19	2448868	2448890	DNA/TcMar-Tigger	800	+	11	2448879	68433
chr19	2380446	2580446	harbor1	chr19	2449197	2449432	DNA/TcMar-Tigger	800	+	118	2449315	68869
chr19	56679064	56879064	harbor1	chr19	56700483	56700613	DNA/TcMar-Tigger	982	+	65	56700548	21484
chr19	56679064	56879064	harbor1	chr19	56700916	56700987	DNA/TcMar-Tigger	982	+	36	56700952	21888
chr19	56679064	56879064	harbor1	chr19	56700979	56701195	DNA/TcMar-Tigger	1837	+	108	56701087	22023
chr19	56679064	56879064	harbor1	chr19	56701486	56701601	DNA/TcMar-Tigger	1837	+	58	56701544	22480
chr19	56679064	56879064	harbor1	chr19	56761416	56761843	DNA/TcMar-Tigger	1085	+	214	56761630	82566
chr19	40953641	41153641	harbor1	chr19	41040412	41040873	DNA/TcMar-Tigger	2697	+	230	41040642	87001
chr19	44197487	44397487	harbor1	chr19	44258678	44259488	DNA/TcMar-Tigger	4675	+	405	44259083	61596
chr19	17028593	17228593	harbor1	chr19	17032510	17032927	DNA/TcMar-Tigger	2337	+	208	17032718	4125
chr19	17028593	17228593	harbor1	chr19	17033244	17033452	DNA/TcMar-Tigger	2337	+	104	17033348	4755
chr19	17028593	17228593	harbor1	chr19	17034496	17034734	DNA/TcMar-Tigger	1296	+	119	17034615	6022
chr19	2410912	2610912	harbor1	chr19	2448868	2448890	DNA/TcMar-Tigger	800	+	11	2448879	37967
chr19	2410912	2610912	harbor1	chr19	2449197	2449432	DNA/TcMar-Tigger	800	+	118	2449315	38403
chr19	13853161	14053161	harbor1	chr19	13910932	13911079	DNA/TcMar-Tigger	1136	+	74	13911006	57845
chr19	13853161	14053161	harbor1	chr19	13911233	13911352	DNA/TcMar-Tigger	1136	+	60	13911293	58132
chr19	14392892	14592892	harbor1	chr19	14438115	14438322	DNA/TcMar-Tigger	1177	+	104	14438219	45327
chr19	34177687	34377687	harbor1	chr19	34260103	34260447	DNA/TcMar-Tigger	2206	+	172	34260275	82588
chr19	42278497	42478497	harbor1	chr19	42361348	42361665	DNA/TcMar-Tigger	1006	+	158	42361506	83009
chr19	46326583	46526583	harbor1	chr19	46371932	46372189	DNA/TcMar-Tigger	977	+	128	46372060	45477
chr19	46326583	46526583	harbor1	chr19	46372513	46372601	DNA/TcMar-Tigger	977	+	44	46372557	45974
chr19	19626356	19826356	harbor1	chr19	19698470	19698734	DNA/TcMar-Tigger	1317	+	132	19698602	72246
chr19	49979549	50179549	harbor1	chr19	50015200	50015314	DNA/TcMar-Tigger	1251	+	57	50015257	35708
chr19	49979549	50179549	harbor1	chr19	50015609	50015734	DNA/TcMar-Tigger	1251	+	62	50015671	36122
chr19	40976993	41176993	harbor1	chr19	41040412	41040873	DNA/TcMar-Tigger	2697	+	230	41040642	63649
chr19	40976993	41176993	harbor1	chr19	41057020	41057345	DNA/TcMar-Tigger	1602	+	162	41057182	80189
chr19	11756239	11956239	harbor1	chr19	11756148	11756398	DNA/TcMar-Tigger	1208	+	125	11756273	34
chr19	11756239	11956239	harbor1	chr19	11759281	11759709	DNA/TcMar-Tigger	2383	+	214	11759495	3256
chr19	53162859	53362859	harbor1	chr19	53198715	53198844	DNA/TcMar-Tigger	705	+	64	53198779	35920
chr19	53162859	53362859	harbor1	chr19	53199127	53199223	DNA/TcMar-Tigger	705	+	48	53199175	36316
chr19	53162859	53362859	harbor1	chr19	53220435	53220621	DNA/TcMar-Tigger	979	+	93	53220528	57669
chr19	53162859	53362859	harbor1	chr19	53220775	53220914	DNA/TcMar-Tigger	751	+	70	53220845	57986
chr19	46273520	46473520	harbor1	chr19	46371932	46372189	DNA/TcMar-Tigger	977	+	128	46372060	98540
chr19	46273520	46473520	harbor1	chr19	46372513	46372601	DNA/TcMar-Tigger	977	+	44	46372557	99037
chr19	44980412	45180412	harbor1	chr19	45042574	45042615	DNA/TcMar-Tigger	1441	+	20	45042594	62182
chr19	44980412	45180412	harbor1	chr19	45042916	45043194	DNA/TcMar-Tigger	1441	+	139	45043055	62643
chr19	12706380	12906380	harbor1	chr19	12768186	12768240	DNA/TcMar-Tigger	1107	+	27	12768213	61833
chr19	12706380	12906380	harbor1	chr19	12768241	12768259	DNA/TcMar-Tigger	1133	+	9	12768250	61870
chr19	12706380	12906380	harbor1	chr19	12768395	12768618	DNA/TcMar-Tigger	1133	+	112	12768507	62127
chr19	46184523	46384523	harbor1	chr19	46192815	46192907	DNA/TcMar-Tigger	2633	+	46	46192861	8338
chr19	46184523	46384523	harbor1	chr19	46193221	46193729	DNA/TcMar-Tigger	2633	+	254	46193475	8952
chr19	29868245	30068245	harbor1	chr19	29868409	29868797	DNA/TcMar-Tigger	1104	+	194	29868603	358
chr19	29868245	30068245	harbor1	chr19	29869304	29869735	DNA/TcMar-Tigger	1104	+	216	29869520	1275
chr19	56659796	56859796	harbor1	chr19	56700483	56700613	DNA/TcMar-Tigger	982	+	65	56700548	40752
chr19	56659796	56859796	harbor1	chr19	56700916	56700987	DNA/TcMar-Tigger	982	+	36	56700952	41156
chr19	56659796	56859796	harbor1	chr19	56700979	56701195	DNA/TcMar-Tigger	1837	+	108	56701087	41291
chr19	56659796	56859796	harbor1	chr19	56701486	56701601	DNA/TcMar-Tigger	1837	+	58	56701544	41748
chr19	7339670	7539670	harbor1	chr19	7415876	7416116	DNA/TcMar-Tigger	1253	+	120	7415996	76326
chr19	7339670	7539670	harbor1	chr19	7416433	7416528	DNA/TcMar-Tigger	1253	+	48	7416481	76811
chr19	19375634	19575634	harbor1	chr19	19455000	19455073	DNA/TcMar-Tigger	1087	+	36	19455036	79402
chr19	19375634	19575634	harbor1	chr19	19455507	19455770	DNA/TcMar-Tigger	1087	+	132	19455639	80005
chr19	19375634	19575634	harbor1	chr19	19456197	19456646	DNA/TcMar-Tigger	898	+	224	19456421	80787
chr19	18662068	18862068	harbor1	chr19	18737625	18737739	DNA/TcMar-Tigger	2040	+	57	18737682	75614
chr19	18662068	18862068	harbor1	chr19	18737783	18738041	DNA/TcMar-Tigger	2040	+	129	18737912	75844
chr19	18662068	18862068	harbor1	chr19	18738346	18738437	DNA/TcMar-Tigger	2040	+	46	18738392	76324
chr19	36253362	36453362	harbor1	chr19	36337358	36337653	DNA/TcMar-Tigger	1312	+	148	36337506	84144
chr19	17009202	17209202	harbor1	chr19	17032510	17032927	DNA/TcMar-Tigger	2337	+	208	17032718	23516
chr19	17009202	17209202	harbor1	chr19	17033244	17033452	DNA/TcMar-Tigger	2337	+	104	17033348	24146
chr19	17009202	17209202	harbor1	chr19	17034496	17034734	DNA/TcMar-Tigger	1296	+	119	17034615	25413
chr19	38724202	38924202	harbor1	chr19	38758135	38758446	DNA/TcMar-Tigger	3082	+	156	38758291	34089
chr19	38724202	38924202	harbor1	chr19	38759056	38759317	DNA/TcMar-Tigger	3082	+	130	38759186	34984
chr19	40969345	41169345	harbor1	chr19	41040412	41040873	DNA/TcMar-Tigger	2697	+	230	41040642	71297
chr19	40969345	41169345	harbor1	chr19	41057020	41057345	DNA/TcMar-Tigger	1602	+	162	41057182	87837
chr19	2341299	2541299	harbor1	chr19	2350544	2350851	DNA/TcMar-Tigger	678	+	154	2350698	9399
chr19	56430803	56630803	harbor1	chr19	56431216	56431341	DNA/TcMar-Tigger	645	+	62	56431278	475
chr19	56430803	56630803	harbor1	chr19	56446316	56446644	DNA/TcMar-Tigger	1015	+	164	56446480	15677
chr19	56430803	56630803	harbor1	chr19	56472466	56472882	DNA/TcMar-Tigger	2258	+	208	56472674	41871
chr19	56430803	56630803	harbor1	chr19	56505803	56505923	DNA/TcMar-Tigger	849	+	60	56505863	75060
chr19	56430803	56630803	harbor1	chr19	56505911	56506047	DNA/TcMar-Tigger	774	+	68	56505979	75176
chr19	56430803	56630803	harbor1	chr19	56519710	56519975	DNA/TcMar-Tigger	1424	+	132	56519842	89039
chr19	56430803	56630803	harbor1	chr19	56521967	56522221	DNA/TcMar-Tigger	1268	+	127	56522094	91291
chr19	56704905	56904905	harbor1	chr19	56761416	56761843	DNA/TcMar-Tigger	1085	+	214	56761630	56725
chr19	56704905	56904905	harbor1	chr19	56790297	56790814	DNA/TcMar-Tigger	3025	+	258	56790555	85650
chr19	84081	284081	harbor1	chr19	122304	122396	DNA/TcMar-Tigger	1033	+	46	122350	38269
chr19	84081	284081	harbor1	chr19	122689	122823	DNA/TcMar-Tigger	1033	+	67	122756	38675
chr19	84081	284081	harbor1	chr19	122824	123283	DNA/TcMar-Tigger	2350	+	230	123054	38973
chr19	11757892	11957892	harbor1	chr19	11759281	11759709	DNA/TcMar-Tigger	2383	+	214	11759495	1603
chr19	43776277	43976277	harbor1	chr19	43862930	43863544	DNA/TcMar-Tigger	4581	+	307	43863237	86960
chr19	43776277	43976277	harbor1	chr19	43863806	43864018	DNA/TcMar-Tigger	4581	+	106	43863912	87635
chr19	44766134	44966134	harbor1	chr19	44823565	44823696	DNA/TcMar-Tigger	698	+	66	44823631	57497
chr19	11472338	11672338	harbor1	chr19	11523068	11523352	DNA/TcMar-Tigger	1520	+	142	11523210	50872
chr19	37737411	37937411	harbor1	chr19	37825814	37827996	DNA/TcMar-Tigger	14862	+	1091	37826905	89494
chr19	37737411	37937411	harbor1	chr19	37828289	37828465	DNA/TcMar-Tigger	14862	+	88	37828377	90966
chr19	37737411	37937411	harbor1	chr19	37832042	37832524	DNA/TcMar-Tigger	4243	+	241	37832283	94872
chr19	37737411	37937411	harbor1	chr19	37832828	37833079	DNA/TcMar-Tigger	4243	+	126	37832954	95543
chr19	42326591	42526591	harbor1	chr19	42361348	42361665	DNA/TcMar-Tigger	1006	+	158	42361506	34915
chr19	42326591	42526591	harbor1	chr19	42414584	42414949	DNA/TcMar-Tigger	8371	+	182	42414766	88175
chr19	42326591	42526591	harbor1	chr19	42415261	42415529	DNA/TcMar-Tigger	8371	+	134	42415395	88804
chr19	42326591	42526591	harbor1	chr19	42415826	42416060	DNA/TcMar-Tigger	8371	+	117	42415943	89352
chr19	42326591	42526591	harbor1	chr19	42416355	42416910	DNA/TcMar-Tigger	8371	+	278	42416633	90042
chr19	42326591	42526591	harbor1	chr19	42417220	42417243	DNA/TcMar-Tigger	8371	+	12	42417232	90641
chr19	42326591	42526591	harbor1	chr19	42417684	42417985	DNA/TcMar-Tigger	8371	+	150	42417834	91243
chr19	42326591	42526591	harbor1	chr19	42418283	42418830	DNA/TcMar-Tigger	8371	+	274	42418557	91966
chr20	61370575	61570575	harbor1	chr20	61439887	61440677	DNA/TcMar-Tigger	1164	+	395	61440282	69707
chr20	17757330	17957330	harbor1	chr20	17832412	17833526	DNA/TcMar-Tigger	6697	+	557	17832969	75639
chr20	44779652	44979652	harbor1	chr20	44868037	44868204	DNA/TcMar-Tigger	981	+	84	44868121	88469
chr20	18831823	19031823	harbor1	chr20	18887760	18888257	DNA/TcMar-Tigger	3239	+	248	18888008	56185
chr20	18831823	19031823	harbor1	chr20	18888553	18888692	DNA/TcMar-Tigger	3239	+	70	18888623	56800
chr20	29332595	29532595	harbor1	chr20	29413710	29413950	DNA/TcMar-Tigger	565	+	120	29413830	81235
chr20	58260032	58460032	harbor1	chr20	58288476	58288823	DNA/TcMar-Tigger	774	+	174	58288650	28618
chr20	58260032	58460032	harbor1	chr20	58289125	58289222	DNA/TcMar-Tigger	774	+	48	58289173	29141
chr20	58260032	58460032	harbor1	chr20	58318381	58318617	DNA/TcMar-Tigger	946	+	118	58318499	58467
chr20	58260032	58460032	harbor1	chr20	58329881	58330224	DNA/TcMar-Tigger	1620	+	172	58330053	70021
chr20	58260032	58460032	harbor1	chr20	58347281	58347824	DNA/TcMar-Tigger	1801	+	272	58347553	87521
chr20	24689611	24889611	harbor1	chr20	24691677	24691802	DNA/TcMar-Tigger	486	+	62	24691739	2128
chr20	42199979	42399979	harbor1	chr20	42255905	42256264	DNA/TcMar-Tigger	544	+	180	42256085	56106
chr20	42199979	42399979	harbor1	chr20	42267038	42267411	DNA/TcMar-Tigger	2173	+	186	42267224	67245
chr20	59455789	59655789	harbor1	chr20	59479483	59479830	DNA/TcMar-Tigger	1995	+	174	59479657	23868
chr20	29366170	29566170	harbor1	chr20	29413710	29413950	DNA/TcMar-Tigger	565	+	120	29413830	47660
chr20	29366170	29566170	harbor1	chr20	29449310	29449412	DNA/TcMar-Tigger	559	+	51	29449361	83191
chr20	29366170	29566170	harbor1	chr20	29449408	29449728	DNA/TcMar-Tigger	6839	+	160	29449568	83398
chr20	29366170	29566170	harbor1	chr20	29450038	29451222	DNA/TcMar-Tigger	6839	+	592	29450630	84460
chr20	52563354	52763354	harbor1	chr20	52606399	52606727	DNA/TcMar-Tigger	4656	+	164	52606563	43209
chr20	52563354	52763354	harbor1	chr20	52607062	52607757	DNA/TcMar-Tigger	4656	+	348	52607410	44056
chr20	52563354	52763354	harbor1	chr20	52637766	52637926	DNA/TcMar-Tigger	464	+	80	52637846	74492
chr20	52563354	52763354	harbor1	chr20	52637956	52638135	DNA/TcMar-Tigger	464	+	90	52638046	74692
chr20	22657682	22857682	harbor1	chr20	22679690	22679891	DNA/TcMar-Tigger	809	+	100	22679790	22108
chr20	30197384	30397384	harbor1	chr20	30223229	30223550	DNA/TcMar-Tigger	1550	+	160	30223389	26005
chr20	35958756	36158756	harbor1	chr20	36042751	36042962	DNA/TcMar-Tigger	985	+	106	36042857	84101
chr20	51830911	52030911	harbor1	chr20	51866769	51866887	DNA/TcMar-Tigger	801	+	59	51866828	35917
chr20	33531992	33731992	harbor1	chr20	33567397	33567577	DNA/TcMar-Tigger	1896	+	90	33567487	35495
chr20	33531992	33731992	harbor1	chr20	33567884	33568019	DNA/TcMar-Tigger	1896	+	68	33567952	35960
chr20	10417114	10617114	harbor1	chr20	10455936	10456286	DNA/TcMar-Tigger	2164	+	175	10456111	38997
chr20	2881387	3081387	harbor1	chr20	2883157	2883255	DNA/TcMar-Tigger	613	+	49	2883206	1819
chr20	2881387	3081387	harbor1	chr20	2892361	2892782	DNA/TcMar-Tigger	2275	+	210	2892571	11184
chr20	2881387	3081387	harbor1	chr20	2903042	2903277	DNA/TcMar-Tigger	1370	+	118	2903160	21773
chr20	2881387	3081387	harbor1	chr20	2905323	2905687	DNA/TcMar-Tigger	1494	+	182	2905505	24118
chr20	2881387	3081387	harbor1	chr20	2905986	2906328	DNA/TcMar-Tigger	1494	+	171	2906157	24770
chr20	2881387	3081387	harbor1	chr20	2908276	2908518	DNA/TcMar-Tigger	633	+	121	2908397	27010
chr20	2881387	3081387	harbor1	chr20	2914739	2915007	DNA/TcMar-Tigger	1123	+	134	2914873	33486
chr20	2881387	3081387	harbor1	chr20	2943122	2943242	DNA/TcMar-Tigger	554	+	60	2943182	61795
chr20	2881387	3081387	harbor1	chr20	2963635	2963756	DNA/TcMar-Tigger	743	+	60	2963695	82308
chr20	41546184	41746184	harbor1	chr20	41558985	41559098	DNA/TcMar-Tigger	482	+	56	41559041	12857
chr20	41546184	41746184	harbor1	chr20	41569758	41569947	DNA/TcMar-Tigger	1059	+	94	41569852	23668
chr20	41546184	41746184	harbor1	chr20	41608296	41608564	DNA/TcMar-Tigger	636	+	134	41608430	62246
chr20	9402040	9602040	harbor1	chr20	9435945	9436270	DNA/TcMar-Tigger	1592	+	162	9436107	34067
chr20	9402040	9602040	harbor1	chr20	9485458	9485670	DNA/TcMar-Tigger	1376	+	106	9485564	83524
chr20	6569772	6769772	harbor1	chr20	6648158	6648483	DNA/TcMar-Tigger	1713	+	162	6648320	78548
chr20	31506248	31706248	harbor1	chr20	31550565	31550731	DNA/TcMar-Tigger	1323	+	83	31550648	44400
chr20	31506248	31706248	harbor1	chr20	31550983	31551180	DNA/TcMar-Tigger	1323	+	98	31551081	44833
chr20	430657	630657	harbor1	chr20	479782	479995	DNA/TcMar-Tigger	992	+	106	479888	49231
chr20	430657	630657	harbor1	chr20	528957	529048	DNA/TcMar-Tigger	4194	+	46	529003	98346
chr20	430657	630657	harbor1	chr20	529326	529941	DNA/TcMar-Tigger	4194	+	308	529634	98977
chr20	39446282	39646282	harbor1	chr20	39468158	39468397	DNA/TcMar-Tigger	681	+	120	39468278	21996
chr20	39446282	39646282	harbor1	chr20	39508512	39508906	DNA/TcMar-Tigger	2482	+	197	39508709	62427
chr20	19048291	19248291	harbor1	chr20	19114407	19115001	DNA/TcMar-Tigger	2662	+	297	19114704	66413
chr20	42133499	42333499	harbor1	chr20	42173484	42173907	DNA/TcMar-Tigger	731	+	212	42173696	40197
chr20	34050356	34250356	harbor1	chr20	34060256	34060457	DNA/TcMar-Tigger	1057	+	100	34060356	10000
chr20	59417815	59617815	harbor1	chr20	59479483	59479830	DNA/TcMar-Tigger	1995	+	174	59479657	61842
chr20	14234603	14434603	harbor1	chr20	14247551	14247639	DNA/TcMar-Tigger	628	+	44	14247595	12992
chr20	14234603	14434603	harbor1	chr20	14247644	14248303	DNA/TcMar-Tigger	5338	+	330	14247974	13371
chr20	14234603	14434603	harbor1	chr20	14248587	14248800	DNA/TcMar-Tigger	5338	+	106	14248693	14090
chr20	14234603	14434603	harbor1	chr20	14296824	14298285	DNA/TcMar-Tigger	14415	+	730	14297554	62951
chr20	14234603	14434603	harbor1	chr20	14298587	14299443	DNA/TcMar-Tigger	14415	+	428	14299015	64412
chr20	14234603	14434603	harbor1	chr20	14299442	14299604	DNA/TcMar-Tigger	1135	+	81	14299523	64920
chr20	14234603	14434603	harbor1	chr20	14310349	14311509	DNA/TcMar-Tigger	6934	+	580	14310929	76326
chr20	38757782	38957782	harbor1	chr20	38790835	38790987	DNA/TcMar-Tigger	845	+	76	38790911	33129
chr20	38757782	38957782	harbor1	chr20	38791291	38791359	DNA/TcMar-Tigger	845	+	34	38791325	33543
chr20	38757782	38957782	harbor1	chr20	38791533	38791630	DNA/TcMar-Tigger	845	+	48	38791581	33799
chr20	1999665	2199665	harbor1	chr20	2015829	2016178	DNA/TcMar-Tigger	6488	+	174	2016003	16338
chr20	1999665	2199665	harbor1	chr20	2016488	2016992	DNA/TcMar-Tigger	6488	+	252	2016740	17075
chr20	1999665	2199665	harbor1	chr20	2025785	2025983	DNA/TcMar-Tigger	908	+	99	2025884	26219
chr20	1999665	2199665	harbor1	chr20	2027529	2027546	DNA/TcMar-Tigger	908	+	8	2027537	27872
chr20	1999665	2199665	harbor1	chr20	2027875	2027970	DNA/TcMar-Tigger	908	+	48	2027923	28258
chr20	1999665	2199665	harbor1	chr20	2085492	2085725	DNA/TcMar-Tigger	1335	+	116	2085608	85943
chr20	1999665	2199665	harbor1	chr20	2015145	2015487	DNA/TcMar-Tigger	6488	+	171	2015316	15651
chr20	47287166	47487166	harbor1	chr20	47301629	47301786	DNA/TcMar-Tigger	1399	+	78	47301707	14541
chr20	47287166	47487166	harbor1	chr20	47302162	47302194	DNA/TcMar-Tigger	1399	+	16	47302178	15012
chr20	47287166	47487166	harbor1	chr20	47302464	47302589	DNA/TcMar-Tigger	1399	+	62	47302526	15360
chr20	47287166	47487166	harbor1	chr20	47326787	47326959	DNA/TcMar-Tigger	425	+	86	47326873	39707
chr20	25506175	25706175	harbor1	chr20	25585927	25586030	DNA/TcMar-Tigger	740	+	52	25585979	79804
chr20	25506175	25706175	harbor1	chr20	25586481	25586609	DNA/TcMar-Tigger	752	+	64	25586545	80370
chr21	34625073	34825073	harbor1	chr21	34667293	34667628	DNA/TcMar-Tigger	688	+	168	34667461	42388
chr21	16973945	17173945	harbor1	chr21	17005472	17005991	DNA/TcMar-Tigger	3134	+	260	17005732	31787
chr21	15635602	15835602	harbor1	chr21	15643715	15644065	DNA/TcMar-Tigger	621	+	175	15643890	8288
chr21	15635602	15835602	harbor1	chr21	15735225	15735554	DNA/TcMar-Tigger	1923	+	164	15735389	99787
chr21	30498359	30698359	harbor1	chr21	30500993	30501433	DNA/TcMar-Tigger	2649	+	220	30501213	2854
chr21	37130125	37330125	harbor1	chr21	37129932	37130257	DNA/TcMar-Tigger	592	+	162	37130094	31
chr21	37130125	37330125	harbor1	chr21	37135817	37138298	DNA/TcMar-Tigger	14395	+	1240	37137057	6932
chr21	37130125	37330125	harbor1	chr21	37194189	37194699	DNA/TcMar-Tigger	2790	+	255	37194444	64319
chr21	37130125	37330125	harbor1	chr21	37194701	37194790	DNA/TcMar-Tigger	449	+	44	37194745	64620
chr21	37130125	37330125	harbor1	chr21	37204096	37204421	DNA/TcMar-Tigger	1927	+	162	37204258	74133
chr21	42450690	42650690	harbor1	chr21	42488583	42488997	DNA/TcMar-Tigger	609	+	207	42488790	38100
chr21	34311097	34511097	harbor1	chr21	34311991	34312206	DNA/TcMar-Tigger	723	+	108	34312099	1002
chr21	26408972	26608972	harbor1	chr21	26454695	26454753	DNA/TcMar-Tigger	735	+	29	26454724	45752
chr21	26408972	26608972	harbor1	chr21	26454884	26454957	DNA/TcMar-Tigger	735	+	36	26454920	45948
chr21	39743786	39943786	harbor1	chr21	39790764	39791083	DNA/TcMar-Tigger	1470	+	160	39790924	47138
chr21	15464659	15664659	harbor1	chr21	15468508	15468775	DNA/TcMar-Tigger	1076	+	134	15468642	3983
chr21	33991353	34191353	harbor1	chr21	34080806	34081412	DNA/TcMar-Tigger	1450	+	303	34081109	89756
chr21	46399461	46599461	harbor1	chr21	46422754	46422934	DNA/TcMar-Tigger	480	+	90	46422844	23383
chr21	46399461	46599461	harbor1	chr21	46482259	46482669	DNA/TcMar-Tigger	2132	+	205	46482464	83003
chr21	44997121	45197121	harbor1	chr21	45060922	45061182	DNA/TcMar-Tigger	1183	+	130	45061052	63931
chr21	44997121	45197121	harbor1	chr21	45081358	45081629	DNA/TcMar-Tigger	1642	+	136	45081494	84373
chr21	19130418	19330418	harbor1	chr21	19193623	19193886	DNA/TcMar-Tigger	2150	+	132	19193755	63337
chr21	19130418	19330418	harbor1	chr21	19195151	19195317	DNA/TcMar-Tigger	2150	+	83	19195234	64816
chr21	18121982	18321982	harbor1	chr21	18125843	18126034	DNA/TcMar-Tigger	1123	+	96	18125939	3957
chr21	18121982	18321982	harbor1	chr21	18126161	18126491	DNA/TcMar-Tigger	1975	+	165	18126326	4344
chr21	13893683	14093683	harbor1	chr21	13961639	13961772	DNA/TcMar-Tigger	812	+	66	13961705	68022
chr21	13893683	14093683	harbor1	chr21	13966510	13966934	DNA/TcMar-Tigger	1889	+	212	13966722	73039
chr22	39331954	39531954	harbor1	chr22	39424978	39425090	DNA/TcMar-Tigger	1785	+	56	39425034	93080
chr22	39331954	39531954	harbor1	chr22	39425396	39425548	DNA/TcMar-Tigger	1785	+	76	39425472	93518
chr22	39331954	39531954	harbor1	chr22	39425846	39425868	DNA/TcMar-Tigger	1785	+	11	39425857	93903
chr22	39331954	39531954	harbor1	chr22	39426159	39426228	DNA/TcMar-Tigger	1785	+	34	39426193	94239
chr22	10485187	10685187	harbor1	chr22	10531954	10532325	DNA/TcMar-Tigger	1592	+	186	10532140	46953
chr22	10485187	10685187	harbor1	chr22	10543084	10543417	DNA/TcMar-Tigger	1540	+	166	10543250	58063
chr22	38509582	38709582	harbor1	chr22	38575886	38575897	DNA/TcMar-Tigger	3730	+	6	38575892	66310
chr22	38509582	38709582	harbor1	chr22	38576145	38576799	DNA/TcMar-Tigger	3730	+	327	38576472	66890
chr22	42598210	42798210	harbor1	chr22	42640683	42640850	DNA/TcMar-Tigger	1680	+	84	42640767	42557
chr22	42598210	42798210	harbor1	chr22	42641155	42641309	DNA/TcMar-Tigger	1680	+	77	42641232	43022
chr22	42598210	42798210	harbor1	chr22	42641924	42641986	DNA/TcMar-Tigger	1680	+	31	42641955	43745
chr22	40161042	40361042	harbor1	chr22	40201739	40201972	DNA/TcMar-Tigger	1246	+	116	40201855	40813
chr22	44176045	44376045	harbor1	chr22	44217179	44217370	DNA/TcMar-Tigger	1327	+	96	44217275	41230
chr22	19759481	19959481	harbor1	chr22	19856407	19856509	DNA/TcMar-Tigger	2511	+	51	19856458	96977
chr22	19759481	19959481	harbor1	chr22	19856811	19857238	DNA/TcMar-Tigger	2511	+	214	19857025	97544
chr22	24879023	25079023	harbor1	chr22	24890256	24890339	DNA/TcMar-Tigger	561	+	42	24890298	11275
chr22	48734214	48934214	harbor1	chr22	48813691	48816086	DNA/TcMar-Tigger	14558	+	1198	48814889	80675
chr22	48734214	48934214	harbor1	chr22	48816459	48816908	DNA/TcMar-Tigger	2413	+	224	48816683	82469
chr22	27833544	28033544	harbor1	chr22	27857144	27857289	DNA/TcMar-Tigger	711	+	72	27857216	23672
chr22	27833544	28033544	harbor1	chr22	27878575	27878958	DNA/TcMar-Tigger	1813	+	192	27878767	45223
chr22	16487907	16687907	harbor1	chr22	16518007	16518257	DNA/TcMar-Tigger	2228	+	125	16518132	30225
chr22	16487907	16687907	harbor1	chr22	16518551	16518705	DNA/TcMar-Tigger	2228	+	77	16518628	30721
chr22	16487907	16687907	harbor1	chr22	16518989	16519457	DNA/TcMar-Tigger	2501	+	234	16519223	31316
chr22	33821349	34021349	harbor1	chr22	33840632	33840675	DNA/TcMar-Tigger	1555	+	22	33840654	19305
chr22	33821349	34021349	harbor1	chr22	33840921	33841216	DNA/TcMar-Tigger	1555	+	148	33841069	19720
chr22	24232807	24432807	harbor1	chr22	24297604	24298032	DNA/TcMar-Tigger	2714	+	214	24297818	65011
chr22	24232807	24432807	harbor1	chr22	24298033	24298340	DNA/TcMar-Tigger	1649	+	154	24298187	65380
chr22	24232807	24432807	harbor1	chr22	24298341	24298443	DNA/TcMar-Tigger	2714	+	51	24298392	65585
chr22	24232807	24432807	harbor1	chr22	24329117	24329335	DNA/TcMar-Tigger	1262	+	109	24329226	96419
chr22	29228352	29428352	harbor1	chr22	29295692	29295929	DNA/TcMar-Tigger	478	+	118	29295810	67458
chr22	27397527	27597527	harbor1	chr22	27447867	27448252	DNA/TcMar-Tigger	2031	+	192	27448059	50532
chr22	42927825	43127825	harbor1	chr22	42950016	42950353	DNA/TcMar-Tigger	1960	+	168	42950184	22359
chr22	18928268	19128268	harbor1	chr22	18988102	18988240	DNA/TcMar-Tigger	688	+	69	18988171	59903
chr22	18928268	19128268	harbor1	chr22	18988528	18988570	DNA/TcMar-Tigger	688	+	21	18988549	60281
chr22	40561426	40761426	harbor1	chr22	40574249	40574440	DNA/TcMar-Tigger	2038	+	96	40574345	12919
chr22	40561426	40761426	harbor1	chr22	40574733	40574899	DNA/TcMar-Tigger	2038	+	83	40574816	13390
chr22	33915598	34115598	harbor1	chr22	34009682	34009720	DNA/TcMar-Tigger	993	+	19	34009701	94103
chr22	33915598	34115598	harbor1	chr22	34010033	34010227	DNA/TcMar-Tigger	993	+	97	34010130	94532
chr22	33915598	34115598	harbor1	chr22	34013235	34013448	DNA/TcMar-Tigger	1201	+	106	34013341	97743
chr22	33915598	34115598	harbor1	chr22	34013785	34013877	DNA/TcMar-Tigger	1201	+	46	34013831	98233
chr22	23730633	23930633	harbor1	chr22	23784580	23784664	DNA/TcMar-Tigger	2003	+	42	23784622	53989
chr22	23730633	23930633	harbor1	chr22	23785294	23785557	DNA/TcMar-Tigger	2003	+	132	23785426	54793
chr22	25534051	25734051	harbor1	chr22	25584177	25584622	DNA/TcMar-Tigger	1975	+	222	25584399	50348
chr22	25534051	25734051	harbor1	chr22	25584622	25584772	DNA/TcMar-Tigger	905	+	75	25584697	50646
chr22	25534051	25734051	harbor1	chr22	25600123	25600147	DNA/TcMar-Tigger	1270	+	12	25600135	66084
chr22	25534051	25734051	harbor1	chr22	25600440	25600754	DNA/TcMar-Tigger	1270	+	157	25600597	66546
chr22	19641586	19841586	harbor1	chr22	19712947	19713170	DNA/TcMar-Tigger	627	+	112	19713059	71473
chr22	32342816	32542816	harbor1	chr22	32435301	32435537	DNA/TcMar-Tigger	1504	+	118	32435419	92603
chr22	16504276	16704276	harbor1	chr22	16518007	16518257	DNA/TcMar-Tigger	2228	+	125	16518132	13856
chr22	16504276	16704276	harbor1	chr22	16518551	16518705	DNA/TcMar-Tigger	2228	+	77	16518628	14352
chr22	16504276	16704276	harbor1	chr22	16518989	16519457	DNA/TcMar-Tigger	2501	+	234	16519223	14947
chr22	11359787	11559787	harbor1	chr22	11443376	11443584	DNA/TcMar-Tigger	1138	+	104	11443480	83693
chr22	34074412	34274412	harbor1	chr22	34109432	34109774	DNA/TcMar-Tigger	1853	+	171	34109603	35191
chr22	11758260	11958260	harbor1	chr22	11845733	11846023	DNA/TcMar-Tigger	1622	+	145	11845878	87618
chrX	47619362	47819362	harbor1	chrX	47643392	47643700	DNA/TcMar-Tigger	1277	+	154	47643546	24184
chrX	69199112	69399112	harbor1	chrX	69290357	69290665	DNA/TcMar-Tigger	1079	+	154	69290511	91399
chrX	8324370	8524370	harbor1	chrX	8376249	8376353	DNA/TcMar-Tigger	590	+	52	8376301	51931
chrX	8324370	8524370	harbor1	chrX	8376351	8376607	DNA/TcMar-Tigger	1478	+	128	8376479	52109
chrX	8324370	8524370	harbor1	chrX	8408451	8408784	DNA/TcMar-Tigger	1849	+	166	8408617	84247
chrX	96100675	96300675	harbor1	chrX	96101049	96101813	DNA/TcMar-Tigger	3574	+	382	96101431	756
chrX	96100675	96300675	harbor1	chrX	96158963	96159315	DNA/TcMar-Tigger	16918	+	176	96159139	58464
chrX	96100675	96300675	harbor1	chrX	96156237	96158594	DNA/TcMar-Tigger	16918	+	1178	96157415	56740
chrX	12035511	12235511	harbor1	chrX	12049512	12049602	DNA/TcMar-Tigger	586	+	45	12049557	14046
chrX	12035511	12235511	harbor1	chrX	12049601	12050554	DNA/TcMar-Tigger	5563	+	476	12050077	14566
chrX	38326752	38526752	harbor1	chrX	38360653	38361057	DNA/TcMar-Tigger	5641	+	202	38360855	34103
chrX	38326752	38526752	harbor1	chrX	38361315	38361975	DNA/TcMar-Tigger	5641	+	330	38361645	34893
chrX	1393857	1593857	harbor1	chrX	1400025	1400365	DNA/TcMar-Tigger	1292	+	170	1400195	6338
chrX	1393857	1593857	harbor1	chrX	1411623	1411796	DNA/TcMar-Tigger	721	+	86	1411709	17852
chrX	42813765	43013765	harbor1	chrX	42839244	42839607	DNA/TcMar-Tigger	7688	+	182	42839426	25661
chrX	42813765	43013765	harbor1	chrX	42840030	42840903	DNA/TcMar-Tigger	7688	+	436	42840466	26701
