H_chr	H_start	H_end	Harbor	TE_chr	TE_start	TE_end	TE	score	TE_strand	TE_half	TE_middle_pos	TE_dis
chr1	234473588	234673588	harbor1	chr1	234485450	234485715	DNA/hAT-Charlie	1250	+	132	234485582	11994
chr1	234473588	234673588	harbor1	chr1	234514092	234514204	DNA/hAT-Charlie	411	+	56	234514148	40560
chr1	234473588	234673588	harbor1	chr1	234524921	234525042	DNA/hAT-Charlie	429	+	60	234524981	51393
chr1	161699396	161899396	harbor1	chr1	161713684	161713908	DNA/hAT-Charlie	1279	+	112	161713796	14400
chr1	161699396	161899396	harbor1	chr1	161718038	161718155	DNA/hAT-Charlie	458	+	58	161718096	18700
chr1	161699396	161899396	harbor1	chr1	161796427	161796758	DNA/hAT-Charlie	826	+	166	161796593	97197
chr1	36619682	36819682	harbor1	chr1	36624480	36624634	DNA/hAT-Charlie	566	+	77	36624557	4875
chr1	36619682	36819682	harbor1	chr1	36674706	36674883	DNA/hAT-Charlie	605	+	88	36674794	55112
chr1	36619682	36819682	harbor1	chr1	36680502	36680798	DNA/hAT-Charlie	596	+	148	36680650	60968
chr1	36619682	36819682	harbor1	chr1	36681265	36681570	DNA/hAT-Charlie	682	+	152	36681417	61735
chr1	36619682	36819682	harbor1	chr1	36682640	36683519	DNA/hAT-Charlie	3063	+	440	36683080	63398
chr1	36619682	36819682	harbor1	chr1	36685526	36686144	DNA/hAT-Charlie	2697	+	309	36685835	66153
chr1	36619682	36819682	harbor1	chr1	36686470	36686657	DNA/hAT-Charlie	2697	+	94	36686564	66882
chr1	28686527	28886527	harbor1	chr1	28718620	28718718	DNA/hAT-Charlie	504	+	49	28718669	32142
chr1	28686527	28886527	harbor1	chr1	28779218	28779359	DNA/hAT-Charlie	490	+	70	28779288	92761
chr1	187934296	188134296	harbor1	chr1	187989215	187989388	DNA/hAT-Charlie	787	+	86	187989301	55005
chr1	79114311	79314311	harbor1	chr1	79200006	79200210	DNA/hAT-Charlie	753	+	102	79200108	85797
chr1	232202979	232402979	harbor1	chr1	232276240	232276411	DNA/hAT-Charlie	413	+	86	232276326	73347
chr1	244268148	244468148	harbor1	chr1	244271206	244271419	DNA/hAT-Charlie	956	+	106	244271312	3164
chr1	244268148	244468148	harbor1	chr1	244337168	244337436	DNA/hAT-Charlie	567	+	134	244337302	69154
chr1	182089820	182289820	harbor1	chr1	182113116	182113268	DNA/hAT-Charlie	511	+	76	182113192	23372
chr1	182089820	182289820	harbor1	chr1	182121498	182121644	DNA/hAT-Charlie	587	+	73	182121571	31751
chr1	182089820	182289820	harbor1	chr1	182138298	182138472	DNA/hAT-Charlie	623	+	87	182138385	48565
chr1	182089820	182289820	harbor1	chr1	182155722	182155959	DNA/hAT-Charlie	970	+	118	182155840	66020
chr1	178962333	179162333	harbor1	chr1	178970891	178971053	DNA/hAT-Charlie	632	+	81	178970972	8639
chr1	178962333	179162333	harbor1	chr1	179020648	179020786	DNA/hAT-Charlie	442	+	69	179020717	58384
chr1	178962333	179162333	harbor1	chr1	179060361	179060701	DNA/hAT-Charlie	2125	+	170	179060531	98198
chr1	222698793	222898793	harbor1	chr1	222715166	222715305	DNA/hAT-Charlie	424	+	70	222715236	16443
chr1	222698793	222898793	harbor1	chr1	222716544	222716764	DNA/hAT-Charlie	836	+	110	222716654	17861
chr1	222698793	222898793	harbor1	chr1	222722060	222722166	DNA/hAT-Charlie	399	+	53	222722113	23320
chr1	222698793	222898793	harbor1	chr1	222784724	222784961	DNA/hAT-Charlie	475	+	118	222784842	86049
chr1	150352413	150552413	harbor1	chr1	150378555	150378695	DNA/hAT-Charlie	625	+	70	150378625	26212
chr1	150352413	150552413	harbor1	chr1	150379000	150379012	DNA/hAT-Charlie	625	+	6	150379006	26593
chr1	150352413	150552413	harbor1	chr1	150379312	150379386	DNA/hAT-Charlie	625	+	37	150379349	26936
chr1	150352413	150552413	harbor1	chr1	150379836	150379941	DNA/hAT-Charlie	559	+	52	150379888	27475
chr1	150352413	150552413	harbor1	chr1	150383989	150384200	DNA/hAT-Charlie	571	+	106	150384095	31682
chr1	94585470	94785470	harbor1	chr1	94594154	94594476	DNA/hAT-Charlie	1928	+	161	94594315	8845
chr1	181147469	181347469	harbor1	chr1	181170329	181170545	DNA/hAT-Charlie	1161	+	108	181170437	22968
chr1	181147469	181347469	harbor1	chr1	181223922	181224074	DNA/hAT-Charlie	452	+	76	181223998	76529
chr1	50085083	50285083	harbor1	chr1	50172491	50172691	DNA/hAT-Charlie	947	+	100	50172591	87508
chr1	8241903	8441903	harbor1	chr1	8244432	8244646	DNA/hAT-Charlie	1060	+	107	8244539	2636
chr1	29488753	29688753	harbor1	chr1	29489309	29489594	DNA/hAT-Charlie	542	+	142	29489451	698
chr1	59479253	59679253	harbor1	chr1	59480878	59481146	DNA/hAT-Charlie	408	+	134	59481012	1759
chr1	59479253	59679253	harbor1	chr1	59513216	59513369	DNA/hAT-Charlie	453	+	76	59513292	34039
chr1	59479253	59679253	harbor1	chr1	59519900	59520125	DNA/hAT-Charlie	1300	+	112	59520012	40759
chr1	154896235	155096235	harbor1	chr1	154980884	154981045	DNA/hAT-Charlie	698	+	80	154980964	84729
chr1	154896235	155096235	harbor1	chr1	154982414	154982567	DNA/hAT-Charlie	673	+	76	154982490	86255
chr1	154896235	155096235	harbor1	chr1	154910581	154910792	DNA/hAT-Charlie	621	+	106	154910687	14452
chr1	29719198	29919198	harbor1	chr1	29747765	29747982	DNA/hAT-Charlie	460	+	108	29747873	28675
chr1	109248550	109448550	harbor1	chr1	109324565	109324710	DNA/hAT-Charlie	523	+	72	109324637	76087
chr1	109248550	109448550	harbor1	chr1	109347793	109347972	DNA/hAT-Charlie	1001	+	90	109347883	99333
chr1	215718321	215918321	harbor1	chr1	215748416	215748618	DNA/hAT-Charlie	597	+	101	215748517	30196
chr1	215718321	215918321	harbor1	chr1	215814809	215814946	DNA/hAT-Charlie	528	+	68	215814877	96556
chr1	111130357	111330357	harbor1	chr1	111157335	111157537	DNA/hAT-Charlie	981	+	101	111157436	27079
chr1	111130357	111330357	harbor1	chr1	111183842	111184044	DNA/hAT-Charlie	1008	+	101	111183943	53586
chr1	111130357	111330357	harbor1	chr1	111190384	111190708	DNA/hAT-Charlie	1068	+	162	111190546	60189
chr1	219270043	219470043	harbor1	chr1	219337668	219337879	DNA/hAT-Charlie	823	+	106	219337774	67731
chr1	219270043	219470043	harbor1	chr1	219355089	219355257	DNA/hAT-Charlie	576	+	84	219355173	85130
chr1	219270043	219470043	harbor1	chr1	219363270	219363539	DNA/hAT-Charlie	829	+	134	219363404	93361
chr1	237802493	238002493	harbor1	chr1	237804909	237805114	DNA/hAT-Charlie	778	+	102	237805011	2518
chr1	237802493	238002493	harbor1	chr1	237818212	237818385	DNA/hAT-Charlie	631	+	86	237818298	15805
chr1	237802493	238002493	harbor1	chr1	237863123	237863310	DNA/hAT-Charlie	686	+	94	237863217	60724
chr1	237802493	238002493	harbor1	chr1	237881968	237882178	DNA/hAT-Charlie	465	+	105	237882073	79580
chr1	237802493	238002493	harbor1	chr1	237898256	237898432	DNA/hAT-Charlie	696	+	88	237898344	95851
chr1	25981437	26181437	harbor1	chr1	26059764	26059928	DNA/hAT-Charlie	691	+	82	26059846	78409
chr1	116082008	116282008	harbor1	chr1	116113605	116113847	DNA/hAT-Charlie	538	+	121	116113726	31718
chr1	116082008	116282008	harbor1	chr1	116127757	116127940	DNA/hAT-Charlie	938	+	92	116127849	45841
chr1	116082008	116282008	harbor1	chr1	116162648	116162874	DNA/hAT-Charlie	414	+	113	116162761	80753
chr1	116082008	116282008	harbor1	chr1	116173398	116173557	DNA/hAT-Charlie	641	+	80	116173478	91470
chr1	116082008	116282008	harbor1	chr1	116177066	116177258	DNA/hAT-Charlie	1071	+	96	116177162	95154
chr1	13675368	13875368	harbor1	chr1	13678192	13678282	DNA/hAT-Charlie	485	+	45	13678237	2869
chr1	13675368	13875368	harbor1	chr1	13689872	13689891	DNA/hAT-Charlie	519	+	10	13689882	14514
chr1	13675368	13875368	harbor1	chr1	13690247	13690384	DNA/hAT-Charlie	519	+	68	13690315	14947
chr1	13675368	13875368	harbor1	chr1	13737202	13737494	DNA/hAT-Charlie	1543	+	146	13737348	61980
chr1	13675368	13875368	harbor1	chr1	13769851	13770066	DNA/hAT-Charlie	988	+	108	13769959	94591
chr1	176134461	176334461	harbor1	chr1	176153325	176153395	DNA/hAT-Charlie	465	+	35	176153360	18899
chr1	176134461	176334461	harbor1	chr1	176168898	176169368	DNA/hAT-Charlie	951	+	235	176169133	34672
chr1	176134461	176334461	harbor1	chr1	176171746	176172060	DNA/hAT-Charlie	799	+	157	176171903	37442
chr1	176134461	176334461	harbor1	chr1	176172342	176172473	DNA/hAT-Charlie	799	+	66	176172408	37947
chr1	176134461	176334461	harbor1	chr1	176182390	176182600	DNA/hAT-Charlie	957	+	105	176182495	48034
chr1	230352990	230552990	harbor1	chr1	230385834	230385992	DNA/hAT-Charlie	752	+	79	230385913	32923
chr1	230352990	230552990	harbor1	chr1	230417935	230418122	DNA/hAT-Charlie	1081	+	94	230418029	65039
chr1	168750546	168950546	harbor1	chr1	168771035	168771225	DNA/hAT-Charlie	475	+	95	168771130	20584
chr1	168750546	168950546	harbor1	chr1	168772532	168772748	DNA/hAT-Charlie	1165	+	108	168772640	22094
chr1	168750546	168950546	harbor1	chr1	168804446	168804696	DNA/hAT-Charlie	468	+	125	168804571	54025
chr1	171264660	171464660	harbor1	chr1	171283680	171283937	DNA/hAT-Charlie	1084	+	128	171283808	19148
chr1	171264660	171464660	harbor1	chr1	171313299	171313510	DNA/hAT-Charlie	603	+	106	171313405	48745
chr1	171264660	171464660	harbor1	chr1	171339053	171339210	DNA/hAT-Charlie	445	+	78	171339131	74471
chr1	154914524	155114524	harbor1	chr1	154980884	154981045	DNA/hAT-Charlie	698	+	80	154980964	66440
chr1	154914524	155114524	harbor1	chr1	154982414	154982567	DNA/hAT-Charlie	673	+	76	154982490	67966
chr1	195409037	195609037	harbor1	chr1	195502753	195503281	DNA/hAT-Charlie	3387	+	264	195503017	93980
chr1	119147098	119347098	harbor1	chr1	119238531	119238714	DNA/hAT-Charlie	934	+	92	119238623	91525
chr1	80621502	80821502	harbor1	chr1	80663911	80664438	DNA/hAT-Charlie	1554	+	264	80664175	42673
chr1	80621502	80821502	harbor1	chr1	80680368	80680572	DNA/hAT-Charlie	688	+	102	80680470	58968
chr1	208001267	208201267	harbor1	chr1	208001327	208001487	DNA/hAT-Charlie	684	+	80	208001407	140
chr1	208001267	208201267	harbor1	chr1	208034765	208035114	DNA/hAT-Charlie	1025	+	174	208034939	33672
chr1	208001267	208201267	harbor1	chr1	208038121	208038238	DNA/hAT-Charlie	422	+	58	208038179	36912
chr1	208001267	208201267	harbor1	chr1	208041506	208041713	DNA/hAT-Charlie	853	+	104	208041610	40343
chr1	197582611	197782611	harbor1	chr1	197586041	197586510	DNA/hAT-Charlie	1856	+	234	197586275	3664
chr1	197582611	197782611	harbor1	chr1	197597798	197598082	DNA/hAT-Charlie	1009	+	142	197597940	15329
chr1	197582611	197782611	harbor1	chr1	197663472	197663822	DNA/hAT-Charlie	690	+	175	197663647	81036
chr1	197582611	197782611	harbor1	chr1	197669572	197669945	DNA/hAT-Charlie	595	+	186	197669758	87147
chr1	197582611	197782611	harbor1	chr1	197678556	197678656	DNA/hAT-Charlie	477	+	50	197678606	95995
chr1	239265468	239465468	harbor1	chr1	239363430	239363721	DNA/hAT-Charlie	1125	+	146	239363576	98108
chr1	114302945	114502945	harbor1	chr1	114303586	114303985	DNA/hAT-Charlie	1545	+	200	114303786	841
chr1	114302945	114502945	harbor1	chr1	114315710	114315922	DNA/hAT-Charlie	1228	+	106	114315816	12871
chr1	114302945	114502945	harbor1	chr1	114330992	114331014	DNA/hAT-Charlie	1029	+	11	114331003	28058
chr1	114302945	114502945	harbor1	chr1	114331476	114331770	DNA/hAT-Charlie	1029	+	147	114331623	28678
chr1	114302945	114502945	harbor1	chr1	114327076	114327581	DNA/hAT-Charlie	3731	+	252	114327328	24383
chr1	87353233	87553233	harbor1	chr1	87397976	87398652	DNA/hAT-Charlie	2080	+	338	87398314	45081
chr1	57087097	57287097	harbor1	chr1	57090762	57091025	DNA/hAT-Charlie	1717	+	132	57090894	3797
chr1	57087097	57287097	harbor1	chr1	57091160	57091231	DNA/hAT-Charlie	413	+	36	57091196	4099
chr1	57087097	57287097	harbor1	chr1	57104109	57104321	DNA/hAT-Charlie	445	+	106	57104215	17118
chr1	57087097	57287097	harbor1	chr1	57115431	57115636	DNA/hAT-Charlie	846	+	102	57115533	28436
chr1	57087097	57287097	harbor1	chr1	57128430	57128613	DNA/hAT-Charlie	660	+	92	57128522	41425
chr1	43567312	43767312	harbor1	chr1	43610528	43610597	DNA/hAT-Charlie	968	+	34	43610562	43250
chr1	43567312	43767312	harbor1	chr1	43610887	43611049	DNA/hAT-Charlie	968	+	81	43610968	43656
chr1	43567312	43767312	harbor1	chr1	43634218	43634323	DNA/hAT-Charlie	552	+	52	43634270	66958
chr1	32165623	32365623	harbor1	chr1	32186799	32186925	DNA/hAT-Charlie	1060	+	63	32186862	21239
chr1	32165623	32365623	harbor1	chr1	32187202	32187364	DNA/hAT-Charlie	1060	+	81	32187283	21660
chr1	32165623	32365623	harbor1	chr1	32245594	32245752	DNA/hAT-Charlie	889	+	79	32245673	80050
chr1	190839266	191039266	harbor1	chr1	190906028	190906333	DNA/hAT-Charlie	652	+	152	190906180	66914
chr1	17977487	18177487	harbor1	chr1	17986439	17986641	DNA/hAT-Charlie	1023	+	101	17986540	9053
chr1	37092934	37292934	harbor1	chr1	37098663	37098828	DNA/hAT-Charlie	670	+	82	37098745	5811
chr1	37092934	37292934	harbor1	chr1	37113826	37114007	DNA/hAT-Charlie	489	+	90	37113916	20982
chr1	37092934	37292934	harbor1	chr1	37178351	37178566	DNA/hAT-Charlie	1090	+	108	37178459	85525
chr1	243422589	243622589	harbor1	chr1	243431577	243432207	DNA/hAT-Charlie	1410	+	315	243431892	9303
chr1	243422589	243622589	harbor1	chr1	243432531	243432687	DNA/hAT-Charlie	1410	+	78	243432609	10020
chr1	243422589	243622589	harbor1	chr1	243433833	243434271	DNA/hAT-Charlie	1224	+	219	243434052	11463
chr1	51095933	51295933	harbor1	chr1	51144152	51144299	DNA/hAT-Charlie	732	+	74	51144226	48293
chr1	51095933	51295933	harbor1	chr1	51185696	51185795	DNA/hAT-Charlie	575	+	50	51185746	89813
chr1	51095933	51295933	harbor1	chr1	51192277	51192495	DNA/hAT-Charlie	848	+	109	51192386	96453
chr1	184683952	184883952	harbor1	chr1	184767723	184768036	DNA/hAT-Charlie	1761	+	156	184767879	83927
chr1	184683952	184883952	harbor1	chr1	184771653	184771861	DNA/hAT-Charlie	993	+	104	184771757	87805
chr1	53608248	53808248	harbor1	chr1	53617138	53617553	DNA/hAT-Charlie	1404	+	208	53617346	9098
chr1	53608248	53808248	harbor1	chr1	53617581	53617811	DNA/hAT-Charlie	592	+	115	53617696	9448
chr1	53608248	53808248	harbor1	chr1	53674260	53674440	DNA/hAT-Charlie	820	+	90	53674350	66102
chr1	168490883	168690883	harbor1	chr1	168568617	168568814	DNA/hAT-Charlie	486	+	98	168568715	77832
chr1	103162050	103362050	harbor1	chr1	103238975	103239212	DNA/hAT-Charlie	870	+	118	103239093	77043
chr1	103162050	103362050	harbor1	chr1	103258457	103258634	DNA/hAT-Charlie	503	+	88	103258545	96495
chr1	186598105	186798105	harbor1	chr1	186606647	186606729	DNA/hAT-Charlie	451	+	41	186606688	8583
chr1	186598105	186798105	harbor1	chr1	186606929	186607200	DNA/hAT-Charlie	704	+	136	186607065	8960
chr1	160259693	160459693	harbor1	chr1	160275015	160275354	DNA/hAT-Charlie	2380	+	170	160275185	15492
chr1	160259693	160459693	harbor1	chr1	160277151	160277411	DNA/hAT-Charlie	882	+	130	160277281	17588
chr1	160259693	160459693	harbor1	chr1	160324206	160324282	DNA/hAT-Charlie	810	+	38	160324244	64551
chr1	160259693	160459693	harbor1	chr1	160324598	160324730	DNA/hAT-Charlie	810	+	66	160324664	64971
chr1	160259693	160459693	harbor1	chr1	160324713	160324848	DNA/hAT-Charlie	809	+	68	160324781	65088
chr1	160259693	160459693	harbor1	chr1	160329618	160329812	DNA/hAT-Charlie	628	+	97	160329715	70022
chr1	18254878	18454878	harbor1	chr1	18267793	18267985	DNA/hAT-Charlie	857	+	96	18267889	13011
chr1	18254878	18454878	harbor1	chr1	18274462	18274667	DNA/hAT-Charlie	951	+	102	18274564	19686
chr1	18254878	18454878	harbor1	chr1	18333793	18334108	DNA/hAT-Charlie	1301	+	158	18333951	79073
chr1	65858547	66058547	harbor1	chr1	65866169	65866357	DNA/hAT-Charlie	452	+	94	65866263	7716
chr1	65858547	66058547	harbor1	chr1	65868651	65868998	DNA/hAT-Charlie	2236	+	174	65868825	10278
chr1	65858547	66058547	harbor1	chr1	65885930	65886151	DNA/hAT-Charlie	1035	+	110	65886040	27493
chr1	65858547	66058547	harbor1	chr1	65913791	65913945	DNA/hAT-Charlie	686	+	77	65913868	55321
chr1	65858547	66058547	harbor1	chr1	65914857	65915161	DNA/hAT-Charlie	1122	+	152	65915009	56462
chr1	65858547	66058547	harbor1	chr1	65952021	65952206	DNA/hAT-Charlie	780	+	92	65952113	93566
chr1	50482160	50682160	harbor1	chr1	50504828	50505001	DNA/hAT-Charlie	708	+	86	50504914	22754
chr1	50482160	50682160	harbor1	chr1	50505576	50505795	DNA/hAT-Charlie	1150	+	110	50505686	23526
chr1	70933892	71133892	harbor1	chr1	70936135	70936279	DNA/hAT-Charlie	522	+	72	70936207	2315
chr1	70933892	71133892	harbor1	chr1	71005010	71005218	DNA/hAT-Charlie	1082	+	104	71005114	71222
chr1	70933892	71133892	harbor1	chr1	71013994	71014132	DNA/hAT-Charlie	554	+	69	71014063	80171
chr1	210507012	210707012	harbor1	chr1	210599075	210599271	DNA/hAT-Charlie	824	+	98	210599173	92161
chr1	202402460	202602460	harbor1	chr1	202423465	202423597	DNA/hAT-Charlie	486	+	66	202423531	21071
chr1	202402460	202602460	harbor1	chr1	202441462	202441586	DNA/hAT-Charlie	660	+	62	202441524	39064
chr1	202402460	202602460	harbor1	chr1	202472878	202473006	DNA/hAT-Charlie	551	+	64	202472942	70482
chr1	202402460	202602460	harbor1	chr1	202479718	202479896	DNA/hAT-Charlie	815	+	89	202479807	77347
chr1	202402460	202602460	harbor1	chr1	202480432	202480905	DNA/hAT-Charlie	3409	+	236	202480668	78208
chr1	202402460	202602460	harbor1	chr1	202481254	202481587	DNA/hAT-Charlie	3409	+	166	202481420	78960
chr1	202402460	202602460	harbor1	chr1	202486184	202486345	DNA/hAT-Charlie	730	+	80	202486264	83804
chr1	172112720	172312720	harbor1	chr1	172116667	172116888	DNA/hAT-Charlie	522	+	110	172116777	4057
chr1	172112720	172312720	harbor1	chr1	172204913	172205161	DNA/hAT-Charlie	621	+	124	172205037	92317
chr1	17904948	18104948	harbor1	chr1	17909175	17909369	DNA/hAT-Charlie	807	+	97	17909272	4324
chr1	17904948	18104948	harbor1	chr1	17964730	17964852	DNA/hAT-Charlie	412	+	61	17964791	59843
chr1	17904948	18104948	harbor1	chr1	17986439	17986641	DNA/hAT-Charlie	1023	+	101	17986540	81592
chr1	31393087	31593087	harbor1	chr1	31420991	31421344	DNA/hAT-Charlie	2361	+	176	31421167	28080
chr1	215658779	215858779	harbor1	chr1	215666505	215666678	DNA/hAT-Charlie	546	+	86	215666591	7812
chr1	215658779	215858779	harbor1	chr1	215708408	215708476	DNA/hAT-Charlie	1008	+	34	215708442	49663
chr1	215658779	215858779	harbor1	chr1	215708849	215709226	DNA/hAT-Charlie	1008	+	188	215709037	50258
chr1	215658779	215858779	harbor1	chr1	215748416	215748618	DNA/hAT-Charlie	597	+	101	215748517	89738
chr1	88548172	88748172	harbor1	chr1	88572372	88572786	DNA/hAT-Charlie	1583	+	207	88572579	24407
chr1	88548172	88748172	harbor1	chr1	88616033	88616227	DNA/hAT-Charlie	878	+	97	88616130	67958
chr1	88548172	88748172	harbor1	chr1	88625440	88625635	DNA/hAT-Charlie	1045	+	98	88625538	77366
chr1	166995668	167195668	harbor1	chr1	167019087	167019297	DNA/hAT-Charlie	1157	+	105	167019192	23524
chr1	166995668	167195668	harbor1	chr1	167085545	167085698	DNA/hAT-Charlie	937	+	76	167085621	89953
chr1	166995668	167195668	harbor1	chr1	167095434	167095646	DNA/hAT-Charlie	490	+	106	167095540	99872
chr1	21172560	21372560	harbor1	chr1	21204888	21205107	DNA/hAT-Charlie	1085	+	110	21204998	32438
chr1	21172560	21372560	harbor1	chr1	21229409	21229888	DNA/hAT-Charlie	3582	+	240	21229649	57089
chr1	21172560	21372560	harbor1	chr1	21230216	21230381	DNA/hAT-Charlie	3582	+	82	21230298	57738
chr1	21172560	21372560	harbor1	chr1	21230686	21230852	DNA/hAT-Charlie	3582	+	83	21230769	58209
chr1	21172560	21372560	harbor1	chr1	21233903	21233982	DNA/hAT-Charlie	709	+	40	21233943	61383
chr1	21172560	21372560	harbor1	chr1	21234288	21234396	DNA/hAT-Charlie	709	+	54	21234342	61782
chr1	21172560	21372560	harbor1	chr1	21237049	21237234	DNA/hAT-Charlie	506	+	92	21237141	64581
chr1	164953409	165153409	harbor1	chr1	164996006	164996079	DNA/hAT-Charlie	475	+	36	164996042	42633
chr1	164953409	165153409	harbor1	chr1	164996394	164996496	DNA/hAT-Charlie	475	+	51	164996445	43036
chr1	3300137	3500137	harbor1	chr1	3357717	3357926	DNA/hAT-Charlie	679	+	104	3357821	57684
chr1	202066985	202266985	harbor1	chr1	202094904	202094995	DNA/hAT-Charlie	1654	+	46	202094950	27965
chr1	202066985	202266985	harbor1	chr1	202095282	202095551	DNA/hAT-Charlie	1654	+	134	202095416	28431
chr1	202066985	202266985	harbor1	chr1	202096401	202096524	DNA/hAT-Charlie	712	+	62	202096463	29478
chr1	202066985	202266985	harbor1	chr1	202140538	202140717	DNA/hAT-Charlie	702	+	90	202140628	73643
chr1	147613982	147813982	harbor1	chr1	147651326	147651494	DNA/hAT-Charlie	808	+	84	147651410	37428
chr1	147613982	147813982	harbor1	chr1	147658373	147658473	DNA/hAT-Charlie	543	+	50	147658423	44441
chr1	147613982	147813982	harbor1	chr1	147666687	147666788	DNA/hAT-Charlie	586	+	50	147666737	52755
chr1	147613982	147813982	harbor1	chr1	147669481	147669586	DNA/hAT-Charlie	414	+	52	147669533	55551
chr1	147613982	147813982	harbor1	chr1	147701276	147701483	DNA/hAT-Charlie	698	+	104	147701380	87398
chr1	76801715	77001715	harbor1	chr1	76826708	76826991	DNA/hAT-Charlie	743	+	142	76826850	25135
chr1	195780808	195980808	harbor1	chr1	195876259	195877018	DNA/hAT-Charlie	3141	+	380	195876639	95831
chr1	195780808	195980808	harbor1	chr1	195877316	195877459	DNA/hAT-Charlie	3141	+	72	195877388	96580
chr1	195780808	195980808	harbor1	chr1	195879380	195879908	DNA/hAT-Charlie	3141	+	264	195879644	98836
chr1	195119095	195319095	harbor1	chr1	195152576	195152853	DNA/hAT-Charlie	404	+	138	195152714	33619
chr1	195119095	195319095	harbor1	chr1	195164633	195164804	DNA/hAT-Charlie	806	+	86	195164719	45624
chr1	177703164	177903164	harbor1	chr1	177774169	177774364	DNA/hAT-Charlie	798	+	98	177774267	71103
chr1	240619405	240819405	harbor1	chr1	240632121	240632201	DNA/hAT-Charlie	1590	+	40	240632161	12756
chr1	240619405	240819405	harbor1	chr1	240631567	240631819	DNA/hAT-Charlie	1590	+	126	240631693	12288
chr1	40176712	40376712	harbor1	chr1	40201090	40201203	DNA/hAT-Charlie	596	+	56	40201146	24434
chr1	40176712	40376712	harbor1	chr1	40201749	40201975	DNA/hAT-Charlie	595	+	113	40201862	25150
chr1	40176712	40376712	harbor1	chr1	40211001	40211184	DNA/hAT-Charlie	776	+	92	40211093	34381
chr1	40176712	40376712	harbor1	chr1	40244010	40244178	DNA/hAT-Charlie	875	+	84	40244094	67382
chr1	169323770	169523770	harbor1	chr1	169371870	169372083	DNA/hAT-Charlie	621	+	106	169371976	48206
chr1	169323770	169523770	harbor1	chr1	169372866	169373133	DNA/hAT-Charlie	1116	+	134	169373000	49230
chr1	169323770	169523770	harbor1	chr1	169387574	169387652	DNA/hAT-Charlie	419	+	39	169387613	63843
chr1	196966759	197166759	harbor1	chr1	196972938	196973141	DNA/hAT-Charlie	636	+	102	196973040	6281
chr1	218695033	218895033	harbor1	chr1	218726992	218727529	DNA/hAT-Charlie	2238	+	268	218727260	32227
chr1	88781685	88981685	harbor1	chr1	88822322	88822453	DNA/hAT-Charlie	553	+	66	88822388	40703
chr1	71611143	71811143	harbor1	chr1	71616180	71618800	DNA/hAT-Charlie	19002	+	1310	71617490	6347
chr1	71611143	71811143	harbor1	chr1	71625889	71626167	DNA/hAT-Charlie	1603	+	139	71626028	14885
chr1	71611143	71811143	harbor1	chr1	71652411	71652589	DNA/hAT-Charlie	752	+	89	71652500	41357
chr1	71611143	71811143	harbor1	chr1	71652878	71652892	DNA/hAT-Charlie	752	+	7	71652885	41742
chr1	86107127	86307127	harbor1	chr1	86194118	86194324	DNA/hAT-Charlie	1198	+	103	86194221	87094
chr1	50312631	50512631	harbor1	chr1	50324811	50325252	DNA/hAT-Charlie	2074	+	220	50325031	12400
chr1	50312631	50512631	harbor1	chr1	50372341	50372513	DNA/hAT-Charlie	407	+	86	50372427	59796
chr1	93511514	93711514	harbor1	chr1	93523670	93523981	DNA/hAT-Charlie	1370	+	156	93523826	12312
chr1	93511514	93711514	harbor1	chr1	93592813	93593076	DNA/hAT-Charlie	643	+	132	93592945	81431
chr1	118485714	118685714	harbor1	chr1	118508376	118508531	DNA/hAT-Charlie	628	+	78	118508454	22740
chr1	150030465	150230465	harbor1	chr1	150043045	150043236	DNA/hAT-Charlie	548	+	96	150043141	12676
chr1	150030465	150230465	harbor1	chr1	150108307	150108480	DNA/hAT-Charlie	723	+	86	150108393	77928
chr1	150030465	150230465	harbor1	chr1	150127080	150127259	DNA/hAT-Charlie	892	+	90	150127170	96705
chr1	57674615	57874615	harbor1	chr1	57712452	57712688	DNA/hAT-Charlie	616	+	118	57712570	37955
chr1	57674615	57874615	harbor1	chr1	57749403	57749600	DNA/hAT-Charlie	664	+	98	57749501	74886
chr1	57674615	57874615	harbor1	chr1	57761106	57761367	DNA/hAT-Charlie	798	+	130	57761236	86621
chr1	88994811	89194811	harbor1	chr1	89006401	89006602	DNA/hAT-Charlie	812	+	100	89006501	11690
chr1	88994811	89194811	harbor1	chr1	89011408	89011522	DNA/hAT-Charlie	418	+	57	89011465	16654
chr1	88994811	89194811	harbor1	chr1	89012138	89012261	DNA/hAT-Charlie	467	+	62	89012200	17389
chr1	88994811	89194811	harbor1	chr1	89012463	89012665	DNA/hAT-Charlie	719	+	101	89012564	17753
chr1	88994811	89194811	harbor1	chr1	89052024	89052222	DNA/hAT-Charlie	846	+	99	89052123	57312
chr1	88994811	89194811	harbor1	chr1	89057244	89057363	DNA/hAT-Charlie	506	+	60	89057304	62493
chr1	154830364	155030364	harbor1	chr1	154841331	154841506	DNA/hAT-Charlie	889	+	88	154841419	11055
chr1	154830364	155030364	harbor1	chr1	154852143	154852207	DNA/hAT-Charlie	1687	+	32	154852175	21811
chr1	154830364	155030364	harbor1	chr1	154852513	154852840	DNA/hAT-Charlie	1687	+	164	154852677	22313
chr1	154830364	155030364	harbor1	chr1	154910581	154910792	DNA/hAT-Charlie	621	+	106	154910687	80323
chr1	234926773	235126773	harbor1	chr1	234933929	234933975	DNA/hAT-Charlie	868	+	23	234933952	7179
chr1	234926773	235126773	harbor1	chr1	234934586	234934880	DNA/hAT-Charlie	868	+	147	234934733	7960
chr1	234926773	235126773	harbor1	chr1	234935013	234935307	DNA/hAT-Charlie	868	+	147	234935160	8387
chr1	234926773	235126773	harbor1	chr1	234935583	234935937	DNA/hAT-Charlie	868	+	177	234935760	8987
chr1	234926773	235126773	harbor1	chr1	234996507	234996718	DNA/hAT-Charlie	994	+	106	234996613	69840
chr1	165787383	165987383	harbor1	chr1	165811228	165811530	DNA/hAT-Charlie	576	+	151	165811379	23996
chr1	98296871	98496871	harbor1	chr1	98318701	98318816	DNA/hAT-Charlie	400	+	58	98318759	21888
chr1	98296871	98496871	harbor1	chr1	98325888	98326047	DNA/hAT-Charlie	465	+	80	98325968	29097
chr1	98296871	98496871	harbor1	chr1	98370606	98370819	DNA/hAT-Charlie	1147	+	106	98370712	73841
chr1	98296871	98496871	harbor1	chr1	98372772	98372993	DNA/hAT-Charlie	1071	+	110	98372882	76011
chr1	16387386	16587386	harbor1	chr1	16431797	16431907	DNA/hAT-Charlie	449	+	55	16431852	44466
chr1	16387386	16587386	harbor1	chr1	16443236	16443542	DNA/hAT-Charlie	803	+	153	16443389	56003
chr1	216654338	216854338	harbor1	chr1	216669013	216669166	DNA/hAT-Charlie	504	+	76	216669089	14751
chr1	216654338	216854338	harbor1	chr1	216675825	216676004	DNA/hAT-Charlie	665	+	90	216675915	21577
chr1	216654338	216854338	harbor1	chr1	216676497	216676692	DNA/hAT-Charlie	1059	+	98	216676595	22257
chr1	216654338	216854338	harbor1	chr1	216736709	216736868	DNA/hAT-Charlie	760	+	80	216736789	82451
chr1	216654338	216854338	harbor1	chr1	216738067	216738213	DNA/hAT-Charlie	435	+	73	216738140	83802
chr1	216654338	216854338	harbor1	chr1	216739529	216739688	DNA/hAT-Charlie	766	+	80	216739609	85271
chr1	146999194	147199194	harbor1	chr1	147031918	147032131	DNA/hAT-Charlie	1026	+	106	147032024	32830
chr1	146999194	147199194	harbor1	chr1	147072013	147072192	DNA/hAT-Charlie	816	+	90	147072103	72909
chr1	221487667	221687667	harbor1	chr1	221525976	221526183	DNA/hAT-Charlie	975	+	104	221526080	38413
chr1	221487667	221687667	harbor1	chr1	221552738	221552934	DNA/hAT-Charlie	890	+	98	221552836	65169
chr1	221487667	221687667	harbor1	chr1	221575482	221575818	DNA/hAT-Charlie	1913	+	168	221575650	87983
chr1	199229925	199429925	harbor1	chr1	199313652	199313862	DNA/hAT-Charlie	639	+	105	199313757	83832
chr1	14714041	14914041	harbor1	chr1	14726707	14726876	DNA/hAT-Charlie	940	+	84	14726791	12750
chr1	14714041	14914041	harbor1	chr1	14729836	14730075	DNA/hAT-Charlie	1042	+	120	14729956	15915
chr1	14714041	14914041	harbor1	chr1	14731959	14732356	DNA/hAT-Charlie	2480	+	198	14732157	18116
chr1	14714041	14914041	harbor1	chr1	14732667	14732867	DNA/hAT-Charlie	2480	+	100	14732767	18726
chr1	14714041	14914041	harbor1	chr1	14802426	14802627	DNA/hAT-Charlie	719	+	100	14802526	88485
chr1	90358234	90558234	harbor1	chr1	90370840	90370967	DNA/hAT-Charlie	672	+	64	90370904	12670
chr1	90358234	90558234	harbor1	chr1	90371727	90371902	DNA/hAT-Charlie	683	+	88	90371815	13581
chr1	90358234	90558234	harbor1	chr1	90406360	90406505	DNA/hAT-Charlie	541	+	72	90406432	48198
chr1	98857149	99057149	harbor1	chr1	98928199	98928604	DNA/hAT-Charlie	1315	+	202	98928401	71252
chr1	98857149	99057149	harbor1	chr1	98947145	98947288	DNA/hAT-Charlie	676	+	72	98947217	90068
chr1	199266646	199466646	harbor1	chr1	199313652	199313862	DNA/hAT-Charlie	639	+	105	199313757	47111
chr1	51722227	51922227	harbor1	chr1	51809549	51809614	DNA/hAT-Charlie	799	+	32	51809581	87354
chr1	51722227	51922227	harbor1	chr1	51809936	51810033	DNA/hAT-Charlie	799	+	48	51809984	87757
chr1	86387472	86587472	harbor1	chr1	86399158	86399304	DNA/hAT-Charlie	584	+	73	86399231	11759
chr1	86387472	86587472	harbor1	chr1	86399318	86399479	DNA/hAT-Charlie	579	+	80	86399398	11926
chr1	86387472	86587472	harbor1	chr1	86399518	86399656	DNA/hAT-Charlie	561	+	69	86399587	12115
chr1	86387472	86587472	harbor1	chr1	86435858	86436168	DNA/hAT-Charlie	1420	+	155	86436013	48541
chr1	115090116	115290116	harbor1	chr1	115186454	115186613	DNA/hAT-Charlie	770	+	80	115186534	96418
chr1	218310499	218510499	harbor1	chr1	218335473	218335648	DNA/hAT-Charlie	872	+	88	218335561	25062
chr1	218310499	218510499	harbor1	chr1	218343781	218344008	DNA/hAT-Charlie	736	+	114	218343895	33396
chr1	218310499	218510499	harbor1	chr1	218350317	218350513	DNA/hAT-Charlie	940	+	98	218350415	39916
chr1	218310499	218510499	harbor1	chr1	218363896	218364113	DNA/hAT-Charlie	1498	+	108	218364004	53505
chr1	218310499	218510499	harbor1	chr1	218406361	218406509	DNA/hAT-Charlie	805	+	74	218406435	95936
chr1	209621836	209821836	harbor1	chr1	209631501	209631654	DNA/hAT-Charlie	515	+	76	209631577	9741
chr1	209621836	209821836	harbor1	chr1	209678768	209678968	DNA/hAT-Charlie	897	+	100	209678868	57032
chr1	209621836	209821836	harbor1	chr1	209702496	209702671	DNA/hAT-Charlie	735	+	88	209702584	80748
chr1	209621836	209821836	harbor1	chr1	209702671	209702813	DNA/hAT-Charlie	634	+	71	209702742	80906
chr1	234318168	234518168	harbor1	chr1	234341880	234342078	DNA/hAT-Charlie	448	+	99	234341979	23811
chr1	14180074	14380074	harbor1	chr1	14187595	14187783	DNA/hAT-Charlie	1053	+	94	14187689	7615
chr1	14180074	14380074	harbor1	chr1	14229976	14230161	DNA/hAT-Charlie	989	+	92	14230068	49994
chr1	14180074	14380074	harbor1	chr1	14239793	14239993	DNA/hAT-Charlie	697	+	100	14239893	59819
chr1	14180074	14380074	harbor1	chr1	14261924	14262133	DNA/hAT-Charlie	532	+	104	14262028	81954
chr1	14180074	14380074	harbor1	chr1	14262263	14262317	DNA/hAT-Charlie	532	+	27	14262290	82216
chr1	14180074	14380074	harbor1	chr1	14269120	14269346	DNA/hAT-Charlie	1154	+	113	14269233	89159
chr1	14180074	14380074	harbor1	chr1	14275247	14275414	DNA/hAT-Charlie	998	+	84	14275331	95257
chr1	53570730	53770730	harbor1	chr1	53617138	53617553	DNA/hAT-Charlie	1404	+	208	53617346	46616
chr1	53570730	53770730	harbor1	chr1	53617581	53617811	DNA/hAT-Charlie	592	+	115	53617696	46966
chr1	95611964	95811964	harbor1	chr1	95625979	95626203	DNA/hAT-Charlie	1007	+	112	95626091	14127
chr1	95611964	95811964	harbor1	chr1	95626202	95626342	DNA/hAT-Charlie	601	+	70	95626272	14308
chr1	95611964	95811964	harbor1	chr1	95650717	95650858	DNA/hAT-Charlie	620	+	70	95650787	38823
chr1	95611964	95811964	harbor1	chr1	95651358	95651503	DNA/hAT-Charlie	436	+	72	95651430	39466
chr1	95611964	95811964	harbor1	chr1	95680143	95680312	DNA/hAT-Charlie	690	+	84	95680227	68263
chr1	179729439	179929439	harbor1	chr1	179739425	179739654	DNA/hAT-Charlie	1470	+	114	179739539	10100
chr1	179729439	179929439	harbor1	chr1	179772435	179772591	DNA/hAT-Charlie	875	+	78	179772513	43074
chr1	179729439	179929439	harbor1	chr1	179774390	179774511	DNA/hAT-Charlie	551	+	60	179774450	45011
chr1	179729439	179929439	harbor1	chr1	179780519	179780693	DNA/hAT-Charlie	1125	+	87	179780606	51167
chr1	105195212	105395212	harbor1	chr1	105236764	105236955	DNA/hAT-Charlie	566	+	96	105236860	41648
chr1	207459715	207659715	harbor1	chr1	207468241	207468464	DNA/hAT-Charlie	1562	+	112	207468353	8638
chr1	207459715	207659715	harbor1	chr1	207492482	207492696	DNA/hAT-Charlie	1166	+	107	207492589	32874
chr1	207459715	207659715	harbor1	chr1	207499767	207499975	DNA/hAT-Charlie	576	+	104	207499871	40156
chr1	207459715	207659715	harbor1	chr1	207500007	207500225	DNA/hAT-Charlie	473	+	109	207500116	40401
chr1	207459715	207659715	harbor1	chr1	207504805	207505131	DNA/hAT-Charlie	2082	+	163	207504968	45253
chr1	49680967	49880967	harbor1	chr1	49713003	49713351	DNA/hAT-Charlie	1091	+	174	49713177	32210
chr1	49680967	49880967	harbor1	chr1	49713407	49713813	DNA/hAT-Charlie	678	+	203	49713610	32643
chr1	176660658	176860658	harbor1	chr1	176687836	176688055	DNA/hAT-Charlie	424	+	110	176687946	27288
chr1	176660658	176860658	harbor1	chr1	176704494	176704631	DNA/hAT-Charlie	475	+	68	176704562	43904
chr1	176660658	176860658	harbor1	chr1	176704630	176704971	DNA/hAT-Charlie	1536	+	170	176704800	44142
chr1	176660658	176860658	harbor1	chr1	176732594	176732745	DNA/hAT-Charlie	733	+	76	176732670	72012
chr1	176660658	176860658	harbor1	chr1	176732846	176733191	DNA/hAT-Charlie	2042	+	172	176733018	72360
chr1	176660658	176860658	harbor1	chr1	176760450	176760584	DNA/hAT-Charlie	397	+	67	176760517	99859
chr1	244459010	244659010	harbor1	chr1	244462980	244463303	DNA/hAT-Charlie	1051	+	162	244463142	4132
chr1	244459010	244659010	harbor1	chr1	244483136	244483297	DNA/hAT-Charlie	692	+	80	244483216	24206
chr1	244459010	244659010	harbor1	chr1	244490639	244491012	DNA/hAT-Charlie	1091	+	186	244490825	31815
chr1	150471267	150671267	harbor1	chr1	150522650	150522828	DNA/hAT-Charlie	753	+	89	150522739	51472
chr1	150471267	150671267	harbor1	chr1	150529569	150529600	DNA/hAT-Charlie	426	+	16	150529585	58318
chr1	150471267	150671267	harbor1	chr1	150529897	150530015	DNA/hAT-Charlie	426	+	59	150529956	58689
chr1	40192911	40392911	harbor1	chr1	40201090	40201203	DNA/hAT-Charlie	596	+	56	40201146	8235
chr1	40192911	40392911	harbor1	chr1	40201749	40201975	DNA/hAT-Charlie	595	+	113	40201862	8951
chr1	40192911	40392911	harbor1	chr1	40211001	40211184	DNA/hAT-Charlie	776	+	92	40211093	18182
chr1	40192911	40392911	harbor1	chr1	40244010	40244178	DNA/hAT-Charlie	875	+	84	40244094	51183
chr1	85706262	85906262	harbor1	chr1	85715489	85715720	DNA/hAT-Charlie	1578	+	116	85715605	9343
chr1	85706262	85906262	harbor1	chr1	85716020	85716087	DNA/hAT-Charlie	1578	+	34	85716054	9792
chr1	85706262	85906262	harbor1	chr1	85786950	85787195	DNA/hAT-Charlie	1100	+	122	85787072	80810
chr1	85706262	85906262	harbor1	chr1	85790544	85791456	DNA/hAT-Charlie	3529	+	456	85791000	84738
chr1	85706262	85906262	harbor1	chr1	85791457	85791830	DNA/hAT-Charlie	1712	+	186	85791643	85381
chr1	85706262	85906262	harbor1	chr1	85791955	85792164	DNA/hAT-Charlie	538	+	104	85792059	85797
chr1	55316616	55516616	harbor1	chr1	55338873	55339089	DNA/hAT-Charlie	735	+	108	55338981	22365
chr1	55316616	55516616	harbor1	chr1	55341773	55341942	DNA/hAT-Charlie	468	+	84	55341857	25241
chr1	18576910	18776910	harbor1	chr1	18608723	18608942	DNA/hAT-Charlie	954	+	110	18608833	31923
chr1	18576910	18776910	harbor1	chr1	18668041	18668205	DNA/hAT-Charlie	795	+	82	18668123	91213
chr1	18576910	18776910	harbor1	chr1	18674821	18674975	DNA/hAT-Charlie	539	+	77	18674898	97988
chr1	103976521	104176521	harbor1	chr1	103982374	103982705	DNA/hAT-Charlie	986	+	166	103982540	6019
chr1	103976521	104176521	harbor1	chr1	104040772	104040995	DNA/hAT-Charlie	503	+	112	104040884	64363
chr1	103976521	104176521	harbor1	chr1	104060808	104061176	DNA/hAT-Charlie	484	+	184	104060992	84471
chr1	103976521	104176521	harbor1	chr1	104075628	104075744	DNA/hAT-Charlie	511	+	58	104075686	99165
chr1	108162342	108362342	harbor1	chr1	108184594	108184815	DNA/hAT-Charlie	1003	+	110	108184704	22362
chr1	108162342	108362342	harbor1	chr1	108202451	108202590	DNA/hAT-Charlie	556	+	70	108202521	40179
chr1	108162342	108362342	harbor1	chr1	108202625	108202800	DNA/hAT-Charlie	596	+	88	108202713	40371
chr1	108162342	108362342	harbor1	chr1	108225386	108225528	DNA/hAT-Charlie	402	+	71	108225457	63115
chr1	110012496	110212496	harbor1	chr1	110027492	110027811	DNA/hAT-Charlie	1529	+	160	110027652	15156
chr1	110012496	110212496	harbor1	chr1	110081586	110081656	DNA/hAT-Charlie	1022	+	35	110081621	69125
chr1	110012496	110212496	harbor1	chr1	110081956	110082081	DNA/hAT-Charlie	1022	+	62	110082018	69522
chr1	202516063	202716063	harbor1	chr1	202575713	202575822	DNA/hAT-Charlie	407	+	54	202575767	59704
chr1	202516063	202716063	harbor1	chr1	202577243	202577506	DNA/hAT-Charlie	1334	+	132	202577375	61312
chr1	198218231	198418231	harbor1	chr1	198223380	198224136	DNA/hAT-Charlie	3021	+	378	198223758	5527
chr1	198218231	198418231	harbor1	chr1	198224518	198224832	DNA/hAT-Charlie	1008	+	157	198224675	6444
chr1	198218231	198418231	harbor1	chr1	198233586	198233751	DNA/hAT-Charlie	612	+	82	198233668	15437
chr1	31466198	31666198	harbor1	chr1	31508497	31508826	DNA/hAT-Charlie	696	+	164	31508661	42463
chr1	8856868	9056868	harbor1	chr1	8902689	8902875	DNA/hAT-Charlie	1224	+	93	8902782	45914
chr1	193475728	193675728	harbor1	chr1	193505797	193506091	DNA/hAT-Charlie	1537	+	147	193505944	30216
chr1	91655636	91855636	harbor1	chr1	91699911	91700200	DNA/hAT-Charlie	1437	+	144	91700055	44419
chr1	91655636	91855636	harbor1	chr1	91701971	91702197	DNA/hAT-Charlie	969	+	113	91702084	46448
chr1	91655636	91855636	harbor1	chr1	91720501	91720680	DNA/hAT-Charlie	849	+	90	91720591	64955
chr1	91655636	91855636	harbor1	chr1	91743717	91743834	DNA/hAT-Charlie	394	+	58	91743775	88139
chr1	91655636	91855636	harbor1	chr1	91743864	91744086	DNA/hAT-Charlie	932	+	111	91743975	88339
chr1	91655636	91855636	harbor1	chr1	91744386	91744473	DNA/hAT-Charlie	932	+	44	91744430	88794
chr1	66360768	66560768	harbor1	chr1	66437950	66438158	DNA/hAT-Charlie	1178	+	104	66438054	77286
chr1	66360768	66560768	harbor1	chr1	66436860	66437932	DNA/hAT-Charlie	3187	+	536	66437396	76628
chr1	181217203	181417203	harbor1	chr1	181223922	181224074	DNA/hAT-Charlie	452	+	76	181223998	6795
chr1	49172083	49372083	harbor1	chr1	49188928	49189101	DNA/hAT-Charlie	732	+	86	49189014	16931
chr1	53768516	53968516	harbor1	chr1	53771483	53771654	DNA/hAT-Charlie	763	+	86	53771569	3053
chr1	53768516	53968516	harbor1	chr1	53776308	53776613	DNA/hAT-Charlie	1547	+	152	53776460	7944
chr1	53768516	53968516	harbor1	chr1	53777483	53777662	DNA/hAT-Charlie	648	+	90	53777573	9057
chr1	53768516	53968516	harbor1	chr1	53782612	53783080	DNA/hAT-Charlie	1888	+	234	53782846	14330
chr1	53768516	53968516	harbor1	chr1	53784102	53784224	DNA/hAT-Charlie	511	+	61	53784163	15647
chr1	53768516	53968516	harbor1	chr1	53784259	53784318	DNA/hAT-Charlie	511	+	30	53784289	15773
chr1	53768516	53968516	harbor1	chr1	53799510	53799785	DNA/hAT-Charlie	738	+	138	53799648	31132
chr1	53768516	53968516	harbor1	chr1	53849758	53850037	DNA/hAT-Charlie	642	+	140	53849898	81382
chr1	163412508	163612508	harbor1	chr1	163435416	163435570	DNA/hAT-Charlie	682	+	77	163435493	22985
chr1	175893864	176093864	harbor1	chr1	175934056	175934274	DNA/hAT-Charlie	1610	+	109	175934165	40301
chr1	175893864	176093864	harbor1	chr1	175935975	175936088	DNA/hAT-Charlie	484	+	56	175936031	42167
chr1	175893864	176093864	harbor1	chr1	175937576	175937723	DNA/hAT-Charlie	870	+	74	175937650	43786
chr1	175893864	176093864	harbor1	chr1	175944167	175944360	DNA/hAT-Charlie	773	+	96	175944263	50399
chr1	102971453	103171453	harbor1	chr1	103055637	103055821	DNA/hAT-Charlie	1025	+	92	103055729	84276
chr1	117850570	118050570	harbor1	chr1	117853134	117853443	DNA/hAT-Charlie	1363	+	154	117853288	2718
chr1	117850570	118050570	harbor1	chr1	117864119	117864783	DNA/hAT-Charlie	1923	+	332	117864451	13881
chr1	117850570	118050570	harbor1	chr1	117864983	117865143	DNA/hAT-Charlie	716	+	80	117865063	14493
chr1	117850570	118050570	harbor1	chr1	117894313	117894471	DNA/hAT-Charlie	758	+	79	117894392	43822
chr1	117850570	118050570	harbor1	chr1	117894477	117895566	DNA/hAT-Charlie	4144	+	544	117895021	44451
chr1	117850570	118050570	harbor1	chr1	117910883	117911003	DNA/hAT-Charlie	423	+	60	117910943	60373
chr1	117850570	118050570	harbor1	chr1	117932313	117932513	DNA/hAT-Charlie	801	+	100	117932413	81843
chr1	59514821	59714821	harbor1	chr1	59519900	59520125	DNA/hAT-Charlie	1300	+	112	59520012	5191
chr1	26059916	26259916	harbor1	chr1	26059764	26059928	DNA/hAT-Charlie	691	+	82	26059846	70
chr1	26059916	26259916	harbor1	chr1	26120101	26120248	DNA/hAT-Charlie	434	+	74	26120175	60259
chr1	227402611	227602611	harbor1	chr1	227427403	227427657	DNA/hAT-Charlie	618	+	127	227427530	24919
chr1	227402611	227602611	harbor1	chr1	227430265	227430419	DNA/hAT-Charlie	568	+	77	227430342	27731
chr1	227402611	227602611	harbor1	chr1	227439459	227439534	DNA/hAT-Charlie	928	+	38	227439497	36886
chr1	227402611	227602611	harbor1	chr1	227439843	227439965	DNA/hAT-Charlie	928	+	61	227439904	37293
chr1	60147330	60347330	harbor1	chr1	60174254	60174432	DNA/hAT-Charlie	660	+	89	60174343	27013
chr1	107817780	108017780	harbor1	chr1	107824995	107825208	DNA/hAT-Charlie	894	+	106	107825101	7321
chr1	107817780	108017780	harbor1	chr1	107841750	107842006	DNA/hAT-Charlie	1098	+	128	107841878	24098
chr1	107817780	108017780	harbor1	chr1	107858452	107858764	DNA/hAT-Charlie	1803	+	156	107858608	40828
chr1	107817780	108017780	harbor1	chr1	107901267	107901760	DNA/hAT-Charlie	2192	+	246	107901513	83733
chr1	107817780	108017780	harbor1	chr1	107902074	107902168	DNA/hAT-Charlie	2192	+	47	107902121	84341
chr1	29020983	29220983	harbor1	chr1	29021163	29021577	DNA/hAT-Charlie	5589	+	207	29021370	387
chr1	29020983	29220983	harbor1	chr1	29021880	29022440	DNA/hAT-Charlie	5589	+	280	29022160	1177
chr1	29020983	29220983	harbor1	chr1	29022738	29022997	DNA/hAT-Charlie	5589	+	130	29022868	1885
chr1	29020983	29220983	harbor1	chr1	29023294	29023405	DNA/hAT-Charlie	5589	+	56	29023350	2367
chr1	29020983	29220983	harbor1	chr1	29023712	29023795	DNA/hAT-Charlie	5589	+	42	29023754	2771
chr1	29020983	29220983	harbor1	chr1	29031488	29031663	DNA/hAT-Charlie	912	+	88	29031576	10593
chr1	29020983	29220983	harbor1	chr1	29043402	29043582	DNA/hAT-Charlie	645	+	90	29043492	22509
chr1	92885729	93085729	harbor1	chr1	92886775	92886999	DNA/hAT-Charlie	1128	+	112	92886887	1158
chr1	92885729	93085729	harbor1	chr1	92952088	92952241	DNA/hAT-Charlie	860	+	76	92952164	66435
chr1	92885729	93085729	harbor1	chr1	92968117	92968401	DNA/hAT-Charlie	562	+	142	92968259	82530
chr1	52385685	52585685	harbor1	chr1	52387138	52387434	DNA/hAT-Charlie	1765	+	148	52387286	1601
chr1	52385685	52585685	harbor1	chr1	52442906	52443006	DNA/hAT-Charlie	788	+	50	52442956	57271
chr1	52385685	52585685	harbor1	chr1	52443602	52443616	DNA/hAT-Charlie	788	+	7	52443609	57924
chr1	52385685	52585685	harbor1	chr1	52443780	52443931	DNA/hAT-Charlie	741	+	76	52443856	58171
chr1	52385685	52585685	harbor1	chr1	52461886	52462050	DNA/hAT-Charlie	962	+	82	52461968	76283
chr1	52385685	52585685	harbor1	chr1	52471520	52471720	DNA/hAT-Charlie	897	+	100	52471620	85935
chr1	184758351	184958351	harbor1	chr1	184767723	184768036	DNA/hAT-Charlie	1761	+	156	184767879	9528
chr1	184758351	184958351	harbor1	chr1	184771653	184771861	DNA/hAT-Charlie	993	+	104	184771757	13406
chr1	184758351	184958351	harbor1	chr1	184803354	184803483	DNA/hAT-Charlie	702	+	64	184803418	45067
chr1	50806559	51006559	harbor1	chr1	50831867	50832273	DNA/hAT-Charlie	2853	+	203	50832070	25511
chr1	50806559	51006559	harbor1	chr1	50858463	50858743	DNA/hAT-Charlie	1112	+	140	50858603	52044
chr1	50806559	51006559	harbor1	chr1	50879673	50879856	DNA/hAT-Charlie	1177	+	92	50879765	73206
chr1	50806559	51006559	harbor1	chr1	50902247	50902541	DNA/hAT-Charlie	1212	+	147	50902394	95835
chr1	51097160	51297160	harbor1	chr1	51144152	51144299	DNA/hAT-Charlie	732	+	74	51144226	47066
chr1	51097160	51297160	harbor1	chr1	51185696	51185795	DNA/hAT-Charlie	575	+	50	51185746	88586
chr1	51097160	51297160	harbor1	chr1	51192277	51192495	DNA/hAT-Charlie	848	+	109	51192386	95226
chr1	5448447	5648447	harbor1	chr1	5491815	5492009	DNA/hAT-Charlie	880	+	97	5491912	43465
chr1	5448447	5648447	harbor1	chr1	5508949	5509116	DNA/hAT-Charlie	447	+	84	5509033	60586
chr1	236545939	236745939	harbor1	chr1	236552624	236553067	DNA/hAT-Charlie	912	+	222	236552846	6907
chr1	236545939	236745939	harbor1	chr1	236575315	236575530	DNA/hAT-Charlie	1127	+	108	236575423	29484
chr1	236545939	236745939	harbor1	chr1	236641901	236642317	DNA/hAT-Charlie	1588	+	208	236642109	96170
chr1	146538911	146738911	harbor1	chr1	146548664	146549184	DNA/hAT-Charlie	3967	+	260	146548924	10013
chr1	146538911	146738911	harbor1	chr1	146564667	146565164	DNA/hAT-Charlie	787	+	248	146564915	26004
chr1	146538911	146738911	harbor1	chr1	146582486	146582613	DNA/hAT-Charlie	498	+	64	146582550	43639
chr1	146538911	146738911	harbor1	chr1	146613822	146613976	DNA/hAT-Charlie	640	+	77	146613899	74988
chr1	144643139	144843139	harbor1	chr1	144673130	144673347	DNA/hAT-Charlie	757	+	108	144673238	30099
chr1	144643139	144843139	harbor1	chr1	144694852	144695056	DNA/hAT-Charlie	796	+	102	144694954	51815
chr1	91130897	91330897	harbor1	chr1	91134484	91134809	DNA/hAT-Charlie	681	+	162	91134646	3749
chr1	91130897	91330897	harbor1	chr1	91194338	91194528	DNA/hAT-Charlie	1177	+	95	91194433	63536
chr1	91130897	91330897	harbor1	chr1	91202780	91202886	DNA/hAT-Charlie	672	+	53	91202833	71936
chr1	91130897	91330897	harbor1	chr1	91203210	91203268	DNA/hAT-Charlie	672	+	29	91203239	72342
chr1	184789190	184989190	harbor1	chr1	184803354	184803483	DNA/hAT-Charlie	702	+	64	184803418	14228
chr1	184789190	184989190	harbor1	chr1	184868985	184869083	DNA/hAT-Charlie	488	+	49	184869034	79844
chr1	184789190	184989190	harbor1	chr1	184883650	184883827	DNA/hAT-Charlie	604	+	88	184883738	94548
chr1	228153397	228353397	harbor1	chr1	228167250	228167352	DNA/hAT-Charlie	533	+	51	228167301	13904
chr1	228153397	228353397	harbor1	chr1	228167657	228167754	DNA/hAT-Charlie	533	+	48	228167705	14308
chr1	234880125	235080125	harbor1	chr1	234924568	234924628	DNA/hAT-Charlie	431	+	30	234924598	44473
chr1	234880125	235080125	harbor1	chr1	234933929	234933975	DNA/hAT-Charlie	868	+	23	234933952	53827
chr1	234880125	235080125	harbor1	chr1	234934586	234934880	DNA/hAT-Charlie	868	+	147	234934733	54608
chr1	234880125	235080125	harbor1	chr1	234935013	234935307	DNA/hAT-Charlie	868	+	147	234935160	55035
chr1	234880125	235080125	harbor1	chr1	234935583	234935937	DNA/hAT-Charlie	868	+	177	234935760	55635
chr1	246725797	246925797	harbor1	chr1	246814595	246814918	DNA/hAT-Charlie	1304	+	162	246814757	88960
chr1	163245512	163445512	harbor1	chr1	163303661	163304043	DNA/hAT-Charlie	1805	+	191	163303852	58340
chr1	163245512	163445512	harbor1	chr1	163339730	163340232	DNA/hAT-Charlie	2107	+	251	163339981	94469
chr1	57953272	58153272	harbor1	chr1	57971931	57972174	DNA/hAT-Charlie	712	+	122	57972053	18781
chr1	57953272	58153272	harbor1	chr1	57999543	57999753	DNA/hAT-Charlie	1225	+	105	57999648	46376
chr1	57953272	58153272	harbor1	chr1	58023378	58023527	DNA/hAT-Charlie	523	+	74	58023452	70180
chr1	57953272	58153272	harbor1	chr1	58037359	58037711	DNA/hAT-Charlie	2351	+	176	58037535	84263
chr1	57953272	58153272	harbor1	chr1	57999297	57999465	DNA/hAT-Charlie	772	+	84	57999381	46109
chr1	57953272	58153272	harbor1	chr1	58032061	58032224	DNA/hAT-Charlie	856	+	82	58032143	78871
chr1	63234272	63434272	harbor1	chr1	63260848	63261047	DNA/hAT-Charlie	1081	+	100	63260948	26676
chr1	63234272	63434272	harbor1	chr1	63303650	63303887	DNA/hAT-Charlie	647	+	118	63303768	69496
chr1	63234272	63434272	harbor1	chr1	63311427	63311545	DNA/hAT-Charlie	687	+	59	63311486	77214
chr1	63234272	63434272	harbor1	chr1	63311862	63311969	DNA/hAT-Charlie	687	+	54	63311916	77644
chr1	147973195	148173195	harbor1	chr1	147985447	147985583	DNA/hAT-Charlie	693	+	68	147985515	12320
chr1	147973195	148173195	harbor1	chr1	148065363	148065451	DNA/hAT-Charlie	801	+	44	148065407	92212
chr1	147973195	148173195	harbor1	chr1	148065888	148066071	DNA/hAT-Charlie	801	+	92	148065980	92785
chr1	147973195	148173195	harbor1	chr1	148066384	148066453	DNA/hAT-Charlie	801	+	34	148066418	93223
chr1	20233635	20433635	harbor1	chr1	20258731	20258901	DNA/hAT-Charlie	687	+	85	20258816	25181
chr1	20233635	20433635	harbor1	chr1	20264798	20264957	DNA/hAT-Charlie	735	+	80	20264878	31243
chr1	20233635	20433635	harbor1	chr1	20312111	20312266	DNA/hAT-Charlie	698	+	78	20312189	78554
chr1	176884080	177084080	harbor1	chr1	176910705	176911033	DNA/hAT-Charlie	2021	+	164	176910869	26789
chr1	176884080	177084080	harbor1	chr1	176925345	176925507	DNA/hAT-Charlie	944	+	81	176925426	41346
chr1	176884080	177084080	harbor1	chr1	176934623	176934861	DNA/hAT-Charlie	530	+	119	176934742	50662
chr1	176884080	177084080	harbor1	chr1	176940767	176941001	DNA/hAT-Charlie	499	+	117	176940884	56804
chr1	176884080	177084080	harbor1	chr1	176966266	176967002	DNA/hAT-Charlie	1108	+	368	176966634	82554
chr1	243362060	243562060	harbor1	chr1	243371784	243371962	DNA/hAT-Charlie	725	+	89	243371873	9813
chr1	243362060	243562060	harbor1	chr1	243372994	243373170	DNA/hAT-Charlie	708	+	88	243373082	11022
chr1	243362060	243562060	harbor1	chr1	243382327	243382606	DNA/hAT-Charlie	923	+	140	243382467	20407
chr1	243362060	243562060	harbor1	chr1	243389464	243389702	DNA/hAT-Charlie	456	+	119	243389583	27523
chr1	243362060	243562060	harbor1	chr1	243400121	243400333	DNA/hAT-Charlie	648	+	106	243400227	38167
chr1	243362060	243562060	harbor1	chr1	243403607	243403987	DNA/hAT-Charlie	2582	+	190	243403797	41737
chr1	243362060	243562060	harbor1	chr1	243412496	243412712	DNA/hAT-Charlie	1110	+	108	243412604	50544
chr1	243362060	243562060	harbor1	chr1	243431577	243432207	DNA/hAT-Charlie	1410	+	315	243431892	69832
chr1	243362060	243562060	harbor1	chr1	243432531	243432687	DNA/hAT-Charlie	1410	+	78	243432609	70549
chr1	243362060	243562060	harbor1	chr1	243433833	243434271	DNA/hAT-Charlie	1224	+	219	243434052	71992
chr1	180386978	180586978	harbor1	chr1	180417098	180417345	DNA/hAT-Charlie	669	+	124	180417222	30244
chr1	180386978	180586978	harbor1	chr1	180437948	180438299	DNA/hAT-Charlie	2046	+	176	180438124	51146
chr1	180386978	180586978	harbor1	chr1	180442270	180442491	DNA/hAT-Charlie	774	+	110	180442380	55402
chr1	180386978	180586978	harbor1	chr1	180466510	180466593	DNA/hAT-Charlie	440	+	42	180466552	79574
chr1	180386978	180586978	harbor1	chr1	180480713	180480749	DNA/hAT-Charlie	513	+	18	180480731	93753
chr1	180386978	180586978	harbor1	chr1	180481052	180481244	DNA/hAT-Charlie	513	+	96	180481148	94170
chr1	12327930	12527930	harbor1	chr1	12359358	12359560	DNA/hAT-Charlie	911	+	101	12359459	31529
chr1	91339465	91539465	harbor1	chr1	91396827	91397141	DNA/hAT-Charlie	1967	+	157	91396984	57519
chr1	91339465	91539465	harbor1	chr1	91429701	91429849	DNA/hAT-Charlie	639	+	74	91429775	90310
chr1	91339465	91539465	harbor1	chr1	91430293	91430353	DNA/hAT-Charlie	639	+	30	91430323	90858
chr1	41310941	41510941	harbor1	chr1	41327856	41328159	DNA/hAT-Charlie	1339	+	152	41328008	17067
chr1	41310941	41510941	harbor1	chr1	41360624	41360790	DNA/hAT-Charlie	786	+	83	41360707	49766
chr1	19214228	19414228	harbor1	chr1	19241222	19241503	DNA/hAT-Charlie	530	+	140	19241362	27134
chr1	19214228	19414228	harbor1	chr1	19279814	19280042	DNA/hAT-Charlie	1721	+	114	19279928	65700
chr1	161019032	161219032	harbor1	chr1	161103937	161104105	DNA/hAT-Charlie	479	+	84	161104021	84989
chr1	93356745	93556745	harbor1	chr1	93387621	93387914	DNA/hAT-Charlie	944	+	146	93387767	31022
chr1	81043063	81243063	harbor1	chr1	81058206	81058427	DNA/hAT-Charlie	1122	+	110	81058316	15253
chr1	167197897	167397897	harbor1	chr1	167197685	167197985	DNA/hAT-Charlie	536	+	150	167197835	62
chr1	167197897	167397897	harbor1	chr1	167265699	167265889	DNA/hAT-Charlie	1029	+	95	167265794	67897
chr1	167197897	167397897	harbor1	chr1	167271790	167272119	DNA/hAT-Charlie	1292	+	164	167271954	74057
chr1	167197897	167397897	harbor1	chr1	167283222	167283412	DNA/hAT-Charlie	422	+	95	167283317	85420
chr1	64621335	64821335	harbor1	chr1	64624911	64625106	DNA/hAT-Charlie	814	+	98	64625009	3674
chr1	64621335	64821335	harbor1	chr1	64651100	64651259	DNA/hAT-Charlie	501	+	80	64651180	29845
chr1	64621335	64821335	harbor1	chr1	64660304	64660422	DNA/hAT-Charlie	531	+	59	64660363	39028
chr1	64621335	64821335	harbor1	chr1	64660417	64660520	DNA/hAT-Charlie	660	+	52	64660469	39134
chr1	64621335	64821335	harbor1	chr1	64660826	64660904	DNA/hAT-Charlie	660	+	39	64660865	39530
chr1	21729520	21929520	harbor1	chr1	21732294	21732458	DNA/hAT-Charlie	489	+	82	21732376	2856
chr1	21729520	21929520	harbor1	chr1	21732664	21732973	DNA/hAT-Charlie	837	+	154	21732818	3298
chr1	21729520	21929520	harbor1	chr1	21824925	21825287	DNA/hAT-Charlie	1362	+	181	21825106	95586
chr1	227797032	227997032	harbor1	chr1	227840035	227840121	DNA/hAT-Charlie	1196	+	43	227840078	43046
chr1	227797032	227997032	harbor1	chr1	227840421	227840672	DNA/hAT-Charlie	1196	+	126	227840547	43515
chr1	20683133	20883133	harbor1	chr1	20751877	20751978	DNA/hAT-Charlie	3927	+	50	20751927	68794
chr1	20683133	20883133	harbor1	chr1	20752272	20752300	DNA/hAT-Charlie	3927	+	14	20752286	69153
chr1	20683133	20883133	harbor1	chr1	20752590	20752947	DNA/hAT-Charlie	3927	+	178	20752768	69635
chr1	20683133	20883133	harbor1	chr1	20753242	20753722	DNA/hAT-Charlie	3927	+	240	20753482	70349
chr1	20683133	20883133	harbor1	chr1	20756171	20756407	DNA/hAT-Charlie	855	+	118	20756289	73156
chr1	20683133	20883133	harbor1	chr1	20756601	20756708	DNA/hAT-Charlie	1053	+	54	20756655	73522
chr1	20683133	20883133	harbor1	chr1	20757008	20757136	DNA/hAT-Charlie	1053	+	64	20757072	73939
chr1	210239567	210439567	harbor1	chr1	210248215	210248408	DNA/hAT-Charlie	535	+	96	210248311	8744
chr1	210239567	210439567	harbor1	chr1	210248407	210248528	DNA/hAT-Charlie	397	+	60	210248467	8900
chr1	210239567	210439567	harbor1	chr1	210264082	210264314	DNA/hAT-Charlie	1189	+	116	210264198	24631
chr1	210239567	210439567	harbor1	chr1	210281379	210281518	DNA/hAT-Charlie	759	+	70	210281449	41882
chr1	208585659	208785659	harbor1	chr1	208599353	208599454	DNA/hAT-Charlie	405	+	50	208599403	13744
chr1	208585659	208785659	harbor1	chr1	208599457	208599551	DNA/hAT-Charlie	430	+	47	208599504	13845
chr1	208585659	208785659	harbor1	chr1	208638184	208638311	DNA/hAT-Charlie	814	+	64	208638248	52589
chr1	208585659	208785659	harbor1	chr1	208661188	208661358	DNA/hAT-Charlie	689	+	85	208661273	75614
chr1	100433486	100633486	harbor1	chr1	100434929	100435115	DNA/hAT-Charlie	754	+	93	100435022	1536
chr1	100433486	100633486	harbor1	chr1	100437928	100438406	DNA/hAT-Charlie	1161	+	239	100438167	4681
chr1	100433486	100633486	harbor1	chr1	100440361	100440468	DNA/hAT-Charlie	679	+	54	100440415	6929
chr1	100433486	100633486	harbor1	chr1	100466965	100467107	DNA/hAT-Charlie	711	+	71	100467036	33550
chr1	146020882	146220882	harbor1	chr1	146041022	146041206	DNA/hAT-Charlie	866	+	92	146041114	20232
chr1	114064873	114264873	harbor1	chr1	114074961	114075118	DNA/hAT-Charlie	413	+	78	114075039	10166
chr1	114064873	114264873	harbor1	chr1	114079262	114079396	DNA/hAT-Charlie	455	+	67	114079329	14456
chr1	75520638	75720638	harbor1	chr1	75523716	75523931	DNA/hAT-Charlie	1014	+	108	75523824	3186
chr1	75520638	75720638	harbor1	chr1	75531969	75532133	DNA/hAT-Charlie	904	+	82	75532051	11413
chr1	75520638	75720638	harbor1	chr1	75586987	75587205	DNA/hAT-Charlie	950	+	109	75587096	66458
chr1	101073825	101273825	harbor1	chr1	101077584	101077791	DNA/hAT-Charlie	833	+	104	101077688	3863
chr1	101073825	101273825	harbor1	chr1	101130296	101130479	DNA/hAT-Charlie	512	+	92	101130388	56563
chr1	186798454	186998454	harbor1	chr1	186807847	186808084	DNA/hAT-Charlie	2173	+	118	186807965	9511
chr1	186798454	186998454	harbor1	chr1	186808353	186808866	DNA/hAT-Charlie	2173	+	256	186808609	10155
chr1	186798454	186998454	harbor1	chr1	186832709	186832818	DNA/hAT-Charlie	449	+	54	186832763	34309
chr1	186798454	186998454	harbor1	chr1	186840146	186840272	DNA/hAT-Charlie	685	+	63	186840209	41755
chr1	186798454	186998454	harbor1	chr1	186850067	186850296	DNA/hAT-Charlie	431	+	114	186850181	51727
chr1	186798454	186998454	harbor1	chr1	186880438	186880618	DNA/hAT-Charlie	568	+	90	186880528	82074
chr1	186798454	186998454	harbor1	chr1	186810300	186810938	DNA/hAT-Charlie	2880	+	319	186810619	12165
chr1	85034057	85234057	harbor1	chr1	85063854	85064160	DNA/hAT-Charlie	1040	+	153	85064007	29950
chr1	85034057	85234057	harbor1	chr1	85121946	85122106	DNA/hAT-Charlie	649	+	80	85122026	87969
chr1	84880410	85080410	harbor1	chr1	84885068	84885258	DNA/hAT-Charlie	1034	+	95	84885163	4753
chr1	84880410	85080410	harbor1	chr1	84907261	84907427	DNA/hAT-Charlie	1082	+	83	84907344	26934
chr1	84880410	85080410	harbor1	chr1	84935438	84935754	DNA/hAT-Charlie	1016	+	158	84935596	55186
chr1	84880410	85080410	harbor1	chr1	84973001	84973199	DNA/hAT-Charlie	935	+	99	84973100	92690
chr1	84880410	85080410	harbor1	chr1	84973500	84973719	DNA/hAT-Charlie	935	+	110	84973610	93200
chr1	183261703	183461703	harbor1	chr1	183263440	183263536	DNA/hAT-Charlie	802	+	48	183263488	1785
chr1	183261703	183461703	harbor1	chr1	183263832	183263927	DNA/hAT-Charlie	802	+	48	183263880	2177
chr1	183261703	183461703	harbor1	chr1	183280303	183280386	DNA/hAT-Charlie	1475	+	42	183280345	18642
chr1	183261703	183461703	harbor1	chr1	183280687	183280775	DNA/hAT-Charlie	1475	+	44	183280731	19028
chr1	183261703	183461703	harbor1	chr1	183281085	183281170	DNA/hAT-Charlie	1475	+	42	183281127	19424
chr1	183261703	183461703	harbor1	chr1	183281223	183281444	DNA/hAT-Charlie	1200	+	110	183281333	19630
chr1	183261703	183461703	harbor1	chr1	183286483	183286643	DNA/hAT-Charlie	698	+	80	183286563	24860
chr1	183261703	183461703	harbor1	chr1	183310545	183310758	DNA/hAT-Charlie	1190	+	106	183310651	48948
chr1	183261703	183461703	harbor1	chr1	183355320	183355497	DNA/hAT-Charlie	985	+	88	183355408	93705
chr1	57200868	57400868	harbor1	chr1	57236862	57237050	DNA/hAT-Charlie	566	+	94	57236956	36088
chr1	57200868	57400868	harbor1	chr1	57238143	57238308	DNA/hAT-Charlie	681	+	82	57238225	37357
chr1	57200868	57400868	harbor1	chr1	57290303	57290489	DNA/hAT-Charlie	896	+	93	57290396	89528
chr1	15800460	16000460	harbor1	chr1	15813609	15813724	DNA/hAT-Charlie	499	+	58	15813667	13207
chr1	15800460	16000460	harbor1	chr1	15814331	15814423	DNA/hAT-Charlie	499	+	46	15814377	13917
chr1	15800460	16000460	harbor1	chr1	15856318	15856565	DNA/hAT-Charlie	1116	+	124	15856442	55982
chr1	15800460	16000460	harbor1	chr1	15856868	15856955	DNA/hAT-Charlie	1116	+	44	15856912	56452
chr1	15800460	16000460	harbor1	chr1	15891923	15892001	DNA/hAT-Charlie	618	+	39	15891962	91502
chr1	15800460	16000460	harbor1	chr1	15892323	15892397	DNA/hAT-Charlie	618	+	37	15892360	91900
chr1	213370308	213570308	harbor1	chr1	213447757	213447949	DNA/hAT-Charlie	671	+	96	213447853	77545
chr1	213370308	213570308	harbor1	chr1	213448255	213448330	DNA/hAT-Charlie	671	+	38	213448293	77985
chr1	151380398	151580398	harbor1	chr1	151386092	151386425	DNA/hAT-Charlie	2136	+	166	151386258	5860
chr1	151380398	151580398	harbor1	chr1	151413881	151414040	DNA/hAT-Charlie	516	+	80	151413961	33563
chr1	151380398	151580398	harbor1	chr1	151420660	151420887	DNA/hAT-Charlie	697	+	114	151420774	40376
chr1	151380398	151580398	harbor1	chr1	151421208	151421260	DNA/hAT-Charlie	697	+	26	151421234	40836
chr1	151380398	151580398	harbor1	chr1	151425348	151425442	DNA/hAT-Charlie	435	+	47	151425395	44997
chr1	151380398	151580398	harbor1	chr1	151427208	151427456	DNA/hAT-Charlie	1264	+	124	151427332	46934
chr1	151380398	151580398	harbor1	chr1	151449289	151449508	DNA/hAT-Charlie	1011	+	110	151449399	69001
chr1	151380398	151580398	harbor1	chr1	151474716	151475851	DNA/hAT-Charlie	4237	+	568	151475284	94886
chr1	151380398	151580398	harbor1	chr1	151479769	151479881	DNA/hAT-Charlie	553	+	56	151479825	99427
chr1	151380398	151580398	harbor1	chr1	151480178	151480234	DNA/hAT-Charlie	553	+	28	151480206	99808
chr1	177386307	177586307	harbor1	chr1	177471574	177471636	DNA/hAT-Charlie	537	+	31	177471605	85298
chr1	177386307	177586307	harbor1	chr1	177471822	177471978	DNA/hAT-Charlie	537	+	78	177471900	85593
chr1	177386307	177586307	harbor1	chr1	177473273	177473380	DNA/hAT-Charlie	407	+	54	177473327	87020
chr1	74821167	75021167	harbor1	chr1	74859192	74859386	DNA/hAT-Charlie	1018	+	97	74859289	38122
chr1	74821167	75021167	harbor1	chr1	74896626	74896816	DNA/hAT-Charlie	974	+	95	74896721	75554
chr1	111776442	111976442	harbor1	chr1	111830602	111830925	DNA/hAT-Charlie	1089	+	162	111830764	54322
chr1	182483020	182683020	harbor1	chr1	182485721	182486039	DNA/hAT-Charlie	1244	+	159	182485880	2860
chr1	182483020	182683020	harbor1	chr1	182494444	182494567	DNA/hAT-Charlie	734	+	62	182494506	11486
chr1	215877363	216077363	harbor1	chr1	215944126	215944334	DNA/hAT-Charlie	830	+	104	215944230	66867
chr1	215877363	216077363	harbor1	chr1	215946648	215946773	DNA/hAT-Charlie	741	+	62	215946710	69347
chr1	215877363	216077363	harbor1	chr1	215946775	215947042	DNA/hAT-Charlie	1540	+	134	215946909	69546
chr1	215877363	216077363	harbor1	chr1	215947344	215947450	DNA/hAT-Charlie	1540	+	53	215947397	70034
chr1	200599653	200799653	harbor1	chr1	200642340	200642540	DNA/hAT-Charlie	420	+	100	200642440	42787
chr1	200599653	200799653	harbor1	chr1	200644983	200645190	DNA/hAT-Charlie	649	+	104	200645087	45434
chr1	200599653	200799653	harbor1	chr1	200656169	200656270	DNA/hAT-Charlie	462	+	50	200656219	56566
chr1	200599653	200799653	harbor1	chr1	200656273	200656336	DNA/hAT-Charlie	463	+	32	200656305	56652
chr1	200599653	200799653	harbor1	chr1	200662679	200662939	DNA/hAT-Charlie	559	+	130	200662809	63156
chr1	200599653	200799653	harbor1	chr1	200695247	200695474	DNA/hAT-Charlie	1022	+	114	200695361	95708
chr1	62586261	62786261	harbor1	chr1	62610314	62610474	DNA/hAT-Charlie	1456	+	80	62610394	24133
chr1	62586261	62786261	harbor1	chr1	62611065	62611300	DNA/hAT-Charlie	1456	+	118	62611183	24922
chr1	62586261	62786261	harbor1	chr1	62611523	62611604	DNA/hAT-Charlie	1456	+	40	62611563	25302
chr1	62586261	62786261	harbor1	chr1	62617472	62617804	DNA/hAT-Charlie	1543	+	166	62617638	31377
chr1	62586261	62786261	harbor1	chr1	62637389	62637602	DNA/hAT-Charlie	899	+	106	62637495	51234
chr1	18277025	18477025	harbor1	chr1	18333793	18334108	DNA/hAT-Charlie	1301	+	158	18333951	56926
chr1	73772867	73972867	harbor1	chr1	73783857	73784023	DNA/hAT-Charlie	605	+	83	73783940	11073
chr1	56106842	56306842	harbor1	chr1	56124572	56124761	DNA/hAT-Charlie	1148	+	94	56124666	17824
chr1	56106842	56306842	harbor1	chr1	56129989	56130108	DNA/hAT-Charlie	544	+	60	56130049	23207
chr1	56106842	56306842	harbor1	chr1	56144029	56144241	DNA/hAT-Charlie	946	+	106	56144135	37293
chr1	56106842	56306842	harbor1	chr1	56148292	56148617	DNA/hAT-Charlie	1284	+	162	56148454	41612
chr1	56106842	56306842	harbor1	chr1	56194325	56194532	DNA/hAT-Charlie	936	+	104	56194429	87587
chr1	8176042	8376042	harbor1	chr1	8222826	8223232	DNA/hAT-Charlie	1985	+	203	8223029	46987
chr1	8176042	8376042	harbor1	chr1	8226022	8226132	DNA/hAT-Charlie	871	+	55	8226077	50035
chr1	8176042	8376042	harbor1	chr1	8244432	8244646	DNA/hAT-Charlie	1060	+	107	8244539	68497
chr1	89545136	89745136	harbor1	chr1	89576523	89576705	DNA/hAT-Charlie	710	+	91	89576614	31478
chr1	89545136	89745136	harbor1	chr1	89588301	89588458	DNA/hAT-Charlie	482	+	78	89588379	43243
chr1	89545136	89745136	harbor1	chr1	89588818	89589189	DNA/hAT-Charlie	970	+	186	89589004	43868
chr1	89545136	89745136	harbor1	chr1	89590860	89591059	DNA/hAT-Charlie	1126	+	100	89590960	45824
chr1	89545136	89745136	harbor1	chr1	89613193	89613504	DNA/hAT-Charlie	1300	+	156	89613349	68213
chr1	89545136	89745136	harbor1	chr1	89624779	89625003	DNA/hAT-Charlie	598	+	112	89624891	79755
chr1	238425333	238625333	harbor1	chr1	238435278	238435489	DNA/hAT-Charlie	860	+	106	238435384	10051
chr1	238425333	238625333	harbor1	chr1	238515294	238515601	DNA/hAT-Charlie	969	+	154	238515448	90115
chr1	238425333	238625333	harbor1	chr1	238518031	238518160	DNA/hAT-Charlie	444	+	64	238518095	92762
chr1	35528163	35728163	harbor1	chr1	35548466	35548690	DNA/hAT-Charlie	476	+	112	35548578	20415
chr1	35528163	35728163	harbor1	chr1	35580401	35580478	DNA/hAT-Charlie	480	+	38	35580439	52276
chr1	35528163	35728163	harbor1	chr1	35580792	35580900	DNA/hAT-Charlie	480	+	54	35580846	52683
chr1	35528163	35728163	harbor1	chr1	35585218	35585327	DNA/hAT-Charlie	431	+	54	35585272	57109
chr1	35528163	35728163	harbor1	chr1	35585475	35585762	DNA/hAT-Charlie	1419	+	144	35585619	57456
chr1	35528163	35728163	harbor1	chr1	35586060	35586121	DNA/hAT-Charlie	1419	+	30	35586090	57927
chr1	35528163	35728163	harbor1	chr1	35597404	35597623	DNA/hAT-Charlie	633	+	110	35597514	69351
chr1	35528163	35728163	harbor1	chr1	35604804	35604993	DNA/hAT-Charlie	426	+	94	35604898	76735
chr1	35528163	35728163	harbor1	chr1	35626787	35627055	DNA/hAT-Charlie	739	+	134	35626921	98758
chr1	201697635	201897635	harbor1	chr1	201701493	201701632	DNA/hAT-Charlie	607	+	70	201701563	3928
chr1	201697635	201897635	harbor1	chr1	201762374	201762683	DNA/hAT-Charlie	1951	+	154	201762528	64893
chr1	211077993	211277993	harbor1	chr1	211100800	211100948	DNA/hAT-Charlie	588	+	74	211100874	22881
chr1	79018502	79218502	harbor1	chr1	79091490	79092103	DNA/hAT-Charlie	1554	+	306	79091796	73294
chr1	37338604	37538604	harbor1	chr1	37374782	37375020	DNA/hAT-Charlie	1061	+	119	37374901	36297
chr1	37338604	37538604	harbor1	chr1	37381210	37381237	DNA/hAT-Charlie	480	+	14	37381224	42620
chr1	37338604	37538604	harbor1	chr1	37381545	37381634	DNA/hAT-Charlie	480	+	44	37381589	42985
chr1	37338604	37538604	harbor1	chr1	37384099	37384178	DNA/hAT-Charlie	483	+	40	37384139	45535
chr1	37338604	37538604	harbor1	chr1	37384622	37384750	DNA/hAT-Charlie	760	+	64	37384686	46082
chr1	37338604	37538604	harbor1	chr1	37406319	37406508	DNA/hAT-Charlie	654	+	94	37406413	67809
chr1	37338604	37538604	harbor1	chr1	37406878	37406965	DNA/hAT-Charlie	394	+	44	37406922	68318
chr1	37338604	37538604	harbor1	chr1	37413722	37413896	DNA/hAT-Charlie	653	+	87	37413809	75205
chr1	1820966	2020966	harbor1	chr1	1858667	1859016	DNA/hAT-Charlie	1386	+	174	1858841	37875
chr1	1820966	2020966	harbor1	chr1	1859318	1859401	DNA/hAT-Charlie	1386	+	42	1859360	38394
chr1	1820966	2020966	harbor1	chr1	1859500	1859569	DNA/hAT-Charlie	1386	+	34	1859534	38568
chr1	240566678	240766678	harbor1	chr1	240632121	240632201	DNA/hAT-Charlie	1590	+	40	240632161	65483
chr1	240566678	240766678	harbor1	chr1	240631567	240631819	DNA/hAT-Charlie	1590	+	126	240631693	65015
chr1	180571269	180771269	harbor1	chr1	180637090	180637553	DNA/hAT-Charlie	1443	+	232	180637322	66053
chr1	180571269	180771269	harbor1	chr1	180637854	180637923	DNA/hAT-Charlie	1443	+	34	180637888	66619
chr1	180571269	180771269	harbor1	chr1	180637940	180638362	DNA/hAT-Charlie	532	+	211	180638151	66882
chr1	180571269	180771269	harbor1	chr1	180647941	180648125	DNA/hAT-Charlie	626	+	92	180648033	76764
chr1	226469013	226669013	harbor1	chr1	226473700	226473796	DNA/hAT-Charlie	469	+	48	226473748	4735
chr1	226469013	226669013	harbor1	chr1	226474363	226474499	DNA/hAT-Charlie	469	+	68	226474431	5418
chr1	226469013	226669013	harbor1	chr1	226532973	226533170	DNA/hAT-Charlie	962	+	98	226533071	64058
chr1	85292850	85492850	harbor1	chr1	85293095	85293226	DNA/hAT-Charlie	1315	+	66	85293161	311
chr1	85292850	85492850	harbor1	chr1	85293281	85293495	DNA/hAT-Charlie	1315	+	107	85293388	538
chr1	85292850	85492850	harbor1	chr1	85342792	85342967	DNA/hAT-Charlie	584	+	88	85342880	50030
chr1	85292850	85492850	harbor1	chr1	85357445	85357696	DNA/hAT-Charlie	461	+	126	85357571	64721
chr1	243644433	243844433	harbor1	chr1	243740535	243740674	DNA/hAT-Charlie	484	+	70	243740605	96172
chr2	76860619	77060619	harbor1	chr2	76929337	76929460	DNA/hAT-Charlie	459	+	62	76929399	68780
chr2	227169988	227369988	harbor1	chr2	227206581	227206738	DNA/hAT-Charlie	620	+	78	227206659	36671
chr2	6170728	6370728	harbor1	chr2	6225692	6225914	DNA/hAT-Charlie	1569	+	111	6225803	55075
chr2	6170728	6370728	harbor1	chr2	6244648	6245188	DNA/hAT-Charlie	3430	+	270	6244918	74190
chr2	6170728	6370728	harbor1	chr2	6268121	6268642	DNA/hAT-Charlie	3265	+	260	6268381	97653
chr2	46424731	46624731	harbor1	chr2	46432378	46432564	DNA/hAT-Charlie	866	+	93	46432471	7740
chr2	46424731	46624731	harbor1	chr2	46462902	46463184	DNA/hAT-Charlie	594	+	141	46463043	38312
chr2	46424731	46624731	harbor1	chr2	46488904	46489056	DNA/hAT-Charlie	631	+	76	46488980	64249
chr2	46424731	46624731	harbor1	chr2	46498256	46498555	DNA/hAT-Charlie	671	+	150	46498406	73675
chr2	46424731	46624731	harbor1	chr2	46498550	46499495	DNA/hAT-Charlie	3161	+	472	46499022	74291
chr2	167134294	167334294	harbor1	chr2	167136928	167137088	DNA/hAT-Charlie	931	+	80	167137008	2714
chr2	167134294	167334294	harbor1	chr2	167139738	167139910	DNA/hAT-Charlie	790	+	86	167139824	5530
chr2	167134294	167334294	harbor1	chr2	167185988	167186182	DNA/hAT-Charlie	819	+	97	167186085	51791
chr2	46774189	46974189	harbor1	chr2	46782881	46783225	DNA/hAT-Charlie	1609	+	172	46783053	8864
chr2	46774189	46974189	harbor1	chr2	46832686	46832764	DNA/hAT-Charlie	429	+	39	46832725	58536
chr2	46774189	46974189	harbor1	chr2	46832770	46832850	DNA/hAT-Charlie	401	+	40	46832810	58621
chr2	46774189	46974189	harbor1	chr2	46837121	46837264	DNA/hAT-Charlie	525	+	72	46837193	63004
chr2	46774189	46974189	harbor1	chr2	46855817	46855950	DNA/hAT-Charlie	519	+	66	46855883	81694
chr2	46774189	46974189	harbor1	chr2	46868796	46868978	DNA/hAT-Charlie	878	+	91	46868887	94698
chr2	21985456	22185456	harbor1	chr2	21989558	21990081	DNA/hAT-Charlie	3238	+	262	21989820	4364
chr2	51912419	52112419	harbor1	chr2	51928211	51928413	DNA/hAT-Charlie	646	+	101	51928312	15893
chr2	51912419	52112419	harbor1	chr2	51975029	51975169	DNA/hAT-Charlie	432	+	70	51975099	62680
chr2	8525035	8725035	harbor1	chr2	8531390	8532103	DNA/hAT-Charlie	2899	+	356	8531746	6711
chr2	228757478	228957478	harbor1	chr2	228796826	228796989	DNA/hAT-Charlie	611	+	82	228796908	39430
chr2	228757478	228957478	harbor1	chr2	228826820	228826978	DNA/hAT-Charlie	434	+	79	228826899	69421
chr2	196739891	196939891	harbor1	chr2	196777017	196777305	DNA/hAT-Charlie	518	+	144	196777161	37270
chr2	196739891	196939891	harbor1	chr2	196782726	196782840	DNA/hAT-Charlie	475	+	57	196782783	42892
chr2	196739891	196939891	harbor1	chr2	196825652	196826312	DNA/hAT-Charlie	1241	+	330	196825982	86091
chr2	42983160	43183160	harbor1	chr2	43009462	43009837	DNA/hAT-Charlie	2385	+	188	43009650	26490
chr2	151693818	151893818	harbor1	chr2	151726678	151726743	DNA/hAT-Charlie	598	+	32	151726710	32892
chr2	151693818	151893818	harbor1	chr2	151727071	151727180	DNA/hAT-Charlie	598	+	54	151727125	33307
chr2	151693818	151893818	harbor1	chr2	151738175	151738369	DNA/hAT-Charlie	950	+	97	151738272	44454
chr2	151693818	151893818	harbor1	chr2	151777697	151778008	DNA/hAT-Charlie	1462	+	156	151777853	84035
chr2	210988091	211188091	harbor1	chr2	211041198	211041422	DNA/hAT-Charlie	1249	+	112	211041310	53219
chr2	210988091	211188091	harbor1	chr2	211060362	211060570	DNA/hAT-Charlie	431	+	104	211060466	72375
chr2	111387730	111587730	harbor1	chr2	111415048	111415267	DNA/hAT-Charlie	1144	+	110	111415158	27428
chr2	111387730	111587730	harbor1	chr2	111426887	111426930	DNA/hAT-Charlie	467	+	22	111426909	39179
chr2	111387730	111587730	harbor1	chr2	111434694	111434855	DNA/hAT-Charlie	651	+	80	111434774	47044
chr2	177966827	178166827	harbor1	chr2	178061245	178061432	DNA/hAT-Charlie	751	+	94	178061339	94512
chr2	48504407	48704407	harbor1	chr2	48569706	48569760	DNA/hAT-Charlie	490	+	27	48569733	65326
chr2	48504407	48704407	harbor1	chr2	48569955	48570052	DNA/hAT-Charlie	490	+	48	48570003	65596
chr2	48504407	48704407	harbor1	chr2	48570353	48570396	DNA/hAT-Charlie	490	+	22	48570375	65968
chr2	48504407	48704407	harbor1	chr2	48578320	48578499	DNA/hAT-Charlie	1130	+	90	48578410	74003
chr2	219367382	219567382	harbor1	chr2	219391691	219391833	DNA/hAT-Charlie	770	+	71	219391762	24380
chr2	219367382	219567382	harbor1	chr2	219401108	219401353	DNA/hAT-Charlie	988	+	122	219401230	33848
chr2	219367382	219567382	harbor1	chr2	219401658	219401744	DNA/hAT-Charlie	988	+	43	219401701	34319
chr2	219367382	219567382	harbor1	chr2	219455330	219455526	DNA/hAT-Charlie	913	+	98	219455428	88046
chr2	219367382	219567382	harbor1	chr2	219458323	219458561	DNA/hAT-Charlie	903	+	119	219458442	91060
chr2	97342203	97542203	harbor1	chr2	97348204	97348320	DNA/hAT-Charlie	831	+	58	97348262	6059
chr2	97342203	97542203	harbor1	chr2	97397407	97397630	DNA/hAT-Charlie	767	+	112	97397519	55316
chr2	123804371	124004371	harbor1	chr2	123882855	123883040	DNA/hAT-Charlie	400	+	92	123882947	78576
chr2	182098878	182298878	harbor1	chr2	182122308	182122540	DNA/hAT-Charlie	467	+	116	182122424	23546
chr2	182098878	182298878	harbor1	chr2	182134220	182134381	DNA/hAT-Charlie	645	+	80	182134300	35422
chr2	182098878	182298878	harbor1	chr2	182134389	182134553	DNA/hAT-Charlie	450	+	82	182134471	35593
chr2	182098878	182298878	harbor1	chr2	182134811	182134878	DNA/hAT-Charlie	496	+	34	182134845	35967
chr2	104968275	105168275	harbor1	chr2	105017449	105017539	DNA/hAT-Charlie	477	+	45	105017494	49219
chr2	104968275	105168275	harbor1	chr2	105037052	105037195	DNA/hAT-Charlie	535	+	72	105037124	68849
chr2	131662940	131862940	harbor1	chr2	131735151	131735374	DNA/hAT-Charlie	468	+	112	131735263	72323
chr2	131662940	131862940	harbor1	chr2	131749454	131749704	DNA/hAT-Charlie	834	+	125	131749579	86639
chr2	120304716	120504716	harbor1	chr2	120361401	120361566	DNA/hAT-Charlie	637	+	82	120361483	56767
chr2	120304716	120504716	harbor1	chr2	120382405	120382565	DNA/hAT-Charlie	690	+	80	120382485	77769
chr2	228621887	228821887	harbor1	chr2	228644594	228644855	DNA/hAT-Charlie	551	+	130	228644724	22837
chr2	228621887	228821887	harbor1	chr2	228657438	228657627	DNA/hAT-Charlie	613	+	94	228657532	35645
chr2	228621887	228821887	harbor1	chr2	228662905	228663122	DNA/hAT-Charlie	1442	+	108	228663013	41126
chr2	108179000	108379000	harbor1	chr2	108222188	108222377	DNA/hAT-Charlie	635	+	94	108222282	43282
chr2	183461566	183661566	harbor1	chr2	183468585	183468791	DNA/hAT-Charlie	817	+	103	183468688	7122
chr2	183461566	183661566	harbor1	chr2	183477307	183477561	DNA/hAT-Charlie	477	+	127	183477434	15868
chr2	206499367	206699367	harbor1	chr2	206529716	206529819	DNA/hAT-Charlie	1395	+	52	206529768	30401
chr2	206499367	206699367	harbor1	chr2	206530108	206530368	DNA/hAT-Charlie	1395	+	130	206530238	30871
chr2	206499367	206699367	harbor1	chr2	206590714	206590937	DNA/hAT-Charlie	454	+	112	206590826	91459
chr2	10400980	10600980	harbor1	chr2	10412201	10412406	DNA/hAT-Charlie	756	+	102	10412303	11323
chr2	10400980	10600980	harbor1	chr2	10461380	10461497	DNA/hAT-Charlie	843	+	58	10461438	60458
chr2	10400980	10600980	harbor1	chr2	10461802	10461880	DNA/hAT-Charlie	843	+	39	10461841	60861
chr2	10400980	10600980	harbor1	chr2	10477044	10477210	DNA/hAT-Charlie	608	+	83	10477127	76147
chr2	16903119	17103119	harbor1	chr2	16973456	16973588	DNA/hAT-Charlie	510	+	66	16973522	70403
chr2	129595732	129795732	harbor1	chr2	129598281	129598735	DNA/hAT-Charlie	655	+	227	129598508	2776
chr2	129595732	129795732	harbor1	chr2	129614175	129614390	DNA/hAT-Charlie	1574	+	108	129614283	18551
chr2	189955639	190155639	harbor1	chr2	190007164	190007678	DNA/hAT-Charlie	2378	+	257	190007421	51782
chr2	189955639	190155639	harbor1	chr2	190007976	190008424	DNA/hAT-Charlie	2378	+	224	190008200	52561
chr2	189955639	190155639	harbor1	chr2	190008452	190008637	DNA/hAT-Charlie	578	+	92	190008544	52905
chr2	189955639	190155639	harbor1	chr2	190020182	190020458	DNA/hAT-Charlie	868	+	138	190020320	64681
chr2	189955639	190155639	harbor1	chr2	190046500	190046962	DNA/hAT-Charlie	942	+	231	190046731	91092
chr2	52725972	52925972	harbor1	chr2	52763386	52763607	DNA/hAT-Charlie	601	+	110	52763496	37524
chr2	52725972	52925972	harbor1	chr2	52779426	52779577	DNA/hAT-Charlie	890	+	76	52779502	53530
chr2	52725972	52925972	harbor1	chr2	52780760	52780917	DNA/hAT-Charlie	587	+	78	52780838	54866
chr2	22832731	23032731	harbor1	chr2	22850838	22851013	DNA/hAT-Charlie	405	+	88	22850926	18195
chr2	22832731	23032731	harbor1	chr2	22875890	22876105	DNA/hAT-Charlie	834	+	108	22875998	43267
chr2	22832731	23032731	harbor1	chr2	22894985	22895223	DNA/hAT-Charlie	831	+	119	22895104	62373
chr2	22832731	23032731	harbor1	chr2	22918128	22918375	DNA/hAT-Charlie	760	+	124	22918252	85521
chr2	35774564	35974564	harbor1	chr2	35829881	35830187	DNA/hAT-Charlie	499	+	153	35830034	55470
chr2	35774564	35974564	harbor1	chr2	35858462	35858936	DNA/hAT-Charlie	1719	+	237	35858699	84135
chr2	228468482	228668482	harbor1	chr2	228480980	228481065	DNA/hAT-Charlie	457	+	42	228481022	12540
chr2	228468482	228668482	harbor1	chr2	228483265	228483837	DNA/hAT-Charlie	1827	+	286	228483551	15069
chr2	228468482	228668482	harbor1	chr2	228484666	228485278	DNA/hAT-Charlie	2287	+	306	228484972	16490
chr2	228468482	228668482	harbor1	chr2	228530007	228530536	DNA/hAT-Charlie	3618	+	264	228530271	61789
chr2	31347144	31547144	harbor1	chr2	31373289	31373495	DNA/hAT-Charlie	1003	+	103	31373392	26248
chr2	31347144	31547144	harbor1	chr2	31382800	31382915	DNA/hAT-Charlie	513	+	58	31382858	35714
chr2	31347144	31547144	harbor1	chr2	31416493	31416676	DNA/hAT-Charlie	887	+	92	31416585	69441
chr2	18775325	18975325	harbor1	chr2	18869627	18869944	DNA/hAT-Charlie	925	+	158	18869785	94460
chr2	62567769	62767769	harbor1	chr2	62611835	62612101	DNA/hAT-Charlie	686	+	133	62611968	44199
chr2	62567769	62767769	harbor1	chr2	62612230	62612715	DNA/hAT-Charlie	1374	+	242	62612472	44703
chr2	62567769	62767769	harbor1	chr2	62613016	62613046	DNA/hAT-Charlie	1374	+	15	62613031	45262
chr2	62567769	62767769	harbor1	chr2	62654133	62654342	DNA/hAT-Charlie	575	+	104	62654237	86468
chr2	62567769	62767769	harbor1	chr2	62659631	62659789	DNA/hAT-Charlie	625	+	79	62659710	91941
chr2	11573956	11773956	harbor1	chr2	11577159	11577362	DNA/hAT-Charlie	728	+	102	11577261	3305
chr2	11573956	11773956	harbor1	chr2	11603380	11603551	DNA/hAT-Charlie	421	+	86	11603466	29510
chr2	11573956	11773956	harbor1	chr2	11624716	11624928	DNA/hAT-Charlie	1366	+	106	11624822	50866
chr2	11573956	11773956	harbor1	chr2	11661070	11661202	DNA/hAT-Charlie	443	+	66	11661136	87180
chr2	11573956	11773956	harbor1	chr2	11672720	11673649	DNA/hAT-Charlie	3849	+	464	11673184	99228
chr2	89259574	89459574	harbor1	chr2	89276681	89276792	DNA/hAT-Charlie	485	+	56	89276737	17163
chr2	222226995	222426995	harbor1	chr2	222252012	222252284	DNA/hAT-Charlie	974	+	136	222252148	25153
chr2	222226995	222426995	harbor1	chr2	222277554	222277653	DNA/hAT-Charlie	1368	+	50	222277604	50609
chr2	222226995	222426995	harbor1	chr2	222277951	222278085	DNA/hAT-Charlie	1393	+	67	222278018	51023
chr2	222226995	222426995	harbor1	chr2	222313358	222313540	DNA/hAT-Charlie	553	+	91	222313449	86454
chr2	180103780	180303780	harbor1	chr2	180120106	180120290	DNA/hAT-Charlie	561	+	92	180120198	16418
chr2	180103780	180303780	harbor1	chr2	180124862	180125041	DNA/hAT-Charlie	782	+	90	180124952	21172
chr2	180103780	180303780	harbor1	chr2	180126052	180126205	DNA/hAT-Charlie	572	+	76	180126128	22348
chr2	77170951	77370951	harbor1	chr2	77231403	77231486	DNA/hAT-Charlie	409	+	42	77231445	60494
chr2	77170951	77370951	harbor1	chr2	77234623	77234744	DNA/hAT-Charlie	510	+	60	77234683	63732
chr2	77170951	77370951	harbor1	chr2	77261852	77262369	DNA/hAT-Charlie	3398	+	258	77262110	91159
chr2	77170951	77370951	harbor1	chr2	77265986	77266209	DNA/hAT-Charlie	1100	+	112	77266098	95147
chr2	77170951	77370951	harbor1	chr2	77268824	77269018	DNA/hAT-Charlie	712	+	97	77268921	97970
chr2	142863623	143063623	harbor1	chr2	142888529	142888653	DNA/hAT-Charlie	511	+	62	142888591	24968
chr2	142863623	143063623	harbor1	chr2	142916330	142916498	DNA/hAT-Charlie	635	+	84	142916414	52791
chr2	45392992	45592992	harbor1	chr2	45422414	45423209	DNA/hAT-Charlie	2482	+	398	45422812	29820
chr2	45392992	45592992	harbor1	chr2	45423303	45423457	DNA/hAT-Charlie	517	+	77	45423380	30388
chr2	45392992	45592992	harbor1	chr2	45424359	45424555	DNA/hAT-Charlie	584	+	98	45424457	31465
chr2	45392992	45592992	harbor1	chr2	45466898	45467030	DNA/hAT-Charlie	510	+	66	45466964	73972
chr2	45392992	45592992	harbor1	chr2	45467199	45467333	DNA/hAT-Charlie	449	+	67	45467266	74274
chr2	225119816	225319816	harbor1	chr2	225192711	225193923	DNA/hAT-Charlie	3172	+	606	225193317	73501
chr2	225119816	225319816	harbor1	chr2	225210704	225210871	DNA/hAT-Charlie	509	+	84	225210788	90972
chr2	131040448	131240448	harbor1	chr2	131085795	131085995	DNA/hAT-Charlie	593	+	100	131085895	45447
chr2	217859532	218059532	harbor1	chr2	217863314	217863459	DNA/hAT-Charlie	815	+	72	217863386	3854
chr2	30065287	30265287	harbor1	chr2	30079991	30080322	DNA/hAT-Charlie	2061	+	166	30080157	14870
chr2	30065287	30265287	harbor1	chr2	30109793	30109971	DNA/hAT-Charlie	605	+	89	30109882	44595
chr2	30065287	30265287	harbor1	chr2	30157852	30158013	DNA/hAT-Charlie	814	+	80	30157932	92645
chr2	143626257	143826257	harbor1	chr2	143643455	143643636	DNA/hAT-Charlie	550	+	90	143643545	17288
chr2	143626257	143826257	harbor1	chr2	143711001	143711214	DNA/hAT-Charlie	948	+	106	143711107	84850
chr2	197297994	197497994	harbor1	chr2	197332044	197332276	DNA/hAT-Charlie	827	+	116	197332160	34166
chr2	197297994	197497994	harbor1	chr2	197353741	197353992	DNA/hAT-Charlie	404	+	126	197353867	55873
chr2	197297994	197497994	harbor1	chr2	197389308	197389526	DNA/hAT-Charlie	1325	+	109	197389417	91423
chr2	239109184	239309184	harbor1	chr2	239179276	239179619	DNA/hAT-Charlie	1736	+	172	239179448	70264
chr2	233118757	233318757	harbor1	chr2	233128011	233128323	DNA/hAT-Charlie	1959	+	156	233128167	9410
chr2	233118757	233318757	harbor1	chr2	233171444	233171598	DNA/hAT-Charlie	506	+	77	233171521	52764
chr2	233118757	233318757	harbor1	chr2	233182832	233183064	DNA/hAT-Charlie	687	+	116	233182948	64191
chr2	214443970	214643970	harbor1	chr2	214451053	214451214	DNA/hAT-Charlie	741	+	80	214451133	7163
chr2	214443970	214643970	harbor1	chr2	214497708	214497828	DNA/hAT-Charlie	410	+	60	214497768	53798
chr2	214443970	214643970	harbor1	chr2	214517396	214517570	DNA/hAT-Charlie	564	+	87	214517483	73513
chr2	171238831	171438831	harbor1	chr2	171238728	171239044	DNA/hAT-Charlie	1977	+	158	171238886	55
chr2	171238831	171438831	harbor1	chr2	171254253	171254534	DNA/hAT-Charlie	1285	+	140	171254393	15562
chr2	171238831	171438831	harbor1	chr2	171327296	171327471	DNA/hAT-Charlie	421	+	88	171327384	88553
chr2	127777920	127977920	harbor1	chr2	127779092	127779186	DNA/hAT-Charlie	420	+	47	127779139	1219
chr2	127777920	127977920	harbor1	chr2	127779486	127779623	DNA/hAT-Charlie	420	+	68	127779554	1634
chr2	127777920	127977920	harbor1	chr2	127817095	127817167	DNA/hAT-Charlie	509	+	36	127817131	39211
chr2	127777920	127977920	harbor1	chr2	127817312	127817400	DNA/hAT-Charlie	509	+	44	127817356	39436
chr2	22667688	22867688	harbor1	chr2	22752645	22752869	DNA/hAT-Charlie	1163	+	112	22752757	85069
chr2	229108911	229308911	harbor1	chr2	229140086	229140682	DNA/hAT-Charlie	1182	+	298	229140384	31473
chr2	229108911	229308911	harbor1	chr2	229163902	229164132	DNA/hAT-Charlie	434	+	115	229164017	55106
chr2	229108911	229308911	harbor1	chr2	229180484	229180624	DNA/hAT-Charlie	515	+	70	229180554	71643
chr2	229108911	229308911	harbor1	chr2	229189814	229190283	DNA/hAT-Charlie	1179	+	234	229190048	81137
chr2	229108911	229308911	harbor1	chr2	229190845	229191070	DNA/hAT-Charlie	466	+	112	229190957	82046
chr2	61144459	61344459	harbor1	chr2	61166881	61167082	DNA/hAT-Charlie	718	+	100	61166981	22522
chr2	61144459	61344459	harbor1	chr2	61167392	61167539	DNA/hAT-Charlie	718	+	74	61167466	23007
chr2	61144459	61344459	harbor1	chr2	61194423	61194501	DNA/hAT-Charlie	875	+	39	61194462	50003
chr2	61144459	61344459	harbor1	chr2	61195344	61195391	DNA/hAT-Charlie	875	+	24	61195368	50909
chr2	61144459	61344459	harbor1	chr2	61195688	61195786	DNA/hAT-Charlie	875	+	49	61195737	51278
chr2	61144459	61344459	harbor1	chr2	61220900	61221111	DNA/hAT-Charlie	911	+	106	61221006	76547
chr2	110650625	110850625	harbor1	chr2	110721015	110721174	DNA/hAT-Charlie	465	+	80	110721095	70470
chr2	110650625	110850625	harbor1	chr2	110733829	110734275	DNA/hAT-Charlie	2428	+	223	110734052	83427
chr2	110650625	110850625	harbor1	chr2	110734543	110734598	DNA/hAT-Charlie	2428	+	28	110734571	83946
chr2	162356072	162556072	harbor1	chr2	162376662	162376811	DNA/hAT-Charlie	663	+	74	162376736	20664
chr2	19182034	19382034	harbor1	chr2	19222271	19222510	DNA/hAT-Charlie	413	+	120	19222391	40357
chr2	19182034	19382034	harbor1	chr2	19240700	19240862	DNA/hAT-Charlie	793	+	81	19240781	58747
chr2	19182034	19382034	harbor1	chr2	19267204	19267338	DNA/hAT-Charlie	565	+	67	19267271	85237
chr2	34046236	34246236	harbor1	chr2	34060580	34060765	DNA/hAT-Charlie	456	+	92	34060672	14436
chr2	34046236	34246236	harbor1	chr2	34070829	34070881	DNA/hAT-Charlie	423	+	26	34070855	24619
chr2	34046236	34246236	harbor1	chr2	34087951	34088376	DNA/hAT-Charlie	1105	+	212	34088163	41927
chr2	34046236	34246236	harbor1	chr2	34092098	34092310	DNA/hAT-Charlie	778	+	106	34092204	45968
chr2	34046236	34246236	harbor1	chr2	34123705	34123881	DNA/hAT-Charlie	491	+	88	34123793	77557
chr2	189501373	189701373	harbor1	chr2	189558583	189558659	DNA/hAT-Charlie	931	+	38	189558621	57248
chr2	189501373	189701373	harbor1	chr2	189558973	189559353	DNA/hAT-Charlie	931	+	190	189559163	57790
chr2	37675894	37875894	harbor1	chr2	37717940	37718123	DNA/hAT-Charlie	974	+	92	37718032	42138
chr2	37675894	37875894	harbor1	chr2	37740946	37741196	DNA/hAT-Charlie	685	+	125	37741071	65177
chr2	37675894	37875894	harbor1	chr2	37754976	37755082	DNA/hAT-Charlie	453	+	53	37755029	79135
chr2	179578651	179778651	harbor1	chr2	179615332	179615504	DNA/hAT-Charlie	818	+	86	179615418	36767
chr2	179578651	179778651	harbor1	chr2	179642533	179643507	DNA/hAT-Charlie	3913	+	487	179643020	64369
chr2	179578651	179778651	harbor1	chr2	179676722	179676867	DNA/hAT-Charlie	783	+	72	179676794	98143
chr2	169077780	169277780	harbor1	chr2	169095184	169095360	DNA/hAT-Charlie	860	+	88	169095272	17492
chr2	169077780	169277780	harbor1	chr2	169131589	169131786	DNA/hAT-Charlie	478	+	98	169131687	53907
chr2	169077780	169277780	harbor1	chr2	169140152	169140291	DNA/hAT-Charlie	548	+	70	169140222	62442
chr2	169077780	169277780	harbor1	chr2	169144157	169144333	DNA/hAT-Charlie	891	+	88	169144245	66465
chr2	199086750	199286750	harbor1	chr2	199129288	199129472	DNA/hAT-Charlie	849	+	92	199129380	42630
chr2	199086750	199286750	harbor1	chr2	199133786	199133934	DNA/hAT-Charlie	402	+	74	199133860	47110
chr2	102970028	103170028	harbor1	chr2	102999121	102999453	DNA/hAT-Charlie	2227	+	166	102999287	29259
chr2	102970028	103170028	harbor1	chr2	103017061	103017298	DNA/hAT-Charlie	615	+	118	103017179	47151
chr2	190575386	190775386	harbor1	chr2	190607360	190607512	DNA/hAT-Charlie	479	+	76	190607436	32050
chr2	190575386	190775386	harbor1	chr2	190652904	190653077	DNA/hAT-Charlie	1054	+	86	190652990	77604
chr2	190575386	190775386	harbor1	chr2	190663374	190663595	DNA/hAT-Charlie	1195	+	110	190663484	88098
chr2	190597983	190797983	harbor1	chr2	190607360	190607512	DNA/hAT-Charlie	479	+	76	190607436	9453
chr2	190597983	190797983	harbor1	chr2	190652904	190653077	DNA/hAT-Charlie	1054	+	86	190652990	55007
chr2	190597983	190797983	harbor1	chr2	190663374	190663595	DNA/hAT-Charlie	1195	+	110	190663484	65501
chr2	15138323	15338323	harbor1	chr2	15145719	15145891	DNA/hAT-Charlie	786	+	86	15145805	7482
chr2	15138323	15338323	harbor1	chr2	15180664	15180808	DNA/hAT-Charlie	564	+	72	15180736	42413
chr2	15138323	15338323	harbor1	chr2	15225930	15226085	DNA/hAT-Charlie	874	+	78	15226008	87685
chr2	45233566	45433566	harbor1	chr2	45234487	45234616	DNA/hAT-Charlie	554	+	64	45234551	985
chr2	45233566	45433566	harbor1	chr2	45234683	45235458	DNA/hAT-Charlie	3418	+	388	45235071	1505
chr2	45233566	45433566	harbor1	chr2	45235746	45236172	DNA/hAT-Charlie	3418	+	213	45235959	2393
chr2	45233566	45433566	harbor1	chr2	45251437	45251535	DNA/hAT-Charlie	488	+	49	45251486	17920
chr2	45233566	45433566	harbor1	chr2	45293989	45294306	DNA/hAT-Charlie	1546	+	158	45294147	60581
chr2	45233566	45433566	harbor1	chr2	45297090	45297393	DNA/hAT-Charlie	1427	+	152	45297242	63676
chr2	45233566	45433566	harbor1	chr2	45316988	45317169	DNA/hAT-Charlie	840	+	90	45317078	83512
chr2	170846863	171046863	harbor1	chr2	170888636	170888794	DNA/hAT-Charlie	766	+	79	170888715	41852
chr2	170846863	171046863	harbor1	chr2	170889249	170889404	DNA/hAT-Charlie	443	+	78	170889327	42464
chr2	170846863	171046863	harbor1	chr2	170913776	170914009	DNA/hAT-Charlie	571	+	116	170913892	67029
chr2	54040615	54240615	harbor1	chr2	54043304	54043470	DNA/hAT-Charlie	581	+	83	54043387	2772
chr2	54040615	54240615	harbor1	chr2	54043552	54043711	DNA/hAT-Charlie	436	+	80	54043632	3017
chr2	54040615	54240615	harbor1	chr2	54061986	54062124	DNA/hAT-Charlie	580	+	69	54062055	21440
chr2	54040615	54240615	harbor1	chr2	54104703	54104856	DNA/hAT-Charlie	424	+	76	54104779	64164
chr2	191969839	192169839	harbor1	chr2	192019984	192020445	DNA/hAT-Charlie	451	+	230	192020214	50375
chr2	191969839	192169839	harbor1	chr2	192060394	192060639	DNA/hAT-Charlie	586	+	122	192060516	90677
chr2	18220720	18420720	harbor1	chr2	18249976	18250173	DNA/hAT-Charlie	651	+	98	18250074	29354
chr2	102050179	102250179	harbor1	chr2	102135742	102135941	DNA/hAT-Charlie	889	+	100	102135842	85663
chr2	2388272	2588272	harbor1	chr2	2410203	2410418	DNA/hAT-Charlie	610	+	108	2410311	22039
chr2	186354208	186554208	harbor1	chr2	186368744	186368908	DNA/hAT-Charlie	563	+	82	186368826	14618
chr2	186354208	186554208	harbor1	chr2	186392972	186393137	DNA/hAT-Charlie	409	+	82	186393054	38846
chr2	186354208	186554208	harbor1	chr2	186426408	186426579	DNA/hAT-Charlie	473	+	86	186426494	72286
chr2	223999586	224199586	harbor1	chr2	224007947	224008091	DNA/hAT-Charlie	487	+	72	224008019	8433
chr2	223999586	224199586	harbor1	chr2	224014926	224015194	DNA/hAT-Charlie	741	+	134	224015060	15474
chr2	166610858	166810858	harbor1	chr2	166681504	166681663	DNA/hAT-Charlie	667	+	80	166681584	70726
chr2	228586400	228786400	harbor1	chr2	228594574	228594705	DNA/hAT-Charlie	410	+	66	228594640	8240
chr2	228586400	228786400	harbor1	chr2	228644594	228644855	DNA/hAT-Charlie	551	+	130	228644724	58324
chr2	228586400	228786400	harbor1	chr2	228657438	228657627	DNA/hAT-Charlie	613	+	94	228657532	71132
chr2	228586400	228786400	harbor1	chr2	228662905	228663122	DNA/hAT-Charlie	1442	+	108	228663013	76613
chr2	24166311	24366311	harbor1	chr2	24185674	24185817	DNA/hAT-Charlie	609	+	72	24185746	19435
chr2	24166311	24366311	harbor1	chr2	24221410	24221614	DNA/hAT-Charlie	445	+	102	24221512	55201
chr2	24166311	24366311	harbor1	chr2	24237757	24237912	DNA/hAT-Charlie	541	+	78	24237835	71524
chr2	24166311	24366311	harbor1	chr2	24249793	24250927	DNA/hAT-Charlie	5251	+	567	24250360	84049
chr2	24166311	24366311	harbor1	chr2	24251678	24251919	DNA/hAT-Charlie	846	+	120	24251798	85487
chr2	54060360	54260360	harbor1	chr2	54061986	54062124	DNA/hAT-Charlie	580	+	69	54062055	1695
chr2	54060360	54260360	harbor1	chr2	54104703	54104856	DNA/hAT-Charlie	424	+	76	54104779	44419
chr2	54060360	54260360	harbor1	chr2	54150111	54150307	DNA/hAT-Charlie	883	+	98	54150209	89849
chr2	54060360	54260360	harbor1	chr2	54155416	54155688	DNA/hAT-Charlie	1393	+	136	54155552	95192
chr2	200956	400956	harbor1	chr2	222442	222529	DNA/hAT-Charlie	472	+	44	222486	21530
chr2	200956	400956	harbor1	chr2	239208	239376	DNA/hAT-Charlie	578	+	84	239292	38336
chr2	131845912	132045912	harbor1	chr2	131847494	131847561	DNA/hAT-Charlie	455	+	34	131847528	1616
chr2	131845912	132045912	harbor1	chr2	131847857	131847966	DNA/hAT-Charlie	455	+	54	131847911	1999
chr2	6687245	6887245	harbor1	chr2	6719004	6719154	DNA/hAT-Charlie	557	+	75	6719079	31834
chr2	6687245	6887245	harbor1	chr2	6776642	6776926	DNA/hAT-Charlie	1940	+	142	6776784	89539
chr2	180469937	180669937	harbor1	chr2	180474876	180475056	DNA/hAT-Charlie	755	+	90	180474966	5029
chr2	180469937	180669937	harbor1	chr2	180517744	180517912	DNA/hAT-Charlie	519	+	84	180517828	47891
chr2	99244365	99444365	harbor1	chr2	99257103	99257295	DNA/hAT-Charlie	710	+	96	99257199	12834
chr2	99244365	99444365	harbor1	chr2	99279324	99279437	DNA/hAT-Charlie	451	+	56	99279380	35015
chr2	99244365	99444365	harbor1	chr2	99279751	99279891	DNA/hAT-Charlie	987	+	70	99279821	35456
chr2	99244365	99444365	harbor1	chr2	99288988	99289143	DNA/hAT-Charlie	804	+	78	99289066	44701
chr2	99244365	99444365	harbor1	chr2	99306751	99306939	DNA/hAT-Charlie	620	+	94	99306845	62480
chr2	97693356	97893356	harbor1	chr2	97698617	97698802	DNA/hAT-Charlie	814	+	92	97698709	5353
chr2	97693356	97893356	harbor1	chr2	97715206	97715365	DNA/hAT-Charlie	419	+	80	97715286	21930
chr2	97693356	97893356	harbor1	chr2	97736191	97736281	DNA/hAT-Charlie	443	+	45	97736236	42880
chr2	97693356	97893356	harbor1	chr2	97757721	97757813	DNA/hAT-Charlie	403	+	46	97757767	64411
chr2	97693356	97893356	harbor1	chr2	97777392	97777589	DNA/hAT-Charlie	1027	+	98	97777490	84134
chr2	97693356	97893356	harbor1	chr2	97779551	97779700	DNA/hAT-Charlie	725	+	74	97779625	86269
chr2	95595556	95795556	harbor1	chr2	95653972	95654145	DNA/hAT-Charlie	906	+	86	95654058	58502
chr2	95595556	95795556	harbor1	chr2	95685653	95685933	DNA/hAT-Charlie	536	+	140	95685793	90237
chr2	95595556	95795556	harbor1	chr2	95687819	95687955	DNA/hAT-Charlie	401	+	68	95687887	92331
chr2	95595556	95795556	harbor1	chr2	95687961	95688056	DNA/hAT-Charlie	609	+	48	95688009	92453
chr2	60543293	60743293	harbor1	chr2	60597545	60597753	DNA/hAT-Charlie	1224	+	104	60597649	54356
chr2	60543293	60743293	harbor1	chr2	60642683	60642706	DNA/hAT-Charlie	494	+	12	60642695	99402
chr2	60543293	60743293	harbor1	chr2	60642737	60642854	DNA/hAT-Charlie	494	+	58	60642795	99502
chr2	48912957	49112957	harbor1	chr2	48979046	48979162	DNA/hAT-Charlie	560	+	58	48979104	66147
chr2	48912957	49112957	harbor1	chr2	48984738	48984911	DNA/hAT-Charlie	423	+	86	48984824	71867
chr2	48912957	49112957	harbor1	chr2	48998058	48998998	DNA/hAT-Charlie	1770	+	470	48998528	85571
chr2	48912957	49112957	harbor1	chr2	48999667	48999848	DNA/hAT-Charlie	600	+	90	48999757	86800
chr2	168090572	168290572	harbor1	chr2	168130175	168130320	DNA/hAT-Charlie	441	+	72	168130247	39675
chr2	168090572	168290572	harbor1	chr2	168149965	168150121	DNA/hAT-Charlie	736	+	78	168150043	59471
chr2	45738140	45938140	harbor1	chr2	45788894	45789050	DNA/hAT-Charlie	546	+	78	45788972	50832
chr2	45738140	45938140	harbor1	chr2	45807665	45807842	DNA/hAT-Charlie	980	+	88	45807753	69613
chr2	164279231	164479231	harbor1	chr2	164323955	164324097	DNA/hAT-Charlie	445	+	71	164324026	44795
chr2	164279231	164479231	harbor1	chr2	164359844	164360004	DNA/hAT-Charlie	733	+	80	164359924	80693
chr2	69268821	69468821	harbor1	chr2	69295218	69295349	DNA/hAT-Charlie	588	+	66	69295284	26463
chr2	69268821	69468821	harbor1	chr2	69355438	69355604	DNA/hAT-Charlie	834	+	83	69355521	86700
chr2	76916723	77116723	harbor1	chr2	76929337	76929460	DNA/hAT-Charlie	459	+	62	76929399	12676
chr2	76916723	77116723	harbor1	chr2	76971184	76971359	DNA/hAT-Charlie	482	+	88	76971272	54549
chr2	76916723	77116723	harbor1	chr2	76997687	76998215	DNA/hAT-Charlie	3529	+	264	76997951	81228
chr2	234043830	234243830	harbor1	chr2	234053443	234053611	DNA/hAT-Charlie	419	+	84	234053527	9697
chr2	29534903	29734903	harbor1	chr2	29544246	29544506	DNA/hAT-Charlie	1025	+	130	29544376	9473
chr2	29534903	29734903	harbor1	chr2	29548940	29549013	DNA/hAT-Charlie	483	+	36	29548976	14073
chr2	29534903	29734903	harbor1	chr2	29549473	29549594	DNA/hAT-Charlie	710	+	60	29549533	14630
chr2	29534903	29734903	harbor1	chr2	29549589	29549934	DNA/hAT-Charlie	1441	+	172	29549761	14858
chr2	29534903	29734903	harbor1	chr2	29554478	29554658	DNA/hAT-Charlie	481	+	90	29554568	19665
chr2	29534903	29734903	harbor1	chr2	29555216	29555262	DNA/hAT-Charlie	481	+	23	29555239	20336
chr2	29534903	29734903	harbor1	chr2	29559873	29560020	DNA/hAT-Charlie	554	+	74	29559947	25044
chr2	29534903	29734903	harbor1	chr2	29561046	29561214	DNA/hAT-Charlie	924	+	84	29561130	26227
chr2	29534903	29734903	harbor1	chr2	29573354	29573499	DNA/hAT-Charlie	454	+	72	29573426	38523
chr2	29534903	29734903	harbor1	chr2	29573536	29573737	DNA/hAT-Charlie	989	+	100	29573636	38733
chr2	29534903	29734903	harbor1	chr2	29576610	29577100	DNA/hAT-Charlie	3401	+	245	29576855	41952
chr2	29534903	29734903	harbor1	chr2	29589124	29589274	DNA/hAT-Charlie	586	+	75	29589199	54296
chr2	29534903	29734903	harbor1	chr2	29593952	29594164	DNA/hAT-Charlie	1181	+	106	29594058	59155
chr2	29534903	29734903	harbor1	chr2	29604084	29604364	DNA/hAT-Charlie	1231	+	140	29604224	69321
chr2	29534903	29734903	harbor1	chr2	29606601	29606817	DNA/hAT-Charlie	1179	+	108	29606709	71806
chr2	141435450	141635450	harbor1	chr2	141440827	141441054	DNA/hAT-Charlie	560	+	114	141440941	5491
chr2	141435450	141635450	harbor1	chr2	141522069	141522247	DNA/hAT-Charlie	832	+	89	141522158	86708
chr2	141435450	141635450	harbor1	chr2	141524453	141524674	DNA/hAT-Charlie	1315	+	110	141524563	89113
chr2	33406391	33606391	harbor1	chr2	33489004	33489226	DNA/hAT-Charlie	1246	+	111	33489115	82724
chr2	33406391	33606391	harbor1	chr2	33406825	33407414	DNA/hAT-Charlie	1851	+	294	33407119	728
chr2	133740922	133940922	harbor1	chr2	133822710	133822946	DNA/hAT-Charlie	636	+	118	133822828	81906
chr2	65955052	66155052	harbor1	chr2	66001033	66001195	DNA/hAT-Charlie	921	+	81	66001114	46062
chr2	65955052	66155052	harbor1	chr2	66008540	66008705	DNA/hAT-Charlie	742	+	82	66008622	53570
chr2	65955052	66155052	harbor1	chr2	66016215	66016436	DNA/hAT-Charlie	590	+	110	66016325	61273
chr2	65955052	66155052	harbor1	chr2	66016436	66016753	DNA/hAT-Charlie	1282	+	158	66016594	61542
chr2	65955052	66155052	harbor1	chr2	66016800	66017108	DNA/hAT-Charlie	506	+	154	66016954	61902
chr2	65955052	66155052	harbor1	chr2	66022287	66022446	DNA/hAT-Charlie	632	+	80	66022367	67315
chr2	65955052	66155052	harbor1	chr2	66022458	66022667	DNA/hAT-Charlie	1392	+	104	66022562	67510
chr2	113883993	114083993	harbor1	chr2	113887403	113887596	DNA/hAT-Charlie	532	+	96	113887499	3506
chr2	113883993	114083993	harbor1	chr2	113888918	113889050	DNA/hAT-Charlie	670	+	66	113888984	4991
chr2	113883993	114083993	harbor1	chr2	113907039	113907282	DNA/hAT-Charlie	586	+	122	113907161	23168
chr2	113883993	114083993	harbor1	chr2	113907552	113907690	DNA/hAT-Charlie	586	+	69	113907621	23628
chr2	113883993	114083993	harbor1	chr2	113908003	113908098	DNA/hAT-Charlie	586	+	48	113908051	24058
chr2	113883993	114083993	harbor1	chr2	113908108	113908496	DNA/hAT-Charlie	715	+	194	113908302	24309
chr2	210783285	210983285	harbor1	chr2	210841867	210841992	DNA/hAT-Charlie	634	+	62	210841929	58644
chr2	210783285	210983285	harbor1	chr2	210881768	210881918	DNA/hAT-Charlie	470	+	75	210881843	98558
chr2	24610513	24810513	harbor1	chr2	24623550	24623586	DNA/hAT-Charlie	866	+	18	24623568	13055
chr2	24610513	24810513	harbor1	chr2	24623964	24624179	DNA/hAT-Charlie	866	+	108	24624072	13559
chr2	24610513	24810513	harbor1	chr2	24624201	24624324	DNA/hAT-Charlie	539	+	62	24624263	13750
chr2	124622456	124822456	harbor1	chr2	124686909	124687025	DNA/hAT-Charlie	563	+	58	124686967	64511
chr2	124622456	124822456	harbor1	chr2	124692247	124692445	DNA/hAT-Charlie	965	+	99	124692346	69890
chr2	124622456	124822456	harbor1	chr2	124698942	124699116	DNA/hAT-Charlie	569	+	87	124699029	76573
chr2	191323087	191523087	harbor1	chr2	191345144	191345285	DNA/hAT-Charlie	510	+	70	191345214	22127
chr2	191323087	191523087	harbor1	chr2	191373207	191373372	DNA/hAT-Charlie	830	+	82	191373289	50202
chr2	191323087	191523087	harbor1	chr2	191397000	191397121	DNA/hAT-Charlie	437	+	60	191397060	73973
chr2	191323087	191523087	harbor1	chr2	191399323	191399535	DNA/hAT-Charlie	1058	+	106	191399429	76342
chr2	191323087	191523087	harbor1	chr2	191410515	191410737	DNA/hAT-Charlie	686	+	111	191410626	87539
chr2	191323087	191523087	harbor1	chr2	191415463	191415662	DNA/hAT-Charlie	514	+	100	191415563	92476
chr2	36764907	36964907	harbor1	chr2	36776265	36776518	DNA/hAT-Charlie	1052	+	126	36776391	11484
chr2	36764907	36964907	harbor1	chr2	36777120	36777288	DNA/hAT-Charlie	1052	+	84	36777204	12297
chr2	36764907	36964907	harbor1	chr2	36784361	36784437	DNA/hAT-Charlie	473	+	38	36784399	19492
chr2	36764907	36964907	harbor1	chr2	36792051	36792168	DNA/hAT-Charlie	535	+	58	36792109	27202
chr2	36764907	36964907	harbor1	chr2	36792555	36792711	DNA/hAT-Charlie	723	+	78	36792633	27726
chr2	36764907	36964907	harbor1	chr2	36792947	36793095	DNA/hAT-Charlie	795	+	74	36793021	28114
chr2	36764907	36964907	harbor1	chr2	36815358	36815515	DNA/hAT-Charlie	432	+	78	36815436	50529
chr2	36764907	36964907	harbor1	chr2	36861425	36861659	DNA/hAT-Charlie	755	+	117	36861542	96635
chr2	138166622	138366622	harbor1	chr2	138196256	138197587	DNA/hAT-Charlie	2464	+	666	138196922	30300
chr2	138166622	138366622	harbor1	chr2	138197602	138198263	DNA/hAT-Charlie	1300	+	330	138197932	31310
chr2	138166622	138366622	harbor1	chr2	138198554	138198809	DNA/hAT-Charlie	1300	+	128	138198682	32060
chr2	138166622	138366622	harbor1	chr2	138238963	138239142	DNA/hAT-Charlie	650	+	90	138239053	72431
chr2	123327493	123527493	harbor1	chr2	123328647	123328993	DNA/hAT-Charlie	1646	+	173	123328820	1327
chr2	123327493	123527493	harbor1	chr2	123397960	123398080	DNA/hAT-Charlie	488	+	60	123398020	70527
chr2	195349835	195549835	harbor1	chr2	195392933	195393121	DNA/hAT-Charlie	576	+	94	195393027	43192
chr2	132720014	132920014	harbor1	chr2	132727428	132727590	DNA/hAT-Charlie	507	+	81	132727509	7495
chr2	132720014	132920014	harbor1	chr2	132772284	132772409	DNA/hAT-Charlie	498	+	62	132772346	52332
chr2	132720014	132920014	harbor1	chr2	132818379	132818393	DNA/hAT-Charlie	1616	+	7	132818386	98372
chr2	132720014	132920014	harbor1	chr2	132818680	132819135	DNA/hAT-Charlie	1616	+	228	132818908	98894
chr2	149035773	149235773	harbor1	chr2	149052926	149053114	DNA/hAT-Charlie	747	+	94	149053020	17247
chr2	149035773	149235773	harbor1	chr2	149122784	149123485	DNA/hAT-Charlie	1575	+	350	149123134	87361
chr2	44192465	44392465	harbor1	chr2	44199497	44199703	DNA/hAT-Charlie	657	+	103	44199600	7135
chr2	44192465	44392465	harbor1	chr2	44216250	44216413	DNA/hAT-Charlie	806	+	82	44216332	23867
chr2	44192465	44392465	harbor1	chr2	44226497	44226659	DNA/hAT-Charlie	514	+	81	44226578	34113
chr2	66207082	66407082	harbor1	chr2	66279440	66279739	DNA/hAT-Charlie	1310	+	150	66279590	72508
chr2	66207082	66407082	harbor1	chr2	66304804	66305114	DNA/hAT-Charlie	1404	+	155	66304959	97877
chr2	111331440	111531440	harbor1	chr2	111415048	111415267	DNA/hAT-Charlie	1144	+	110	111415158	83718
chr2	111331440	111531440	harbor1	chr2	111426887	111426930	DNA/hAT-Charlie	467	+	22	111426909	95469
chr2	39252493	39452493	harbor1	chr2	39259228	39259393	DNA/hAT-Charlie	560	+	82	39259310	6817
chr2	39252493	39452493	harbor1	chr2	39268114	39268233	DNA/hAT-Charlie	437	+	60	39268174	15681
chr2	39252493	39452493	harbor1	chr2	39269620	39269906	DNA/hAT-Charlie	632	+	143	39269763	17270
chr2	39252493	39452493	harbor1	chr2	39273233	39273418	DNA/hAT-Charlie	979	+	92	39273325	20832
chr2	39252493	39452493	harbor1	chr2	39294805	39295129	DNA/hAT-Charlie	1421	+	162	39294967	42474
chr2	39252493	39452493	harbor1	chr2	39295308	39295499	DNA/hAT-Charlie	728	+	96	39295404	42911
chr2	39252493	39452493	harbor1	chr2	39314908	39315032	DNA/hAT-Charlie	516	+	62	39314970	62477
chr2	39252493	39452493	harbor1	chr2	39318921	39319141	DNA/hAT-Charlie	1183	+	110	39319031	66538
chr2	39252493	39452493	harbor1	chr2	39344398	39344629	DNA/hAT-Charlie	1207	+	116	39344514	92021
chr2	39252493	39452493	harbor1	chr2	39346975	39347202	DNA/hAT-Charlie	1195	+	114	39347089	94596
chr2	39252493	39452493	harbor1	chr2	39347199	39347342	DNA/hAT-Charlie	748	+	72	39347271	94778
chr2	39252493	39452493	harbor1	chr2	39349965	39350183	DNA/hAT-Charlie	1053	+	109	39350074	97581
chr2	55831726	56031726	harbor1	chr2	55879705	55879918	DNA/hAT-Charlie	777	+	106	55879811	48085
chr2	55831726	56031726	harbor1	chr2	55903472	55903603	DNA/hAT-Charlie	696	+	66	55903538	71812
chr2	55831726	56031726	harbor1	chr2	55928286	55928422	DNA/hAT-Charlie	1888	+	68	55928354	96628
chr2	55831726	56031726	harbor1	chr2	55928677	55929296	DNA/hAT-Charlie	1888	+	310	55928987	97261
chr2	131786528	131986528	harbor1	chr2	131847494	131847561	DNA/hAT-Charlie	455	+	34	131847528	61000
chr2	131786528	131986528	harbor1	chr2	131847857	131847966	DNA/hAT-Charlie	455	+	54	131847911	61383
chr2	54761079	54961079	harbor1	chr2	54799642	54799760	DNA/hAT-Charlie	570	+	59	54799701	38622
chr2	54761079	54961079	harbor1	chr2	54835691	54835893	DNA/hAT-Charlie	962	+	101	54835792	74713
chr2	229966213	230166213	harbor1	chr2	230002814	230002944	DNA/hAT-Charlie	483	+	65	230002879	36666
chr2	229966213	230166213	harbor1	chr2	230003233	230003352	DNA/hAT-Charlie	483	+	60	230003293	37080
chr2	229966213	230166213	harbor1	chr2	230019888	230020052	DNA/hAT-Charlie	665	+	82	230019970	53757
chr2	229966213	230166213	harbor1	chr2	230024731	230024849	DNA/hAT-Charlie	3731	+	59	230024790	58577
chr2	229966213	230166213	harbor1	chr2	230025159	230025431	DNA/hAT-Charlie	3731	+	136	230025295	59082
chr2	229966213	230166213	harbor1	chr2	230025639	230025765	DNA/hAT-Charlie	3731	+	63	230025702	59489
chr2	229966213	230166213	harbor1	chr2	230026069	230026639	DNA/hAT-Charlie	3731	+	285	230026354	60141
chr2	229966213	230166213	harbor1	chr2	230026844	230027022	DNA/hAT-Charlie	910	+	89	230026933	60720
chr2	229966213	230166213	harbor1	chr2	230027683	230028073	DNA/hAT-Charlie	1297	+	195	230027878	61665
chr2	229966213	230166213	harbor1	chr2	230028631	230028909	DNA/hAT-Charlie	1297	+	139	230028770	62557
chr2	229966213	230166213	harbor1	chr2	230028917	230028994	DNA/hAT-Charlie	987	+	38	230028955	62742
chr2	229966213	230166213	harbor1	chr2	230029285	230029426	DNA/hAT-Charlie	987	+	70	230029355	63142
chr2	229966213	230166213	harbor1	chr2	230029724	230029818	DNA/hAT-Charlie	987	+	47	230029771	63558
chr2	229966213	230166213	harbor1	chr2	230050162	230050475	DNA/hAT-Charlie	507	+	156	230050318	84105
chr2	238986786	239186786	harbor1	chr2	239009896	239010536	DNA/hAT-Charlie	2261	+	320	239010216	23430
chr2	238986786	239186786	harbor1	chr2	239010842	239010884	DNA/hAT-Charlie	2261	+	21	239010863	24077
chr2	238986786	239186786	harbor1	chr2	239022067	239022158	DNA/hAT-Charlie	418	+	46	239022113	35327
chr2	238986786	239186786	harbor1	chr2	239029213	239029401	DNA/hAT-Charlie	585	+	94	239029307	42521
chr2	57573476	57773476	harbor1	chr2	57602555	57602763	DNA/hAT-Charlie	770	+	104	57602659	29183
chr2	57573476	57773476	harbor1	chr2	57607942	57608379	DNA/hAT-Charlie	1373	+	218	57608160	34684
chr2	197312438	197512438	harbor1	chr2	197332044	197332276	DNA/hAT-Charlie	827	+	116	197332160	19722
chr2	197312438	197512438	harbor1	chr2	197353741	197353992	DNA/hAT-Charlie	404	+	126	197353867	41429
chr2	197312438	197512438	harbor1	chr2	197389308	197389526	DNA/hAT-Charlie	1325	+	109	197389417	76979
chr2	165670113	165870113	harbor1	chr2	165677158	165677390	DNA/hAT-Charlie	1047	+	116	165677274	7161
chr2	165670113	165870113	harbor1	chr2	165701090	165701299	DNA/hAT-Charlie	984	+	104	165701194	31081
chr2	165670113	165870113	harbor1	chr2	165744732	165744840	DNA/hAT-Charlie	513	+	54	165744786	74673
chr2	28248505	28448505	harbor1	chr2	28248988	28249075	DNA/hAT-Charlie	719	+	44	28249032	527
chr2	28248505	28448505	harbor1	chr2	28249389	28249518	DNA/hAT-Charlie	719	+	64	28249453	948
chr2	28248505	28448505	harbor1	chr2	28298546	28298748	DNA/hAT-Charlie	1106	+	101	28298647	50142
chr2	28248505	28448505	harbor1	chr2	28318258	28318479	DNA/hAT-Charlie	968	+	110	28318368	69863
chr2	62279677	62479677	harbor1	chr2	62366883	62366904	DNA/hAT-Charlie	789	+	10	62366893	87216
chr2	62279677	62479677	harbor1	chr2	62367201	62367368	DNA/hAT-Charlie	789	+	84	62367285	87608
chr2	62279677	62479677	harbor1	chr2	62367668	62367795	DNA/hAT-Charlie	789	+	64	62367732	88055
chr2	62279677	62479677	harbor1	chr2	62370338	62370513	DNA/hAT-Charlie	870	+	88	62370426	90749
chr2	2267415	2467415	harbor1	chr2	2288495	2288734	DNA/hAT-Charlie	820	+	120	2288615	21200
chr2	2267415	2467415	harbor1	chr2	2290686	2290855	DNA/hAT-Charlie	480	+	84	2290770	23355
chr2	2267415	2467415	harbor1	chr2	2304893	2305094	DNA/hAT-Charlie	726	+	100	2304993	37578
chr2	2267415	2467415	harbor1	chr2	2335778	2336078	DNA/hAT-Charlie	1612	+	150	2335928	68513
chr2	2267415	2467415	harbor1	chr2	2340693	2340821	DNA/hAT-Charlie	434	+	64	2340757	73342
chr2	5948330	6148330	harbor1	chr2	6031462	6031656	DNA/hAT-Charlie	755	+	97	6031559	83229
chr2	140778440	140978440	harbor1	chr2	140777962	140778800	DNA/hAT-Charlie	3192	+	419	140778381	59
chr2	140778440	140978440	harbor1	chr2	140778820	140779124	DNA/hAT-Charlie	887	+	152	140778972	532
chr2	140778440	140978440	harbor1	chr2	140802158	140802760	DNA/hAT-Charlie	1906	+	301	140802459	24019
chr2	140778440	140978440	harbor1	chr2	140809225	140809449	DNA/hAT-Charlie	443	+	112	140809337	30897
chr2	140778440	140978440	harbor1	chr2	140854609	140854796	DNA/hAT-Charlie	889	+	94	140854703	76263
chr2	140778440	140978440	harbor1	chr2	140858020	140858260	DNA/hAT-Charlie	753	+	120	140858140	79700
chr2	140778440	140978440	harbor1	chr2	140862259	140862502	DNA/hAT-Charlie	1172	+	122	140862381	83941
chr2	140778440	140978440	harbor1	chr2	140863349	140863493	DNA/hAT-Charlie	733	+	72	140863421	84981
chr2	87028414	87228414	harbor1	chr2	87028939	87029152	DNA/hAT-Charlie	901	+	106	87029045	631
chr2	122163960	122363960	harbor1	chr2	122182215	122182388	DNA/hAT-Charlie	497	+	86	122182301	18341
chr2	122163960	122363960	harbor1	chr2	122205288	122205429	DNA/hAT-Charlie	414	+	70	122205358	41398
chr2	122163960	122363960	harbor1	chr2	122225482	122225659	DNA/hAT-Charlie	486	+	88	122225570	61610
chr2	122163960	122363960	harbor1	chr2	122252703	122252822	DNA/hAT-Charlie	472	+	60	122252763	88803
chr2	122163960	122363960	harbor1	chr2	122263807	122264010	DNA/hAT-Charlie	996	+	102	122263909	99949
chr2	197954001	198154001	harbor1	chr2	197968917	197969233	DNA/hAT-Charlie	1927	+	158	197969075	15074
chr2	197954001	198154001	harbor1	chr2	197970005	197970066	DNA/hAT-Charlie	1331	+	30	197970035	16034
chr2	197954001	198154001	harbor1	chr2	197970456	197970696	DNA/hAT-Charlie	1331	+	120	197970576	16575
chr2	197954001	198154001	harbor1	chr2	197985608	197985784	DNA/hAT-Charlie	717	+	88	197985696	31695
chr2	197954001	198154001	harbor1	chr2	197987182	197987542	DNA/hAT-Charlie	831	+	180	197987362	33361
chr2	197954001	198154001	harbor1	chr2	198001667	198002179	DNA/hAT-Charlie	3749	+	256	198001923	47922
chr2	197954001	198154001	harbor1	chr2	198026176	198026363	DNA/hAT-Charlie	499	+	94	198026270	72269
chr2	197954001	198154001	harbor1	chr2	198046055	198046260	DNA/hAT-Charlie	1125	+	102	198046157	92156
chr2	169674112	169874112	harbor1	chr2	169723467	169723687	DNA/hAT-Charlie	1469	+	110	169723577	49465
chr2	169674112	169874112	harbor1	chr2	169743501	169743733	DNA/hAT-Charlie	642	+	116	169743617	69505
chr2	169674112	169874112	harbor1	chr2	169751063	169751220	DNA/hAT-Charlie	483	+	78	169751141	77029
chr2	222830801	223030801	harbor1	chr2	222845689	222845928	DNA/hAT-Charlie	1287	+	120	222845809	15008
chr2	222830801	223030801	harbor1	chr2	222846054	222846130	DNA/hAT-Charlie	1287	+	38	222846092	15291
chr2	16651278	16851278	harbor1	chr2	16677817	16678039	DNA/hAT-Charlie	872	+	111	16677928	26650
chr2	16651278	16851278	harbor1	chr2	16691390	16691569	DNA/hAT-Charlie	554	+	90	16691480	40202
chr2	33575951	33775951	harbor1	chr2	33589746	33589921	DNA/hAT-Charlie	981	+	88	33589834	13883
chr2	33575951	33775951	harbor1	chr2	33604684	33604896	DNA/hAT-Charlie	408	+	106	33604790	28839
chr2	33575951	33775951	harbor1	chr2	33609216	33609361	DNA/hAT-Charlie	482	+	72	33609288	33337
chr2	33575951	33775951	harbor1	chr2	33644384	33644741	DNA/hAT-Charlie	2242	+	178	33644562	68611
chr2	33575951	33775951	harbor1	chr2	33649591	33649762	DNA/hAT-Charlie	632	+	86	33649677	73726
chr2	33575951	33775951	harbor1	chr2	33651729	33651961	DNA/hAT-Charlie	635	+	116	33651845	75894
chr2	33575951	33775951	harbor1	chr2	33675330	33675734	DNA/hAT-Charlie	977	+	202	33675532	99581
chr2	19174725	19374725	harbor1	chr2	19222271	19222510	DNA/hAT-Charlie	413	+	120	19222391	47666
chr2	19174725	19374725	harbor1	chr2	19240700	19240862	DNA/hAT-Charlie	793	+	81	19240781	66056
chr2	19174725	19374725	harbor1	chr2	19267204	19267338	DNA/hAT-Charlie	565	+	67	19267271	92546
chr2	18584961	18784961	harbor1	chr2	18593343	18593474	DNA/hAT-Charlie	558	+	66	18593409	8448
chr2	137692291	137892291	harbor1	chr2	137725635	137725807	DNA/hAT-Charlie	794	+	86	137725721	33430
chr2	137692291	137892291	harbor1	chr2	137728119	137728418	DNA/hAT-Charlie	453	+	150	137728269	35978
chr2	86859648	87059648	harbor1	chr2	86864428	86864631	DNA/hAT-Charlie	418	+	102	86864530	4882
chr2	86859648	87059648	harbor1	chr2	86864776	86865028	DNA/hAT-Charlie	677	+	126	86864902	5254
chr2	86859648	87059648	harbor1	chr2	86884081	86884166	DNA/hAT-Charlie	588	+	42	86884123	24475
chr2	86859648	87059648	harbor1	chr2	86884473	86884592	DNA/hAT-Charlie	588	+	60	86884533	24885
chr2	86859648	87059648	harbor1	chr2	86959001	86959203	DNA/hAT-Charlie	660	+	101	86959102	99454
chr2	167160013	167360013	harbor1	chr2	167185988	167186182	DNA/hAT-Charlie	819	+	97	167186085	26072
chr3	121881931	122081931	harbor1	chr3	121883898	121884058	DNA/hAT-Charlie	651	+	80	121883978	2047
chr3	121881931	122081931	harbor1	chr3	121884362	121884416	DNA/hAT-Charlie	651	+	27	121884389	2458
chr3	121881931	122081931	harbor1	chr3	121884727	121884837	DNA/hAT-Charlie	651	+	55	121884782	2851
chr3	121881931	122081931	harbor1	chr3	121898542	121898824	DNA/hAT-Charlie	827	+	141	121898683	16752
chr3	121881931	122081931	harbor1	chr3	121909712	121909922	DNA/hAT-Charlie	1471	+	105	121909817	27886
chr3	121430729	121630729	harbor1	chr3	121435646	121436033	DNA/hAT-Charlie	1624	+	194	121435840	5111
chr3	121430729	121630729	harbor1	chr3	121463057	121463093	DNA/hAT-Charlie	3122	+	18	121463075	32346
chr3	121430729	121630729	harbor1	chr3	121463452	121464243	DNA/hAT-Charlie	3122	+	396	121463848	33119
chr3	121430729	121630729	harbor1	chr3	121464396	121464570	DNA/hAT-Charlie	1557	+	87	121464483	33754
chr3	121430729	121630729	harbor1	chr3	121464895	121465074	DNA/hAT-Charlie	1557	+	90	121464985	34256
chr3	121430729	121630729	harbor1	chr3	121465387	121465465	DNA/hAT-Charlie	1557	+	39	121465426	34697
chr3	121430729	121630729	harbor1	chr3	121481258	121481449	DNA/hAT-Charlie	780	+	96	121481354	50625
chr3	121430729	121630729	harbor1	chr3	121491786	121492073	DNA/hAT-Charlie	1378	+	144	121491930	61201
chr3	146069718	146269718	harbor1	chr3	146158616	146158809	DNA/hAT-Charlie	855	+	96	146158712	88994
chr3	64425570	64625570	harbor1	chr3	64426444	64426605	DNA/hAT-Charlie	679	+	80	64426524	954
chr3	64425570	64625570	harbor1	chr3	64439912	64440066	DNA/hAT-Charlie	828	+	77	64439989	14419
chr3	64425570	64625570	harbor1	chr3	64451503	64451653	DNA/hAT-Charlie	654	+	75	64451578	26008
chr3	64425570	64625570	harbor1	chr3	64452777	64452948	DNA/hAT-Charlie	540	+	86	64452863	27293
chr3	64425570	64625570	harbor1	chr3	64453131	64453278	DNA/hAT-Charlie	446	+	74	64453205	27635
chr3	64425570	64625570	harbor1	chr3	64459482	64459631	DNA/hAT-Charlie	652	+	74	64459556	33986
chr3	64425570	64625570	harbor1	chr3	64522407	64524761	DNA/hAT-Charlie	11585	+	1177	64523584	98014
chr3	41084512	41284512	harbor1	chr3	41092185	41092317	DNA/hAT-Charlie	520	+	66	41092251	7739
chr3	41084512	41284512	harbor1	chr3	41138671	41138892	DNA/hAT-Charlie	986	+	110	41138781	54269
chr3	41084512	41284512	harbor1	chr3	41173827	41174039	DNA/hAT-Charlie	1243	+	106	41173933	89421
chr3	51350053	51550053	harbor1	chr3	51402408	51402566	DNA/hAT-Charlie	1006	+	79	51402487	52434
chr3	51350053	51550053	harbor1	chr3	51402872	51402921	DNA/hAT-Charlie	1006	+	24	51402896	52843
chr3	51350053	51550053	harbor1	chr3	51425928	51426215	DNA/hAT-Charlie	1519	+	144	51426072	76019
chr3	51350053	51550053	harbor1	chr3	51426510	51426652	DNA/hAT-Charlie	1519	+	71	51426581	76528
chr3	49991538	50191538	harbor1	chr3	50013876	50014062	DNA/hAT-Charlie	1172	+	93	50013969	22431
chr3	72242407	72442407	harbor1	chr3	72243845	72243903	DNA/hAT-Charlie	534	+	29	72243874	1467
chr3	72242407	72442407	harbor1	chr3	72244412	72244506	DNA/hAT-Charlie	534	+	47	72244459	2052
chr3	72242407	72442407	harbor1	chr3	72254400	72254638	DNA/hAT-Charlie	1067	+	119	72254519	12112
chr3	72242407	72442407	harbor1	chr3	72254621	72254760	DNA/hAT-Charlie	769	+	70	72254691	12284
chr3	72242407	72442407	harbor1	chr3	72265709	72265861	DNA/hAT-Charlie	426	+	76	72265785	23378
chr3	72242407	72442407	harbor1	chr3	72284031	72284199	DNA/hAT-Charlie	476	+	84	72284115	41708
chr3	72242407	72442407	harbor1	chr3	72292259	72292624	DNA/hAT-Charlie	1359	+	182	72292441	50034
chr3	72242407	72442407	harbor1	chr3	72292910	72292948	DNA/hAT-Charlie	1359	+	19	72292929	50522
chr3	72242407	72442407	harbor1	chr3	72293285	72293366	DNA/hAT-Charlie	1359	+	40	72293325	50918
chr3	72242407	72442407	harbor1	chr3	72297176	72297350	DNA/hAT-Charlie	813	+	87	72297263	54856
chr3	72242407	72442407	harbor1	chr3	72303403	72303789	DNA/hAT-Charlie	1563	+	193	72303596	61189
chr3	72242407	72442407	harbor1	chr3	72316111	72316269	DNA/hAT-Charlie	610	+	79	72316190	73783
chr3	72242407	72442407	harbor1	chr3	72323727	72324015	DNA/hAT-Charlie	637	+	144	72323871	81464
chr3	72242407	72442407	harbor1	chr3	72328884	72329055	DNA/hAT-Charlie	662	+	86	72328970	86563
chr3	36826635	37026635	harbor1	chr3	36835680	36835878	DNA/hAT-Charlie	983	+	99	36835779	9144
chr3	36826635	37026635	harbor1	chr3	36837788	36837958	DNA/hAT-Charlie	714	+	85	36837873	11238
chr3	36826635	37026635	harbor1	chr3	36858192	36858378	DNA/hAT-Charlie	1149	+	93	36858285	31650
chr3	36826635	37026635	harbor1	chr3	36869113	36869260	DNA/hAT-Charlie	620	+	74	36869187	42552
chr3	36826635	37026635	harbor1	chr3	36874872	36875060	DNA/hAT-Charlie	507	+	94	36874966	48331
chr3	36826635	37026635	harbor1	chr3	36875769	36875902	DNA/hAT-Charlie	554	+	66	36875835	49200
chr3	36826635	37026635	harbor1	chr3	36875918	36876089	DNA/hAT-Charlie	593	+	86	36876004	49369
chr3	36826635	37026635	harbor1	chr3	36878025	36878375	DNA/hAT-Charlie	2019	+	175	36878200	51565
chr3	36826635	37026635	harbor1	chr3	36887557	36887725	DNA/hAT-Charlie	1155	+	84	36887641	61006
chr3	36826635	37026635	harbor1	chr3	36906351	36906437	DNA/hAT-Charlie	1511	+	43	36906394	79759
chr3	36826635	37026635	harbor1	chr3	36906922	36907150	DNA/hAT-Charlie	1511	+	114	36907036	80401
chr3	36826635	37026635	harbor1	chr3	36907449	36907459	DNA/hAT-Charlie	1511	+	5	36907454	80819
chr3	36826635	37026635	harbor1	chr3	36907764	36907913	DNA/hAT-Charlie	1511	+	74	36907838	81203
chr3	36826635	37026635	harbor1	chr3	36916035	36916237	DNA/hAT-Charlie	1011	+	101	36916136	89501
chr3	36826635	37026635	harbor1	chr3	36917727	36917957	DNA/hAT-Charlie	682	+	115	36917842	91207
chr3	154409220	154609220	harbor1	chr3	154416358	154416481	DNA/hAT-Charlie	715	+	62	154416420	7200
chr3	154409220	154609220	harbor1	chr3	154442277	154442483	DNA/hAT-Charlie	732	+	103	154442380	33160
chr3	154409220	154609220	harbor1	chr3	154465291	154465506	DNA/hAT-Charlie	923	+	108	154465399	56179
chr3	154409220	154609220	harbor1	chr3	154466051	154466188	DNA/hAT-Charlie	505	+	68	154466119	56899
chr3	154409220	154609220	harbor1	chr3	154473973	154474177	DNA/hAT-Charlie	841	+	102	154474075	64855
chr3	154409220	154609220	harbor1	chr3	154475489	154475911	DNA/hAT-Charlie	1561	+	211	154475700	66480
chr3	148727451	148927451	harbor1	chr3	148730895	148731195	DNA/hAT-Charlie	1235	+	150	148731045	3594
chr3	148727451	148927451	harbor1	chr3	148750747	148750951	DNA/hAT-Charlie	1186	+	102	148750849	23398
chr3	148727451	148927451	harbor1	chr3	148812783	148812909	DNA/hAT-Charlie	760	+	63	148812846	85395
chr3	188616616	188816616	harbor1	chr3	188619484	188619707	DNA/hAT-Charlie	866	+	112	188619596	2980
chr3	188616616	188816616	harbor1	chr3	188634439	188634962	DNA/hAT-Charlie	3565	+	262	188634701	18085
chr3	188616616	188816616	harbor1	chr3	188650775	188650977	DNA/hAT-Charlie	769	+	101	188650876	34260
chr3	136705744	136905744	harbor1	chr3	136744976	136745154	DNA/hAT-Charlie	539	+	89	136745065	39321
chr3	136705744	136905744	harbor1	chr3	136789320	136789401	DNA/hAT-Charlie	892	+	40	136789360	83616
chr3	136705744	136905744	harbor1	chr3	136789717	136789960	DNA/hAT-Charlie	892	+	122	136789839	84095
chr3	113017192	113217192	harbor1	chr3	113075771	113076540	DNA/hAT-Charlie	3183	+	384	113076155	58963
chr3	113017192	113217192	harbor1	chr3	113076532	113076665	DNA/hAT-Charlie	676	+	66	113076598	59406
chr3	113017192	113217192	harbor1	chr3	113092411	113092556	DNA/hAT-Charlie	775	+	72	113092483	75291
chr3	113017192	113217192	harbor1	chr3	113107021	113107182	DNA/hAT-Charlie	824	+	80	113107101	89909
chr3	130389895	130589895	harbor1	chr3	130396513	130396817	DNA/hAT-Charlie	774	+	152	130396665	6770
chr3	130389895	130589895	harbor1	chr3	130441385	130441619	DNA/hAT-Charlie	559	+	117	130441502	51607
chr3	130389895	130589895	harbor1	chr3	130441635	130441848	DNA/hAT-Charlie	996	+	106	130441741	51846
chr3	130389895	130589895	harbor1	chr3	130458392	130458579	DNA/hAT-Charlie	1057	+	94	130458486	68591
chr3	130389895	130589895	harbor1	chr3	130459420	130459588	DNA/hAT-Charlie	761	+	84	130459504	69609
chr3	130389895	130589895	harbor1	chr3	130468013	130468226	DNA/hAT-Charlie	920	+	106	130468119	78224
chr3	130389895	130589895	harbor1	chr3	130476461	130476652	DNA/hAT-Charlie	690	+	96	130476557	86662
chr3	130389895	130589895	harbor1	chr3	130477582	130477703	DNA/hAT-Charlie	765	+	60	130477642	87747
chr3	130389895	130589895	harbor1	chr3	130478421	130479028	DNA/hAT-Charlie	1398	+	304	130478725	88830
chr3	130389895	130589895	harbor1	chr3	130479551	130479969	DNA/hAT-Charlie	1245	+	209	130479760	89865
chr3	130389895	130589895	harbor1	chr3	130479970	130480763	DNA/hAT-Charlie	1703	+	396	130480366	90471
chr3	130389895	130589895	harbor1	chr3	130489254	130489404	DNA/hAT-Charlie	819	+	75	130489329	99434
chr3	44953778	45153778	harbor1	chr3	44956526	44956657	DNA/hAT-Charlie	520	+	66	44956592	2814
chr3	44953778	45153778	harbor1	chr3	44961824	44961974	DNA/hAT-Charlie	650	+	75	44961899	8121
chr3	44953778	45153778	harbor1	chr3	45038208	45038505	DNA/hAT-Charlie	759	+	148	45038356	84578
chr3	44953778	45153778	harbor1	chr3	45038524	45038657	DNA/hAT-Charlie	979	+	66	45038590	84812
chr3	44953778	45153778	harbor1	chr3	45038817	45038987	DNA/hAT-Charlie	979	+	85	45038902	85124
chr3	44953778	45153778	harbor1	chr3	45042457	45042629	DNA/hAT-Charlie	784	+	86	45042543	88765
chr3	184080515	184280515	harbor1	chr3	184126432	184126590	DNA/hAT-Charlie	825	+	79	184126511	45996
chr3	98266368	98466368	harbor1	chr3	98305954	98306046	DNA/hAT-Charlie	482	+	46	98306000	39632
chr3	98266368	98466368	harbor1	chr3	98323023	98323152	DNA/hAT-Charlie	448	+	64	98323087	56719
chr3	98266368	98466368	harbor1	chr3	98348829	98349613	DNA/hAT-Charlie	1540	+	392	98349221	82853
chr3	138974591	139174591	harbor1	chr3	138979901	138979956	DNA/hAT-Charlie	480	+	28	138979929	5338
chr3	138974591	139174591	harbor1	chr3	138980001	138980095	DNA/hAT-Charlie	480	+	47	138980048	5457
chr3	138974591	139174591	harbor1	chr3	139032071	139032276	DNA/hAT-Charlie	1511	+	102	139032173	57582
chr3	134198894	134398894	harbor1	chr3	134202148	134202325	DNA/hAT-Charlie	700	+	88	134202236	3342
chr3	134198894	134398894	harbor1	chr3	134203745	134203972	DNA/hAT-Charlie	938	+	114	134203859	4965
chr3	134198894	134398894	harbor1	chr3	134253170	134253318	DNA/hAT-Charlie	678	+	74	134253244	54350
chr3	134198894	134398894	harbor1	chr3	134255638	134255946	DNA/hAT-Charlie	1570	+	154	134255792	56898
chr3	19736976	19936976	harbor1	chr3	19742721	19742925	DNA/hAT-Charlie	1052	+	102	19742823	5847
chr3	19736976	19936976	harbor1	chr3	19762655	19762783	DNA/hAT-Charlie	763	+	64	19762719	25743
chr3	19736976	19936976	harbor1	chr3	19771618	19771780	DNA/hAT-Charlie	906	+	81	19771699	34723
chr3	19736976	19936976	harbor1	chr3	19775129	19775391	DNA/hAT-Charlie	884	+	131	19775260	38284
chr3	19736976	19936976	harbor1	chr3	19829177	19829348	DNA/hAT-Charlie	411	+	86	19829263	92287
chr3	19736976	19936976	harbor1	chr3	19830219	19830625	DNA/hAT-Charlie	1359	+	203	19830422	93446
chr3	142775137	142975137	harbor1	chr3	142800381	142800585	DNA/hAT-Charlie	526	+	102	142800483	25346
chr3	142775137	142975137	harbor1	chr3	142824222	142824430	DNA/hAT-Charlie	920	+	104	142824326	49189
chr3	128494353	128694353	harbor1	chr3	128545294	128545479	DNA/hAT-Charlie	763	+	92	128545386	51033
chr3	128494353	128694353	harbor1	chr3	128586111	128586276	DNA/hAT-Charlie	459	+	82	128586193	91840
chr3	31383156	31583156	harbor1	chr3	31384440	31385947	DNA/hAT-Charlie	5430	+	754	31385194	2038
chr3	31383156	31583156	harbor1	chr3	31395118	31395301	DNA/hAT-Charlie	914	+	92	31395210	12054
chr3	31383156	31583156	harbor1	chr3	31413791	31413972	DNA/hAT-Charlie	896	+	90	31413881	30725
chr3	31383156	31583156	harbor1	chr3	31433951	31434425	DNA/hAT-Charlie	745	+	237	31434188	51032
chr3	4541244	4741244	harbor1	chr3	4589386	4589538	DNA/hAT-Charlie	592	+	76	4589462	48218
chr3	4541244	4741244	harbor1	chr3	4599285	4599607	DNA/hAT-Charlie	783	+	161	4599446	58202
chr3	4541244	4741244	harbor1	chr3	4607163	4607303	DNA/hAT-Charlie	756	+	70	4607233	65989
chr3	4541244	4741244	harbor1	chr3	4608525	4608721	DNA/hAT-Charlie	930	+	98	4608623	67379
chr3	106078245	106278245	harbor1	chr3	106084385	106084529	DNA/hAT-Charlie	481	+	72	106084457	6212
chr3	106078245	106278245	harbor1	chr3	106122594	106122909	DNA/hAT-Charlie	1256	+	158	106122752	44507
chr3	160200097	160400097	harbor1	chr3	160278818	160278989	DNA/hAT-Charlie	410	+	86	160278904	78807
chr3	26266349	26466349	harbor1	chr3	26304039	26304197	DNA/hAT-Charlie	717	+	79	26304118	37769
chr3	26266349	26466349	harbor1	chr3	26311741	26311847	DNA/hAT-Charlie	439	+	53	26311794	45445
chr3	120835789	121035789	harbor1	chr3	120859641	120859812	DNA/hAT-Charlie	963	+	86	120859727	23938
chr3	120835789	121035789	harbor1	chr3	120876237	120876581	DNA/hAT-Charlie	792	+	172	120876409	40620
chr3	100142998	100342998	harbor1	chr3	100170853	100171140	DNA/hAT-Charlie	723	+	144	100170997	27999
chr3	100142998	100342998	harbor1	chr3	100183491	100183596	DNA/hAT-Charlie	556	+	52	100183543	40545
chr3	67926982	68126982	harbor1	chr3	67971542	67971684	DNA/hAT-Charlie	844	+	71	67971613	44631
chr3	67926982	68126982	harbor1	chr3	67973112	67973320	DNA/hAT-Charlie	626	+	104	67973216	46234
chr3	67926982	68126982	harbor1	chr3	67983818	67984011	DNA/hAT-Charlie	837	+	96	67983914	56932
chr3	67926982	68126982	harbor1	chr3	68015768	68016263	DNA/hAT-Charlie	1571	+	248	68016016	89034
chr3	110938623	111138623	harbor1	chr3	111007404	111007579	DNA/hAT-Charlie	768	+	88	111007492	68869
chr3	110938623	111138623	harbor1	chr3	111014705	111014875	DNA/hAT-Charlie	671	+	85	111014790	76167
chr3	110938623	111138623	harbor1	chr3	111026981	111027254	DNA/hAT-Charlie	1102	+	136	111027117	88494
chr3	110938623	111138623	harbor1	chr3	111029328	111029576	DNA/hAT-Charlie	663	+	124	111029452	90829
chr3	81156579	81356579	harbor1	chr3	81206022	81206299	DNA/hAT-Charlie	840	+	138	81206160	49581
chr3	174414129	174614129	harbor1	chr3	174466181	174466391	DNA/hAT-Charlie	1449	+	105	174466286	52157
chr3	33052218	33252218	harbor1	chr3	33058930	33059136	DNA/hAT-Charlie	998	+	103	33059033	6815
chr3	33052218	33252218	harbor1	chr3	33059152	33059244	DNA/hAT-Charlie	663	+	46	33059198	6980
chr3	33052218	33252218	harbor1	chr3	33059292	33059420	DNA/hAT-Charlie	663	+	64	33059356	7138
chr3	33052218	33252218	harbor1	chr3	33065582	33065685	DNA/hAT-Charlie	746	+	52	33065634	13416
chr3	33052218	33252218	harbor1	chr3	33094570	33094928	DNA/hAT-Charlie	1415	+	179	33094749	42531
chr3	33052218	33252218	harbor1	chr3	33095236	33095267	DNA/hAT-Charlie	1415	+	16	33095252	43034
chr3	33052218	33252218	harbor1	chr3	33099678	33099828	DNA/hAT-Charlie	1244	+	75	33099753	47535
chr3	33052218	33252218	harbor1	chr3	33100122	33100284	DNA/hAT-Charlie	1244	+	81	33100203	47985
chr3	33052218	33252218	harbor1	chr3	33100730	33100896	DNA/hAT-Charlie	715	+	83	33100813	48595
chr3	33052218	33252218	harbor1	chr3	33101503	33101600	DNA/hAT-Charlie	715	+	48	33101551	49333
chr3	33052218	33252218	harbor1	chr3	33101914	33101954	DNA/hAT-Charlie	715	+	20	33101934	49716
chr3	33052218	33252218	harbor1	chr3	33104539	33104761	DNA/hAT-Charlie	614	+	111	33104650	52432
chr3	33052218	33252218	harbor1	chr3	33113569	33113725	DNA/hAT-Charlie	653	+	78	33113647	61429
chr3	61396810	61596810	harbor1	chr3	61400043	61400488	DNA/hAT-Charlie	1984	+	222	61400265	3455
chr3	61396810	61596810	harbor1	chr3	61410458	61410596	DNA/hAT-Charlie	573	+	69	61410527	13717
chr3	61396810	61596810	harbor1	chr3	61442890	61443221	DNA/hAT-Charlie	1530	+	166	61443056	46246
chr3	61396810	61596810	harbor1	chr3	61448506	61448720	DNA/hAT-Charlie	1115	+	107	61448613	51803
chr3	61396810	61596810	harbor1	chr3	61451309	61451410	DNA/hAT-Charlie	527	+	50	61451359	54549
chr3	107906777	108106777	harbor1	chr3	107921093	107921271	DNA/hAT-Charlie	500	+	89	107921182	14405
chr3	107906777	108106777	harbor1	chr3	107945041	107945233	DNA/hAT-Charlie	943	+	96	107945137	38360
chr3	107906777	108106777	harbor1	chr3	107948185	107948457	DNA/hAT-Charlie	2046	+	136	107948321	41544
chr3	107906777	108106777	harbor1	chr3	107981283	107981648	DNA/hAT-Charlie	460	+	182	107981465	74688
chr3	55748133	55948133	harbor1	chr3	55770287	55770548	DNA/hAT-Charlie	547	+	130	55770417	22284
chr3	55748133	55948133	harbor1	chr3	55796397	55796423	DNA/hAT-Charlie	486	+	13	55796410	48277
chr3	55748133	55948133	harbor1	chr3	55796725	55796811	DNA/hAT-Charlie	486	+	43	55796768	48635
chr3	55748133	55948133	harbor1	chr3	55806537	55806741	DNA/hAT-Charlie	1349	+	102	55806639	58506
chr3	55748133	55948133	harbor1	chr3	55811025	55811207	DNA/hAT-Charlie	714	+	91	55811116	62983
chr3	143391911	143591911	harbor1	chr3	143464647	143464831	DNA/hAT-Charlie	903	+	92	143464739	72828
chr3	143391911	143591911	harbor1	chr3	143476720	143476954	DNA/hAT-Charlie	930	+	117	143476837	84926
chr3	143391911	143591911	harbor1	chr3	143482060	143482468	DNA/hAT-Charlie	740	+	204	143482264	90353
chr3	179313521	179513521	harbor1	chr3	179343240	179343408	DNA/hAT-Charlie	1009	+	84	179343324	29803
chr3	179313521	179513521	harbor1	chr3	179366039	179366234	DNA/hAT-Charlie	659	+	98	179366137	52616
chr3	179313521	179513521	harbor1	chr3	179393821	179393860	DNA/hAT-Charlie	677	+	20	179393841	80320
chr3	179313521	179513521	harbor1	chr3	179394147	179394296	DNA/hAT-Charlie	677	+	74	179394221	80700
chr3	10927688	11127688	harbor1	chr3	10931533	10931818	DNA/hAT-Charlie	559	+	142	10931675	3987
chr3	10927688	11127688	harbor1	chr3	10977370	10977817	DNA/hAT-Charlie	1447	+	224	10977594	49906
chr3	10927688	11127688	harbor1	chr3	10983718	10983932	DNA/hAT-Charlie	949	+	107	10983825	56137
chr3	188111066	188311066	harbor1	chr3	188169473	188169764	DNA/hAT-Charlie	546	+	146	188169619	58553
chr3	188111066	188311066	harbor1	chr3	188195580	188195858	DNA/hAT-Charlie	1256	+	139	188195719	84653
chr3	188111066	188311066	harbor1	chr3	188201365	188201425	DNA/hAT-Charlie	418	+	30	188201395	90329
chr3	188111066	188311066	harbor1	chr3	188201719	188201864	DNA/hAT-Charlie	418	+	72	188201791	90725
chr3	10387589	10587589	harbor1	chr3	10388718	10389106	DNA/hAT-Charlie	952	+	194	10388912	1323
chr3	10387589	10587589	harbor1	chr3	10395666	10395856	DNA/hAT-Charlie	420	+	95	10395761	8172
chr3	10387589	10587589	harbor1	chr3	10401709	10401890	DNA/hAT-Charlie	694	+	90	10401799	14210
chr3	10387589	10587589	harbor1	chr3	10420986	10421145	DNA/hAT-Charlie	656	+	80	10421066	33477
chr3	130454684	130654684	harbor1	chr3	130458392	130458579	DNA/hAT-Charlie	1057	+	94	130458486	3802
chr3	130454684	130654684	harbor1	chr3	130459420	130459588	DNA/hAT-Charlie	761	+	84	130459504	4820
chr3	130454684	130654684	harbor1	chr3	130468013	130468226	DNA/hAT-Charlie	920	+	106	130468119	13435
chr3	130454684	130654684	harbor1	chr3	130476461	130476652	DNA/hAT-Charlie	690	+	96	130476557	21873
chr3	130454684	130654684	harbor1	chr3	130477582	130477703	DNA/hAT-Charlie	765	+	60	130477642	22958
chr3	130454684	130654684	harbor1	chr3	130478421	130479028	DNA/hAT-Charlie	1398	+	304	130478725	24041
chr3	130454684	130654684	harbor1	chr3	130479551	130479969	DNA/hAT-Charlie	1245	+	209	130479760	25076
chr3	130454684	130654684	harbor1	chr3	130479970	130480763	DNA/hAT-Charlie	1703	+	396	130480366	25682
chr3	130454684	130654684	harbor1	chr3	130489254	130489404	DNA/hAT-Charlie	819	+	75	130489329	34645
chr3	130454684	130654684	harbor1	chr3	130492559	130492631	DNA/hAT-Charlie	434	+	36	130492595	37911
chr3	130454684	130654684	harbor1	chr3	130492879	130492963	DNA/hAT-Charlie	434	+	42	130492921	38237
chr3	130454684	130654684	harbor1	chr3	130528671	130528809	DNA/hAT-Charlie	487	+	69	130528740	74056
chr3	130454684	130654684	harbor1	chr3	130529076	130529117	DNA/hAT-Charlie	487	+	20	130529096	74412
chr3	130454684	130654684	harbor1	chr3	130529939	130530123	DNA/hAT-Charlie	710	+	92	130530031	75347
chr3	3401031	3601031	harbor1	chr3	3417036	3417589	DNA/hAT-Charlie	3282	+	276	3417312	16281
chr3	101301235	101501235	harbor1	chr3	101329137	101329338	DNA/hAT-Charlie	514	+	100	101329237	28002
chr3	101301235	101501235	harbor1	chr3	101348964	101349138	DNA/hAT-Charlie	576	+	87	101349051	47816
chr3	16257206	16457206	harbor1	chr3	16261522	16261701	DNA/hAT-Charlie	963	+	90	16261612	4406
chr3	16257206	16457206	harbor1	chr3	16314407	16314565	DNA/hAT-Charlie	714	+	79	16314486	57280
chr3	16257206	16457206	harbor1	chr3	16328603	16328782	DNA/hAT-Charlie	968	+	90	16328693	71487
chr3	16257206	16457206	harbor1	chr3	16353470	16353565	DNA/hAT-Charlie	512	+	48	16353518	96312
chr3	16257206	16457206	harbor1	chr3	16353962	16354055	DNA/hAT-Charlie	459	+	46	16354008	96802
chr3	52227454	52427454	harbor1	chr3	52233380	52233537	DNA/hAT-Charlie	479	+	78	52233458	6004
chr3	179336704	179536704	harbor1	chr3	179343240	179343408	DNA/hAT-Charlie	1009	+	84	179343324	6620
chr3	179336704	179536704	harbor1	chr3	179366039	179366234	DNA/hAT-Charlie	659	+	98	179366137	29433
chr3	179336704	179536704	harbor1	chr3	179393821	179393860	DNA/hAT-Charlie	677	+	20	179393841	57137
chr3	179336704	179536704	harbor1	chr3	179394147	179394296	DNA/hAT-Charlie	677	+	74	179394221	57517
chr3	179336704	179536704	harbor1	chr3	179421654	179422034	DNA/hAT-Charlie	1466	+	190	179421844	85140
chr3	177531171	177731171	harbor1	chr3	177546089	177546258	DNA/hAT-Charlie	594	+	84	177546173	15002
chr3	177531171	177731171	harbor1	chr3	177566783	177567063	DNA/hAT-Charlie	1776	+	140	177566923	35752
chr3	177531171	177731171	harbor1	chr3	177577420	177577505	DNA/hAT-Charlie	437	+	42	177577462	46291
chr3	177531171	177731171	harbor1	chr3	177580952	177581118	DNA/hAT-Charlie	786	+	83	177581035	49864
chr3	177531171	177731171	harbor1	chr3	177581394	177581432	DNA/hAT-Charlie	786	+	19	177581413	50242
chr3	177531171	177731171	harbor1	chr3	177612741	177613037	DNA/hAT-Charlie	717	+	148	177612889	81718
chr3	44866996	45066996	harbor1	chr3	44883997	44884141	DNA/hAT-Charlie	628	+	72	44884069	17073
chr3	44866996	45066996	harbor1	chr3	44884141	44884272	DNA/hAT-Charlie	446	+	66	44884207	17211
chr3	44866996	45066996	harbor1	chr3	44956526	44956657	DNA/hAT-Charlie	520	+	66	44956592	89596
chr3	44866996	45066996	harbor1	chr3	44961824	44961974	DNA/hAT-Charlie	650	+	75	44961899	94903
chr3	40779167	40979167	harbor1	chr3	40779611	40779752	DNA/hAT-Charlie	486	+	70	40779681	514
chr3	40779167	40979167	harbor1	chr3	40817176	40817352	DNA/hAT-Charlie	1041	+	88	40817264	38097
chr3	40779167	40979167	harbor1	chr3	40841693	40841909	DNA/hAT-Charlie	1209	+	108	40841801	62634
chr3	40779167	40979167	harbor1	chr3	40842971	40843037	DNA/hAT-Charlie	2152	+	33	40843004	63837
chr3	40779167	40979167	harbor1	chr3	40843376	40843872	DNA/hAT-Charlie	2152	+	248	40843624	64457
chr3	67883853	68083853	harbor1	chr3	67971542	67971684	DNA/hAT-Charlie	844	+	71	67971613	87760
chr3	67883853	68083853	harbor1	chr3	67973112	67973320	DNA/hAT-Charlie	626	+	104	67973216	89363
chr3	106016667	106216667	harbor1	chr3	106033741	106033882	DNA/hAT-Charlie	527	+	70	106033811	17144
chr3	106016667	106216667	harbor1	chr3	106084385	106084529	DNA/hAT-Charlie	481	+	72	106084457	67790
chr3	33072738	33272738	harbor1	chr3	33094570	33094928	DNA/hAT-Charlie	1415	+	179	33094749	22011
chr3	33072738	33272738	harbor1	chr3	33095236	33095267	DNA/hAT-Charlie	1415	+	16	33095252	22514
chr3	33072738	33272738	harbor1	chr3	33099678	33099828	DNA/hAT-Charlie	1244	+	75	33099753	27015
chr3	33072738	33272738	harbor1	chr3	33100122	33100284	DNA/hAT-Charlie	1244	+	81	33100203	27465
chr3	33072738	33272738	harbor1	chr3	33100730	33100896	DNA/hAT-Charlie	715	+	83	33100813	28075
chr3	33072738	33272738	harbor1	chr3	33101503	33101600	DNA/hAT-Charlie	715	+	48	33101551	28813
chr3	33072738	33272738	harbor1	chr3	33101914	33101954	DNA/hAT-Charlie	715	+	20	33101934	29196
chr3	33072738	33272738	harbor1	chr3	33104539	33104761	DNA/hAT-Charlie	614	+	111	33104650	31912
chr3	33072738	33272738	harbor1	chr3	33113569	33113725	DNA/hAT-Charlie	653	+	78	33113647	40909
chr3	89849106	90049106	harbor1	chr3	89857154	89857393	DNA/hAT-Charlie	1061	+	120	89857274	8168
chr3	89849106	90049106	harbor1	chr3	89938250	89938438	DNA/hAT-Charlie	801	+	94	89938344	89238
chr3	184050779	184250779	harbor1	chr3	184057886	184058317	DNA/hAT-Charlie	1042	+	216	184058102	7323
chr3	184050779	184250779	harbor1	chr3	184126432	184126590	DNA/hAT-Charlie	825	+	79	184126511	75732
chr3	114431362	114631362	harbor1	chr3	114461681	114461845	DNA/hAT-Charlie	714	+	82	114461763	30401
chr3	114431362	114631362	harbor1	chr3	114504586	114504774	DNA/hAT-Charlie	449	+	94	114504680	73318
chr3	114431362	114631362	harbor1	chr3	114518776	114518981	DNA/hAT-Charlie	953	+	102	114518878	87516
chr3	96786345	96986345	harbor1	chr3	96839153	96839506	DNA/hAT-Charlie	2110	+	176	96839329	52984
chr3	56997560	57197560	harbor1	chr3	57011416	57011633	DNA/hAT-Charlie	991	+	108	57011524	13964
chr3	56997560	57197560	harbor1	chr3	57015069	57015205	DNA/hAT-Charlie	586	+	68	57015137	17577
chr3	56997560	57197560	harbor1	chr3	57092865	57093183	DNA/hAT-Charlie	767	+	159	57093024	95464
chr3	106660709	106860709	harbor1	chr3	106702212	106702430	DNA/hAT-Charlie	1060	+	109	106702321	41612
chr3	106660709	106860709	harbor1	chr3	106712776	106712963	DNA/hAT-Charlie	1031	+	94	106712870	52161
chr3	106660709	106860709	harbor1	chr3	106723585	106723800	DNA/hAT-Charlie	946	+	108	106723693	62984
chr3	106660709	106860709	harbor1	chr3	106723809	106723945	DNA/hAT-Charlie	474	+	68	106723877	63168
chr3	75159465	75359465	harbor1	chr3	75165028	75165295	DNA/hAT-Charlie	1155	+	134	75165162	5697
chr3	75159465	75359465	harbor1	chr3	75169380	75169595	DNA/hAT-Charlie	515	+	108	75169488	10023
chr3	75159465	75359465	harbor1	chr3	75177931	75178072	DNA/hAT-Charlie	623	+	70	75178001	18536
chr3	75159465	75359465	harbor1	chr3	75249813	75249973	DNA/hAT-Charlie	824	+	80	75249893	90428
chr3	75159465	75359465	harbor1	chr3	75250484	75250680	DNA/hAT-Charlie	1132	+	98	75250582	91117
chr3	122878729	123078729	harbor1	chr3	122894854	122895446	DNA/hAT-Charlie	1610	+	296	122895150	16421
chr3	122878729	123078729	harbor1	chr3	122897882	122898203	DNA/hAT-Charlie	945	+	160	122898042	19313
chr3	122878729	123078729	harbor1	chr3	122898200	122898399	DNA/hAT-Charlie	760	+	100	122898300	19571
chr3	122878729	123078729	harbor1	chr3	122916357	122916509	DNA/hAT-Charlie	656	+	76	122916433	37704
chr3	122878729	123078729	harbor1	chr3	122950442	122950734	DNA/hAT-Charlie	1086	+	146	122950588	71859
chr3	122878729	123078729	harbor1	chr3	122976181	122976364	DNA/hAT-Charlie	1192	+	92	122976273	97544
chr3	41436348	41636348	harbor1	chr3	41463927	41465220	DNA/hAT-Charlie	2604	+	646	41464573	28225
chr3	41436348	41636348	harbor1	chr3	41507019	41507808	DNA/hAT-Charlie	1249	+	394	41507413	71065
chr3	41436348	41636348	harbor1	chr3	41516094	41516391	DNA/hAT-Charlie	671	+	148	41516242	79894
chr3	41436348	41636348	harbor1	chr3	41532634	41532798	DNA/hAT-Charlie	888	+	82	41532716	96368
chr3	41436348	41636348	harbor1	chr3	41533529	41533743	DNA/hAT-Charlie	719	+	107	41533636	97288
chr3	96290901	96490901	harbor1	chr3	96308614	96309016	DNA/hAT-Charlie	783	+	201	96308815	17914
chr3	96290901	96490901	harbor1	chr3	96347835	96348076	DNA/hAT-Charlie	610	+	120	96347955	57054
chr3	137170930	137370930	harbor1	chr3	137196878	137197063	DNA/hAT-Charlie	518	+	92	137196970	26040
chr3	137170930	137370930	harbor1	chr3	137218976	137219162	DNA/hAT-Charlie	873	+	93	137219069	48139
chr3	137170930	137370930	harbor1	chr3	137221892	137222010	DNA/hAT-Charlie	438	+	59	137221951	51021
chr3	137170930	137370930	harbor1	chr3	137225033	137225153	DNA/hAT-Charlie	659	+	60	137225093	54163
chr3	137170930	137370930	harbor1	chr3	137267706	137267861	DNA/hAT-Charlie	412	+	78	137267784	96854
chr3	2717033	2917033	harbor1	chr3	2735353	2735610	DNA/hAT-Charlie	698	+	128	2735481	18448
chr3	27665091	27865091	harbor1	chr3	27706798	27707004	DNA/hAT-Charlie	1148	+	103	27706901	41810
chr3	27665091	27865091	harbor1	chr3	27731890	27732051	DNA/hAT-Charlie	972	+	80	27731970	66879
chr3	67547228	67747228	harbor1	chr3	67564594	67564814	DNA/hAT-Charlie	1479	+	110	67564704	17476
chr3	67547228	67747228	harbor1	chr3	67571142	67571377	DNA/hAT-Charlie	1123	+	118	67571260	24032
chr3	67547228	67747228	harbor1	chr3	67607192	67607509	DNA/hAT-Charlie	1446	+	158	67607350	60122
chr3	67547228	67747228	harbor1	chr3	67630869	67630996	DNA/hAT-Charlie	450	+	64	67630933	83705
chr3	67547228	67747228	harbor1	chr3	67641562	67641643	DNA/hAT-Charlie	513	+	40	67641602	94374
chr3	47691513	47891513	harbor1	chr3	47724469	47724686	DNA/hAT-Charlie	1250	+	108	47724577	33064
chr3	47691513	47891513	harbor1	chr3	47756625	47756828	DNA/hAT-Charlie	661	+	102	47756727	65214
chr3	47691513	47891513	harbor1	chr3	47758545	47758691	DNA/hAT-Charlie	469	+	73	47758618	67105
chr3	124035877	124235877	harbor1	chr3	124040366	124040585	DNA/hAT-Charlie	1088	+	110	124040476	4599
chr3	124035877	124235877	harbor1	chr3	124061956	124062106	DNA/hAT-Charlie	659	+	75	124062031	26154
chr3	418916	618916	harbor1	chr3	418784	418980	DNA/hAT-Charlie	610	+	98	418882	34
chr3	418916	618916	harbor1	chr3	426673	426829	DNA/hAT-Charlie	717	+	78	426751	7835
chr3	418916	618916	harbor1	chr3	474346	474557	DNA/hAT-Charlie	946	+	106	474452	55536
chr3	418916	618916	harbor1	chr3	482086	482411	DNA/hAT-Charlie	1174	+	162	482248	63332
chr3	418916	618916	harbor1	chr3	494889	495160	DNA/hAT-Charlie	1035	+	136	495025	76109
chr3	418916	618916	harbor1	chr3	495458	495514	DNA/hAT-Charlie	1035	+	28	495486	76570
chr3	418916	618916	harbor1	chr3	502191	502481	DNA/hAT-Charlie	648	+	145	502336	83420
chr3	418916	618916	harbor1	chr3	511345	511510	DNA/hAT-Charlie	432	+	82	511427	92511
chr3	41917133	42117133	harbor1	chr3	41934073	41934257	DNA/hAT-Charlie	752	+	92	41934165	17032
chr3	41917133	42117133	harbor1	chr3	41939688	41940014	DNA/hAT-Charlie	2166	+	163	41939851	22718
chr3	41917133	42117133	harbor1	chr3	41942077	41942237	DNA/hAT-Charlie	663	+	80	41942157	25024
chr3	41917133	42117133	harbor1	chr3	41942827	41942931	DNA/hAT-Charlie	663	+	52	41942879	25746
chr3	41917133	42117133	harbor1	chr3	41943237	41943343	DNA/hAT-Charlie	663	+	53	41943290	26157
chr3	41917133	42117133	harbor1	chr3	41956721	41956930	DNA/hAT-Charlie	937	+	104	41956825	39692
chr3	41917133	42117133	harbor1	chr3	41961259	41961421	DNA/hAT-Charlie	520	+	81	41961340	44207
chr3	41917133	42117133	harbor1	chr3	41966077	41966104	DNA/hAT-Charlie	457	+	14	41966091	48958
chr3	41917133	42117133	harbor1	chr3	41967057	41967191	DNA/hAT-Charlie	457	+	67	41967124	49991
chr3	41917133	42117133	harbor1	chr3	42004393	42004528	DNA/hAT-Charlie	433	+	68	42004461	87328
chr3	157550891	157750891	harbor1	chr3	157642789	157643002	DNA/hAT-Charlie	521	+	106	157642895	92004
chr3	157550891	157750891	harbor1	chr3	157644413	157644589	DNA/hAT-Charlie	833	+	88	157644501	93610
chr3	154526806	154726806	harbor1	chr3	154591292	154591500	DNA/hAT-Charlie	913	+	104	154591396	64590
chr3	60961928	61161928	harbor1	chr3	60993886	60994224	DNA/hAT-Charlie	1249	+	169	60994055	32127
chr3	60961928	61161928	harbor1	chr3	60997386	60997632	DNA/hAT-Charlie	453	+	123	60997509	35581
chr3	60961928	61161928	harbor1	chr3	61011683	61011847	DNA/hAT-Charlie	723	+	82	61011765	49837
chr3	60961928	61161928	harbor1	chr3	61011930	61013117	DNA/hAT-Charlie	3295	+	594	61012524	50596
chr3	60961928	61161928	harbor1	chr3	61026547	61026761	DNA/hAT-Charlie	1371	+	107	61026654	64726
chr3	60961928	61161928	harbor1	chr3	61029896	61029962	DNA/hAT-Charlie	521	+	33	61029929	68001
chr3	60961928	61161928	harbor1	chr3	61030270	61030327	DNA/hAT-Charlie	521	+	28	61030298	68370
chr3	60961928	61161928	harbor1	chr3	61032703	61032721	DNA/hAT-Charlie	472	+	9	61032712	70784
chr3	60961928	61161928	harbor1	chr3	61033218	61033303	DNA/hAT-Charlie	472	+	42	61033260	71332
chr3	60961928	61161928	harbor1	chr3	61033316	61033624	DNA/hAT-Charlie	1432	+	154	61033470	71542
chr3	60961928	61161928	harbor1	chr3	61037384	61037524	DNA/hAT-Charlie	591	+	70	61037454	75526
chr3	60961928	61161928	harbor1	chr3	61037910	61037942	DNA/hAT-Charlie	591	+	16	61037926	75998
chr3	60961928	61161928	harbor1	chr3	61056694	61057396	DNA/hAT-Charlie	1306	+	351	61057045	95117
chr3	142680248	142880248	harbor1	chr3	142731754	142732073	DNA/hAT-Charlie	1436	+	160	142731914	51666
chr3	142680248	142880248	harbor1	chr3	142738527	142738723	DNA/hAT-Charlie	952	+	98	142738625	58377
chr3	142680248	142880248	harbor1	chr3	142739882	142740180	DNA/hAT-Charlie	1953	+	149	142740031	59783
chr3	185750754	185950754	harbor1	chr3	185766347	185766668	DNA/hAT-Charlie	1770	+	160	185766507	15753
chr3	185750754	185950754	harbor1	chr3	185767431	185767597	DNA/hAT-Charlie	657	+	83	185767514	16760
chr3	185750754	185950754	harbor1	chr3	185779569	185779721	DNA/hAT-Charlie	733	+	76	185779645	28891
chr3	185750754	185950754	harbor1	chr3	185783020	185783285	DNA/hAT-Charlie	672	+	132	185783152	32398
chr3	185750754	185950754	harbor1	chr3	185811417	185811641	DNA/hAT-Charlie	1031	+	112	185811529	60775
chr3	60952855	61152855	harbor1	chr3	60993886	60994224	DNA/hAT-Charlie	1249	+	169	60994055	41200
chr3	60952855	61152855	harbor1	chr3	60997386	60997632	DNA/hAT-Charlie	453	+	123	60997509	44654
chr3	60952855	61152855	harbor1	chr3	61011683	61011847	DNA/hAT-Charlie	723	+	82	61011765	58910
chr3	60952855	61152855	harbor1	chr3	61011930	61013117	DNA/hAT-Charlie	3295	+	594	61012524	59669
chr3	60952855	61152855	harbor1	chr3	61026547	61026761	DNA/hAT-Charlie	1371	+	107	61026654	73799
chr3	60952855	61152855	harbor1	chr3	61029896	61029962	DNA/hAT-Charlie	521	+	33	61029929	77074
chr3	60952855	61152855	harbor1	chr3	61030270	61030327	DNA/hAT-Charlie	521	+	28	61030298	77443
chr3	60952855	61152855	harbor1	chr3	61032703	61032721	DNA/hAT-Charlie	472	+	9	61032712	79857
chr3	60952855	61152855	harbor1	chr3	61033218	61033303	DNA/hAT-Charlie	472	+	42	61033260	80405
chr3	60952855	61152855	harbor1	chr3	61033316	61033624	DNA/hAT-Charlie	1432	+	154	61033470	80615
chr3	60952855	61152855	harbor1	chr3	61037384	61037524	DNA/hAT-Charlie	591	+	70	61037454	84599
chr3	60952855	61152855	harbor1	chr3	61037910	61037942	DNA/hAT-Charlie	591	+	16	61037926	85071
chr3	41019031	41219031	harbor1	chr3	41073506	41073825	DNA/hAT-Charlie	1249	+	160	41073666	54635
chr3	41019031	41219031	harbor1	chr3	41092185	41092317	DNA/hAT-Charlie	520	+	66	41092251	73220
chr3	147601964	147801964	harbor1	chr3	147605030	147605196	DNA/hAT-Charlie	520	+	83	147605113	3149
chr3	147601964	147801964	harbor1	chr3	147611357	147611530	DNA/hAT-Charlie	948	+	86	147611443	9479
chr3	147601964	147801964	harbor1	chr3	147648665	147648930	DNA/hAT-Charlie	519	+	132	147648797	46833
chr3	169466004	169666004	harbor1	chr3	169521571	169521756	DNA/hAT-Charlie	834	+	92	169521663	55659
chr3	43064910	43264910	harbor1	chr3	43089666	43089859	DNA/hAT-Charlie	494	+	96	43089762	24852
chr3	43064910	43264910	harbor1	chr3	43101471	43101616	DNA/hAT-Charlie	626	+	72	43101543	36633
chr3	43064910	43264910	harbor1	chr3	43132467	43132582	DNA/hAT-Charlie	580	+	58	43132525	67615
chr3	43064910	43264910	harbor1	chr3	43132593	43132972	DNA/hAT-Charlie	1696	+	190	43132783	67873
chr3	43064910	43264910	harbor1	chr3	43142115	43142247	DNA/hAT-Charlie	631	+	66	43142181	77271
chr3	43064910	43264910	harbor1	chr3	43160732	43160983	DNA/hAT-Charlie	828	+	126	43160858	95948
chr3	153192567	153392567	harbor1	chr3	153197359	153197514	DNA/hAT-Charlie	553	+	78	153197437	4870
chr3	153192567	153392567	harbor1	chr3	153274363	153274510	DNA/hAT-Charlie	468	+	74	153274437	81870
chr3	72691028	72891028	harbor1	chr3	72697807	72697969	DNA/hAT-Charlie	494	+	81	72697888	6860
chr3	72691028	72891028	harbor1	chr3	72742938	72743117	DNA/hAT-Charlie	433	+	90	72743028	52000
chr3	72691028	72891028	harbor1	chr3	72764629	72764779	DNA/hAT-Charlie	729	+	75	72764704	73676
chr3	72691028	72891028	harbor1	chr3	72766863	72767027	DNA/hAT-Charlie	706	+	82	72766945	75917
chr3	72691028	72891028	harbor1	chr3	72789282	72789455	DNA/hAT-Charlie	1108	+	86	72789368	98340
chr3	21898228	22098228	harbor1	chr3	21899040	21899268	DNA/hAT-Charlie	957	+	114	21899154	926
chr3	21898228	22098228	harbor1	chr3	21920020	21920206	DNA/hAT-Charlie	561	+	93	21920113	21885
chr3	196814748	197014748	harbor1	chr3	196901876	196902062	DNA/hAT-Charlie	1099	+	93	196901969	87221
chr3	196814748	197014748	harbor1	chr3	196853606	196853782	DNA/hAT-Charlie	642	+	88	196853694	38946
chr3	73898699	74098699	harbor1	chr3	73930966	73931431	DNA/hAT-Charlie	1627	+	232	73931198	32499
chr3	73898699	74098699	harbor1	chr3	73962659	73962841	DNA/hAT-Charlie	717	+	91	73962750	64051
chr3	193841912	194041912	harbor1	chr3	193843287	193843510	DNA/hAT-Charlie	1013	+	112	193843399	1487
chr3	193841912	194041912	harbor1	chr3	193847569	193847729	DNA/hAT-Charlie	442	+	80	193847649	5737
chr3	193841912	194041912	harbor1	chr3	193854099	193854311	DNA/hAT-Charlie	1084	+	106	193854205	12293
chr3	193841912	194041912	harbor1	chr3	193884008	193884201	DNA/hAT-Charlie	718	+	96	193884104	42192
chr3	193841912	194041912	harbor1	chr3	193884717	193884897	DNA/hAT-Charlie	889	+	90	193884807	42895
chr3	193841912	194041912	harbor1	chr3	193890004	193890350	DNA/hAT-Charlie	872	+	173	193890177	48265
chr3	193841912	194041912	harbor1	chr3	193896737	193896911	DNA/hAT-Charlie	814	+	87	193896824	54912
chr3	193841912	194041912	harbor1	chr3	193888149	193888316	DNA/hAT-Charlie	528	+	84	193888233	46321
chr3	101479486	101679486	harbor1	chr3	101570071	101570250	DNA/hAT-Charlie	1077	+	90	101570161	90675
chr3	101479486	101679486	harbor1	chr3	101498699	101498999	DNA/hAT-Charlie	1698	+	150	101498849	19363
chr3	19215286	19415286	harbor1	chr3	19228234	19228358	DNA/hAT-Charlie	552	+	62	19228296	13010
chr3	19215286	19415286	harbor1	chr3	19258324	19258905	DNA/hAT-Charlie	1451	+	290	19258614	43328
chr3	19215286	19415286	harbor1	chr3	19258949	19259108	DNA/hAT-Charlie	1451	+	80	19259029	43743
chr3	19215286	19415286	harbor1	chr3	19268669	19268821	DNA/hAT-Charlie	718	+	76	19268745	53459
chr3	19215286	19415286	harbor1	chr3	19270114	19270283	DNA/hAT-Charlie	755	+	84	19270198	54912
chr3	19215286	19415286	harbor1	chr3	19293417	19293578	DNA/hAT-Charlie	777	+	80	19293497	78211
chr3	19215286	19415286	harbor1	chr3	19304713	19304915	DNA/hAT-Charlie	949	+	101	19304814	89528
chr3	150873907	151073907	harbor1	chr3	150879258	150879471	DNA/hAT-Charlie	1173	+	106	150879364	5457
chr3	150873907	151073907	harbor1	chr3	150880453	150880653	DNA/hAT-Charlie	543	+	100	150880553	6646
chr3	150873907	151073907	harbor1	chr3	150913786	150913893	DNA/hAT-Charlie	494	+	54	150913840	39933
chr3	150873907	151073907	harbor1	chr3	150913950	150914149	DNA/hAT-Charlie	1203	+	100	150914050	40143
chr3	150873907	151073907	harbor1	chr3	150969031	150969283	DNA/hAT-Charlie	1088	+	126	150969157	95250
chr3	52200100	52400100	harbor1	chr3	52233380	52233537	DNA/hAT-Charlie	479	+	78	52233458	33358
chr3	161953290	162153290	harbor1	chr3	161990457	161990604	DNA/hAT-Charlie	513	+	74	161990531	37241
chr3	184835222	185035222	harbor1	chr3	184857234	184857309	DNA/hAT-Charlie	533	+	38	184857272	22050
chr3	184835222	185035222	harbor1	chr3	184913686	184913909	DNA/hAT-Charlie	1286	+	112	184913798	78576
chr3	184835222	185035222	harbor1	chr3	184932964	184933117	DNA/hAT-Charlie	772	+	76	184933040	97818
chr3	94170260	94370260	harbor1	chr3	94196178	94196405	DNA/hAT-Charlie	835	+	114	94196292	26032
chr3	94170260	94370260	harbor1	chr3	94260540	94260710	DNA/hAT-Charlie	726	+	85	94260625	90365
chr3	94170260	94370260	harbor1	chr3	94267710	94267910	DNA/hAT-Charlie	1079	+	100	94267810	97550
chr3	94170260	94370260	harbor1	chr3	94269800	94270023	DNA/hAT-Charlie	1129	+	112	94269912	99652
chr3	94170260	94370260	harbor1	chr3	94270018	94270139	DNA/hAT-Charlie	432	+	60	94270078	99818
chr3	159359790	159559790	harbor1	chr3	159372606	159372964	DNA/hAT-Charlie	1187	+	179	159372785	12995
chr3	159359790	159559790	harbor1	chr3	159374819	159375145	DNA/hAT-Charlie	1319	+	163	159374982	15192
chr3	132896540	133096540	harbor1	chr3	132925629	132925840	DNA/hAT-Charlie	661	+	106	132925735	29195
chr3	132896540	133096540	harbor1	chr3	132935081	132935413	DNA/hAT-Charlie	2104	+	166	132935247	38707
chr3	132896540	133096540	harbor1	chr3	132952864	132953101	DNA/hAT-Charlie	567	+	118	132952982	56442
chr3	132896540	133096540	harbor1	chr3	132993700	132993868	DNA/hAT-Charlie	479	+	84	132993784	97244
chr3	196375920	196575920	harbor1	chr3	196421315	196421472	DNA/hAT-Charlie	731	+	78	196421393	45473
chr3	196375920	196575920	harbor1	chr3	196474823	196475030	DNA/hAT-Charlie	928	+	104	196474927	99007
chr3	141038788	141238788	harbor1	chr3	141112748	141112940	DNA/hAT-Charlie	601	+	96	141112844	74056
chr3	14418608	14618608	harbor1	chr3	14435695	14436013	DNA/hAT-Charlie	413	+	159	14435854	17246
chr3	14418608	14618608	harbor1	chr3	14493956	14494328	DNA/hAT-Charlie	829	+	186	14494142	75534
chr3	14418608	14618608	harbor1	chr3	14508271	14508414	DNA/hAT-Charlie	455	+	72	14508343	89735
chr3	14418608	14618608	harbor1	chr3	14508632	14508914	DNA/hAT-Charlie	1152	+	141	14508773	90165
chr3	144681807	144881807	harbor1	chr3	144688916	144689125	DNA/hAT-Charlie	928	+	104	144689020	7213
chr3	95874243	96074243	harbor1	chr3	95879701	95879888	DNA/hAT-Charlie	495	+	94	95879795	5552
chr3	95874243	96074243	harbor1	chr3	95880192	95880398	DNA/hAT-Charlie	582	+	103	95880295	6052
chr3	95874243	96074243	harbor1	chr3	95938838	95939040	DNA/hAT-Charlie	511	+	101	95938939	64696
chr3	95874243	96074243	harbor1	chr3	95971926	95972057	DNA/hAT-Charlie	592	+	66	95971992	97749
chr3	151518943	151718943	harbor1	chr3	151545905	151546106	DNA/hAT-Charlie	460	+	100	151546005	27062
chr3	151518943	151718943	harbor1	chr3	151564468	151564680	DNA/hAT-Charlie	697	+	106	151564574	45631
chr3	151518943	151718943	harbor1	chr3	151585076	151585372	DNA/hAT-Charlie	1380	+	148	151585224	66281
chr3	151518943	151718943	harbor1	chr3	151599513	151599862	DNA/hAT-Charlie	975	+	174	151599687	80744
chr3	130864516	131064516	harbor1	chr3	130901835	130902060	DNA/hAT-Charlie	892	+	112	130901947	37431
chr3	130864516	131064516	harbor1	chr3	130930591	130930829	DNA/hAT-Charlie	567	+	119	130930710	66194
chr3	130864516	131064516	harbor1	chr3	130935537	130936530	DNA/hAT-Charlie	4594	+	496	130936033	71517
chr3	130864516	131064516	harbor1	chr3	130936837	130937228	DNA/hAT-Charlie	4594	+	196	130937033	72517
chr3	118264899	118464899	harbor1	chr3	118272442	118272598	DNA/hAT-Charlie	448	+	78	118272520	7621
chr3	118264899	118464899	harbor1	chr3	118307090	118307331	DNA/hAT-Charlie	1112	+	120	118307210	42311
chr3	117409893	117609893	harbor1	chr3	117419499	117419674	DNA/hAT-Charlie	758	+	88	117419587	9694
chr3	117409893	117609893	harbor1	chr3	117424348	117424645	DNA/hAT-Charlie	1411	+	148	117424496	14603
chr3	143604669	143804669	harbor1	chr3	143617213	143617425	DNA/hAT-Charlie	932	+	106	143617319	12650
chr3	143604669	143804669	harbor1	chr3	143617452	143617785	DNA/hAT-Charlie	796	+	166	143617618	12949
chr3	143604669	143804669	harbor1	chr3	143657456	143657857	DNA/hAT-Charlie	2164	+	200	143657656	52987
chr3	143604669	143804669	harbor1	chr3	143658166	143658269	DNA/hAT-Charlie	2164	+	52	143658218	53549
chr3	143604669	143804669	harbor1	chr3	143658270	143658385	DNA/hAT-Charlie	525	+	58	143658328	53659
chr3	143604669	143804669	harbor1	chr3	143674945	143675100	DNA/hAT-Charlie	430	+	78	143675023	70354
chr3	13169611	13369611	harbor1	chr3	13173775	13173946	DNA/hAT-Charlie	633	+	86	13173861	4250
chr3	13169611	13369611	harbor1	chr3	13231764	13232191	DNA/hAT-Charlie	746	+	214	13231978	62367
chr3	13169611	13369611	harbor1	chr3	13255868	13256068	DNA/hAT-Charlie	633	+	100	13255968	86357
chr3	77208102	77408102	harbor1	chr3	77284050	77284277	DNA/hAT-Charlie	941	+	114	77284164	76062
chr3	57200723	57400723	harbor1	chr3	57209079	57209277	DNA/hAT-Charlie	1118	+	99	57209178	8455
chr3	189250636	189450636	harbor1	chr3	189297520	189297653	DNA/hAT-Charlie	554	+	66	189297586	46950
chr3	189250636	189450636	harbor1	chr3	189318153	189318276	DNA/hAT-Charlie	509	+	62	189318215	67579
chr3	23177231	23377231	harbor1	chr3	23180404	23180602	DNA/hAT-Charlie	1004	+	99	23180503	3272
chr3	23177231	23377231	harbor1	chr3	23229708	23229896	DNA/hAT-Charlie	860	+	94	23229802	52571
chr3	16004685	16204685	harbor1	chr3	16046734	16047524	DNA/hAT-Charlie	2656	+	395	16047129	42444
chr3	16004685	16204685	harbor1	chr3	16047705	16047757	DNA/hAT-Charlie	2656	+	26	16047731	43046
chr3	16004685	16204685	harbor1	chr3	16047757	16047840	DNA/hAT-Charlie	467	+	42	16047799	43114
chr3	60987691	61187691	harbor1	chr3	60993886	60994224	DNA/hAT-Charlie	1249	+	169	60994055	6364
chr3	60987691	61187691	harbor1	chr3	60997386	60997632	DNA/hAT-Charlie	453	+	123	60997509	9818
chr3	60987691	61187691	harbor1	chr3	61011683	61011847	DNA/hAT-Charlie	723	+	82	61011765	24074
chr3	60987691	61187691	harbor1	chr3	61011930	61013117	DNA/hAT-Charlie	3295	+	594	61012524	24833
chr3	60987691	61187691	harbor1	chr3	61026547	61026761	DNA/hAT-Charlie	1371	+	107	61026654	38963
chr3	60987691	61187691	harbor1	chr3	61029896	61029962	DNA/hAT-Charlie	521	+	33	61029929	42238
chr3	60987691	61187691	harbor1	chr3	61030270	61030327	DNA/hAT-Charlie	521	+	28	61030298	42607
chr3	60987691	61187691	harbor1	chr3	61032703	61032721	DNA/hAT-Charlie	472	+	9	61032712	45021
chr3	60987691	61187691	harbor1	chr3	61033218	61033303	DNA/hAT-Charlie	472	+	42	61033260	45569
chr3	60987691	61187691	harbor1	chr3	61033316	61033624	DNA/hAT-Charlie	1432	+	154	61033470	45779
chr3	60987691	61187691	harbor1	chr3	61037384	61037524	DNA/hAT-Charlie	591	+	70	61037454	49763
chr3	60987691	61187691	harbor1	chr3	61037910	61037942	DNA/hAT-Charlie	591	+	16	61037926	50235
chr3	60987691	61187691	harbor1	chr3	61056694	61057396	DNA/hAT-Charlie	1306	+	351	61057045	69354
chr3	60987691	61187691	harbor1	chr3	61074392	61074608	DNA/hAT-Charlie	548	+	108	61074500	86809
chr3	74771499	74971499	harbor1	chr3	74847426	74847589	DNA/hAT-Charlie	464	+	82	74847508	76009
chr3	74771499	74971499	harbor1	chr3	74852663	74852865	DNA/hAT-Charlie	809	+	101	74852764	81265
chr3	49156862	49356862	harbor1	chr3	49208237	49208580	DNA/hAT-Charlie	2201	+	172	49208409	51547
chr3	111100414	111300414	harbor1	chr3	111101605	111101768	DNA/hAT-Charlie	647	+	82	111101687	1273
chr3	111100414	111300414	harbor1	chr3	111115435	111115599	DNA/hAT-Charlie	928	+	82	111115517	15103
chr3	111100414	111300414	harbor1	chr3	111150539	111150827	DNA/hAT-Charlie	1187	+	144	111150683	50269
chr3	111100414	111300414	harbor1	chr3	111150836	111151026	DNA/hAT-Charlie	690	+	95	111150931	50517
chr3	111100414	111300414	harbor1	chr3	111161456	111161766	DNA/hAT-Charlie	1837	+	155	111161611	61197
chr3	76601185	76801185	harbor1	chr3	76634747	76635102	DNA/hAT-Charlie	1878	+	178	76634925	33740
chr3	76601185	76801185	harbor1	chr3	76660013	76660323	DNA/hAT-Charlie	648	+	155	76660168	58983
chr3	4142876	4342876	harbor1	chr3	4143778	4143942	DNA/hAT-Charlie	649	+	82	4143860	984
chr3	4142876	4342876	harbor1	chr3	4170035	4170254	DNA/hAT-Charlie	1036	+	110	4170145	27269
chr3	4142876	4342876	harbor1	chr3	4193083	4193245	DNA/hAT-Charlie	670	+	81	4193164	50288
chr3	4142876	4342876	harbor1	chr3	4194055	4194240	DNA/hAT-Charlie	770	+	92	4194147	51271
chr3	4142876	4342876	harbor1	chr3	4219717	4219867	DNA/hAT-Charlie	410	+	75	4219792	76916
chr3	173250937	173450937	harbor1	chr3	173260262	173260488	DNA/hAT-Charlie	918	+	113	173260375	9438
chr3	187294463	187494463	harbor1	chr3	187333957	187334105	DNA/hAT-Charlie	601	+	74	187334031	39568
chr3	187294463	187494463	harbor1	chr3	187356299	187356515	DNA/hAT-Charlie	1343	+	108	187356407	61944
chr3	69596038	69796038	harbor1	chr3	69603183	69604040	DNA/hAT-Charlie	2723	+	428	69603611	7573
chr3	69596038	69796038	harbor1	chr3	69614265	69614493	DNA/hAT-Charlie	1720	+	114	69614379	18341
chr3	69596038	69796038	harbor1	chr3	69617637	69617805	DNA/hAT-Charlie	728	+	84	69617721	21683
chr3	69596038	69796038	harbor1	chr3	69620769	69620959	DNA/hAT-Charlie	741	+	95	69620864	24826
chr3	69596038	69796038	harbor1	chr3	69676688	69676888	DNA/hAT-Charlie	1069	+	100	69676788	80750
chr3	73821318	74021318	harbor1	chr3	73848621	73848798	DNA/hAT-Charlie	760	+	88	73848709	27391
chr3	73821318	74021318	harbor1	chr3	73874223	73874395	DNA/hAT-Charlie	867	+	86	73874309	52991
chr3	73821318	74021318	harbor1	chr3	73874453	73874651	DNA/hAT-Charlie	890	+	99	73874552	53234
chr3	181756359	181956359	harbor1	chr3	181780620	181780839	DNA/hAT-Charlie	919	+	110	181780730	24371
chr3	181756359	181956359	harbor1	chr3	181781059	181781441	DNA/hAT-Charlie	749	+	191	181781250	24891
chr3	181756359	181956359	harbor1	chr3	181788718	181788938	DNA/hAT-Charlie	814	+	110	181788828	32469
chr3	181756359	181956359	harbor1	chr3	181790204	181790302	DNA/hAT-Charlie	515	+	49	181790253	33894
chr3	181756359	181956359	harbor1	chr3	181790601	181790642	DNA/hAT-Charlie	515	+	20	181790621	34262
chr3	181756359	181956359	harbor1	chr3	181798947	181799135	DNA/hAT-Charlie	924	+	94	181799041	42682
chr3	181756359	181956359	harbor1	chr3	181835401	181835595	DNA/hAT-Charlie	996	+	97	181835498	79139
chr3	11750120	11950120	harbor1	chr3	11770544	11770625	DNA/hAT-Charlie	428	+	40	11770584	20464
chr3	11750120	11950120	harbor1	chr3	11792413	11792580	DNA/hAT-Charlie	509	+	84	11792497	42377
chr3	11750120	11950120	harbor1	chr3	11842052	11842122	DNA/hAT-Charlie	525	+	35	11842087	91967
chr3	11750120	11950120	harbor1	chr3	11842414	11842427	DNA/hAT-Charlie	525	+	6	11842420	92300
chr3	11750120	11950120	harbor1	chr3	11842718	11842794	DNA/hAT-Charlie	525	+	38	11842756	92636
chr3	11750120	11950120	harbor1	chr3	11843251	11843424	DNA/hAT-Charlie	807	+	86	11843337	93217
chr3	11750120	11950120	harbor1	chr3	11846030	11846195	DNA/hAT-Charlie	831	+	82	11846112	95992
chr3	11750120	11950120	harbor1	chr3	11829170	11829358	DNA/hAT-Charlie	874	+	94	11829264	79144
chr3	171925249	172125249	harbor1	chr3	171965562	171965777	DNA/hAT-Charlie	536	+	108	171965670	40421
chr3	171925249	172125249	harbor1	chr3	171977237	171977389	DNA/hAT-Charlie	497	+	76	171977313	52064
chr3	171925249	172125249	harbor1	chr3	171981047	171981202	DNA/hAT-Charlie	909	+	78	171981125	55876
chr3	140474965	140674965	harbor1	chr3	140506714	140506990	DNA/hAT-Charlie	1246	+	138	140506852	31887
chr3	140474965	140674965	harbor1	chr3	140544438	140544604	DNA/hAT-Charlie	772	+	83	140544521	69556
chr3	140474965	140674965	harbor1	chr3	140560664	140560971	DNA/hAT-Charlie	935	+	154	140560818	85853
chr3	140474965	140674965	harbor1	chr3	140572611	140572762	DNA/hAT-Charlie	809	+	76	140572687	97722
chr3	68757710	68957710	harbor1	chr3	68769022	68769497	DNA/hAT-Charlie	2967	+	238	68769260	11550
chr3	68757710	68957710	harbor1	chr3	68770539	68770640	DNA/hAT-Charlie	425	+	50	68770589	12879
chr3	68757710	68957710	harbor1	chr3	68777335	68777543	DNA/hAT-Charlie	748	+	104	68777439	19729
chr3	68757710	68957710	harbor1	chr3	68799756	68800271	DNA/hAT-Charlie	3418	+	258	68800014	42304
chr3	68757710	68957710	harbor1	chr3	68807423	68808126	DNA/hAT-Charlie	1522	+	352	68807775	50065
chr3	68757710	68957710	harbor1	chr3	68823190	68823439	DNA/hAT-Charlie	1428	+	124	68823314	65604
chr3	68757710	68957710	harbor1	chr3	68823812	68824047	DNA/hAT-Charlie	1428	+	118	68823930	66220
chr3	68757710	68957710	harbor1	chr3	68836975	68837197	DNA/hAT-Charlie	1124	+	111	68837086	79376
chr3	68757710	68957710	harbor1	chr3	68837210	68837339	DNA/hAT-Charlie	594	+	64	68837274	79564
chr3	107525183	107725183	harbor1	chr3	107557925	107558082	DNA/hAT-Charlie	623	+	78	107558003	32820
chr3	1112153	1312153	harbor1	chr3	1124078	1124285	DNA/hAT-Charlie	768	+	104	1124182	12029
chr3	1112153	1312153	harbor1	chr3	1139036	1139256	DNA/hAT-Charlie	503	+	110	1139146	26993
chr3	71531421	71731421	harbor1	chr3	71537759	71538088	DNA/hAT-Charlie	1830	+	164	71537923	6502
chr3	71531421	71731421	harbor1	chr3	71588736	71588894	DNA/hAT-Charlie	589	+	79	71588815	57394
chr3	71531421	71731421	harbor1	chr3	71598501	71598694	DNA/hAT-Charlie	1161	+	96	71598597	67176
chr3	71531421	71731421	harbor1	chr3	71599076	71599255	DNA/hAT-Charlie	665	+	90	71599166	67745
chr3	71531421	71731421	harbor1	chr3	71611318	71611540	DNA/hAT-Charlie	1396	+	111	71611429	80008
chr3	71531421	71731421	harbor1	chr3	71623969	71624041	DNA/hAT-Charlie	608	+	36	71624005	92584
chr3	71531421	71731421	harbor1	chr3	71624376	71624472	DNA/hAT-Charlie	608	+	48	71624424	93003
chr3	110642818	110842818	harbor1	chr3	110711200	110711372	DNA/hAT-Charlie	614	+	86	110711286	68468
chr3	110642818	110842818	harbor1	chr3	110727462	110727566	DNA/hAT-Charlie	426	+	52	110727514	84696
chr3	110642818	110842818	harbor1	chr3	110727565	110727675	DNA/hAT-Charlie	1320	+	55	110727620	84802
chr3	110642818	110842818	harbor1	chr3	110727975	110728251	DNA/hAT-Charlie	1320	+	138	110728113	85295
chr3	29768236	29968236	harbor1	chr3	29774573	29775027	DNA/hAT-Charlie	1883	+	227	29774800	6564
chr3	29768236	29968236	harbor1	chr3	29823531	29823729	DNA/hAT-Charlie	775	+	99	29823630	55394
chr3	23268000	23468000	harbor1	chr3	23283774	23283937	DNA/hAT-Charlie	549	+	82	23283856	15856
chr3	23268000	23468000	harbor1	chr3	23302940	23303439	DNA/hAT-Charlie	3293	+	250	23303190	35190
chr3	23268000	23468000	harbor1	chr3	23356816	23356896	DNA/hAT-Charlie	410	+	40	23356856	88856
chr3	114431323	114631323	harbor1	chr3	114461681	114461845	DNA/hAT-Charlie	714	+	82	114461763	30440
chr3	114431323	114631323	harbor1	chr3	114504586	114504774	DNA/hAT-Charlie	449	+	94	114504680	73357
chr3	114431323	114631323	harbor1	chr3	114518776	114518981	DNA/hAT-Charlie	953	+	102	114518878	87555
chr3	711551	911551	harbor1	chr3	774901	775064	DNA/hAT-Charlie	766	+	82	774983	63432
chr3	711551	911551	harbor1	chr3	779775	779905	DNA/hAT-Charlie	503	+	65	779840	68289
chr3	26310250	26510250	harbor1	chr3	26311741	26311847	DNA/hAT-Charlie	439	+	53	26311794	1544
chr3	26310250	26510250	harbor1	chr3	26369621	26369806	DNA/hAT-Charlie	602	+	92	26369713	59463
chr3	26310250	26510250	harbor1	chr3	26379475	26379661	DNA/hAT-Charlie	1030	+	93	26379568	69318
chr3	67392911	67592911	harbor1	chr3	67392977	67393023	DNA/hAT-Charlie	616	+	23	67393000	89
chr3	67392911	67592911	harbor1	chr3	67399196	67399898	DNA/hAT-Charlie	2766	+	351	67399547	6636
chr3	67392911	67592911	harbor1	chr3	67400025	67400403	DNA/hAT-Charlie	2766	+	189	67400214	7303
chr3	67392911	67592911	harbor1	chr3	67442349	67442518	DNA/hAT-Charlie	648	+	84	67442433	49522
chr3	67392911	67592911	harbor1	chr3	67476162	67476698	DNA/hAT-Charlie	3292	+	268	67476430	83519
chr3	887525	1087525	harbor1	chr3	898793	899021	DNA/hAT-Charlie	647	+	114	898907	11382
chr3	887525	1087525	harbor1	chr3	921849	922044	DNA/hAT-Charlie	632	+	98	921947	34422
chr3	178605179	178805179	harbor1	chr3	178661655	178661820	DNA/hAT-Charlie	940	+	82	178661737	56558
chr3	98264038	98464038	harbor1	chr3	98305954	98306046	DNA/hAT-Charlie	482	+	46	98306000	41962
chr3	98264038	98464038	harbor1	chr3	98323023	98323152	DNA/hAT-Charlie	448	+	64	98323087	59049
chr3	98264038	98464038	harbor1	chr3	98348829	98349613	DNA/hAT-Charlie	1540	+	392	98349221	85183
chr3	38198972	38398972	harbor1	chr3	38207504	38207682	DNA/hAT-Charlie	795	+	89	38207593	8621
chr3	5500909	5700909	harbor1	chr3	5500725	5500945	DNA/hAT-Charlie	806	+	110	5500835	74
chr3	5500909	5700909	harbor1	chr3	5503130	5503303	DNA/hAT-Charlie	690	+	86	5503216	2307
chr3	5500909	5700909	harbor1	chr3	5553124	5553287	DNA/hAT-Charlie	412	+	82	5553206	52297
chr3	5500909	5700909	harbor1	chr3	5564005	5564044	DNA/hAT-Charlie	544	+	20	5564025	63116
chr3	5500909	5700909	harbor1	chr3	5564354	5564494	DNA/hAT-Charlie	544	+	70	5564424	63515
chr3	5500909	5700909	harbor1	chr3	5564504	5564686	DNA/hAT-Charlie	974	+	91	5564595	63686
chr3	5500909	5700909	harbor1	chr3	5583561	5583874	DNA/hAT-Charlie	993	+	156	5583717	82808
chr3	5500909	5700909	harbor1	chr3	5590596	5590753	DNA/hAT-Charlie	616	+	78	5590674	89765
chr3	28533140	28733140	harbor1	chr3	28551137	28551327	DNA/hAT-Charlie	914	+	95	28551232	18092
chr3	28533140	28733140	harbor1	chr3	28572156	28572296	DNA/hAT-Charlie	527	+	70	28572226	39086
chr3	28533140	28733140	harbor1	chr3	28591586	28591800	DNA/hAT-Charlie	965	+	107	28591693	58553
chr3	28533140	28733140	harbor1	chr3	28632044	28632328	DNA/hAT-Charlie	1010	+	142	28632186	99046
chr3	28533140	28733140	harbor1	chr3	28632626	28632665	DNA/hAT-Charlie	1010	+	20	28632646	99506
chr3	11132145	11332145	harbor1	chr3	11171480	11171579	DNA/hAT-Charlie	535	+	50	11171530	39385
chr3	11132145	11332145	harbor1	chr3	11183335	11183549	DNA/hAT-Charlie	1027	+	107	11183442	51297
chr3	11132145	11332145	harbor1	chr3	11196763	11196829	DNA/hAT-Charlie	683	+	33	11196796	64651
chr3	11132145	11332145	harbor1	chr3	11197141	11197237	DNA/hAT-Charlie	683	+	48	11197189	65044
chr3	11132145	11332145	harbor1	chr3	11228183	11228237	DNA/hAT-Charlie	679	+	27	11228210	96065
chr3	11132145	11332145	harbor1	chr3	11228389	11228532	DNA/hAT-Charlie	679	+	72	11228461	96316
chr3	11132145	11332145	harbor1	chr3	11229482	11229822	DNA/hAT-Charlie	596	+	170	11229652	97507
chr3	11132145	11332145	harbor1	chr3	11230533	11230687	DNA/hAT-Charlie	813	+	77	11230610	98465
chr3	39123872	39323872	harbor1	chr3	39145826	39145987	DNA/hAT-Charlie	739	+	80	39145906	22034
chr3	39123872	39323872	harbor1	chr3	39159513	39159699	DNA/hAT-Charlie	935	+	93	39159606	35734
chr3	39123872	39323872	harbor1	chr3	39212851	39213012	DNA/hAT-Charlie	942	+	80	39212931	89059
chr3	20205653	20405653	harbor1	chr3	20214833	20215026	DNA/hAT-Charlie	606	+	96	20214929	9276
chr3	20205653	20405653	harbor1	chr3	20218181	20218359	DNA/hAT-Charlie	677	+	89	20218270	12617
chr3	20205653	20405653	harbor1	chr3	20218383	20218546	DNA/hAT-Charlie	733	+	82	20218465	12812
chr3	180719030	180919030	harbor1	chr3	180761240	180761570	DNA/hAT-Charlie	1979	+	165	180761405	42375
chr3	180719030	180919030	harbor1	chr3	180783947	180784154	DNA/hAT-Charlie	977	+	104	180784051	65021
chr4	105310844	105510844	harbor1	chr4	105341887	105342029	DNA/hAT-Charlie	657	+	71	105341958	31114
chr4	105310844	105510844	harbor1	chr4	105347294	105347457	DNA/hAT-Charlie	764	+	82	105347376	36532
chr4	105310844	105510844	harbor1	chr4	105388932	105389061	DNA/hAT-Charlie	477	+	64	105388996	78152
chr4	105310844	105510844	harbor1	chr4	105396578	105396784	DNA/hAT-Charlie	924	+	103	105396681	85837
chr4	19250126	19450126	harbor1	chr4	19320598	19320735	DNA/hAT-Charlie	787	+	68	19320666	70540
chr4	19250126	19450126	harbor1	chr4	19321111	19321252	DNA/hAT-Charlie	787	+	70	19321181	71055
chr4	19250126	19450126	harbor1	chr4	19323475	19323696	DNA/hAT-Charlie	762	+	110	19323585	73459
chr4	19250126	19450126	harbor1	chr4	19338123	19338301	DNA/hAT-Charlie	609	+	89	19338212	88086
chr4	19250126	19450126	harbor1	chr4	19348849	19348982	DNA/hAT-Charlie	401	+	66	19348915	98789
chr4	6713772	6913772	harbor1	chr4	6795035	6795068	DNA/hAT-Charlie	1134	+	16	6795051	81279
chr4	6713772	6913772	harbor1	chr4	6795372	6795598	DNA/hAT-Charlie	1134	+	113	6795485	81713
chr4	6713772	6913772	harbor1	chr4	6795891	6795944	DNA/hAT-Charlie	1134	+	26	6795917	82145
chr4	6713772	6913772	harbor1	chr4	6801124	6801317	DNA/hAT-Charlie	981	+	96	6801220	87448
chr4	6713772	6913772	harbor1	chr4	6812235	6812399	DNA/hAT-Charlie	785	+	82	6812317	98545
chr4	177096803	177296803	harbor1	chr4	177186050	177186246	DNA/hAT-Charlie	814	+	98	177186148	89345
chr4	125200706	125400706	harbor1	chr4	125240647	125240849	DNA/hAT-Charlie	735	+	101	125240748	40042
chr4	125200706	125400706	harbor1	chr4	125277885	125280480	DNA/hAT-Charlie	17638	+	1298	125279183	78477
chr4	20868970	21068970	harbor1	chr4	20895937	20896300	DNA/hAT-Charlie	625	+	182	20896119	27149
chr4	20868970	21068970	harbor1	chr4	20901354	20901482	DNA/hAT-Charlie	741	+	64	20901418	32448
chr4	20868970	21068970	harbor1	chr4	20945103	20945264	DNA/hAT-Charlie	533	+	80	20945183	76213
chr4	41954857	42154857	harbor1	chr4	42027093	42028112	DNA/hAT-Charlie	7682	+	510	42027603	72746
chr4	41954857	42154857	harbor1	chr4	42028419	42029076	DNA/hAT-Charlie	7682	+	328	42028747	73890
chr4	41954857	42154857	harbor1	chr4	42031287	42031894	DNA/hAT-Charlie	2984	+	304	42031591	76734
chr4	66835405	67035405	harbor1	chr4	66912781	66912962	DNA/hAT-Charlie	835	+	90	66912871	77466
chr4	151923984	152123984	harbor1	chr4	151945689	151945896	DNA/hAT-Charlie	1291	+	104	151945793	21809
chr4	151923984	152123984	harbor1	chr4	151948199	151949378	DNA/hAT-Charlie	5406	+	590	151948789	24805
chr4	151923984	152123984	harbor1	chr4	151949861	151949920	DNA/hAT-Charlie	5406	+	30	151949891	25907
chr4	151923984	152123984	harbor1	chr4	151980017	151980147	DNA/hAT-Charlie	554	+	65	151980082	56098
chr4	151923984	152123984	harbor1	chr4	151980277	151980558	DNA/hAT-Charlie	767	+	140	151980417	56433
chr4	151923984	152123984	harbor1	chr4	151980544	151980739	DNA/hAT-Charlie	500	+	98	151980642	56658
chr4	151923984	152123984	harbor1	chr4	151996504	151996631	DNA/hAT-Charlie	548	+	64	151996568	72584
chr4	151923984	152123984	harbor1	chr4	151996934	151996974	DNA/hAT-Charlie	548	+	20	151996954	72970
chr4	151923984	152123984	harbor1	chr4	151997820	151998299	DNA/hAT-Charlie	3272	+	240	151998060	74076
chr4	151923984	152123984	harbor1	chr4	152012574	152012916	DNA/hAT-Charlie	2101	+	171	152012745	88761
chr4	170178744	170378744	harbor1	chr4	170197153	170197322	DNA/hAT-Charlie	560	+	84	170197237	18493
chr4	170178744	170378744	harbor1	chr4	170247797	170247888	DNA/hAT-Charlie	468	+	46	170247843	69099
chr4	172711870	172911870	harbor1	chr4	172716079	172716275	DNA/hAT-Charlie	503	+	98	172716177	4307
chr4	172711870	172911870	harbor1	chr4	172771654	172771806	DNA/hAT-Charlie	388	+	76	172771730	59860
chr4	172711870	172911870	harbor1	chr4	172789316	172789529	DNA/hAT-Charlie	1360	+	106	172789422	77552
chr4	172711870	172911870	harbor1	chr4	172803187	172803516	DNA/hAT-Charlie	2167	+	164	172803351	91481
chr4	84394301	84594301	harbor1	chr4	84415987	84416189	DNA/hAT-Charlie	907	+	101	84416088	21787
chr4	84394301	84594301	harbor1	chr4	84460732	84460943	DNA/hAT-Charlie	609	+	106	84460838	66537
chr4	131743652	131943652	harbor1	chr4	131837106	131837328	DNA/hAT-Charlie	991	+	111	131837217	93565
chr4	156022177	156222177	harbor1	chr4	156115490	156115661	DNA/hAT-Charlie	449	+	86	156115576	93399
chr4	156022177	156222177	harbor1	chr4	156115953	156116009	DNA/hAT-Charlie	449	+	28	156115981	93804
chr4	178428790	178628790	harbor1	chr4	178459479	178459580	DNA/hAT-Charlie	685	+	50	178459529	30739
chr4	178428790	178628790	harbor1	chr4	178460192	178460257	DNA/hAT-Charlie	685	+	32	178460224	31434
chr4	122335521	122535521	harbor1	chr4	122340119	122340299	DNA/hAT-Charlie	700	+	90	122340209	4688
chr4	122335521	122535521	harbor1	chr4	122395870	122395991	DNA/hAT-Charlie	539	+	60	122395930	60409
chr4	122335521	122535521	harbor1	chr4	122433714	122433862	DNA/hAT-Charlie	388	+	74	122433788	98267
chr4	81440715	81640715	harbor1	chr4	81467885	81468094	DNA/hAT-Charlie	1016	+	104	81467989	27274
chr4	108195037	108395037	harbor1	chr4	108273307	108273543	DNA/hAT-Charlie	571	+	118	108273425	78388
chr4	108195037	108395037	harbor1	chr4	108285865	108286027	DNA/hAT-Charlie	607	+	81	108285946	90909
chr4	41379139	41579139	harbor1	chr4	41380790	41380924	DNA/hAT-Charlie	472	+	67	41380857	1718
chr4	41379139	41579139	harbor1	chr4	41465791	41465954	DNA/hAT-Charlie	772	+	82	41465873	86734
chr4	41379139	41579139	harbor1	chr4	41466302	41466455	DNA/hAT-Charlie	562	+	76	41466378	87239
chr4	146126953	146326953	harbor1	chr4	146141306	146141514	DNA/hAT-Charlie	1093	+	104	146141410	14457
chr4	146126953	146326953	harbor1	chr4	146141764	146141921	DNA/hAT-Charlie	410	+	78	146141842	14889
chr4	146126953	146326953	harbor1	chr4	146212237	146212506	DNA/hAT-Charlie	1434	+	134	146212371	85418
chr4	146126953	146326953	harbor1	chr4	146212811	146212865	DNA/hAT-Charlie	1434	+	27	146212838	85885
chr4	19930301	20130301	harbor1	chr4	19996608	19996890	DNA/hAT-Charlie	1016	+	141	19996749	66448
chr4	19930301	20130301	harbor1	chr4	20005240	20005342	DNA/hAT-Charlie	475	+	51	20005291	74990
chr4	152609837	152809837	harbor1	chr4	152609950	152610135	DNA/hAT-Charlie	403	+	92	152610042	205
chr4	152609837	152809837	harbor1	chr4	152642535	152642700	DNA/hAT-Charlie	515	+	82	152642617	32780
chr4	152609837	152809837	harbor1	chr4	152664992	152665097	DNA/hAT-Charlie	444	+	52	152665044	55207
chr4	152609837	152809837	harbor1	chr4	152666207	152666370	DNA/hAT-Charlie	401	+	82	152666289	56452
chr4	152609837	152809837	harbor1	chr4	152680340	152680526	DNA/hAT-Charlie	876	+	93	152680433	70596
chr4	152609837	152809837	harbor1	chr4	152689680	152689837	DNA/hAT-Charlie	725	+	78	152689758	79921
chr4	152609837	152809837	harbor1	chr4	152693958	152694107	DNA/hAT-Charlie	932	+	74	152694032	84195
chr4	152609837	152809837	harbor1	chr4	152694678	152694855	DNA/hAT-Charlie	529	+	88	152694766	84929
chr4	147382739	147582739	harbor1	chr4	147445075	147445256	DNA/hAT-Charlie	721	+	90	147445165	62426
chr4	147382739	147582739	harbor1	chr4	147446059	147446217	DNA/hAT-Charlie	729	+	79	147446138	63399
chr4	147382739	147582739	harbor1	chr4	147464862	147464997	DNA/hAT-Charlie	514	+	68	147464930	82191
chr4	147382739	147582739	harbor1	chr4	147473333	147473549	DNA/hAT-Charlie	995	+	108	147473441	90702
chr4	37400090	37600090	harbor1	chr4	37459568	37459719	DNA/hAT-Charlie	732	+	76	37459644	59554
chr4	88098907	88298907	harbor1	chr4	88109862	88109950	DNA/hAT-Charlie	628	+	44	88109906	10999
chr4	88098907	88298907	harbor1	chr4	88110114	88110223	DNA/hAT-Charlie	628	+	54	88110168	11261
chr4	88098907	88298907	harbor1	chr4	88110678	88110820	DNA/hAT-Charlie	650	+	71	88110749	11842
chr4	88098907	88298907	harbor1	chr4	88118480	88118626	DNA/hAT-Charlie	417	+	73	88118553	19646
chr4	88098907	88298907	harbor1	chr4	88130142	88130613	DNA/hAT-Charlie	3350	+	236	88130378	31471
chr4	88098907	88298907	harbor1	chr4	88134971	88135149	DNA/hAT-Charlie	761	+	89	88135060	36153
chr4	58520849	58720849	harbor1	chr4	58604448	58604629	DNA/hAT-Charlie	704	+	90	58604538	83689
chr4	35208740	35408740	harbor1	chr4	35213242	35213394	DNA/hAT-Charlie	477	+	76	35213318	4578
chr4	46122644	46322644	harbor1	chr4	46126537	46126754	DNA/hAT-Charlie	895	+	108	46126645	4001
chr4	46122644	46322644	harbor1	chr4	46199918	46200248	DNA/hAT-Charlie	1892	+	165	46200083	77439
chr4	31585939	31785939	harbor1	chr4	31591944	31592125	DNA/hAT-Charlie	564	+	90	31592034	6095
chr4	31585939	31785939	harbor1	chr4	31599626	31599843	DNA/hAT-Charlie	885	+	108	31599734	13795
chr4	31585939	31785939	harbor1	chr4	31632613	31632828	DNA/hAT-Charlie	476	+	108	31632721	46782
chr4	31585939	31785939	harbor1	chr4	31646527	31646865	DNA/hAT-Charlie	1658	+	169	31646696	60757
chr4	31585939	31785939	harbor1	chr4	31649705	31649888	DNA/hAT-Charlie	842	+	92	31649797	63858
chr4	111550960	111750960	harbor1	chr4	111562317	111562496	DNA/hAT-Charlie	639	+	90	111562407	11447
chr4	111550960	111750960	harbor1	chr4	111562587	111562755	DNA/hAT-Charlie	717	+	84	111562671	11711
chr4	11304743	11504743	harbor1	chr4	11313450	11313643	DNA/hAT-Charlie	903	+	96	11313546	8803
chr4	11304743	11504743	harbor1	chr4	11370991	11371267	DNA/hAT-Charlie	952	+	138	11371129	66386
chr4	180394441	180594441	harbor1	chr4	180417908	180418068	DNA/hAT-Charlie	524	+	80	180417988	23547
chr4	180394441	180594441	harbor1	chr4	180438470	180438612	DNA/hAT-Charlie	531	+	71	180438541	44100
chr4	180394441	180594441	harbor1	chr4	180482591	180482922	DNA/hAT-Charlie	1297	+	166	180482757	88316
chr4	180394441	180594441	harbor1	chr4	180493016	180493186	DNA/hAT-Charlie	601	+	85	180493101	98660
chr4	175698119	175898119	harbor1	chr4	175786034	175786129	DNA/hAT-Charlie	395	+	48	175786082	87963
chr4	175698119	175898119	harbor1	chr4	175786143	175786234	DNA/hAT-Charlie	393	+	46	175786189	88070
chr4	175698119	175898119	harbor1	chr4	175797931	175798041	DNA/hAT-Charlie	509	+	55	175797986	99867
chr4	107802869	108002869	harbor1	chr4	107849264	107849462	DNA/hAT-Charlie	1026	+	99	107849363	46494
chr4	13891379	14091379	harbor1	chr4	13919630	13919768	DNA/hAT-Charlie	460	+	69	13919699	28320
chr4	13891379	14091379	harbor1	chr4	13946246	13946440	DNA/hAT-Charlie	906	+	97	13946343	54964
chr4	13891379	14091379	harbor1	chr4	13952937	13953163	DNA/hAT-Charlie	780	+	113	13953050	61671
chr4	13891379	14091379	harbor1	chr4	13955614	13955950	DNA/hAT-Charlie	2124	+	168	13955782	64403
chr4	173217660	173417660	harbor1	chr4	173244064	173244261	DNA/hAT-Charlie	1050	+	98	173244162	26502
chr4	173217660	173417660	harbor1	chr4	173246989	173247130	DNA/hAT-Charlie	604	+	70	173247059	29399
chr4	173217660	173417660	harbor1	chr4	173311956	173312164	DNA/hAT-Charlie	1005	+	104	173312060	94400
chr4	168722666	168922666	harbor1	chr4	168748196	168748361	DNA/hAT-Charlie	761	+	82	168748278	25612
chr4	168722666	168922666	harbor1	chr4	168815165	168815344	DNA/hAT-Charlie	433	+	90	168815255	92589
chr4	189712793	189912793	harbor1	chr4	189721456	189721683	DNA/hAT-Charlie	853	+	114	189721570	8777
chr4	189712793	189912793	harbor1	chr4	189729429	189729687	DNA/hAT-Charlie	1084	+	129	189729558	16765
chr4	189712793	189912793	harbor1	chr4	189740118	189740324	DNA/hAT-Charlie	862	+	103	189740221	27428
chr4	189712793	189912793	harbor1	chr4	189752251	189752280	DNA/hAT-Charlie	858	+	14	189752265	39472
chr4	189712793	189912793	harbor1	chr4	189754550	189754730	DNA/hAT-Charlie	858	+	90	189754640	41847
chr4	189712793	189912793	harbor1	chr4	189769432	189769737	DNA/hAT-Charlie	1213	+	152	189769584	56791
chr4	65681722	65881722	harbor1	chr4	65690428	65690677	DNA/hAT-Charlie	551	+	124	65690552	8830
chr4	65681722	65881722	harbor1	chr4	65690746	65691098	DNA/hAT-Charlie	852	+	176	65690922	9200
chr4	65681722	65881722	harbor1	chr4	65691108	65691628	DNA/hAT-Charlie	392	+	260	65691368	9646
chr4	82126099	82326099	harbor1	chr4	82136249	82136459	DNA/hAT-Charlie	969	+	105	82136354	10255
chr4	82126099	82326099	harbor1	chr4	82218611	82218837	DNA/hAT-Charlie	841	+	113	82218724	92625
chr4	82126099	82326099	harbor1	chr4	82218850	82218950	DNA/hAT-Charlie	484	+	50	82218900	92801
chr4	4658971	4858971	harbor1	chr4	4715904	4716278	DNA/hAT-Charlie	1500	+	187	4716091	57120
chr4	4658971	4858971	harbor1	chr4	4716570	4716670	DNA/hAT-Charlie	1500	+	50	4716620	57649
chr4	4658971	4858971	harbor1	chr4	4743082	4743463	DNA/hAT-Charlie	694	+	190	4743272	84301
chr4	4658971	4858971	harbor1	chr4	4702079	4702241	DNA/hAT-Charlie	457	+	81	4702160	43189
chr4	187661498	187861498	harbor1	chr4	187727312	187727598	DNA/hAT-Charlie	817	+	143	187727455	65957
chr4	187661498	187861498	harbor1	chr4	187733894	187733964	DNA/hAT-Charlie	389	+	35	187733929	72431
chr4	18905232	19105232	harbor1	chr4	18930020	18930465	DNA/hAT-Charlie	1198	+	222	18930242	25010
chr4	18905232	19105232	harbor1	chr4	18956998	18957143	DNA/hAT-Charlie	786	+	72	18957070	51838
chr4	18905232	19105232	harbor1	chr4	18972225	18972333	DNA/hAT-Charlie	488	+	54	18972279	67047
chr4	18905232	19105232	harbor1	chr4	19000863	19001011	DNA/hAT-Charlie	547	+	74	19000937	95705
chr4	162016648	162216648	harbor1	chr4	162095257	162095491	DNA/hAT-Charlie	563	+	117	162095374	78726
chr4	129823031	130023031	harbor1	chr4	129826838	129826926	DNA/hAT-Charlie	463	+	44	129826882	3851
chr4	129823031	130023031	harbor1	chr4	129827042	129827310	DNA/hAT-Charlie	1082	+	134	129827176	4145
chr4	129823031	130023031	harbor1	chr4	129829537	129829716	DNA/hAT-Charlie	611	+	90	129829627	6596
chr4	129823031	130023031	harbor1	chr4	129905554	129905676	DNA/hAT-Charlie	471	+	61	129905615	82584
chr4	97724477	97924477	harbor1	chr4	97727511	97727759	DNA/hAT-Charlie	484	+	124	97727635	3158
chr4	28878407	29078407	harbor1	chr4	28919823	28920017	DNA/hAT-Charlie	846	+	97	28919920	41513
chr4	28878407	29078407	harbor1	chr4	28920067	28920190	DNA/hAT-Charlie	394	+	62	28920129	41722
chr4	28878407	29078407	harbor1	chr4	28963685	28963923	DNA/hAT-Charlie	631	+	119	28963804	85397
chr4	22139271	22339271	harbor1	chr4	22200817	22202044	DNA/hAT-Charlie	2232	+	614	22201431	62160
chr4	22139271	22339271	harbor1	chr4	22199958	22200390	DNA/hAT-Charlie	668	+	216	22200174	60903
chr4	26779759	26979759	harbor1	chr4	26781052	26781234	DNA/hAT-Charlie	929	+	91	26781143	1384
chr4	26779759	26979759	harbor1	chr4	26867944	26868149	DNA/hAT-Charlie	401	+	102	26868046	88287
chr5	143035685	143235685	harbor1	chr5	143064133	143064298	DNA/hAT-Charlie	597	+	82	143064215	28530
chr5	143035685	143235685	harbor1	chr5	143074443	143074737	DNA/hAT-Charlie	1418	+	147	143074590	38905
chr5	143035685	143235685	harbor1	chr5	143115929	143116173	DNA/hAT-Charlie	463	+	122	143116051	80366
chr5	102401648	102601648	harbor1	chr5	102440218	102440653	DNA/hAT-Charlie	2244	+	218	102440436	38788
chr5	102401648	102601648	harbor1	chr5	102458661	102458812	DNA/hAT-Charlie	687	+	76	102458737	57089
chr5	87020004	87220004	harbor1	chr5	87061899	87062077	DNA/hAT-Charlie	416	+	89	87061988	41984
chr5	87020004	87220004	harbor1	chr5	87109646	87109740	DNA/hAT-Charlie	869	+	47	87109693	89689
chr5	87020004	87220004	harbor1	chr5	87110113	87110203	DNA/hAT-Charlie	869	+	45	87110158	90154
chr5	156808738	157008738	harbor1	chr5	156819919	156820078	DNA/hAT-Charlie	631	+	80	156819999	11261
chr5	156808738	157008738	harbor1	chr5	156846555	156846773	DNA/hAT-Charlie	1049	+	109	156846664	37926
chr5	156808738	157008738	harbor1	chr5	156860995	156861075	DNA/hAT-Charlie	552	+	40	156861035	52297
chr5	156808738	157008738	harbor1	chr5	156861378	156861464	DNA/hAT-Charlie	552	+	43	156861421	52683
chr5	156808738	157008738	harbor1	chr5	156882272	156882474	DNA/hAT-Charlie	851	+	101	156882373	73635
chr5	156808738	157008738	harbor1	chr5	156891942	156892062	DNA/hAT-Charlie	549	+	60	156892002	83264
chr5	131191986	131391986	harbor1	chr5	131206811	131207003	DNA/hAT-Charlie	687	+	96	131206907	14921
chr5	131191986	131391986	harbor1	chr5	131217099	131217329	DNA/hAT-Charlie	1041	+	115	131217214	25228
chr5	131191986	131391986	harbor1	chr5	131221192	131221416	DNA/hAT-Charlie	1706	+	112	131221304	29318
chr5	131191986	131391986	harbor1	chr5	131255152	131255430	DNA/hAT-Charlie	1355	+	139	131255291	63305
chr5	178697554	178897554	harbor1	chr5	178726166	178726316	DNA/hAT-Charlie	592	+	75	178726241	28687
chr5	178697554	178897554	harbor1	chr5	178726600	178726636	DNA/hAT-Charlie	592	+	18	178726618	29064
chr5	178697554	178897554	harbor1	chr5	178754716	178754859	DNA/hAT-Charlie	540	+	72	178754788	57234
chr5	99461037	99661037	harbor1	chr5	99507155	99507357	DNA/hAT-Charlie	764	+	101	99507256	46219
chr5	99461037	99661037	harbor1	chr5	99513591	99513778	DNA/hAT-Charlie	727	+	94	99513685	52648
chr5	8036024	8236024	harbor1	chr5	8047508	8047701	DNA/hAT-Charlie	779	+	96	8047604	11580
chr5	8036024	8236024	harbor1	chr5	8076119	8076355	DNA/hAT-Charlie	638	+	118	8076237	40213
chr5	84051850	84251850	harbor1	chr5	84118763	84118935	DNA/hAT-Charlie	602	+	86	84118849	66999
chr5	112317505	112517505	harbor1	chr5	112317518	112317963	DNA/hAT-Charlie	1241	+	222	112317740	235
chr5	112317505	112517505	harbor1	chr5	112329050	112329336	DNA/hAT-Charlie	1172	+	143	112329193	11688
chr5	112317505	112517505	harbor1	chr5	112338719	112338906	DNA/hAT-Charlie	603	+	94	112338813	21308
chr5	112317505	112517505	harbor1	chr5	112347223	112347332	DNA/hAT-Charlie	658	+	54	112347277	29772
chr5	112317505	112517505	harbor1	chr5	112350007	112350214	DNA/hAT-Charlie	762	+	104	112350111	32606
chr5	112317505	112517505	harbor1	chr5	112414376	112414536	DNA/hAT-Charlie	755	+	80	112414456	96951
chr5	100339448	100539448	harbor1	chr5	100395751	100395884	DNA/hAT-Charlie	991	+	66	100395817	56369
chr5	100339448	100539448	harbor1	chr5	100396196	100396260	DNA/hAT-Charlie	991	+	32	100396228	56780
chr5	100339448	100539448	harbor1	chr5	100405251	100405469	DNA/hAT-Charlie	785	+	109	100405360	65912
chr5	100339448	100539448	harbor1	chr5	100415848	100416015	DNA/hAT-Charlie	479	+	84	100415932	76484
chr5	6345858	6545858	harbor1	chr5	6391374	6391555	DNA/hAT-Charlie	719	+	90	6391464	45606
chr5	6345858	6545858	harbor1	chr5	6411464	6411643	DNA/hAT-Charlie	681	+	90	6411554	65696
chr5	6345858	6545858	harbor1	chr5	6417665	6417865	DNA/hAT-Charlie	744	+	100	6417765	71907
chr5	6345858	6545858	harbor1	chr5	6417866	6418130	DNA/hAT-Charlie	1957	+	132	6417998	72140
chr5	6345858	6545858	harbor1	chr5	6427627	6427836	DNA/hAT-Charlie	986	+	104	6427731	81873
chr5	6345858	6545858	harbor1	chr5	6429004	6429338	DNA/hAT-Charlie	2047	+	167	6429171	83313
chr5	154863813	155063813	harbor1	chr5	154863841	154864159	DNA/hAT-Charlie	587	+	159	154864000	187
chr5	154863813	155063813	harbor1	chr5	154873792	154873988	DNA/hAT-Charlie	730	+	98	154873890	10077
chr5	154863813	155063813	harbor1	chr5	154899499	154899705	DNA/hAT-Charlie	864	+	103	154899602	35789
chr5	154863813	155063813	harbor1	chr5	154899704	154900267	DNA/hAT-Charlie	2414	+	282	154899986	36173
chr5	154863813	155063813	harbor1	chr5	154923719	154923877	DNA/hAT-Charlie	760	+	79	154923798	59985
chr5	127346196	127546196	harbor1	chr5	127354455	127354605	DNA/hAT-Charlie	646	+	75	127354530	8334
chr5	127346196	127546196	harbor1	chr5	127357755	127358009	DNA/hAT-Charlie	505	+	127	127357882	11686
chr5	92028988	92228988	harbor1	chr5	92098409	92098898	DNA/hAT-Charlie	787	+	244	92098653	69665
chr5	92028988	92228988	harbor1	chr5	92099398	92100135	DNA/hAT-Charlie	1863	+	368	92099766	70778
chr5	92028988	92228988	harbor1	chr5	92100169	92100221	DNA/hAT-Charlie	1863	+	26	92100195	71207
chr5	92028988	92228988	harbor1	chr5	92103509	92103685	DNA/hAT-Charlie	734	+	88	92103597	74609
chr5	172476219	172676219	harbor1	chr5	172481109	172481654	DNA/hAT-Charlie	3396	+	272	172481381	5162
chr5	172476219	172676219	harbor1	chr5	172495661	172495800	DNA/hAT-Charlie	471	+	70	172495731	19512
chr5	172476219	172676219	harbor1	chr5	172513865	172514201	DNA/hAT-Charlie	2198	+	168	172514033	37814
chr5	172476219	172676219	harbor1	chr5	172525107	172525300	DNA/hAT-Charlie	850	+	96	172525203	48984
chr5	172476219	172676219	harbor1	chr5	172551453	172551548	DNA/hAT-Charlie	890	+	48	172551501	75282
chr5	172476219	172676219	harbor1	chr5	172552388	172552482	DNA/hAT-Charlie	890	+	47	172552435	76216
chr5	172476219	172676219	harbor1	chr5	172562420	172562617	DNA/hAT-Charlie	444	+	98	172562518	86299
chr5	131106664	131306664	harbor1	chr5	131152683	131153143	DNA/hAT-Charlie	1687	+	230	131152913	46249
chr5	131106664	131306664	harbor1	chr5	131153419	131153725	DNA/hAT-Charlie	1687	+	153	131153572	46908
chr5	131106664	131306664	harbor1	chr5	131165668	131165810	DNA/hAT-Charlie	868	+	71	131165739	59075
chr5	6088382	6288382	harbor1	chr5	6091839	6091967	DNA/hAT-Charlie	494	+	64	6091903	3521
chr5	6088382	6288382	harbor1	chr5	6091973	6092138	DNA/hAT-Charlie	753	+	82	6092055	3673
chr5	6088382	6288382	harbor1	chr5	6092576	6092636	DNA/hAT-Charlie	753	+	30	6092606	4224
chr5	6088382	6288382	harbor1	chr5	6106291	6106502	DNA/hAT-Charlie	593	+	106	6106397	18015
chr5	6088382	6288382	harbor1	chr5	6140942	6141071	DNA/hAT-Charlie	435	+	64	6141006	52624
chr5	6088382	6288382	harbor1	chr5	6157476	6157619	DNA/hAT-Charlie	581	+	72	6157548	69166
chr5	6088382	6288382	harbor1	chr5	6178025	6178113	DNA/hAT-Charlie	455	+	44	6178069	89687
chr5	32090403	32290403	harbor1	chr5	32099969	32100115	DNA/hAT-Charlie	430	+	73	32100042	9639
chr5	32090403	32290403	harbor1	chr5	32122067	32122367	DNA/hAT-Charlie	1964	+	150	32122217	31814
chr5	32090403	32290403	harbor1	chr5	32124458	32124612	DNA/hAT-Charlie	730	+	77	32124535	34132
chr5	32090403	32290403	harbor1	chr5	32133740	32133857	DNA/hAT-Charlie	493	+	58	32133798	43395
chr5	179517171	179717171	harbor1	chr5	179530910	179531249	DNA/hAT-Charlie	1521	+	170	179531080	13909
chr5	140016915	140216915	harbor1	chr5	140078747	140078989	DNA/hAT-Charlie	883	+	121	140078868	61953
chr5	140016915	140216915	harbor1	chr5	140079290	140079305	DNA/hAT-Charlie	883	+	8	140079298	62383
chr5	35507357	35707357	harbor1	chr5	35516555	35516891	DNA/hAT-Charlie	2006	+	168	35516723	9366
chr5	35507357	35707357	harbor1	chr5	35592263	35592505	DNA/hAT-Charlie	542	+	121	35592384	85027
chr5	75214570	75414570	harbor1	chr5	75227722	75228059	DNA/hAT-Charlie	2403	+	168	75227890	13320
chr5	148271112	148471112	harbor1	chr5	148292053	148292204	DNA/hAT-Charlie	512	+	76	148292129	21017
chr5	148271112	148471112	harbor1	chr5	148303927	148304139	DNA/hAT-Charlie	420	+	106	148304033	32921
chr5	148271112	148471112	harbor1	chr5	148364428	148364622	DNA/hAT-Charlie	775	+	97	148364525	93413
chr5	148271112	148471112	harbor1	chr5	148365007	148365303	DNA/hAT-Charlie	506	+	148	148365155	94043
chr5	98051787	98251787	harbor1	chr5	98065223	98065423	DNA/hAT-Charlie	626	+	100	98065323	13536
chr5	98051787	98251787	harbor1	chr5	98113073	98113400	DNA/hAT-Charlie	1897	+	164	98113237	61450
chr5	98051787	98251787	harbor1	chr5	98133039	98133187	DNA/hAT-Charlie	617	+	74	98133113	81326
chr5	106164471	106364471	harbor1	chr5	106252376	106252539	DNA/hAT-Charlie	772	+	82	106252458	87987
chr5	106164471	106364471	harbor1	chr5	106200986	106201158	DNA/hAT-Charlie	541	+	86	106201072	36601
chr5	38750889	38950889	harbor1	chr5	38800990	38801166	DNA/hAT-Charlie	1009	+	88	38801078	50189
chr5	66954490	67154490	harbor1	chr5	67002869	67003060	DNA/hAT-Charlie	1050	+	96	67002965	48475
chr5	66954490	67154490	harbor1	chr5	67020814	67021015	DNA/hAT-Charlie	697	+	100	67020914	66424
chr5	57939556	58139556	harbor1	chr5	57996202	57996307	DNA/hAT-Charlie	476	+	52	57996254	56698
chr5	57939556	58139556	harbor1	chr5	57996317	57996531	DNA/hAT-Charlie	847	+	107	57996424	56868
chr5	57939556	58139556	harbor1	chr5	58034876	58035008	DNA/hAT-Charlie	463	+	66	58034942	95386
chr5	57939556	58139556	harbor1	chr5	58036797	58037127	DNA/hAT-Charlie	1259	+	165	58036962	97406
chr5	15825385	16025385	harbor1	chr5	15859307	15859422	DNA/hAT-Charlie	521	+	58	15859365	33980
chr5	15825385	16025385	harbor1	chr5	15880438	15880690	DNA/hAT-Charlie	688	+	126	15880564	55179
chr5	15825385	16025385	harbor1	chr5	15889568	15889739	DNA/hAT-Charlie	693	+	86	15889654	64269
chr5	15825385	16025385	harbor1	chr5	15890102	15890245	DNA/hAT-Charlie	2171	+	72	15890174	64789
chr5	15825385	16025385	harbor1	chr5	15890540	15890748	DNA/hAT-Charlie	2171	+	104	15890644	65259
chr5	15825385	16025385	harbor1	chr5	15916143	15916315	DNA/hAT-Charlie	677	+	86	15916229	90844
chr5	177041941	177241941	harbor1	chr5	177125504	177125560	DNA/hAT-Charlie	429	+	28	177125532	83591
chr5	177041941	177241941	harbor1	chr5	177125866	177125948	DNA/hAT-Charlie	429	+	41	177125907	83966
chr5	167767179	167967179	harbor1	chr5	167777895	167778114	DNA/hAT-Charlie	946	+	110	167778005	10826
chr5	167767179	167967179	harbor1	chr5	167780032	167780216	DNA/hAT-Charlie	567	+	92	167780124	12945
chr5	167767179	167967179	harbor1	chr5	167780872	167781028	DNA/hAT-Charlie	567	+	78	167780950	13771
chr5	167767179	167967179	harbor1	chr5	167781290	167781462	DNA/hAT-Charlie	567	+	86	167781376	14197
chr5	167767179	167967179	harbor1	chr5	167791709	167791927	DNA/hAT-Charlie	434	+	109	167791818	24639
chr5	167767179	167967179	harbor1	chr5	167799271	167799371	DNA/hAT-Charlie	450	+	50	167799321	32142
chr5	167767179	167967179	harbor1	chr5	167799371	167799544	DNA/hAT-Charlie	471	+	86	167799457	32278
chr5	167767179	167967179	harbor1	chr5	167807796	167807940	DNA/hAT-Charlie	698	+	72	167807868	40689
chr5	24856824	25056824	harbor1	chr5	24914571	24914754	DNA/hAT-Charlie	590	+	92	24914663	57839
chr5	24856824	25056824	harbor1	chr5	24934652	24934869	DNA/hAT-Charlie	1262	+	108	24934760	77936
chr5	24856824	25056824	harbor1	chr5	24955879	24956054	DNA/hAT-Charlie	827	+	88	24955967	99143
chr5	63320095	63520095	harbor1	chr5	63327591	63327753	DNA/hAT-Charlie	816	+	81	63327672	7577
chr5	63320095	63520095	harbor1	chr5	63411473	63411557	DNA/hAT-Charlie	428	+	42	63411515	91420
chr5	63320095	63520095	harbor1	chr5	63411549	63411828	DNA/hAT-Charlie	1114	+	140	63411689	91594
chr5	126257657	126457657	harbor1	chr5	126311161	126311310	DNA/hAT-Charlie	464	+	74	126311235	53578
chr5	126257657	126457657	harbor1	chr5	126338062	126338245	DNA/hAT-Charlie	798	+	92	126338154	80497
chr5	80966518	81166518	harbor1	chr5	80983531	80983634	DNA/hAT-Charlie	675	+	52	80983583	17065
chr5	80966518	81166518	harbor1	chr5	80983643	80983973	DNA/hAT-Charlie	1533	+	165	80983808	17290
chr5	156356183	156556183	harbor1	chr5	156453532	156453731	DNA/hAT-Charlie	949	+	100	156453632	97449
chr5	156356183	156556183	harbor1	chr5	156368592	156369004	DNA/hAT-Charlie	2769	+	206	156368798	12615
chr5	51003529	51203529	harbor1	chr5	51005423	51005580	DNA/hAT-Charlie	510	+	78	51005501	1972
chr5	51003529	51203529	harbor1	chr5	51006260	51006580	DNA/hAT-Charlie	1454	+	160	51006420	2891
chr5	51003529	51203529	harbor1	chr5	51015969	51016177	DNA/hAT-Charlie	1278	+	104	51016073	12544
chr5	159682223	159882223	harbor1	chr5	159711422	159711601	DNA/hAT-Charlie	420	+	90	159711512	29289
chr5	159682223	159882223	harbor1	chr5	159750646	159750920	DNA/hAT-Charlie	580	+	137	159750783	68560
chr5	159682223	159882223	harbor1	chr5	159759247	159759432	DNA/hAT-Charlie	491	+	92	159759339	77116
chr5	76060976	76260976	harbor1	chr5	76092312	76092498	DNA/hAT-Charlie	604	+	93	76092405	31429
chr5	76060976	76260976	harbor1	chr5	76097110	76097687	DNA/hAT-Charlie	1684	+	288	76097398	36422
chr5	107544129	107744129	harbor1	chr5	107591155	107591485	DNA/hAT-Charlie	499	+	165	107591320	47191
chr5	107544129	107744129	harbor1	chr5	107629678	107629774	DNA/hAT-Charlie	1408	+	48	107629726	85597
chr5	107544129	107744129	harbor1	chr5	107630079	107630199	DNA/hAT-Charlie	1408	+	60	107630139	86010
chr5	177840343	178040343	harbor1	chr5	177854892	177855144	DNA/hAT-Charlie	451	+	126	177855018	14675
chr5	177840343	178040343	harbor1	chr5	177877452	177877579	DNA/hAT-Charlie	499	+	64	177877516	37173
chr5	177840343	178040343	harbor1	chr5	177877889	177878021	DNA/hAT-Charlie	499	+	66	177877955	37612
chr5	177840343	178040343	harbor1	chr5	177920844	177921032	DNA/hAT-Charlie	642	+	94	177920938	80595
chr5	177840343	178040343	harbor1	chr5	177921304	177921384	DNA/hAT-Charlie	642	+	40	177921344	81001
chr5	134072270	134272270	harbor1	chr5	134073293	134073470	DNA/hAT-Charlie	686	+	88	134073381	1111
chr5	99020985	99220985	harbor1	chr5	99063167	99063487	DNA/hAT-Charlie	1271	+	160	99063327	42342
chr5	99020985	99220985	harbor1	chr5	99103208	99103419	DNA/hAT-Charlie	540	+	106	99103314	82329
chr5	99020985	99220985	harbor1	chr5	99114503	99114708	DNA/hAT-Charlie	1087	+	102	99114605	93620
chr5	90365978	90565978	harbor1	chr5	90434183	90434418	DNA/hAT-Charlie	419	+	118	90434301	68323
chr5	90365978	90565978	harbor1	chr5	90461739	90462022	DNA/hAT-Charlie	794	+	142	90461881	95903
chr5	90365978	90565978	harbor1	chr5	90465456	90465591	DNA/hAT-Charlie	692	+	68	90465524	99546
chr5	90365978	90565978	harbor1	chr5	90465863	90465918	DNA/hAT-Charlie	692	+	28	90465891	99913
chr5	93230318	93430318	harbor1	chr5	93259926	93260101	DNA/hAT-Charlie	912	+	88	93260014	29696
chr5	93230318	93430318	harbor1	chr5	93291288	93291466	DNA/hAT-Charlie	888	+	89	93291377	61059
chr5	93230318	93430318	harbor1	chr5	93325959	93326069	DNA/hAT-Charlie	439	+	55	93326014	95696
chr5	106464090	106664090	harbor1	chr5	106475166	106475496	DNA/hAT-Charlie	1774	+	165	106475331	11241
chr5	106464090	106664090	harbor1	chr5	106482947	106483101	DNA/hAT-Charlie	560	+	77	106483024	18934
chr5	106464090	106664090	harbor1	chr5	106487833	106488015	DNA/hAT-Charlie	476	+	91	106487924	23834
chr5	19260739	19460739	harbor1	chr5	19318266	19318480	DNA/hAT-Charlie	888	+	107	19318373	57634
chr5	39975426	40175426	harbor1	chr5	39980259	39980455	DNA/hAT-Charlie	1352	+	98	39980357	4931
chr5	39975426	40175426	harbor1	chr5	40030219	40030403	DNA/hAT-Charlie	730	+	92	40030311	54885
chr5	173974889	174174889	harbor1	chr5	174039164	174039380	DNA/hAT-Charlie	974	+	108	174039272	64383
chr5	173974889	174174889	harbor1	chr5	174048220	174048397	DNA/hAT-Charlie	721	+	88	174048308	73419
chr5	173974889	174174889	harbor1	chr5	174051082	174051312	DNA/hAT-Charlie	1017	+	115	174051197	76308
chr5	39576991	39776991	harbor1	chr5	39600241	39600418	DNA/hAT-Charlie	440	+	88	39600329	23338
chr5	39576991	39776991	harbor1	chr5	39608351	39608474	DNA/hAT-Charlie	566	+	62	39608413	31422
chr5	39576991	39776991	harbor1	chr5	39608741	39608802	DNA/hAT-Charlie	566	+	30	39608771	31780
chr5	39576991	39776991	harbor1	chr5	39662580	39662780	DNA/hAT-Charlie	982	+	100	39662680	85689
chr5	161166282	161366282	harbor1	chr5	161184408	161184728	DNA/hAT-Charlie	1173	+	160	161184568	18286
chr5	161166282	161366282	harbor1	chr5	161197807	161197924	DNA/hAT-Charlie	478	+	58	161197865	31583
chr5	62346101	62546101	harbor1	chr5	62374235	62374430	DNA/hAT-Charlie	786	+	98	62374333	28232
chr5	62346101	62546101	harbor1	chr5	62375712	62375906	DNA/hAT-Charlie	734	+	97	62375809	29708
chr5	62346101	62546101	harbor1	chr5	62409710	62409816	DNA/hAT-Charlie	581	+	53	62409763	63662
chr5	62346101	62546101	harbor1	chr5	62414637	62414787	DNA/hAT-Charlie	645	+	75	62414712	68611
chr5	62346101	62546101	harbor1	chr5	62427456	62427830	DNA/hAT-Charlie	2123	+	187	62427643	81542
chr5	62346101	62546101	harbor1	chr5	62434602	62434740	DNA/hAT-Charlie	670	+	69	62434671	88570
chr5	62346101	62546101	harbor1	chr5	62436805	62437064	DNA/hAT-Charlie	469	+	130	62436935	90834
chr5	38461505	38661505	harbor1	chr5	38515137	38515320	DNA/hAT-Charlie	623	+	92	38515229	53724
chr5	38461505	38661505	harbor1	chr5	38535395	38535612	DNA/hAT-Charlie	992	+	108	38535503	73998
chr5	38461505	38661505	harbor1	chr5	38535868	38536233	DNA/hAT-Charlie	1218	+	182	38536050	74545
chr5	38461505	38661505	harbor1	chr5	38536570	38536764	DNA/hAT-Charlie	721	+	97	38536667	75162
chr5	38461505	38661505	harbor1	chr5	38546363	38546744	DNA/hAT-Charlie	474	+	190	38546553	85048
chr5	144231643	144431643	harbor1	chr5	144263225	144263697	DNA/hAT-Charlie	794	+	236	144263461	31818
chr5	144231643	144431643	harbor1	chr5	144291714	144292166	DNA/hAT-Charlie	1412	+	226	144291940	60297
chr5	99064949	99264949	harbor1	chr5	99103208	99103419	DNA/hAT-Charlie	540	+	106	99103314	38365
chr5	99064949	99264949	harbor1	chr5	99114503	99114708	DNA/hAT-Charlie	1087	+	102	99114605	49656
chr5	173828355	174028355	harbor1	chr5	173832044	173832228	DNA/hAT-Charlie	838	+	92	173832136	3781
chr5	173828355	174028355	harbor1	chr5	173845089	173845112	DNA/hAT-Charlie	841	+	12	173845101	16746
chr5	173828355	174028355	harbor1	chr5	173845427	173845589	DNA/hAT-Charlie	841	+	81	173845508	17153
chr5	173828355	174028355	harbor1	chr5	173846340	173846663	DNA/hAT-Charlie	823	+	162	173846502	18147
chr5	173828355	174028355	harbor1	chr5	173881105	173881276	DNA/hAT-Charlie	764	+	86	173881191	52836
chr5	173828355	174028355	harbor1	chr5	173881577	173881848	DNA/hAT-Charlie	764	+	136	173881713	53358
chr5	173828355	174028355	harbor1	chr5	173882279	173882441	DNA/hAT-Charlie	670	+	81	173882360	54005
chr5	173828355	174028355	harbor1	chr5	173903453	173903617	DNA/hAT-Charlie	702	+	82	173903535	75180
chr5	173828355	174028355	harbor1	chr5	173920978	173921193	DNA/hAT-Charlie	482	+	108	173921086	92731
chr5	98366037	98566037	harbor1	chr5	98412821	98413039	DNA/hAT-Charlie	814	+	109	98412930	46893
chr5	98366037	98566037	harbor1	chr5	98426137	98426319	DNA/hAT-Charlie	594	+	91	98426228	60191
chr5	98366037	98566037	harbor1	chr5	98461896	98462045	DNA/hAT-Charlie	533	+	74	98461970	95933
chr5	98366037	98566037	harbor1	chr5	98465695	98465945	DNA/hAT-Charlie	487	+	125	98465820	99783
chr5	112697116	112897116	harbor1	chr5	112703209	112703274	DNA/hAT-Charlie	745	+	32	112703241	6125
chr5	112697116	112897116	harbor1	chr5	112703549	112703647	DNA/hAT-Charlie	745	+	49	112703598	6482
chr5	112697116	112897116	harbor1	chr5	112711057	112711409	DNA/hAT-Charlie	2245	+	176	112711233	14117
chr5	112697116	112897116	harbor1	chr5	112714170	112714330	DNA/hAT-Charlie	483	+	80	112714250	17134
chr5	112697116	112897116	harbor1	chr5	112728003	112728125	DNA/hAT-Charlie	1219	+	61	112728064	30948
chr5	112697116	112897116	harbor1	chr5	112728432	112728504	DNA/hAT-Charlie	1219	+	36	112728468	31352
chr5	112697116	112897116	harbor1	chr5	112747931	112748109	DNA/hAT-Charlie	966	+	89	112748020	50904
chr5	112697116	112897116	harbor1	chr5	112763780	112763909	DNA/hAT-Charlie	656	+	64	112763844	66728
chr5	112697116	112897116	harbor1	chr5	112791430	112791668	DNA/hAT-Charlie	1377	+	119	112791549	94433
chr5	54259303	54459303	harbor1	chr5	54293128	54293476	DNA/hAT-Charlie	598	+	174	54293302	33999
chr5	54259303	54459303	harbor1	chr5	54294202	54294362	DNA/hAT-Charlie	663	+	80	54294282	34979
chr5	54259303	54459303	harbor1	chr5	54317335	54317440	DNA/hAT-Charlie	644	+	52	54317387	58084
chr5	54259303	54459303	harbor1	chr5	54358472	54358779	DNA/hAT-Charlie	1336	+	154	54358626	99323
chr5	53011930	53211930	harbor1	chr5	53041569	53041888	DNA/hAT-Charlie	1557	+	160	53041729	29799
chr5	53011930	53211930	harbor1	chr5	53094961	53095119	DNA/hAT-Charlie	475	+	79	53095040	83110
chr5	179569916	179769916	harbor1	chr5	179631139	179631319	DNA/hAT-Charlie	706	+	90	179631229	61313
chr5	160590546	160790546	harbor1	chr5	160603368	160603550	DNA/hAT-Charlie	1092	+	91	160603459	12913
chr5	160590546	160790546	harbor1	chr5	160604756	160604795	DNA/hAT-Charlie	464	+	20	160604776	14230
chr5	160590546	160790546	harbor1	chr5	160609111	160609330	DNA/hAT-Charlie	567	+	110	160609221	18675
chr5	160590546	160790546	harbor1	chr5	160620007	160620203	DNA/hAT-Charlie	435	+	98	160620105	29559
chr5	160590546	160790546	harbor1	chr5	160642454	160642651	DNA/hAT-Charlie	1026	+	98	160642552	52006
chr5	160590546	160790546	harbor1	chr5	160646378	160646593	DNA/hAT-Charlie	596	+	108	160646486	55940
chr5	160590546	160790546	harbor1	chr5	160648227	160648437	DNA/hAT-Charlie	1392	+	105	160648332	57786
chr5	160590546	160790546	harbor1	chr5	160649529	160649726	DNA/hAT-Charlie	916	+	98	160649627	59081
chr5	160590546	160790546	harbor1	chr5	160656472	160656675	DNA/hAT-Charlie	604	+	102	160656574	66028
chr5	160590546	160790546	harbor1	chr5	160665421	160665688	DNA/hAT-Charlie	623	+	134	160665555	75009
chr5	160590546	160790546	harbor1	chr5	160681762	160682000	DNA/hAT-Charlie	644	+	119	160681881	91335
chr5	175260696	175460696	harbor1	chr5	175261216	175261377	DNA/hAT-Charlie	587	+	80	175261296	600
chr5	175260696	175460696	harbor1	chr5	175288422	175288595	DNA/hAT-Charlie	740	+	86	175288508	27812
chr5	175260696	175460696	harbor1	chr5	175292996	175293212	DNA/hAT-Charlie	641	+	108	175293104	32408
chr5	175260696	175460696	harbor1	chr5	175323422	175323625	DNA/hAT-Charlie	1041	+	102	175323524	62828
chr5	175260696	175460696	harbor1	chr5	175342390	175342619	DNA/hAT-Charlie	592	+	114	175342504	81808
chr5	175260696	175460696	harbor1	chr5	175359922	175360129	DNA/hAT-Charlie	1038	+	104	175360026	99330
chr5	130639908	130839908	harbor1	chr5	130656968	130657112	DNA/hAT-Charlie	581	+	72	130657040	17132
chr5	130639908	130839908	harbor1	chr5	130725356	130725540	DNA/hAT-Charlie	1300	+	92	130725448	85540
chr5	130639908	130839908	harbor1	chr5	130725646	130725792	DNA/hAT-Charlie	427	+	73	130725719	85811
chr5	136868045	137068045	harbor1	chr5	136881732	136882135	DNA/hAT-Charlie	1222	+	202	136881934	13889
chr5	136868045	137068045	harbor1	chr5	136882344	136882496	DNA/hAT-Charlie	714	+	76	136882420	14375
chr5	136868045	137068045	harbor1	chr5	136959738	136960000	DNA/hAT-Charlie	1114	+	131	136959869	91824
chr5	136868045	137068045	harbor1	chr5	136960686	136960868	DNA/hAT-Charlie	714	+	91	136960777	92732
chr5	89797764	89997764	harbor1	chr5	89828680	89828796	DNA/hAT-Charlie	426	+	58	89828738	30974
chr5	20894218	21094218	harbor1	chr5	20985968	20986151	DNA/hAT-Charlie	881	+	92	20986060	91842
chr5	7298465	7498465	harbor1	chr5	7322629	7322712	DNA/hAT-Charlie	437	+	42	7322671	24206
chr5	7298465	7498465	harbor1	chr5	7356884	7357055	DNA/hAT-Charlie	491	+	86	7356970	58505
chr5	7298465	7498465	harbor1	chr5	7366277	7366751	DNA/hAT-Charlie	1971	+	237	7366514	68049
chr5	158243711	158443711	harbor1	chr5	158271781	158271996	DNA/hAT-Charlie	1084	+	108	158271889	28178
chr5	158243711	158443711	harbor1	chr5	158278147	158278464	DNA/hAT-Charlie	1665	+	158	158278305	34594
chr5	172149908	172349908	harbor1	chr5	172152536	172152656	DNA/hAT-Charlie	424	+	60	172152596	2688
chr5	172149908	172349908	harbor1	chr5	172152654	172153004	DNA/hAT-Charlie	1783	+	175	172152829	2921
chr5	172149908	172349908	harbor1	chr5	172153328	172153367	DNA/hAT-Charlie	1783	+	20	172153348	3440
chr5	172149908	172349908	harbor1	chr5	172177504	172177785	DNA/hAT-Charlie	762	+	140	172177644	27736
chr5	172149908	172349908	harbor1	chr5	172178815	172179031	DNA/hAT-Charlie	879	+	108	172178923	29015
chr5	172149908	172349908	harbor1	chr5	172197417	172197581	DNA/hAT-Charlie	672	+	82	172197499	47591
chr5	172149908	172349908	harbor1	chr5	172208445	172208617	DNA/hAT-Charlie	758	+	86	172208531	58623
chr5	40175910	40375910	harbor1	chr5	40188935	40189144	DNA/hAT-Charlie	830	+	104	40189039	13129
chr5	40175910	40375910	harbor1	chr5	40272966	40273120	DNA/hAT-Charlie	513	+	77	40273043	97133
chr5	102528933	102728933	harbor1	chr5	102601151	102601328	DNA/hAT-Charlie	762	+	88	102601239	72306
chr5	57285825	57485825	harbor1	chr5	57316741	57316965	DNA/hAT-Charlie	998	+	112	57316853	31028
chr5	57285825	57485825	harbor1	chr5	57345110	57345309	DNA/hAT-Charlie	589	+	100	57345210	59385
chr5	57285825	57485825	harbor1	chr5	57373973	57374263	DNA/hAT-Charlie	1260	+	145	57374118	88293
chr5	17419368	17619368	harbor1	chr5	17419416	17419579	DNA/hAT-Charlie	747	+	82	17419498	130
chr5	9885825	10085825	harbor1	chr5	9890968	9891108	DNA/hAT-Charlie	440	+	70	9891038	5213
chr5	9885825	10085825	harbor1	chr5	9891102	9891486	DNA/hAT-Charlie	1439	+	192	9891294	5469
chr5	9885825	10085825	harbor1	chr5	9938565	9938785	DNA/hAT-Charlie	1261	+	110	9938675	52850
chr5	9885825	10085825	harbor1	chr5	9983125	9983336	DNA/hAT-Charlie	1084	+	106	9983231	97406
chr5	151998542	152198542	harbor1	chr5	152000217	152000423	DNA/hAT-Charlie	921	+	103	152000320	1778
chr5	151998542	152198542	harbor1	chr5	152018018	152018188	DNA/hAT-Charlie	461	+	85	152018103	19561
chr5	151998542	152198542	harbor1	chr5	152018504	152018739	DNA/hAT-Charlie	461	+	118	152018622	20080
chr5	151998542	152198542	harbor1	chr5	152057165	152057324	DNA/hAT-Charlie	746	+	80	152057245	58703
chr5	151998542	152198542	harbor1	chr5	152073300	152073517	DNA/hAT-Charlie	544	+	108	152073408	74866
chr5	149108535	149308535	harbor1	chr5	149132088	149132292	DNA/hAT-Charlie	1030	+	102	149132190	23655
chr5	149108535	149308535	harbor1	chr5	149152003	149152266	DNA/hAT-Charlie	415	+	132	149152135	43600
chr5	149108535	149308535	harbor1	chr5	149164468	149164633	DNA/hAT-Charlie	761	+	82	149164550	56015
chr5	149108535	149308535	harbor1	chr5	149167109	149167321	DNA/hAT-Charlie	1007	+	106	149167215	58680
chr5	149108535	149308535	harbor1	chr5	149167319	149167455	DNA/hAT-Charlie	644	+	68	149167387	58852
chr5	149108535	149308535	harbor1	chr5	149171928	149172087	DNA/hAT-Charlie	826	+	80	149172008	63473
chr5	149108535	149308535	harbor1	chr5	149172141	149172411	DNA/hAT-Charlie	483	+	135	149172276	63741
chr5	159930021	160130021	harbor1	chr5	159936079	159936286	DNA/hAT-Charlie	1135	+	104	159936183	6162
chr5	159930021	160130021	harbor1	chr5	159936937	159937122	DNA/hAT-Charlie	808	+	92	159937029	7008
chr5	159930021	160130021	harbor1	chr5	159964210	159964553	DNA/hAT-Charlie	1015	+	172	159964382	34361
chr5	159930021	160130021	harbor1	chr5	159993064	159993158	DNA/hAT-Charlie	569	+	47	159993111	63090
chr5	159930021	160130021	harbor1	chr5	159993615	159993656	DNA/hAT-Charlie	569	+	20	159993635	63614
chr5	159930021	160130021	harbor1	chr5	159993815	159994123	DNA/hAT-Charlie	599	+	154	159993969	63948
chr5	159930021	160130021	harbor1	chr5	159997651	159997720	DNA/hAT-Charlie	1624	+	34	159997685	67664
chr5	159930021	160130021	harbor1	chr5	159998017	159998454	DNA/hAT-Charlie	1624	+	218	159998235	68214
chr5	159930021	160130021	harbor1	chr5	160001187	160001333	DNA/hAT-Charlie	714	+	73	160001260	71239
chr5	159930021	160130021	harbor1	chr5	160003638	160003764	DNA/hAT-Charlie	767	+	63	160003701	73680
chr5	159930021	160130021	harbor1	chr5	160003762	160003967	DNA/hAT-Charlie	1240	+	102	160003864	73843
chr5	159930021	160130021	harbor1	chr5	160004273	160004428	DNA/hAT-Charlie	1240	+	78	160004351	74330
chr5	159930021	160130021	harbor1	chr5	160004733	160004744	DNA/hAT-Charlie	1240	+	6	160004739	74718
chr5	159930021	160130021	harbor1	chr5	160009551	160009733	DNA/hAT-Charlie	424	+	91	160009642	79621
chr5	159930021	160130021	harbor1	chr5	160013921	160014077	DNA/hAT-Charlie	821	+	78	160013999	83978
chr5	159930021	160130021	harbor1	chr5	160014707	160014764	DNA/hAT-Charlie	821	+	28	160014735	84714
chr5	159930021	160130021	harbor1	chr5	160020462	160020986	DNA/hAT-Charlie	3559	+	262	160020724	90703
chr5	71117468	71317468	harbor1	chr5	71141888	71142083	DNA/hAT-Charlie	861	+	98	71141986	24518
chr5	120292448	120492448	harbor1	chr5	120388941	120389059	DNA/hAT-Charlie	759	+	59	120389000	96552
chr5	120292448	120492448	harbor1	chr5	120389346	120389776	DNA/hAT-Charlie	759	+	215	120389561	97113
chr5	38370025	38570025	harbor1	chr5	38384830	38385054	DNA/hAT-Charlie	1310	+	112	38384942	14917
chr5	38370025	38570025	harbor1	chr5	38451636	38451708	DNA/hAT-Charlie	685	+	36	38451672	81647
chr5	38370025	38570025	harbor1	chr5	38452012	38452036	DNA/hAT-Charlie	685	+	12	38452024	81999
chr5	38370025	38570025	harbor1	chr5	38452331	38452444	DNA/hAT-Charlie	685	+	56	38452387	82362
chr5	38370025	38570025	harbor1	chr5	38453029	38453210	DNA/hAT-Charlie	969	+	90	38453119	83094
chr5	60923588	61123588	harbor1	chr5	60926256	60926429	DNA/hAT-Charlie	683	+	86	60926342	2754
chr5	60923588	61123588	harbor1	chr5	61009183	61009442	DNA/hAT-Charlie	491	+	130	61009313	85725
chr5	72258098	72458098	harbor1	chr5	72272131	72272225	DNA/hAT-Charlie	440	+	47	72272178	14080
chr5	72258098	72458098	harbor1	chr5	72272760	72272857	DNA/hAT-Charlie	458	+	48	72272808	14710
chr5	72258098	72458098	harbor1	chr5	72286955	72287280	DNA/hAT-Charlie	2101	+	162	72287117	29019
chr5	72258098	72458098	harbor1	chr5	72309864	72310008	DNA/hAT-Charlie	475	+	72	72309936	51838
chr5	72258098	72458098	harbor1	chr5	72312228	72312621	DNA/hAT-Charlie	1124	+	196	72312424	54326
chr5	72258098	72458098	harbor1	chr5	72312918	72313022	DNA/hAT-Charlie	1124	+	52	72312970	54872
chr5	72258098	72458098	harbor1	chr5	72332805	72333040	DNA/hAT-Charlie	669	+	118	72332923	74825
chr5	119672351	119872351	harbor1	chr5	119747746	119747838	DNA/hAT-Charlie	492	+	46	119747792	75441
chr5	35245409	35445409	harbor1	chr5	35245355	35245489	DNA/hAT-Charlie	441	+	67	35245422	13
chr5	35245409	35445409	harbor1	chr5	35264362	35264542	DNA/hAT-Charlie	874	+	90	35264452	19043
chr5	26799773	26999773	harbor1	chr5	26834772	26835094	DNA/hAT-Charlie	1931	+	161	26834933	35160
chr5	26799773	26999773	harbor1	chr5	26883410	26883610	DNA/hAT-Charlie	528	+	100	26883510	83737
chr5	175848152	176048152	harbor1	chr5	175852916	175853295	DNA/hAT-Charlie	767	+	190	175853106	4954
chr5	175848152	176048152	harbor1	chr5	175921596	175921808	DNA/hAT-Charlie	557	+	106	175921702	73550
chr5	161747911	161947911	harbor1	chr5	161776513	161777435	DNA/hAT-Charlie	761	+	461	161776974	29063
chr5	161747911	161947911	harbor1	chr5	161775449	161776252	DNA/hAT-Charlie	2036	+	402	161775851	27940
chr5	169152805	169352805	harbor1	chr5	169162194	169162351	DNA/hAT-Charlie	549	+	78	169162272	9467
chr5	169152805	169352805	harbor1	chr5	169184761	169184903	DNA/hAT-Charlie	696	+	71	169184832	32027
chr5	169152805	169352805	harbor1	chr5	169218383	169218548	DNA/hAT-Charlie	585	+	82	169218465	65660
chr5	166911735	167111735	harbor1	chr5	166940463	166940685	DNA/hAT-Charlie	1173	+	111	166940574	28839
chr5	166911735	167111735	harbor1	chr5	166959385	166959540	DNA/hAT-Charlie	557	+	78	166959463	47728
chr5	166911735	167111735	harbor1	chr5	166996394	166996585	DNA/hAT-Charlie	553	+	96	166996490	84755
chr5	39583943	39783943	harbor1	chr5	39600241	39600418	DNA/hAT-Charlie	440	+	88	39600329	16386
chr5	39583943	39783943	harbor1	chr5	39608351	39608474	DNA/hAT-Charlie	566	+	62	39608413	24470
chr5	39583943	39783943	harbor1	chr5	39608741	39608802	DNA/hAT-Charlie	566	+	30	39608771	24828
chr5	39583943	39783943	harbor1	chr5	39662580	39662780	DNA/hAT-Charlie	982	+	100	39662680	78737
chr5	116615102	116815102	harbor1	chr5	116635767	116636123	DNA/hAT-Charlie	2692	+	178	116635945	20843
chr5	116615102	116815102	harbor1	chr5	116682464	116682633	DNA/hAT-Charlie	516	+	84	116682548	67446
chr5	32621055	32821055	harbor1	chr5	32644044	32644248	DNA/hAT-Charlie	1811	+	102	32644146	23091
chr5	32621055	32821055	harbor1	chr5	32644560	32644992	DNA/hAT-Charlie	1811	+	216	32644776	23721
chr5	149838695	150038695	harbor1	chr5	149860538	149860762	DNA/hAT-Charlie	1659	+	112	149860650	21955
chr5	149838695	150038695	harbor1	chr5	149875154	149875333	DNA/hAT-Charlie	686	+	90	149875244	36549
chr5	149838695	150038695	harbor1	chr5	149916890	149917038	DNA/hAT-Charlie	558	+	74	149916964	78269
chr5	62575511	62775511	harbor1	chr5	62587487	62587664	DNA/hAT-Charlie	505	+	88	62587575	12064
chr5	62575511	62775511	harbor1	chr5	62599064	62599207	DNA/hAT-Charlie	671	+	72	62599136	23625
chr5	62575511	62775511	harbor1	chr5	62612179	62612804	DNA/hAT-Charlie	2721	+	312	62612491	36980
chr5	62575511	62775511	harbor1	chr5	62614365	62614501	DNA/hAT-Charlie	486	+	68	62614433	38922
chr5	62575511	62775511	harbor1	chr5	62615262	62615330	DNA/hAT-Charlie	486	+	34	62615296	39785
chr5	62575511	62775511	harbor1	chr5	62622190	62622356	DNA/hAT-Charlie	687	+	83	62622273	46762
chr5	62575511	62775511	harbor1	chr5	62635632	62635951	DNA/hAT-Charlie	2131	+	160	62635792	60281
chr5	62575511	62775511	harbor1	chr5	62642691	62642863	DNA/hAT-Charlie	663	+	86	62642777	67266
chr5	62575511	62775511	harbor1	chr5	62662957	62663219	DNA/hAT-Charlie	1365	+	131	62663088	87577
chr5	62575511	62775511	harbor1	chr5	62663532	62663580	DNA/hAT-Charlie	1365	+	24	62663556	88045
chr5	62575511	62775511	harbor1	chr5	62664546	62664560	DNA/hAT-Charlie	1365	+	7	62664553	89042
chr5	171929045	172129045	harbor1	chr5	171952772	171952981	DNA/hAT-Charlie	1397	+	104	171952876	23831
chr5	171929045	172129045	harbor1	chr5	171986826	171987190	DNA/hAT-Charlie	1793	+	182	171987008	57963
chr5	171929045	172129045	harbor1	chr5	172009162	172009487	DNA/hAT-Charlie	769	+	162	172009324	80279
chr5	171929045	172129045	harbor1	chr5	172012834	172012925	DNA/hAT-Charlie	598	+	46	172012880	83835
chr5	171929045	172129045	harbor1	chr5	172013611	172013654	DNA/hAT-Charlie	598	+	22	172013633	84588
chr5	171929045	172129045	harbor1	chr5	172013953	172014128	DNA/hAT-Charlie	598	+	88	172014041	84996
chr5	171929045	172129045	harbor1	chr5	172014548	172014793	DNA/hAT-Charlie	777	+	122	172014670	85625
chr5	171929045	172129045	harbor1	chr5	172016039	172016152	DNA/hAT-Charlie	1959	+	56	172016095	87050
chr5	171929045	172129045	harbor1	chr5	172016458	172016661	DNA/hAT-Charlie	1959	+	102	172016560	87515
chr5	171929045	172129045	harbor1	chr5	172017062	172017181	DNA/hAT-Charlie	1959	+	60	172017122	88077
chr5	171929045	172129045	harbor1	chr5	172017494	172017701	DNA/hAT-Charlie	1959	+	104	172017598	88553
chr5	171929045	172129045	harbor1	chr5	172017949	172018054	DNA/hAT-Charlie	1959	+	52	172018001	88956
chr5	171929045	172129045	harbor1	chr5	172018202	172018469	DNA/hAT-Charlie	700	+	134	172018336	89291
chr5	40293280	40493280	harbor1	chr5	40386653	40386960	DNA/hAT-Charlie	1342	+	154	40386807	93527
chr5	40293280	40493280	harbor1	chr5	40386991	40387192	DNA/hAT-Charlie	955	+	100	40387091	93811
chr5	40293280	40493280	harbor1	chr5	40389331	40389470	DNA/hAT-Charlie	548	+	70	40389401	96121
chr5	40293280	40493280	harbor1	chr5	40386458	40386643	DNA/hAT-Charlie	834	+	92	40386550	93270
chr5	114009195	114209195	harbor1	chr5	114014913	114015036	DNA/hAT-Charlie	448	+	62	114014975	5780
chr5	114009195	114209195	harbor1	chr5	114015068	114015202	DNA/hAT-Charlie	4367	+	67	114015135	5940
chr5	114009195	114209195	harbor1	chr5	114098336	114098682	DNA/hAT-Charlie	1977	+	173	114098509	89314
chr5	114009195	114209195	harbor1	chr5	114015562	114016603	DNA/hAT-Charlie	4367	+	520	114016082	6887
chr6	7574554	7774554	harbor1	chr6	7634408	7634547	DNA/hAT-Charlie	441	+	70	7634478	59924
chr6	7574554	7774554	harbor1	chr6	7651827	7652000	DNA/hAT-Charlie	460	+	86	7651913	77359
chr6	164486733	164686733	harbor1	chr6	164540469	164540988	DNA/hAT-Charlie	3549	+	260	164540729	53996
chr6	20161315	20361315	harbor1	chr6	20160975	20161507	DNA/hAT-Charlie	4075	+	266	20161241	74
chr6	20161315	20361315	harbor1	chr6	20207501	20207663	DNA/hAT-Charlie	795	+	81	20207582	46267
chr6	20161315	20361315	harbor1	chr6	20223110	20223811	DNA/hAT-Charlie	2210	+	350	20223460	62145
chr6	20161315	20361315	harbor1	chr6	20223920	20224397	DNA/hAT-Charlie	1919	+	238	20224158	62843
chr6	20161315	20361315	harbor1	chr6	20224684	20224853	DNA/hAT-Charlie	1919	+	84	20224768	63453
chr6	20161315	20361315	harbor1	chr6	20237414	20237524	DNA/hAT-Charlie	462	+	55	20237469	76154
chr6	128283216	128483216	harbor1	chr6	128290384	128290586	DNA/hAT-Charlie	541	+	101	128290485	7269
chr6	125801913	126001913	harbor1	chr6	125806757	125806971	DNA/hAT-Charlie	571	+	107	125806864	4951
chr6	125801913	126001913	harbor1	chr6	125821057	125821216	DNA/hAT-Charlie	463	+	80	125821137	19224
chr6	125801913	126001913	harbor1	chr6	125887259	125887411	DNA/hAT-Charlie	474	+	76	125887335	85422
chr6	126482795	126682795	harbor1	chr6	126538189	126539113	DNA/hAT-Charlie	2282	+	462	126538651	55856
chr6	126482795	126682795	harbor1	chr6	126549804	126549894	DNA/hAT-Charlie	474	+	45	126549849	67054
chr6	126482795	126682795	harbor1	chr6	126556647	126556821	DNA/hAT-Charlie	1048	+	87	126556734	73939
chr6	126482795	126682795	harbor1	chr6	126571097	126571261	DNA/hAT-Charlie	574	+	82	126571179	88384
chr6	70708947	70908947	harbor1	chr6	70729859	70730023	DNA/hAT-Charlie	589	+	82	70729941	20994
chr6	70708947	70908947	harbor1	chr6	70762212	70762426	DNA/hAT-Charlie	923	+	107	70762319	53372
chr6	70708947	70908947	harbor1	chr6	70772415	70772551	DNA/hAT-Charlie	546	+	68	70772483	63536
chr6	70708947	70908947	harbor1	chr6	70779753	70780122	DNA/hAT-Charlie	2597	+	184	70779937	70990
chr6	109606384	109806384	harbor1	chr6	109625432	109625752	DNA/hAT-Charlie	2033	+	160	109625592	19208
chr6	109606384	109806384	harbor1	chr6	109658484	109658706	DNA/hAT-Charlie	895	+	111	109658595	52211
chr6	109606384	109806384	harbor1	chr6	109658704	109658799	DNA/hAT-Charlie	429	+	48	109658752	52368
chr6	109606384	109806384	harbor1	chr6	109663367	109664284	DNA/hAT-Charlie	4532	+	458	109663825	57441
chr6	147275233	147475233	harbor1	chr6	147291910	147292091	DNA/hAT-Charlie	953	+	90	147292000	16767
chr6	147275233	147475233	harbor1	chr6	147294718	147294928	DNA/hAT-Charlie	572	+	105	147294823	19590
chr6	147275233	147475233	harbor1	chr6	147305079	147305306	DNA/hAT-Charlie	449	+	114	147305193	29960
chr6	147275233	147475233	harbor1	chr6	147312428	147312669	DNA/hAT-Charlie	748	+	120	147312548	37315
chr6	147275233	147475233	harbor1	chr6	147317413	147317618	DNA/hAT-Charlie	926	+	102	147317515	42282
chr6	147275233	147475233	harbor1	chr6	147330826	147331035	DNA/hAT-Charlie	822	+	104	147330930	55697
chr6	147275233	147475233	harbor1	chr6	147351124	147351284	DNA/hAT-Charlie	796	+	80	147351204	75971
chr6	63488918	63688918	harbor1	chr6	63523655	63523840	DNA/hAT-Charlie	1155	+	92	63523747	34829
chr6	63488918	63688918	harbor1	chr6	63537218	63537375	DNA/hAT-Charlie	727	+	78	63537296	48378
chr6	33260055	33460055	harbor1	chr6	33267451	33267610	DNA/hAT-Charlie	561	+	80	33267531	7476
chr6	33260055	33460055	harbor1	chr6	33284644	33285000	DNA/hAT-Charlie	1464	+	178	33284822	24767
chr6	33260055	33460055	harbor1	chr6	33285007	33285199	DNA/hAT-Charlie	1259	+	96	33285103	25048
chr6	33260055	33460055	harbor1	chr6	33285824	33285858	DNA/hAT-Charlie	1259	+	17	33285841	25786
chr6	33260055	33460055	harbor1	chr6	33286457	33286582	DNA/hAT-Charlie	1259	+	62	33286519	26464
chr6	33260055	33460055	harbor1	chr6	33300275	33300380	DNA/hAT-Charlie	595	+	52	33300327	40272
chr6	33260055	33460055	harbor1	chr6	33300984	33301112	DNA/hAT-Charlie	595	+	64	33301048	40993
chr6	33260055	33460055	harbor1	chr6	33301097	33301230	DNA/hAT-Charlie	626	+	66	33301163	41108
chr6	33260055	33460055	harbor1	chr6	33301989	33302133	DNA/hAT-Charlie	635	+	72	33302061	42006
chr6	33260055	33460055	harbor1	chr6	33303604	33303729	DNA/hAT-Charlie	622	+	62	33303666	43611
chr6	33260055	33460055	harbor1	chr6	33325900	33326163	DNA/hAT-Charlie	568	+	132	33326032	65977
chr6	33260055	33460055	harbor1	chr6	33326476	33326540	DNA/hAT-Charlie	568	+	32	33326508	66453
chr6	33260055	33460055	harbor1	chr6	33328118	33328162	DNA/hAT-Charlie	443	+	22	33328140	68085
chr6	33260055	33460055	harbor1	chr6	33328490	33328602	DNA/hAT-Charlie	443	+	56	33328546	68491
chr6	33260055	33460055	harbor1	chr6	33308626	33308847	DNA/hAT-Charlie	1537	+	110	33308736	48681
chr6	43090959	43290959	harbor1	chr6	43118116	43118254	DNA/hAT-Charlie	854	+	69	43118185	27226
chr6	43090959	43290959	harbor1	chr6	43118556	43118601	DNA/hAT-Charlie	854	+	22	43118578	27619
chr6	43090959	43290959	harbor1	chr6	43152620	43152725	DNA/hAT-Charlie	558	+	52	43152672	61713
chr6	43090959	43290959	harbor1	chr6	43153084	43153100	DNA/hAT-Charlie	558	+	8	43153092	62133
chr6	43090959	43290959	harbor1	chr6	43159161	43159566	DNA/hAT-Charlie	576	+	202	43159363	68404
chr6	43090959	43290959	harbor1	chr6	43177119	43177228	DNA/hAT-Charlie	855	+	54	43177173	86214
chr6	43090959	43290959	harbor1	chr6	43177530	43177587	DNA/hAT-Charlie	855	+	28	43177558	86599
chr6	43090959	43290959	harbor1	chr6	43185146	43185369	DNA/hAT-Charlie	641	+	112	43185258	94299
chr6	92262488	92462488	harbor1	chr6	92297309	92297473	DNA/hAT-Charlie	685	+	82	92297391	34903
chr6	92262488	92462488	harbor1	chr6	92362062	92362357	DNA/hAT-Charlie	1413	+	148	92362210	99722
chr6	159931637	160131637	harbor1	chr6	159957090	159957305	DNA/hAT-Charlie	1063	+	108	159957198	25561
chr6	159931637	160131637	harbor1	chr6	159965568	159965840	DNA/hAT-Charlie	1161	+	136	159965704	34067
chr6	159931637	160131637	harbor1	chr6	160001064	160001594	DNA/hAT-Charlie	3774	+	265	160001329	69692
chr6	159931637	160131637	harbor1	chr6	160013244	160013417	DNA/hAT-Charlie	541	+	86	160013330	81693
chr6	150161979	150361979	harbor1	chr6	150210602	150210919	DNA/hAT-Charlie	660	+	158	150210760	48781
chr6	150161979	150361979	harbor1	chr6	150212151	150212343	DNA/hAT-Charlie	884	+	96	150212247	50268
chr6	150161979	150361979	harbor1	chr6	150244540	150244736	DNA/hAT-Charlie	1126	+	98	150244638	82659
chr6	150161979	150361979	harbor1	chr6	150247270	150247462	DNA/hAT-Charlie	476	+	96	150247366	85387
chr6	150161979	150361979	harbor1	chr6	150247471	150247597	DNA/hAT-Charlie	464	+	63	150247534	85555
chr6	150161979	150361979	harbor1	chr6	150247735	150247882	DNA/hAT-Charlie	784	+	74	150247809	85830
chr6	150161979	150361979	harbor1	chr6	150248257	150248293	DNA/hAT-Charlie	784	+	18	150248275	86296
chr6	150161979	150361979	harbor1	chr6	150248308	150248450	DNA/hAT-Charlie	513	+	71	150248379	86400
chr6	4441046	4641046	harbor1	chr6	4445930	4446490	DNA/hAT-Charlie	1250	+	280	4446210	5164
chr6	4441046	4641046	harbor1	chr6	4449576	4449681	DNA/hAT-Charlie	448	+	52	4449628	8582
chr6	4441046	4641046	harbor1	chr6	4458032	4458207	DNA/hAT-Charlie	480	+	88	4458120	17074
chr6	4441046	4641046	harbor1	chr6	4458242	4458517	DNA/hAT-Charlie	848	+	138	4458380	17334
chr6	4441046	4641046	harbor1	chr6	4477037	4477204	DNA/hAT-Charlie	689	+	84	4477121	36075
chr6	4441046	4641046	harbor1	chr6	4500940	4500964	DNA/hAT-Charlie	420	+	12	4500952	59906
chr6	4441046	4641046	harbor1	chr6	4502443	4502602	DNA/hAT-Charlie	420	+	80	4502523	61477
chr6	4441046	4641046	harbor1	chr6	4503939	4504103	DNA/hAT-Charlie	911	+	82	4504021	62975
chr6	4441046	4641046	harbor1	chr6	4504934	4505151	DNA/hAT-Charlie	1136	+	108	4505042	63996
chr6	121853841	122053841	harbor1	chr6	121857621	121858136	DNA/hAT-Charlie	3448	+	258	121857879	4038
chr6	121853841	122053841	harbor1	chr6	121879203	121879535	DNA/hAT-Charlie	1494	+	166	121879369	25528
chr6	67977629	68177629	harbor1	chr6	68037692	68037893	DNA/hAT-Charlie	718	+	100	68037792	60163
chr6	36532897	36732897	harbor1	chr6	36556012	36556142	DNA/hAT-Charlie	471	+	65	36556077	23180
chr6	36532897	36732897	harbor1	chr6	36566894	36567095	DNA/hAT-Charlie	633	+	100	36566994	34097
chr6	36532897	36732897	harbor1	chr6	36567399	36567449	DNA/hAT-Charlie	633	+	25	36567424	34527
chr6	36532897	36732897	harbor1	chr6	36567723	36567775	DNA/hAT-Charlie	633	+	26	36567749	34852
chr6	36532897	36732897	harbor1	chr6	36632634	36632797	DNA/hAT-Charlie	767	+	82	36632716	99819
chr6	25776004	25976004	harbor1	chr6	25793706	25793881	DNA/hAT-Charlie	804	+	88	25793794	17790
chr6	86122732	86322732	harbor1	chr6	86128029	86128251	DNA/hAT-Charlie	867	+	111	86128140	5408
chr6	86122732	86322732	harbor1	chr6	86154388	86154599	DNA/hAT-Charlie	708	+	106	86154494	31762
chr6	86122732	86322732	harbor1	chr6	86159223	86159371	DNA/hAT-Charlie	819	+	74	86159297	36565
chr6	26316125	26516125	harbor1	chr6	26319887	26319988	DNA/hAT-Charlie	569	+	50	26319937	3812
chr6	26316125	26516125	harbor1	chr6	26323092	26323290	DNA/hAT-Charlie	443	+	99	26323191	7066
chr6	26316125	26516125	harbor1	chr6	26338501	26338762	DNA/hAT-Charlie	1100	+	130	26338631	22506
chr6	116620103	116820103	harbor1	chr6	116655846	116656068	DNA/hAT-Charlie	1311	+	111	116655957	35854
chr6	116620103	116820103	harbor1	chr6	116656384	116656457	DNA/hAT-Charlie	1311	+	36	116656420	36317
chr6	116620103	116820103	harbor1	chr6	116683067	116683329	DNA/hAT-Charlie	582	+	131	116683198	63095
chr6	116620103	116820103	harbor1	chr6	116700650	116700781	DNA/hAT-Charlie	440	+	66	116700716	80613
chr6	116620103	116820103	harbor1	chr6	116707452	116707637	DNA/hAT-Charlie	870	+	92	116707544	87441
chr6	112084800	112284800	harbor1	chr6	112084957	112085153	DNA/hAT-Charlie	770	+	98	112085055	255
chr6	112084800	112284800	harbor1	chr6	112097911	112098143	DNA/hAT-Charlie	1060	+	116	112098027	13227
chr6	112084800	112284800	harbor1	chr6	112137265	112137657	DNA/hAT-Charlie	855	+	196	112137461	52661
chr6	112084800	112284800	harbor1	chr6	112137665	112138735	DNA/hAT-Charlie	2503	+	535	112138200	53400
chr6	112084800	112284800	harbor1	chr6	112146387	112146570	DNA/hAT-Charlie	1032	+	92	112146479	61679
chr6	112084800	112284800	harbor1	chr6	112164867	112165019	DNA/hAT-Charlie	774	+	76	112164943	80143
chr6	118740268	118940268	harbor1	chr6	118804986	118805137	DNA/hAT-Charlie	798	+	76	118805062	64794
chr6	22726312	22926312	harbor1	chr6	22734354	22734458	DNA/hAT-Charlie	488	+	52	22734406	8094
chr6	22726312	22926312	harbor1	chr6	22738844	22739068	DNA/hAT-Charlie	527	+	112	22738956	12644
chr6	22726312	22926312	harbor1	chr6	22753800	22753812	DNA/hAT-Charlie	688	+	6	22753806	27494
chr6	22726312	22926312	harbor1	chr6	22754305	22754503	DNA/hAT-Charlie	688	+	99	22754404	28092
chr6	22726312	22926312	harbor1	chr6	22755910	22756095	DNA/hAT-Charlie	821	+	92	22756002	29690
chr6	22726312	22926312	harbor1	chr6	22822385	22822596	DNA/hAT-Charlie	828	+	106	22822491	96179
chr6	126195301	126395301	harbor1	chr6	126196114	126196393	DNA/hAT-Charlie	812	+	140	126196254	953
chr6	126195301	126395301	harbor1	chr6	126196414	126196977	DNA/hAT-Charlie	1050	+	282	126196696	1395
chr6	126195301	126395301	harbor1	chr6	126293227	126294498	DNA/hAT-Charlie	5085	+	636	126293863	98562
chr6	126195301	126395301	harbor1	chr6	126294536	126295055	DNA/hAT-Charlie	2222	+	260	126294796	99495
chr6	64986850	65186850	harbor1	chr6	65079242	65079369	DNA/hAT-Charlie	492	+	64	65079306	92456
chr6	64986850	65186850	harbor1	chr6	65079353	65079578	DNA/hAT-Charlie	682	+	112	65079465	92615
chr6	18038607	18238607	harbor1	chr6	18062616	18062845	DNA/hAT-Charlie	1102	+	114	18062730	24123
chr6	18038607	18238607	harbor1	chr6	18065357	18065711	DNA/hAT-Charlie	2445	+	177	18065534	26927
chr6	18038607	18238607	harbor1	chr6	18088325	18088427	DNA/hAT-Charlie	579	+	51	18088376	49769
chr6	18038607	18238607	harbor1	chr6	18088562	18088648	DNA/hAT-Charlie	579	+	43	18088605	49998
chr6	18038607	18238607	harbor1	chr6	18094895	18094961	DNA/hAT-Charlie	574	+	33	18094928	56321
chr6	18038607	18238607	harbor1	chr6	18095275	18095389	DNA/hAT-Charlie	574	+	57	18095332	56725
chr6	70313575	70513575	harbor1	chr6	70350072	70350270	DNA/hAT-Charlie	897	+	99	70350171	36596
chr6	57063399	57263399	harbor1	chr6	57127903	57128083	DNA/hAT-Charlie	825	+	90	57127993	64594
chr6	57063399	57263399	harbor1	chr6	57159425	57159656	DNA/hAT-Charlie	1413	+	116	57159541	96142
chr6	57063399	57263399	harbor1	chr6	57161344	57161545	DNA/hAT-Charlie	576	+	100	57161444	98045
chr6	83689592	83889592	harbor1	chr6	83693895	83694044	DNA/hAT-Charlie	465	+	74	83693969	4377
chr6	83689592	83889592	harbor1	chr6	83712238	83712368	DNA/hAT-Charlie	460	+	65	83712303	22711
chr6	12391601	12591601	harbor1	chr6	12412534	12412720	DNA/hAT-Charlie	938	+	93	12412627	21026
chr6	12391601	12591601	harbor1	chr6	12420872	12420987	DNA/hAT-Charlie	467	+	58	12420930	29329
chr6	12391601	12591601	harbor1	chr6	12422594	12422771	DNA/hAT-Charlie	786	+	88	12422682	31081
chr6	12391601	12591601	harbor1	chr6	12427849	12428011	DNA/hAT-Charlie	824	+	81	12427930	36329
chr6	107500963	107700963	harbor1	chr6	107507247	107507308	DNA/hAT-Charlie	1022	+	30	107507277	6314
chr6	107500963	107700963	harbor1	chr6	107507606	107507726	DNA/hAT-Charlie	1022	+	60	107507666	6703
chr6	107500963	107700963	harbor1	chr6	107519166	107519372	DNA/hAT-Charlie	1119	+	103	107519269	18306
chr6	39730097	39930097	harbor1	chr6	39734749	39735082	DNA/hAT-Charlie	613	+	166	39734915	4818
chr6	39730097	39930097	harbor1	chr6	39785885	39786148	DNA/hAT-Charlie	525	+	132	39786017	55920
chr6	39730097	39930097	harbor1	chr6	39797507	39797678	DNA/hAT-Charlie	801	+	86	39797593	67496
chr6	39730097	39930097	harbor1	chr6	39797915	39798108	DNA/hAT-Charlie	1097	+	96	39798011	67914
chr6	39730097	39930097	harbor1	chr6	39814043	39814303	DNA/hAT-Charlie	1499	+	130	39814173	84076
chr6	39730097	39930097	harbor1	chr6	39815018	39815204	DNA/hAT-Charlie	872	+	93	39815111	85014
chr6	39730097	39930097	harbor1	chr6	39822941	39823097	DNA/hAT-Charlie	421	+	78	39823019	92922
chr6	83763171	83963171	harbor1	chr6	83817082	83817255	DNA/hAT-Charlie	771	+	86	83817168	53997
chr6	83763171	83963171	harbor1	chr6	83843163	83843306	DNA/hAT-Charlie	538	+	72	83843235	80064
chr6	83763171	83963171	harbor1	chr6	83843320	83843491	DNA/hAT-Charlie	554	+	86	83843406	80235
chr6	34495959	34695959	harbor1	chr6	34546098	34546278	DNA/hAT-Charlie	733	+	90	34546188	50229
chr6	34495959	34695959	harbor1	chr6	34585945	34586043	DNA/hAT-Charlie	437	+	49	34585994	90035
chr6	34127346	34327346	harbor1	chr6	34155435	34155523	DNA/hAT-Charlie	494	+	44	34155479	28133
chr6	34127346	34327346	harbor1	chr6	34155648	34155720	DNA/hAT-Charlie	494	+	36	34155684	28338
chr6	109763746	109963746	harbor1	chr6	109783691	109783845	DNA/hAT-Charlie	583	+	77	109783768	20022
chr6	109763746	109963746	harbor1	chr6	109792110	109792336	DNA/hAT-Charlie	1058	+	113	109792223	28477
chr6	109763746	109963746	harbor1	chr6	109801858	109802097	DNA/hAT-Charlie	435	+	120	109801978	38232
chr6	109763746	109963746	harbor1	chr6	109802407	109802586	DNA/hAT-Charlie	442	+	90	109802497	38751
chr6	109763746	109963746	harbor1	chr6	109808288	109809551	DNA/hAT-Charlie	4924	+	632	109808920	45174
chr6	154505258	154705258	harbor1	chr6	154531525	154531727	DNA/hAT-Charlie	941	+	101	154531626	26368
chr6	154505258	154705258	harbor1	chr6	154534865	154534962	DNA/hAT-Charlie	538	+	48	154534913	29655
chr6	154505258	154705258	harbor1	chr6	154535188	154535688	DNA/hAT-Charlie	2230	+	250	154535438	30180
chr6	154505258	154705258	harbor1	chr6	154544503	154544674	DNA/hAT-Charlie	612	+	86	154544589	39331
chr6	154505258	154705258	harbor1	chr6	154580081	154580356	DNA/hAT-Charlie	1257	+	138	154580219	74961
chr6	154505258	154705258	harbor1	chr6	154582857	154583017	DNA/hAT-Charlie	433	+	80	154582937	77679
chr6	94080583	94280583	harbor1	chr6	94101959	94102050	DNA/hAT-Charlie	452	+	46	94102005	21422
chr6	94080583	94280583	harbor1	chr6	94102339	94102382	DNA/hAT-Charlie	452	+	22	94102361	21778
chr6	51569033	51769033	harbor1	chr6	51627312	51627493	DNA/hAT-Charlie	675	+	90	51627402	58369
chr6	51569033	51769033	harbor1	chr6	51629683	51630641	DNA/hAT-Charlie	3793	+	479	51630162	61129
chr6	149647378	149847378	harbor1	chr6	149660074	149660225	DNA/hAT-Charlie	561	+	76	149660150	12772
chr6	149647378	149847378	harbor1	chr6	149690022	149690200	DNA/hAT-Charlie	590	+	89	149690111	42733
chr6	149647378	149847378	harbor1	chr6	149690513	149690547	DNA/hAT-Charlie	590	+	17	149690530	43152
chr6	149647378	149847378	harbor1	chr6	149690829	149690945	DNA/hAT-Charlie	590	+	58	149690887	43509
chr6	71201362	71401362	harbor1	chr6	71259048	71259287	DNA/hAT-Charlie	572	+	120	71259168	57806
chr6	71201362	71401362	harbor1	chr6	71264054	71264269	DNA/hAT-Charlie	501	+	108	71264162	62800
chr6	62572607	62772607	harbor1	chr6	62591756	62591957	DNA/hAT-Charlie	630	+	100	62591856	19249
chr6	62572607	62772607	harbor1	chr6	62635605	62635808	DNA/hAT-Charlie	917	+	102	62635707	63100
chr6	62572607	62772607	harbor1	chr6	62636162	62636310	DNA/hAT-Charlie	579	+	74	62636236	63629
chr6	62572607	62772607	harbor1	chr6	62657910	62658122	DNA/hAT-Charlie	827	+	106	62658016	85409
chr6	17125487	17325487	harbor1	chr6	17131917	17132038	DNA/hAT-Charlie	853	+	60	17131977	6490
chr6	17125487	17325487	harbor1	chr6	17132033	17132500	DNA/hAT-Charlie	3352	+	234	17132267	6780
chr6	17125487	17325487	harbor1	chr6	17146455	17146982	DNA/hAT-Charlie	1114	+	264	17146719	21232
chr6	17125487	17325487	harbor1	chr6	17148299	17148446	DNA/hAT-Charlie	751	+	74	17148373	22886
chr6	17125487	17325487	harbor1	chr6	17148742	17148774	DNA/hAT-Charlie	751	+	16	17148758	23271
chr6	17125487	17325487	harbor1	chr6	17161220	17161397	DNA/hAT-Charlie	776	+	88	17161308	35821
chr6	17125487	17325487	harbor1	chr6	17167618	17167777	DNA/hAT-Charlie	708	+	80	17167698	42211
chr6	17125487	17325487	harbor1	chr6	17214669	17214898	DNA/hAT-Charlie	1179	+	114	17214783	89296
chr6	46871561	47071561	harbor1	chr6	46874817	46875023	DNA/hAT-Charlie	1252	+	103	46874920	3359
chr6	46871561	47071561	harbor1	chr6	46880245	46880553	DNA/hAT-Charlie	608	+	154	46880399	8838
chr6	46871561	47071561	harbor1	chr6	46941507	46941636	DNA/hAT-Charlie	600	+	64	46941571	70010
chr6	23922124	24122124	harbor1	chr6	23935742	23935890	DNA/hAT-Charlie	503	+	74	23935816	13692
chr6	23922124	24122124	harbor1	chr6	23985816	23985932	DNA/hAT-Charlie	429	+	58	23985874	63750
chr6	23922124	24122124	harbor1	chr6	23986714	23987536	DNA/hAT-Charlie	3232	+	411	23987125	65001
chr6	23922124	24122124	harbor1	chr6	24006954	24007156	DNA/hAT-Charlie	808	+	101	24007055	84931
chr6	23922124	24122124	harbor1	chr6	24016492	24016657	DNA/hAT-Charlie	810	+	82	24016574	94450
chr6	23922124	24122124	harbor1	chr6	23986062	23986319	DNA/hAT-Charlie	3232	+	128	23986190	64066
chr6	83840575	84040575	harbor1	chr6	83843163	83843306	DNA/hAT-Charlie	538	+	72	83843235	2660
chr6	83840575	84040575	harbor1	chr6	83843320	83843491	DNA/hAT-Charlie	554	+	86	83843406	2831
chr6	83840575	84040575	harbor1	chr6	83909752	83909964	DNA/hAT-Charlie	1135	+	106	83909858	69283
chr6	154414077	154614077	harbor1	chr6	154421855	154421984	DNA/hAT-Charlie	636	+	64	154421919	7842
chr6	154414077	154614077	harbor1	chr6	154422291	154422331	DNA/hAT-Charlie	636	+	20	154422311	8234
chr6	154414077	154614077	harbor1	chr6	154447182	154447383	DNA/hAT-Charlie	957	+	100	154447282	33205
chr6	154414077	154614077	harbor1	chr6	154457975	154458180	DNA/hAT-Charlie	1059	+	102	154458077	44000
chr6	154414077	154614077	harbor1	chr6	154498304	154498615	DNA/hAT-Charlie	440	+	156	154498460	84383
chr6	150473108	150673108	harbor1	chr6	150512165	150512226	DNA/hAT-Charlie	699	+	30	150512195	39087
chr6	150473108	150673108	harbor1	chr6	150512532	150512674	DNA/hAT-Charlie	699	+	71	150512603	39495
chr6	150473108	150673108	harbor1	chr6	150532768	150532916	DNA/hAT-Charlie	633	+	74	150532842	59734
chr6	150473108	150673108	harbor1	chr6	150542248	150542434	DNA/hAT-Charlie	848	+	93	150542341	69233
chr6	77437407	77637407	harbor1	chr6	77451056	77451219	DNA/hAT-Charlie	770	+	82	77451138	13731
chr6	77437407	77637407	harbor1	chr6	77455686	77455851	DNA/hAT-Charlie	774	+	82	77455768	18361
chr6	77437407	77637407	harbor1	chr6	77492386	77492605	DNA/hAT-Charlie	730	+	110	77492496	55089
chr6	77437407	77637407	harbor1	chr6	77532011	77532219	DNA/hAT-Charlie	1042	+	104	77532115	94708
chr6	152414955	152614955	harbor1	chr6	152512969	152513143	DNA/hAT-Charlie	692	+	87	152513056	98101
chr6	50090444	50290444	harbor1	chr6	50091891	50091927	DNA/hAT-Charlie	494	+	18	50091909	1465
chr6	50090444	50290444	harbor1	chr6	50155851	50156027	DNA/hAT-Charlie	514	+	88	50155939	65495
chr6	45845126	46045126	harbor1	chr6	45858919	45859150	DNA/hAT-Charlie	649	+	116	45859035	13909
chr6	45845126	46045126	harbor1	chr6	45867120	45867253	DNA/hAT-Charlie	584	+	66	45867186	22060
chr6	45845126	46045126	harbor1	chr6	45930934	45931276	DNA/hAT-Charlie	1604	+	171	45931105	85979
chr6	45845126	46045126	harbor1	chr6	45944132	45944445	DNA/hAT-Charlie	1342	+	156	45944288	99162
chr6	158258918	158458918	harbor1	chr6	158261138	158261334	DNA/hAT-Charlie	792	+	98	158261236	2318
chr6	158258918	158458918	harbor1	chr6	158311157	158311243	DNA/hAT-Charlie	470	+	43	158311200	52282
chr6	146198027	146398027	harbor1	chr6	146269521	146269840	DNA/hAT-Charlie	1878	+	160	146269681	71654
chr6	49492327	49692327	harbor1	chr6	49544956	49545134	DNA/hAT-Charlie	446	+	89	49545045	52718
chr6	49492327	49692327	harbor1	chr6	49556053	49556211	DNA/hAT-Charlie	734	+	79	49556132	63805
chr6	49492327	49692327	harbor1	chr6	49563034	49563529	DNA/hAT-Charlie	3342	+	248	49563282	70955
chr6	49492327	49692327	harbor1	chr6	49563524	49563985	DNA/hAT-Charlie	3024	+	230	49563754	71427
chr6	17858844	18058844	harbor1	chr6	17903121	17903348	DNA/hAT-Charlie	580	+	114	17903235	44391
chr6	17858844	18058844	harbor1	chr6	17905015	17905249	DNA/hAT-Charlie	1733	+	117	17905132	46288
chr6	17858844	18058844	harbor1	chr6	17931955	17932142	DNA/hAT-Charlie	1236	+	94	17932049	73205
chr6	105342515	105542515	harbor1	chr6	105379200	105379344	DNA/hAT-Charlie	479	+	72	105379272	36757
chr6	105342515	105542515	harbor1	chr6	105379917	105380047	DNA/hAT-Charlie	496	+	65	105379982	37467
chr6	105342515	105542515	harbor1	chr6	105431099	105431200	DNA/hAT-Charlie	523	+	50	105431149	88634
chr6	62118920	62318920	harbor1	chr6	62132340	62132524	DNA/hAT-Charlie	742	+	92	62132432	13512
chr6	51541284	51741284	harbor1	chr6	51627312	51627493	DNA/hAT-Charlie	675	+	90	51627402	86118
chr6	51541284	51741284	harbor1	chr6	51629683	51630641	DNA/hAT-Charlie	3793	+	479	51630162	88878
chr6	56356147	56556147	harbor1	chr6	56428842	56429016	DNA/hAT-Charlie	806	+	87	56428929	72782
chr6	56356147	56556147	harbor1	chr6	56442032	56442187	DNA/hAT-Charlie	608	+	78	56442110	85963
chr6	56356147	56556147	harbor1	chr6	56455009	56455654	DNA/hAT-Charlie	1002	+	322	56455331	99184
chr6	37781668	37981668	harbor1	chr6	37847820	37847981	DNA/hAT-Charlie	757	+	80	37847900	66232
chr6	37781668	37981668	harbor1	chr6	37852190	37852380	DNA/hAT-Charlie	894	+	95	37852285	70617
chr6	14854122	15054122	harbor1	chr6	14887036	14887159	DNA/hAT-Charlie	690	+	62	14887098	32976
chr6	14854122	15054122	harbor1	chr6	14906777	14906954	DNA/hAT-Charlie	860	+	88	14906865	52743
chr6	14854122	15054122	harbor1	chr6	14924174	14924397	DNA/hAT-Charlie	1137	+	112	14924286	70164
chr6	14854122	15054122	harbor1	chr6	14953037	14953445	DNA/hAT-Charlie	1707	+	204	14953241	99119
chr6	153802596	154002596	harbor1	chr6	153805858	153806040	DNA/hAT-Charlie	923	+	91	153805949	3353
chr6	22547808	22747808	harbor1	chr6	22592730	22593165	DNA/hAT-Charlie	1424	+	218	22592948	45140
chr6	22547808	22747808	harbor1	chr6	22617796	22617985	DNA/hAT-Charlie	718	+	94	22617890	70082
chr6	22547808	22747808	harbor1	chr6	22626219	22626451	DNA/hAT-Charlie	1449	+	116	22626335	78527
chr6	89472274	89672274	harbor1	chr6	89513995	89514095	DNA/hAT-Charlie	1512	+	50	89514045	41771
chr6	89472274	89672274	harbor1	chr6	89514389	89514528	DNA/hAT-Charlie	1512	+	70	89514459	42185
chr6	89472274	89672274	harbor1	chr6	89538320	89538401	DNA/hAT-Charlie	524	+	40	89538360	66086
chr6	89472274	89672274	harbor1	chr6	89541850	89542134	DNA/hAT-Charlie	820	+	142	89541992	69718
chr6	89472274	89672274	harbor1	chr6	89557614	89558141	DNA/hAT-Charlie	3695	+	264	89557878	85604
chr6	89472274	89672274	harbor1	chr6	89538403	89539522	DNA/hAT-Charlie	3573	+	560	89538963	66689
chr6	101408010	101608010	harbor1	chr6	101420474	101420653	DNA/hAT-Charlie	834	+	90	101420564	12554
chr6	131062950	131262950	harbor1	chr6	131106688	131106984	DNA/hAT-Charlie	1274	+	148	131106836	43886
chr6	131062950	131262950	harbor1	chr6	131159740	131159938	DNA/hAT-Charlie	709	+	99	131159839	96889
chr6	80811391	81011391	harbor1	chr6	80884479	80884674	DNA/hAT-Charlie	810	+	98	80884577	73186
chr6	147515035	147715035	harbor1	chr6	147554858	147556097	DNA/hAT-Charlie	5009	+	620	147555478	40443
chr6	147515035	147715035	harbor1	chr6	147556391	147556546	DNA/hAT-Charlie	3365	+	78	147556469	41434
chr6	147515035	147715035	harbor1	chr6	147556723	147557259	DNA/hAT-Charlie	823	+	268	147556991	41956
chr6	147515035	147715035	harbor1	chr6	147580494	147580688	DNA/hAT-Charlie	754	+	97	147580591	65556
chr6	6002112	6202112	harbor1	chr6	6025903	6026209	DNA/hAT-Charlie	670	+	153	6026056	23944
chr6	6002112	6202112	harbor1	chr6	6037082	6037287	DNA/hAT-Charlie	1229	+	102	6037184	35072
chr6	6002112	6202112	harbor1	chr6	6056168	6056292	DNA/hAT-Charlie	439	+	62	6056230	54118
chr6	6002112	6202112	harbor1	chr6	6089145	6089326	DNA/hAT-Charlie	774	+	90	6089235	87123
chr6	6002112	6202112	harbor1	chr6	6089780	6089894	DNA/hAT-Charlie	460	+	57	6089837	87725
chr6	158827230	159027230	harbor1	chr6	158871090	158871181	DNA/hAT-Charlie	1326	+	46	158871136	43906
chr6	158827230	159027230	harbor1	chr6	158871483	158871603	DNA/hAT-Charlie	1326	+	60	158871543	44313
chr6	158827230	159027230	harbor1	chr6	158891668	158891755	DNA/hAT-Charlie	995	+	44	158891712	64482
chr6	158827230	159027230	harbor1	chr6	158892041	158892155	DNA/hAT-Charlie	995	+	57	158892098	64868
chr6	80560341	80760341	harbor1	chr6	80585061	80585234	DNA/hAT-Charlie	429	+	86	80585147	24806
chr6	80560341	80760341	harbor1	chr6	80620920	80620998	DNA/hAT-Charlie	479	+	39	80620959	60618
chr6	80560341	80760341	harbor1	chr6	80644038	80644162	DNA/hAT-Charlie	635	+	62	80644100	83759
chr6	80560341	80760341	harbor1	chr6	80644383	80644507	DNA/hAT-Charlie	626	+	62	80644445	84104
chr6	31058960	31258960	harbor1	chr6	31071864	31072167	DNA/hAT-Charlie	1528	+	152	31072016	13056
chr6	31058960	31258960	harbor1	chr6	31121786	31121928	DNA/hAT-Charlie	479	+	71	31121857	62897
chr6	107052290	107252290	harbor1	chr6	107061646	107061816	DNA/hAT-Charlie	824	+	85	107061731	9441
chr6	107052290	107252290	harbor1	chr6	107099722	107099872	DNA/hAT-Charlie	1045	+	75	107099797	47507
chr6	107052290	107252290	harbor1	chr6	107100169	107100238	DNA/hAT-Charlie	1045	+	34	107100203	47913
chr6	76715932	76915932	harbor1	chr6	76733483	76733647	DNA/hAT-Charlie	594	+	82	76733565	17633
chr6	54638971	54838971	harbor1	chr6	54647432	54647737	DNA/hAT-Charlie	1531	+	152	54647584	8613
chr6	54638971	54838971	harbor1	chr6	54683563	54683764	DNA/hAT-Charlie	869	+	100	54683663	44692
chr6	54638971	54838971	harbor1	chr6	54691329	54691628	DNA/hAT-Charlie	1102	+	150	54691479	52508
chr6	54638971	54838971	harbor1	chr6	54701574	54701849	DNA/hAT-Charlie	587	+	138	54701712	62741
chr6	54638971	54838971	harbor1	chr6	54707033	54707177	DNA/hAT-Charlie	523	+	72	54707105	68134
chr6	54638971	54838971	harbor1	chr6	54708357	54708518	DNA/hAT-Charlie	546	+	80	54708437	69466
chr6	54638971	54838971	harbor1	chr6	54710936	54711051	DNA/hAT-Charlie	621	+	58	54710994	72023
chr6	54638971	54838971	harbor1	chr6	54711115	54711299	DNA/hAT-Charlie	842	+	92	54711207	72236
chr6	67837123	68037123	harbor1	chr6	67855161	67855315	DNA/hAT-Charlie	509	+	77	67855238	18115
chr6	67837123	68037123	harbor1	chr6	67865582	67866057	DNA/hAT-Charlie	441	+	238	67865820	28697
chr6	67837123	68037123	harbor1	chr6	67866163	67866461	DNA/hAT-Charlie	665	+	149	67866312	29189
chr6	67837123	68037123	harbor1	chr6	67875446	67875738	DNA/hAT-Charlie	521	+	146	67875592	38469
chr6	67837123	68037123	harbor1	chr6	67906425	67906877	DNA/hAT-Charlie	932	+	226	67906651	69528
chr6	52398660	52598660	harbor1	chr6	52478618	52478982	DNA/hAT-Charlie	627	+	182	52478800	80140
chr6	108815922	109015922	harbor1	chr6	108869837	108870075	DNA/hAT-Charlie	750	+	119	108869956	54034
chr6	108815922	109015922	harbor1	chr6	108870230	108870457	DNA/hAT-Charlie	741	+	114	108870344	54422
chr6	108815922	109015922	harbor1	chr6	108872523	108872715	DNA/hAT-Charlie	438	+	96	108872619	56697
chr6	108815922	109015922	harbor1	chr6	108884243	108884395	DNA/hAT-Charlie	825	+	76	108884319	68397
chr6	108815922	109015922	harbor1	chr6	108885840	108886028	DNA/hAT-Charlie	1019	+	94	108885934	70012
chr6	108815922	109015922	harbor1	chr6	108886593	108886816	DNA/hAT-Charlie	444	+	112	108886705	70783
chr6	98615847	98815847	harbor1	chr6	98623755	98623924	DNA/hAT-Charlie	656	+	84	98623839	7992
chr6	98615847	98815847	harbor1	chr6	98668670	98668883	DNA/hAT-Charlie	1045	+	106	98668776	52929
chr6	16321069	16521069	harbor1	chr6	16332827	16332974	DNA/hAT-Charlie	747	+	74	16332901	11832
chr6	16321069	16521069	harbor1	chr6	16341339	16341504	DNA/hAT-Charlie	627	+	82	16341421	20352
chr6	16321069	16521069	harbor1	chr6	16354001	16354154	DNA/hAT-Charlie	540	+	76	16354077	33008
chr6	16321069	16521069	harbor1	chr6	16392827	16392907	DNA/hAT-Charlie	435	+	40	16392867	71798
chr6	16321069	16521069	harbor1	chr6	16399623	16399850	DNA/hAT-Charlie	838	+	114	16399737	78668
chr6	16321069	16521069	harbor1	chr6	16399981	16400126	DNA/hAT-Charlie	639	+	72	16400053	78984
chr6	136687181	136887181	harbor1	chr6	136728528	136728902	DNA/hAT-Charlie	802	+	187	136728715	41534
chr6	136687181	136887181	harbor1	chr6	136784666	136784892	DNA/hAT-Charlie	528	+	113	136784779	97598
chr6	123912068	124112068	harbor1	chr6	123986554	123986725	DNA/hAT-Charlie	548	+	86	123986640	74572
chr6	123912068	124112068	harbor1	chr6	123989189	123989899	DNA/hAT-Charlie	2344	+	355	123989544	77476
chr6	123912068	124112068	harbor1	chr6	123990323	123990477	DNA/hAT-Charlie	494	+	77	123990400	78332
chr6	60574882	60774882	harbor1	chr6	60597694	60597819	DNA/hAT-Charlie	507	+	62	60597756	22874
chr6	60574882	60774882	harbor1	chr6	60646085	60646308	DNA/hAT-Charlie	999	+	112	60646197	71315
chr6	125713762	125913762	harbor1	chr6	125781958	125782260	DNA/hAT-Charlie	1105	+	151	125782109	68347
chr6	125713762	125913762	harbor1	chr6	125806757	125806971	DNA/hAT-Charlie	571	+	107	125806864	93102
chr6	40584416	40784416	harbor1	chr6	40633280	40633756	DNA/hAT-Charlie	1929	+	238	40633518	49102
chr6	40584416	40784416	harbor1	chr6	40656512	40656537	DNA/hAT-Charlie	815	+	12	40656524	72108
chr6	40584416	40784416	harbor1	chr6	40657412	40657723	DNA/hAT-Charlie	815	+	156	40657568	73152
chr6	62971758	63171758	harbor1	chr6	62977580	62977757	DNA/hAT-Charlie	476	+	88	62977668	5910
chr6	62971758	63171758	harbor1	chr6	63049469	63049637	DNA/hAT-Charlie	455	+	84	63049553	77795
chr6	80717104	80917104	harbor1	chr6	80792778	80792911	DNA/hAT-Charlie	739	+	66	80792844	75740
chr6	80717104	80917104	harbor1	chr6	80810207	80810459	DNA/hAT-Charlie	508	+	126	80810333	93229
chr6	64382615	64582615	harbor1	chr6	64389482	64389677	DNA/hAT-Charlie	672	+	98	64389580	6965
chr6	64382615	64582615	harbor1	chr6	64422011	64422105	DNA/hAT-Charlie	530	+	47	64422058	39443
chr6	94591099	94791099	harbor1	chr6	94591748	94592036	DNA/hAT-Charlie	914	+	144	94591892	793
chr6	10559409	10759409	harbor1	chr6	10576170	10576393	DNA/hAT-Charlie	975	+	112	10576282	16873
chr6	10559409	10759409	harbor1	chr6	10612311	10612523	DNA/hAT-Charlie	1177	+	106	10612417	53008
chr6	10559409	10759409	harbor1	chr6	10613548	10613788	DNA/hAT-Charlie	658	+	120	10613668	54259
chr6	10559409	10759409	harbor1	chr6	10620808	10621023	DNA/hAT-Charlie	1382	+	108	10620916	61507
chr6	10559409	10759409	harbor1	chr6	10630379	10630525	DNA/hAT-Charlie	946	+	73	10630452	71043
chr6	10559409	10759409	harbor1	chr6	10630821	10630873	DNA/hAT-Charlie	946	+	26	10630847	71438
chr6	10559409	10759409	harbor1	chr6	10654625	10654784	DNA/hAT-Charlie	703	+	80	10654705	95296
chr6	10559409	10759409	harbor1	chr6	10655986	10656305	DNA/hAT-Charlie	782	+	160	10656146	96737
chr6	10559409	10759409	harbor1	chr6	10657654	10657764	DNA/hAT-Charlie	535	+	55	10657709	98300
chr6	129617422	129817422	harbor1	chr6	129620759	129621234	DNA/hAT-Charlie	1783	+	238	129620997	3575
chr6	129617422	129817422	harbor1	chr6	129660573	129660732	DNA/hAT-Charlie	677	+	80	129660653	43231
chr6	129617422	129817422	harbor1	chr6	129678226	129678438	DNA/hAT-Charlie	449	+	106	129678332	60910
chr6	129617422	129817422	harbor1	chr6	129715864	129716097	DNA/hAT-Charlie	1124	+	116	129715980	98558
chr6	129617422	129817422	harbor1	chr6	129716406	129717305	DNA/hAT-Charlie	1124	+	450	129716856	99434
chr6	118119946	118319946	harbor1	chr6	118144638	118144844	DNA/hAT-Charlie	421	+	103	118144741	24795
chr6	118119946	118319946	harbor1	chr6	118145329	118146096	DNA/hAT-Charlie	1582	+	384	118145713	25767
chr6	124262984	124462984	harbor1	chr6	124330700	124331048	DNA/hAT-Charlie	2237	+	174	124330874	67890
chr6	170682777	170882777	harbor1	chr6	170701272	170701438	DNA/hAT-Charlie	538	+	83	170701355	18578
chr6	77132138	77332138	harbor1	chr6	77213553	77213686	DNA/hAT-Charlie	715	+	66	77213619	81481
chr6	120486239	120686239	harbor1	chr6	120546721	120546854	DNA/hAT-Charlie	457	+	66	120546787	60548
chr6	111841449	112041449	harbor1	chr6	111875231	111875555	DNA/hAT-Charlie	1162	+	162	111875393	33944
chr6	111841449	112041449	harbor1	chr6	111914331	111914487	DNA/hAT-Charlie	918	+	78	111914409	72960
chr6	111841449	112041449	harbor1	chr6	111924903	111925026	DNA/hAT-Charlie	925	+	62	111924965	83516
chr6	111841449	112041449	harbor1	chr6	111925337	111925418	DNA/hAT-Charlie	925	+	40	111925377	83928
chr6	43641333	43841333	harbor1	chr6	43678308	43678383	DNA/hAT-Charlie	518	+	38	43678346	37013
chr6	43641333	43841333	harbor1	chr6	43679133	43679336	DNA/hAT-Charlie	1093	+	102	43679235	37902
chr6	43641333	43841333	harbor1	chr6	43702343	43702522	DNA/hAT-Charlie	564	+	90	43702433	61100
chr6	98437313	98637313	harbor1	chr6	98511112	98511595	DNA/hAT-Charlie	3385	+	242	98511354	74041
chr6	14268936	14468936	harbor1	chr6	14342760	14342893	DNA/hAT-Charlie	441	+	66	14342826	73890
chr6	14268936	14468936	harbor1	chr6	14366357	14366478	DNA/hAT-Charlie	870	+	60	14366417	97481
chr6	14268936	14468936	harbor1	chr6	14366610	14366673	DNA/hAT-Charlie	870	+	32	14366642	97706
chr6	121930625	122130625	harbor1	chr6	121999476	121999745	DNA/hAT-Charlie	605	+	134	121999610	68985
chr6	121930625	122130625	harbor1	chr6	122023414	122023628	DNA/hAT-Charlie	739	+	107	122023521	92896
chr6	121930625	122130625	harbor1	chr6	122024419	122025087	DNA/hAT-Charlie	1938	+	334	122024753	94128
chr6	15922776	16122776	harbor1	chr6	15947281	15947477	DNA/hAT-Charlie	482	+	98	15947379	24603
chr6	15922776	16122776	harbor1	chr6	15953576	15953749	DNA/hAT-Charlie	743	+	86	15953662	30886
chr6	15922776	16122776	harbor1	chr6	15953761	15953938	DNA/hAT-Charlie	926	+	88	15953849	31073
chr6	15922776	16122776	harbor1	chr6	15979269	15979580	DNA/hAT-Charlie	1729	+	156	15979425	56649
chr6	15922776	16122776	harbor1	chr6	15993902	15994038	DNA/hAT-Charlie	532	+	68	15993970	71194
chr6	15922776	16122776	harbor1	chr6	16000008	16000161	DNA/hAT-Charlie	843	+	76	16000084	77308
chr6	15922776	16122776	harbor1	chr6	16017836	16017971	DNA/hAT-Charlie	781	+	68	16017904	95128
chr6	149029854	149229854	harbor1	chr6	149037630	149037833	DNA/hAT-Charlie	979	+	102	149037732	7878
chr6	149029854	149229854	harbor1	chr6	149087662	149087806	DNA/hAT-Charlie	420	+	72	149087734	57880
chr6	149029854	149229854	harbor1	chr6	149092811	149092893	DNA/hAT-Charlie	765	+	41	149092852	62998
chr6	149029854	149229854	harbor1	chr6	149093172	149093275	DNA/hAT-Charlie	765	+	52	149093224	63370
chr6	149029854	149229854	harbor1	chr6	149109849	149110571	DNA/hAT-Charlie	2469	+	361	149110210	80356
chr6	152447208	152647208	harbor1	chr6	152512969	152513143	DNA/hAT-Charlie	692	+	87	152513056	65848
chr6	81009011	81209011	harbor1	chr6	81051257	81051407	DNA/hAT-Charlie	630	+	75	81051332	42321
chr6	87397046	87597046	harbor1	chr6	87397417	87397596	DNA/hAT-Charlie	869	+	90	87397507	461
chr6	87397046	87597046	harbor1	chr6	87477642	87477832	DNA/hAT-Charlie	1077	+	95	87477737	80691
chr6	110621265	110821265	harbor1	chr6	110625133	110625294	DNA/hAT-Charlie	717	+	80	110625213	3948
chr6	110621265	110821265	harbor1	chr6	110699888	110700412	DNA/hAT-Charlie	3579	+	262	110700150	78885
chr6	88396770	88596770	harbor1	chr6	88472287	88472615	DNA/hAT-Charlie	1504	+	164	88472451	75681
chr6	88396770	88596770	harbor1	chr6	88492005	88492228	DNA/hAT-Charlie	1273	+	112	88492117	95347
chr6	88396770	88596770	harbor1	chr6	88493924	88494130	DNA/hAT-Charlie	1158	+	103	88494027	97257
chr6	88396770	88596770	harbor1	chr6	88494889	88494927	DNA/hAT-Charlie	833	+	19	88494908	98138
chr6	88396770	88596770	harbor1	chr6	88495217	88495381	DNA/hAT-Charlie	833	+	82	88495299	98529
chr6	33066561	33266561	harbor1	chr6	33149085	33149235	DNA/hAT-Charlie	572	+	75	33149160	82599
chr6	158218147	158418147	harbor1	chr6	158261138	158261334	DNA/hAT-Charlie	792	+	98	158261236	43089
chr6	158218147	158418147	harbor1	chr6	158311157	158311243	DNA/hAT-Charlie	470	+	43	158311200	93053
chr6	22345476	22545476	harbor1	chr6	22352320	22352783	DNA/hAT-Charlie	1099	+	232	22352552	7076
chr6	22345476	22545476	harbor1	chr6	22408191	22408398	DNA/hAT-Charlie	718	+	104	22408295	62819
chr6	22345476	22545476	harbor1	chr6	22412671	22412878	DNA/hAT-Charlie	1490	+	104	22412775	67299
chr6	69606676	69806676	harbor1	chr6	69668427	69668548	DNA/hAT-Charlie	424	+	60	69668487	61811
chr6	69606676	69806676	harbor1	chr6	69685443	69685518	DNA/hAT-Charlie	492	+	38	69685481	78805
chr6	69606676	69806676	harbor1	chr6	69685823	69685896	DNA/hAT-Charlie	492	+	36	69685859	79183
chr6	69606676	69806676	harbor1	chr6	69686794	69687002	DNA/hAT-Charlie	916	+	104	69686898	80222
chr6	132544741	132744741	harbor1	chr6	132545316	132545549	DNA/hAT-Charlie	596	+	116	132545432	691
chr6	132544741	132744741	harbor1	chr6	132568711	132568896	DNA/hAT-Charlie	618	+	92	132568803	24062
chr6	132544741	132744741	harbor1	chr6	132574699	132575011	DNA/hAT-Charlie	1486	+	156	132574855	30114
chr6	132544741	132744741	harbor1	chr6	132584654	132585119	DNA/hAT-Charlie	1808	+	232	132584886	40145
chr6	157784610	157984610	harbor1	chr6	157799390	157799539	DNA/hAT-Charlie	1607	+	74	157799464	14854
chr6	157784610	157984610	harbor1	chr6	157799895	157800232	DNA/hAT-Charlie	1607	+	168	157800063	15453
chr6	157784610	157984610	harbor1	chr6	157801252	157801438	DNA/hAT-Charlie	667	+	93	157801345	16735
chr6	157784610	157984610	harbor1	chr6	157830587	157830766	DNA/hAT-Charlie	787	+	90	157830677	46067
chr6	157784610	157984610	harbor1	chr6	157859928	157860122	DNA/hAT-Charlie	891	+	97	157860025	75415
chr6	81108424	81308424	harbor1	chr6	81120501	81120832	DNA/hAT-Charlie	2129	+	166	81120667	12243
chr6	81108424	81308424	harbor1	chr6	81127599	81127713	DNA/hAT-Charlie	456	+	57	81127656	19232
chr6	81108424	81308424	harbor1	chr6	81128385	81128567	DNA/hAT-Charlie	870	+	91	81128476	20052
chr6	125553650	125753650	harbor1	chr6	125620774	125620941	DNA/hAT-Charlie	449	+	84	125620858	67208
chr6	125553650	125753650	harbor1	chr6	125622317	125622615	DNA/hAT-Charlie	1002	+	149	125622466	68816
chr6	40313388	40513388	harbor1	chr6	40330588	40330748	DNA/hAT-Charlie	824	+	80	40330668	17280
chr6	40313388	40513388	harbor1	chr6	40388502	40388861	DNA/hAT-Charlie	1121	+	180	40388682	75294
chr6	40313388	40513388	harbor1	chr6	40397836	40398086	DNA/hAT-Charlie	835	+	125	40397961	84573
chr6	166289202	166489202	harbor1	chr6	166322994	166323168	DNA/hAT-Charlie	861	+	87	166323081	33879
chr6	166289202	166489202	harbor1	chr6	166340998	166341165	DNA/hAT-Charlie	1115	+	84	166341082	51880
chr6	166289202	166489202	harbor1	chr6	166341469	166341492	DNA/hAT-Charlie	1115	+	12	166341481	52279
chr7	80221462	80421462	harbor1	chr7	80271655	80271787	DNA/hAT-Charlie	511	+	66	80271721	50259
chr7	80221462	80421462	harbor1	chr7	80273676	80273838	DNA/hAT-Charlie	443	+	81	80273757	52295
chr7	86714089	86914089	harbor1	chr7	86727772	86727987	DNA/hAT-Charlie	960	+	108	86727880	13791
chr7	86714089	86914089	harbor1	chr7	86739545	86739728	DNA/hAT-Charlie	834	+	92	86739637	25548
chr7	133378143	133578143	harbor1	chr7	133381861	133382016	DNA/hAT-Charlie	546	+	78	133381939	3796
chr7	133378143	133578143	harbor1	chr7	133396039	133396214	DNA/hAT-Charlie	882	+	88	133396127	17984
chr7	56277253	56477253	harbor1	chr7	56316050	56316265	DNA/hAT-Charlie	1072	+	108	56316158	38905
chr7	51161352	51361352	harbor1	chr7	51171118	51172090	DNA/hAT-Charlie	2209	+	486	51171604	10252
chr7	51161352	51361352	harbor1	chr7	51185186	51185306	DNA/hAT-Charlie	537	+	60	51185246	23894
chr7	51161352	51361352	harbor1	chr7	51213212	51213518	DNA/hAT-Charlie	1403	+	153	51213365	52013
chr7	122423496	122623496	harbor1	chr7	122428094	122428471	DNA/hAT-Charlie	2782	+	188	122428282	4786
chr7	122423496	122623496	harbor1	chr7	122428768	122429262	DNA/hAT-Charlie	2782	+	247	122429015	5519
chr7	122423496	122623496	harbor1	chr7	122465386	122465724	DNA/hAT-Charlie	1991	+	169	122465555	42059
chr7	122423496	122623496	harbor1	chr7	122482241	122482492	DNA/hAT-Charlie	926	+	126	122482367	58871
chr7	122423496	122623496	harbor1	chr7	122502866	122503029	DNA/hAT-Charlie	460	+	82	122502948	79452
chr7	122423496	122623496	harbor1	chr7	122512774	122513196	DNA/hAT-Charlie	1776	+	211	122512985	89489
chr7	937819	1137819	harbor1	chr7	939084	939221	DNA/hAT-Charlie	587	+	68	939152	1333
chr7	937819	1137819	harbor1	chr7	939518	939547	DNA/hAT-Charlie	587	+	14	939532	1713
chr7	54222229	54422229	harbor1	chr7	54245762	54245930	DNA/hAT-Charlie	656	+	84	54245846	23617
chr7	43428129	43628129	harbor1	chr7	43433022	43433133	DNA/hAT-Charlie	623	+	56	43433078	4949
chr7	43428129	43628129	harbor1	chr7	43462517	43462635	DNA/hAT-Charlie	612	+	59	43462576	34447
chr7	43428129	43628129	harbor1	chr7	43501475	43501549	DNA/hAT-Charlie	1215	+	37	43501512	73383
chr7	43428129	43628129	harbor1	chr7	43501861	43502073	DNA/hAT-Charlie	1215	+	106	43501967	73838
chr7	51057207	51257207	harbor1	chr7	51091957	51092294	DNA/hAT-Charlie	2220	+	168	51092125	34918
chr7	51057207	51257207	harbor1	chr7	51133455	51133609	DNA/hAT-Charlie	695	+	77	51133532	76325
chr7	51057207	51257207	harbor1	chr7	51152985	51153306	DNA/hAT-Charlie	588	+	160	51153145	95938
chr7	72417129	72617129	harbor1	chr7	72436724	72436866	DNA/hAT-Charlie	592	+	71	72436795	19666
chr7	55859347	56059347	harbor1	chr7	55864036	55864125	DNA/hAT-Charlie	1004	+	44	55864080	4733
chr7	55859347	56059347	harbor1	chr7	55864418	55864529	DNA/hAT-Charlie	1004	+	56	55864474	5127
chr7	55859347	56059347	harbor1	chr7	55864840	55865089	DNA/hAT-Charlie	1004	+	124	55864964	5617
chr7	55859347	56059347	harbor1	chr7	55865385	55865458	DNA/hAT-Charlie	1004	+	36	55865421	6074
chr7	55859347	56059347	harbor1	chr7	55865760	55865972	DNA/hAT-Charlie	1004	+	106	55865866	6519
chr7	55859347	56059347	harbor1	chr7	55866268	55866296	DNA/hAT-Charlie	1004	+	14	55866282	6935
chr7	55859347	56059347	harbor1	chr7	55866605	55866677	DNA/hAT-Charlie	1004	+	36	55866641	7294
chr7	55859347	56059347	harbor1	chr7	55886376	55886434	DNA/hAT-Charlie	2292	+	29	55886405	27058
chr7	55859347	56059347	harbor1	chr7	55886751	55886814	DNA/hAT-Charlie	2292	+	32	55886783	27436
chr7	55859347	56059347	harbor1	chr7	55887107	55887160	DNA/hAT-Charlie	2292	+	26	55887133	27786
chr7	55859347	56059347	harbor1	chr7	55930473	55930527	DNA/hAT-Charlie	1070	+	27	55930500	71153
chr7	55859347	56059347	harbor1	chr7	55930781	55930900	DNA/hAT-Charlie	1070	+	60	55930841	71494
chr7	55859347	56059347	harbor1	chr7	55885664	55886059	DNA/hAT-Charlie	2292	+	198	55885862	26515
chr7	105424269	105624269	harbor1	chr7	105451850	105452142	DNA/hAT-Charlie	1360	+	146	105451996	27727
chr7	105424269	105624269	harbor1	chr7	105453900	105454028	DNA/hAT-Charlie	494	+	64	105453964	29695
chr7	105424269	105624269	harbor1	chr7	105474824	105475029	DNA/hAT-Charlie	937	+	102	105474926	50657
chr7	105424269	105624269	harbor1	chr7	105490800	105491015	DNA/hAT-Charlie	1134	+	108	105490908	66639
chr7	105424269	105624269	harbor1	chr7	105500645	105500843	DNA/hAT-Charlie	559	+	99	105500744	76475
chr7	72785443	72985443	harbor1	chr7	72801962	72802149	DNA/hAT-Charlie	1144	+	94	72802056	16613
chr7	72785443	72985443	harbor1	chr7	72812650	72812701	DNA/hAT-Charlie	809	+	26	72812676	27233
chr7	72785443	72985443	harbor1	chr7	72812994	72813153	DNA/hAT-Charlie	809	+	80	72813074	27631
chr7	139560079	139760079	harbor1	chr7	139626047	139626090	DNA/hAT-Charlie	835	+	22	139626069	65990
chr7	139560079	139760079	harbor1	chr7	139626403	139626573	DNA/hAT-Charlie	835	+	85	139626488	66409
chr7	139560079	139760079	harbor1	chr7	139651293	139651602	DNA/hAT-Charlie	601	+	154	139651447	91368
chr7	53666169	53866169	harbor1	chr7	53759140	53759426	DNA/hAT-Charlie	471	+	143	53759283	93114
chr7	82399330	82599330	harbor1	chr7	82409499	82409662	DNA/hAT-Charlie	525	+	82	82409581	10251
chr7	82399330	82599330	harbor1	chr7	82419852	82420083	DNA/hAT-Charlie	1080	+	116	82419968	20638
chr7	82399330	82599330	harbor1	chr7	82423811	82424112	DNA/hAT-Charlie	762	+	150	82423961	24631
chr7	82399330	82599330	harbor1	chr7	82427723	82427896	DNA/hAT-Charlie	723	+	86	82427809	28479
chr7	80070013	80270013	harbor1	chr7	80088786	80088992	DNA/hAT-Charlie	961	+	103	80088889	18876
chr7	80070013	80270013	harbor1	chr7	80109296	80109460	DNA/hAT-Charlie	793	+	82	80109378	39365
chr7	80070013	80270013	harbor1	chr7	80121151	80121298	DNA/hAT-Charlie	544	+	74	80121225	51212
chr7	80070013	80270013	harbor1	chr7	80121793	80121988	DNA/hAT-Charlie	595	+	98	80121891	51878
chr7	27595592	27795592	harbor1	chr7	27691211	27691521	DNA/hAT-Charlie	657	+	155	27691366	95774
chr7	27595592	27795592	harbor1	chr7	27692175	27692309	DNA/hAT-Charlie	583	+	67	27692242	96650
chr7	85661732	85861732	harbor1	chr7	85682837	85683417	DNA/hAT-Charlie	2206	+	290	85683127	21395
chr7	134998339	135198339	harbor1	chr7	135016070	135016523	DNA/hAT-Charlie	921	+	226	135016296	17957
chr7	129748223	129948223	harbor1	chr7	129808878	129809041	DNA/hAT-Charlie	488	+	82	129808960	60737
chr7	129748223	129948223	harbor1	chr7	129809811	129809929	DNA/hAT-Charlie	2019	+	59	129809870	61647
chr7	129748223	129948223	harbor1	chr7	129810846	129811118	DNA/hAT-Charlie	2019	+	136	129810982	62759
chr7	129748223	129948223	harbor1	chr7	129811708	129811890	DNA/hAT-Charlie	2019	+	91	129811799	63576
chr7	129748223	129948223	harbor1	chr7	129812591	129812899	DNA/hAT-Charlie	1222	+	154	129812745	64522
chr7	129748223	129948223	harbor1	chr7	129826868	129826986	DNA/hAT-Charlie	602	+	59	129826927	78704
chr7	129748223	129948223	harbor1	chr7	129827284	129827396	DNA/hAT-Charlie	602	+	56	129827340	79117
chr7	129748223	129948223	harbor1	chr7	129840900	129841104	DNA/hAT-Charlie	1370	+	102	129841002	92779
chr7	129748223	129948223	harbor1	chr7	129841399	129841598	DNA/hAT-Charlie	999	+	100	129841499	93276
chr7	129748223	129948223	harbor1	chr7	129810234	129810541	DNA/hAT-Charlie	2019	+	154	129810388	62165
chr7	86558972	86758972	harbor1	chr7	86566230	86566577	DNA/hAT-Charlie	1625	+	174	86566404	7432
chr7	86558972	86758972	harbor1	chr7	86566874	86567028	DNA/hAT-Charlie	1625	+	77	86566951	7979
chr7	86558972	86758972	harbor1	chr7	86573317	86573814	DNA/hAT-Charlie	845	+	248	86573565	14593
chr7	86558972	86758972	harbor1	chr7	86573938	86574048	DNA/hAT-Charlie	453	+	55	86573993	15021
chr7	86558972	86758972	harbor1	chr7	86635676	86635906	DNA/hAT-Charlie	522	+	115	86635791	76819
chr7	113615979	113815979	harbor1	chr7	113693820	113693967	DNA/hAT-Charlie	860	+	74	113693894	77915
chr7	113615979	113815979	harbor1	chr7	113694008	113694202	DNA/hAT-Charlie	808	+	97	113694105	78126
chr7	113615979	113815979	harbor1	chr7	113707018	113707303	DNA/hAT-Charlie	645	+	142	113707160	91181
chr7	105787914	105987914	harbor1	chr7	105822818	105823032	DNA/hAT-Charlie	662	+	107	105822925	35011
chr7	105787914	105987914	harbor1	chr7	105867782	105867996	DNA/hAT-Charlie	907	+	107	105867889	79975
chr7	105787914	105987914	harbor1	chr7	105885881	105886111	DNA/hAT-Charlie	1142	+	115	105885996	98082
chr7	35659459	35859459	harbor1	chr7	35667072	35667234	DNA/hAT-Charlie	799	+	81	35667153	7694
chr7	35659459	35859459	harbor1	chr7	35749227	35749480	DNA/hAT-Charlie	576	+	126	35749353	89894
chr7	117914563	118114563	harbor1	chr7	117992340	117992449	DNA/hAT-Charlie	488	+	54	117992394	77831
chr7	117914563	118114563	harbor1	chr7	118009244	118009911	DNA/hAT-Charlie	1739	+	334	118009578	95015
chr7	8868392	9068392	harbor1	chr7	8869753	8869887	DNA/hAT-Charlie	506	+	67	8869820	1428
chr7	8868392	9068392	harbor1	chr7	8935199	8935412	DNA/hAT-Charlie	597	+	106	8935305	66913
chr7	132222910	132422910	harbor1	chr7	132242956	132243058	DNA/hAT-Charlie	444	+	51	132243007	20097
chr7	132222910	132422910	harbor1	chr7	132243089	132243233	DNA/hAT-Charlie	620	+	72	132243161	20251
chr7	132222910	132422910	harbor1	chr7	132320735	132320911	DNA/hAT-Charlie	853	+	88	132320823	97913
chr7	32922647	33122647	harbor1	chr7	32961564	32962093	DNA/hAT-Charlie	3712	+	264	32961828	39181
chr7	140789845	140989845	harbor1	chr7	140850772	140851011	DNA/hAT-Charlie	762	+	120	140850892	61047
chr7	140789845	140989845	harbor1	chr7	140851147	140851341	DNA/hAT-Charlie	491	+	97	140851244	61399
chr7	140789845	140989845	harbor1	chr7	140866687	140866790	DNA/hAT-Charlie	597	+	52	140866739	76894
chr7	140789845	140989845	harbor1	chr7	140887590	140887720	DNA/hAT-Charlie	856	+	65	140887655	97810
chr7	140789845	140989845	harbor1	chr7	140888173	140888550	DNA/hAT-Charlie	856	+	188	140888361	98516
chr7	140789845	140989845	harbor1	chr7	140888859	140889000	DNA/hAT-Charlie	685	+	70	140888929	99084
chr7	6133836	6333836	harbor1	chr7	6138586	6138905	DNA/hAT-Charlie	2088	+	160	6138746	4910
chr7	6133836	6333836	harbor1	chr7	6158012	6158338	DNA/hAT-Charlie	1016	+	163	6158175	24339
chr7	6133836	6333836	harbor1	chr7	6208879	6209033	DNA/hAT-Charlie	552	+	77	6208956	75120
chr7	16966674	17166674	harbor1	chr7	17006909	17007054	DNA/hAT-Charlie	1324	+	72	17006981	40307
chr7	16966674	17166674	harbor1	chr7	17007363	17007447	DNA/hAT-Charlie	1324	+	42	17007405	40731
chr7	34633287	34833287	harbor1	chr7	34645396	34645566	DNA/hAT-Charlie	528	+	85	34645481	12194
chr7	52809442	53009442	harbor1	chr7	52844174	52845099	DNA/hAT-Charlie	2621	+	462	52844636	35194
chr7	17440744	17640744	harbor1	chr7	17463581	17463877	DNA/hAT-Charlie	1684	+	148	17463729	22985
chr7	17440744	17640744	harbor1	chr7	17487908	17488119	DNA/hAT-Charlie	797	+	106	17488014	47270
chr7	17440744	17640744	harbor1	chr7	17497688	17497855	DNA/hAT-Charlie	645	+	84	17497772	57028
chr7	17440744	17640744	harbor1	chr7	17497879	17498038	DNA/hAT-Charlie	768	+	80	17497959	57215
chr7	17440744	17640744	harbor1	chr7	17501304	17501484	DNA/hAT-Charlie	739	+	90	17501394	60650
chr7	135577470	135777470	harbor1	chr7	135610538	135610656	DNA/hAT-Charlie	615	+	59	135610597	33127
chr7	135577470	135777470	harbor1	chr7	135658805	135658960	DNA/hAT-Charlie	759	+	78	135658883	81413
chr7	43593935	43793935	harbor1	chr7	43629985	43630182	DNA/hAT-Charlie	893	+	98	43630083	36148
chr7	43593935	43793935	harbor1	chr7	43661721	43661824	DNA/hAT-Charlie	480	+	52	43661773	67838
chr7	43593935	43793935	harbor1	chr7	43661859	43662232	DNA/hAT-Charlie	2719	+	186	43662045	68110
chr7	43593935	43793935	harbor1	chr7	43662530	43662841	DNA/hAT-Charlie	2719	+	156	43662686	68751
chr7	131671793	131871793	harbor1	chr7	131767067	131767350	DNA/hAT-Charlie	1142	+	142	131767209	95416
chr7	71259016	71459016	harbor1	chr7	71261038	71261208	DNA/hAT-Charlie	499	+	85	71261123	2107
chr7	71259016	71459016	harbor1	chr7	71357161	71357487	DNA/hAT-Charlie	2015	+	163	71357324	98308
chr7	115010832	115210832	harbor1	chr7	115043576	115044916	DNA/hAT-Charlie	4710	+	670	115044246	33414
chr7	115010832	115210832	harbor1	chr7	115089590	115089761	DNA/hAT-Charlie	851	+	86	115089676	78844
chr7	36832814	37032814	harbor1	chr7	36833821	36833990	DNA/hAT-Charlie	824	+	84	36833905	1091
chr7	36832814	37032814	harbor1	chr7	36839825	36840028	DNA/hAT-Charlie	1258	+	102	36839927	7113
chr7	36832814	37032814	harbor1	chr7	36876200	36876501	DNA/hAT-Charlie	573	+	150	36876350	43536
chr7	36832814	37032814	harbor1	chr7	36900022	36900182	DNA/hAT-Charlie	822	+	80	36900102	67288
chr7	36832814	37032814	harbor1	chr7	36924934	36925135	DNA/hAT-Charlie	768	+	100	36925034	92220
chr7	10094706	10294706	harbor1	chr7	10126157	10126861	DNA/hAT-Charlie	961	+	352	10126509	31803
chr7	10094706	10294706	harbor1	chr7	10162309	10162865	DNA/hAT-Charlie	1060	+	278	10162587	67881
chr7	10094706	10294706	harbor1	chr7	10163101	10163564	DNA/hAT-Charlie	767	+	232	10163333	68627
chr7	10094706	10294706	harbor1	chr7	10125167	10125332	DNA/hAT-Charlie	465	+	82	10125249	30543
chr7	143314552	143514552	harbor1	chr7	143372525	143372675	DNA/hAT-Charlie	748	+	75	143372600	58048
chr7	96347015	96547015	harbor1	chr7	96377476	96377651	DNA/hAT-Charlie	475	+	88	96377564	30549
chr7	96347015	96547015	harbor1	chr7	96385616	96385910	DNA/hAT-Charlie	591	+	147	96385763	38748
chr7	96347015	96547015	harbor1	chr7	96405351	96406068	DNA/hAT-Charlie	1898	+	358	96405709	58694
chr7	96347015	96547015	harbor1	chr7	96427175	96427454	DNA/hAT-Charlie	533	+	140	96427315	80300
chr7	152961614	153161614	harbor1	chr7	153025551	153025823	DNA/hAT-Charlie	762	+	136	153025687	64073
chr7	152971739	153171739	harbor1	chr7	153025551	153025823	DNA/hAT-Charlie	762	+	136	153025687	53948
chr7	152971739	153171739	harbor1	chr7	153069804	153070020	DNA/hAT-Charlie	743	+	108	153069912	98173
chr7	17015978	17215978	harbor1	chr7	17087040	17087271	DNA/hAT-Charlie	754	+	116	17087156	71178
chr7	17015978	17215978	harbor1	chr7	17088047	17088234	DNA/hAT-Charlie	1041	+	94	17088141	72163
chr7	128556838	128756838	harbor1	chr7	128580574	128580795	DNA/hAT-Charlie	1130	+	110	128580684	23846
chr7	128556838	128756838	harbor1	chr7	128641360	128641787	DNA/hAT-Charlie	2892	+	214	128641574	84736
chr7	128556838	128756838	harbor1	chr7	128650758	128651177	DNA/hAT-Charlie	2599	+	210	128650968	94130
chr7	143343613	143543613	harbor1	chr7	143372525	143372675	DNA/hAT-Charlie	748	+	75	143372600	28987
chr7	143343613	143543613	harbor1	chr7	143439147	143439332	DNA/hAT-Charlie	677	+	92	143439239	95626
chr7	143343613	143543613	harbor1	chr7	143439684	143439747	DNA/hAT-Charlie	677	+	32	143439716	96103
chr7	14511279	14711279	harbor1	chr7	14556998	14557190	DNA/hAT-Charlie	878	+	96	14557094	45815
chr7	28020837	28220837	harbor1	chr7	28027342	28027537	DNA/hAT-Charlie	600	+	98	28027440	6603
chr7	10029424	10229424	harbor1	chr7	10042646	10042804	DNA/hAT-Charlie	503	+	79	10042725	13301
chr7	10029424	10229424	harbor1	chr7	10126157	10126861	DNA/hAT-Charlie	961	+	352	10126509	97085
chr7	10029424	10229424	harbor1	chr7	10125167	10125332	DNA/hAT-Charlie	465	+	82	10125249	95825
chr7	154271835	154471835	harbor1	chr7	154329232	154329344	DNA/hAT-Charlie	465	+	56	154329288	57453
chr7	154271835	154471835	harbor1	chr7	154353049	154353195	DNA/hAT-Charlie	556	+	73	154353122	81287
chr7	154271835	154471835	harbor1	chr7	154368300	154368442	DNA/hAT-Charlie	920	+	71	154368371	96536
chr7	154271835	154471835	harbor1	chr7	154368914	154368934	DNA/hAT-Charlie	920	+	10	154368924	97089
chr7	143421541	143621541	harbor1	chr7	143439147	143439332	DNA/hAT-Charlie	677	+	92	143439239	17698
chr7	143421541	143621541	harbor1	chr7	143439684	143439747	DNA/hAT-Charlie	677	+	32	143439716	18175
chr7	143421541	143621541	harbor1	chr7	143505648	143505733	DNA/hAT-Charlie	606	+	42	143505690	84149
chr7	143421541	143621541	harbor1	chr7	143506129	143506211	DNA/hAT-Charlie	606	+	41	143506170	84629
chr7	69823521	70023521	harbor1	chr7	69839939	69840061	DNA/hAT-Charlie	635	+	61	69840000	16479
chr7	69823521	70023521	harbor1	chr7	69875255	69875387	DNA/hAT-Charlie	496	+	66	69875321	51800
chr7	55139865	55339865	harbor1	chr7	55201934	55202109	DNA/hAT-Charlie	655	+	88	55202022	62157
chr7	55139865	55339865	harbor1	chr7	55210375	55210539	DNA/hAT-Charlie	843	+	82	55210457	70592
chr7	55139865	55339865	harbor1	chr7	55215693	55215878	DNA/hAT-Charlie	847	+	92	55215785	75920
chr7	55139865	55339865	harbor1	chr7	55221421	55221601	DNA/hAT-Charlie	561	+	90	55221511	81646
chr7	91075634	91275634	harbor1	chr7	91085895	91086062	DNA/hAT-Charlie	585	+	84	91085979	10345
chr7	91075634	91275634	harbor1	chr7	91090330	91090538	DNA/hAT-Charlie	1163	+	104	91090434	14800
chr7	91075634	91275634	harbor1	chr7	91118515	91118792	DNA/hAT-Charlie	823	+	138	91118653	43019
chr7	91075634	91275634	harbor1	chr7	91129083	91130496	DNA/hAT-Charlie	6017	+	706	91129789	54155
chr7	91075634	91275634	harbor1	chr7	91142126	91142553	DNA/hAT-Charlie	777	+	214	91142340	66706
chr7	55897764	56097764	harbor1	chr7	55930473	55930527	DNA/hAT-Charlie	1070	+	27	55930500	32736
chr7	55897764	56097764	harbor1	chr7	55930781	55930900	DNA/hAT-Charlie	1070	+	60	55930841	33077
chr7	78748616	78948616	harbor1	chr7	78774076	78774249	DNA/hAT-Charlie	450	+	86	78774162	25546
chr7	78748616	78948616	harbor1	chr7	78793273	78793489	DNA/hAT-Charlie	894	+	108	78793381	44765
chr7	78748616	78948616	harbor1	chr7	78811708	78811775	DNA/hAT-Charlie	573	+	34	78811742	63126
chr7	78748616	78948616	harbor1	chr7	78812291	78812379	DNA/hAT-Charlie	573	+	44	78812335	63719
chr7	16437792	16637792	harbor1	chr7	16472314	16472442	DNA/hAT-Charlie	728	+	64	16472378	34586
chr7	16437792	16637792	harbor1	chr7	16473209	16473550	DNA/hAT-Charlie	1889	+	170	16473379	35587
chr7	16437792	16637792	harbor1	chr7	16524498	16524702	DNA/hAT-Charlie	626	+	102	16524600	86808
chr7	71873048	72073048	harbor1	chr7	71893131	71893360	DNA/hAT-Charlie	1185	+	114	71893245	20197
chr7	71873048	72073048	harbor1	chr7	71945446	71945939	DNA/hAT-Charlie	3223	+	246	71945692	72644
chr7	12935701	13135701	harbor1	chr7	12985704	12985921	DNA/hAT-Charlie	668	+	108	12985812	50111
chr7	12935701	13135701	harbor1	chr7	12985918	12986399	DNA/hAT-Charlie	915	+	240	12986158	50457
chr7	12935701	13135701	harbor1	chr7	12994947	12995110	DNA/hAT-Charlie	466	+	82	12995029	59328
chr7	12935701	13135701	harbor1	chr7	13007880	13008034	DNA/hAT-Charlie	780	+	77	13007957	72256
chr7	12935701	13135701	harbor1	chr7	13035509	13035841	DNA/hAT-Charlie	2074	+	166	13035675	99974
chr7	2720338	2920338	harbor1	chr7	2805877	2806163	DNA/hAT-Charlie	928	+	143	2806020	85682
chr7	131762901	131962901	harbor1	chr7	131767067	131767350	DNA/hAT-Charlie	1142	+	142	131767209	4308
chr7	131762901	131962901	harbor1	chr7	131779039	131779166	DNA/hAT-Charlie	652	+	64	131779103	16202
chr7	131762901	131962901	harbor1	chr7	131799813	131799959	DNA/hAT-Charlie	703	+	73	131799886	36985
chr7	131762901	131962901	harbor1	chr7	131800004	131800192	DNA/hAT-Charlie	1049	+	94	131800098	37197
chr7	131762901	131962901	harbor1	chr7	131800364	131800535	DNA/hAT-Charlie	463	+	86	131800450	37549
chr7	131762901	131962901	harbor1	chr7	131813003	131813201	DNA/hAT-Charlie	855	+	99	131813102	50201
chr7	131762901	131962901	harbor1	chr7	131828107	131828285	DNA/hAT-Charlie	887	+	89	131828196	65295
chr7	126104294	126304294	harbor1	chr7	126135225	126135386	DNA/hAT-Charlie	479	+	80	126135305	31011
chr7	126104294	126304294	harbor1	chr7	126193198	126193354	DNA/hAT-Charlie	500	+	78	126193276	88982
chr7	99127024	99327024	harbor1	chr7	99167284	99167495	DNA/hAT-Charlie	2629	+	106	99167390	40366
chr7	99127024	99327024	harbor1	chr7	99167781	99168061	DNA/hAT-Charlie	2629	+	140	99167921	40897
chr7	99127024	99327024	harbor1	chr7	99174016	99174520	DNA/hAT-Charlie	3487	+	252	99174268	47244
chr7	56573122	56773122	harbor1	chr7	56577353	56577473	DNA/hAT-Charlie	513	+	60	56577413	4291
chr7	125559893	125759893	harbor1	chr7	125567838	125568061	DNA/hAT-Charlie	972	+	112	125567950	8057
chr7	125559893	125759893	harbor1	chr7	125591101	125591323	DNA/hAT-Charlie	811	+	111	125591212	31319
chr7	50023522	50223522	harbor1	chr7	50080129	50080763	DNA/hAT-Charlie	1167	+	317	50080446	56924
chr7	50023522	50223522	harbor1	chr7	50105361	50105958	DNA/hAT-Charlie	1179	+	298	50105659	82137
chr7	146302425	146502425	harbor1	chr7	146328011	146328350	DNA/hAT-Charlie	2102	+	170	146328181	25756
chr7	146302425	146502425	harbor1	chr7	146346139	146346399	DNA/hAT-Charlie	1604	+	130	146346269	43844
chr7	146302425	146502425	harbor1	chr7	146346726	146346854	DNA/hAT-Charlie	957	+	64	146346790	44365
chr7	92337078	92537078	harbor1	chr7	92347178	92347414	DNA/hAT-Charlie	1377	+	118	92347296	10218
chr7	92337078	92537078	harbor1	chr7	92353744	92353869	DNA/hAT-Charlie	545	+	62	92353806	16728
chr7	92337078	92537078	harbor1	chr7	92419208	92419374	DNA/hAT-Charlie	745	+	83	92419291	82213
chr7	92337078	92537078	harbor1	chr7	92419384	92419563	DNA/hAT-Charlie	1351	+	90	92419474	82396
chr7	92337078	92537078	harbor1	chr7	92419596	92419739	DNA/hAT-Charlie	1351	+	72	92419668	82590
chr7	43240795	43440795	harbor1	chr7	43250687	43250963	DNA/hAT-Charlie	496	+	138	43250825	10030
chr7	43240795	43440795	harbor1	chr7	43252391	43252515	DNA/hAT-Charlie	549	+	62	43252453	11658
chr7	43240795	43440795	harbor1	chr7	43257194	43257310	DNA/hAT-Charlie	467	+	58	43257252	16457
chr7	43240795	43440795	harbor1	chr7	43268413	43268620	DNA/hAT-Charlie	944	+	104	43268517	27722
chr7	43240795	43440795	harbor1	chr7	43269794	43269965	DNA/hAT-Charlie	731	+	86	43269880	29085
chr7	43240795	43440795	harbor1	chr7	43283151	43283665	DNA/hAT-Charlie	2125	+	257	43283408	42613
chr7	43240795	43440795	harbor1	chr7	43285248	43285394	DNA/hAT-Charlie	656	+	73	43285321	44526
chr7	43240795	43440795	harbor1	chr7	43293768	43294112	DNA/hAT-Charlie	2102	+	172	43293940	53145
chr7	43240795	43440795	harbor1	chr7	43313309	43313339	DNA/hAT-Charlie	546	+	15	43313324	72529
chr7	43240795	43440795	harbor1	chr7	43313637	43313920	DNA/hAT-Charlie	546	+	142	43313779	72984
chr7	117642717	117842717	harbor1	chr7	117679255	117679380	DNA/hAT-Charlie	587	+	62	117679317	36600
chr7	117642717	117842717	harbor1	chr7	117712899	117713217	DNA/hAT-Charlie	1929	+	159	117713058	70341
chr7	90649409	90849409	harbor1	chr7	90657538	90657692	DNA/hAT-Charlie	599	+	77	90657615	8206
chr7	13570164	13770164	harbor1	chr7	13605942	13606127	DNA/hAT-Charlie	727	+	92	13606034	35870
chr7	13570164	13770164	harbor1	chr7	13637644	13637841	DNA/hAT-Charlie	589	+	98	13637742	67578
chr7	3885459	4085459	harbor1	chr7	3890235	3890524	DNA/hAT-Charlie	986	+	144	3890379	4920
chr7	3885459	4085459	harbor1	chr7	3918204	3918723	DNA/hAT-Charlie	3517	+	260	3918464	33005
chr7	3885459	4085459	harbor1	chr7	3930307	3930447	DNA/hAT-Charlie	541	+	70	3930377	44918
chr7	136358903	136558903	harbor1	chr7	136370476	136370692	DNA/hAT-Charlie	902	+	108	136370584	11681
chr7	136358903	136558903	harbor1	chr7	136388481	136388741	DNA/hAT-Charlie	530	+	130	136388611	29708
chr7	136358903	136558903	harbor1	chr7	136400709	136400882	DNA/hAT-Charlie	527	+	86	136400795	41892
chr7	3291708	3491708	harbor1	chr7	3369347	3369502	DNA/hAT-Charlie	576	+	78	3369425	77717
chr7	141375456	141575456	harbor1	chr7	141407015	141407205	DNA/hAT-Charlie	901	+	95	141407110	31654
chr7	141375456	141575456	harbor1	chr7	141440298	141440401	DNA/hAT-Charlie	464	+	52	141440350	64894
chr7	141375456	141575456	harbor1	chr7	141468191	141468328	DNA/hAT-Charlie	691	+	68	141468259	92803
chr7	76088133	76288133	harbor1	chr7	76130433	76130592	DNA/hAT-Charlie	828	+	80	76130513	42380
chr7	24460441	24660441	harbor1	chr7	24506055	24506261	DNA/hAT-Charlie	834	+	103	24506158	45717
chr7	6042369	6242369	harbor1	chr7	6112656	6112846	DNA/hAT-Charlie	1291	+	95	6112751	70382
chr7	6042369	6242369	harbor1	chr7	6138586	6138905	DNA/hAT-Charlie	2088	+	160	6138746	96377
chr7	64208631	64408631	harbor1	chr7	64247362	64247561	DNA/hAT-Charlie	560	+	100	64247462	38831
chr7	64208631	64408631	harbor1	chr7	64247851	64247927	DNA/hAT-Charlie	560	+	38	64247889	39258
chr7	57225578	57425578	harbor1	chr7	57291918	57292134	DNA/hAT-Charlie	1483	+	108	57292026	66448
chr7	131386550	131586550	harbor1	chr7	131389020	131389227	DNA/hAT-Charlie	972	+	104	131389124	2574
chr7	137108135	137308135	harbor1	chr7	137147562	137147811	DNA/hAT-Charlie	740	+	124	137147686	39551
chr7	137108135	137308135	harbor1	chr7	137169770	137170074	DNA/hAT-Charlie	1101	+	152	137169922	61787
chr7	137108135	137308135	harbor1	chr7	137196897	137197037	DNA/hAT-Charlie	558	+	70	137196967	88832
chr7	29128320	29328320	harbor1	chr7	29163231	29163449	DNA/hAT-Charlie	791	+	109	29163340	35020
chr7	29128320	29328320	harbor1	chr7	29202990	29203184	DNA/hAT-Charlie	1403	+	97	29203087	74767
chr7	29128320	29328320	harbor1	chr7	29203493	29203621	DNA/hAT-Charlie	1403	+	64	29203557	75237
chr7	107869765	108069765	harbor1	chr7	107925287	107925536	DNA/hAT-Charlie	1721	+	124	107925411	55646
chr7	131725459	131925459	harbor1	chr7	131767067	131767350	DNA/hAT-Charlie	1142	+	142	131767209	41750
chr7	131725459	131925459	harbor1	chr7	131779039	131779166	DNA/hAT-Charlie	652	+	64	131779103	53644
chr7	131725459	131925459	harbor1	chr7	131799813	131799959	DNA/hAT-Charlie	703	+	73	131799886	74427
chr7	131725459	131925459	harbor1	chr7	131800004	131800192	DNA/hAT-Charlie	1049	+	94	131800098	74639
chr7	131725459	131925459	harbor1	chr7	131800364	131800535	DNA/hAT-Charlie	463	+	86	131800450	74991
chr7	131725459	131925459	harbor1	chr7	131813003	131813201	DNA/hAT-Charlie	855	+	99	131813102	87643
chr7	77443171	77643171	harbor1	chr7	77456732	77456831	DNA/hAT-Charlie	483	+	50	77456782	13611
chr7	77443171	77643171	harbor1	chr7	77468670	77468758	DNA/hAT-Charlie	481	+	44	77468714	25543
chr7	77443171	77643171	harbor1	chr7	77472155	77472457	DNA/hAT-Charlie	502	+	151	77472306	29135
chr7	77443171	77643171	harbor1	chr7	77498607	77498915	DNA/hAT-Charlie	497	+	154	77498761	55590
chr7	77443171	77643171	harbor1	chr7	77517220	77517497	DNA/hAT-Charlie	727	+	138	77517358	74187
chr7	97007562	97207562	harbor1	chr7	97096150	97096310	DNA/hAT-Charlie	783	+	80	97096230	88668
chr7	110741582	110941582	harbor1	chr7	110803788	110803975	DNA/hAT-Charlie	869	+	94	110803882	62300
chr7	77949647	78149647	harbor1	chr7	77969070	77969363	DNA/hAT-Charlie	1102	+	146	77969216	19569
chr7	77949647	78149647	harbor1	chr7	77978655	77978776	DNA/hAT-Charlie	917	+	60	77978715	29068
chr7	77949647	78149647	harbor1	chr7	77979080	77979270	DNA/hAT-Charlie	917	+	95	77979175	29528
chr7	77949647	78149647	harbor1	chr7	78001097	78001247	DNA/hAT-Charlie	753	+	75	78001172	51525
chr7	77949647	78149647	harbor1	chr7	78002057	78002184	DNA/hAT-Charlie	676	+	64	78002121	52474
chr7	77949647	78149647	harbor1	chr7	78012930	78013043	DNA/hAT-Charlie	520	+	56	78012986	63339
chr7	77949647	78149647	harbor1	chr7	78038517	78038657	DNA/hAT-Charlie	735	+	70	78038587	88940
chr7	47433673	47633673	harbor1	chr7	47510388	47510591	DNA/hAT-Charlie	2813	+	102	47510490	76817
chr7	47433673	47633673	harbor1	chr7	47510883	47511572	DNA/hAT-Charlie	2813	+	344	47511227	77554
chr7	100463473	100663473	harbor1	chr7	100482343	100482397	DNA/hAT-Charlie	518	+	27	100482370	18897
chr7	100463473	100663473	harbor1	chr7	100482713	100482796	DNA/hAT-Charlie	524	+	42	100482755	19282
chr7	100463473	100663473	harbor1	chr7	100496471	100496496	DNA/hAT-Charlie	686	+	12	100496483	33010
chr7	100463473	100663473	harbor1	chr7	100496795	100497078	DNA/hAT-Charlie	686	+	142	100496937	33464
chr7	96292171	96492171	harbor1	chr7	96302750	96302921	DNA/hAT-Charlie	992	+	86	96302836	10665
chr7	96292171	96492171	harbor1	chr7	96315324	96315440	DNA/hAT-Charlie	556	+	58	96315382	23211
chr7	96292171	96492171	harbor1	chr7	96332149	96332461	DNA/hAT-Charlie	1273	+	156	96332305	40134
chr7	96292171	96492171	harbor1	chr7	96339439	96339786	DNA/hAT-Charlie	2105	+	174	96339613	47442
chr7	96292171	96492171	harbor1	chr7	96344635	96344867	DNA/hAT-Charlie	949	+	116	96344751	52580
chr7	96292171	96492171	harbor1	chr7	96377476	96377651	DNA/hAT-Charlie	475	+	88	96377564	85393
chr7	96292171	96492171	harbor1	chr7	96385616	96385910	DNA/hAT-Charlie	591	+	147	96385763	93592
chr7	448014	648014	harbor1	chr7	448493	448924	DNA/hAT-Charlie	1492	+	216	448709	695
chr7	448014	648014	harbor1	chr7	524204	524423	DNA/hAT-Charlie	734	+	110	524314	76300
chr7	24450005	24650005	harbor1	chr7	24459550	24459886	DNA/hAT-Charlie	809	+	168	24459718	9713
chr7	24450005	24650005	harbor1	chr7	24506055	24506261	DNA/hAT-Charlie	834	+	103	24506158	56153
chr7	154685715	154885715	harbor1	chr7	154691184	154691531	DNA/hAT-Charlie	929	+	174	154691358	5643
chr7	154685715	154885715	harbor1	chr7	154731620	154732025	DNA/hAT-Charlie	634	+	202	154731822	46107
chr7	48058805	48258805	harbor1	chr7	48079994	48080493	DNA/hAT-Charlie	3154	+	250	48080244	21439
chr7	48058805	48258805	harbor1	chr7	48098908	48099079	DNA/hAT-Charlie	690	+	86	48098994	40189
chr7	48058805	48258805	harbor1	chr7	48151207	48151385	DNA/hAT-Charlie	633	+	89	48151296	92491
chr7	48058805	48258805	harbor1	chr7	48070595	48071107	DNA/hAT-Charlie	1847	+	256	48070851	12046
chr7	96132442	96332442	harbor1	chr7	96207926	96208073	DNA/hAT-Charlie	544	+	74	96208000	75558
chr7	84683775	84883775	harbor1	chr7	84761905	84762229	DNA/hAT-Charlie	1435	+	162	84762067	78292
chr7	53309170	53509170	harbor1	chr7	53313957	53314153	DNA/hAT-Charlie	471	+	98	53314055	4885
chr7	53309170	53509170	harbor1	chr7	53316857	53317174	DNA/hAT-Charlie	1043	+	158	53317015	7845
chr7	53309170	53509170	harbor1	chr7	53345772	53345967	DNA/hAT-Charlie	833	+	98	53345870	36700
chr7	64026064	64226064	harbor1	chr7	64068397	64068549	DNA/hAT-Charlie	554	+	76	64068473	42409
chr7	64026064	64226064	harbor1	chr7	64119359	64119472	DNA/hAT-Charlie	506	+	56	64119415	93351
chr7	131533257	131733257	harbor1	chr7	131582690	131582829	DNA/hAT-Charlie	450	+	70	131582760	49503
chr7	131533257	131733257	harbor1	chr7	131614298	131614556	DNA/hAT-Charlie	4532	+	129	131614427	81170
chr7	131533257	131733257	harbor1	chr7	131614859	131615609	DNA/hAT-Charlie	4532	+	375	131615234	81977
chr7	131533257	131733257	harbor1	chr7	131615939	131616131	DNA/hAT-Charlie	4532	+	96	131616035	82778
chr7	131533257	131733257	harbor1	chr7	131616431	131616526	DNA/hAT-Charlie	4532	+	48	131616479	83222
chr7	131533257	131733257	harbor1	chr7	131616832	131616873	DNA/hAT-Charlie	4532	+	20	131616852	83595
chr7	131533257	131733257	harbor1	chr7	131622796	131622920	DNA/hAT-Charlie	473	+	62	131622858	89601
chr7	113236368	113436368	harbor1	chr7	113248258	113248607	DNA/hAT-Charlie	1176	+	174	113248432	12064
chr7	122566879	122766879	harbor1	chr7	122579185	122579370	DNA/hAT-Charlie	777	+	92	122579277	12398
chr7	138885883	139085883	harbor1	chr7	138887406	138889197	DNA/hAT-Charlie	4063	+	896	138888302	2419
chr7	138885883	139085883	harbor1	chr7	138932694	138932852	DNA/hAT-Charlie	668	+	79	138932773	46890
chr7	130527703	130727703	harbor1	chr7	130562572	130562846	DNA/hAT-Charlie	850	+	137	130562709	35006
chr7	130527703	130727703	harbor1	chr7	130562855	130563043	DNA/hAT-Charlie	933	+	94	130562949	35246
chr7	130527703	130727703	harbor1	chr7	130619133	130619334	DNA/hAT-Charlie	832	+	100	130619233	91530
chr7	50832760	51032760	harbor1	chr7	50925469	50925655	DNA/hAT-Charlie	719	+	93	50925562	92802
chr7	114981682	115181682	harbor1	chr7	114999825	114999999	DNA/hAT-Charlie	624	+	87	114999912	18230
chr7	114981682	115181682	harbor1	chr7	115043576	115044916	DNA/hAT-Charlie	4710	+	670	115044246	62564
chr7	141415075	141615075	harbor1	chr7	141440298	141440401	DNA/hAT-Charlie	464	+	52	141440350	25275
chr7	141415075	141615075	harbor1	chr7	141468191	141468328	DNA/hAT-Charlie	691	+	68	141468259	53184
chr7	141415075	141615075	harbor1	chr7	141484337	141484484	DNA/hAT-Charlie	771	+	74	141484411	69336
chr7	11177442	11377442	harbor1	chr7	11187307	11187517	DNA/hAT-Charlie	494	+	105	11187412	9970
chr7	11177442	11377442	harbor1	chr7	11222970	11223132	DNA/hAT-Charlie	848	+	81	11223051	45609
chr7	11257789	11457789	harbor1	chr7	11287698	11287978	DNA/hAT-Charlie	657	+	140	11287838	30049
chr7	11257789	11457789	harbor1	chr7	11287982	11288194	DNA/hAT-Charlie	557	+	106	11288088	30299
chr7	11257789	11457789	harbor1	chr7	11295613	11296915	DNA/hAT-Charlie	4436	+	651	11296264	38475
chr7	11257789	11457789	harbor1	chr7	11318283	11318473	DNA/hAT-Charlie	826	+	95	11318378	60589
chr7	31049012	31249012	harbor1	chr7	31049130	31049309	DNA/hAT-Charlie	619	+	90	31049220	208
chr7	31049012	31249012	harbor1	chr7	31066599	31066767	DNA/hAT-Charlie	652	+	84	31066683	17671
chr7	31049012	31249012	harbor1	chr7	31099291	31099480	DNA/hAT-Charlie	1030	+	94	31099385	50373
chr7	31049012	31249012	harbor1	chr7	31136375	31136587	DNA/hAT-Charlie	757	+	106	31136481	87469
chr7	110399715	110599715	harbor1	chr7	110497761	110497932	DNA/hAT-Charlie	441	+	86	110497847	98132
chr7	45157333	45357333	harbor1	chr7	45194073	45194241	DNA/hAT-Charlie	584	+	84	45194157	36824
chr7	13933401	14133401	harbor1	chr7	13948519	13948742	DNA/hAT-Charlie	1149	+	112	13948631	15230
chr7	13933401	14133401	harbor1	chr7	13971362	13971650	DNA/hAT-Charlie	604	+	144	13971506	38105
chr7	13933401	14133401	harbor1	chr7	13994569	13994858	DNA/hAT-Charlie	740	+	144	13994713	61312
chr7	13933401	14133401	harbor1	chr7	14027392	14027598	DNA/hAT-Charlie	1096	+	103	14027495	94094
chr8	83500485	83700485	harbor1	chr8	83524726	83525069	DNA/hAT-Charlie	787	+	172	83524898	24413
chr8	83500485	83700485	harbor1	chr8	83583225	83583421	DNA/hAT-Charlie	490	+	98	83583323	82838
chr8	137967819	138167819	harbor1	chr8	137985056	137985580	DNA/hAT-Charlie	3813	+	262	137985318	17499
chr8	137967819	138167819	harbor1	chr8	137997060	137997519	DNA/hAT-Charlie	2574	+	230	137997290	29471
chr8	137967819	138167819	harbor1	chr8	138049557	138049765	DNA/hAT-Charlie	818	+	104	138049661	81842
chr8	137967819	138167819	harbor1	chr8	138051424	138051560	DNA/hAT-Charlie	436	+	68	138051492	83673
chr8	16027209	16227209	harbor1	chr8	16110699	16110863	DNA/hAT-Charlie	463	+	82	16110781	83572
chr8	16027209	16227209	harbor1	chr8	16117048	16117541	DNA/hAT-Charlie	3435	+	246	16117294	90085
chr8	16027209	16227209	harbor1	chr8	16117538	16118023	DNA/hAT-Charlie	3293	+	242	16117780	90571
chr8	118770668	118970668	harbor1	chr8	118844761	118844858	DNA/hAT-Charlie	395	+	48	118844809	74141
chr8	118770668	118970668	harbor1	chr8	118847970	118848167	DNA/hAT-Charlie	649	+	98	118848068	77400
chr8	61597659	61797659	harbor1	chr8	61618142	61618387	DNA/hAT-Charlie	501	+	122	61618264	20605
chr8	61597659	61797659	harbor1	chr8	61646174	61646346	DNA/hAT-Charlie	734	+	86	61646260	48601
chr8	61597659	61797659	harbor1	chr8	61683635	61683794	DNA/hAT-Charlie	418	+	80	61683715	86056
chr8	81524994	81724994	harbor1	chr8	81536753	81536967	DNA/hAT-Charlie	1081	+	107	81536860	11866
chr8	81524994	81724994	harbor1	chr8	81540112	81540290	DNA/hAT-Charlie	866	+	89	81540201	15207
chr8	81524994	81724994	harbor1	chr8	81541206	81541371	DNA/hAT-Charlie	558	+	82	81541288	16294
chr8	81524994	81724994	harbor1	chr8	81548090	81548265	DNA/hAT-Charlie	606	+	88	81548178	23184
chr8	81524994	81724994	harbor1	chr8	81589986	81590374	DNA/hAT-Charlie	529	+	194	81590180	65186
chr8	81524994	81724994	harbor1	chr8	81602543	81602708	DNA/hAT-Charlie	463	+	82	81602625	77631
chr8	81524994	81724994	harbor1	chr8	81575774	81575988	DNA/hAT-Charlie	1165	+	107	81575881	50887
chr8	21177035	21377035	harbor1	chr8	21186736	21186926	DNA/hAT-Charlie	568	+	95	21186831	9796
chr8	21177035	21377035	harbor1	chr8	21229951	21230172	DNA/hAT-Charlie	642	+	110	21230061	53026
chr8	21177035	21377035	harbor1	chr8	21236299	21236509	DNA/hAT-Charlie	596	+	105	21236404	59369
chr8	21177035	21377035	harbor1	chr8	21272565	21272726	DNA/hAT-Charlie	626	+	80	21272645	95610
chr8	128040241	128240241	harbor1	chr8	128059359	128059703	DNA/hAT-Charlie	1232	+	172	128059531	19290
chr8	128040241	128240241	harbor1	chr8	128094151	128094587	DNA/hAT-Charlie	947	+	218	128094369	54128
chr8	128040241	128240241	harbor1	chr8	128095528	128095701	DNA/hAT-Charlie	964	+	86	128095614	55373
chr8	128040241	128240241	harbor1	chr8	128097388	128097557	DNA/hAT-Charlie	703	+	84	128097472	57231
chr8	128040241	128240241	harbor1	chr8	128115959	128116046	DNA/hAT-Charlie	950	+	44	128116003	75762
chr8	128040241	128240241	harbor1	chr8	128116074	128116218	DNA/hAT-Charlie	950	+	72	128116146	75905
chr8	54940266	55140266	harbor1	chr8	54946164	54947679	DNA/hAT-Charlie	2841	+	758	54946922	6656
chr8	54940266	55140266	harbor1	chr8	54968116	54968411	DNA/hAT-Charlie	1349	+	148	54968264	27998
chr8	142056466	142256466	harbor1	chr8	142117772	142117947	DNA/hAT-Charlie	745	+	88	142117860	61394
chr8	81327795	81527795	harbor1	chr8	81358841	81359187	DNA/hAT-Charlie	1077	+	173	81359014	31219
chr8	98789680	98989680	harbor1	chr8	98821055	98821405	DNA/hAT-Charlie	2000	+	175	98821230	31550
chr8	103204177	103404177	harbor1	chr8	103205636	103205768	DNA/hAT-Charlie	452	+	66	103205702	1525
chr8	103204177	103404177	harbor1	chr8	103231810	103232014	DNA/hAT-Charlie	391	+	102	103231912	27735
chr8	103204177	103404177	harbor1	chr8	103277675	103277853	DNA/hAT-Charlie	805	+	89	103277764	73587
chr8	100269421	100469421	harbor1	chr8	100305474	100305612	DNA/hAT-Charlie	679	+	69	100305543	36122
chr8	100269421	100469421	harbor1	chr8	100312233	100312321	DNA/hAT-Charlie	479	+	44	100312277	42856
chr8	62940653	63140653	harbor1	chr8	62995830	62996007	DNA/hAT-Charlie	984	+	88	62995918	55265
chr8	50117492	50317492	harbor1	chr8	50140944	50141053	DNA/hAT-Charlie	470	+	54	50140998	23506
chr8	73742143	73942143	harbor1	chr8	73759677	73759782	DNA/hAT-Charlie	448	+	52	73759729	17586
chr8	73742143	73942143	harbor1	chr8	73760071	73760226	DNA/hAT-Charlie	448	+	78	73760149	18006
chr8	73742143	73942143	harbor1	chr8	73760927	73761124	DNA/hAT-Charlie	736	+	98	73761025	18882
chr8	73742143	73942143	harbor1	chr8	73813578	73813750	DNA/hAT-Charlie	481	+	86	73813664	71521
chr8	73742143	73942143	harbor1	chr8	73814033	73814201	DNA/hAT-Charlie	481	+	84	73814117	71974
chr8	73742143	73942143	harbor1	chr8	73814263	73814527	DNA/hAT-Charlie	1037	+	132	73814395	72252
chr8	73742143	73942143	harbor1	chr8	73814818	73815094	DNA/hAT-Charlie	1037	+	138	73814956	72813
chr8	73742143	73942143	harbor1	chr8	73815398	73815515	DNA/hAT-Charlie	1037	+	58	73815456	73313
chr8	37467762	37667762	harbor1	chr8	37489184	37489366	DNA/hAT-Charlie	404	+	91	37489275	21513
chr8	37467762	37667762	harbor1	chr8	37503493	37503658	DNA/hAT-Charlie	404	+	82	37503575	35813
chr8	37467762	37667762	harbor1	chr8	37512026	37512209	DNA/hAT-Charlie	537	+	92	37512118	44356
chr8	37467762	37667762	harbor1	chr8	37542924	37543085	DNA/hAT-Charlie	424	+	80	37543004	75242
chr8	11579269	11779269	harbor1	chr8	11585929	11586467	DNA/hAT-Charlie	3641	+	269	11586198	6929
chr8	11579269	11779269	harbor1	chr8	11626806	11626968	DNA/hAT-Charlie	408	+	81	11626887	47618
chr8	11579269	11779269	harbor1	chr8	11649390	11649544	DNA/hAT-Charlie	753	+	77	11649467	70198
chr8	11579269	11779269	harbor1	chr8	11651377	11651538	DNA/hAT-Charlie	630	+	80	11651457	72188
chr8	48423010	48623010	harbor1	chr8	48495619	48495817	DNA/hAT-Charlie	694	+	99	48495718	72708
chr8	141309044	141509044	harbor1	chr8	141407496	141407562	DNA/hAT-Charlie	1185	+	33	141407529	98485
chr8	141309044	141509044	harbor1	chr8	141407867	141408012	DNA/hAT-Charlie	1185	+	72	141407939	98895
chr8	10170685	10370685	harbor1	chr8	10202501	10202686	DNA/hAT-Charlie	441	+	92	10202593	31908
chr8	10170685	10370685	harbor1	chr8	10246051	10246275	DNA/hAT-Charlie	828	+	112	10246163	75478
chr8	106900940	107100940	harbor1	chr8	106970855	106971050	DNA/hAT-Charlie	788	+	98	106970953	70013
chr8	106900940	107100940	harbor1	chr8	106992551	106992617	DNA/hAT-Charlie	432	+	33	106992584	91644
chr8	106900940	107100940	harbor1	chr8	106992684	106992748	DNA/hAT-Charlie	507	+	32	106992716	91776
chr8	106900940	107100940	harbor1	chr8	106999478	106999805	DNA/hAT-Charlie	1946	+	164	106999642	98702
chr8	35542346	35742346	harbor1	chr8	35578447	35578607	DNA/hAT-Charlie	417	+	80	35578527	36181
chr8	55565230	55765230	harbor1	chr8	55571486	55571970	DNA/hAT-Charlie	3181	+	242	55571728	6498
chr8	11392644	11592644	harbor1	chr8	11441322	11441475	DNA/hAT-Charlie	547	+	76	11441398	48754
chr8	68603363	68803363	harbor1	chr8	68643799	68644025	DNA/hAT-Charlie	428	+	113	68643912	40549
chr8	68603363	68803363	harbor1	chr8	68671255	68671803	DNA/hAT-Charlie	853	+	274	68671529	68166
chr8	68603363	68803363	harbor1	chr8	68699022	68699185	DNA/hAT-Charlie	774	+	82	68699104	95741
chr8	113848735	114048735	harbor1	chr8	113873229	113873601	DNA/hAT-Charlie	1004	+	186	113873415	24680
chr8	113848735	114048735	harbor1	chr8	113873599	113873930	DNA/hAT-Charlie	1222	+	166	113873765	25030
chr8	113848735	114048735	harbor1	chr8	113893296	113893480	DNA/hAT-Charlie	437	+	92	113893388	44653
chr8	123967728	124167728	harbor1	chr8	124032846	124032999	DNA/hAT-Charlie	401	+	76	124032922	65194
chr8	123967728	124167728	harbor1	chr8	124052209	124052397	DNA/hAT-Charlie	434	+	94	124052303	84575
chr8	123967728	124167728	harbor1	chr8	124060935	124061117	DNA/hAT-Charlie	861	+	91	124061026	93298
chr8	104945182	105145182	harbor1	chr8	104978882	104979161	DNA/hAT-Charlie	589	+	140	104979022	33840
chr8	134315803	134515803	harbor1	chr8	134326445	134326656	DNA/hAT-Charlie	1096	+	106	134326551	10748
chr8	134315803	134515803	harbor1	chr8	134364099	134364246	DNA/hAT-Charlie	608	+	74	134364173	48370
chr8	134315803	134515803	harbor1	chr8	134375301	134375461	DNA/hAT-Charlie	648	+	80	134375381	59578
chr8	134315803	134515803	harbor1	chr8	134388660	134388818	DNA/hAT-Charlie	430	+	79	134388739	72936
chr8	134315803	134515803	harbor1	chr8	134401715	134402050	DNA/hAT-Charlie	2352	+	168	134401883	86080
chr8	95963894	96163894	harbor1	chr8	96008397	96008681	DNA/hAT-Charlie	916	+	142	96008539	44645
chr8	58927460	59127460	harbor1	chr8	58974102	58974316	DNA/hAT-Charlie	839	+	107	58974209	46749
chr8	58927460	59127460	harbor1	chr8	58988281	58988499	DNA/hAT-Charlie	819	+	109	58988390	60930
chr8	11806412	12006412	harbor1	chr8	11832629	11832767	DNA/hAT-Charlie	671	+	69	11832698	26286
chr8	11806412	12006412	harbor1	chr8	11833644	11833812	DNA/hAT-Charlie	705	+	84	11833728	27316
chr8	11806412	12006412	harbor1	chr8	11840215	11840525	DNA/hAT-Charlie	1751	+	155	11840370	33958
chr8	76016316	76216316	harbor1	chr8	76099763	76099925	DNA/hAT-Charlie	464	+	81	76099844	83528
chr8	70895821	71095821	harbor1	chr8	70929165	70929334	DNA/hAT-Charlie	539	+	84	70929249	33428
chr8	70895821	71095821	harbor1	chr8	70952830	70953050	DNA/hAT-Charlie	758	+	110	70952940	57119
chr8	3765528	3965528	harbor1	chr8	3814474	3814680	DNA/hAT-Charlie	708	+	103	3814577	49049
chr8	3765528	3965528	harbor1	chr8	3824481	3824784	DNA/hAT-Charlie	954	+	152	3824633	59105
chr8	117704130	117904130	harbor1	chr8	117729827	117730025	DNA/hAT-Charlie	1131	+	99	117729926	25796
chr8	117704130	117904130	harbor1	chr8	117758221	117758374	DNA/hAT-Charlie	659	+	76	117758297	54167
chr8	117704130	117904130	harbor1	chr8	117759646	117759760	DNA/hAT-Charlie	409	+	57	117759703	55573
chr8	117704130	117904130	harbor1	chr8	117760016	117761159	DNA/hAT-Charlie	4708	+	572	117760588	56458
chr8	3381091	3581091	harbor1	chr8	3444504	3444632	DNA/hAT-Charlie	558	+	64	3444568	63477
chr8	3381091	3581091	harbor1	chr8	3462320	3462795	DNA/hAT-Charlie	2498	+	238	3462558	81467
chr8	90770215	90970215	harbor1	chr8	90860091	90860300	DNA/hAT-Charlie	410	+	104	90860195	89980
chr8	90770215	90970215	harbor1	chr8	90863965	90864203	DNA/hAT-Charlie	763	+	119	90864084	93869
chr8	32405275	32605275	harbor1	chr8	32416494	32416636	DNA/hAT-Charlie	516	+	71	32416565	11290
chr8	32405275	32605275	harbor1	chr8	32425459	32425615	DNA/hAT-Charlie	616	+	78	32425537	20262
chr8	32405275	32605275	harbor1	chr8	32489950	32490027	DNA/hAT-Charlie	869	+	38	32489988	84713
chr8	32405275	32605275	harbor1	chr8	32490318	32490424	DNA/hAT-Charlie	869	+	53	32490371	85096
chr8	51485876	51685876	harbor1	chr8	51507667	51507897	DNA/hAT-Charlie	904	+	115	51507782	21906
chr8	90115395	90315395	harbor1	chr8	90127923	90128060	DNA/hAT-Charlie	406	+	68	90127991	12596
chr8	90115395	90315395	harbor1	chr8	90157702	90157871	DNA/hAT-Charlie	844	+	84	90157786	42391
chr8	90115395	90315395	harbor1	chr8	90199416	90199634	DNA/hAT-Charlie	1530	+	109	90199525	84130
chr8	90115395	90315395	harbor1	chr8	90128196	90129893	DNA/hAT-Charlie	3816	+	848	90129044	13649
chr8	48267773	48467773	harbor1	chr8	48304636	48304825	DNA/hAT-Charlie	809	+	94	48304730	36957
chr8	48267773	48467773	harbor1	chr8	48326020	48326184	DNA/hAT-Charlie	658	+	82	48326102	58329
chr8	131114305	131314305	harbor1	chr8	131125075	131125312	DNA/hAT-Charlie	919	+	118	131125193	10888
chr8	7323207	7523207	harbor1	chr8	7366823	7367031	DNA/hAT-Charlie	576	+	104	7366927	43720
chr8	67057064	67257064	harbor1	chr8	67114971	67115186	DNA/hAT-Charlie	701	+	108	67115079	58015
chr8	136524334	136724334	harbor1	chr8	136617418	136617839	DNA/hAT-Charlie	579	+	210	136617628	93294
chr8	1780587	1980587	harbor1	chr8	1880253	1880700	DNA/hAT-Charlie	1492	+	224	1880477	99890
chr8	12301956	12501956	harbor1	chr8	12308661	12308895	DNA/hAT-Charlie	517	+	117	12308778	6822
chr8	12301956	12501956	harbor1	chr8	12341720	12341999	DNA/hAT-Charlie	437	+	140	12341860	39904
chr8	12301956	12501956	harbor1	chr8	12342040	12342190	DNA/hAT-Charlie	431	+	75	12342115	40159
chr8	131790789	131990789	harbor1	chr8	131800235	131800436	DNA/hAT-Charlie	804	+	100	131800335	9546
chr8	131790789	131990789	harbor1	chr8	131819834	131820042	DNA/hAT-Charlie	1080	+	104	131819938	29149
chr8	131790789	131990789	harbor1	chr8	131889876	131890105	DNA/hAT-Charlie	424	+	114	131889990	99201
chr8	107858652	108058652	harbor1	chr8	107888988	107889098	DNA/hAT-Charlie	441	+	55	107889043	30391
chr8	107858652	108058652	harbor1	chr8	107896280	107896490	DNA/hAT-Charlie	1010	+	105	107896385	37733
chr8	107858652	108058652	harbor1	chr8	107896752	107896991	DNA/hAT-Charlie	435	+	120	107896872	38220
chr8	107858652	108058652	harbor1	chr8	107897060	107897213	DNA/hAT-Charlie	409	+	76	107897136	38484
chr8	37455127	37655127	harbor1	chr8	37489184	37489366	DNA/hAT-Charlie	404	+	91	37489275	34148
chr8	37455127	37655127	harbor1	chr8	37503493	37503658	DNA/hAT-Charlie	404	+	82	37503575	48448
chr8	37455127	37655127	harbor1	chr8	37512026	37512209	DNA/hAT-Charlie	537	+	92	37512118	56991
chr8	37455127	37655127	harbor1	chr8	37542924	37543085	DNA/hAT-Charlie	424	+	80	37543004	87877
chr8	115522799	115722799	harbor1	chr8	115608665	115608852	DNA/hAT-Charlie	466	+	94	115608759	85960
chr8	115522799	115722799	harbor1	chr8	115609146	115609196	DNA/hAT-Charlie	466	+	25	115609171	86372
chr8	26423286	26623286	harbor1	chr8	26441824	26442002	DNA/hAT-Charlie	530	+	89	26441913	18627
chr8	74216027	74416027	harbor1	chr8	74250565	74250733	DNA/hAT-Charlie	1165	+	84	74250649	34622
chr8	50519265	50719265	harbor1	chr8	50565978	50566186	DNA/hAT-Charlie	488	+	104	50566082	46817
chr8	8556075	8756075	harbor1	chr8	8609268	8609410	DNA/hAT-Charlie	511	+	71	8609339	53264
chr8	69917784	70117784	harbor1	chr8	69921408	69921748	DNA/hAT-Charlie	688	+	170	69921578	3794
chr8	69917784	70117784	harbor1	chr8	69947765	69947846	DNA/hAT-Charlie	492	+	40	69947805	30021
chr8	69917784	70117784	harbor1	chr8	69948164	69948197	DNA/hAT-Charlie	492	+	16	69948180	30396
chr8	69917784	70117784	harbor1	chr8	69949029	69949291	DNA/hAT-Charlie	809	+	131	69949160	31376
chr8	69917784	70117784	harbor1	chr8	69980125	69980312	DNA/hAT-Charlie	913	+	94	69980219	62435
chr8	69917784	70117784	harbor1	chr8	70015553	70015989	DNA/hAT-Charlie	2552	+	218	70015771	97987
chr8	69917784	70117784	harbor1	chr8	70016282	70016294	DNA/hAT-Charlie	2552	+	6	70016288	98504
chr8	69917784	70117784	harbor1	chr8	70016399	70016873	DNA/hAT-Charlie	2552	+	237	70016636	98852
chr8	69917784	70117784	harbor1	chr8	70016872	70017043	DNA/hAT-Charlie	479	+	86	70016958	99174
chr8	69917784	70117784	harbor1	chr8	70017713	70017797	DNA/hAT-Charlie	792	+	42	70017755	99971
chr8	37247528	37447528	harbor1	chr8	37264925	37265038	DNA/hAT-Charlie	448	+	56	37264981	17453
chr8	37247528	37447528	harbor1	chr8	37307368	37307691	DNA/hAT-Charlie	1621	+	162	37307530	60002
chr8	37247528	37447528	harbor1	chr8	37316212	37316529	DNA/hAT-Charlie	1375	+	158	37316370	68842
chr8	117779678	117979678	harbor1	chr8	117841929	117842118	DNA/hAT-Charlie	1174	+	94	117842023	62345
chr8	117779678	117979678	harbor1	chr8	117860587	117860868	DNA/hAT-Charlie	965	+	140	117860727	81049
chr8	90269173	90469173	harbor1	chr8	90302796	90302919	DNA/hAT-Charlie	649	+	62	90302858	33685
chr8	62928292	63128292	harbor1	chr8	62929741	62929958	DNA/hAT-Charlie	1492	+	108	62929849	1557
chr8	62928292	63128292	harbor1	chr8	62995830	62996007	DNA/hAT-Charlie	984	+	88	62995918	67626
chr8	83533030	83733030	harbor1	chr8	83583225	83583421	DNA/hAT-Charlie	490	+	98	83583323	50293
chr8	83533030	83733030	harbor1	chr8	83630189	83630494	DNA/hAT-Charlie	1889	+	152	83630341	97311
chr8	21352920	21552920	harbor1	chr8	21371260	21371465	DNA/hAT-Charlie	891	+	102	21371362	18442
chr8	21352920	21552920	harbor1	chr8	21371579	21371732	DNA/hAT-Charlie	621	+	76	21371655	18735
chr8	21352920	21552920	harbor1	chr8	21372100	21372665	DNA/hAT-Charlie	915	+	282	21372382	19462
chr8	21352920	21552920	harbor1	chr8	21403071	21403343	DNA/hAT-Charlie	433	+	136	21403207	50287
chr8	23042871	23242871	harbor1	chr8	23114300	23114489	DNA/hAT-Charlie	547	+	94	23114394	71523
chr8	88910051	89110051	harbor1	chr8	88937091	88937405	DNA/hAT-Charlie	1317	+	157	88937248	27197
chr8	88910051	89110051	harbor1	chr8	88956648	88956930	DNA/hAT-Charlie	899	+	141	88956789	46738
chr8	88910051	89110051	harbor1	chr8	88986581	88986702	DNA/hAT-Charlie	409	+	60	88986641	76590
chr8	88910051	89110051	harbor1	chr8	88994799	88994985	DNA/hAT-Charlie	585	+	93	88994892	84841
chr8	104722753	104922753	harbor1	chr8	104753809	104753862	DNA/hAT-Charlie	758	+	26	104753835	31082
chr8	104722753	104922753	harbor1	chr8	104754172	104754323	DNA/hAT-Charlie	758	+	76	104754248	31495
chr8	16111660	16311660	harbor1	chr8	16117048	16117541	DNA/hAT-Charlie	3435	+	246	16117294	5634
chr8	16111660	16311660	harbor1	chr8	16117538	16118023	DNA/hAT-Charlie	3293	+	242	16117780	6120
chr8	16111660	16311660	harbor1	chr8	16147880	16148053	DNA/hAT-Charlie	760	+	86	16147966	36306
chr8	137850784	138050784	harbor1	chr8	137854269	137854360	DNA/hAT-Charlie	398	+	46	137854315	3531
chr8	137850784	138050784	harbor1	chr8	137856586	137856742	DNA/hAT-Charlie	586	+	78	137856664	5880
chr8	137850784	138050784	harbor1	chr8	137856787	137856869	DNA/hAT-Charlie	398	+	41	137856828	6044
chr8	137850784	138050784	harbor1	chr8	137857086	137857279	DNA/hAT-Charlie	608	+	96	137857182	6398
chr8	137850784	138050784	harbor1	chr8	137928803	137928995	DNA/hAT-Charlie	555	+	96	137928899	78115
chr8	82150746	82350746	harbor1	chr8	82195680	82195935	DNA/hAT-Charlie	718	+	128	82195808	45062
chr8	82150746	82350746	harbor1	chr8	82195927	82196095	DNA/hAT-Charlie	576	+	84	82196011	45265
chr8	123962967	124162967	harbor1	chr8	124032846	124032999	DNA/hAT-Charlie	401	+	76	124032922	69955
chr8	123962967	124162967	harbor1	chr8	124052209	124052397	DNA/hAT-Charlie	434	+	94	124052303	89336
chr8	123962967	124162967	harbor1	chr8	124060935	124061117	DNA/hAT-Charlie	861	+	91	124061026	98059
chr8	31111004	31311004	harbor1	chr8	31128927	31128970	DNA/hAT-Charlie	878	+	22	31128949	17945
chr8	31111004	31311004	harbor1	chr8	31129281	31129442	DNA/hAT-Charlie	878	+	80	31129361	18357
chr8	31111004	31311004	harbor1	chr8	31174283	31174648	DNA/hAT-Charlie	1761	+	182	31174465	63461
chr8	31111004	31311004	harbor1	chr8	31174999	31175154	DNA/hAT-Charlie	3477	+	78	31175077	64073
chr8	31111004	31311004	harbor1	chr8	31175451	31176045	DNA/hAT-Charlie	3477	+	297	31175748	64744
chr8	31111004	31311004	harbor1	chr8	31187316	31187483	DNA/hAT-Charlie	852	+	84	31187400	76396
chr8	31111004	31311004	harbor1	chr8	31187767	31187807	DNA/hAT-Charlie	852	+	20	31187787	76783
chr8	53614207	53814207	harbor1	chr8	53654062	53654620	DNA/hAT-Charlie	5211	+	279	53654341	40134
chr8	53614207	53814207	harbor1	chr8	53654937	53655771	DNA/hAT-Charlie	5211	+	417	53655354	41147
chr8	53614207	53814207	harbor1	chr8	53656090	53656121	DNA/hAT-Charlie	5211	+	16	53656106	41899
chr8	53614207	53814207	harbor1	chr8	53661588	53661807	DNA/hAT-Charlie	1593	+	110	53661698	47491
chr8	53614207	53814207	harbor1	chr8	53706796	53707309	DNA/hAT-Charlie	3512	+	256	53707052	92845
chr8	104614186	104814186	harbor1	chr8	104639581	104639755	DNA/hAT-Charlie	797	+	87	104639668	25482
chr8	37447052	37647052	harbor1	chr8	37489184	37489366	DNA/hAT-Charlie	404	+	91	37489275	42223
chr8	37447052	37647052	harbor1	chr8	37503493	37503658	DNA/hAT-Charlie	404	+	82	37503575	56523
chr8	37447052	37647052	harbor1	chr8	37512026	37512209	DNA/hAT-Charlie	537	+	92	37512118	65066
chr8	37447052	37647052	harbor1	chr8	37542924	37543085	DNA/hAT-Charlie	424	+	80	37543004	95952
chr8	110217538	110417538	harbor1	chr8	110266903	110267100	DNA/hAT-Charlie	681	+	98	110267001	49463
chr8	110217538	110417538	harbor1	chr8	110279325	110279556	DNA/hAT-Charlie	407	+	116	110279441	61903
chr8	19249016	19449016	harbor1	chr8	19279439	19279628	DNA/hAT-Charlie	797	+	94	19279533	30517
chr8	19249016	19449016	harbor1	chr8	19323153	19323381	DNA/hAT-Charlie	1222	+	114	19323267	74251
chr8	19249016	19449016	harbor1	chr8	19323681	19323741	DNA/hAT-Charlie	1222	+	30	19323711	74695
chr8	19249016	19449016	harbor1	chr8	19346214	19346667	DNA/hAT-Charlie	2705	+	226	19346440	97424
chr8	38431829	38631829	harbor1	chr8	38444084	38444220	DNA/hAT-Charlie	479	+	68	38444152	12323
chr8	38431829	38631829	harbor1	chr8	38462006	38462223	DNA/hAT-Charlie	900	+	108	38462114	30285
chr8	38431829	38631829	harbor1	chr8	38462514	38462603	DNA/hAT-Charlie	900	+	44	38462558	30729
chr8	120368589	120568589	harbor1	chr8	120456779	120456931	DNA/hAT-Charlie	639	+	76	120456855	88266
chr8	120368589	120568589	harbor1	chr8	120462719	120462915	DNA/hAT-Charlie	463	+	98	120462817	94228
chr8	19354063	19554063	harbor1	chr8	19403886	19404097	DNA/hAT-Charlie	1104	+	106	19403992	49929
chr8	19354063	19554063	harbor1	chr8	19417154	19417272	DNA/hAT-Charlie	529	+	59	19417213	63150
chr8	19354063	19554063	harbor1	chr8	19433700	19433896	DNA/hAT-Charlie	1221	+	98	19433798	79735
chr8	19354063	19554063	harbor1	chr8	19435542	19435729	DNA/hAT-Charlie	598	+	94	19435636	81573
chr8	122470423	122670423	harbor1	chr8	122507781	122508050	DNA/hAT-Charlie	415	+	134	122507915	37492
chr8	122470423	122670423	harbor1	chr8	122530282	122530485	DNA/hAT-Charlie	600	+	102	122530384	59961
chr8	122470423	122670423	harbor1	chr8	122533773	122534258	DNA/hAT-Charlie	3364	+	242	122534015	63592
chr8	122470423	122670423	harbor1	chr8	122564178	122564394	DNA/hAT-Charlie	1042	+	108	122564286	93863
chr8	141326002	141526002	harbor1	chr8	141407496	141407562	DNA/hAT-Charlie	1185	+	33	141407529	81527
chr8	141326002	141526002	harbor1	chr8	141407867	141408012	DNA/hAT-Charlie	1185	+	72	141407939	81937
chr8	85534795	85734795	harbor1	chr8	85546087	85546164	DNA/hAT-Charlie	398	+	38	85546125	11330
chr8	85534795	85734795	harbor1	chr8	85546338	85546476	DNA/hAT-Charlie	876	+	69	85546407	11612
chr8	85534795	85734795	harbor1	chr8	85558506	85558722	DNA/hAT-Charlie	1002	+	108	85558614	23819
chr8	85534795	85734795	harbor1	chr8	85561143	85561430	DNA/hAT-Charlie	1084	+	144	85561287	26492
chr8	85534795	85734795	harbor1	chr8	85608731	85609076	DNA/hAT-Charlie	1082	+	172	85608903	74108
chr8	85534795	85734795	harbor1	chr8	85621436	85621665	DNA/hAT-Charlie	472	+	114	85621550	86755
chr8	85534795	85734795	harbor1	chr8	85629550	85629728	DNA/hAT-Charlie	817	+	89	85629639	94844
chr8	85534795	85734795	harbor1	chr8	85629730	85630014	DNA/hAT-Charlie	711	+	142	85629872	95077
chr8	26909540	27109540	harbor1	chr8	26920229	26920429	DNA/hAT-Charlie	816	+	100	26920329	10789
chr8	26909540	27109540	harbor1	chr8	26960876	26961203	DNA/hAT-Charlie	1836	+	164	26961040	51500
chr8	26909540	27109540	harbor1	chr8	26982214	26982363	DNA/hAT-Charlie	422	+	74	26982288	72748
chr8	26909540	27109540	harbor1	chr8	26993032	26993735	DNA/hAT-Charlie	1478	+	352	26993384	83844
chr8	26909540	27109540	harbor1	chr8	26994022	26994159	DNA/hAT-Charlie	558	+	68	26994090	84550
chr8	26909540	27109540	harbor1	chr8	26994737	26994801	DNA/hAT-Charlie	558	+	32	26994769	85229
chr8	90898230	91098230	harbor1	chr8	90939023	90939228	DNA/hAT-Charlie	898	+	102	90939125	40895
chr8	120225162	120425162	harbor1	chr8	120241130	120241340	DNA/hAT-Charlie	686	+	105	120241235	16073
chr8	120225162	120425162	harbor1	chr8	120249611	120249766	DNA/hAT-Charlie	657	+	78	120249689	24527
chr8	120225162	120425162	harbor1	chr8	120264688	120264885	DNA/hAT-Charlie	508	+	98	120264786	39624
chr8	120225162	120425162	harbor1	chr8	120289185	120289455	DNA/hAT-Charlie	640	+	135	120289320	64158
chr8	120225162	120425162	harbor1	chr8	120308688	120308944	DNA/hAT-Charlie	1014	+	128	120308816	83654
chr8	120225162	120425162	harbor1	chr8	120309235	120309352	DNA/hAT-Charlie	1014	+	58	120309293	84131
chr8	85439998	85639998	harbor1	chr8	85531096	85531227	DNA/hAT-Charlie	594	+	66	85531162	91164
chr8	37120774	37320774	harbor1	chr8	37186017	37186233	DNA/hAT-Charlie	1200	+	108	37186125	65351
chr8	37120774	37320774	harbor1	chr8	37195399	37195588	DNA/hAT-Charlie	1044	+	94	37195493	74719
chr8	68169996	68369996	harbor1	chr8	68238300	68238437	DNA/hAT-Charlie	423	+	68	68238368	68372
chr8	136668758	136868758	harbor1	chr8	136680785	136680992	DNA/hAT-Charlie	480	+	104	136680889	12131
chr8	136668758	136868758	harbor1	chr8	136681184	136681501	DNA/hAT-Charlie	808	+	158	136681342	12584
chr8	136668758	136868758	harbor1	chr8	136700968	136701147	DNA/hAT-Charlie	735	+	90	136701058	32300
chr8	136668758	136868758	harbor1	chr8	136705533	136706455	DNA/hAT-Charlie	3532	+	461	136705994	37236
chr8	136668758	136868758	harbor1	chr8	136706755	136707155	DNA/hAT-Charlie	3532	+	200	136706955	38197
chr8	16034162	16234162	harbor1	chr8	16110699	16110863	DNA/hAT-Charlie	463	+	82	16110781	76619
chr8	16034162	16234162	harbor1	chr8	16117048	16117541	DNA/hAT-Charlie	3435	+	246	16117294	83132
chr8	16034162	16234162	harbor1	chr8	16117538	16118023	DNA/hAT-Charlie	3293	+	242	16117780	83618
chr8	89002426	89202426	harbor1	chr8	89040942	89042025	DNA/hAT-Charlie	7545	+	542	89041484	39058
chr8	89002426	89202426	harbor1	chr8	89075399	89075917	DNA/hAT-Charlie	3596	+	259	89075658	73232
chr8	89002426	89202426	harbor1	chr8	89080531	89080730	DNA/hAT-Charlie	620	+	100	89080631	78205
chr8	92634224	92834224	harbor1	chr8	92646505	92646713	DNA/hAT-Charlie	884	+	104	92646609	12385
chr8	92634224	92834224	harbor1	chr8	92727483	92727663	DNA/hAT-Charlie	633	+	90	92727573	93349
chr8	92634224	92834224	harbor1	chr8	92732182	92732384	DNA/hAT-Charlie	850	+	101	92732283	98059
chr8	60843045	61043045	harbor1	chr8	60875313	60875455	DNA/hAT-Charlie	508	+	71	60875384	32339
chr8	60843045	61043045	harbor1	chr8	60893011	60893145	DNA/hAT-Charlie	411	+	67	60893078	50033
chr8	60843045	61043045	harbor1	chr8	60895720	60895829	DNA/hAT-Charlie	438	+	54	60895774	52729
chr8	60843045	61043045	harbor1	chr8	60907775	60908188	DNA/hAT-Charlie	2860	+	206	60907981	64936
chr8	60843045	61043045	harbor1	chr8	60936414	60936599	DNA/hAT-Charlie	755	+	92	60936506	93461
chr8	17128020	17328020	harbor1	chr8	17151113	17151318	DNA/hAT-Charlie	947	+	102	17151215	23195
chr8	17128020	17328020	harbor1	chr8	17196258	17196407	DNA/hAT-Charlie	918	+	74	17196332	68312
chr8	17128020	17328020	harbor1	chr8	17219922	17220096	DNA/hAT-Charlie	664	+	87	17220009	91989
chr8	80657735	80857735	harbor1	chr8	80715634	80715791	DNA/hAT-Charlie	616	+	78	80715712	57977
chr8	80657735	80857735	harbor1	chr8	80722940	80723136	DNA/hAT-Charlie	455	+	98	80723038	65303
chr8	80657735	80857735	harbor1	chr8	80723138	80723799	DNA/hAT-Charlie	1840	+	330	80723468	65733
chr8	80657735	80857735	harbor1	chr8	80744034	80744305	DNA/hAT-Charlie	968	+	136	80744170	86435
chr8	80657735	80857735	harbor1	chr8	80751495	80751661	DNA/hAT-Charlie	459	+	83	80751578	93843
chr8	120989963	121189963	harbor1	chr8	121000058	121001025	DNA/hAT-Charlie	3060	+	484	121000542	10579
chr8	120989963	121189963	harbor1	chr8	121001053	121001357	DNA/hAT-Charlie	2802	+	152	121001205	11242
chr8	120989963	121189963	harbor1	chr8	121076902	121077103	DNA/hAT-Charlie	832	+	100	121077002	87039
chr8	120989963	121189963	harbor1	chr8	121077098	121077357	DNA/hAT-Charlie	909	+	130	121077228	87265
chr8	120989963	121189963	harbor1	chr8	121085503	121085630	DNA/hAT-Charlie	685	+	64	121085567	95604
chr8	120989963	121189963	harbor1	chr8	121085650	121086250	DNA/hAT-Charlie	1999	+	300	121085950	95987
chr8	120989963	121189963	harbor1	chr8	121086840	121087075	DNA/hAT-Charlie	1999	+	118	121086958	96995
chr8	60909043	61109043	harbor1	chr8	60936414	60936599	DNA/hAT-Charlie	755	+	92	60936506	27463
chr8	40558086	40758086	harbor1	chr8	40561670	40561890	DNA/hAT-Charlie	1661	+	110	40561780	3694
chr8	130309875	130509875	harbor1	chr8	130336309	130336471	DNA/hAT-Charlie	857	+	81	130336390	26515
chr8	130309875	130509875	harbor1	chr8	130389993	130390142	DNA/hAT-Charlie	519	+	74	130390067	80192
chr8	74213481	74413481	harbor1	chr8	74250565	74250733	DNA/hAT-Charlie	1165	+	84	74250649	37168
chr8	123733076	123933076	harbor1	chr8	123733728	123733896	DNA/hAT-Charlie	857	+	84	123733812	736
chr8	123733076	123933076	harbor1	chr8	123734686	123735079	DNA/hAT-Charlie	630	+	196	123734882	1806
chr8	123733076	123933076	harbor1	chr8	123735128	123735412	DNA/hAT-Charlie	684	+	142	123735270	2194
chr8	123733076	123933076	harbor1	chr8	123758475	123758735	DNA/hAT-Charlie	501	+	130	123758605	25529
chr8	123733076	123933076	harbor1	chr8	123821987	123822445	DNA/hAT-Charlie	2285	+	229	123822216	89140
chr8	16588671	16788671	harbor1	chr8	16615558	16615738	DNA/hAT-Charlie	656	+	90	16615648	26977
chr8	16588671	16788671	harbor1	chr8	16680537	16680655	DNA/hAT-Charlie	420	+	59	16680596	91925
chr8	108006118	108206118	harbor1	chr8	108012235	108012403	DNA/hAT-Charlie	462	+	84	108012319	6201
chr8	108006118	108206118	harbor1	chr8	108029117	108029335	DNA/hAT-Charlie	1053	+	109	108029226	23108
chr8	132716350	132916350	harbor1	chr8	132720363	132720533	DNA/hAT-Charlie	418	+	85	132720448	4098
chr8	132716350	132916350	harbor1	chr8	132732717	132732937	DNA/hAT-Charlie	878	+	110	132732827	16477
chr8	132716350	132916350	harbor1	chr8	132748284	132748495	DNA/hAT-Charlie	913	+	106	132748390	32040
chr8	110552374	110752374	harbor1	chr8	110596466	110596687	DNA/hAT-Charlie	931	+	110	110596576	44202
chr8	110552374	110752374	harbor1	chr8	110610063	110610179	DNA/hAT-Charlie	450	+	58	110610121	57747
chr8	110552374	110752374	harbor1	chr8	110615559	110615759	DNA/hAT-Charlie	827	+	100	110615659	63285
chr8	48290992	48490992	harbor1	chr8	48304636	48304825	DNA/hAT-Charlie	809	+	94	48304730	13738
chr8	48290992	48490992	harbor1	chr8	48326020	48326184	DNA/hAT-Charlie	658	+	82	48326102	35110
chr8	94226773	94426773	harbor1	chr8	94231456	94231616	DNA/hAT-Charlie	515	+	80	94231536	4763
chr8	94226773	94426773	harbor1	chr8	94266171	94266295	DNA/hAT-Charlie	407	+	62	94266233	39460
chr8	94226773	94426773	harbor1	chr8	94306799	94306943	DNA/hAT-Charlie	530	+	72	94306871	80098
chr8	26314272	26514272	harbor1	chr8	26329789	26329939	DNA/hAT-Charlie	502	+	75	26329864	15592
chr8	70478501	70678501	harbor1	chr8	70478634	70478839	DNA/hAT-Charlie	1024	+	102	70478736	235
chr8	94686213	94886213	harbor1	chr8	94735720	94735853	DNA/hAT-Charlie	569	+	66	94735786	49573
chr8	94686213	94886213	harbor1	chr8	94748519	94748621	DNA/hAT-Charlie	1871	+	51	94748570	62357
chr8	94686213	94886213	harbor1	chr8	94749241	94749305	DNA/hAT-Charlie	1720	+	32	94749273	63060
chr8	94686213	94886213	harbor1	chr8	94748656	94748884	DNA/hAT-Charlie	1871	+	114	94748770	62557
chr8	58649064	58849064	harbor1	chr8	58685455	58685603	DNA/hAT-Charlie	654	+	74	58685529	36465
chr8	58649064	58849064	harbor1	chr8	58685603	58685992	DNA/hAT-Charlie	1459	+	194	58685797	36733
chr8	58649064	58849064	harbor1	chr8	58686285	58686516	DNA/hAT-Charlie	1459	+	116	58686401	37337
chr8	109104133	109304133	harbor1	chr8	109105746	109105926	DNA/hAT-Charlie	925	+	90	109105836	1703
chr8	109104133	109304133	harbor1	chr8	109160321	109160667	DNA/hAT-Charlie	825	+	173	109160494	56361
chr8	109104133	109304133	harbor1	chr8	109168458	109171017	DNA/hAT-Charlie	6093	+	1280	109169738	65605
chr8	109104133	109304133	harbor1	chr8	109176853	109177458	DNA/hAT-Charlie	1624	+	302	109177155	73022
chr8	109104133	109304133	harbor1	chr8	109192502	109192815	DNA/hAT-Charlie	1335	+	156	109192658	88525
chr8	69324859	69524859	harbor1	chr8	69349442	69349653	DNA/hAT-Charlie	937	+	106	69349548	24689
chr8	69324859	69524859	harbor1	chr8	69395893	69396195	DNA/hAT-Charlie	401	+	151	69396044	71185
chr8	69324859	69524859	harbor1	chr8	69417493	69417842	DNA/hAT-Charlie	795	+	174	69417667	92808
chr8	48294780	48494780	harbor1	chr8	48304636	48304825	DNA/hAT-Charlie	809	+	94	48304730	9950
chr8	48294780	48494780	harbor1	chr8	48326020	48326184	DNA/hAT-Charlie	658	+	82	48326102	31322
chr8	86499090	86699090	harbor1	chr8	86527551	86527706	DNA/hAT-Charlie	612	+	78	86527629	28539
chr8	100735781	100935781	harbor1	chr8	100756803	100756919	DNA/hAT-Charlie	835	+	58	100756861	21080
chr8	100735781	100935781	harbor1	chr8	100757227	100757302	DNA/hAT-Charlie	835	+	38	100757265	21484
chr8	100735781	100935781	harbor1	chr8	100759328	100759485	DNA/hAT-Charlie	788	+	78	100759406	23625
chr8	100735781	100935781	harbor1	chr8	100811164	100811246	DNA/hAT-Charlie	1333	+	41	100811205	75424
chr8	100735781	100935781	harbor1	chr8	100828237	100828516	DNA/hAT-Charlie	677	+	140	100828377	92596
chr8	100735781	100935781	harbor1	chr8	100830009	100830361	DNA/hAT-Charlie	2153	+	176	100830185	94404
chr8	100735781	100935781	harbor1	chr8	100810598	100810851	DNA/hAT-Charlie	1333	+	126	100810724	74943
chr8	93578948	93778948	harbor1	chr8	93582543	93582934	DNA/hAT-Charlie	1264	+	196	93582739	3791
chr8	93578948	93778948	harbor1	chr8	93614015	93614231	DNA/hAT-Charlie	1075	+	108	93614123	35175
chr8	93578948	93778948	harbor1	chr8	93620264	93620573	DNA/hAT-Charlie	569	+	154	93620418	41470
chr8	93578948	93778948	harbor1	chr8	93643224	93643357	DNA/hAT-Charlie	778	+	66	93643290	64342
chr8	93578948	93778948	harbor1	chr8	93647761	93647968	DNA/hAT-Charlie	870	+	104	93647865	68917
chr8	93578948	93778948	harbor1	chr8	93662748	93662901	DNA/hAT-Charlie	479	+	76	93662824	83876
chr8	93578948	93778948	harbor1	chr8	93678353	93678638	DNA/hAT-Charlie	936	+	142	93678495	99547
chr8	25356198	25556198	harbor1	chr8	25359492	25359798	DNA/hAT-Charlie	2085	+	153	25359645	3447
chr8	25356198	25556198	harbor1	chr8	25373965	25374100	DNA/hAT-Charlie	441	+	68	25374033	17835
chr8	25356198	25556198	harbor1	chr8	25416100	25416260	DNA/hAT-Charlie	529	+	80	25416180	59982
chr8	25356198	25556198	harbor1	chr8	25430254	25430773	DNA/hAT-Charlie	3603	+	260	25430514	74316
chr8	25356198	25556198	harbor1	chr8	25452454	25452636	DNA/hAT-Charlie	585	+	91	25452545	96347
chr8	30072251	30272251	harbor1	chr8	30081472	30081633	DNA/hAT-Charlie	450	+	80	30081552	9301
chr8	30072251	30272251	harbor1	chr8	30130178	30130471	DNA/hAT-Charlie	583	+	146	30130324	58073
chr8	84972957	85172957	harbor1	chr8	84994031	84994225	DNA/hAT-Charlie	684	+	97	84994128	21171
chr8	84972957	85172957	harbor1	chr8	85010878	85011024	DNA/hAT-Charlie	477	+	73	85010951	37994
chr8	84972957	85172957	harbor1	chr8	85057517	85057759	DNA/hAT-Charlie	659	+	121	85057638	84681
chr8	84972957	85172957	harbor1	chr8	85069427	85069704	DNA/hAT-Charlie	3613	+	138	85069565	96608
chr8	84972957	85172957	harbor1	chr8	85070008	85071204	DNA/hAT-Charlie	3613	+	598	85070606	97649
chr8	95747443	95947443	harbor1	chr8	95762323	95762471	DNA/hAT-Charlie	407	+	74	95762397	14954
chr8	95747443	95947443	harbor1	chr8	95783420	95783771	DNA/hAT-Charlie	2201	+	176	95783596	36153
chr8	95747443	95947443	harbor1	chr8	95806626	95807752	DNA/hAT-Charlie	1698	+	563	95807189	59746
chr8	95747443	95947443	harbor1	chr8	95808557	95808891	DNA/hAT-Charlie	879	+	167	95808724	61281
chr8	95747443	95947443	harbor1	chr8	95837909	95838074	DNA/hAT-Charlie	507	+	82	95837991	90548
chr9	97128163	97328163	harbor1	chr9	97187752	97187915	DNA/hAT-Charlie	753	+	82	97187834	59671
chr9	35497155	35697155	harbor1	chr9	35536161	35536307	DNA/hAT-Charlie	442	+	73	35536234	39079
chr9	33990465	34190465	harbor1	chr9	34040743	34040906	DNA/hAT-Charlie	647	+	82	34040825	50360
chr9	118082244	118282244	harbor1	chr9	118090003	118090222	DNA/hAT-Charlie	1040	+	110	118090113	7869
chr9	77843322	78043322	harbor1	chr9	77846068	77846402	DNA/hAT-Charlie	940	+	167	77846235	2913
chr9	77843322	78043322	harbor1	chr9	77887943	77888155	DNA/hAT-Charlie	827	+	106	77888049	44727
chr9	77843322	78043322	harbor1	chr9	77888163	77888299	DNA/hAT-Charlie	425	+	68	77888231	44909
chr9	77843322	78043322	harbor1	chr9	77908798	77908922	DNA/hAT-Charlie	558	+	62	77908860	65538
chr9	77843322	78043322	harbor1	chr9	77930823	77931123	DNA/hAT-Charlie	1492	+	150	77930973	87651
chr9	27520084	27720084	harbor1	chr9	27558745	27558927	DNA/hAT-Charlie	588	+	91	27558836	38752
chr9	27520084	27720084	harbor1	chr9	27604438	27604611	DNA/hAT-Charlie	462	+	86	27604524	84440
chr9	30111802	30311802	harbor1	chr9	30145072	30145599	DNA/hAT-Charlie	3571	+	264	30145336	33534
chr9	125661246	125861246	harbor1	chr9	125676823	125676978	DNA/hAT-Charlie	518	+	78	125676901	15655
chr9	125661246	125861246	harbor1	chr9	125684231	125684452	DNA/hAT-Charlie	741	+	110	125684341	23095
chr9	125661246	125861246	harbor1	chr9	125703047	125703197	DNA/hAT-Charlie	678	+	75	125703122	41876
chr9	125661246	125861246	harbor1	chr9	125727751	125727892	DNA/hAT-Charlie	830	+	70	125727821	66575
chr9	26899847	27099847	harbor1	chr9	26913548	26913709	DNA/hAT-Charlie	427	+	80	26913628	13781
chr9	26899847	27099847	harbor1	chr9	26932297	26932617	DNA/hAT-Charlie	1430	+	160	26932457	32610
chr9	26899847	27099847	harbor1	chr9	26983386	26983594	DNA/hAT-Charlie	830	+	104	26983490	83643
chr9	85829151	86029151	harbor1	chr9	85842146	85842340	DNA/hAT-Charlie	861	+	97	85842243	13092
chr9	85829151	86029151	harbor1	chr9	85878135	85878403	DNA/hAT-Charlie	1272	+	134	85878269	49118
chr9	85829151	86029151	harbor1	chr9	85919877	85920013	DNA/hAT-Charlie	654	+	68	85919945	90794
chr9	85829151	86029151	harbor1	chr9	85922005	85922166	DNA/hAT-Charlie	575	+	80	85922085	92934
chr9	9456564	9656564	harbor1	chr9	9469034	9469301	DNA/hAT-Charlie	915	+	134	9469168	12604
chr9	98539418	98739418	harbor1	chr9	98545501	98545658	DNA/hAT-Charlie	646	+	78	98545579	6161
chr9	98539418	98739418	harbor1	chr9	98604066	98604226	DNA/hAT-Charlie	424	+	80	98604146	64728
chr9	15589894	15789894	harbor1	chr9	15657904	15658094	DNA/hAT-Charlie	928	+	95	15657999	68105
chr9	15589894	15789894	harbor1	chr9	15667274	15667363	DNA/hAT-Charlie	467	+	44	15667318	77424
chr9	15589894	15789894	harbor1	chr9	15667661	15667769	DNA/hAT-Charlie	467	+	54	15667715	77821
chr9	83145654	83345654	harbor1	chr9	83184917	83185084	DNA/hAT-Charlie	608	+	84	83185001	39347
chr9	83145654	83345654	harbor1	chr9	83221352	83221571	DNA/hAT-Charlie	560	+	110	83221462	75808
chr9	113974093	114174093	harbor1	chr9	113987842	113987949	DNA/hAT-Charlie	513	+	54	113987896	13803
chr9	113974093	114174093	harbor1	chr9	114000379	114000591	DNA/hAT-Charlie	1424	+	106	114000485	26392
chr9	113974093	114174093	harbor1	chr9	114013802	114013967	DNA/hAT-Charlie	725	+	82	114013884	39791
chr9	113974093	114174093	harbor1	chr9	114029291	114029485	DNA/hAT-Charlie	552	+	97	114029388	55295
chr9	96822423	97022423	harbor1	chr9	96902050	96902151	DNA/hAT-Charlie	739	+	50	96902100	79677
chr9	96822423	97022423	harbor1	chr9	96902441	96902753	DNA/hAT-Charlie	739	+	156	96902597	80174
chr9	27086639	27286639	harbor1	chr9	27133640	27133864	DNA/hAT-Charlie	495	+	112	27133752	47113
chr9	27086639	27286639	harbor1	chr9	27181593	27181754	DNA/hAT-Charlie	443	+	80	27181673	95034
chr9	69968562	70168562	harbor1	chr9	70006878	70007042	DNA/hAT-Charlie	586	+	82	70006960	38398
chr9	69968562	70168562	harbor1	chr9	70043029	70043194	DNA/hAT-Charlie	537	+	82	70043111	74549
chr9	69968562	70168562	harbor1	chr9	70056668	70057184	DNA/hAT-Charlie	3413	+	258	70056926	88364
chr9	38729526	38929526	harbor1	chr9	38739929	38740115	DNA/hAT-Charlie	1034	+	93	38740022	10496
chr9	38729526	38929526	harbor1	chr9	38744010	38744187	DNA/hAT-Charlie	607	+	88	38744098	14572
chr9	38729526	38929526	harbor1	chr9	38744260	38744379	DNA/hAT-Charlie	488	+	60	38744320	14794
chr9	38729526	38929526	harbor1	chr9	38731653	38731821	DNA/hAT-Charlie	502	+	84	38731737	2211
chr9	83176166	83376166	harbor1	chr9	83184917	83185084	DNA/hAT-Charlie	608	+	84	83185001	8835
chr9	83176166	83376166	harbor1	chr9	83221352	83221571	DNA/hAT-Charlie	560	+	110	83221462	45296
chr9	83176166	83376166	harbor1	chr9	83259032	83259715	DNA/hAT-Charlie	1423	+	342	83259374	83208
chr9	41529270	41729270	harbor1	chr9	41534675	41534916	DNA/hAT-Charlie	1969	+	120	41534795	5525
chr9	41529270	41729270	harbor1	chr9	41535486	41535572	DNA/hAT-Charlie	1969	+	43	41535529	6259
chr9	111126466	111326466	harbor1	chr9	111212087	111212290	DNA/hAT-Charlie	530	+	102	111212189	85723
chr9	19269648	19469648	harbor1	chr9	19278917	19279032	DNA/hAT-Charlie	593	+	58	19278975	9327
chr9	19269648	19469648	harbor1	chr9	19279852	19279874	DNA/hAT-Charlie	593	+	11	19279863	10215
chr9	19269648	19469648	harbor1	chr9	19303355	19303537	DNA/hAT-Charlie	971	+	91	19303446	33798
chr9	19269648	19469648	harbor1	chr9	19310386	19310575	DNA/hAT-Charlie	1130	+	94	19310480	40832
chr9	4843494	5043494	harbor1	chr9	4871453	4871605	DNA/hAT-Charlie	461	+	76	4871529	28035
chr9	4843494	5043494	harbor1	chr9	4871901	4871929	DNA/hAT-Charlie	461	+	14	4871915	28421
chr9	4843494	5043494	harbor1	chr9	4872019	4872080	DNA/hAT-Charlie	461	+	30	4872049	28555
chr9	4843494	5043494	harbor1	chr9	4924597	4924796	DNA/hAT-Charlie	888	+	100	4924697	81203
chr9	4843494	5043494	harbor1	chr9	4930783	4930938	DNA/hAT-Charlie	808	+	78	4930861	87367
chr9	125219548	125419548	harbor1	chr9	125257046	125257398	DNA/hAT-Charlie	2212	+	176	125257222	37674
chr9	125219548	125419548	harbor1	chr9	125262711	125263198	DNA/hAT-Charlie	2101	+	244	125262955	43407
chr9	35823927	36023927	harbor1	chr9	35870661	35870870	DNA/hAT-Charlie	558	+	104	35870765	46838
chr9	124701289	124901289	harbor1	chr9	124710719	124711192	DNA/hAT-Charlie	819	+	236	124710955	9666
chr9	124701289	124901289	harbor1	chr9	124741043	124741218	DNA/hAT-Charlie	993	+	88	124741131	39842
chr9	124701289	124901289	harbor1	chr9	124753076	124753404	DNA/hAT-Charlie	1024	+	164	124753240	51951
chr9	124701289	124901289	harbor1	chr9	124796736	124796959	DNA/hAT-Charlie	1160	+	112	124796848	95559
chr9	9337465	9537465	harbor1	chr9	9395220	9395303	DNA/hAT-Charlie	504	+	42	9395262	57797
chr9	9337465	9537465	harbor1	chr9	9396281	9396446	DNA/hAT-Charlie	567	+	82	9396363	58898
chr9	108619343	108819343	harbor1	chr9	108619821	108619976	DNA/hAT-Charlie	645	+	78	108619899	556
chr9	108619343	108819343	harbor1	chr9	108620233	108620270	DNA/hAT-Charlie	645	+	18	108620251	908
chr9	108619343	108819343	harbor1	chr9	108623268	108623610	DNA/hAT-Charlie	719	+	171	108623439	4096
chr9	108619343	108819343	harbor1	chr9	108640702	108640898	DNA/hAT-Charlie	849	+	98	108640800	21457
chr9	108619343	108819343	harbor1	chr9	108664107	108664218	DNA/hAT-Charlie	549	+	56	108664163	44820
chr9	108619343	108819343	harbor1	chr9	108669608	108669770	DNA/hAT-Charlie	408	+	81	108669689	50346
chr9	108619343	108819343	harbor1	chr9	108675541	108675778	DNA/hAT-Charlie	793	+	118	108675659	56316
chr9	108619343	108819343	harbor1	chr9	108678674	108678945	DNA/hAT-Charlie	433	+	136	108678810	59467
chr9	131594814	131794814	harbor1	chr9	131676818	131677003	DNA/hAT-Charlie	977	+	92	131676910	82096
chr9	131594814	131794814	harbor1	chr9	131694244	131694442	DNA/hAT-Charlie	734	+	99	131694343	99529
chr9	111194252	111394252	harbor1	chr9	111212087	111212290	DNA/hAT-Charlie	530	+	102	111212189	17937
chr9	111194252	111394252	harbor1	chr9	111232312	111232658	DNA/hAT-Charlie	2087	+	173	111232485	38233
chr9	122630502	122830502	harbor1	chr9	122694607	122694777	DNA/hAT-Charlie	793	+	85	122694692	64190
chr9	122630502	122830502	harbor1	chr9	122703884	122704224	DNA/hAT-Charlie	2185	+	170	122704054	73552
chr9	79808333	80008333	harbor1	chr9	79823130	79823197	DNA/hAT-Charlie	822	+	34	79823164	14831
chr9	79808333	80008333	harbor1	chr9	79823500	79823628	DNA/hAT-Charlie	822	+	64	79823564	15231
chr9	79808333	80008333	harbor1	chr9	79857701	79857846	DNA/hAT-Charlie	495	+	72	79857773	49440
chr9	100628232	100828232	harbor1	chr9	100687514	100687705	DNA/hAT-Charlie	762	+	96	100687610	59378
chr9	100628232	100828232	harbor1	chr9	100687735	100687893	DNA/hAT-Charlie	684	+	79	100687814	59582
chr9	100628232	100828232	harbor1	chr9	100720078	100720204	DNA/hAT-Charlie	546	+	63	100720141	91909
chr9	97380466	97580466	harbor1	chr9	97432833	97433052	DNA/hAT-Charlie	901	+	110	97432943	52477
chr9	97380466	97580466	harbor1	chr9	97476644	97476810	DNA/hAT-Charlie	408	+	83	97476727	96261
chr9	97380466	97580466	harbor1	chr9	97479686	97479853	DNA/hAT-Charlie	528	+	84	97479770	99304
chr9	137812511	138012511	harbor1	chr9	137864771	137864975	DNA/hAT-Charlie	887	+	102	137864873	52362
chr9	128404376	128604376	harbor1	chr9	128443556	128443820	DNA/hAT-Charlie	664	+	132	128443688	39312
chr9	128404376	128604376	harbor1	chr9	128451427	128451499	DNA/hAT-Charlie	754	+	36	128451463	47087
chr9	128404376	128604376	harbor1	chr9	128451811	128451919	DNA/hAT-Charlie	754	+	54	128451865	47489
chr9	128404376	128604376	harbor1	chr9	128482025	128482222	DNA/hAT-Charlie	518	+	98	128482123	77747
chr9	82084965	82284965	harbor1	chr9	82085519	82085644	DNA/hAT-Charlie	436	+	62	82085581	616
chr9	82084965	82284965	harbor1	chr9	82088937	82089089	DNA/hAT-Charlie	659	+	76	82089013	4048
chr9	82084965	82284965	harbor1	chr9	82095667	82095826	DNA/hAT-Charlie	458	+	80	82095747	10782
chr9	82084965	82284965	harbor1	chr9	82122610	82122809	DNA/hAT-Charlie	1060	+	100	82122710	37745
chr9	82084965	82284965	harbor1	chr9	82135271	82135494	DNA/hAT-Charlie	799	+	112	82135383	50418
chr9	82084965	82284965	harbor1	chr9	82172342	82172506	DNA/hAT-Charlie	681	+	82	82172424	87459
chr9	82084965	82284965	harbor1	chr9	82132988	82133173	DNA/hAT-Charlie	801	+	92	82133080	48115
chr9	62690974	62890974	harbor1	chr9	62741590	62741784	DNA/hAT-Charlie	604	+	97	62741687	50713
chr9	39958162	40158162	harbor1	chr9	39962821	39963043	DNA/hAT-Charlie	1062	+	111	39962932	4770
chr9	39958162	40158162	harbor1	chr9	40019398	40019719	DNA/hAT-Charlie	1066	+	160	40019558	61396
chr9	39958162	40158162	harbor1	chr9	40039834	40040046	DNA/hAT-Charlie	718	+	106	40039940	81778
chr9	6052672	6252672	harbor1	chr9	6055214	6055324	DNA/hAT-Charlie	602	+	55	6055269	2597
chr9	6052672	6252672	harbor1	chr9	6091077	6091287	DNA/hAT-Charlie	920	+	105	6091182	38510
chr9	24894640	25094640	harbor1	chr9	24913888	24914084	DNA/hAT-Charlie	614	+	98	24913986	19346
chr9	24894640	25094640	harbor1	chr9	24934663	24935982	DNA/hAT-Charlie	1586	+	660	24935323	40683
chr9	24894640	25094640	harbor1	chr9	24937527	24937686	DNA/hAT-Charlie	472	+	80	24937607	42967
chr9	92274638	92474638	harbor1	chr9	92291805	92291919	DNA/hAT-Charlie	528	+	57	92291862	17224
chr9	92274638	92474638	harbor1	chr9	92303270	92303583	DNA/hAT-Charlie	1198	+	156	92303426	28788
chr9	92274638	92474638	harbor1	chr9	92327046	92327203	DNA/hAT-Charlie	483	+	78	92327124	52486
chr9	128936395	129136395	harbor1	chr9	128942961	128943028	DNA/hAT-Charlie	642	+	34	128942995	6600
chr9	128936395	129136395	harbor1	chr9	128943324	128943533	DNA/hAT-Charlie	642	+	104	128943428	7033
chr9	14444199	14644199	harbor1	chr9	14472314	14472573	DNA/hAT-Charlie	1028	+	130	14472444	28245
chr9	14444199	14644199	harbor1	chr9	14472866	14472942	DNA/hAT-Charlie	1028	+	38	14472904	28705
chr9	14444199	14644199	harbor1	chr9	14520677	14520851	DNA/hAT-Charlie	501	+	87	14520764	76565
chr9	14444199	14644199	harbor1	chr9	14521202	14521380	DNA/hAT-Charlie	472	+	89	14521291	77092
chr9	103036626	103236626	harbor1	chr9	103110501	103110662	DNA/hAT-Charlie	437	+	80	103110581	73955
chr9	11654478	11854478	harbor1	chr9	11730418	11730584	DNA/hAT-Charlie	416	+	83	11730501	76023
chr9	65612787	65812787	harbor1	chr9	65671911	65672030	DNA/hAT-Charlie	608	+	60	65671971	59184
chr9	65612787	65812787	harbor1	chr9	65684627	65684782	DNA/hAT-Charlie	745	+	78	65684705	71918
chr9	88014892	88214892	harbor1	chr9	88032283	88032358	DNA/hAT-Charlie	472	+	38	88032321	17429
chr9	88014892	88214892	harbor1	chr9	88036412	88036740	DNA/hAT-Charlie	2079	+	164	88036576	21684
chr9	37467661	37667661	harbor1	chr9	37497475	37497684	DNA/hAT-Charlie	1119	+	104	37497579	29918
chr9	37467661	37667661	harbor1	chr9	37514364	37514558	DNA/hAT-Charlie	632	+	97	37514461	46800
chr9	37467661	37667661	harbor1	chr9	37514853	37514935	DNA/hAT-Charlie	632	+	41	37514894	47233
chr9	37467661	37667661	harbor1	chr9	37532766	37533084	DNA/hAT-Charlie	829	+	159	37532925	65264
chr9	37467661	37667661	harbor1	chr9	37565495	37565641	DNA/hAT-Charlie	485	+	73	37565568	97907
chr9	71663645	71863645	harbor1	chr9	71682680	71682866	DNA/hAT-Charlie	894	+	93	71682773	19128
chr9	71663645	71863645	harbor1	chr9	71686097	71686602	DNA/hAT-Charlie	3400	+	252	71686349	22704
chr9	71663645	71863645	harbor1	chr9	71687273	71687359	DNA/hAT-Charlie	587	+	43	71687316	23671
chr9	71663645	71863645	harbor1	chr9	71739667	71739876	DNA/hAT-Charlie	1639	+	104	71739771	76126
chr9	71663645	71863645	harbor1	chr9	71751373	71751533	DNA/hAT-Charlie	425	+	80	71751453	87808
chr9	123396288	123596288	harbor1	chr9	123412897	123412927	DNA/hAT-Charlie	822	+	15	123412912	16624
chr9	123396288	123596288	harbor1	chr9	123413199	123413422	DNA/hAT-Charlie	832	+	112	123413311	17023
chr9	123396288	123596288	harbor1	chr9	123437837	123438119	DNA/hAT-Charlie	425	+	141	123437978	41690
chr9	123097805	123297805	harbor1	chr9	123113801	123113992	DNA/hAT-Charlie	865	+	96	123113897	16092
chr9	76775172	76975172	harbor1	chr9	76778045	76778210	DNA/hAT-Charlie	568	+	82	76778127	2955
chr9	76775172	76975172	harbor1	chr9	76806088	76806282	DNA/hAT-Charlie	981	+	97	76806185	31013
chr9	76775172	76975172	harbor1	chr9	76813306	76813401	DNA/hAT-Charlie	525	+	48	76813354	38182
chr9	76775172	76975172	harbor1	chr9	76829449	76829649	DNA/hAT-Charlie	946	+	100	76829549	54377
chr9	117261750	117461750	harbor1	chr9	117312367	117312652	DNA/hAT-Charlie	687	+	142	117312509	50759
chr9	117261750	117461750	harbor1	chr9	117353308	117353497	DNA/hAT-Charlie	1037	+	94	117353402	91652
chr9	106805920	107005920	harbor1	chr9	106886773	106886967	DNA/hAT-Charlie	518	+	97	106886870	80950
chr9	106805920	107005920	harbor1	chr9	106894653	106895003	DNA/hAT-Charlie	892	+	175	106894828	88908
chr9	106805920	107005920	harbor1	chr9	106898378	106898624	DNA/hAT-Charlie	866	+	123	106898501	92581
chr9	73012635	73212635	harbor1	chr9	73017279	73017410	DNA/hAT-Charlie	492	+	66	73017345	4710
chr9	86770401	86970401	harbor1	chr9	86791650	86791893	DNA/hAT-Charlie	496	+	122	86791772	21371
chr9	86770401	86970401	harbor1	chr9	86806502	86806943	DNA/hAT-Charlie	1798	+	220	86806722	36321
chr9	86770401	86970401	harbor1	chr9	86827787	86828096	DNA/hAT-Charlie	967	+	154	86827941	57540
chr9	29175045	29375045	harbor1	chr9	29195883	29196044	DNA/hAT-Charlie	575	+	80	29195963	20918
chr9	29175045	29375045	harbor1	chr9	29239580	29239758	DNA/hAT-Charlie	1107	+	89	29239669	64624
chr9	71449025	71649025	harbor1	chr9	71482739	71482847	DNA/hAT-Charlie	460	+	54	71482793	33768
chr9	71449025	71649025	harbor1	chr9	71483135	71483193	DNA/hAT-Charlie	460	+	29	71483164	34139
chr9	71449025	71649025	harbor1	chr9	71486857	71487023	DNA/hAT-Charlie	783	+	83	71486940	37915
chr9	9337706	9537706	harbor1	chr9	9395220	9395303	DNA/hAT-Charlie	504	+	42	9395262	57556
chr9	9337706	9537706	harbor1	chr9	9396281	9396446	DNA/hAT-Charlie	567	+	82	9396363	58657
chr9	14428652	14628652	harbor1	chr9	14472314	14472573	DNA/hAT-Charlie	1028	+	130	14472444	43792
chr9	14428652	14628652	harbor1	chr9	14472866	14472942	DNA/hAT-Charlie	1028	+	38	14472904	44252
chr9	14428652	14628652	harbor1	chr9	14520677	14520851	DNA/hAT-Charlie	501	+	87	14520764	92112
chr9	14428652	14628652	harbor1	chr9	14521202	14521380	DNA/hAT-Charlie	472	+	89	14521291	92639
chr9	88022901	88222901	harbor1	chr9	88032283	88032358	DNA/hAT-Charlie	472	+	38	88032321	9420
chr9	88022901	88222901	harbor1	chr9	88036412	88036740	DNA/hAT-Charlie	2079	+	164	88036576	13675
chr9	21391629	21591629	harbor1	chr9	21407932	21408987	DNA/hAT-Charlie	2476	+	528	21408460	16831
chr9	21391629	21591629	harbor1	chr9	21437307	21437869	DNA/hAT-Charlie	2294	+	281	21437588	45959
chr9	21391629	21591629	harbor1	chr9	21439559	21439668	DNA/hAT-Charlie	906	+	54	21439613	47984
chr9	21391629	21591629	harbor1	chr9	21439986	21440310	DNA/hAT-Charlie	906	+	162	21440148	48519
chr9	21391629	21591629	harbor1	chr9	21454992	21455300	DNA/hAT-Charlie	1420	+	154	21455146	63517
chr9	21391629	21591629	harbor1	chr9	21477604	21477762	DNA/hAT-Charlie	828	+	79	21477683	86054
chr9	21391629	21591629	harbor1	chr9	21486284	21486340	DNA/hAT-Charlie	897	+	28	21486312	94683
chr9	21391629	21591629	harbor1	chr9	21486650	21486819	DNA/hAT-Charlie	897	+	84	21486734	95105
chr9	134347360	134547360	harbor1	chr9	134354474	134354642	DNA/hAT-Charlie	543	+	84	134354558	7198
chr9	130786765	130986765	harbor1	chr9	130793685	130794214	DNA/hAT-Charlie	3721	+	264	130793949	7184
chr9	37572989	37772989	harbor1	chr9	37583620	37583814	DNA/hAT-Charlie	1013	+	97	37583717	10728
chr9	37572989	37772989	harbor1	chr9	37625866	37625940	DNA/hAT-Charlie	427	+	37	37625903	52914
chr9	37572989	37772989	harbor1	chr9	37626522	37626537	DNA/hAT-Charlie	427	+	8	37626530	53541
chr9	37572989	37772989	harbor1	chr9	37626808	37626929	DNA/hAT-Charlie	427	+	60	37626868	53879
chr9	37572989	37772989	harbor1	chr9	37628839	37628916	DNA/hAT-Charlie	877	+	38	37628877	55888
chr9	37572989	37772989	harbor1	chr9	37629214	37629311	DNA/hAT-Charlie	877	+	48	37629262	56273
chr9	37572989	37772989	harbor1	chr9	37669315	37669480	DNA/hAT-Charlie	721	+	82	37669397	96408
chr9	90063687	90263687	harbor1	chr9	90073734	90074050	DNA/hAT-Charlie	1088	+	158	90073892	10205
chr9	90063687	90263687	harbor1	chr9	90099601	90099771	DNA/hAT-Charlie	1170	+	85	90099686	35999
chr9	90063687	90263687	harbor1	chr9	90130918	90131061	DNA/hAT-Charlie	467	+	72	90130990	67303
chr9	90063687	90263687	harbor1	chr9	90131364	90131403	DNA/hAT-Charlie	467	+	20	90131384	67697
chr9	84566430	84766430	harbor1	chr9	84566991	84567208	DNA/hAT-Charlie	1297	+	108	84567099	669
chr9	84566430	84766430	harbor1	chr9	84608220	84608461	DNA/hAT-Charlie	1198	+	120	84608340	41910
chr9	84566430	84766430	harbor1	chr9	84611470	84611626	DNA/hAT-Charlie	722	+	78	84611548	45118
chr9	84566430	84766430	harbor1	chr9	84640233	84640448	DNA/hAT-Charlie	886	+	108	84640341	73911
chr9	84566430	84766430	harbor1	chr9	84651830	84652055	DNA/hAT-Charlie	616	+	112	84651942	85512
chr9	38182405	38382405	harbor1	chr9	38189377	38189691	DNA/hAT-Charlie	1761	+	157	38189534	7129
chr9	38182405	38382405	harbor1	chr9	38189701	38189912	DNA/hAT-Charlie	841	+	106	38189807	7402
chr9	38182405	38382405	harbor1	chr9	38238236	38238375	DNA/hAT-Charlie	754	+	70	38238306	55901
chr9	38182405	38382405	harbor1	chr9	38251940	38252091	DNA/hAT-Charlie	637	+	76	38252016	69611
chr9	38182405	38382405	harbor1	chr9	38256374	38256523	DNA/hAT-Charlie	554	+	74	38256448	74043
chr9	38182405	38382405	harbor1	chr9	38257584	38257767	DNA/hAT-Charlie	985	+	92	38257676	75271
chr9	38182405	38382405	harbor1	chr9	38281453	38281638	DNA/hAT-Charlie	908	+	92	38281545	99140
chr9	70026245	70226245	harbor1	chr9	70043029	70043194	DNA/hAT-Charlie	537	+	82	70043111	16866
chr9	70026245	70226245	harbor1	chr9	70056668	70057184	DNA/hAT-Charlie	3413	+	258	70056926	30681
chr9	70026245	70226245	harbor1	chr9	70077372	70077579	DNA/hAT-Charlie	914	+	104	70077476	51231
chr9	70026245	70226245	harbor1	chr9	70088545	70088847	DNA/hAT-Charlie	655	+	151	70088696	62451
chr9	70026245	70226245	harbor1	chr9	70105252	70105379	DNA/hAT-Charlie	514	+	64	70105316	79071
chr9	70026245	70226245	harbor1	chr9	70106008	70106179	DNA/hAT-Charlie	482	+	86	70106094	79849
chr9	70026245	70226245	harbor1	chr9	70117668	70117865	DNA/hAT-Charlie	522	+	98	70117766	91521
chr9	30978261	31178261	harbor1	chr9	31066185	31066361	DNA/hAT-Charlie	426	+	88	31066273	88012
chr9	104724134	104924134	harbor1	chr9	104744066	104744576	DNA/hAT-Charlie	1399	+	255	104744321	20187
chr9	104724134	104924134	harbor1	chr9	104761115	104761424	DNA/hAT-Charlie	1134	+	154	104761269	37135
chr9	104724134	104924134	harbor1	chr9	104789519	104789776	DNA/hAT-Charlie	862	+	128	104789647	65513
chr9	37780766	37980766	harbor1	chr9	37842664	37842864	DNA/hAT-Charlie	419	+	100	37842764	61998
chr9	35780975	35980975	harbor1	chr9	35781446	35781570	DNA/hAT-Charlie	457	+	62	35781508	533
chr9	35780975	35980975	harbor1	chr9	35782159	35782316	DNA/hAT-Charlie	535	+	78	35782237	1262
chr9	35780975	35980975	harbor1	chr9	35785321	35785505	DNA/hAT-Charlie	545	+	92	35785413	4438
chr9	35780975	35980975	harbor1	chr9	35797819	35797997	DNA/hAT-Charlie	803	+	89	35797908	16933
chr9	35780975	35980975	harbor1	chr9	35797986	35798123	DNA/hAT-Charlie	757	+	68	35798054	17079
chr9	35780975	35980975	harbor1	chr9	35870661	35870870	DNA/hAT-Charlie	558	+	104	35870765	89790
chr9	86403068	86603068	harbor1	chr9	86417598	86417807	DNA/hAT-Charlie	525	+	104	86417702	14634
chr9	126255986	126455986	harbor1	chr9	126257765	126257869	DNA/hAT-Charlie	561	+	52	126257817	1831
chr9	126255986	126455986	harbor1	chr9	126268018	126268190	DNA/hAT-Charlie	1005	+	86	126268104	12118
chr9	126255986	126455986	harbor1	chr9	126325243	126325462	DNA/hAT-Charlie	651	+	110	126325353	69367
chr9	126255986	126455986	harbor1	chr9	126330448	126330582	DNA/hAT-Charlie	416	+	67	126330515	74529
chr9	126255986	126455986	harbor1	chr9	126333925	126334100	DNA/hAT-Charlie	610	+	88	126334013	78027
chr9	40994530	41194530	harbor1	chr9	41048553	41048855	DNA/hAT-Charlie	1311	+	151	41048704	54174
chr9	40994530	41194530	harbor1	chr9	41054635	41054795	DNA/hAT-Charlie	707	+	80	41054715	60185
chr9	40994530	41194530	harbor1	chr9	41091615	41091764	DNA/hAT-Charlie	760	+	74	41091689	97159
chr9	71363821	71563821	harbor1	chr9	71403129	71403349	DNA/hAT-Charlie	1107	+	110	71403239	39418
chr9	71363821	71563821	harbor1	chr9	71427259	71427447	DNA/hAT-Charlie	837	+	94	71427353	63532
chr9	71363821	71563821	harbor1	chr9	71437321	71437589	DNA/hAT-Charlie	1241	+	134	71437455	73634
chr9	71363821	71563821	harbor1	chr9	71437891	71437940	DNA/hAT-Charlie	1241	+	24	71437915	74094
chr9	120298963	120498963	harbor1	chr9	120348051	120348233	DNA/hAT-Charlie	631	+	91	120348142	49179
chr9	120298963	120498963	harbor1	chr9	120364294	120364456	DNA/hAT-Charlie	770	+	81	120364375	65412
chr9	120298963	120498963	harbor1	chr9	120391007	120391182	DNA/hAT-Charlie	455	+	88	120391095	92132
chr9	104665042	104865042	harbor1	chr9	104683325	104683442	DNA/hAT-Charlie	416	+	58	104683383	18341
chr9	104665042	104865042	harbor1	chr9	104744066	104744576	DNA/hAT-Charlie	1399	+	255	104744321	79279
chr9	104665042	104865042	harbor1	chr9	104761115	104761424	DNA/hAT-Charlie	1134	+	154	104761269	96227
chr9	76422465	76622465	harbor1	chr9	76439095	76439211	DNA/hAT-Charlie	627	+	58	76439153	16688
chr9	76422465	76622465	harbor1	chr9	76440727	76440784	DNA/hAT-Charlie	616	+	28	76440755	18290
chr9	76422465	76622465	harbor1	chr9	76441082	76441148	DNA/hAT-Charlie	616	+	33	76441115	18650
chr9	76422465	76622465	harbor1	chr9	76441438	76441508	DNA/hAT-Charlie	616	+	35	76441473	19008
chr9	76422465	76622465	harbor1	chr9	76444917	76445043	DNA/hAT-Charlie	554	+	63	76444980	22515
chr9	76422465	76622465	harbor1	chr9	76467448	76467620	DNA/hAT-Charlie	668	+	86	76467534	45069
chr9	76422465	76622465	harbor1	chr9	76468534	76469155	DNA/hAT-Charlie	1042	+	310	76468844	46379
chr9	76422465	76622465	harbor1	chr9	76481324	76481532	DNA/hAT-Charlie	1078	+	104	76481428	58963
chr9	76422465	76622465	harbor1	chr9	76521941	76521987	DNA/hAT-Charlie	723	+	23	76521964	99499
chr9	76422465	76622465	harbor1	chr9	76522305	76522401	DNA/hAT-Charlie	723	+	48	76522353	99888
chr9	74105381	74305381	harbor1	chr9	74184932	74185013	DNA/hAT-Charlie	475	+	40	74184972	79591
chr9	74105381	74305381	harbor1	chr9	74185095	74185244	DNA/hAT-Charlie	475	+	74	74185169	79788
chr9	74105381	74305381	harbor1	chr9	74203351	74203527	DNA/hAT-Charlie	762	+	88	74203439	98058
chr9	40638818	40838818	harbor1	chr9	40693943	40694080	DNA/hAT-Charlie	584	+	68	40694011	55193
chr9	40638818	40838818	harbor1	chr9	40722066	40722263	DNA/hAT-Charlie	1083	+	98	40722164	83346
chr9	77275183	77475183	harbor1	chr9	77291029	77291380	DNA/hAT-Charlie	2128	+	176	77291205	16022
chr9	101557101	101757101	harbor1	chr9	101633490	101633813	DNA/hAT-Charlie	1590	+	162	101633652	76551
chr9	101557101	101757101	harbor1	chr9	101635249	101635470	DNA/hAT-Charlie	1251	+	110	101635359	78258
chr9	101557101	101757101	harbor1	chr9	101642589	101643135	DNA/hAT-Charlie	3200	+	273	101642862	85761
chr9	98081996	98281996	harbor1	chr9	98108288	98108487	DNA/hAT-Charlie	1361	+	100	98108388	26392
chr9	98081996	98281996	harbor1	chr9	98149296	98149366	DNA/hAT-Charlie	443	+	35	98149331	67335
chr9	98081996	98281996	harbor1	chr9	98165775	98165939	DNA/hAT-Charlie	685	+	82	98165857	83861
chr9	134048819	134248819	harbor1	chr9	134147026	134147222	DNA/hAT-Charlie	664	+	98	134147124	98305
chr9	134048819	134248819	harbor1	chr9	134147262	134147402	DNA/hAT-Charlie	415	+	70	134147332	98513
chr9	134048819	134248819	harbor1	chr9	134147407	134147571	DNA/hAT-Charlie	486	+	82	134147489	98670
chr9	87337117	87537117	harbor1	chr9	87393603	87393758	DNA/hAT-Charlie	759	+	78	87393681	56564
chr9	65784459	65984459	harbor1	chr9	65827171	65827344	DNA/hAT-Charlie	780	+	86	65827257	42798
chr9	71005723	71205723	harbor1	chr9	71043640	71043814	DNA/hAT-Charlie	536	+	87	71043727	38004
chr9	71005723	71205723	harbor1	chr9	71045772	71045989	DNA/hAT-Charlie	493	+	108	71045880	40157
chr9	71005723	71205723	harbor1	chr9	71046285	71046370	DNA/hAT-Charlie	493	+	42	71046327	40604
chr9	71005723	71205723	harbor1	chr9	71052357	71052538	DNA/hAT-Charlie	545	+	90	71052447	46724
chr9	9268559	9468559	harbor1	chr9	9272901	9273334	DNA/hAT-Charlie	1507	+	216	9273117	4558
chr9	9268559	9468559	harbor1	chr9	9299273	9299483	DNA/hAT-Charlie	938	+	105	9299378	30819
chr9	113415641	113615641	harbor1	chr9	113427122	113427166	DNA/hAT-Charlie	549	+	22	113427144	11503
chr9	113415641	113615641	harbor1	chr9	113427477	113427626	DNA/hAT-Charlie	549	+	74	113427551	11910
chr9	113415641	113615641	harbor1	chr9	113499704	113499857	DNA/hAT-Charlie	612	+	76	113499780	84139
chr9	19514673	19714673	harbor1	chr9	19571533	19571697	DNA/hAT-Charlie	903	+	82	19571615	56942
chr9	95712097	95912097	harbor1	chr9	95713574	95713848	DNA/hAT-Charlie	594	+	137	95713711	1614
chr9	95712097	95912097	harbor1	chr9	95741128	95741355	DNA/hAT-Charlie	483	+	114	95741242	29145
chr9	95712097	95912097	harbor1	chr9	95753422	95753609	DNA/hAT-Charlie	864	+	94	95753516	41419
chr9	95712097	95912097	harbor1	chr9	95763924	95764089	DNA/hAT-Charlie	717	+	82	95764006	51909
chr9	95712097	95912097	harbor1	chr9	95771182	95771298	DNA/hAT-Charlie	447	+	58	95771240	59143
chr9	95712097	95912097	harbor1	chr9	95786116	95786301	DNA/hAT-Charlie	622	+	92	95786208	74111
chr9	95712097	95912097	harbor1	chr9	95793396	95793514	DNA/hAT-Charlie	637	+	59	95793455	81358
chr9	103338140	103538140	harbor1	chr9	103354629	103354847	DNA/hAT-Charlie	896	+	109	103354738	16598
chr9	103338140	103538140	harbor1	chr9	103430096	103430410	DNA/hAT-Charlie	806	+	157	103430253	92113
chr9	33552175	33752175	harbor1	chr9	33631804	33632326	DNA/hAT-Charlie	1011	+	261	33632065	79890
chr9	99822946	100022946	harbor1	chr9	99843200	99843339	DNA/hAT-Charlie	601	+	70	99843270	20324
chr9	99822946	100022946	harbor1	chr9	99844227	99844406	DNA/hAT-Charlie	863	+	90	99844317	21371
chr9	99822946	100022946	harbor1	chr9	99871996	99872174	DNA/hAT-Charlie	1106	+	89	99872085	49139
chr9	99822946	100022946	harbor1	chr9	99877799	99877962	DNA/hAT-Charlie	497	+	82	99877881	54935
chr9	93887463	94087463	harbor1	chr9	93893372	93893560	DNA/hAT-Charlie	895	+	94	93893466	6003
chr9	93887463	94087463	harbor1	chr9	93919918	93920088	DNA/hAT-Charlie	580	+	85	93920003	32540
chr9	93887463	94087463	harbor1	chr9	93935428	93935630	DNA/hAT-Charlie	520	+	101	93935529	48066
chr9	93887463	94087463	harbor1	chr9	93936395	93936406	DNA/hAT-Charlie	520	+	6	93936401	48938
chr9	21362181	21562181	harbor1	chr9	21407932	21408987	DNA/hAT-Charlie	2476	+	528	21408460	46279
chr9	21362181	21562181	harbor1	chr9	21437307	21437869	DNA/hAT-Charlie	2294	+	281	21437588	75407
chr9	21362181	21562181	harbor1	chr9	21439559	21439668	DNA/hAT-Charlie	906	+	54	21439613	77432
chr9	21362181	21562181	harbor1	chr9	21439986	21440310	DNA/hAT-Charlie	906	+	162	21440148	77967
chr9	21362181	21562181	harbor1	chr9	21454992	21455300	DNA/hAT-Charlie	1420	+	154	21455146	92965
chr9	71815207	72015207	harbor1	chr9	71820718	71820841	DNA/hAT-Charlie	742	+	62	71820780	5573
chr9	71815207	72015207	harbor1	chr9	71821178	71821204	DNA/hAT-Charlie	742	+	13	71821191	5984
chr9	71815207	72015207	harbor1	chr9	71906195	71906463	DNA/hAT-Charlie	563	+	134	71906329	91122
chr9	71815207	72015207	harbor1	chr9	71914236	71914439	DNA/hAT-Charlie	1390	+	102	71914338	99131
chr9	124069006	124269006	harbor1	chr9	124089517	124089676	DNA/hAT-Charlie	876	+	80	124089597	20591
chr9	124069006	124269006	harbor1	chr9	124117391	124117522	DNA/hAT-Charlie	451	+	66	124117457	48451
chr9	26128453	26328453	harbor1	chr9	26131131	26131293	DNA/hAT-Charlie	505	+	81	26131212	2759
chr9	26128453	26328453	harbor1	chr9	26131614	26131850	DNA/hAT-Charlie	853	+	118	26131732	3279
chr9	26128453	26328453	harbor1	chr9	26139007	26139226	DNA/hAT-Charlie	440	+	110	26139117	10664
chr9	26128453	26328453	harbor1	chr9	26142674	26142891	DNA/hAT-Charlie	1013	+	108	26142782	14329
chr9	26128453	26328453	harbor1	chr9	26150531	26150674	DNA/hAT-Charlie	606	+	72	26150603	22150
chr9	26128453	26328453	harbor1	chr9	26151935	26152040	DNA/hAT-Charlie	451	+	52	26151987	23534
chr9	26128453	26328453	harbor1	chr9	26194190	26194526	DNA/hAT-Charlie	1987	+	168	26194358	65905
chr9	26128453	26328453	harbor1	chr9	26217732	26217915	DNA/hAT-Charlie	925	+	92	26217824	89371
chr9	67564572	67764572	harbor1	chr9	67575298	67575390	DNA/hAT-Charlie	482	+	46	67575344	10772
chr9	67564572	67764572	harbor1	chr9	67630726	67630825	DNA/hAT-Charlie	1787	+	50	67630776	66204
chr9	67564572	67764572	harbor1	chr9	67631125	67631221	DNA/hAT-Charlie	1787	+	48	67631173	66601
chr9	67564572	67764572	harbor1	chr9	67631517	67631801	DNA/hAT-Charlie	1787	+	142	67631659	67087
chr9	30571757	30771757	harbor1	chr9	30607425	30607638	DNA/hAT-Charlie	654	+	106	30607531	35774
chr9	100749114	100949114	harbor1	chr9	100759774	100760091	DNA/hAT-Charlie	1097	+	158	100759932	10818
chr9	100749114	100949114	harbor1	chr9	100768317	100768424	DNA/hAT-Charlie	427	+	54	100768371	19257
chr9	100749114	100949114	harbor1	chr9	100768529	100768750	DNA/hAT-Charlie	1065	+	110	100768639	19525
chr9	100749114	100949114	harbor1	chr9	100811093	100811294	DNA/hAT-Charlie	883	+	100	100811193	62079
chr9	100749114	100949114	harbor1	chr9	100847651	100847887	DNA/hAT-Charlie	589	+	118	100847769	98655
chr9	77686599	77886599	harbor1	chr9	77738602	77738804	DNA/hAT-Charlie	645	+	101	77738703	52104
chr9	120819187	121019187	harbor1	chr9	120819189	120819328	DNA/hAT-Charlie	664	+	70	120819259	72
chr9	120819187	121019187	harbor1	chr9	120849534	120849660	DNA/hAT-Charlie	670	+	63	120849597	30410
chr9	120819187	121019187	harbor1	chr9	120893890	120894033	DNA/hAT-Charlie	519	+	72	120893962	74775
chr9	92345684	92545684	harbor1	chr9	92419769	92419944	DNA/hAT-Charlie	600	+	88	92419857	74173
chr9	92345684	92545684	harbor1	chr9	92428302	92428477	DNA/hAT-Charlie	410	+	88	92428390	82706
chr9	130370027	130570027	harbor1	chr9	130371669	130371858	DNA/hAT-Charlie	560	+	94	130371763	1736
chr9	130370027	130570027	harbor1	chr9	130401147	130401333	DNA/hAT-Charlie	626	+	93	130401240	31213
chr9	130370027	130570027	harbor1	chr9	130401623	130401741	DNA/hAT-Charlie	626	+	59	130401682	31655
chr9	130370027	130570027	harbor1	chr9	130426651	130426879	DNA/hAT-Charlie	1720	+	114	130426765	56738
chr9	6225801	6425801	harbor1	chr9	6227471	6227638	DNA/hAT-Charlie	452	+	84	6227555	1754
chr9	6225801	6425801	harbor1	chr9	6237511	6237742	DNA/hAT-Charlie	420	+	116	6237627	11826
chr9	6225801	6425801	harbor1	chr9	6245155	6245389	DNA/hAT-Charlie	699	+	117	6245272	19471
chr9	6225801	6425801	harbor1	chr9	6251009	6251757	DNA/hAT-Charlie	1970	+	374	6251383	25582
chr9	6225801	6425801	harbor1	chr9	6252064	6252387	DNA/hAT-Charlie	1970	+	162	6252226	26425
chr9	6225801	6425801	harbor1	chr9	6253087	6253270	DNA/hAT-Charlie	421	+	92	6253179	27378
chr9	6225801	6425801	harbor1	chr9	6254751	6254908	DNA/hAT-Charlie	754	+	78	6254829	29028
chr9	6225801	6425801	harbor1	chr9	6307425	6307585	DNA/hAT-Charlie	836	+	80	6307505	81704
chr9	70478800	70678800	harbor1	chr9	70510228	70510433	DNA/hAT-Charlie	721	+	102	70510330	31530
chr9	70478800	70678800	harbor1	chr9	70511905	70511972	DNA/hAT-Charlie	1388	+	34	70511939	33139
chr9	70478800	70678800	harbor1	chr9	70512281	70512489	DNA/hAT-Charlie	1388	+	104	70512385	33585
chr9	70478800	70678800	harbor1	chr9	70546223	70546429	DNA/hAT-Charlie	906	+	103	70546326	67526
chr9	70478800	70678800	harbor1	chr9	70548693	70548853	DNA/hAT-Charlie	555	+	80	70548773	69973
chr9	70478800	70678800	harbor1	chr9	70554512	70554685	DNA/hAT-Charlie	739	+	86	70554598	75798
chr9	70478800	70678800	harbor1	chr9	70561803	70562220	DNA/hAT-Charlie	1031	+	208	70562011	83211
chr9	36869117	37069117	harbor1	chr9	36914092	36914725	DNA/hAT-Charlie	1957	+	316	36914408	45291
chr9	36869117	37069117	harbor1	chr9	36957564	36957729	DNA/hAT-Charlie	569	+	82	36957646	88529
chr9	26585234	26785234	harbor1	chr9	26655663	26656161	DNA/hAT-Charlie	1331	+	249	26655912	70678
chr9	99559588	99759588	harbor1	chr9	99574774	99574947	DNA/hAT-Charlie	671	+	86	99574860	15272
chr9	99559588	99759588	harbor1	chr9	99592939	99593196	DNA/hAT-Charlie	526	+	128	99593067	33479
chr9	99559588	99759588	harbor1	chr9	99635604	99635805	DNA/hAT-Charlie	874	+	100	99635704	76116
chr9	99559588	99759588	harbor1	chr9	99638116	99638429	DNA/hAT-Charlie	1504	+	156	99638272	78684
chr9	115316730	115516730	harbor1	chr9	115350321	115350540	DNA/hAT-Charlie	1217	+	110	115350431	33701
chr9	115316730	115516730	harbor1	chr9	115364157	115364458	DNA/hAT-Charlie	1268	+	150	115364307	47577
chr9	118473862	118673862	harbor1	chr9	118513499	118513660	DNA/hAT-Charlie	668	+	80	118513579	39717
chr9	118473862	118673862	harbor1	chr9	118530657	118530810	DNA/hAT-Charlie	539	+	76	118530733	56871
chr9	118473862	118673862	harbor1	chr9	118530898	118531079	DNA/hAT-Charlie	765	+	90	118530988	57126
chr9	128502440	128702440	harbor1	chr9	128590273	128590422	DNA/hAT-Charlie	602	+	74	128590347	87907
chr9	128502440	128702440	harbor1	chr9	128590860	128590922	DNA/hAT-Charlie	602	+	31	128590891	88451
chr9	90208311	90408311	harbor1	chr9	90278729	90278913	DNA/hAT-Charlie	1180	+	92	90278821	70510
chr9	90208311	90408311	harbor1	chr9	90287076	90287272	DNA/hAT-Charlie	488	+	98	90287174	78863
chr9	111316148	111516148	harbor1	chr9	111316676	111317116	DNA/hAT-Charlie	1776	+	220	111316896	748
chr9	111316148	111516148	harbor1	chr9	111317398	111317456	DNA/hAT-Charlie	1776	+	29	111317427	1279
chr9	36546922	36746922	harbor1	chr9	36645804	36645959	DNA/hAT-Charlie	722	+	78	36645882	98960
chr9	36546922	36746922	harbor1	chr9	36645970	36646185	DNA/hAT-Charlie	1284	+	108	36646078	99156
chr9	8477014	8677014	harbor1	chr9	8495503	8495751	DNA/hAT-Charlie	545	+	124	8495627	18613
chr9	8477014	8677014	harbor1	chr9	8496790	8496952	DNA/hAT-Charlie	1077	+	81	8496871	19857
chr9	133282205	133482205	harbor1	chr9	133324415	133324656	DNA/hAT-Charlie	1551	+	120	133324535	42330
chr9	17834613	18034613	harbor1	chr9	17835808	17835888	DNA/hAT-Charlie	810	+	40	17835848	1235
chr9	17834613	18034613	harbor1	chr9	17835933	17836044	DNA/hAT-Charlie	810	+	56	17835989	1376
chr9	17834613	18034613	harbor1	chr9	17908253	17908433	DNA/hAT-Charlie	420	+	90	17908343	73730
chr9	35464954	35664954	harbor1	chr9	35536161	35536307	DNA/hAT-Charlie	442	+	73	35536234	71280
chr9	122046153	122246153	harbor1	chr9	122130178	122130504	DNA/hAT-Charlie	1401	+	163	122130341	84188
chr9	122046153	122246153	harbor1	chr9	122139993	122140087	DNA/hAT-Charlie	525	+	47	122140040	93887
chr9	122046153	122246153	harbor1	chr9	122142116	122142220	DNA/hAT-Charlie	413	+	52	122142168	96015
chr9	122046153	122246153	harbor1	chr9	122142352	122142523	DNA/hAT-Charlie	838	+	86	122142438	96285
chr9	133890793	134090793	harbor1	chr9	133941021	133941125	DNA/hAT-Charlie	571	+	52	133941073	50280
chr9	133890793	134090793	harbor1	chr9	133941427	133941509	DNA/hAT-Charlie	571	+	41	133941468	50675
chr9	133890793	134090793	harbor1	chr9	133946604	133946739	DNA/hAT-Charlie	474	+	68	133946672	55879
chr9	133890793	134090793	harbor1	chr9	133982707	133983016	DNA/hAT-Charlie	1193	+	154	133982861	92068
chr9	133890793	134090793	harbor1	chr9	133984925	133985047	DNA/hAT-Charlie	501	+	61	133984986	94193
chr9	65716215	65916215	harbor1	chr9	65744209	65744391	DNA/hAT-Charlie	488	+	91	65744300	28085
chr9	91234380	91434380	harbor1	chr9	91240545	91240732	DNA/hAT-Charlie	830	+	94	91240639	6259
chr9	91234380	91434380	harbor1	chr9	91306531	91306707	DNA/hAT-Charlie	685	+	88	91306619	72239
chr9	91234380	91434380	harbor1	chr9	91321663	91321974	DNA/hAT-Charlie	1449	+	156	91321819	87439
chr9	100686419	100886419	harbor1	chr9	100687514	100687705	DNA/hAT-Charlie	762	+	96	100687610	1191
chr9	100686419	100886419	harbor1	chr9	100687735	100687893	DNA/hAT-Charlie	684	+	79	100687814	1395
chr9	100686419	100886419	harbor1	chr9	100720078	100720204	DNA/hAT-Charlie	546	+	63	100720141	33722
chr9	100686419	100886419	harbor1	chr9	100759774	100760091	DNA/hAT-Charlie	1097	+	158	100759932	73513
chr9	100686419	100886419	harbor1	chr9	100768317	100768424	DNA/hAT-Charlie	427	+	54	100768371	81952
chr9	100686419	100886419	harbor1	chr9	100768529	100768750	DNA/hAT-Charlie	1065	+	110	100768639	82220
chr9	109986587	110186587	harbor1	chr9	110013916	110014123	DNA/hAT-Charlie	881	+	104	110014020	27433
chr9	109986587	110186587	harbor1	chr9	110057712	110057876	DNA/hAT-Charlie	720	+	82	110057794	71207
chr9	109986587	110186587	harbor1	chr9	110057954	110058117	DNA/hAT-Charlie	814	+	82	110058036	71449
chr9	69343718	69543718	harbor1	chr9	69425527	69426055	DNA/hAT-Charlie	3097	+	264	69425791	82073
chr9	69343718	69543718	harbor1	chr9	69443112	69443290	DNA/hAT-Charlie	778	+	89	69443201	99483
chr9	93540116	93740116	harbor1	chr9	93559874	93560011	DNA/hAT-Charlie	853	+	68	93559942	19826
chr9	93540116	93740116	harbor1	chr9	93560307	93560455	DNA/hAT-Charlie	853	+	74	93560381	20265
chr9	132821788	133021788	harbor1	chr9	132849286	132849505	DNA/hAT-Charlie	946	+	110	132849396	27608
chr9	132821788	133021788	harbor1	chr9	132876241	132876443	DNA/hAT-Charlie	586	+	101	132876342	54554
chr9	132821788	133021788	harbor1	chr9	132901916	132902432	DNA/hAT-Charlie	1866	+	258	132902174	80386
chr9	84448714	84648714	harbor1	chr9	84474446	84474628	DNA/hAT-Charlie	537	+	91	84474537	25823
chr9	84448714	84648714	harbor1	chr9	84484897	84485110	DNA/hAT-Charlie	594	+	106	84485003	36289
chr9	84448714	84648714	harbor1	chr9	84485123	84485250	DNA/hAT-Charlie	608	+	64	84485187	36473
chr9	84448714	84648714	harbor1	chr9	84485495	84485576	DNA/hAT-Charlie	460	+	40	84485535	36821
chr9	84448714	84648714	harbor1	chr9	84490908	84491098	DNA/hAT-Charlie	631	+	95	84491003	42289
chr9	84448714	84648714	harbor1	chr9	84491170	84491444	DNA/hAT-Charlie	986	+	137	84491307	42593
chr9	84448714	84648714	harbor1	chr9	84498964	84499153	DNA/hAT-Charlie	507	+	94	84499058	50344
chr9	84448714	84648714	harbor1	chr9	84517236	84517386	DNA/hAT-Charlie	845	+	75	84517311	68597
chr9	13629385	13829385	harbor1	chr9	13647409	13647497	DNA/hAT-Charlie	498	+	44	13647453	18068
chr9	13629385	13829385	harbor1	chr9	13651556	13651749	DNA/hAT-Charlie	599	+	96	13651652	22267
chr9	13629385	13829385	harbor1	chr9	13659480	13659690	DNA/hAT-Charlie	851	+	105	13659585	30200
chr9	76511411	76711411	harbor1	chr9	76521941	76521987	DNA/hAT-Charlie	723	+	23	76521964	10553
chr9	76511411	76711411	harbor1	chr9	76522305	76522401	DNA/hAT-Charlie	723	+	48	76522353	10942
chr9	76511411	76711411	harbor1	chr9	76522706	76522758	DNA/hAT-Charlie	723	+	26	76522732	11321
chr9	76511411	76711411	harbor1	chr9	76548494	76548728	DNA/hAT-Charlie	553	+	117	76548611	37200
chr9	76511411	76711411	harbor1	chr9	76577947	76578108	DNA/hAT-Charlie	1132	+	80	76578027	66616
chr9	76511411	76711411	harbor1	chr9	76578399	76578577	DNA/hAT-Charlie	1132	+	89	76578488	67077
chr9	3979551	4179551	harbor1	chr9	4023802	4023966	DNA/hAT-Charlie	548	+	82	4023884	44333
chr9	3979551	4179551	harbor1	chr9	4033558	4033692	DNA/hAT-Charlie	555	+	67	4033625	54074
chr9	3979551	4179551	harbor1	chr9	4040858	4041029	DNA/hAT-Charlie	595	+	86	4040944	61393
chr9	3979551	4179551	harbor1	chr9	4041194	4041399	DNA/hAT-Charlie	630	+	102	4041296	61745
chr9	24480570	24680570	harbor1	chr9	24527425	24527528	DNA/hAT-Charlie	622	+	52	24527477	46907
chr9	24480570	24680570	harbor1	chr9	24528830	24528959	DNA/hAT-Charlie	656	+	64	24528894	48324
chr9	24480570	24680570	harbor1	chr9	24528962	24529309	DNA/hAT-Charlie	1370	+	174	24529136	48566
chr9	40317669	40517669	harbor1	chr9	40400375	40400474	DNA/hAT-Charlie	429	+	50	40400425	82756
chr9	40317669	40517669	harbor1	chr9	40413233	40413406	DNA/hAT-Charlie	612	+	86	40413319	95650
chr9	107607690	107807690	harbor1	chr9	107618142	107618317	DNA/hAT-Charlie	998	+	88	107618230	10540
chr9	107607690	107807690	harbor1	chr9	107673747	107674009	DNA/hAT-Charlie	571	+	131	107673878	66188
chr9	107607690	107807690	harbor1	chr9	107690320	107690523	DNA/hAT-Charlie	1032	+	102	107690422	82732
chr9	81571714	81771714	harbor1	chr9	81579158	81579333	DNA/hAT-Charlie	869	+	88	81579246	7532
chr9	81571714	81771714	harbor1	chr9	81630235	81630640	DNA/hAT-Charlie	989	+	202	81630437	58723
chr9	81571714	81771714	harbor1	chr9	81639960	81640173	DNA/hAT-Charlie	905	+	106	81640066	68352
chr9	126244659	126444659	harbor1	chr9	126252020	126252171	DNA/hAT-Charlie	1248	+	76	126252096	7437
chr9	126244659	126444659	harbor1	chr9	126252518	126252675	DNA/hAT-Charlie	1248	+	78	126252596	7937
chr9	126244659	126444659	harbor1	chr9	126257765	126257869	DNA/hAT-Charlie	561	+	52	126257817	13158
chr9	126244659	126444659	harbor1	chr9	126268018	126268190	DNA/hAT-Charlie	1005	+	86	126268104	23445
chr9	126244659	126444659	harbor1	chr9	126325243	126325462	DNA/hAT-Charlie	651	+	110	126325353	80694
chr9	126244659	126444659	harbor1	chr9	126330448	126330582	DNA/hAT-Charlie	416	+	67	126330515	85856
chr9	126244659	126444659	harbor1	chr9	126333925	126334100	DNA/hAT-Charlie	610	+	88	126334013	89354
chr9	133275748	133475748	harbor1	chr9	133324415	133324656	DNA/hAT-Charlie	1551	+	120	133324535	48787
chr9	42814263	43014263	harbor1	chr9	42858842	42859076	DNA/hAT-Charlie	417	+	117	42858959	44696
chr9	71323909	71523909	harbor1	chr9	71403129	71403349	DNA/hAT-Charlie	1107	+	110	71403239	79330
chr9	37212323	37412323	harbor1	chr9	37219179	37219384	DNA/hAT-Charlie	780	+	102	37219281	6958
chr9	37212323	37412323	harbor1	chr9	37232512	37232690	DNA/hAT-Charlie	816	+	89	37232601	20278
chr9	37212323	37412323	harbor1	chr9	37256286	37256650	DNA/hAT-Charlie	1370	+	182	37256468	44145
chr9	37212323	37412323	harbor1	chr9	37256667	37256919	DNA/hAT-Charlie	2102	+	126	37256793	44470
chr9	37212323	37412323	harbor1	chr9	37257414	37257753	DNA/hAT-Charlie	2102	+	170	37257584	45261
chr9	37212323	37412323	harbor1	chr9	37269991	37270256	DNA/hAT-Charlie	877	+	132	37270123	57800
chr9	37212323	37412323	harbor1	chr9	37273022	37273216	DNA/hAT-Charlie	939	+	97	37273119	60796
chr9	81054815	81254815	harbor1	chr9	81080244	81080336	DNA/hAT-Charlie	409	+	46	81080290	25475
chr9	81054815	81254815	harbor1	chr9	81128237	81128331	DNA/hAT-Charlie	425	+	47	81128284	73469
chr9	105025159	105225159	harbor1	chr9	105048403	105048612	DNA/hAT-Charlie	1296	+	104	105048507	23348
chr9	105025159	105225159	harbor1	chr9	105075009	105075214	DNA/hAT-Charlie	1020	+	102	105075111	49952
chr9	73838518	74038518	harbor1	chr9	73906611	73906791	DNA/hAT-Charlie	820	+	90	73906701	68183
chr9	73838518	74038518	harbor1	chr9	73910429	73910581	DNA/hAT-Charlie	1243	+	76	73910505	71987
chr9	73838518	74038518	harbor1	chr9	73910884	73911066	DNA/hAT-Charlie	1243	+	91	73910975	72457
chr9	73838518	74038518	harbor1	chr9	73911378	73912012	DNA/hAT-Charlie	1243	+	317	73911695	73177
chr9	73838518	74038518	harbor1	chr9	73913073	73913252	DNA/hAT-Charlie	866	+	90	73913163	74645
chr9	111042351	111242351	harbor1	chr9	111073238	111073456	DNA/hAT-Charlie	1149	+	109	111073347	30996
chr9	111042351	111242351	harbor1	chr9	111096266	111096410	DNA/hAT-Charlie	798	+	72	111096338	53987
chr9	111042351	111242351	harbor1	chr9	111111298	111112519	DNA/hAT-Charlie	4965	+	610	111111908	69557
chr9	105415116	105615116	harbor1	chr9	105439105	105439292	DNA/hAT-Charlie	875	+	94	105439199	24083
chr9	105415116	105615116	harbor1	chr9	105461235	105461524	DNA/hAT-Charlie	1063	+	144	105461379	46263
chr9	70000999	70200999	harbor1	chr9	70006878	70007042	DNA/hAT-Charlie	586	+	82	70006960	5961
chr9	70000999	70200999	harbor1	chr9	70043029	70043194	DNA/hAT-Charlie	537	+	82	70043111	42112
chr9	70000999	70200999	harbor1	chr9	70056668	70057184	DNA/hAT-Charlie	3413	+	258	70056926	55927
chr9	70000999	70200999	harbor1	chr9	70077372	70077579	DNA/hAT-Charlie	914	+	104	70077476	76477
chr9	70000999	70200999	harbor1	chr9	70088545	70088847	DNA/hAT-Charlie	655	+	151	70088696	87697
chr9	9937719	10137719	harbor1	chr9	9975475	9975635	DNA/hAT-Charlie	455	+	80	9975555	37836
chr9	9937719	10137719	harbor1	chr9	9976028	9976312	DNA/hAT-Charlie	497	+	142	9976170	38451
chr9	9937719	10137719	harbor1	chr9	9976867	9977028	DNA/hAT-Charlie	478	+	80	9976947	39228
chr9	41131706	41331706	harbor1	chr9	41175841	41176053	DNA/hAT-Charlie	1207	+	106	41175947	44241
chr9	41131706	41331706	harbor1	chr9	41204108	41204356	DNA/hAT-Charlie	602	+	124	41204232	72526
chr9	12860986	13060986	harbor1	chr9	12919563	12919663	DNA/hAT-Charlie	421	+	50	12919613	58627
chr9	118232156	118432156	harbor1	chr9	118301863	118302124	DNA/hAT-Charlie	819	+	130	118301993	69837
chr9	134939772	135139772	harbor1	chr9	135009561	135009785	DNA/hAT-Charlie	1416	+	112	135009673	69901
chr9	134939772	135139772	harbor1	chr9	135004099	135004274	DNA/hAT-Charlie	721	+	88	135004187	64415
chr9	70300878	70500878	harbor1	chr9	70334529	70334720	DNA/hAT-Charlie	436	+	96	70334625	33747
chr9	70300878	70500878	harbor1	chr9	70391696	70392020	DNA/hAT-Charlie	1214	+	162	70391858	90980
chr9	85697984	85897984	harbor1	chr9	85725347	85725627	DNA/hAT-Charlie	2897	+	140	85725487	27503
chr9	85697984	85897984	harbor1	chr9	85726260	85726990	DNA/hAT-Charlie	2897	+	365	85726625	28641
chr9	85697984	85897984	harbor1	chr9	85727351	85727732	DNA/hAT-Charlie	3804	+	190	85727541	29557
chr9	85697984	85897984	harbor1	chr9	85728018	85728030	DNA/hAT-Charlie	3804	+	6	85728024	30040
chr9	85697984	85897984	harbor1	chr9	85728078	85728909	DNA/hAT-Charlie	3804	+	416	85728494	30510
chr9	85697984	85897984	harbor1	chr9	85767859	85767995	DNA/hAT-Charlie	602	+	68	85767927	69943
chr9	85697984	85897984	harbor1	chr9	85737136	85738261	DNA/hAT-Charlie	4087	+	562	85737698	39714
chr9	70021680	70221680	harbor1	chr9	70043029	70043194	DNA/hAT-Charlie	537	+	82	70043111	21431
chr9	70021680	70221680	harbor1	chr9	70056668	70057184	DNA/hAT-Charlie	3413	+	258	70056926	35246
chr9	70021680	70221680	harbor1	chr9	70077372	70077579	DNA/hAT-Charlie	914	+	104	70077476	55796
chr9	70021680	70221680	harbor1	chr9	70088545	70088847	DNA/hAT-Charlie	655	+	151	70088696	67016
chr9	70021680	70221680	harbor1	chr9	70105252	70105379	DNA/hAT-Charlie	514	+	64	70105316	83636
chr9	70021680	70221680	harbor1	chr9	70106008	70106179	DNA/hAT-Charlie	482	+	86	70106094	84414
chr9	70021680	70221680	harbor1	chr9	70117668	70117865	DNA/hAT-Charlie	522	+	98	70117766	96086
chr9	16021054	16221054	harbor1	chr9	16029385	16029570	DNA/hAT-Charlie	526	+	92	16029477	8423
chr9	16021054	16221054	harbor1	chr9	16033232	16033761	DNA/hAT-Charlie	3731	+	264	16033496	12442
chr9	16021054	16221054	harbor1	chr9	16071991	16072261	DNA/hAT-Charlie	472	+	135	16072126	51072
chr9	16021054	16221054	harbor1	chr9	16075768	16075843	DNA/hAT-Charlie	488	+	38	16075806	54752
chr9	16021054	16221054	harbor1	chr9	16075903	16076026	DNA/hAT-Charlie	488	+	62	16075965	54911
chr9	16021054	16221054	harbor1	chr9	16117990	16118173	DNA/hAT-Charlie	967	+	92	16118082	97028
chr9	16021054	16221054	harbor1	chr9	16056257	16056465	DNA/hAT-Charlie	1048	+	104	16056361	35307
chr9	75138945	75338945	harbor1	chr9	75172059	75172316	DNA/hAT-Charlie	902	+	128	75172187	33242
chr9	75138945	75338945	harbor1	chr9	75233951	75234052	DNA/hAT-Charlie	414	+	50	75234001	95056
chr9	36860327	37060327	harbor1	chr9	36860351	36860491	DNA/hAT-Charlie	465	+	70	36860421	94
chr9	36860327	37060327	harbor1	chr9	36914092	36914725	DNA/hAT-Charlie	1957	+	316	36914408	54081
chr9	36860327	37060327	harbor1	chr9	36957564	36957729	DNA/hAT-Charlie	569	+	82	36957646	97319
chr9	131191662	131391662	harbor1	chr9	131237734	131237906	DNA/hAT-Charlie	495	+	86	131237820	46158
chr9	131191662	131391662	harbor1	chr9	131272301	131272491	DNA/hAT-Charlie	736	+	95	131272396	80734
chr9	37615157	37815157	harbor1	chr9	37625866	37625940	DNA/hAT-Charlie	427	+	37	37625903	10746
chr9	37615157	37815157	harbor1	chr9	37626522	37626537	DNA/hAT-Charlie	427	+	8	37626530	11373
chr9	37615157	37815157	harbor1	chr9	37626808	37626929	DNA/hAT-Charlie	427	+	60	37626868	11711
chr9	37615157	37815157	harbor1	chr9	37628839	37628916	DNA/hAT-Charlie	877	+	38	37628877	13720
chr9	37615157	37815157	harbor1	chr9	37629214	37629311	DNA/hAT-Charlie	877	+	48	37629262	14105
chr9	37615157	37815157	harbor1	chr9	37669315	37669480	DNA/hAT-Charlie	721	+	82	37669397	54240
chr9	37615157	37815157	harbor1	chr9	37680281	37680461	DNA/hAT-Charlie	598	+	90	37680371	65214
chr9	37615157	37815157	harbor1	chr9	37704178	37704482	DNA/hAT-Charlie	1492	+	152	37704330	89173
chr9	105729439	105929439	harbor1	chr9	105761678	105761849	DNA/hAT-Charlie	570	+	86	105761764	32325
chr9	87928835	88128835	harbor1	chr9	87987540	87987822	DNA/hAT-Charlie	1582	+	141	87987681	58846
chr9	87928835	88128835	harbor1	chr9	87999476	87999635	DNA/hAT-Charlie	583	+	80	87999556	70721
chr9	76215837	76415837	harbor1	chr9	76230525	76231022	DNA/hAT-Charlie	3547	+	248	76230773	14936
chr9	76215837	76415837	harbor1	chr9	76232471	76232594	DNA/hAT-Charlie	513	+	62	76232533	16696
chr9	76215837	76415837	harbor1	chr9	76234219	76234572	DNA/hAT-Charlie	544	+	176	76234395	18558
chr9	76215837	76415837	harbor1	chr9	76249096	76249303	DNA/hAT-Charlie	996	+	104	76249200	33363
chr10	3508070	3708070	harbor1	chr10	3535232	3535433	DNA/hAT-Charlie	553	+	100	3535332	27262
chr10	3508070	3708070	harbor1	chr10	3555745	3555855	DNA/hAT-Charlie	451	+	55	3555800	47730
chr10	3508070	3708070	harbor1	chr10	3555856	3556232	DNA/hAT-Charlie	1356	+	188	3556044	47974
chr10	3508070	3708070	harbor1	chr10	3559555	3559974	DNA/hAT-Charlie	451	+	210	3559765	51695
chr10	3508070	3708070	harbor1	chr10	3568503	3568652	DNA/hAT-Charlie	563	+	74	3568577	60507
chr10	3508070	3708070	harbor1	chr10	3580971	3581165	DNA/hAT-Charlie	671	+	97	3581068	72998
chr10	57229440	57429440	harbor1	chr10	57286427	57286611	DNA/hAT-Charlie	809	+	92	57286519	57079
chr10	109893345	110093345	harbor1	chr10	109901586	109901705	DNA/hAT-Charlie	610	+	60	109901646	8301
chr10	109893345	110093345	harbor1	chr10	109901703	109902071	DNA/hAT-Charlie	1666	+	184	109901887	8542
chr10	109893345	110093345	harbor1	chr10	109930534	109930597	DNA/hAT-Charlie	411	+	32	109930566	37221
chr10	109893345	110093345	harbor1	chr10	109930908	109931117	DNA/hAT-Charlie	411	+	104	109931012	37667
chr10	109893345	110093345	harbor1	chr10	109940963	109941158	DNA/hAT-Charlie	871	+	98	109941061	47716
chr10	109893345	110093345	harbor1	chr10	109946738	109946845	DNA/hAT-Charlie	544	+	54	109946792	53447
chr10	109893345	110093345	harbor1	chr10	109956577	109956801	DNA/hAT-Charlie	1333	+	112	109956689	63344
chr10	109893345	110093345	harbor1	chr10	109972386	109972539	DNA/hAT-Charlie	836	+	76	109972462	79117
chr10	121733822	121933822	harbor1	chr10	121776563	121776732	DNA/hAT-Charlie	429	+	84	121776647	42825
chr10	121733822	121933822	harbor1	chr10	121807717	121807990	DNA/hAT-Charlie	1255	+	136	121807853	74031
chr10	99327912	99527912	harbor1	chr10	99333999	99334168	DNA/hAT-Charlie	939	+	84	99334083	6171
chr10	99327912	99527912	harbor1	chr10	99339393	99339719	DNA/hAT-Charlie	2088	+	163	99339556	11644
chr10	99327912	99527912	harbor1	chr10	99349206	99349364	DNA/hAT-Charlie	756	+	79	99349285	21373
chr10	99327912	99527912	harbor1	chr10	99360990	99361096	DNA/hAT-Charlie	453	+	53	99361043	33131
chr10	99327912	99527912	harbor1	chr10	99383865	99384153	DNA/hAT-Charlie	1180	+	144	99384009	56097
chr10	99327912	99527912	harbor1	chr10	99386266	99386447	DNA/hAT-Charlie	1025	+	90	99386356	58444
chr10	99327912	99527912	harbor1	chr10	99390620	99390810	DNA/hAT-Charlie	713	+	95	99390715	62803
chr10	99327912	99527912	harbor1	chr10	99393336	99393509	DNA/hAT-Charlie	450	+	86	99393422	65510
chr10	99327912	99527912	harbor1	chr10	99396820	99397016	DNA/hAT-Charlie	539	+	98	99396918	69006
chr10	92851216	93051216	harbor1	chr10	92864984	92865143	DNA/hAT-Charlie	553	+	80	92865064	13848
chr10	92851216	93051216	harbor1	chr10	92914031	92914292	DNA/hAT-Charlie	1806	+	130	92914161	62945
chr10	92851216	93051216	harbor1	chr10	92914327	92914488	DNA/hAT-Charlie	569	+	80	92914407	63191
chr10	92851216	93051216	harbor1	chr10	92919297	92919401	DNA/hAT-Charlie	413	+	52	92919349	68133
chr10	92851216	93051216	harbor1	chr10	92923838	92924683	DNA/hAT-Charlie	2313	+	422	92924260	73044
chr10	92851216	93051216	harbor1	chr10	92925014	92925299	DNA/hAT-Charlie	2313	+	142	92925156	73940
chr10	92851216	93051216	harbor1	chr10	92925594	92925643	DNA/hAT-Charlie	2313	+	24	92925618	74402
chr10	92851216	93051216	harbor1	chr10	92925929	92926114	DNA/hAT-Charlie	458	+	92	92926021	74805
chr10	92851216	93051216	harbor1	chr10	92926123	92926305	DNA/hAT-Charlie	476	+	91	92926214	74998
chr10	127440355	127640355	harbor1	chr10	127450735	127450944	DNA/hAT-Charlie	870	+	104	127450839	10484
chr10	127440355	127640355	harbor1	chr10	127486685	127486915	DNA/hAT-Charlie	6079	+	115	127486800	46445
chr10	127440355	127640355	harbor1	chr10	127487213	127488344	DNA/hAT-Charlie	6079	+	566	127487779	47424
chr10	127440355	127640355	harbor1	chr10	127507117	127507285	DNA/hAT-Charlie	440	+	84	127507201	66846
chr10	127440355	127640355	harbor1	chr10	127524944	127525102	DNA/hAT-Charlie	427	+	79	127525023	84668
chr10	127440355	127640355	harbor1	chr10	127533098	127533329	DNA/hAT-Charlie	1433	+	116	127533214	92859
chr10	113852404	114052404	harbor1	chr10	113879102	113879267	DNA/hAT-Charlie	431	+	82	113879184	26780
chr10	113852404	114052404	harbor1	chr10	113880872	113881065	DNA/hAT-Charlie	445	+	96	113880968	28564
chr10	113852404	114052404	harbor1	chr10	113948246	113948526	DNA/hAT-Charlie	1335	+	140	113948386	95982
chr10	108410709	108610709	harbor1	chr10	108469754	108469918	DNA/hAT-Charlie	650	+	82	108469836	59127
chr10	34202435	34402435	harbor1	chr10	34265656	34266271	DNA/hAT-Charlie	1122	+	308	34265964	63529
chr10	34202435	34402435	harbor1	chr10	34267754	34267938	DNA/hAT-Charlie	842	+	92	34267846	65411
chr10	127799946	127999946	harbor1	chr10	127835845	127836060	DNA/hAT-Charlie	977	+	108	127835953	36007
chr10	127799946	127999946	harbor1	chr10	127868478	127868721	DNA/hAT-Charlie	861	+	122	127868600	68654
chr10	38102355	38302355	harbor1	chr10	38157915	38158068	DNA/hAT-Charlie	423	+	76	38157991	55636
chr10	38102355	38302355	harbor1	chr10	38194054	38194223	DNA/hAT-Charlie	467	+	84	38194138	91783
chr10	46058347	46258347	harbor1	chr10	46058401	46058498	DNA/hAT-Charlie	532	+	48	46058449	102
chr10	46058347	46258347	harbor1	chr10	46124725	46124890	DNA/hAT-Charlie	541	+	82	46124807	66460
chr10	46058347	46258347	harbor1	chr10	46141450	46141901	DNA/hAT-Charlie	2534	+	226	46141676	83329
chr10	46058347	46258347	harbor1	chr10	46142189	46142312	DNA/hAT-Charlie	1450	+	62	46142251	83904
chr10	46058347	46258347	harbor1	chr10	46143707	46143925	DNA/hAT-Charlie	970	+	109	46143816	85469
chr10	46058347	46258347	harbor1	chr10	46137196	46137355	DNA/hAT-Charlie	533	+	80	46137276	78929
chr10	26640835	26840835	harbor1	chr10	26654328	26654404	DNA/hAT-Charlie	759	+	38	26654366	13531
chr10	26640835	26840835	harbor1	chr10	26654690	26654793	DNA/hAT-Charlie	759	+	52	26654742	13907
chr10	26640835	26840835	harbor1	chr10	26666353	26666541	DNA/hAT-Charlie	474	+	94	26666447	25612
chr10	26640835	26840835	harbor1	chr10	26713479	26713637	DNA/hAT-Charlie	485	+	79	26713558	72723
chr10	128835066	129035066	harbor1	chr10	128924109	128924258	DNA/hAT-Charlie	433	+	74	128924183	89117
chr10	128835066	129035066	harbor1	chr10	128924605	128924684	DNA/hAT-Charlie	433	+	40	128924645	89579
chr10	70845790	71045790	harbor1	chr10	70851301	70851524	DNA/hAT-Charlie	959	+	112	70851413	5623
chr10	70845790	71045790	harbor1	chr10	70901834	70902040	DNA/hAT-Charlie	854	+	103	70901937	56147
chr10	132368705	132568705	harbor1	chr10	132426175	132426497	DNA/hAT-Charlie	1685	+	161	132426336	57631
chr10	80950148	81150148	harbor1	chr10	81010296	81010455	DNA/hAT-Charlie	696	+	80	81010376	60228
chr10	80950148	81150148	harbor1	chr10	81019226	81019436	DNA/hAT-Charlie	1087	+	105	81019331	69183
chr10	55481441	55681441	harbor1	chr10	55514127	55514363	DNA/hAT-Charlie	950	+	118	55514245	32804
chr10	55481441	55681441	harbor1	chr10	55515311	55515717	DNA/hAT-Charlie	1164	+	203	55515514	34073
chr10	33341233	33541233	harbor1	chr10	33357953	33358129	DNA/hAT-Charlie	789	+	88	33358041	16808
chr10	33341233	33541233	harbor1	chr10	33358663	33359346	DNA/hAT-Charlie	1840	+	342	33359005	17772
chr10	127248557	127448557	harbor1	chr10	127248804	127249087	DNA/hAT-Charlie	2146	+	142	127248946	389
chr10	127248557	127448557	harbor1	chr10	127267971	127268164	DNA/hAT-Charlie	869	+	96	127268067	19510
chr10	127248557	127448557	harbor1	chr10	127322512	127322860	DNA/hAT-Charlie	1238	+	174	127322686	74129
chr10	77504150	77704150	harbor1	chr10	77541713	77541889	DNA/hAT-Charlie	695	+	88	77541801	37651
chr10	77504150	77704150	harbor1	chr10	77547804	77548030	DNA/hAT-Charlie	1054	+	113	77547917	43767
chr10	77504150	77704150	harbor1	chr10	77553097	77553330	DNA/hAT-Charlie	748	+	116	77553213	49063
chr10	77504150	77704150	harbor1	chr10	77560212	77560433	DNA/hAT-Charlie	526	+	110	77560322	56172
chr10	77504150	77704150	harbor1	chr10	77591446	77591637	DNA/hAT-Charlie	750	+	96	77591542	87392
chr10	105601717	105801717	harbor1	chr10	105629656	105629896	DNA/hAT-Charlie	541	+	120	105629776	28059
chr10	47002079	47202079	harbor1	chr10	47003578	47003782	DNA/hAT-Charlie	885	+	102	47003680	1601
chr10	47002079	47202079	harbor1	chr10	47031043	47031224	DNA/hAT-Charlie	728	+	90	47031133	29054
chr10	47002079	47202079	harbor1	chr10	47049800	47049959	DNA/hAT-Charlie	416	+	80	47049880	47801
chr10	47002079	47202079	harbor1	chr10	47090188	47090398	DNA/hAT-Charlie	1076	+	105	47090293	88214
chr10	66347624	66547624	harbor1	chr10	66404675	66404888	DNA/hAT-Charlie	1213	+	106	66404781	57157
chr10	66347624	66547624	harbor1	chr10	66413208	66413370	DNA/hAT-Charlie	692	+	81	66413289	65665
chr10	75381197	75581197	harbor1	chr10	75473850	75474030	DNA/hAT-Charlie	440	+	90	75473940	92743
chr10	103253782	103453782	harbor1	chr10	103256741	103256933	DNA/hAT-Charlie	1089	+	96	103256837	3055
chr10	103253782	103453782	harbor1	chr10	103284273	103284421	DNA/hAT-Charlie	549	+	74	103284347	30565
chr10	80892211	81092211	harbor1	chr10	80900392	80900601	DNA/hAT-Charlie	1069	+	104	80900496	8285
chr10	58955136	59155136	harbor1	chr10	58963100	58963310	DNA/hAT-Charlie	1008	+	105	58963205	8069
chr10	58955136	59155136	harbor1	chr10	58965342	58965500	DNA/hAT-Charlie	691	+	79	58965421	10285
chr10	58955136	59155136	harbor1	chr10	58965685	58965870	DNA/hAT-Charlie	1026	+	92	58965777	10641
chr10	58955136	59155136	harbor1	chr10	58966801	58966977	DNA/hAT-Charlie	534	+	88	58966889	11753
chr10	58955136	59155136	harbor1	chr10	58968966	58969145	DNA/hAT-Charlie	563	+	90	58969056	13920
chr10	58955136	59155136	harbor1	chr10	59014227	59014478	DNA/hAT-Charlie	408	+	126	59014353	59217
chr10	90578406	90778406	harbor1	chr10	90593915	90594085	DNA/hAT-Charlie	616	+	85	90594000	15594
chr10	90578406	90778406	harbor1	chr10	90675637	90675807	DNA/hAT-Charlie	805	+	85	90675722	97316
chr10	16371146	16571146	harbor1	chr10	16398455	16398614	DNA/hAT-Charlie	640	+	80	16398535	27389
chr10	16371146	16571146	harbor1	chr10	16405987	16406472	DNA/hAT-Charlie	3095	+	242	16406229	35083
chr10	84430319	84630319	harbor1	chr10	84450230	84450397	DNA/hAT-Charlie	411	+	84	84450314	19995
chr10	84430319	84630319	harbor1	chr10	84481890	84482039	DNA/hAT-Charlie	683	+	74	84481964	51645
chr10	4535391	4735391	harbor1	chr10	4550717	4550866	DNA/hAT-Charlie	819	+	74	4550791	15400
chr10	4535391	4735391	harbor1	chr10	4551302	4551464	DNA/hAT-Charlie	497	+	81	4551383	15992
chr10	4535391	4735391	harbor1	chr10	4608345	4608555	DNA/hAT-Charlie	684	+	105	4608450	73059
chr10	4535391	4735391	harbor1	chr10	4625729	4626026	DNA/hAT-Charlie	431	+	148	4625877	90486
chr10	4535391	4735391	harbor1	chr10	4629839	4630167	DNA/hAT-Charlie	657	+	164	4630003	94612
chr10	119739373	119939373	harbor1	chr10	119750345	119750543	DNA/hAT-Charlie	815	+	99	119750444	11071
chr10	119739373	119939373	harbor1	chr10	119810834	119811064	DNA/hAT-Charlie	455	+	115	119810949	71576
chr10	119739373	119939373	harbor1	chr10	119826189	119826473	DNA/hAT-Charlie	855	+	142	119826331	86958
chr10	119739373	119939373	harbor1	chr10	119830641	119830875	DNA/hAT-Charlie	638	+	117	119830758	91385
chr10	115914653	116114653	harbor1	chr10	115982955	115983082	DNA/hAT-Charlie	427	+	64	115983019	68366
chr10	115914653	116114653	harbor1	chr10	115995554	115995763	DNA/hAT-Charlie	611	+	104	115995658	81005
chr10	115914653	116114653	harbor1	chr10	115995786	115996053	DNA/hAT-Charlie	670	+	134	115995920	81267
chr10	115914653	116114653	harbor1	chr10	116000070	116000216	DNA/hAT-Charlie	426	+	73	116000143	85490
chr10	12859258	13059258	harbor1	chr10	12905195	12905390	DNA/hAT-Charlie	929	+	98	12905293	46035
chr10	12859258	13059258	harbor1	chr10	12930611	12930822	DNA/hAT-Charlie	804	+	106	12930717	71459
chr10	12859258	13059258	harbor1	chr10	12937313	12937445	DNA/hAT-Charlie	450	+	66	12937379	78121
chr10	12859258	13059258	harbor1	chr10	12941494	12941624	DNA/hAT-Charlie	410	+	65	12941559	82301
chr10	113930500	114130500	harbor1	chr10	113948246	113948526	DNA/hAT-Charlie	1335	+	140	113948386	17886
chr10	113930500	114130500	harbor1	chr10	113990736	113990881	DNA/hAT-Charlie	772	+	72	113990808	60308
chr10	113930500	114130500	harbor1	chr10	114019666	114019760	DNA/hAT-Charlie	426	+	47	114019713	89213
chr10	44669959	44869959	harbor1	chr10	44687211	44687358	DNA/hAT-Charlie	636	+	74	44687285	17326
chr10	44669959	44869959	harbor1	chr10	44700097	44700314	DNA/hAT-Charlie	987	+	108	44700205	30246
chr10	70463496	70663496	harbor1	chr10	70527409	70527621	DNA/hAT-Charlie	965	+	106	70527515	64019
chr10	70463496	70663496	harbor1	chr10	70536533	70536748	DNA/hAT-Charlie	925	+	108	70536641	73145
chr10	70463496	70663496	harbor1	chr10	70563030	70563188	DNA/hAT-Charlie	529	+	79	70563109	99613
chr10	27997530	28197530	harbor1	chr10	28001564	28001947	DNA/hAT-Charlie	2619	+	192	28001756	4226
chr10	27997530	28197530	harbor1	chr10	28063515	28063843	DNA/hAT-Charlie	1854	+	164	28063679	66149
chr10	27997530	28197530	harbor1	chr10	28084430	28084567	DNA/hAT-Charlie	712	+	68	28084498	86968
chr10	66550771	66750771	harbor1	chr10	66559382	66559546	DNA/hAT-Charlie	723	+	82	66559464	8693
chr10	66550771	66750771	harbor1	chr10	66645559	66645891	DNA/hAT-Charlie	2021	+	166	66645725	94954
chr10	94360469	94560469	harbor1	chr10	94443515	94443887	DNA/hAT-Charlie	2470	+	186	94443701	83232
chr10	94360469	94560469	harbor1	chr10	94444200	94444396	DNA/hAT-Charlie	2265	+	98	94444298	83829
chr10	85877975	86077975	harbor1	chr10	85887443	85887606	DNA/hAT-Charlie	1012	+	82	85887525	9550
chr10	85877975	86077975	harbor1	chr10	85937658	85937883	DNA/hAT-Charlie	902	+	112	85937770	59795
chr10	85877975	86077975	harbor1	chr10	85975840	85975989	DNA/hAT-Charlie	505	+	74	85975914	97939
chr10	85877975	86077975	harbor1	chr10	85976169	85976341	DNA/hAT-Charlie	444	+	86	85976255	98280
chr10	21128533	21328533	harbor1	chr10	21142680	21142939	DNA/hAT-Charlie	1153	+	130	21142810	14277
chr10	21128533	21328533	harbor1	chr10	21186550	21186779	DNA/hAT-Charlie	1715	+	114	21186664	58131
chr10	113169263	113369263	harbor1	chr10	113230559	113230716	DNA/hAT-Charlie	544	+	78	113230637	61374
chr10	113169263	113369263	harbor1	chr10	113231021	113231061	DNA/hAT-Charlie	544	+	20	113231041	61778
chr10	113169263	113369263	harbor1	chr10	113240699	113240925	DNA/hAT-Charlie	885	+	113	113240812	71549
chr10	113169263	113369263	harbor1	chr10	113240934	113241093	DNA/hAT-Charlie	830	+	80	113241014	71751
chr10	113169263	113369263	harbor1	chr10	113241103	113241294	DNA/hAT-Charlie	770	+	96	113241199	71936
chr10	72079204	72279204	harbor1	chr10	72147888	72149156	DNA/hAT-Charlie	5665	+	634	72148522	69318
chr10	72079204	72279204	harbor1	chr10	72149465	72149630	DNA/hAT-Charlie	5665	+	82	72149547	70343
chr10	2206875	2406875	harbor1	chr10	2222103	2222296	DNA/hAT-Charlie	500	+	96	2222199	15324
chr10	61833023	62033023	harbor1	chr10	61846128	61846274	DNA/hAT-Charlie	474	+	73	61846201	13178
chr10	61833023	62033023	harbor1	chr10	61854900	61855240	DNA/hAT-Charlie	2256	+	170	61855070	22047
chr10	61833023	62033023	harbor1	chr10	61880362	61880649	DNA/hAT-Charlie	1152	+	144	61880506	47483
chr10	61833023	62033023	harbor1	chr10	61891286	61891780	DNA/hAT-Charlie	2018	+	247	61891533	58510
chr10	61833023	62033023	harbor1	chr10	61907712	61907923	DNA/hAT-Charlie	1022	+	106	61907818	74795
chr10	61833023	62033023	harbor1	chr10	61916274	61916447	DNA/hAT-Charlie	969	+	86	61916360	83337
chr10	117882078	118082078	harbor1	chr10	117883093	117883232	DNA/hAT-Charlie	609	+	70	117883163	1085
chr10	117882078	118082078	harbor1	chr10	117884038	117884324	DNA/hAT-Charlie	651	+	143	117884181	2103
chr10	117882078	118082078	harbor1	chr10	117894421	117894555	DNA/hAT-Charlie	422	+	67	117894488	12410
chr10	117882078	118082078	harbor1	chr10	117910358	117910468	DNA/hAT-Charlie	490	+	55	117910413	28335
chr10	117882078	118082078	harbor1	chr10	117966106	117966231	DNA/hAT-Charlie	434	+	62	117966168	84090
chr10	71616597	71816597	harbor1	chr10	71625818	71626259	DNA/hAT-Charlie	1683	+	220	71626038	9441
chr10	71616597	71816597	harbor1	chr10	71641540	71641715	DNA/hAT-Charlie	610	+	88	71641628	25031
chr10	71616597	71816597	harbor1	chr10	71707523	71707664	DNA/hAT-Charlie	408	+	70	71707593	90996
chr10	71616597	71816597	harbor1	chr10	71711656	71711845	DNA/hAT-Charlie	570	+	94	71711750	95153
chr10	17548283	17748283	harbor1	chr10	17548225	17548528	DNA/hAT-Charlie	1143	+	152	17548377	94
chr10	17548283	17748283	harbor1	chr10	17561281	17561387	DNA/hAT-Charlie	407	+	53	17561334	13051
chr10	17548283	17748283	harbor1	chr10	17606505	17606803	DNA/hAT-Charlie	562	+	149	17606654	58371
chr10	109629992	109829992	harbor1	chr10	109726813	109727015	DNA/hAT-Charlie	876	+	101	109726914	96922
chr10	87637865	87837865	harbor1	chr10	87652381	87652574	DNA/hAT-Charlie	722	+	96	87652477	14612
chr10	87637865	87837865	harbor1	chr10	87672745	87673060	DNA/hAT-Charlie	1004	+	158	87672903	35038
chr10	87637865	87837865	harbor1	chr10	87674105	87674172	DNA/hAT-Charlie	1267	+	34	87674139	36274
chr10	87637865	87837865	harbor1	chr10	87674465	87674924	DNA/hAT-Charlie	1267	+	230	87674695	36830
chr10	87637865	87837865	harbor1	chr10	87680989	87681190	DNA/hAT-Charlie	846	+	100	87681089	43224
chr10	123840460	124040460	harbor1	chr10	123876524	123876738	DNA/hAT-Charlie	558	+	107	123876631	36171
chr10	123840460	124040460	harbor1	chr10	123887531	123887678	DNA/hAT-Charlie	828	+	74	123887605	47145
chr10	22146803	22346803	harbor1	chr10	22174633	22174916	DNA/hAT-Charlie	996	+	142	22174775	27972
chr10	22146803	22346803	harbor1	chr10	22194387	22194467	DNA/hAT-Charlie	583	+	40	22194427	47624
chr10	22146803	22346803	harbor1	chr10	22194762	22194872	DNA/hAT-Charlie	583	+	55	22194817	48014
chr10	22146803	22346803	harbor1	chr10	22245097	22245221	DNA/hAT-Charlie	408	+	62	22245159	98356
chr10	22146803	22346803	harbor1	chr10	22245235	22245355	DNA/hAT-Charlie	526	+	60	22245295	98492
chr10	76533646	76733646	harbor1	chr10	76545884	76546063	DNA/hAT-Charlie	864	+	90	76545974	12328
chr10	88362743	88562743	harbor1	chr10	88381785	88384184	DNA/hAT-Charlie	11453	+	1200	88382985	20242
chr10	88362743	88562743	harbor1	chr10	88390835	88391276	DNA/hAT-Charlie	1495	+	220	88391055	28312
chr10	88362743	88562743	harbor1	chr10	88391570	88391660	DNA/hAT-Charlie	1495	+	45	88391615	28872
chr10	33057814	33257814	harbor1	chr10	33066132	33066279	DNA/hAT-Charlie	768	+	74	33066206	8392
chr10	10727550	10927550	harbor1	chr10	10752988	10753161	DNA/hAT-Charlie	472	+	86	10753074	25524
chr10	10727550	10927550	harbor1	chr10	10779627	10779788	DNA/hAT-Charlie	432	+	80	10779707	52157
chr10	10727550	10927550	harbor1	chr10	10785059	10785148	DNA/hAT-Charlie	423	+	44	10785103	57553
chr10	10727550	10927550	harbor1	chr10	10791732	10791948	DNA/hAT-Charlie	445	+	108	10791840	64290
chr10	10727550	10927550	harbor1	chr10	10797244	10797643	DNA/hAT-Charlie	815	+	200	10797444	69894
chr10	55965608	56165608	harbor1	chr10	56010979	56011101	DNA/hAT-Charlie	503	+	61	56011040	45432
chr10	61514543	61714543	harbor1	chr10	61538840	61539020	DNA/hAT-Charlie	1000	+	90	61538930	24387
chr10	62855526	63055526	harbor1	chr10	62858768	62859133	DNA/hAT-Charlie	949	+	182	62858950	3424
chr10	62855526	63055526	harbor1	chr10	62892334	62892513	DNA/hAT-Charlie	834	+	90	62892424	36898
chr10	62855526	63055526	harbor1	chr10	62919900	62920077	DNA/hAT-Charlie	628	+	88	62919988	64462
chr10	62855526	63055526	harbor1	chr10	62940303	62940455	DNA/hAT-Charlie	875	+	76	62940379	84853
chr10	62855526	63055526	harbor1	chr10	62941152	62941380	DNA/hAT-Charlie	1724	+	114	62941266	85740
chr10	86140806	86340806	harbor1	chr10	86158752	86158898	DNA/hAT-Charlie	972	+	73	86158825	18019
chr10	86140806	86340806	harbor1	chr10	86159155	86159273	DNA/hAT-Charlie	972	+	59	86159214	18408
chr10	86140806	86340806	harbor1	chr10	86159617	86159630	DNA/hAT-Charlie	972	+	6	86159623	18817
chr10	86140806	86340806	harbor1	chr10	86171021	86171168	DNA/hAT-Charlie	564	+	74	86171095	30289
chr10	66356921	66556921	harbor1	chr10	66404675	66404888	DNA/hAT-Charlie	1213	+	106	66404781	47860
chr10	66356921	66556921	harbor1	chr10	66413208	66413370	DNA/hAT-Charlie	692	+	81	66413289	56368
chr10	86533680	86733680	harbor1	chr10	86580155	86580376	DNA/hAT-Charlie	1318	+	110	86580265	46585
chr10	86533680	86733680	harbor1	chr10	86594790	86595007	DNA/hAT-Charlie	1535	+	108	86594898	61218
chr10	86533680	86733680	harbor1	chr10	86602379	86602479	DNA/hAT-Charlie	1324	+	50	86602429	68749
chr10	86533680	86733680	harbor1	chr10	86603188	86603447	DNA/hAT-Charlie	1324	+	130	86603318	69638
chr10	7027630	7227630	harbor1	chr10	7051241	7051327	DNA/hAT-Charlie	419	+	43	7051284	23654
chr10	7027630	7227630	harbor1	chr10	7109740	7109906	DNA/hAT-Charlie	672	+	83	7109823	82193
chr10	96343815	96543815	harbor1	chr10	96372467	96372692	DNA/hAT-Charlie	883	+	112	96372579	28764
chr10	96343815	96543815	harbor1	chr10	96385025	96385109	DNA/hAT-Charlie	423	+	42	96385067	41252
chr10	96343815	96543815	harbor1	chr10	96390777	96391097	DNA/hAT-Charlie	1349	+	160	96390937	47122
chr10	96343815	96543815	harbor1	chr10	96439791	96440164	DNA/hAT-Charlie	803	+	186	96439977	96162
chr10	66114582	66314582	harbor1	chr10	66185214	66185697	DNA/hAT-Charlie	821	+	242	66185456	70874
chr10	66114582	66314582	harbor1	chr10	66186329	66186755	DNA/hAT-Charlie	1121	+	213	66186542	71960
chr10	74614244	74814244	harbor1	chr10	74623139	74623307	DNA/hAT-Charlie	701	+	84	74623223	8979
chr10	74614244	74814244	harbor1	chr10	74641900	74642321	DNA/hAT-Charlie	1292	+	210	74642110	27866
chr10	74614244	74814244	harbor1	chr10	74679217	74679533	DNA/hAT-Charlie	696	+	158	74679375	65131
chr10	93046375	93246375	harbor1	chr10	93085378	93085534	DNA/hAT-Charlie	863	+	78	93085456	39081
chr10	79403822	79603822	harbor1	chr10	79439064	79439250	DNA/hAT-Charlie	446	+	93	79439157	35335
chr10	79403822	79603822	harbor1	chr10	79441539	79441732	DNA/hAT-Charlie	587	+	96	79441635	37813
chr10	79403822	79603822	harbor1	chr10	79456168	79456305	DNA/hAT-Charlie	464	+	68	79456236	52414
chr10	79403822	79603822	harbor1	chr10	79456373	79457005	DNA/hAT-Charlie	3080	+	316	79456689	52867
chr10	79403822	79603822	harbor1	chr10	79485753	79485932	DNA/hAT-Charlie	448	+	90	79485843	82021
chr10	79403822	79603822	harbor1	chr10	79487153	79487299	DNA/hAT-Charlie	463	+	73	79487226	83404
chr10	79403822	79603822	harbor1	chr10	79498555	79498834	DNA/hAT-Charlie	1765	+	140	79498695	94873
chr10	42857502	43057502	harbor1	chr10	42911934	42912133	DNA/hAT-Charlie	743	+	100	42912034	54532
chr10	42857502	43057502	harbor1	chr10	42929350	42929438	DNA/hAT-Charlie	414	+	44	42929394	71892
chr10	42857502	43057502	harbor1	chr10	42909412	42909754	DNA/hAT-Charlie	2169	+	171	42909583	52081
chr10	125761307	125961307	harbor1	chr10	125805508	125805714	DNA/hAT-Charlie	994	+	103	125805611	44304
chr10	125761307	125961307	harbor1	chr10	125806497	125806629	DNA/hAT-Charlie	477	+	66	125806563	45256
chr10	63861160	64061160	harbor1	chr10	63862621	63862838	DNA/hAT-Charlie	698	+	108	63862729	1569
chr10	63861160	64061160	harbor1	chr10	63889056	63889272	DNA/hAT-Charlie	1095	+	108	63889164	28004
chr10	63861160	64061160	harbor1	chr10	63896487	63896812	DNA/hAT-Charlie	1514	+	162	63896649	35489
chr10	63861160	64061160	harbor1	chr10	63909032	63909192	DNA/hAT-Charlie	772	+	80	63909112	47952
chr10	68013577	68213577	harbor1	chr10	68092937	68093036	DNA/hAT-Charlie	409	+	50	68092987	79410
chr10	12734315	12934315	harbor1	chr10	12774613	12774946	DNA/hAT-Charlie	1901	+	166	12774779	40464
chr10	12734315	12934315	harbor1	chr10	12789128	12789333	DNA/hAT-Charlie	1385	+	102	12789230	54915
chr10	118448649	118648649	harbor1	chr10	118472395	118472553	DNA/hAT-Charlie	700	+	79	118472474	23825
chr10	118448649	118648649	harbor1	chr10	118544779	118545013	DNA/hAT-Charlie	554	+	117	118544896	96247
chr10	58614528	58814528	harbor1	chr10	58663470	58663802	DNA/hAT-Charlie	2211	+	166	58663636	49108
chr10	58614528	58814528	harbor1	chr10	58674020	58674248	DNA/hAT-Charlie	420	+	114	58674134	59606
chr10	58614528	58814528	harbor1	chr10	58691519	58691798	DNA/hAT-Charlie	474	+	140	58691659	77131
chr10	58614528	58814528	harbor1	chr10	58713929	58714140	DNA/hAT-Charlie	1086	+	106	58714035	99507
chr10	105455062	105655062	harbor1	chr10	105474363	105474598	DNA/hAT-Charlie	540	+	118	105474481	19419
chr10	105455062	105655062	harbor1	chr10	105501751	105501930	DNA/hAT-Charlie	517	+	90	105501841	46779
chr10	105455062	105655062	harbor1	chr10	105463650	105464176	DNA/hAT-Charlie	3804	+	263	105463913	8851
chr10	101477321	101677321	harbor1	chr10	101477301	101477365	DNA/hAT-Charlie	682	+	32	101477333	12
chr10	96344057	96544057	harbor1	chr10	96372467	96372692	DNA/hAT-Charlie	883	+	112	96372579	28522
chr10	96344057	96544057	harbor1	chr10	96385025	96385109	DNA/hAT-Charlie	423	+	42	96385067	41010
chr10	96344057	96544057	harbor1	chr10	96390777	96391097	DNA/hAT-Charlie	1349	+	160	96390937	46880
chr10	96344057	96544057	harbor1	chr10	96439791	96440164	DNA/hAT-Charlie	803	+	186	96439977	95920
chr10	37704662	37904662	harbor1	chr10	37753703	37753913	DNA/hAT-Charlie	461	+	105	37753808	49146
chr10	62152369	62352369	harbor1	chr10	62160272	62160477	DNA/hAT-Charlie	461	+	102	62160374	8005
chr10	62152369	62352369	harbor1	chr10	62161392	62161967	DNA/hAT-Charlie	2213	+	288	62161680	9311
chr10	62152369	62352369	harbor1	chr10	62162268	62162444	DNA/hAT-Charlie	2213	+	88	62162356	9987
chr10	62152369	62352369	harbor1	chr10	62233505	62233746	DNA/hAT-Charlie	493	+	120	62233625	81256
chr11	60226180	60426180	harbor1	chr11	60304616	60304815	DNA/hAT-Charlie	846	+	100	60304716	78536
chr11	102694834	102894834	harbor1	chr11	102755939	102756207	DNA/hAT-Charlie	925	+	134	102756073	61239
chr11	102694834	102894834	harbor1	chr11	102756551	102756580	DNA/hAT-Charlie	925	+	14	102756565	61731
chr11	102694834	102894834	harbor1	chr11	102762645	102762922	DNA/hAT-Charlie	711	+	138	102762783	67949
chr11	60863688	61063688	harbor1	chr11	60899596	60899695	DNA/hAT-Charlie	455	+	50	60899646	35958
chr11	60863688	61063688	harbor1	chr11	60918817	60918982	DNA/hAT-Charlie	699	+	82	60918899	55211
chr11	60863688	61063688	harbor1	chr11	60941457	60941626	DNA/hAT-Charlie	466	+	84	60941541	77853
chr11	60863688	61063688	harbor1	chr11	60955164	60955215	DNA/hAT-Charlie	390	+	26	60955190	91502
chr11	60863688	61063688	harbor1	chr11	60955514	60955598	DNA/hAT-Charlie	390	+	42	60955556	91868
chr11	60863688	61063688	harbor1	chr11	60961792	60961979	DNA/hAT-Charlie	5137	+	94	60961886	98198
chr11	60863688	61063688	harbor1	chr11	60962286	60963359	DNA/hAT-Charlie	5137	+	536	60962822	99134
chr11	26954770	27154770	harbor1	chr11	26956480	26957188	DNA/hAT-Charlie	2354	+	354	26956834	2064
chr11	26954770	27154770	harbor1	chr11	26997232	26997416	DNA/hAT-Charlie	378	+	92	26997324	42554
chr11	26954770	27154770	harbor1	chr11	27008209	27008318	DNA/hAT-Charlie	570	+	54	27008263	53493
chr11	26954770	27154770	harbor1	chr11	27009692	27009827	DNA/hAT-Charlie	426	+	68	27009760	54990
chr11	26954770	27154770	harbor1	chr11	27053336	27053535	DNA/hAT-Charlie	710	+	100	27053436	98666
chr11	129127716	129327716	harbor1	chr11	129162342	129162661	DNA/hAT-Charlie	1774	+	160	129162502	34786
chr11	129127716	129327716	harbor1	chr11	129162670	129163380	DNA/hAT-Charlie	3268	+	355	129163025	35309
chr11	129127716	129327716	harbor1	chr11	129220874	129221028	DNA/hAT-Charlie	468	+	77	129220951	93235
chr11	129127716	129327716	harbor1	chr11	129154934	129155774	DNA/hAT-Charlie	3587	+	420	129155354	27638
chr11	28126859	28326859	harbor1	chr11	28192727	28192844	DNA/hAT-Charlie	610	+	58	28192785	65926
chr11	83377643	83577643	harbor1	chr11	83426171	83426329	DNA/hAT-Charlie	434	+	79	83426250	48607
chr11	74239532	74439532	harbor1	chr11	74255704	74255803	DNA/hAT-Charlie	495	+	50	74255754	16222
chr11	74239532	74439532	harbor1	chr11	74320902	74321105	DNA/hAT-Charlie	391	+	102	74321004	81472
chr11	74239532	74439532	harbor1	chr11	74331615	74331786	DNA/hAT-Charlie	447	+	86	74331701	92169
chr11	74239532	74439532	harbor1	chr11	74339229	74339445	DNA/hAT-Charlie	477	+	108	74339337	99805
chr11	8047767	8247767	harbor1	chr11	8049346	8049453	DNA/hAT-Charlie	520	+	54	8049400	1633
chr11	8047767	8247767	harbor1	chr11	8062669	8062814	DNA/hAT-Charlie	388	+	72	8062741	14974
chr11	89813429	90013429	harbor1	chr11	89864806	89864946	DNA/hAT-Charlie	445	+	70	89864876	51447
chr11	124429546	124629546	harbor1	chr11	124459193	124459333	DNA/hAT-Charlie	727	+	70	124459263	29717
chr11	124429546	124629546	harbor1	chr11	124459982	124460014	DNA/hAT-Charlie	727	+	16	124459998	30452
chr11	124429546	124629546	harbor1	chr11	124500601	124500759	DNA/hAT-Charlie	547	+	79	124500680	71134
chr11	40561735	40761735	harbor1	chr11	40577546	40577689	DNA/hAT-Charlie	767	+	72	40577618	15883
chr11	40561735	40761735	harbor1	chr11	40616941	40617320	DNA/hAT-Charlie	921	+	190	40617131	55396
chr11	40561735	40761735	harbor1	chr11	40636108	40636323	DNA/hAT-Charlie	472	+	108	40636216	74481
chr11	120558096	120758096	harbor1	chr11	120603745	120603886	DNA/hAT-Charlie	684	+	70	120603815	45719
chr11	120558096	120758096	harbor1	chr11	120604221	120604314	DNA/hAT-Charlie	400	+	46	120604267	46171
chr11	59982016	60182016	harbor1	chr11	59985407	59985531	DNA/hAT-Charlie	447	+	62	59985469	3453
chr11	59982016	60182016	harbor1	chr11	59987868	59987918	DNA/hAT-Charlie	447	+	25	59987893	5877
chr11	59982016	60182016	harbor1	chr11	60018278	60018473	DNA/hAT-Charlie	707	+	98	60018376	36360
chr11	59982016	60182016	harbor1	chr11	60023224	60023443	DNA/hAT-Charlie	660	+	110	60023334	41318
chr11	93898200	94098200	harbor1	chr11	93958344	93958568	DNA/hAT-Charlie	867	+	112	93958456	60256
chr11	93898200	94098200	harbor1	chr11	93972916	93973220	DNA/hAT-Charlie	1846	+	152	93973068	74868
chr11	93898200	94098200	harbor1	chr11	93975527	93976072	DNA/hAT-Charlie	2700	+	272	93975799	77599
chr11	93898200	94098200	harbor1	chr11	93977875	93978208	DNA/hAT-Charlie	1362	+	166	93978041	79841
chr11	93898200	94098200	harbor1	chr11	93984240	93984395	DNA/hAT-Charlie	806	+	78	93984318	86118
chr11	42015526	42215526	harbor1	chr11	42063047	42063279	DNA/hAT-Charlie	431	+	116	42063163	47637
chr11	42015526	42215526	harbor1	chr11	42109797	42109953	DNA/hAT-Charlie	431	+	78	42109875	94349
chr11	108888658	109088658	harbor1	chr11	108915275	108916173	DNA/hAT-Charlie	3144	+	449	108915724	27066
chr11	108888658	109088658	harbor1	chr11	108954424	108954557	DNA/hAT-Charlie	714	+	66	108954490	65832
chr11	113402843	113602843	harbor1	chr11	113403588	113403746	DNA/hAT-Charlie	585	+	79	113403667	824
chr11	113402843	113602843	harbor1	chr11	113441377	113441628	DNA/hAT-Charlie	795	+	126	113441503	38660
chr11	113402843	113602843	harbor1	chr11	113442225	113442342	DNA/hAT-Charlie	440	+	58	113442283	39440
chr11	113402843	113602843	harbor1	chr11	113490597	113490786	DNA/hAT-Charlie	720	+	94	113490691	87848
chr11	113402843	113602843	harbor1	chr11	113426359	113426519	DNA/hAT-Charlie	517	+	80	113426439	23596
chr11	131294832	131494832	harbor1	chr11	131296701	131296882	DNA/hAT-Charlie	400	+	90	131296791	1959
chr11	131294832	131494832	harbor1	chr11	131378034	131378203	DNA/hAT-Charlie	677	+	84	131378118	83286
chr11	131294832	131494832	harbor1	chr11	131387970	131388054	DNA/hAT-Charlie	394	+	42	131388012	93180
chr11	131294832	131494832	harbor1	chr11	131390708	131390892	DNA/hAT-Charlie	785	+	92	131390800	95968
chr11	84505330	84705330	harbor1	chr11	84591727	84591861	DNA/hAT-Charlie	533	+	67	84591794	86464
chr11	84505330	84705330	harbor1	chr11	84592156	84592219	DNA/hAT-Charlie	533	+	32	84592188	86858
chr11	84505330	84705330	harbor1	chr11	84598329	84598449	DNA/hAT-Charlie	533	+	60	84598389	93059
chr11	124885391	125085391	harbor1	chr11	124921911	124922291	DNA/hAT-Charlie	1888	+	190	124922101	36710
chr11	124885391	125085391	harbor1	chr11	124944531	124944674	DNA/hAT-Charlie	539	+	72	124944603	59212
chr11	124885391	125085391	harbor1	chr11	124958257	124958461	DNA/hAT-Charlie	1190	+	102	124958359	72968
chr11	34784774	34984774	harbor1	chr11	34792178	34792400	DNA/hAT-Charlie	850	+	111	34792289	7515
chr11	34784774	34984774	harbor1	chr11	34827889	34828042	DNA/hAT-Charlie	478	+	76	34827965	43191
chr11	34784774	34984774	harbor1	chr11	34837585	34837809	DNA/hAT-Charlie	1172	+	112	34837697	52923
chr11	34784774	34984774	harbor1	chr11	34844754	34844966	DNA/hAT-Charlie	908	+	106	34844860	60086
chr11	34784774	34984774	harbor1	chr11	34844952	34845091	DNA/hAT-Charlie	710	+	70	34845022	60248
chr11	34784774	34984774	harbor1	chr11	34851105	34851285	DNA/hAT-Charlie	515	+	90	34851195	66421
chr11	34784774	34984774	harbor1	chr11	34865938	34866332	DNA/hAT-Charlie	2884	+	197	34866135	81361
chr11	34784774	34984774	harbor1	chr11	34873019	34873355	DNA/hAT-Charlie	2471	+	168	34873187	88413
chr11	85135178	85335178	harbor1	chr11	85164902	85165067	DNA/hAT-Charlie	644	+	82	85164984	29806
chr11	71340670	71540670	harbor1	chr11	71345158	71345295	DNA/hAT-Charlie	379	+	68	71345226	4556
chr11	71340670	71540670	harbor1	chr11	71375998	71376149	DNA/hAT-Charlie	646	+	76	71376074	35404
chr11	71340670	71540670	harbor1	chr11	71416965	71417123	DNA/hAT-Charlie	943	+	79	71417044	76374
chr11	71340670	71540670	harbor1	chr11	71417921	71418094	DNA/hAT-Charlie	665	+	86	71418007	77337
chr11	71340670	71540670	harbor1	chr11	71420917	71421138	DNA/hAT-Charlie	1088	+	110	71421027	80357
chr11	71340670	71540670	harbor1	chr11	71417832	71417891	DNA/hAT-Charlie	943	+	30	71417862	77192
chr11	90873344	91073344	harbor1	chr11	90905737	90905968	DNA/hAT-Charlie	613	+	116	90905853	32509
chr11	83651331	83851331	harbor1	chr11	83660296	83660535	DNA/hAT-Charlie	518	+	120	83660416	9085
chr11	83651331	83851331	harbor1	chr11	83666276	83666620	DNA/hAT-Charlie	2137	+	172	83666448	15117
chr11	83651331	83851331	harbor1	chr11	83687449	83687754	DNA/hAT-Charlie	400	+	152	83687601	36270
chr11	83651331	83851331	harbor1	chr11	83690694	83691037	DNA/hAT-Charlie	1337	+	172	83690866	39535
chr11	83651331	83851331	harbor1	chr11	83735348	83735826	DNA/hAT-Charlie	1349	+	239	83735587	84256
chr11	83651331	83851331	harbor1	chr11	83739204	83739429	DNA/hAT-Charlie	638	+	112	83739316	87985
chr11	83651331	83851331	harbor1	chr11	83740665	83740904	DNA/hAT-Charlie	700	+	120	83740785	89454
chr11	83651331	83851331	harbor1	chr11	83746791	83747275	DNA/hAT-Charlie	921	+	242	83747033	95702
chr11	83651331	83851331	harbor1	chr11	83747366	83747384	DNA/hAT-Charlie	921	+	9	83747375	96044
chr11	83651331	83851331	harbor1	chr11	83747683	83747853	DNA/hAT-Charlie	921	+	85	83747768	96437
chr11	21218414	21418414	harbor1	chr11	21267602	21267680	DNA/hAT-Charlie	380	+	39	21267641	49227
chr11	74014923	74214923	harbor1	chr11	74039422	74039607	DNA/hAT-Charlie	979	+	92	74039514	24591
chr11	74014923	74214923	harbor1	chr11	74039616	74039821	DNA/hAT-Charlie	1228	+	102	74039718	24795
chr11	74014923	74214923	harbor1	chr11	74040023	74040358	DNA/hAT-Charlie	2073	+	168	74040191	25268
chr11	74014923	74214923	harbor1	chr11	74045933	74046067	DNA/hAT-Charlie	684	+	67	74046000	31077
chr11	74014923	74214923	harbor1	chr11	74088974	74089145	DNA/hAT-Charlie	393	+	86	74089060	74137
chr11	74014923	74214923	harbor1	chr11	74111692	74111899	DNA/hAT-Charlie	1496	+	104	74111796	96873
chr11	43290743	43490743	harbor1	chr11	43358215	43358471	DNA/hAT-Charlie	646	+	128	43358343	67600
chr11	43290743	43490743	harbor1	chr11	43382621	43382735	DNA/hAT-Charlie	582	+	57	43382678	91935
chr11	113761117	113961117	harbor1	chr11	113764952	113765177	DNA/hAT-Charlie	1033	+	112	113765064	3947
chr11	113761117	113961117	harbor1	chr11	113792007	113792184	DNA/hAT-Charlie	429	+	88	113792095	30978
chr11	113761117	113961117	harbor1	chr11	113804274	113804450	DNA/hAT-Charlie	435	+	88	113804362	43245
chr11	45126574	45326574	harbor1	chr11	45156470	45156588	DNA/hAT-Charlie	383	+	59	45156529	29955
chr11	45126574	45326574	harbor1	chr11	45185174	45185364	DNA/hAT-Charlie	796	+	95	45185269	58695
chr11	45126574	45326574	harbor1	chr11	45207397	45207588	DNA/hAT-Charlie	759	+	96	45207493	80919
chr11	65756855	65956855	harbor1	chr11	65785103	65785207	DNA/hAT-Charlie	410	+	52	65785155	28300
chr11	92716202	92916202	harbor1	chr11	92731251	92731430	DNA/hAT-Charlie	606	+	90	92731341	15139
chr11	92716202	92916202	harbor1	chr11	92743077	92743287	DNA/hAT-Charlie	425	+	105	92743182	26980
chr11	92716202	92916202	harbor1	chr11	92778550	92778682	DNA/hAT-Charlie	506	+	66	92778616	62414
chr11	85701783	85901783	harbor1	chr11	85702077	85702191	DNA/hAT-Charlie	530	+	57	85702134	351
chr11	85701783	85901783	harbor1	chr11	85702485	85702548	DNA/hAT-Charlie	530	+	32	85702517	734
chr11	85701783	85901783	harbor1	chr11	85742501	85742787	DNA/hAT-Charlie	875	+	143	85742644	40861
chr11	115650011	115850011	harbor1	chr11	115741880	115742064	DNA/hAT-Charlie	968	+	92	115741972	91961
chr11	119410322	119610322	harbor1	chr11	119435632	119435816	DNA/hAT-Charlie	1021	+	92	119435724	25402
chr11	119410322	119610322	harbor1	chr11	119452854	119453037	DNA/hAT-Charlie	396	+	92	119452946	42624
chr11	122520816	122720816	harbor1	chr11	122574714	122574879	DNA/hAT-Charlie	1336	+	82	122574796	53980
chr11	122520816	122720816	harbor1	chr11	122575476	122575638	DNA/hAT-Charlie	1336	+	81	122575557	54741
chr11	122520816	122720816	harbor1	chr11	122579667	122579810	DNA/hAT-Charlie	459	+	72	122579739	58923
chr11	122520816	122720816	harbor1	chr11	122603330	122603376	DNA/hAT-Charlie	587	+	23	122603353	82537
chr11	122520816	122720816	harbor1	chr11	122603692	122603787	DNA/hAT-Charlie	587	+	48	122603740	82924
chr11	122520816	122720816	harbor1	chr11	122605384	122605593	DNA/hAT-Charlie	898	+	104	122605488	84672
chr11	87531156	87731156	harbor1	chr11	87555440	87555554	DNA/hAT-Charlie	399	+	57	87555497	24341
chr11	87531156	87731156	harbor1	chr11	87615743	87615862	DNA/hAT-Charlie	433	+	60	87615803	84647
chr11	64984594	65184594	harbor1	chr11	65033177	65033262	DNA/hAT-Charlie	711	+	42	65033219	48625
chr11	64984594	65184594	harbor1	chr11	65033566	65033650	DNA/hAT-Charlie	711	+	42	65033608	49014
chr11	64984594	65184594	harbor1	chr11	65040373	65040715	DNA/hAT-Charlie	1280	+	171	65040544	55950
chr11	19836162	20036162	harbor1	chr11	19853399	19853620	DNA/hAT-Charlie	1344	+	110	19853509	17347
chr11	19836162	20036162	harbor1	chr11	19854481	19854650	DNA/hAT-Charlie	756	+	84	19854565	18403
chr11	19836162	20036162	harbor1	chr11	19908488	19908687	DNA/hAT-Charlie	935	+	100	19908588	72426
chr11	86048710	86248710	harbor1	chr11	86108870	86109079	DNA/hAT-Charlie	496	+	104	86108974	60264
chr11	86048710	86248710	harbor1	chr11	86125821	86125965	DNA/hAT-Charlie	569	+	72	86125893	77183
chr11	86048710	86248710	harbor1	chr11	86130763	86130835	DNA/hAT-Charlie	406	+	36	86130799	82089
chr11	86048710	86248710	harbor1	chr11	86131019	86131271	DNA/hAT-Charlie	898	+	126	86131145	82435
chr11	103799422	103999422	harbor1	chr11	103861349	103861376	DNA/hAT-Charlie	660	+	14	103861363	61941
chr11	103799422	103999422	harbor1	chr11	103861739	103861901	DNA/hAT-Charlie	660	+	81	103861820	62398
chr11	103799422	103999422	harbor1	chr11	103885441	103885608	DNA/hAT-Charlie	426	+	84	103885525	86103
chr11	103799422	103999422	harbor1	chr11	103893292	103893458	DNA/hAT-Charlie	708	+	83	103893375	93953
chr11	103799422	103999422	harbor1	chr11	103894111	103894260	DNA/hAT-Charlie	571	+	74	103894185	94763
chr11	103799422	103999422	harbor1	chr11	103896791	103897007	DNA/hAT-Charlie	1224	+	108	103896899	97477
chr11	15504865	15704865	harbor1	chr11	15534240	15534392	DNA/hAT-Charlie	381	+	76	15534316	29451
chr11	15504865	15704865	harbor1	chr11	15592542	15592642	DNA/hAT-Charlie	418	+	50	15592592	87727
chr11	15504865	15704865	harbor1	chr11	15597719	15597923	DNA/hAT-Charlie	561	+	102	15597821	92956
chr11	64519292	64719292	harbor1	chr11	64533158	64533339	DNA/hAT-Charlie	456	+	90	64533248	13956
chr11	64519292	64719292	harbor1	chr11	64539863	64540158	DNA/hAT-Charlie	820	+	148	64540011	20719
chr11	95346553	95546553	harbor1	chr11	95371678	95371868	DNA/hAT-Charlie	630	+	95	95371773	25220
chr11	95346553	95546553	harbor1	chr11	95372586	95372704	DNA/hAT-Charlie	500	+	59	95372645	26092
chr11	95346553	95546553	harbor1	chr11	95373006	95373109	DNA/hAT-Charlie	500	+	52	95373058	26505
chr11	95346553	95546553	harbor1	chr11	95425110	95425259	DNA/hAT-Charlie	557	+	74	95425184	78631
chr11	26323792	26523792	harbor1	chr11	26340463	26340588	DNA/hAT-Charlie	393	+	62	26340525	16733
chr11	89419473	89619473	harbor1	chr11	89486945	89487054	DNA/hAT-Charlie	554	+	54	89486999	67526
chr11	119918545	120118545	harbor1	chr11	119943405	119943538	DNA/hAT-Charlie	392	+	66	119943471	24926
chr11	119918545	120118545	harbor1	chr11	119962456	119962591	DNA/hAT-Charlie	446	+	68	119962524	43979
chr11	119918545	120118545	harbor1	chr11	119966428	119967133	DNA/hAT-Charlie	2590	+	352	119966780	48235
chr11	119918545	120118545	harbor1	chr11	119967214	119967369	DNA/hAT-Charlie	2590	+	78	119967292	48747
chr11	119918545	120118545	harbor1	chr11	119997132	119997312	DNA/hAT-Charlie	813	+	90	119997222	78677
chr11	4361447	4561447	harbor1	chr11	4435772	4435927	DNA/hAT-Charlie	992	+	78	4435850	74403
chr11	4361447	4561447	harbor1	chr11	4444807	4445029	DNA/hAT-Charlie	1395	+	111	4444918	83471
chr11	79761023	79961023	harbor1	chr11	79772216	79772385	DNA/hAT-Charlie	711	+	84	79772300	11277
chr11	79761023	79961023	harbor1	chr11	79840047	79840068	DNA/hAT-Charlie	529	+	10	79840057	79034
chr11	79761023	79961023	harbor1	chr11	79840429	79840474	DNA/hAT-Charlie	529	+	22	79840451	79428
chr11	79761023	79961023	harbor1	chr11	79840755	79840828	DNA/hAT-Charlie	529	+	36	79840791	79768
chr11	79761023	79961023	harbor1	chr11	79852384	79852692	DNA/hAT-Charlie	861	+	154	79852538	91515
chr11	133712620	133912620	harbor1	chr11	133780487	133780648	DNA/hAT-Charlie	603	+	80	133780567	67947
chr11	116771077	116971077	harbor1	chr11	116847929	116848032	DNA/hAT-Charlie	1030	+	52	116847981	76904
chr11	116771077	116971077	harbor1	chr11	116848373	116848462	DNA/hAT-Charlie	1030	+	44	116848417	77340
chr11	9362549	9562549	harbor1	chr11	9368197	9368355	DNA/hAT-Charlie	1101	+	79	9368276	5727
chr11	9362549	9562549	harbor1	chr11	9368678	9368839	DNA/hAT-Charlie	1101	+	80	9368758	6209
chr11	110918049	111118049	harbor1	chr11	110924060	110924205	DNA/hAT-Charlie	650	+	72	110924132	6083
chr11	110918049	111118049	harbor1	chr11	110982925	110983594	DNA/hAT-Charlie	1554	+	334	110983259	65210
chr11	110918049	111118049	harbor1	chr11	111001128	111001457	DNA/hAT-Charlie	1292	+	164	111001292	83243
chr11	1771470	1971470	harbor1	chr11	1818469	1818617	DNA/hAT-Charlie	628	+	74	1818543	47073
chr11	7169473	7369473	harbor1	chr11	7175781	7176050	DNA/hAT-Charlie	696	+	134	7175915	6442
chr11	7169473	7369473	harbor1	chr11	7256283	7256425	DNA/hAT-Charlie	607	+	71	7256354	86881
chr11	7169473	7369473	harbor1	chr11	7256930	7257139	DNA/hAT-Charlie	537	+	104	7257034	87561
chr11	103732200	103932200	harbor1	chr11	103770286	103770395	DNA/hAT-Charlie	1191	+	54	103770340	38140
chr11	103732200	103932200	harbor1	chr11	103770696	103770939	DNA/hAT-Charlie	1191	+	122	103770818	38618
chr11	103732200	103932200	harbor1	chr11	103777974	103778311	DNA/hAT-Charlie	1612	+	168	103778142	45942
chr11	103732200	103932200	harbor1	chr11	103782779	103782876	DNA/hAT-Charlie	485	+	48	103782827	50627
chr11	79049072	79249072	harbor1	chr11	79091561	79091713	DNA/hAT-Charlie	759	+	76	79091637	42565
chr11	79049072	79249072	harbor1	chr11	79102701	79102938	DNA/hAT-Charlie	828	+	118	79102819	53747
chr11	79049072	79249072	harbor1	chr11	79120586	79120702	DNA/hAT-Charlie	435	+	58	79120644	71572
chr11	79049072	79249072	harbor1	chr11	79123805	79123960	DNA/hAT-Charlie	413	+	78	79123883	74811
chr11	37779393	37979393	harbor1	chr11	37803981	37804107	DNA/hAT-Charlie	683	+	63	37804044	24651
chr11	37779393	37979393	harbor1	chr11	37842841	37843020	DNA/hAT-Charlie	409	+	90	37842931	63538
chr11	5614605	5814605	harbor1	chr11	5618005	5618169	DNA/hAT-Charlie	658	+	82	5618087	3482
chr11	125205258	125405258	harbor1	chr11	125228138	125228350	DNA/hAT-Charlie	917	+	106	125228244	22986
chr11	125205258	125405258	harbor1	chr11	125282722	125282870	DNA/hAT-Charlie	793	+	74	125282796	77538
chr11	125205258	125405258	harbor1	chr11	125283198	125283243	DNA/hAT-Charlie	793	+	22	125283220	77962
chr11	125205258	125405258	harbor1	chr11	125288241	125288410	DNA/hAT-Charlie	696	+	84	125288325	83067
chr11	125205258	125405258	harbor1	chr11	125288725	125288893	DNA/hAT-Charlie	662	+	84	125288809	83551
chr11	134025975	134225975	harbor1	chr11	134043346	134043561	DNA/hAT-Charlie	891	+	108	134043454	17479
chr11	134025975	134225975	harbor1	chr11	134062594	134062919	DNA/hAT-Charlie	1596	+	162	134062756	36781
chr11	134025975	134225975	harbor1	chr11	134109401	134109529	DNA/hAT-Charlie	729	+	64	134109465	83490
chr11	134025975	134225975	harbor1	chr11	134109984	134110035	DNA/hAT-Charlie	729	+	26	134110010	84035
chr11	35947292	36147292	harbor1	chr11	35956417	35956534	DNA/hAT-Charlie	601	+	58	35956475	9183
chr11	35947292	36147292	harbor1	chr11	35983267	35983391	DNA/hAT-Charlie	661	+	62	35983329	36037
chr11	35947292	36147292	harbor1	chr11	36028581	36028844	DNA/hAT-Charlie	1220	+	132	36028713	81421
chr11	35947292	36147292	harbor1	chr11	36047125	36047279	DNA/hAT-Charlie	401	+	77	36047202	99910
chr11	60942901	61142901	harbor1	chr11	60955164	60955215	DNA/hAT-Charlie	390	+	26	60955190	12289
chr11	60942901	61142901	harbor1	chr11	60955514	60955598	DNA/hAT-Charlie	390	+	42	60955556	12655
chr11	60942901	61142901	harbor1	chr11	60961792	60961979	DNA/hAT-Charlie	5137	+	94	60961886	18985
chr11	60942901	61142901	harbor1	chr11	60962286	60963359	DNA/hAT-Charlie	5137	+	536	60962822	19921
chr11	60942901	61142901	harbor1	chr11	60963658	60963805	DNA/hAT-Charlie	5137	+	74	60963732	20831
chr11	60942901	61142901	harbor1	chr11	60964500	60964610	DNA/hAT-Charlie	5137	+	55	60964555	21654
chr11	60942901	61142901	harbor1	chr11	60975265	60975518	DNA/hAT-Charlie	925	+	126	60975391	32490
chr11	60942901	61142901	harbor1	chr11	60975812	60975885	DNA/hAT-Charlie	925	+	36	60975848	32947
chr11	60942901	61142901	harbor1	chr11	61036128	61036375	DNA/hAT-Charlie	784	+	124	61036252	93351
chr11	106840786	107040786	harbor1	chr11	106845106	106845185	DNA/hAT-Charlie	399	+	40	106845146	4360
chr11	106840786	107040786	harbor1	chr11	106870295	106870526	DNA/hAT-Charlie	632	+	116	106870411	29625
chr11	106840786	107040786	harbor1	chr11	106880653	106880818	DNA/hAT-Charlie	642	+	82	106880735	39949
chr11	35290323	35490323	harbor1	chr11	35313049	35313270	DNA/hAT-Charlie	503	+	110	35313159	22836
chr11	35290323	35490323	harbor1	chr11	35334080	35334269	DNA/hAT-Charlie	488	+	94	35334174	43851
chr11	35290323	35490323	harbor1	chr11	35336817	35336885	DNA/hAT-Charlie	437	+	34	35336851	46528
chr11	35290323	35490323	harbor1	chr11	35338081	35338281	DNA/hAT-Charlie	1047	+	100	35338181	47858
chr11	35290323	35490323	harbor1	chr11	35347411	35347616	DNA/hAT-Charlie	585	+	102	35347513	57190
chr11	35290323	35490323	harbor1	chr11	35365840	35366061	DNA/hAT-Charlie	1114	+	110	35365950	75627
chr11	35290323	35490323	harbor1	chr11	35371704	35371864	DNA/hAT-Charlie	491	+	80	35371784	81461
chr11	39722455	39922455	harbor1	chr11	39780623	39780839	DNA/hAT-Charlie	1137	+	108	39780731	58276
chr11	69507716	69707716	harbor1	chr11	69546157	69546302	DNA/hAT-Charlie	445	+	72	69546229	38513
chr11	69507716	69707716	harbor1	chr11	69569341	69569561	DNA/hAT-Charlie	605	+	110	69569451	61735
chr11	132945827	133145827	harbor1	chr11	133012055	133012280	DNA/hAT-Charlie	1014	+	112	133012167	66340
chr11	109697390	109897390	harbor1	chr11	109725074	109725538	DNA/hAT-Charlie	1408	+	232	109725306	27916
chr11	109697390	109897390	harbor1	chr11	109731391	109731579	DNA/hAT-Charlie	676	+	94	109731485	34095
chr11	109697390	109897390	harbor1	chr11	109753176	109753344	DNA/hAT-Charlie	482	+	84	109753260	55870
chr11	21942774	22142774	harbor1	chr11	22002106	22002255	DNA/hAT-Charlie	818	+	74	22002180	59406
chr11	97133818	97333818	harbor1	chr11	97184967	97185031	DNA/hAT-Charlie	506	+	32	97184999	51181
chr11	97133818	97333818	harbor1	chr11	97185258	97185492	DNA/hAT-Charlie	506	+	117	97185375	51557
chr11	97133818	97333818	harbor1	chr11	97221159	97221248	DNA/hAT-Charlie	380	+	44	97221203	87385
chr11	10390098	10590098	harbor1	chr11	10410011	10410262	DNA/hAT-Charlie	644	+	126	10410137	20039
chr11	10390098	10590098	harbor1	chr11	10446184	10446906	DNA/hAT-Charlie	2330	+	361	10446545	56447
chr11	10390098	10590098	harbor1	chr11	10447211	10447647	DNA/hAT-Charlie	2330	+	218	10447429	57331
chr11	10390098	10590098	harbor1	chr11	10448279	10448615	DNA/hAT-Charlie	2105	+	168	10448447	58349
chr11	10390098	10590098	harbor1	chr11	10448669	10449447	DNA/hAT-Charlie	2105	+	389	10449058	58960
chr11	10390098	10590098	harbor1	chr11	10454392	10454637	DNA/hAT-Charlie	621	+	122	10454514	64416
chr11	15394965	15594965	harbor1	chr11	15432074	15432282	DNA/hAT-Charlie	657	+	104	15432178	37213
chr11	15394965	15594965	harbor1	chr11	15432610	15432672	DNA/hAT-Charlie	657	+	31	15432641	37676
chr11	15394965	15594965	harbor1	chr11	15444973	15445172	DNA/hAT-Charlie	983	+	100	15445073	50108
chr11	11274763	11474763	harbor1	chr11	11297026	11297227	DNA/hAT-Charlie	880	+	100	11297126	22363
chr11	11274763	11474763	harbor1	chr11	11298681	11298815	DNA/hAT-Charlie	392	+	67	11298748	23985
chr11	11274763	11474763	harbor1	chr11	11347373	11347543	DNA/hAT-Charlie	575	+	85	11347458	72695
chr11	8091342	8291342	harbor1	chr11	8181518	8181781	DNA/hAT-Charlie	597	+	132	8181650	90308
chr11	8091342	8291342	harbor1	chr11	8181791	8181998	DNA/hAT-Charlie	383	+	104	8181895	90553
chr11	78075169	78275169	harbor1	chr11	78078633	78078728	DNA/hAT-Charlie	613	+	48	78078681	3512
chr11	78075169	78275169	harbor1	chr11	78079026	78079089	DNA/hAT-Charlie	613	+	32	78079058	3889
chr11	78075169	78275169	harbor1	chr11	78108669	78109101	DNA/hAT-Charlie	725	+	216	78108885	33716
chr11	78075169	78275169	harbor1	chr11	78111508	78111720	DNA/hAT-Charlie	588	+	106	78111614	36445
chr11	78075169	78275169	harbor1	chr11	78129545	78129754	DNA/hAT-Charlie	1005	+	104	78129649	54480
chr11	78075169	78275169	harbor1	chr11	78129753	78129875	DNA/hAT-Charlie	531	+	61	78129814	54645
chr11	115982072	116182072	harbor1	chr11	116050857	116050972	DNA/hAT-Charlie	391	+	58	116050915	68843
chr11	134397082	134597082	harbor1	chr11	134406993	134407114	DNA/hAT-Charlie	649	+	60	134407053	9971
chr11	134397082	134597082	harbor1	chr11	134468893	134469112	DNA/hAT-Charlie	1037	+	110	134469003	71921
chr11	31598711	31798711	harbor1	chr11	31611167	31611367	DNA/hAT-Charlie	934	+	100	31611267	12556
chr11	31598711	31798711	harbor1	chr11	31662407	31662552	DNA/hAT-Charlie	379	+	72	31662479	63768
chr11	92236430	92436430	harbor1	chr11	92314997	92315330	DNA/hAT-Charlie	851	+	166	92315163	78733
chr11	92236430	92436430	harbor1	chr11	92315823	92316121	DNA/hAT-Charlie	924	+	149	92315972	79542
chr11	92236430	92436430	harbor1	chr11	92319838	92320056	DNA/hAT-Charlie	412	+	109	92319947	83517
chr11	122976989	123176989	harbor1	chr11	123003702	123003838	DNA/hAT-Charlie	525	+	68	123003770	26781
chr11	6930849	7130849	harbor1	chr11	6932916	6933117	DNA/hAT-Charlie	985	+	100	6933016	2167
chr11	6930849	7130849	harbor1	chr11	6962646	6962821	DNA/hAT-Charlie	686	+	88	6962734	31885
chr11	84149456	84349456	harbor1	chr11	84213424	84213537	DNA/hAT-Charlie	593	+	56	84213480	64024
chr11	84149456	84349456	harbor1	chr11	84213849	84213901	DNA/hAT-Charlie	593	+	26	84213875	64419
chr11	84149456	84349456	harbor1	chr11	84217634	84217809	DNA/hAT-Charlie	470	+	88	84217722	68266
chr11	84149456	84349456	harbor1	chr11	84218700	84218907	DNA/hAT-Charlie	1039	+	104	84218804	69348
chr11	84149456	84349456	harbor1	chr11	84236828	84236923	DNA/hAT-Charlie	390	+	48	84236876	87420
chr11	84149456	84349456	harbor1	chr11	84237228	84237289	DNA/hAT-Charlie	390	+	30	84237258	87802
chr11	84149456	84349456	harbor1	chr11	84243138	84243339	DNA/hAT-Charlie	928	+	100	84243238	93782
chr11	84149456	84349456	harbor1	chr11	84244077	84244181	DNA/hAT-Charlie	473	+	52	84244129	94673
chr11	127926238	128126238	harbor1	chr11	127933354	127933633	DNA/hAT-Charlie	809	+	140	127933494	7256
chr11	127926238	128126238	harbor1	chr11	127960443	127960558	DNA/hAT-Charlie	477	+	58	127960501	34263
chr11	127926238	128126238	harbor1	chr11	127969210	127969525	DNA/hAT-Charlie	941	+	158	127969368	43130
chr11	127926238	128126238	harbor1	chr11	127969880	127970097	DNA/hAT-Charlie	573	+	108	127969988	43750
chr11	7417055	7617055	harbor1	chr11	7512322	7512499	DNA/hAT-Charlie	746	+	88	7512410	95355
chr11	102136086	102336086	harbor1	chr11	102182122	102182257	DNA/hAT-Charlie	543	+	68	102182190	46104
chr11	102018360	102218360	harbor1	chr11	102066869	102066984	DNA/hAT-Charlie	514	+	58	102066927	48567
chr11	102018360	102218360	harbor1	chr11	102099087	102099253	DNA/hAT-Charlie	702	+	83	102099170	80810
chr11	4432239	4632239	harbor1	chr11	4435772	4435927	DNA/hAT-Charlie	992	+	78	4435850	3611
chr11	4432239	4632239	harbor1	chr11	4444807	4445029	DNA/hAT-Charlie	1395	+	111	4444918	12679
chr11	4432239	4632239	harbor1	chr11	4474054	4474287	DNA/hAT-Charlie	532	+	116	4474170	41931
chr11	4432239	4632239	harbor1	chr11	4488200	4488370	DNA/hAT-Charlie	485	+	85	4488285	56046
chr11	120132849	120332849	harbor1	chr11	120196283	120196443	DNA/hAT-Charlie	606	+	80	120196363	63514
chr11	120132849	120332849	harbor1	chr11	120214926	120215086	DNA/hAT-Charlie	761	+	80	120215006	82157
chr11	120132849	120332849	harbor1	chr11	120215339	120215383	DNA/hAT-Charlie	761	+	22	120215361	82512
chr11	5434156	5634156	harbor1	chr11	5434047	5434208	DNA/hAT-Charlie	762	+	80	5434127	29
chr11	5434156	5634156	harbor1	chr11	5511896	5512080	DNA/hAT-Charlie	813	+	92	5511988	77832
chr11	6379093	6579093	harbor1	chr11	6407481	6407693	DNA/hAT-Charlie	484	+	106	6407587	28494
chr11	105646709	105846709	harbor1	chr11	105681546	105681760	DNA/hAT-Charlie	1172	+	107	105681653	34944
chr11	105646709	105846709	harbor1	chr11	105682039	105682153	DNA/hAT-Charlie	1172	+	57	105682096	35387
chr11	105646709	105846709	harbor1	chr11	105693772	105693947	DNA/hAT-Charlie	706	+	88	105693860	47151
chr11	105646709	105846709	harbor1	chr11	105697799	105697947	DNA/hAT-Charlie	390	+	74	105697873	51164
chr11	105646709	105846709	harbor1	chr11	105720160	105720584	DNA/hAT-Charlie	508	+	212	105720372	73663
chr11	105646709	105846709	harbor1	chr11	105736041	105736288	DNA/hAT-Charlie	638	+	124	105736165	89456
chr11	128114008	128314008	harbor1	chr11	128151442	128151621	DNA/hAT-Charlie	585	+	90	128151532	37524
chr11	13951696	14151696	harbor1	chr11	13968363	13968530	DNA/hAT-Charlie	689	+	84	13968447	16751
chr11	13951696	14151696	harbor1	chr11	13984979	13985165	DNA/hAT-Charlie	1138	+	93	13985072	33376
chr11	13951696	14151696	harbor1	chr11	14050316	14050530	DNA/hAT-Charlie	1120	+	107	14050423	98727
chr11	84048144	84248144	harbor1	chr11	84112976	84113946	DNA/hAT-Charlie	4103	+	485	84113461	65317
chr11	84048144	84248144	harbor1	chr11	84113978	84114284	DNA/hAT-Charlie	1065	+	153	84114131	65987
chr11	113495299	113695299	harbor1	chr11	113510553	113510708	DNA/hAT-Charlie	713	+	78	113510631	15332
chr11	113495299	113695299	harbor1	chr11	113573371	113573475	DNA/hAT-Charlie	451	+	52	113573423	78124
chr11	94548482	94748482	harbor1	chr11	94563628	94563840	DNA/hAT-Charlie	1144	+	106	94563734	15252
chr11	94548482	94748482	harbor1	chr11	94575500	94575614	DNA/hAT-Charlie	380	+	57	94575557	27075
chr11	94548482	94748482	harbor1	chr11	94586625	94586833	DNA/hAT-Charlie	1133	+	104	94586729	38247
chr11	94548482	94748482	harbor1	chr11	94594862	94595197	DNA/hAT-Charlie	1265	+	168	94595030	46548
chr11	94548482	94748482	harbor1	chr11	94637692	94637805	DNA/hAT-Charlie	589	+	56	94637748	89266
chr11	131816292	132016292	harbor1	chr11	131841452	131841599	DNA/hAT-Charlie	615	+	74	131841526	25234
chr11	131816292	132016292	harbor1	chr11	131845420	131845571	DNA/hAT-Charlie	496	+	76	131845496	29204
chr11	17578760	17778760	harbor1	chr11	17594844	17595037	DNA/hAT-Charlie	695	+	96	17594940	16180
chr11	17578760	17778760	harbor1	chr11	17632889	17633050	DNA/hAT-Charlie	722	+	80	17632969	54209
chr11	17578760	17778760	harbor1	chr11	17633210	17633278	DNA/hAT-Charlie	722	+	34	17633244	54484
chr11	102325619	102525619	harbor1	chr11	102329086	102329218	DNA/hAT-Charlie	402	+	66	102329152	3533
chr11	123171173	123371173	harbor1	chr11	123179906	123180031	DNA/hAT-Charlie	546	+	62	123179968	8795
chr11	123171173	123371173	harbor1	chr11	123191005	123191162	DNA/hAT-Charlie	378	+	78	123191083	19910
chr11	123171173	123371173	harbor1	chr11	123211833	123212040	DNA/hAT-Charlie	393	+	104	123211937	40764
chr11	123171173	123371173	harbor1	chr11	123237814	123238025	DNA/hAT-Charlie	1097	+	106	123237920	66747
chr11	123171173	123371173	harbor1	chr11	123245460	123245645	DNA/hAT-Charlie	1005	+	92	123245552	74379
chr11	96721950	96921950	harbor1	chr11	96747761	96747979	DNA/hAT-Charlie	1431	+	109	96747870	25920
chr11	13766004	13966004	harbor1	chr11	13781514	13781720	DNA/hAT-Charlie	720	+	103	13781617	15613
chr11	13766004	13966004	harbor1	chr11	13836384	13836546	DNA/hAT-Charlie	398	+	81	13836465	70461
chr11	13766004	13966004	harbor1	chr11	13864549	13864889	DNA/hAT-Charlie	2168	+	170	13864719	98715
chr11	121832507	122032507	harbor1	chr11	121883968	121884178	DNA/hAT-Charlie	1464	+	105	121884073	51566
chr11	121832507	122032507	harbor1	chr11	121893442	121893566	DNA/hAT-Charlie	404	+	62	121893504	60997
chr11	121832507	122032507	harbor1	chr11	121919054	121919415	DNA/hAT-Charlie	699	+	180	121919234	86727
chr11	121832507	122032507	harbor1	chr11	121920022	121920255	DNA/hAT-Charlie	848	+	116	121920138	87631
chr11	41175039	41375039	harbor1	chr11	41191673	41191818	DNA/hAT-Charlie	414	+	72	41191745	16706
chr11	41175039	41375039	harbor1	chr11	41262150	41262374	DNA/hAT-Charlie	706	+	112	41262262	87223
chr11	114599772	114799772	harbor1	chr11	114657265	114657764	DNA/hAT-Charlie	1560	+	250	114657515	57743
chr11	114599772	114799772	harbor1	chr11	114678672	114678874	DNA/hAT-Charlie	386	+	101	114678773	79001
chr11	19303881	19503881	harbor1	chr11	19311050	19311224	DNA/hAT-Charlie	540	+	87	19311137	7256
chr11	19303881	19503881	harbor1	chr11	19314487	19314617	DNA/hAT-Charlie	407	+	65	19314552	10671
chr11	19303881	19503881	harbor1	chr11	19354246	19354444	DNA/hAT-Charlie	1055	+	99	19354345	50464
chr11	19303881	19503881	harbor1	chr11	19387946	19388061	DNA/hAT-Charlie	579	+	58	19388004	84123
chr11	87812296	88012296	harbor1	chr11	87827179	87827272	DNA/hAT-Charlie	385	+	46	87827225	14929
chr11	28677570	28877570	harbor1	chr11	28692021	28692364	DNA/hAT-Charlie	2011	+	172	28692193	14623
chr11	28677570	28877570	harbor1	chr11	28713233	28713384	DNA/hAT-Charlie	619	+	76	28713309	35739
chr11	95769645	95969645	harbor1	chr11	95793981	95794143	DNA/hAT-Charlie	750	+	81	95794062	24417
chr11	95769645	95969645	harbor1	chr11	95842606	95843968	DNA/hAT-Charlie	4818	+	681	95843287	73642
chr11	78537505	78737505	harbor1	chr11	78544408	78544503	DNA/hAT-Charlie	380	+	48	78544456	6951
chr11	78537505	78737505	harbor1	chr11	78568114	78568297	DNA/hAT-Charlie	864	+	92	78568206	30701
chr11	16886980	17086980	harbor1	chr11	16910587	16910766	DNA/hAT-Charlie	1165	+	90	16910677	23697
chr11	16886980	17086980	harbor1	chr11	16912173	16912306	DNA/hAT-Charlie	582	+	66	16912239	25259
chr11	16886980	17086980	harbor1	chr11	16964786	16965009	DNA/hAT-Charlie	587	+	112	16964898	77918
chr11	35168072	35368072	harbor1	chr11	35216765	35216921	DNA/hAT-Charlie	707	+	78	35216843	48771
chr11	35168072	35368072	harbor1	chr11	35221796	35221951	DNA/hAT-Charlie	634	+	78	35221874	53802
chr11	35168072	35368072	harbor1	chr11	35225020	35225220	DNA/hAT-Charlie	1302	+	100	35225120	57048
chr11	57079994	57279994	harbor1	chr11	57105077	57105263	DNA/hAT-Charlie	407	+	93	57105170	25176
chr11	57079994	57279994	harbor1	chr11	57110180	57110791	DNA/hAT-Charlie	1594	+	306	57110486	30492
chr11	57079994	57279994	harbor1	chr11	57146031	57146236	DNA/hAT-Charlie	871	+	102	57146133	66139
chr11	57079994	57279994	harbor1	chr11	57147499	57147705	DNA/hAT-Charlie	657	+	103	57147602	67608
chr11	57079994	57279994	harbor1	chr11	57160636	57160945	DNA/hAT-Charlie	875	+	154	57160790	80796
chr11	72763215	72963215	harbor1	chr11	72802420	72802702	DNA/hAT-Charlie	792	+	141	72802561	39346
chr11	72763215	72963215	harbor1	chr11	72811643	72811672	DNA/hAT-Charlie	411	+	14	72811657	48442
chr11	72763215	72963215	harbor1	chr11	72812295	72812575	DNA/hAT-Charlie	411	+	140	72812435	49220
chr11	68873156	69073156	harbor1	chr11	68906408	68906631	DNA/hAT-Charlie	1065	+	112	68906520	33364
chr11	68873156	69073156	harbor1	chr11	68906942	68906997	DNA/hAT-Charlie	1065	+	28	68906970	33814
chr11	68873156	69073156	harbor1	chr11	68907285	68907324	DNA/hAT-Charlie	1065	+	20	68907305	34149
chr11	68873156	69073156	harbor1	chr11	68924851	68925077	DNA/hAT-Charlie	1476	+	113	68924964	51808
chr11	68873156	69073156	harbor1	chr11	68948994	68949500	DNA/hAT-Charlie	3497	+	253	68949247	76091
chr11	106662535	106862535	harbor1	chr11	106682332	106682490	DNA/hAT-Charlie	469	+	79	106682411	19876
chr11	106662535	106862535	harbor1	chr11	106714667	106714868	DNA/hAT-Charlie	812	+	100	106714767	52232
chr11	126366724	126566724	harbor1	chr11	126375682	126375855	DNA/hAT-Charlie	812	+	86	126375768	9044
chr11	126366724	126566724	harbor1	chr11	126396930	126397105	DNA/hAT-Charlie	779	+	88	126397018	30294
chr11	126366724	126566724	harbor1	chr11	126403446	126403633	DNA/hAT-Charlie	521	+	94	126403540	36816
chr11	126366724	126566724	harbor1	chr11	126403931	126404107	DNA/hAT-Charlie	481	+	88	126404019	37295
chr11	48211786	48411786	harbor1	chr11	48221131	48221326	DNA/hAT-Charlie	611	+	98	48221229	9443
chr11	48211786	48411786	harbor1	chr11	48222187	48222395	DNA/hAT-Charlie	894	+	104	48222291	10505
chr11	18246976	18446976	harbor1	chr11	18250365	18250497	DNA/hAT-Charlie	500	+	66	18250431	3455
chr11	18246976	18446976	harbor1	chr11	18250495	18251021	DNA/hAT-Charlie	2296	+	263	18250758	3782
chr11	18246976	18446976	harbor1	chr11	18273592	18273705	DNA/hAT-Charlie	705	+	56	18273648	26672
chr11	40033670	40233670	harbor1	chr11	40060635	40060809	DNA/hAT-Charlie	417	+	87	40060722	27052
chr11	40033670	40233670	harbor1	chr11	40093111	40093286	DNA/hAT-Charlie	471	+	88	40093199	59529
chr11	40033670	40233670	harbor1	chr11	40131946	40132107	DNA/hAT-Charlie	420	+	80	40132026	98356
chr11	128488820	128688820	harbor1	chr11	128551861	128552029	DNA/hAT-Charlie	1013	+	84	128551945	63125
chr11	34135549	34335549	harbor1	chr11	34135436	34135604	DNA/hAT-Charlie	958	+	84	34135520	29
chr11	34135549	34335549	harbor1	chr11	34156833	34156971	DNA/hAT-Charlie	455	+	69	34156902	21353
chr11	34135549	34335549	harbor1	chr11	34200842	34201123	DNA/hAT-Charlie	903	+	140	34200982	65433
chr11	125561816	125761816	harbor1	chr11	125607495	125607689	DNA/hAT-Charlie	878	+	97	125607592	45776
chr11	114646701	114846701	harbor1	chr11	114657265	114657764	DNA/hAT-Charlie	1560	+	250	114657515	10814
chr11	114646701	114846701	harbor1	chr11	114678672	114678874	DNA/hAT-Charlie	386	+	101	114678773	32072
chr11	114646701	114846701	harbor1	chr11	114700709	114700877	DNA/hAT-Charlie	576	+	84	114700793	54092
chr11	114646701	114846701	harbor1	chr11	114703361	114703551	DNA/hAT-Charlie	719	+	95	114703456	56755
chr11	114646701	114846701	harbor1	chr11	114716928	114717104	DNA/hAT-Charlie	637	+	88	114717016	70315
chr11	114646701	114846701	harbor1	chr11	114720513	114720813	DNA/hAT-Charlie	1156	+	150	114720663	73962
chr11	74398236	74598236	harbor1	chr11	74400462	74400580	DNA/hAT-Charlie	435	+	59	74400521	2285
chr11	74398236	74598236	harbor1	chr11	74428718	74429016	DNA/hAT-Charlie	1394	+	149	74428867	30631
chr11	74398236	74598236	harbor1	chr11	74438088	74438226	DNA/hAT-Charlie	384	+	69	74438157	39921
chr11	74398236	74598236	harbor1	chr11	74469012	74469158	DNA/hAT-Charlie	421	+	73	74469085	70849
chr11	74398236	74598236	harbor1	chr11	74490384	74490578	DNA/hAT-Charlie	1165	+	97	74490481	92245
chr11	74398236	74598236	harbor1	chr11	74490711	74490820	DNA/hAT-Charlie	1165	+	54	74490765	92529
chr11	37450447	37650447	harbor1	chr11	37467667	37467751	DNA/hAT-Charlie	390	+	42	37467709	17262
chr11	37450447	37650447	harbor1	chr11	37476485	37476600	DNA/hAT-Charlie	497	+	58	37476543	26096
chr11	37450447	37650447	harbor1	chr11	37542314	37542626	DNA/hAT-Charlie	1403	+	156	37542470	92023
chr11	37450447	37650447	harbor1	chr11	37547026	37547220	DNA/hAT-Charlie	802	+	97	37547123	96676
chr11	90314172	90514172	harbor1	chr11	90351929	90352262	DNA/hAT-Charlie	1837	+	166	90352095	37923
chr11	90314172	90514172	harbor1	chr11	90383245	90383506	DNA/hAT-Charlie	571	+	130	90383375	69203
chr11	90314172	90514172	harbor1	chr11	90383817	90383855	DNA/hAT-Charlie	571	+	19	90383836	69664
chr11	88698243	88898243	harbor1	chr11	88771125	88771188	DNA/hAT-Charlie	472	+	32	88771157	72914
chr11	88698243	88898243	harbor1	chr11	88771750	88771831	DNA/hAT-Charlie	472	+	40	88771790	73547
chr11	134654003	134854003	harbor1	chr11	134661444	134661615	DNA/hAT-Charlie	385	+	86	134661530	7527
chr11	134654003	134854003	harbor1	chr11	134671322	134671509	DNA/hAT-Charlie	682	+	94	134671416	17413
chr11	98385961	98585961	harbor1	chr11	98430148	98430338	DNA/hAT-Charlie	1141	+	95	98430243	44282
chr11	98385961	98585961	harbor1	chr11	98460586	98460712	DNA/hAT-Charlie	426	+	63	98460649	74688
chr11	114266400	114466400	harbor1	chr11	114272730	114273220	DNA/hAT-Charlie	1333	+	245	114272975	6575
chr11	114266400	114466400	harbor1	chr11	114305037	114305181	DNA/hAT-Charlie	572	+	72	114305109	38709
chr11	114266400	114466400	harbor1	chr11	114315429	114315699	DNA/hAT-Charlie	554	+	135	114315564	49164
chr11	114266400	114466400	harbor1	chr11	114318528	114318663	DNA/hAT-Charlie	457	+	68	114318596	52196
chr11	114266400	114466400	harbor1	chr11	114318967	114319010	DNA/hAT-Charlie	457	+	22	114318989	52589
chr11	114266400	114466400	harbor1	chr11	114349945	114350088	DNA/hAT-Charlie	710	+	72	114350017	83617
chr11	114266400	114466400	harbor1	chr11	114350219	114350273	DNA/hAT-Charlie	710	+	27	114350246	83846
chr11	114266400	114466400	harbor1	chr11	114354972	114355218	DNA/hAT-Charlie	512	+	123	114355095	88695
chr11	18988272	19188272	harbor1	chr11	19016884	19017072	DNA/hAT-Charlie	433	+	94	19016978	28706
chr11	80386549	80586549	harbor1	chr11	80449734	80449807	DNA/hAT-Charlie	387	+	36	80449770	63221
chr11	33538382	33738382	harbor1	chr11	33545453	33545676	DNA/hAT-Charlie	1161	+	112	33545565	7183
chr11	33538382	33738382	harbor1	chr11	33545836	33546001	DNA/hAT-Charlie	402	+	82	33545918	7536
chr11	33538382	33738382	harbor1	chr11	33597045	33597281	DNA/hAT-Charlie	657	+	118	33597163	58781
chr11	63605429	63805429	harbor1	chr11	63650847	63651112	DNA/hAT-Charlie	587	+	132	63650979	45550
chr11	78826365	79026365	harbor1	chr11	78851126	78851273	DNA/hAT-Charlie	768	+	74	78851200	24835
chr11	78826365	79026365	harbor1	chr11	78903845	78904021	DNA/hAT-Charlie	873	+	88	78903933	77568
chr11	36630898	36830898	harbor1	chr11	36640188	36641426	DNA/hAT-Charlie	5496	+	619	36640807	9909
chr11	36630898	36830898	harbor1	chr11	36661087	36661215	DNA/hAT-Charlie	726	+	64	36661151	30253
chr11	36630898	36830898	harbor1	chr11	36661759	36662004	DNA/hAT-Charlie	802	+	122	36661881	30983
chr11	36630898	36830898	harbor1	chr11	36686964	36687227	DNA/hAT-Charlie	854	+	132	36687096	56198
chr11	36630898	36830898	harbor1	chr11	36690089	36690216	DNA/hAT-Charlie	586	+	64	36690153	59255
chr11	36630898	36830898	harbor1	chr11	36691824	36692024	DNA/hAT-Charlie	451	+	100	36691924	61026
chr11	36630898	36830898	harbor1	chr11	36704999	36705105	DNA/hAT-Charlie	414	+	53	36705052	74154
chr11	36630898	36830898	harbor1	chr11	36730321	36730497	DNA/hAT-Charlie	979	+	88	36730409	99511
chr11	37489073	37689073	harbor1	chr11	37542314	37542626	DNA/hAT-Charlie	1403	+	156	37542470	53397
chr11	37489073	37689073	harbor1	chr11	37547026	37547220	DNA/hAT-Charlie	802	+	97	37547123	58050
chr11	124945047	125145047	harbor1	chr11	124958257	124958461	DNA/hAT-Charlie	1190	+	102	124958359	13312
chr11	110643052	110843052	harbor1	chr11	110669238	110669432	DNA/hAT-Charlie	844	+	97	110669335	26283
chr11	110643052	110843052	harbor1	chr11	110709077	110709253	DNA/hAT-Charlie	863	+	88	110709165	66113
chr11	110643052	110843052	harbor1	chr11	110740633	110740814	DNA/hAT-Charlie	796	+	90	110740723	97671
chr11	84178595	84378595	harbor1	chr11	84213424	84213537	DNA/hAT-Charlie	593	+	56	84213480	34885
chr11	84178595	84378595	harbor1	chr11	84213849	84213901	DNA/hAT-Charlie	593	+	26	84213875	35280
chr11	84178595	84378595	harbor1	chr11	84217634	84217809	DNA/hAT-Charlie	470	+	88	84217722	39127
chr11	84178595	84378595	harbor1	chr11	84218700	84218907	DNA/hAT-Charlie	1039	+	104	84218804	40209
chr11	84178595	84378595	harbor1	chr11	84236828	84236923	DNA/hAT-Charlie	390	+	48	84236876	58281
chr11	84178595	84378595	harbor1	chr11	84237228	84237289	DNA/hAT-Charlie	390	+	30	84237258	58663
chr11	84178595	84378595	harbor1	chr11	84243138	84243339	DNA/hAT-Charlie	928	+	100	84243238	64643
chr11	84178595	84378595	harbor1	chr11	84244077	84244181	DNA/hAT-Charlie	473	+	52	84244129	65534
chr11	62873055	63073055	harbor1	chr11	62898512	62898523	DNA/hAT-Charlie	646	+	6	62898518	25463
chr11	62873055	63073055	harbor1	chr11	62898817	62898880	DNA/hAT-Charlie	646	+	32	62898849	25794
chr11	62873055	63073055	harbor1	chr11	62904652	62904693	DNA/hAT-Charlie	936	+	20	62904672	31617
chr11	62873055	63073055	harbor1	chr11	62904991	62905188	DNA/hAT-Charlie	936	+	98	62905089	32034
chr11	62873055	63073055	harbor1	chr11	62905186	62905297	DNA/hAT-Charlie	530	+	56	62905242	32187
chr11	62873055	63073055	harbor1	chr11	62929525	62929695	DNA/hAT-Charlie	605	+	85	62929610	56555
chr11	62873055	63073055	harbor1	chr11	62898129	62898218	DNA/hAT-Charlie	646	+	44	62898173	25118
chr11	13709405	13909405	harbor1	chr11	13719672	13719846	DNA/hAT-Charlie	842	+	87	13719759	10354
chr11	13709405	13909405	harbor1	chr11	13734655	13734840	DNA/hAT-Charlie	1059	+	92	13734747	25342
chr11	13709405	13909405	harbor1	chr11	13781514	13781720	DNA/hAT-Charlie	720	+	103	13781617	72212
chr11	110702025	110902025	harbor1	chr11	110709077	110709253	DNA/hAT-Charlie	863	+	88	110709165	7140
chr11	110702025	110902025	harbor1	chr11	110740633	110740814	DNA/hAT-Charlie	796	+	90	110740723	38698
chr11	101980041	102180041	harbor1	chr11	102066869	102066984	DNA/hAT-Charlie	514	+	58	102066927	86886
chr11	41881756	42081756	harbor1	chr11	41924398	41924594	DNA/hAT-Charlie	598	+	98	41924496	42740
chr11	94540157	94740157	harbor1	chr11	94563628	94563840	DNA/hAT-Charlie	1144	+	106	94563734	23577
chr11	94540157	94740157	harbor1	chr11	94575500	94575614	DNA/hAT-Charlie	380	+	57	94575557	35400
chr11	94540157	94740157	harbor1	chr11	94586625	94586833	DNA/hAT-Charlie	1133	+	104	94586729	46572
chr11	94540157	94740157	harbor1	chr11	94594862	94595197	DNA/hAT-Charlie	1265	+	168	94595030	54873
chr11	94540157	94740157	harbor1	chr11	94637692	94637805	DNA/hAT-Charlie	589	+	56	94637748	97591
chr11	110177659	110377659	harbor1	chr11	110185439	110185616	DNA/hAT-Charlie	935	+	88	110185527	7868
chr11	110177659	110377659	harbor1	chr11	110198421	110198766	DNA/hAT-Charlie	2021	+	172	110198593	20934
chr11	110177659	110377659	harbor1	chr11	110206905	110206967	DNA/hAT-Charlie	818	+	31	110206936	29277
chr11	110177659	110377659	harbor1	chr11	110207274	110207399	DNA/hAT-Charlie	818	+	62	110207336	29677
chr11	110177659	110377659	harbor1	chr11	110207552	110207848	DNA/hAT-Charlie	1345	+	148	110207700	30041
chr11	110177659	110377659	harbor1	chr11	110242820	110243020	DNA/hAT-Charlie	914	+	100	110242920	65261
chr11	110177659	110377659	harbor1	chr11	110271555	110271705	DNA/hAT-Charlie	392	+	75	110271630	93971
chr11	125327504	125527504	harbor1	chr11	125369881	125370025	DNA/hAT-Charlie	744	+	72	125369953	42449
chr11	125327504	125527504	harbor1	chr11	125409816	125409921	DNA/hAT-Charlie	391	+	52	125409868	82364
chr11	6090059	6290059	harbor1	chr11	6178250	6178553	DNA/hAT-Charlie	2008	+	152	6178402	88343
chr11	95754271	95954271	harbor1	chr11	95767880	95768054	DNA/hAT-Charlie	852	+	87	95767967	13696
chr11	95754271	95954271	harbor1	chr11	95793981	95794143	DNA/hAT-Charlie	750	+	81	95794062	39791
chr11	95754271	95954271	harbor1	chr11	95842606	95843968	DNA/hAT-Charlie	4818	+	681	95843287	89016
chr11	95640727	95840727	harbor1	chr11	95643216	95643376	DNA/hAT-Charlie	673	+	80	95643296	2569
chr11	68560914	68760914	harbor1	chr11	68652549	68652741	DNA/hAT-Charlie	564	+	96	68652645	91731
chr11	68560914	68760914	harbor1	chr11	68658191	68658371	DNA/hAT-Charlie	865	+	90	68658281	97367
chr11	68560914	68760914	harbor1	chr11	68658672	68658719	DNA/hAT-Charlie	865	+	24	68658696	97782
chr11	61272269	61472269	harbor1	chr11	61280368	61280550	DNA/hAT-Charlie	941	+	91	61280459	8190
chr11	61272269	61472269	harbor1	chr11	61305779	61306094	DNA/hAT-Charlie	1566	+	158	61305937	33668
chr11	61272269	61472269	harbor1	chr11	61311582	61311748	DNA/hAT-Charlie	599	+	83	61311665	39396
chr11	61272269	61472269	harbor1	chr11	61322607	61322747	DNA/hAT-Charlie	417	+	70	61322677	50408
chr11	61272269	61472269	harbor1	chr11	61356116	61356319	DNA/hAT-Charlie	915	+	102	61356218	83949
chr11	8939133	9139133	harbor1	chr11	8939182	8939241	DNA/hAT-Charlie	622	+	30	8939212	79
chr11	8939133	9139133	harbor1	chr11	8939539	8939685	DNA/hAT-Charlie	622	+	73	8939612	479
chr11	8939133	9139133	harbor1	chr11	8966323	8966545	DNA/hAT-Charlie	905	+	111	8966434	27301
chr11	8939133	9139133	harbor1	chr11	8970550	8970800	DNA/hAT-Charlie	511	+	125	8970675	31542
chr11	8939133	9139133	harbor1	chr11	8971543	8971685	DNA/hAT-Charlie	415	+	71	8971614	32481
chr11	8939133	9139133	harbor1	chr11	8971683	8971815	DNA/hAT-Charlie	749	+	66	8971749	32616
chr11	79845632	80045632	harbor1	chr11	79852384	79852692	DNA/hAT-Charlie	861	+	154	79852538	6906
chr11	79845632	80045632	harbor1	chr11	79884953	79885169	DNA/hAT-Charlie	1168	+	108	79885061	39429
chr11	79845632	80045632	harbor1	chr11	79891305	79891569	DNA/hAT-Charlie	1170	+	132	79891437	45805
chr11	17129953	17329953	harbor1	chr11	17163793	17163884	DNA/hAT-Charlie	378	+	46	17163839	33886
chr11	17129953	17329953	harbor1	chr11	17204164	17204302	DNA/hAT-Charlie	686	+	69	17204233	74280
chr11	107483785	107683785	harbor1	chr11	107567367	107567563	DNA/hAT-Charlie	850	+	98	107567465	83680
chr11	107483785	107683785	harbor1	chr11	107580586	107580772	DNA/hAT-Charlie	419	+	93	107580679	96894
chr11	107483785	107683785	harbor1	chr11	107581076	107581090	DNA/hAT-Charlie	419	+	7	107581083	97298
chr11	194336	394336	harbor1	chr11	258493	258635	DNA/hAT-Charlie	617	+	71	258564	64228
chr11	194336	394336	harbor1	chr11	263425	263546	DNA/hAT-Charlie	377	+	60	263485	69149
chr11	24246450	24446450	harbor1	chr11	24255451	24256115	DNA/hAT-Charlie	2456	+	332	24255783	9333
chr11	24246450	24446450	harbor1	chr11	24256785	24257578	DNA/hAT-Charlie	2456	+	396	24257181	10731
chr11	24246450	24446450	harbor1	chr11	24302425	24302789	DNA/hAT-Charlie	1898	+	182	24302607	56157
chr11	24246450	24446450	harbor1	chr11	24323488	24323635	DNA/hAT-Charlie	383	+	74	24323562	77112
chr11	82001205	82201205	harbor1	chr11	82009436	82009714	DNA/hAT-Charlie	1018	+	139	82009575	8370
chr11	82001205	82201205	harbor1	chr11	82043885	82044051	DNA/hAT-Charlie	442	+	83	82043968	42763
chr11	82001205	82201205	harbor1	chr11	82085641	82085966	DNA/hAT-Charlie	1786	+	162	82085803	84598
chr11	126443381	126643381	harbor1	chr11	126479463	126479595	DNA/hAT-Charlie	575	+	66	126479529	36148
chr11	126443381	126643381	harbor1	chr11	126500222	126500321	DNA/hAT-Charlie	525	+	50	126500272	56891
chr11	105964603	106164603	harbor1	chr11	106012634	106012753	DNA/hAT-Charlie	573	+	60	106012694	48091
chr11	105964603	106164603	harbor1	chr11	106018383	106018526	DNA/hAT-Charlie	612	+	72	106018455	53852
chr11	105964603	106164603	harbor1	chr11	106024426	106024535	DNA/hAT-Charlie	444	+	54	106024480	59877
chr11	105964603	106164603	harbor1	chr11	106024533	106024826	DNA/hAT-Charlie	1316	+	146	106024679	60076
chr11	105964603	106164603	harbor1	chr11	106041371	106041573	DNA/hAT-Charlie	797	+	101	106041472	76869
chr11	41351237	41551237	harbor1	chr11	41365015	41365535	DNA/hAT-Charlie	3337	+	260	41365275	14038
chr11	41351237	41551237	harbor1	chr11	41395938	41396149	DNA/hAT-Charlie	1261	+	106	41396044	44807
chr11	41351237	41551237	harbor1	chr11	41435714	41435923	DNA/hAT-Charlie	437	+	104	41435818	84581
chr11	41351237	41551237	harbor1	chr11	41436211	41436253	DNA/hAT-Charlie	437	+	21	41436232	84995
chr11	31811977	32011977	harbor1	chr11	31875631	31875828	DNA/hAT-Charlie	817	+	98	31875729	63752
chr11	31811977	32011977	harbor1	chr11	31879081	31879255	DNA/hAT-Charlie	832	+	87	31879168	67191
chr11	31811977	32011977	harbor1	chr11	31884219	31884384	DNA/hAT-Charlie	808	+	82	31884301	72324
chr11	31811977	32011977	harbor1	chr11	31884399	31884474	DNA/hAT-Charlie	374	+	38	31884437	72460
chr11	31811977	32011977	harbor1	chr11	31885155	31885402	DNA/hAT-Charlie	728	+	124	31885279	73302
chr11	31811977	32011977	harbor1	chr11	31886437	31886711	DNA/hAT-Charlie	1697	+	137	31886574	74597
chr11	67212761	67412761	harbor1	chr11	67218440	67218591	DNA/hAT-Charlie	1460	+	76	67218516	5755
chr11	67212761	67412761	harbor1	chr11	67218909	67218988	DNA/hAT-Charlie	1460	+	40	67218949	6188
chr11	67212761	67412761	harbor1	chr11	67251549	67251706	DNA/hAT-Charlie	654	+	78	67251627	38866
chr11	124200099	124400099	harbor1	chr11	124219510	124219637	DNA/hAT-Charlie	482	+	64	124219574	19475
chr11	124200099	124400099	harbor1	chr11	124220228	124220364	DNA/hAT-Charlie	434	+	68	124220296	20197
chr11	124200099	124400099	harbor1	chr11	124240742	124240864	DNA/hAT-Charlie	461	+	61	124240803	40704
chr11	124200099	124400099	harbor1	chr11	124256038	124256152	DNA/hAT-Charlie	404	+	57	124256095	55996
chr11	28504909	28704909	harbor1	chr11	28515498	28515710	DNA/hAT-Charlie	735	+	106	28515604	10695
chr11	28504909	28704909	harbor1	chr11	28523851	28524047	DNA/hAT-Charlie	906	+	98	28523949	19040
chr11	28504909	28704909	harbor1	chr11	28563033	28563255	DNA/hAT-Charlie	1023	+	111	28563144	58235
chr11	28504909	28704909	harbor1	chr11	28601989	28602207	DNA/hAT-Charlie	1049	+	109	28602098	97189
chr11	14357795	14557795	harbor1	chr11	14362960	14363278	DNA/hAT-Charlie	721	+	159	14363119	5324
chr11	14357795	14557795	harbor1	chr11	14377404	14377513	DNA/hAT-Charlie	437	+	54	14377458	19663
chr11	14357795	14557795	harbor1	chr11	14410706	14410835	DNA/hAT-Charlie	777	+	64	14410770	52975
chr11	14357795	14557795	harbor1	chr11	14455774	14456017	DNA/hAT-Charlie	761	+	122	14455896	98101
chr11	41158449	41358449	harbor1	chr11	41191673	41191818	DNA/hAT-Charlie	414	+	72	41191745	33296
chr11	81399451	81599451	harbor1	chr11	81407584	81407729	DNA/hAT-Charlie	378	+	72	81407656	8205
chr11	81399451	81599451	harbor1	chr11	81439649	81439864	DNA/hAT-Charlie	440	+	108	81439757	40306
chr11	81399451	81599451	harbor1	chr11	81444970	81445322	DNA/hAT-Charlie	1160	+	176	81445146	45695
chr11	81399451	81599451	harbor1	chr11	81487189	81487350	DNA/hAT-Charlie	604	+	80	81487269	87818
chr11	81399451	81599451	harbor1	chr11	81444834	81444947	DNA/hAT-Charlie	565	+	56	81444890	45439
chr11	92876848	93076848	harbor1	chr11	92901551	92901696	DNA/hAT-Charlie	765	+	72	92901623	24775
chr11	92876848	93076848	harbor1	chr11	92929001	92929330	DNA/hAT-Charlie	1602	+	164	92929165	52317
chr11	92876848	93076848	harbor1	chr11	92940778	92941023	DNA/hAT-Charlie	502	+	122	92940900	64052
chr11	2955364	3155364	harbor1	chr11	2997264	2997418	DNA/hAT-Charlie	397	+	77	2997341	41977
chr11	133798185	133998185	harbor1	chr11	133871694	133872025	DNA/hAT-Charlie	2058	+	166	133871860	73675
chr11	109044882	109244882	harbor1	chr11	109059569	109059761	DNA/hAT-Charlie	903	+	96	109059665	14783
chr11	109044882	109244882	harbor1	chr11	109125362	109125449	DNA/hAT-Charlie	407	+	44	109125406	80524
chr11	109044882	109244882	harbor1	chr11	109129630	109129823	DNA/hAT-Charlie	548	+	96	109129726	84844
chr11	124079733	124279733	harbor1	chr11	124121375	124121593	DNA/hAT-Charlie	1572	+	109	124121484	41751
chr11	124079733	124279733	harbor1	chr11	124143403	124143736	DNA/hAT-Charlie	1244	+	166	124143569	63836
chr11	124079733	124279733	harbor1	chr11	124175146	124175299	DNA/hAT-Charlie	412	+	76	124175222	95489
chr11	124079733	124279733	harbor1	chr11	124179077	124179463	DNA/hAT-Charlie	600	+	193	124179270	99537
chr11	37017026	37217026	harbor1	chr11	37040338	37040479	DNA/hAT-Charlie	552	+	70	37040408	23382
chr11	37017026	37217026	harbor1	chr11	37069717	37069988	DNA/hAT-Charlie	506	+	136	37069853	52827
chr11	37017026	37217026	harbor1	chr11	37076546	37076750	DNA/hAT-Charlie	1053	+	102	37076648	59622
chr11	88961781	89161781	harbor1	chr11	88975556	88975721	DNA/hAT-Charlie	878	+	82	88975638	13857
chr11	88961781	89161781	harbor1	chr11	88982082	88982530	DNA/hAT-Charlie	1149	+	224	88982306	20525
chr11	31384769	31584769	harbor1	chr11	31472278	31472423	DNA/hAT-Charlie	442	+	72	31472350	87581
chr11	31384769	31584769	harbor1	chr11	31479532	31479721	DNA/hAT-Charlie	773	+	94	31479626	94857
chr11	27847842	28047842	harbor1	chr11	27863568	27863733	DNA/hAT-Charlie	888	+	82	27863650	15808
chr11	27847842	28047842	harbor1	chr11	27881736	27881951	DNA/hAT-Charlie	1049	+	108	27881844	34002
chr11	27847842	28047842	harbor1	chr11	27923707	27924208	DNA/hAT-Charlie	1099	+	250	27923957	76115
chr11	92699954	92899954	harbor1	chr11	92731251	92731430	DNA/hAT-Charlie	606	+	90	92731341	31387
chr11	92699954	92899954	harbor1	chr11	92743077	92743287	DNA/hAT-Charlie	425	+	105	92743182	43228
chr11	92699954	92899954	harbor1	chr11	92778550	92778682	DNA/hAT-Charlie	506	+	66	92778616	78662
chr11	40704413	40904413	harbor1	chr11	40718176	40718390	DNA/hAT-Charlie	1035	+	107	40718283	13870
chr11	40704413	40904413	harbor1	chr11	40755548	40755734	DNA/hAT-Charlie	848	+	93	40755641	51228
chr11	40704413	40904413	harbor1	chr11	40757671	40757829	DNA/hAT-Charlie	419	+	79	40757750	53337
chr11	40704413	40904413	harbor1	chr11	40760101	40760442	DNA/hAT-Charlie	1100	+	170	40760271	55858
chr11	126890418	127090418	harbor1	chr11	126941385	126941514	DNA/hAT-Charlie	420	+	64	126941449	51031
chr11	126890418	127090418	harbor1	chr11	126967726	126967936	DNA/hAT-Charlie	1126	+	105	126967831	77413
chr11	82739646	82939646	harbor1	chr11	82744168	82744399	DNA/hAT-Charlie	691	+	116	82744284	4638
chr11	82739646	82939646	harbor1	chr11	82768316	82768451	DNA/hAT-Charlie	452	+	68	82768384	28738
chr11	82739646	82939646	harbor1	chr11	82770624	82770980	DNA/hAT-Charlie	999	+	178	82770802	31156
chr11	82739646	82939646	harbor1	chr11	82771286	82771334	DNA/hAT-Charlie	999	+	24	82771310	31664
chr11	82739646	82939646	harbor1	chr11	82771651	82771856	DNA/hAT-Charlie	999	+	102	82771753	32107
chr11	82739646	82939646	harbor1	chr11	82822153	82822306	DNA/hAT-Charlie	645	+	76	82822229	82583
chr11	82892704	83092704	harbor1	chr11	82904579	82904744	DNA/hAT-Charlie	781	+	82	82904661	11957
chr11	82892704	83092704	harbor1	chr11	82924919	82925272	DNA/hAT-Charlie	1676	+	176	82925095	32391
chr11	82892704	83092704	harbor1	chr11	82926415	82926509	DNA/hAT-Charlie	430	+	47	82926462	33758
chr11	82892704	83092704	harbor1	chr11	82926592	82926756	DNA/hAT-Charlie	939	+	82	82926674	33970
chr11	91655753	91855753	harbor1	chr11	91659636	91659861	DNA/hAT-Charlie	964	+	112	91659748	3995
chr11	91655753	91855753	harbor1	chr11	91686953	91687116	DNA/hAT-Charlie	690	+	82	91687035	31282
chr11	91655753	91855753	harbor1	chr11	91714358	91714549	DNA/hAT-Charlie	668	+	96	91714454	58701
chr11	68926071	69126071	harbor1	chr11	68948994	68949500	DNA/hAT-Charlie	3497	+	253	68949247	23176
chr11	12455680	12655680	harbor1	chr11	12471663	12471824	DNA/hAT-Charlie	746	+	80	12471743	16063
chr11	12455680	12655680	harbor1	chr11	12531098	12531638	DNA/hAT-Charlie	2172	+	270	12531368	75688
chr11	91650522	91850522	harbor1	chr11	91659636	91659861	DNA/hAT-Charlie	964	+	112	91659748	9226
chr11	91650522	91850522	harbor1	chr11	91686953	91687116	DNA/hAT-Charlie	690	+	82	91687035	36513
chr11	91650522	91850522	harbor1	chr11	91714358	91714549	DNA/hAT-Charlie	668	+	96	91714454	63932
chr11	29016135	29216135	harbor1	chr11	29031380	29031590	DNA/hAT-Charlie	736	+	105	29031485	15350
chr11	29016135	29216135	harbor1	chr11	29099751	29099924	DNA/hAT-Charlie	402	+	86	29099837	83702
chr11	71108475	71308475	harbor1	chr11	71109278	71109414	DNA/hAT-Charlie	417	+	68	71109346	871
chr11	101124449	101324449	harbor1	chr11	101200458	101200599	DNA/hAT-Charlie	930	+	70	101200528	76079
chr11	42031622	42231622	harbor1	chr11	42063047	42063279	DNA/hAT-Charlie	431	+	116	42063163	31541
chr11	42031622	42231622	harbor1	chr11	42109797	42109953	DNA/hAT-Charlie	431	+	78	42109875	78253
chr11	113974068	114174068	harbor1	chr11	114003048	114003117	DNA/hAT-Charlie	841	+	34	114003082	29014
chr11	113974068	114174068	harbor1	chr11	114003420	114003540	DNA/hAT-Charlie	841	+	60	114003480	29412
chr11	113974068	114174068	harbor1	chr11	114021496	114021661	DNA/hAT-Charlie	709	+	82	114021578	47510
chr11	81910066	82110066	harbor1	chr11	82009436	82009714	DNA/hAT-Charlie	1018	+	139	82009575	99509
chr11	87721797	87921797	harbor1	chr11	87806933	87807242	DNA/hAT-Charlie	2041	+	154	87807087	85290
chr11	37292385	37492385	harbor1	chr11	37380526	37380745	DNA/hAT-Charlie	1010	+	110	37380636	88251
chr11	37292385	37492385	harbor1	chr11	37382372	37382695	DNA/hAT-Charlie	1425	+	162	37382534	90149
chr11	76156563	76356563	harbor1	chr11	76190634	76190871	DNA/hAT-Charlie	695	+	118	76190752	34189
chr11	28106160	28306160	harbor1	chr11	28192727	28192844	DNA/hAT-Charlie	610	+	58	28192785	86625
chr11	70522453	70722453	harbor1	chr11	70541643	70541855	DNA/hAT-Charlie	978	+	106	70541749	19296
chr11	88572653	88772653	harbor1	chr11	88619294	88619443	DNA/hAT-Charlie	499	+	74	88619368	46715
chr11	88572653	88772653	harbor1	chr11	88657986	88658259	DNA/hAT-Charlie	1345	+	136	88658122	85469
chr11	122314695	122514695	harbor1	chr11	122353073	122353383	DNA/hAT-Charlie	1182	+	155	122353228	38533
chr11	109497366	109697366	harbor1	chr11	109519070	109519213	DNA/hAT-Charlie	438	+	72	109519142	21776
chr11	109497366	109697366	harbor1	chr11	109532588	109532774	DNA/hAT-Charlie	629	+	93	109532681	35315
chr11	109497366	109697366	harbor1	chr11	109534544	109534747	DNA/hAT-Charlie	772	+	102	109534646	37280
chr11	109497366	109697366	harbor1	chr11	109581710	109581859	DNA/hAT-Charlie	701	+	74	109581784	84418
chr11	109497366	109697366	harbor1	chr11	109592671	109592893	DNA/hAT-Charlie	1040	+	111	109592782	95416
chr11	109497366	109697366	harbor1	chr11	109510502	109510715	DNA/hAT-Charlie	990	+	106	109510608	13242
chr11	122922968	123122968	harbor1	chr11	123003702	123003838	DNA/hAT-Charlie	525	+	68	123003770	80802
chr11	13101526	13301526	harbor1	chr11	13109707	13109917	DNA/hAT-Charlie	576	+	105	13109812	8286
chr11	13101526	13301526	harbor1	chr11	13157093	13157224	DNA/hAT-Charlie	555	+	66	13157159	55633
chr11	13101526	13301526	harbor1	chr11	13163310	13163472	DNA/hAT-Charlie	817	+	81	13163391	61865
chr11	13101526	13301526	harbor1	chr11	13176439	13176671	DNA/hAT-Charlie	938	+	116	13176555	75029
chr11	13101526	13301526	harbor1	chr11	13190068	13190339	DNA/hAT-Charlie	685	+	136	13190204	88678
chr11	13101526	13301526	harbor1	chr11	13172733	13172842	DNA/hAT-Charlie	610	+	54	13172787	71261
chr11	69904622	70104622	harbor1	chr11	69979762	69980084	DNA/hAT-Charlie	803	+	161	69979923	75301
chr11	69904622	70104622	harbor1	chr11	69981081	69981200	DNA/hAT-Charlie	803	+	60	69981141	76519
chr11	26902327	27102327	harbor1	chr11	26904286	26904448	DNA/hAT-Charlie	710	+	81	26904367	2040
chr11	26902327	27102327	harbor1	chr11	26914806	26914957	DNA/hAT-Charlie	410	+	76	26914882	12555
chr11	26902327	27102327	harbor1	chr11	26942290	26942367	DNA/hAT-Charlie	408	+	38	26942328	40001
chr11	26902327	27102327	harbor1	chr11	26949309	26949524	DNA/hAT-Charlie	733	+	108	26949417	47090
chr11	26902327	27102327	harbor1	chr11	26956480	26957188	DNA/hAT-Charlie	2354	+	354	26956834	54507
chr11	26902327	27102327	harbor1	chr11	26997232	26997416	DNA/hAT-Charlie	378	+	92	26997324	94997
chr11	131572888	131772888	harbor1	chr11	131646128	131646322	DNA/hAT-Charlie	820	+	97	131646225	73337
chr11	133574343	133774343	harbor1	chr11	133613252	133613362	DNA/hAT-Charlie	539	+	55	133613307	38964
chr11	133574343	133774343	harbor1	chr11	133613677	133613744	DNA/hAT-Charlie	539	+	34	133613711	39368
chr11	124207915	124407915	harbor1	chr11	124219510	124219637	DNA/hAT-Charlie	482	+	64	124219574	11659
chr11	124207915	124407915	harbor1	chr11	124220228	124220364	DNA/hAT-Charlie	434	+	68	124220296	12381
chr11	124207915	124407915	harbor1	chr11	124240742	124240864	DNA/hAT-Charlie	461	+	61	124240803	32888
chr11	124207915	124407915	harbor1	chr11	124256038	124256152	DNA/hAT-Charlie	404	+	57	124256095	48180
chr11	124207915	124407915	harbor1	chr11	124303868	124304038	DNA/hAT-Charlie	511	+	85	124303953	96038
chr11	44804875	45004875	harbor1	chr11	44806866	44807075	DNA/hAT-Charlie	554	+	104	44806970	2095
chr11	44804875	45004875	harbor1	chr11	44816123	44816317	DNA/hAT-Charlie	575	+	97	44816220	11345
chr11	44804875	45004875	harbor1	chr11	44867091	44867277	DNA/hAT-Charlie	1003	+	93	44867184	62309
chr11	44804875	45004875	harbor1	chr11	44878538	44878812	DNA/hAT-Charlie	464	+	137	44878675	73800
chr11	44804875	45004875	harbor1	chr11	44884938	44885154	DNA/hAT-Charlie	723	+	108	44885046	80171
chr11	44804875	45004875	harbor1	chr11	44890218	44890441	DNA/hAT-Charlie	1085	+	112	44890330	85455
chr11	44804875	45004875	harbor1	chr11	44890764	44890895	DNA/hAT-Charlie	1085	+	66	44890830	85955
chr11	44804875	45004875	harbor1	chr11	44891181	44891277	DNA/hAT-Charlie	1085	+	48	44891229	86354
chr11	38037663	38237663	harbor1	chr11	38048818	38049032	DNA/hAT-Charlie	803	+	107	38048925	11262
chr11	3465407	3665407	harbor1	chr11	3485958	3486109	DNA/hAT-Charlie	771	+	76	3486034	20627
chr11	3465407	3665407	harbor1	chr11	3487755	3487976	DNA/hAT-Charlie	1229	+	110	3487865	22458
chr11	3465407	3665407	harbor1	chr11	3533935	3534151	DNA/hAT-Charlie	830	+	108	3534043	68636
chr11	3465407	3665407	harbor1	chr11	3554282	3554490	DNA/hAT-Charlie	607	+	104	3554386	88979
chr11	39344920	39544920	harbor1	chr11	39418883	39419046	DNA/hAT-Charlie	639	+	82	39418965	74045
chr11	39344920	39544920	harbor1	chr11	39423093	39423262	DNA/hAT-Charlie	497	+	84	39423177	78257
chr11	39344920	39544920	harbor1	chr11	39432237	39432410	DNA/hAT-Charlie	616	+	86	39432323	87403
chr11	132180226	132380226	harbor1	chr11	132188142	132188271	DNA/hAT-Charlie	910	+	64	132188206	7980
chr11	132180226	132380226	harbor1	chr11	132207105	132207643	DNA/hAT-Charlie	3648	+	269	132207374	27148
chr11	132180226	132380226	harbor1	chr11	132221530	132221690	DNA/hAT-Charlie	575	+	80	132221610	41384
chr11	132180226	132380226	harbor1	chr11	132233477	132233755	DNA/hAT-Charlie	1167	+	139	132233616	53390
chr11	80660109	80860109	harbor1	chr11	80661215	80661370	DNA/hAT-Charlie	377	+	78	80661293	1184
chr11	80660109	80860109	harbor1	chr11	80663434	80663723	DNA/hAT-Charlie	2124	+	144	80663578	3469
chr11	80660109	80860109	harbor1	chr11	80719203	80719425	DNA/hAT-Charlie	1494	+	111	80719314	59205
chr11	80660109	80860109	harbor1	chr11	80730111	80730245	DNA/hAT-Charlie	594	+	67	80730178	70069
chr11	93561657	93761657	harbor1	chr11	93569456	93569565	DNA/hAT-Charlie	376	+	54	93569510	7853
chr11	93561657	93761657	harbor1	chr11	93578547	93578705	DNA/hAT-Charlie	501	+	79	93578626	16969
chr11	93561657	93761657	harbor1	chr11	93628602	93628660	DNA/hAT-Charlie	1108	+	29	93628631	66974
chr11	93561657	93761657	harbor1	chr11	93629493	93629646	DNA/hAT-Charlie	1108	+	76	93629569	67912
chr11	93561657	93761657	harbor1	chr11	93640535	93640627	DNA/hAT-Charlie	404	+	46	93640581	78924
chr11	93561657	93761657	harbor1	chr11	93647511	93647663	DNA/hAT-Charlie	855	+	76	93647587	85930
chr11	49013705	49213705	harbor1	chr11	49106746	49107026	DNA/hAT-Charlie	1692	+	140	49106886	93181
chr11	61819749	62019749	harbor1	chr11	61860098	61860304	DNA/hAT-Charlie	776	+	103	61860201	40452
chr11	78879808	79079808	harbor1	chr11	78903845	78904021	DNA/hAT-Charlie	873	+	88	78903933	24125
chr11	78879808	79079808	harbor1	chr11	78954390	78954860	DNA/hAT-Charlie	1059	+	235	78954625	74817
chr11	118761380	118961380	harbor1	chr11	118798345	118798524	DNA/hAT-Charlie	681	+	90	118798435	37055
chr11	118761380	118961380	harbor1	chr11	118844498	118844577	DNA/hAT-Charlie	1163	+	40	118844538	83158
chr11	118761380	118961380	harbor1	chr11	118844884	118844905	DNA/hAT-Charlie	1163	+	10	118844894	83514
chr11	118761380	118961380	harbor1	chr11	118845219	118845388	DNA/hAT-Charlie	1163	+	84	118845303	83923
chr11	118761380	118961380	harbor1	chr11	118857066	118857156	DNA/hAT-Charlie	499	+	45	118857111	95731
chr11	118761380	118961380	harbor1	chr11	118857184	118857317	DNA/hAT-Charlie	499	+	66	118857250	95870
chr11	31782150	31982150	harbor1	chr11	31875631	31875828	DNA/hAT-Charlie	817	+	98	31875729	93579
chr11	31782150	31982150	harbor1	chr11	31879081	31879255	DNA/hAT-Charlie	832	+	87	31879168	97018
chr12	94480564	94680564	harbor1	chr12	94481426	94481653	DNA/hAT-Charlie	666	+	114	94481540	976
chr12	94480564	94680564	harbor1	chr12	94482706	94482966	DNA/hAT-Charlie	1201	+	130	94482836	2272
chr12	94480564	94680564	harbor1	chr12	94482964	94483212	DNA/hAT-Charlie	1110	+	124	94483088	2524
chr12	94480564	94680564	harbor1	chr12	94565878	94566092	DNA/hAT-Charlie	1473	+	107	94565985	85421
chr12	94480564	94680564	harbor1	chr12	94486466	94486915	DNA/hAT-Charlie	1876	+	224	94486690	6126
chr12	96973387	97173387	harbor1	chr12	96992577	96992787	DNA/hAT-Charlie	974	+	105	96992682	19295
chr12	96973387	97173387	harbor1	chr12	97000001	97000181	DNA/hAT-Charlie	470	+	90	97000091	26704
chr12	96973387	97173387	harbor1	chr12	97011933	97012004	DNA/hAT-Charlie	611	+	36	97011969	38582
chr12	96973387	97173387	harbor1	chr12	97012005	97012338	DNA/hAT-Charlie	2252	+	166	97012171	38784
chr12	96973387	97173387	harbor1	chr12	97012339	97012473	DNA/hAT-Charlie	611	+	67	97012406	39019
chr12	96973387	97173387	harbor1	chr12	97046554	97046752	DNA/hAT-Charlie	704	+	99	97046653	73266
chr12	5048950	5248950	harbor1	chr12	5079149	5079304	DNA/hAT-Charlie	705	+	78	5079227	30277
chr12	5048950	5248950	harbor1	chr12	5079316	5079504	DNA/hAT-Charlie	744	+	94	5079410	30460
chr12	5048950	5248950	harbor1	chr12	5130282	5130446	DNA/hAT-Charlie	562	+	82	5130364	81414
chr12	17899436	18099436	harbor1	chr12	17968630	17968969	DNA/hAT-Charlie	1787	+	170	17968800	69364
chr12	17899436	18099436	harbor1	chr12	17987235	17987442	DNA/hAT-Charlie	421	+	104	17987339	87903
chr12	124815566	125015566	harbor1	chr12	124834601	124834625	DNA/hAT-Charlie	815	+	12	124834613	19047
chr12	124815566	125015566	harbor1	chr12	124834923	124835087	DNA/hAT-Charlie	815	+	82	124835005	19439
chr12	124815566	125015566	harbor1	chr12	124835679	124835975	DNA/hAT-Charlie	571	+	148	124835827	20261
chr12	124815566	125015566	harbor1	chr12	124837938	124838166	DNA/hAT-Charlie	898	+	114	124838052	22486
chr12	124815566	125015566	harbor1	chr12	124870817	124871000	DNA/hAT-Charlie	834	+	92	124870909	55343
chr12	124815566	125015566	harbor1	chr12	124875867	124875936	DNA/hAT-Charlie	470	+	34	124875901	60335
chr12	124815566	125015566	harbor1	chr12	124875937	124876121	DNA/hAT-Charlie	829	+	92	124876029	60463
chr12	124815566	125015566	harbor1	chr12	124883438	124883551	DNA/hAT-Charlie	489	+	56	124883494	67928
chr12	124815566	125015566	harbor1	chr12	124902076	124902285	DNA/hAT-Charlie	907	+	104	124902180	86614
chr12	16244172	16444172	harbor1	chr12	16269327	16269491	DNA/hAT-Charlie	600	+	82	16269409	25237
chr12	16244172	16444172	harbor1	chr12	16304354	16304529	DNA/hAT-Charlie	450	+	88	16304442	60270
chr12	32739466	32939466	harbor1	chr12	32817801	32818116	DNA/hAT-Charlie	1877	+	158	32817959	78493
chr12	31094007	31294007	harbor1	chr12	31147047	31147505	DNA/hAT-Charlie	2411	+	229	31147276	53269
chr12	31094007	31294007	harbor1	chr12	31193581	31193757	DNA/hAT-Charlie	683	+	88	31193669	99662
chr12	3323047	3523047	harbor1	chr12	3331614	3331727	DNA/hAT-Charlie	423	+	56	3331670	8623
chr12	3323047	3523047	harbor1	chr12	3372893	3373212	DNA/hAT-Charlie	1250	+	160	3373053	50006
chr12	74971811	75171811	harbor1	chr12	75059259	75059545	DNA/hAT-Charlie	1339	+	143	75059402	87591
chr12	95402324	95602324	harbor1	chr12	95437817	95437990	DNA/hAT-Charlie	949	+	86	95437903	35579
chr12	96932037	97132037	harbor1	chr12	96992577	96992787	DNA/hAT-Charlie	974	+	105	96992682	60645
chr12	96932037	97132037	harbor1	chr12	97000001	97000181	DNA/hAT-Charlie	470	+	90	97000091	68054
chr12	96932037	97132037	harbor1	chr12	97011933	97012004	DNA/hAT-Charlie	611	+	36	97011969	79932
chr12	96932037	97132037	harbor1	chr12	97012005	97012338	DNA/hAT-Charlie	2252	+	166	97012171	80134
chr12	96932037	97132037	harbor1	chr12	97012339	97012473	DNA/hAT-Charlie	611	+	67	97012406	80369
chr12	131564005	131764005	harbor1	chr12	131600332	131600528	DNA/hAT-Charlie	467	+	98	131600430	36425
chr12	54201605	54401605	harbor1	chr12	54206734	54206807	DNA/hAT-Charlie	462	+	36	54206770	5165
chr12	54201605	54401605	harbor1	chr12	54256552	54256770	DNA/hAT-Charlie	932	+	109	54256661	55056
chr12	54201605	54401605	harbor1	chr12	54278033	54278271	DNA/hAT-Charlie	1043	+	119	54278152	76547
chr12	60476615	60676615	harbor1	chr12	60546949	60547400	DNA/hAT-Charlie	2624	+	226	60547175	70560
chr12	5847612	6047612	harbor1	chr12	5847664	5847957	DNA/hAT-Charlie	772	+	146	5847810	198
chr12	5847612	6047612	harbor1	chr12	5855177	5855583	DNA/hAT-Charlie	972	+	203	5855380	7768
chr12	5847612	6047612	harbor1	chr12	5855936	5856370	DNA/hAT-Charlie	1075	+	217	5856153	8541
chr12	5847612	6047612	harbor1	chr12	5871429	5871748	DNA/hAT-Charlie	2004	+	160	5871589	23977
chr12	5847612	6047612	harbor1	chr12	5906963	5907377	DNA/hAT-Charlie	1498	+	207	5907170	59558
chr12	43246758	43446758	harbor1	chr12	43279404	43279547	DNA/hAT-Charlie	427	+	72	43279476	32718
chr12	43246758	43446758	harbor1	chr12	43279552	43279689	DNA/hAT-Charlie	2399	+	68	43279620	32862
chr12	43246758	43446758	harbor1	chr12	43280368	43280845	DNA/hAT-Charlie	2399	+	238	43280606	33848
chr12	43246758	43446758	harbor1	chr12	43290519	43290703	DNA/hAT-Charlie	599	+	92	43290611	43853
chr12	43246758	43446758	harbor1	chr12	43336631	43337111	DNA/hAT-Charlie	1660	+	240	43336871	90113
chr12	41060567	41260567	harbor1	chr12	41100592	41100795	DNA/hAT-Charlie	467	+	102	41100694	40127
chr12	41060567	41260567	harbor1	chr12	41104909	41105080	DNA/hAT-Charlie	687	+	86	41104995	44428
chr12	68968222	69168222	harbor1	chr12	69008541	69008831	DNA/hAT-Charlie	1065	+	145	69008686	40464
chr12	68968222	69168222	harbor1	chr12	69009730	69009976	DNA/hAT-Charlie	1094	+	123	69009853	41631
chr12	68968222	69168222	harbor1	chr12	69022090	69022425	DNA/hAT-Charlie	1744	+	168	69022258	54036
chr12	68968222	69168222	harbor1	chr12	69038423	69038607	DNA/hAT-Charlie	900	+	92	69038515	70293
chr12	81240188	81440188	harbor1	chr12	81328314	81328591	DNA/hAT-Charlie	1243	+	138	81328452	88264
chr12	128985440	129185440	harbor1	chr12	129055205	129055334	DNA/hAT-Charlie	541	+	64	129055269	69829
chr12	128985440	129185440	harbor1	chr12	129080103	129080340	DNA/hAT-Charlie	432	+	118	129080221	94781
chr12	74192503	74392503	harbor1	chr12	74288680	74288895	DNA/hAT-Charlie	735	+	108	74288788	96285
chr12	38249101	38449101	harbor1	chr12	38263773	38264211	DNA/hAT-Charlie	1191	+	219	38263992	14891
chr12	38249101	38449101	harbor1	chr12	38264605	38265096	DNA/hAT-Charlie	1191	+	246	38264851	15750
chr12	38249101	38449101	harbor1	chr12	38326066	38326169	DNA/hAT-Charlie	1223	+	52	38326118	77017
chr12	38249101	38449101	harbor1	chr12	38326222	38326320	DNA/hAT-Charlie	1223	+	49	38326271	77170
chr12	6746426	6946426	harbor1	chr12	6787339	6787636	DNA/hAT-Charlie	1408	+	148	6787487	41061
chr12	6746426	6946426	harbor1	chr12	6788193	6788360	DNA/hAT-Charlie	634	+	84	6788277	41851
chr12	59480829	59680829	harbor1	chr12	59573688	59573974	DNA/hAT-Charlie	865	+	143	59573831	93002
chr12	59480829	59680829	harbor1	chr12	59574306	59574422	DNA/hAT-Charlie	865	+	58	59574364	93535
chr12	117274781	117474781	harbor1	chr12	117290116	117290262	DNA/hAT-Charlie	741	+	73	117290189	15408
chr12	117274781	117474781	harbor1	chr12	117295232	117295530	DNA/hAT-Charlie	1023	+	149	117295381	20600
chr12	117274781	117474781	harbor1	chr12	117315958	117316161	DNA/hAT-Charlie	1025	+	102	117316060	41279
chr12	117274781	117474781	harbor1	chr12	117336425	117336548	DNA/hAT-Charlie	1002	+	62	117336487	61706
chr12	117274781	117474781	harbor1	chr12	117336648	117336789	DNA/hAT-Charlie	1002	+	70	117336718	61937
chr12	117274781	117474781	harbor1	chr12	117337095	117337106	DNA/hAT-Charlie	1002	+	6	117337101	62320
chr12	117274781	117474781	harbor1	chr12	117337416	117337494	DNA/hAT-Charlie	1002	+	39	117337455	62674
chr12	117274781	117474781	harbor1	chr12	117346577	117346742	DNA/hAT-Charlie	935	+	82	117346659	71878
chr12	117274781	117474781	harbor1	chr12	117347330	117347570	DNA/hAT-Charlie	449	+	120	117347450	72669
chr12	117274781	117474781	harbor1	chr12	117365841	117366027	DNA/hAT-Charlie	978	+	93	117365934	91153
chr12	117274781	117474781	harbor1	chr12	117369590	117369764	DNA/hAT-Charlie	901	+	87	117369677	94896
chr12	117274781	117474781	harbor1	chr12	117325382	117325971	DNA/hAT-Charlie	1533	+	294	117325676	50895
chr12	79388972	79588972	harbor1	chr12	79403719	79403898	DNA/hAT-Charlie	804	+	90	79403809	14837
chr12	79388972	79588972	harbor1	chr12	79410363	79410575	DNA/hAT-Charlie	1245	+	106	79410469	21497
chr12	79388972	79588972	harbor1	chr12	79418834	79419012	DNA/hAT-Charlie	651	+	89	79418923	29951
chr12	79388972	79588972	harbor1	chr12	79446372	79446566	DNA/hAT-Charlie	591	+	97	79446469	57497
chr12	79388972	79588972	harbor1	chr12	79484591	79484790	DNA/hAT-Charlie	1071	+	100	79484691	95719
chr12	79388972	79588972	harbor1	chr12	79485231	79485377	DNA/hAT-Charlie	1071	+	73	79485304	96332
chr12	47719336	47919336	harbor1	chr12	47779698	47779982	DNA/hAT-Charlie	1532	+	142	47779840	60504
chr12	4705794	4905794	harbor1	chr12	4734321	4734451	DNA/hAT-Charlie	621	+	65	4734386	28592
chr12	71993183	72193183	harbor1	chr12	72020076	72020285	DNA/hAT-Charlie	1218	+	104	72020180	26997
chr12	71993183	72193183	harbor1	chr12	72055534	72055746	DNA/hAT-Charlie	587	+	106	72055640	62457
chr12	71993183	72193183	harbor1	chr12	72068265	72068472	DNA/hAT-Charlie	1089	+	104	72068369	75186
chr12	12316099	12516099	harbor1	chr12	12332429	12332524	DNA/hAT-Charlie	702	+	48	12332477	16378
chr12	12316099	12516099	harbor1	chr12	12332821	12332923	DNA/hAT-Charlie	702	+	51	12332872	16773
chr12	2044271	2244271	harbor1	chr12	2073850	2074040	DNA/hAT-Charlie	545	+	95	2073945	29674
chr12	2044271	2244271	harbor1	chr12	2115655	2115780	DNA/hAT-Charlie	452	+	62	2115717	71446
chr12	128058448	128258448	harbor1	chr12	128135211	128135591	DNA/hAT-Charlie	1765	+	190	128135401	76953
chr12	94056979	94256979	harbor1	chr12	94082588	94082765	DNA/hAT-Charlie	517	+	88	94082676	25697
chr12	94056979	94256979	harbor1	chr12	94083125	94083219	DNA/hAT-Charlie	517	+	47	94083172	26193
chr12	94056979	94256979	harbor1	chr12	94083650	94083752	DNA/hAT-Charlie	447	+	51	94083701	26722
chr12	94056979	94256979	harbor1	chr12	94110400	94110718	DNA/hAT-Charlie	1907	+	159	94110559	53580
chr12	94056979	94256979	harbor1	chr12	94115273	94115530	DNA/hAT-Charlie	460	+	128	94115401	58422
chr12	94056979	94256979	harbor1	chr12	94115739	94115869	DNA/hAT-Charlie	481	+	65	94115804	58825
chr12	94056979	94256979	harbor1	chr12	94119008	94119154	DNA/hAT-Charlie	720	+	73	94119081	62102
chr12	94056979	94256979	harbor1	chr12	94126694	94127117	DNA/hAT-Charlie	1705	+	212	94126906	69927
chr12	94056979	94256979	harbor1	chr12	94155255	94155447	DNA/hAT-Charlie	1023	+	96	94155351	98372
chr12	65208481	65408481	harbor1	chr12	65227647	65227843	DNA/hAT-Charlie	1185	+	98	65227745	19264
chr12	65208481	65408481	harbor1	chr12	65234132	65234322	DNA/hAT-Charlie	548	+	95	65234227	25746
chr12	65208481	65408481	harbor1	chr12	65262122	65262283	DNA/hAT-Charlie	484	+	80	65262202	53721
chr12	65208481	65408481	harbor1	chr12	65262586	65262643	DNA/hAT-Charlie	484	+	28	65262614	54133
chr12	65208481	65408481	harbor1	chr12	65301419	65302243	DNA/hAT-Charlie	3317	+	412	65301831	93350
chr12	32406090	32606090	harbor1	chr12	32475526	32475701	DNA/hAT-Charlie	594	+	88	32475614	69524
chr12	32406090	32606090	harbor1	chr12	32498160	32498594	DNA/hAT-Charlie	1418	+	217	32498377	92287
chr12	32406090	32606090	harbor1	chr12	32498897	32499020	DNA/hAT-Charlie	1418	+	62	32498959	92869
chr12	95882915	96082915	harbor1	chr12	95963238	95963439	DNA/hAT-Charlie	1313	+	100	95963338	80423
chr12	95882915	96082915	harbor1	chr12	95971018	95971130	DNA/hAT-Charlie	584	+	56	95971074	88159
chr12	95882915	96082915	harbor1	chr12	95975142	95975297	DNA/hAT-Charlie	714	+	78	95975220	92305
chr12	91960114	92160114	harbor1	chr12	91973625	91973788	DNA/hAT-Charlie	494	+	82	91973707	13593
chr12	91960114	92160114	harbor1	chr12	91984127	91984289	DNA/hAT-Charlie	781	+	81	91984208	24094
chr12	91960114	92160114	harbor1	chr12	92007906	92008443	DNA/hAT-Charlie	3313	+	268	92008174	48060
chr12	109735929	109935929	harbor1	chr12	109744779	109745001	DNA/hAT-Charlie	559	+	111	109744890	8961
chr12	109735929	109935929	harbor1	chr12	109789717	109789913	DNA/hAT-Charlie	611	+	98	109789815	53886
chr12	109735929	109935929	harbor1	chr12	109798023	109798232	DNA/hAT-Charlie	936	+	104	109798127	62198
chr12	109735929	109935929	harbor1	chr12	109803776	109803962	DNA/hAT-Charlie	626	+	93	109803869	67940
chr12	109735929	109935929	harbor1	chr12	109817755	109817974	DNA/hAT-Charlie	1055	+	110	109817865	81936
chr12	109735929	109935929	harbor1	chr12	109789172	109789358	DNA/hAT-Charlie	1093	+	93	109789265	53336
chr12	10368295	10568295	harbor1	chr12	10416237	10416456	DNA/hAT-Charlie	1470	+	110	10416347	48052
chr12	10368295	10568295	harbor1	chr12	10431678	10431892	DNA/hAT-Charlie	1406	+	107	10431785	63490
chr12	10368295	10568295	harbor1	chr12	10447112	10447324	DNA/hAT-Charlie	1445	+	106	10447218	78923
chr12	124871176	125071176	harbor1	chr12	124875867	124875936	DNA/hAT-Charlie	470	+	34	124875901	4725
chr12	124871176	125071176	harbor1	chr12	124875937	124876121	DNA/hAT-Charlie	829	+	92	124876029	4853
chr12	124871176	125071176	harbor1	chr12	124883438	124883551	DNA/hAT-Charlie	489	+	56	124883494	12318
chr12	124871176	125071176	harbor1	chr12	124902076	124902285	DNA/hAT-Charlie	907	+	104	124902180	31004
chr12	124871176	125071176	harbor1	chr12	124916858	124917083	DNA/hAT-Charlie	1145	+	112	124916970	45794
chr12	124871176	125071176	harbor1	chr12	124966664	124966754	DNA/hAT-Charlie	438	+	45	124966709	95533
chr12	109820035	110020035	harbor1	chr12	109872911	109873139	DNA/hAT-Charlie	1499	+	114	109873025	52990
chr12	109820035	110020035	harbor1	chr12	109874555	109874709	DNA/hAT-Charlie	471	+	77	109874632	54597
chr12	109820035	110020035	harbor1	chr12	109877448	109877640	DNA/hAT-Charlie	1008	+	96	109877544	57509
chr12	16131282	16331282	harbor1	chr12	16169278	16169492	DNA/hAT-Charlie	891	+	107	16169385	38103
chr12	16131282	16331282	harbor1	chr12	16220515	16220677	DNA/hAT-Charlie	812	+	81	16220596	89314
chr12	116802124	117002124	harbor1	chr12	116802332	116802532	DNA/hAT-Charlie	936	+	100	116802432	308
chr12	116802124	117002124	harbor1	chr12	116804236	116804414	DNA/hAT-Charlie	1020	+	89	116804325	2201
chr12	116802124	117002124	harbor1	chr12	116827545	116827763	DNA/hAT-Charlie	1176	+	109	116827654	25530
chr12	116802124	117002124	harbor1	chr12	116835586	116835745	DNA/hAT-Charlie	551	+	80	116835666	33542
chr12	116802124	117002124	harbor1	chr12	116844006	116844212	DNA/hAT-Charlie	1193	+	103	116844109	41985
chr12	116802124	117002124	harbor1	chr12	116844562	116844694	DNA/hAT-Charlie	472	+	66	116844628	42504
chr12	116802124	117002124	harbor1	chr12	116888273	116888446	DNA/hAT-Charlie	912	+	86	116888359	86235
chr12	116802124	117002124	harbor1	chr12	116889867	116889948	DNA/hAT-Charlie	1106	+	40	116889907	87783
chr12	116802124	117002124	harbor1	chr12	116890229	116890391	DNA/hAT-Charlie	1106	+	81	116890310	88186
chr12	116802124	117002124	harbor1	chr12	116895129	116895298	DNA/hAT-Charlie	805	+	84	116895213	93089
chr12	116802124	117002124	harbor1	chr12	116897409	116897589	DNA/hAT-Charlie	731	+	90	116897499	95375
chr12	110452826	110652826	harbor1	chr12	110504074	110504186	DNA/hAT-Charlie	659	+	56	110504130	51304
chr12	110452826	110652826	harbor1	chr12	110504499	110504714	DNA/hAT-Charlie	659	+	108	110504607	51781
chr12	110452826	110652826	harbor1	chr12	110505031	110505052	DNA/hAT-Charlie	528	+	10	110505041	52215
chr12	110452826	110652826	harbor1	chr12	110552484	110552582	DNA/hAT-Charlie	907	+	49	110552533	99707
chr12	6654406	6854406	harbor1	chr12	6669421	6669498	DNA/hAT-Charlie	429	+	38	6669459	15053
chr12	6654406	6854406	harbor1	chr12	6669802	6669840	DNA/hAT-Charlie	429	+	19	6669821	15415
chr12	6654406	6854406	harbor1	chr12	6670050	6670146	DNA/hAT-Charlie	1162	+	48	6670098	15692
chr12	6654406	6854406	harbor1	chr12	6670439	6670696	DNA/hAT-Charlie	1162	+	128	6670567	16161
chr12	6654406	6854406	harbor1	chr12	6738190	6738405	DNA/hAT-Charlie	1000	+	108	6738298	83892
chr12	109413647	109613647	harbor1	chr12	109420271	109420330	DNA/hAT-Charlie	997	+	30	109420301	6654
chr12	109413647	109613647	harbor1	chr12	109420703	109420864	DNA/hAT-Charlie	997	+	80	109420783	7136
chr12	109413647	109613647	harbor1	chr12	109465423	109465565	DNA/hAT-Charlie	549	+	71	109465494	51847
chr12	109413647	109613647	harbor1	chr12	109469781	109470062	DNA/hAT-Charlie	660	+	140	109469921	56274
chr12	109413647	109613647	harbor1	chr12	109482817	109482985	DNA/hAT-Charlie	538	+	84	109482901	69254
chr12	109413647	109613647	harbor1	chr12	109506248	109506336	DNA/hAT-Charlie	633	+	44	109506292	92645
chr12	109413647	109613647	harbor1	chr12	109506650	109506742	DNA/hAT-Charlie	633	+	46	109506696	93049
chr12	109413647	109613647	harbor1	chr12	109513348	109513438	DNA/hAT-Charlie	465	+	45	109513393	99746
chr12	109413647	109613647	harbor1	chr12	109513440	109513640	DNA/hAT-Charlie	695	+	100	109513540	99893
chr12	1	136307	harbor1	chr12	29329	29578	DNA/hAT-Charlie	1297	+	124	29453	29452
chr12	1	136307	harbor1	chr12	39098	39482	DNA/hAT-Charlie	1575	+	192	39290	39289
chr12	1	136307	harbor1	chr12	81042	81230	DNA/hAT-Charlie	458	+	94	81136	81135
chr12	1	136307	harbor1	chr12	98290	98469	DNA/hAT-Charlie	691	+	90	98380	98379
chr12	75023940	75223940	harbor1	chr12	75059259	75059545	DNA/hAT-Charlie	1339	+	143	75059402	35462
chr13	49047700	49247700	harbor1	chr13	49100483	49100782	DNA/hAT-Charlie	632	+	150	49100633	52933
chr13	102769710	102969710	harbor1	chr13	102831082	102831261	DNA/hAT-Charlie	565	+	90	102831172	61462
chr13	35662478	35862478	harbor1	chr13	35678323	35678556	DNA/hAT-Charlie	1547	+	116	35678439	15961
chr13	35662478	35862478	harbor1	chr13	35747540	35747715	DNA/hAT-Charlie	485	+	88	35747628	85150
chr13	113208809	113408809	harbor1	chr13	113240162	113240356	DNA/hAT-Charlie	463	+	97	113240259	31450
chr13	69735301	69935301	harbor1	chr13	69739803	69740031	DNA/hAT-Charlie	833	+	114	69739917	4616
chr13	69735301	69935301	harbor1	chr13	69764654	69764798	DNA/hAT-Charlie	549	+	72	69764726	29425
chr13	69735301	69935301	harbor1	chr13	69764809	69764929	DNA/hAT-Charlie	436	+	60	69764869	29568
chr13	69735301	69935301	harbor1	chr13	69765252	69765365	DNA/hAT-Charlie	436	+	56	69765308	30007
chr13	69735301	69935301	harbor1	chr13	69799783	69800108	DNA/hAT-Charlie	1924	+	162	69799945	64644
chr13	35447407	35647407	harbor1	chr13	35522586	35522922	DNA/hAT-Charlie	1953	+	168	35522754	75347
chr13	51279069	51479069	harbor1	chr13	51331931	51332063	DNA/hAT-Charlie	452	+	66	51331997	52928
chr13	51279069	51479069	harbor1	chr13	51356979	51357176	DNA/hAT-Charlie	966	+	98	51357077	78008
chr13	51279069	51479069	harbor1	chr13	51371044	51371198	DNA/hAT-Charlie	643	+	77	51371121	92052
chr13	92008256	92208256	harbor1	chr13	92015062	92015278	DNA/hAT-Charlie	714	+	108	92015170	6914
chr13	26637409	26837409	harbor1	chr13	26712137	26712309	DNA/hAT-Charlie	683	+	86	26712223	74814
chr13	58607680	58807680	harbor1	chr13	58641695	58641975	DNA/hAT-Charlie	1198	+	140	58641835	34155
chr13	58607680	58807680	harbor1	chr13	58642289	58642450	DNA/hAT-Charlie	1198	+	80	58642369	34689
chr13	25574448	25774448	harbor1	chr13	25593470	25594235	DNA/hAT-Charlie	991	+	382	25593852	19404
chr13	25574448	25774448	harbor1	chr13	25595088	25595355	DNA/hAT-Charlie	448	+	134	25595222	20774
chr13	25574448	25774448	harbor1	chr13	25600889	25601111	DNA/hAT-Charlie	576	+	111	25601000	26552
chr13	25574448	25774448	harbor1	chr13	25606743	25606898	DNA/hAT-Charlie	672	+	78	25606821	32373
chr13	25574448	25774448	harbor1	chr13	25606916	25607253	DNA/hAT-Charlie	2168	+	168	25607084	32636
chr13	25574448	25774448	harbor1	chr13	25607262	25607400	DNA/hAT-Charlie	600	+	69	25607331	32883
chr13	25574448	25774448	harbor1	chr13	25631196	25631371	DNA/hAT-Charlie	607	+	88	25631284	56836
chr13	76633960	76833960	harbor1	chr13	76705035	76705200	DNA/hAT-Charlie	594	+	82	76705117	71157
chr13	34855318	35055318	harbor1	chr13	34866091	34866222	DNA/hAT-Charlie	444	+	66	34866157	10839
chr13	34855318	35055318	harbor1	chr13	34953761	34954085	DNA/hAT-Charlie	2188	+	162	34953923	98605
chr13	102768648	102968648	harbor1	chr13	102831082	102831261	DNA/hAT-Charlie	565	+	90	102831172	62524
chr13	25295822	25495822	harbor1	chr13	25348057	25348174	DNA/hAT-Charlie	422	+	58	25348115	52293
chr13	25295822	25495822	harbor1	chr13	25348155	25348453	DNA/hAT-Charlie	1080	+	149	25348304	52482
chr13	25295822	25495822	harbor1	chr13	25348575	25348633	DNA/hAT-Charlie	1080	+	29	25348604	52782
chr13	25295822	25495822	harbor1	chr13	25359312	25359467	DNA/hAT-Charlie	476	+	78	25359390	63568
chr13	25295822	25495822	harbor1	chr13	25380385	25380674	DNA/hAT-Charlie	1264	+	144	25380529	84707
chr13	24208292	24408292	harbor1	chr13	24218607	24218827	DNA/hAT-Charlie	1395	+	110	24218717	10425
chr13	24208292	24408292	harbor1	chr13	24227348	24227574	DNA/hAT-Charlie	734	+	113	24227461	19169
chr13	24208292	24408292	harbor1	chr13	24227870	24227908	DNA/hAT-Charlie	734	+	19	24227889	19597
chr13	24208292	24408292	harbor1	chr13	24228431	24228708	DNA/hAT-Charlie	588	+	138	24228569	20277
chr13	46299481	46499481	harbor1	chr13	46353510	46353683	DNA/hAT-Charlie	750	+	86	46353596	54115
chr13	46299481	46499481	harbor1	chr13	46353758	46353954	DNA/hAT-Charlie	1087	+	98	46353856	54375
chr13	52264859	52464859	harbor1	chr13	52281035	52281140	DNA/hAT-Charlie	830	+	52	52281087	16228
chr13	52264859	52464859	harbor1	chr13	52281173	52281320	DNA/hAT-Charlie	830	+	74	52281247	16388
chr13	20319218	20519218	harbor1	chr13	20321259	20321497	DNA/hAT-Charlie	501	+	119	20321378	2160
chr13	20319218	20519218	harbor1	chr13	20340060	20340203	DNA/hAT-Charlie	443	+	72	20340132	20914
chr13	20319218	20519218	harbor1	chr13	20389781	20389868	DNA/hAT-Charlie	425	+	44	20389825	70607
chr13	20319218	20519218	harbor1	chr13	20395971	20396276	DNA/hAT-Charlie	1035	+	152	20396123	76905
chr13	77680175	77880175	harbor1	chr13	77717724	77717877	DNA/hAT-Charlie	559	+	76	77717800	37625
chr13	77680175	77880175	harbor1	chr13	77718170	77718477	DNA/hAT-Charlie	1173	+	154	77718324	38149
chr13	77680175	77880175	harbor1	chr13	77735472	77735787	DNA/hAT-Charlie	663	+	158	77735630	55455
chr13	77680175	77880175	harbor1	chr13	77776469	77776646	DNA/hAT-Charlie	616	+	88	77776557	96382
chr13	59984783	60184783	harbor1	chr13	60007539	60007670	DNA/hAT-Charlie	540	+	66	60007605	22822
chr13	59984783	60184783	harbor1	chr13	60036309	60036496	DNA/hAT-Charlie	697	+	94	60036403	51620
chr13	41378341	41578341	harbor1	chr13	41395398	41395599	DNA/hAT-Charlie	738	+	100	41395498	17157
chr13	41378341	41578341	harbor1	chr13	41395831	41395986	DNA/hAT-Charlie	738	+	78	41395909	17568
chr13	41378341	41578341	harbor1	chr13	41408714	41408893	DNA/hAT-Charlie	976	+	90	41408804	30463
chr13	85492790	85692790	harbor1	chr13	85589588	85589753	DNA/hAT-Charlie	713	+	82	85589670	96880
chr13	87894965	88094965	harbor1	chr13	87924944	87926344	DNA/hAT-Charlie	2732	+	700	87925644	30679
chr13	87894965	88094965	harbor1	chr13	87930582	87930762	DNA/hAT-Charlie	514	+	90	87930672	35707
chr13	87894965	88094965	harbor1	chr13	87930861	87931053	DNA/hAT-Charlie	448	+	96	87930957	35992
chr13	87894965	88094965	harbor1	chr13	87944926	87945335	DNA/hAT-Charlie	1291	+	204	87945130	50165
chr13	72836662	73036662	harbor1	chr13	72879690	72880016	DNA/hAT-Charlie	1607	+	163	72879853	43191
chr13	72836662	73036662	harbor1	chr13	72903459	72903659	DNA/hAT-Charlie	847	+	100	72903559	66897
chr13	72836662	73036662	harbor1	chr13	72926117	72926199	DNA/hAT-Charlie	528	+	41	72926158	89496
chr13	58719302	58919302	harbor1	chr13	58753526	58753671	DNA/hAT-Charlie	714	+	72	58753598	34296
chr13	58719302	58919302	harbor1	chr13	58794730	58794928	DNA/hAT-Charlie	841	+	99	58794829	75527
chr13	97794457	97994457	harbor1	chr13	97799541	97800078	DNA/hAT-Charlie	868	+	268	97799809	5352
chr13	97794457	97994457	harbor1	chr13	97823810	97824135	DNA/hAT-Charlie	1281	+	162	97823972	29515
chr13	97794457	97994457	harbor1	chr13	97832108	97832322	DNA/hAT-Charlie	426	+	107	97832215	37758
chr13	61189938	61389938	harbor1	chr13	61240311	61241691	DNA/hAT-Charlie	4052	+	690	61241001	51063
chr13	61189938	61389938	harbor1	chr13	61281359	61281545	DNA/hAT-Charlie	1282	+	93	61281452	91514
chr13	48058307	48258307	harbor1	chr13	48090860	48091063	DNA/hAT-Charlie	917	+	102	48090962	32655
chr13	48058307	48258307	harbor1	chr13	48097204	48097424	DNA/hAT-Charlie	508	+	110	48097314	39007
chr13	29080377	29280377	harbor1	chr13	29113457	29113646	DNA/hAT-Charlie	695	+	94	29113551	33174
chr13	29080377	29280377	harbor1	chr13	29126521	29126742	DNA/hAT-Charlie	1400	+	110	29126631	46254
chr13	97265963	97465963	harbor1	chr13	97347807	97347942	DNA/hAT-Charlie	488	+	68	97347875	81912
chr14	64159541	64359541	harbor1	chr14	64166148	64166360	DNA/hAT-Charlie	1145	+	106	64166254	6713
chr14	64159541	64359541	harbor1	chr14	64222286	64222434	DNA/hAT-Charlie	778	+	74	64222360	62819
chr14	64159541	64359541	harbor1	chr14	64222741	64222772	DNA/hAT-Charlie	778	+	16	64222757	63216
chr14	64159541	64359541	harbor1	chr14	64247101	64247296	DNA/hAT-Charlie	692	+	98	64247199	87658
chr14	21947518	22147518	harbor1	chr14	21952333	21952469	DNA/hAT-Charlie	566	+	68	21952401	4883
chr14	21947518	22147518	harbor1	chr14	22001095	22001303	DNA/hAT-Charlie	833	+	104	22001199	53681
chr14	21947518	22147518	harbor1	chr14	22022598	22022791	DNA/hAT-Charlie	740	+	96	22022694	75176
chr14	23247661	23447661	harbor1	chr14	23289767	23289979	DNA/hAT-Charlie	1186	+	106	23289873	42212
chr14	23247661	23447661	harbor1	chr14	23310712	23310927	DNA/hAT-Charlie	729	+	108	23310820	63159
chr14	69846416	70046416	harbor1	chr14	69856856	69857103	DNA/hAT-Charlie	537	+	124	69856980	10564
chr14	69846416	70046416	harbor1	chr14	69857409	69857513	DNA/hAT-Charlie	537	+	52	69857461	11045
chr14	69846416	70046416	harbor1	chr14	69888982	69889166	DNA/hAT-Charlie	955	+	92	69889074	42658
chr14	69846416	70046416	harbor1	chr14	69914020	69914204	DNA/hAT-Charlie	857	+	92	69914112	67696
chr14	69846416	70046416	harbor1	chr14	69922524	69922698	DNA/hAT-Charlie	530	+	87	69922611	76195
chr14	99359904	99559904	harbor1	chr14	99362798	99363009	DNA/hAT-Charlie	764	+	106	99362904	3000
chr14	99359904	99559904	harbor1	chr14	99433319	99433441	DNA/hAT-Charlie	459	+	61	99433380	73476
chr14	88440908	88640908	harbor1	chr14	88468641	88468765	DNA/hAT-Charlie	483	+	62	88468703	27795
chr14	88440908	88640908	harbor1	chr14	88512607	88512797	DNA/hAT-Charlie	971	+	95	88512702	71794
chr14	88440908	88640908	harbor1	chr14	88519298	88519499	DNA/hAT-Charlie	1041	+	100	88519398	78490
chr14	38718769	38918769	harbor1	chr14	38761311	38761467	DNA/hAT-Charlie	638	+	78	38761389	42620
chr14	38718769	38918769	harbor1	chr14	38761538	38761636	DNA/hAT-Charlie	478	+	49	38761587	42818
chr14	58959527	59159527	harbor1	chr14	58964397	58964525	DNA/hAT-Charlie	806	+	64	58964461	4934
chr14	58959527	59159527	harbor1	chr14	58965129	58965230	DNA/hAT-Charlie	806	+	50	58965179	5652
chr14	58959527	59159527	harbor1	chr14	59050662	59050807	DNA/hAT-Charlie	593	+	72	59050734	91207
chr14	80092088	80292088	harbor1	chr14	80160348	80160508	DNA/hAT-Charlie	672	+	80	80160428	68340
chr14	80092088	80292088	harbor1	chr14	80168414	80168748	DNA/hAT-Charlie	1699	+	167	80168581	76493
chr14	80092088	80292088	harbor1	chr14	80172007	80172225	DNA/hAT-Charlie	1403	+	109	80172116	80028
chr14	80092088	80292088	harbor1	chr14	80177588	80177790	DNA/hAT-Charlie	700	+	101	80177689	85601
chr14	80997544	81197544	harbor1	chr14	81020274	81020770	DNA/hAT-Charlie	3653	+	248	81020522	22978
chr14	80997544	81197544	harbor1	chr14	81020768	81021234	DNA/hAT-Charlie	3636	+	233	81021001	23457
chr14	80997544	81197544	harbor1	chr14	81062930	81063131	DNA/hAT-Charlie	817	+	100	81063030	65486
chr14	98224347	98424347	harbor1	chr14	98233344	98233597	DNA/hAT-Charlie	1012	+	126	98233470	9123
chr14	98224347	98424347	harbor1	chr14	98245144	98245451	DNA/hAT-Charlie	1257	+	154	98245298	20951
chr14	98224347	98424347	harbor1	chr14	98251785	98251984	DNA/hAT-Charlie	819	+	100	98251885	27538
chr14	98224347	98424347	harbor1	chr14	98273819	98274019	DNA/hAT-Charlie	822	+	100	98273919	49572
chr14	98224347	98424347	harbor1	chr14	98291232	98291450	DNA/hAT-Charlie	920	+	109	98291341	66994
chr14	98224347	98424347	harbor1	chr14	98307986	98308197	DNA/hAT-Charlie	3906	+	106	98308092	83745
chr14	98224347	98424347	harbor1	chr14	98308509	98309653	DNA/hAT-Charlie	3906	+	572	98309081	84734
chr14	66936800	67136800	harbor1	chr14	66957728	66958051	DNA/hAT-Charlie	1881	+	162	66957890	21090
chr14	66936800	67136800	harbor1	chr14	66992722	66993005	DNA/hAT-Charlie	1179	+	142	66992864	56064
chr14	55828373	56028373	harbor1	chr14	55918085	55918422	DNA/hAT-Charlie	2132	+	168	55918253	89880
chr14	55828373	56028373	harbor1	chr14	55921098	55921200	DNA/hAT-Charlie	547	+	51	55921149	92776
chr14	55828373	56028373	harbor1	chr14	55836632	55836771	DNA/hAT-Charlie	420	+	70	55836702	8329
chr14	80691491	80891491	harbor1	chr14	80721357	80721676	DNA/hAT-Charlie	1334	+	160	80721517	30026
chr14	97698129	97898129	harbor1	chr14	97752670	97752854	DNA/hAT-Charlie	966	+	92	97752762	54633
chr14	97698129	97898129	harbor1	chr14	97778191	97778344	DNA/hAT-Charlie	421	+	76	97778267	80138
chr14	97698129	97898129	harbor1	chr14	97780956	97781164	DNA/hAT-Charlie	978	+	104	97781060	82931
chr14	69017177	69217177	harbor1	chr14	69018327	69018482	DNA/hAT-Charlie	3247	+	78	69018405	1228
chr14	69017177	69217177	harbor1	chr14	69018828	69019096	DNA/hAT-Charlie	3247	+	134	69018962	1785
chr14	69017177	69217177	harbor1	chr14	69019392	69019620	DNA/hAT-Charlie	3247	+	114	69019506	2329
chr14	69017177	69217177	harbor1	chr14	69019630	69019908	DNA/hAT-Charlie	3195	+	139	69019769	2592
chr14	69017177	69217177	harbor1	chr14	69020541	69020896	DNA/hAT-Charlie	3195	+	178	69020719	3542
chr14	69017177	69217177	harbor1	chr14	69021203	69021229	DNA/hAT-Charlie	3195	+	13	69021216	4039
chr14	69017177	69217177	harbor1	chr14	69021363	69021386	DNA/hAT-Charlie	3195	+	12	69021375	4198
chr14	69017177	69217177	harbor1	chr14	69021680	69021880	DNA/hAT-Charlie	3195	+	100	69021780	4603
chr14	69017177	69217177	harbor1	chr14	69087903	69088194	DNA/hAT-Charlie	763	+	146	69088049	70872
chr14	69017177	69217177	harbor1	chr14	69089726	69089933	DNA/hAT-Charlie	1153	+	104	69089830	72653
chr14	69017177	69217177	harbor1	chr14	69107370	69107534	DNA/hAT-Charlie	556	+	82	69107452	90275
chr14	76600498	76800498	harbor1	chr14	76605822	76605986	DNA/hAT-Charlie	662	+	82	76605904	5406
chr14	76600498	76800498	harbor1	chr14	76614356	76614521	DNA/hAT-Charlie	650	+	82	76614438	13940
chr14	76600498	76800498	harbor1	chr14	76638474	76638662	DNA/hAT-Charlie	1651	+	94	76638568	38070
chr14	76600498	76800498	harbor1	chr14	76638959	76639102	DNA/hAT-Charlie	1651	+	72	76639031	38533
chr14	76600498	76800498	harbor1	chr14	76649425	76649592	DNA/hAT-Charlie	716	+	84	76649509	49011
chr14	76600498	76800498	harbor1	chr14	76664218	76664459	DNA/hAT-Charlie	1089	+	120	76664338	63840
chr14	76600498	76800498	harbor1	chr14	76668274	76668350	DNA/hAT-Charlie	947	+	38	76668312	67814
chr14	76600498	76800498	harbor1	chr14	76668661	76668764	DNA/hAT-Charlie	947	+	52	76668713	68215
chr14	76600498	76800498	harbor1	chr14	76676577	76676924	DNA/hAT-Charlie	1218	+	174	76676751	76253
chr14	19605217	19805217	harbor1	chr14	19693180	19693378	DNA/hAT-Charlie	981	+	99	19693279	88062
chr14	63970607	64170607	harbor1	chr14	63982135	63982261	DNA/hAT-Charlie	511	+	63	63982198	11591
chr14	63970607	64170607	harbor1	chr14	64017815	64018169	DNA/hAT-Charlie	885	+	177	64017992	47385
chr14	63970607	64170607	harbor1	chr14	64054531	64054668	DNA/hAT-Charlie	677	+	68	64054599	83992
chr14	87095251	87295251	harbor1	chr14	87132754	87133048	DNA/hAT-Charlie	489	+	147	87132901	37650
chr14	87095251	87295251	harbor1	chr14	87144162	87144364	DNA/hAT-Charlie	632	+	101	87144263	49012
chr14	34236100	34436100	harbor1	chr14	34328471	34328636	DNA/hAT-Charlie	883	+	82	34328553	92453
chr14	53693796	53893796	harbor1	chr14	53704222	53705105	DNA/hAT-Charlie	3231	+	442	53704664	10868
chr14	53693796	53893796	harbor1	chr14	53705574	53705881	DNA/hAT-Charlie	2343	+	154	53705728	11932
chr14	53693796	53893796	harbor1	chr14	53706036	53706279	DNA/hAT-Charlie	2343	+	122	53706158	12362
chr14	53693796	53893796	harbor1	chr14	53738257	53738636	DNA/hAT-Charlie	601	+	190	53738447	44651
chr14	53693796	53893796	harbor1	chr14	53767532	53767662	DNA/hAT-Charlie	522	+	65	53767597	73801
chr14	53693796	53893796	harbor1	chr14	53774064	53774272	DNA/hAT-Charlie	1415	+	104	53774168	80372
chr14	85865398	86065398	harbor1	chr14	85956659	85957178	DNA/hAT-Charlie	3387	+	260	85956919	91521
chr14	51943763	52143763	harbor1	chr14	51951697	51951904	DNA/hAT-Charlie	1066	+	104	51951801	8038
chr14	51943763	52143763	harbor1	chr14	51951916	51952093	DNA/hAT-Charlie	663	+	88	51952004	8241
chr14	51943763	52143763	harbor1	chr14	51975835	51976209	DNA/hAT-Charlie	2371	+	187	51976022	32259
chr14	51943763	52143763	harbor1	chr14	51976497	51976656	DNA/hAT-Charlie	2371	+	80	51976577	32814
chr14	51943763	52143763	harbor1	chr14	51978214	51978433	DNA/hAT-Charlie	759	+	110	51978324	34561
chr14	51943763	52143763	harbor1	chr14	52027398	52027544	DNA/hAT-Charlie	568	+	73	52027471	83708
chr14	51943763	52143763	harbor1	chr14	52041519	52041682	DNA/hAT-Charlie	644	+	82	52041601	97838
chr14	46248771	46448771	harbor1	chr14	46325930	46326058	DNA/hAT-Charlie	447	+	64	46325994	77223
chr14	46248771	46448771	harbor1	chr14	46326074	46326254	DNA/hAT-Charlie	511	+	90	46326164	77393
chr14	46248771	46448771	harbor1	chr14	46344431	46344645	DNA/hAT-Charlie	1025	+	107	46344538	95767
chr14	78806683	79006683	harbor1	chr14	78873710	78873835	DNA/hAT-Charlie	664	+	62	78873772	67089
chr14	78806683	79006683	harbor1	chr14	78892023	78892205	DNA/hAT-Charlie	924	+	91	78892114	85431
chr14	78806683	79006683	harbor1	chr14	78896946	78897155	DNA/hAT-Charlie	1017	+	104	78897050	90367
chr14	78806683	79006683	harbor1	chr14	78904185	78904400	DNA/hAT-Charlie	1152	+	108	78904293	97610
chr14	101489120	101689120	harbor1	chr14	101513783	101513966	DNA/hAT-Charlie	460	+	92	101513875	24755
chr14	66796386	66996386	harbor1	chr14	66822343	66822494	DNA/hAT-Charlie	662	+	76	66822419	26033
chr14	66796386	66996386	harbor1	chr14	66829843	66830161	DNA/hAT-Charlie	1419	+	159	66830002	33616
chr14	66796386	66996386	harbor1	chr14	66850537	66850744	DNA/hAT-Charlie	1005	+	104	66850641	54255
chr14	66796386	66996386	harbor1	chr14	66867863	66868075	DNA/hAT-Charlie	893	+	106	66867969	71583
chr14	86528620	86728620	harbor1	chr14	86530457	86530837	DNA/hAT-Charlie	1736	+	190	86530647	2027
chr14	86528620	86728620	harbor1	chr14	86564690	86565015	DNA/hAT-Charlie	723	+	162	86564852	36232
chr14	93709546	93909546	harbor1	chr14	93750510	93750682	DNA/hAT-Charlie	660	+	86	93750596	41050
chr14	93709546	93909546	harbor1	chr14	93773368	93773552	DNA/hAT-Charlie	987	+	92	93773460	63914
chr14	93709546	93909546	harbor1	chr14	93776655	93777132	DNA/hAT-Charlie	1594	+	238	93776893	67347
chr14	93709546	93909546	harbor1	chr14	93803156	93803521	DNA/hAT-Charlie	1861	+	182	93803338	93792
chr14	39794968	39994968	harbor1	chr14	39807152	39807327	DNA/hAT-Charlie	506	+	88	39807240	12272
chr14	39794968	39994968	harbor1	chr14	39807514	39807670	DNA/hAT-Charlie	791	+	78	39807592	12624
chr14	39794968	39994968	harbor1	chr14	39848989	39849146	DNA/hAT-Charlie	798	+	78	39849067	54099
chr14	39794968	39994968	harbor1	chr14	39868698	39869434	DNA/hAT-Charlie	2201	+	368	39869066	74098
chr14	39794968	39994968	harbor1	chr14	39888861	39889188	DNA/hAT-Charlie	2000	+	164	39889025	94057
chr14	65202260	65402260	harbor1	chr14	65251834	65252132	DNA/hAT-Charlie	2016	+	149	65251983	49723
chr14	65202260	65402260	harbor1	chr14	65277139	65277399	DNA/hAT-Charlie	4857	+	130	65277269	75009
chr14	65202260	65402260	harbor1	chr14	65277520	65277599	DNA/hAT-Charlie	4857	+	40	65277560	75300
chr14	65202260	65402260	harbor1	chr14	65277972	65278837	DNA/hAT-Charlie	5597	+	432	65278404	76144
chr14	65202260	65402260	harbor1	chr14	65301042	65301280	DNA/hAT-Charlie	1716	+	119	65301161	98901
chr14	32591478	32791478	harbor1	chr14	32682817	32682975	DNA/hAT-Charlie	936	+	79	32682896	91418
chr14	61209798	61409798	harbor1	chr14	61303872	61304075	DNA/hAT-Charlie	889	+	102	61303974	94176
chr14	101471142	101671142	harbor1	chr14	101513783	101513966	DNA/hAT-Charlie	460	+	92	101513875	42733
chr14	43152444	43352444	harbor1	chr14	43195672	43195795	DNA/hAT-Charlie	466	+	62	43195734	43290
chr14	43152444	43352444	harbor1	chr14	43196801	43198406	DNA/hAT-Charlie	5259	+	802	43197603	45159
chr14	43152444	43352444	harbor1	chr14	43220440	43220788	DNA/hAT-Charlie	1023	+	174	43220614	68170
chr14	48626883	48826883	harbor1	chr14	48684453	48684658	DNA/hAT-Charlie	538	+	102	48684555	57672
chr14	58767942	58967942	harbor1	chr14	58807172	58807359	DNA/hAT-Charlie	901	+	94	58807266	39324
chr14	58767942	58967942	harbor1	chr14	58842380	58842556	DNA/hAT-Charlie	718	+	88	58842468	74526
chr14	58767942	58967942	harbor1	chr14	58769374	58769521	DNA/hAT-Charlie	609	+	74	58769448	1506
chr14	49047477	49247477	harbor1	chr14	49111548	49111660	DNA/hAT-Charlie	431	+	56	49111604	64127
chr14	23829601	24029601	harbor1	chr14	23889796	23890275	DNA/hAT-Charlie	1775	+	240	23890036	60435
chr14	23829601	24029601	harbor1	chr14	23896469	23897279	DNA/hAT-Charlie	3469	+	405	23896874	67273
chr14	23829601	24029601	harbor1	chr14	23899303	23899899	DNA/hAT-Charlie	2569	+	298	23899601	70000
chr14	23829601	24029601	harbor1	chr14	23905100	23905747	DNA/hAT-Charlie	1961	+	324	23905424	75823
chr14	23829601	24029601	harbor1	chr14	23905720	23905901	DNA/hAT-Charlie	544	+	90	23905810	76209
chr14	28274284	28474284	harbor1	chr14	28275379	28275561	DNA/hAT-Charlie	629	+	91	28275470	1186
chr14	28274284	28474284	harbor1	chr14	28280625	28280832	DNA/hAT-Charlie	760	+	104	28280729	6445
chr14	33843256	34043256	harbor1	chr14	33861886	33861946	DNA/hAT-Charlie	419	+	30	33861916	18660
chr14	33843256	34043256	harbor1	chr14	33926307	33926497	DNA/hAT-Charlie	591	+	95	33926402	83146
chr14	62591670	62791670	harbor1	chr14	62595411	62595604	DNA/hAT-Charlie	761	+	96	62595507	3837
chr14	62591670	62791670	harbor1	chr14	62669118	62669456	DNA/hAT-Charlie	2143	+	169	62669287	77617
chr14	78292435	78492435	harbor1	chr14	78309526	78309719	DNA/hAT-Charlie	473	+	96	78309622	17187
chr14	78292435	78492435	harbor1	chr14	78311429	78311658	DNA/hAT-Charlie	1377	+	114	78311543	19108
chr14	78292435	78492435	harbor1	chr14	78317244	78317609	DNA/hAT-Charlie	2126	+	182	78317426	24991
chr14	78292435	78492435	harbor1	chr14	78342996	78343143	DNA/hAT-Charlie	704	+	74	78343070	50635
chr14	78292435	78492435	harbor1	chr14	78343753	78343895	DNA/hAT-Charlie	691	+	71	78343824	51389
chr14	78292435	78492435	harbor1	chr14	78348629	78348785	DNA/hAT-Charlie	857	+	78	78348707	56272
chr14	78292435	78492435	harbor1	chr14	78361153	78361310	DNA/hAT-Charlie	479	+	78	78361231	68796
chr14	78292435	78492435	harbor1	chr14	78388539	78388705	DNA/hAT-Charlie	925	+	83	78388622	96187
chr14	78292435	78492435	harbor1	chr14	78390235	78390380	DNA/hAT-Charlie	690	+	72	78390307	97872
chr14	78292435	78492435	harbor1	chr14	78348173	78348297	DNA/hAT-Charlie	445	+	62	78348235	55800
chr14	78292435	78492435	harbor1	chr14	78364451	78365065	DNA/hAT-Charlie	1462	+	307	78364758	72323
chr14	85195821	85395821	harbor1	chr14	85202411	85202630	DNA/hAT-Charlie	923	+	110	85202521	6700
chr14	103994577	104194577	harbor1	chr14	104009272	104009409	DNA/hAT-Charlie	816	+	68	104009340	14763
chr14	103994577	104194577	harbor1	chr14	104040847	104041028	DNA/hAT-Charlie	533	+	90	104040937	46360
chr14	94024715	94224715	harbor1	chr14	94045112	94045345	DNA/hAT-Charlie	489	+	116	94045228	20513
chr14	94024715	94224715	harbor1	chr14	94061850	94061965	DNA/hAT-Charlie	461	+	58	94061908	37193
chr14	94024715	94224715	harbor1	chr14	94077784	94077918	DNA/hAT-Charlie	545	+	67	94077851	53136
chr14	94024715	94224715	harbor1	chr14	94099863	94100043	DNA/hAT-Charlie	815	+	90	94099953	75238
chr14	90600642	90800642	harbor1	chr14	90604969	90605154	DNA/hAT-Charlie	533	+	92	90605061	4419
chr14	90600642	90800642	harbor1	chr14	90625943	90626113	DNA/hAT-Charlie	645	+	85	90626028	25386
chr14	90600642	90800642	harbor1	chr14	90667363	90667717	DNA/hAT-Charlie	1479	+	177	90667540	66898
chr14	20373544	20573544	harbor1	chr14	20416416	20416542	DNA/hAT-Charlie	840	+	63	20416479	42935
chr14	20373544	20573544	harbor1	chr14	20416898	20416937	DNA/hAT-Charlie	840	+	20	20416918	43374
chr14	20373544	20573544	harbor1	chr14	20416947	20417100	DNA/hAT-Charlie	829	+	76	20417023	43479
chr14	20373544	20573544	harbor1	chr14	20441396	20441558	DNA/hAT-Charlie	668	+	81	20441477	67933
chr14	20373544	20573544	harbor1	chr14	20466983	20467146	DNA/hAT-Charlie	697	+	82	20467065	93521
chr14	20373544	20573544	harbor1	chr14	20467527	20467706	DNA/hAT-Charlie	1467	+	90	20467617	94073
chr14	20373544	20573544	harbor1	chr14	20467994	20468272	DNA/hAT-Charlie	1467	+	139	20468133	94589
chr14	90075941	90275941	harbor1	chr14	90086791	90087104	DNA/hAT-Charlie	1350	+	156	90086947	11006
chr14	90075941	90275941	harbor1	chr14	90087286	90087488	DNA/hAT-Charlie	1350	+	101	90087387	11446
chr14	90075941	90275941	harbor1	chr14	90088518	90088694	DNA/hAT-Charlie	560	+	88	90088606	12665
chr14	90075941	90275941	harbor1	chr14	90115761	90115898	DNA/hAT-Charlie	610	+	68	90115829	39888
chr14	90075941	90275941	harbor1	chr14	90168554	90168729	DNA/hAT-Charlie	498	+	88	90168642	92701
chr14	82776454	82976454	harbor1	chr14	82862329	82862874	DNA/hAT-Charlie	874	+	272	82862601	86147
chr14	82776454	82976454	harbor1	chr14	82863189	82863223	DNA/hAT-Charlie	874	+	17	82863206	86752
chr14	91881643	92081643	harbor1	chr14	91881510	91881646	DNA/hAT-Charlie	807	+	68	91881578	65
chr14	91881643	92081643	harbor1	chr14	91881763	91881903	DNA/hAT-Charlie	585	+	70	91881833	190
chr14	91881643	92081643	harbor1	chr14	91882187	91882299	DNA/hAT-Charlie	440	+	56	91882243	600
chr14	91881643	92081643	harbor1	chr14	91921493	91921633	DNA/hAT-Charlie	598	+	70	91921563	39920
chr14	91881643	92081643	harbor1	chr14	91929765	91929901	DNA/hAT-Charlie	667	+	68	91929833	48190
chr14	91881643	92081643	harbor1	chr14	91955815	91955947	DNA/hAT-Charlie	714	+	66	91955881	74238
chr14	91881643	92081643	harbor1	chr14	91956245	91956297	DNA/hAT-Charlie	714	+	26	91956271	74628
chr14	91881643	92081643	harbor1	chr14	91960158	91960363	DNA/hAT-Charlie	1289	+	102	91960260	78617
chr14	91881643	92081643	harbor1	chr14	91978436	91978521	DNA/hAT-Charlie	533	+	42	91978478	96835
chr14	91881643	92081643	harbor1	chr14	91978799	91978914	DNA/hAT-Charlie	533	+	58	91978857	97214
chr14	75726123	75926123	harbor1	chr14	75779243	75779355	DNA/hAT-Charlie	464	+	56	75779299	53176
chr14	33283992	33483992	harbor1	chr14	33368355	33368533	DNA/hAT-Charlie	469	+	89	33368444	84452
chr14	89825489	90025489	harbor1	chr14	89828209	89830572	DNA/hAT-Charlie	9908	+	1182	89829391	3902
chr14	89825489	90025489	harbor1	chr14	89850366	89850528	DNA/hAT-Charlie	677	+	81	89850447	24958
chr14	89825489	90025489	harbor1	chr14	89883213	89883363	DNA/hAT-Charlie	2857	+	75	89883288	57799
chr14	89825489	90025489	harbor1	chr14	89883698	89883838	DNA/hAT-Charlie	2857	+	70	89883768	58279
chr14	89825489	90025489	harbor1	chr14	89881940	89882779	DNA/hAT-Charlie	2857	+	420	89882360	56871
chr14	82787450	82987450	harbor1	chr14	82862329	82862874	DNA/hAT-Charlie	874	+	272	82862601	75151
chr14	82787450	82987450	harbor1	chr14	82863189	82863223	DNA/hAT-Charlie	874	+	17	82863206	75756
chr14	105609416	105809416	harbor1	chr14	105614231	105614561	DNA/hAT-Charlie	2044	+	165	105614396	4980
chr14	105609416	105809416	harbor1	chr14	105633666	105633996	DNA/hAT-Charlie	2112	+	165	105633831	24415
chr14	21555755	21755755	harbor1	chr14	21570916	21571070	DNA/hAT-Charlie	715	+	77	21570993	15238
chr14	21555755	21755755	harbor1	chr14	21627776	21627915	DNA/hAT-Charlie	480	+	70	21627846	72091
chr14	70986147	71186147	harbor1	chr14	70987226	70987426	DNA/hAT-Charlie	1139	+	100	70987326	1179
chr14	70986147	71186147	harbor1	chr14	71004033	71004243	DNA/hAT-Charlie	740	+	105	71004138	17991
chr14	70986147	71186147	harbor1	chr14	71004288	71004626	DNA/hAT-Charlie	2068	+	169	71004457	18310
chr14	70986147	71186147	harbor1	chr14	71076806	71076983	DNA/hAT-Charlie	810	+	88	71076894	90747
chr14	92702515	92902515	harbor1	chr14	92707430	92707730	DNA/hAT-Charlie	1059	+	150	92707580	5065
chr14	92702515	92902515	harbor1	chr14	92708221	92708314	DNA/hAT-Charlie	424	+	46	92708267	5752
chr14	92702515	92902515	harbor1	chr14	92713512	92713673	DNA/hAT-Charlie	615	+	80	92713592	11077
chr14	92702515	92902515	harbor1	chr14	92726383	92726462	DNA/hAT-Charlie	461	+	40	92726423	23908
chr14	92702515	92902515	harbor1	chr14	92730583	92730662	DNA/hAT-Charlie	560	+	40	92730623	28108
chr14	92702515	92902515	harbor1	chr14	92730953	92731000	DNA/hAT-Charlie	560	+	24	92730977	28462
chr14	92702515	92902515	harbor1	chr14	92732177	92732387	DNA/hAT-Charlie	798	+	105	92732282	29767
chr14	92702515	92902515	harbor1	chr14	92750023	92750088	DNA/hAT-Charlie	670	+	32	92750055	47540
chr14	92702515	92902515	harbor1	chr14	92751120	92751247	DNA/hAT-Charlie	670	+	64	92751184	48669
chr14	92702515	92902515	harbor1	chr14	92758839	92758918	DNA/hAT-Charlie	427	+	40	92758879	56364
chr14	92702515	92902515	harbor1	chr14	92771417	92771950	DNA/hAT-Charlie	3576	+	266	92771683	69168
chr14	92702515	92902515	harbor1	chr14	92780390	92780612	DNA/hAT-Charlie	1247	+	111	92780501	77986
chr14	55779991	55979991	harbor1	chr14	55789601	55789813	DNA/hAT-Charlie	602	+	106	55789707	9716
chr14	55779991	55979991	harbor1	chr14	55802909	55803091	DNA/hAT-Charlie	586	+	91	55803000	23009
chr14	55779991	55979991	harbor1	chr14	55813554	55813741	DNA/hAT-Charlie	644	+	94	55813648	33657
chr14	55779991	55979991	harbor1	chr14	55836632	55836771	DNA/hAT-Charlie	420	+	70	55836702	56711
chr14	64981559	65181559	harbor1	chr14	65021523	65021636	DNA/hAT-Charlie	437	+	56	65021579	40020
chr14	64981559	65181559	harbor1	chr14	65023508	65023734	DNA/hAT-Charlie	824	+	113	65023621	42062
chr14	64981559	65181559	harbor1	chr14	65023745	65023819	DNA/hAT-Charlie	771	+	37	65023782	42223
chr14	64981559	65181559	harbor1	chr14	65024119	65024214	DNA/hAT-Charlie	771	+	48	65024167	42608
chr14	39690311	39890311	harbor1	chr14	39705292	39705509	DNA/hAT-Charlie	1187	+	108	39705400	15089
chr14	39690311	39890311	harbor1	chr14	39714588	39714798	DNA/hAT-Charlie	724	+	105	39714693	24382
chr14	39690311	39890311	harbor1	chr14	39715041	39715212	DNA/hAT-Charlie	686	+	86	39715127	24816
chr14	39690311	39890311	harbor1	chr14	39715193	39715335	DNA/hAT-Charlie	447	+	71	39715264	24953
chr14	55055243	55255243	harbor1	chr14	55106124	55106290	DNA/hAT-Charlie	462	+	83	55106207	50964
chr14	55055243	55255243	harbor1	chr14	55106567	55106699	DNA/hAT-Charlie	462	+	66	55106633	51390
chr14	55055243	55255243	harbor1	chr14	55106692	55106871	DNA/hAT-Charlie	674	+	90	55106782	51539
chr14	55055243	55255243	harbor1	chr14	55107489	55107559	DNA/hAT-Charlie	674	+	35	55107524	52281
chr14	55055243	55255243	harbor1	chr14	55120599	55120775	DNA/hAT-Charlie	814	+	88	55120687	65444
chr14	55055243	55255243	harbor1	chr14	55134009	55134071	DNA/hAT-Charlie	863	+	31	55134040	78797
chr14	55055243	55255243	harbor1	chr14	55134206	55134359	DNA/hAT-Charlie	863	+	76	55134282	79039
chr14	61983282	62183282	harbor1	chr14	62080172	62080316	DNA/hAT-Charlie	650	+	72	62080244	96962
chr14	81911155	82111155	harbor1	chr14	81996805	81996885	DNA/hAT-Charlie	429	+	40	81996845	85690
chr14	81911155	82111155	harbor1	chr14	82000765	82000913	DNA/hAT-Charlie	653	+	74	82000839	89684
chr14	79910170	80110170	harbor1	chr14	79975333	79975357	DNA/hAT-Charlie	615	+	12	79975345	65175
chr14	79910170	80110170	harbor1	chr14	79975838	79975972	DNA/hAT-Charlie	615	+	67	79975905	65735
chr14	79910170	80110170	harbor1	chr14	79980196	79980459	DNA/hAT-Charlie	724	+	132	79980328	70158
chr14	72720854	72920854	harbor1	chr14	72722401	72722547	DNA/hAT-Charlie	417	+	73	72722474	1620
chr14	72720854	72920854	harbor1	chr14	72751539	72751839	DNA/hAT-Charlie	1408	+	150	72751689	30835
chr14	72720854	72920854	harbor1	chr14	72778182	72778669	DNA/hAT-Charlie	2875	+	244	72778426	57572
chr14	72720854	72920854	harbor1	chr14	72786392	72786615	DNA/hAT-Charlie	1335	+	112	72786504	65650
chr14	22896526	23096526	harbor1	chr14	22975302	22975488	DNA/hAT-Charlie	490	+	93	22975395	78869
chr14	79697647	79897647	harbor1	chr14	79724456	79724581	DNA/hAT-Charlie	549	+	62	79724518	26871
chr14	37832955	38032955	harbor1	chr14	37851658	37851810	DNA/hAT-Charlie	447	+	76	37851734	18779
chr14	37832955	38032955	harbor1	chr14	37853369	37853544	DNA/hAT-Charlie	495	+	88	37853457	20502
chr14	37832955	38032955	harbor1	chr14	37854867	37854971	DNA/hAT-Charlie	457	+	52	37854919	21964
chr14	37832955	38032955	harbor1	chr14	37874954	37875098	DNA/hAT-Charlie	875	+	72	37875026	42071
chr14	37832955	38032955	harbor1	chr14	37879935	37880192	DNA/hAT-Charlie	429	+	128	37880063	47108
chr14	37832955	38032955	harbor1	chr14	37888681	37888960	DNA/hAT-Charlie	1438	+	140	37888821	55866
chr14	37832955	38032955	harbor1	chr14	37898478	37898612	DNA/hAT-Charlie	524	+	67	37898545	65590
chr14	37832955	38032955	harbor1	chr14	37900028	37900210	DNA/hAT-Charlie	526	+	91	37900119	67164
chr14	37832955	38032955	harbor1	chr14	37900292	37901109	DNA/hAT-Charlie	2522	+	408	37900700	67745
chr14	101701807	101901807	harbor1	chr14	101714747	101714839	DNA/hAT-Charlie	1057	+	46	101714793	12986
chr14	101701807	101901807	harbor1	chr14	101715180	101715406	DNA/hAT-Charlie	1057	+	113	101715293	13486
chr14	101701807	101901807	harbor1	chr14	101727492	101727671	DNA/hAT-Charlie	655	+	90	101727582	25775
chr14	101701807	101901807	harbor1	chr14	101744111	101744246	DNA/hAT-Charlie	488	+	68	101744179	42372
chr14	101701807	101901807	harbor1	chr14	101780407	101780507	DNA/hAT-Charlie	549	+	50	101780457	78650
chr14	59281012	59481012	harbor1	chr14	59283960	59284126	DNA/hAT-Charlie	508	+	83	59284043	3031
chr14	59281012	59481012	harbor1	chr14	59309501	59309722	DNA/hAT-Charlie	1040	+	110	59309611	28599
chr14	59281012	59481012	harbor1	chr14	59319762	59319898	DNA/hAT-Charlie	662	+	68	59319830	38818
chr14	59281012	59481012	harbor1	chr14	59358102	59358242	DNA/hAT-Charlie	426	+	70	59358172	77160
chr15	86726217	86926217	harbor1	chr15	86770290	86770517	DNA/hAT-Charlie	865	+	114	86770404	44187
chr15	86726217	86926217	harbor1	chr15	86796639	86796847	DNA/hAT-Charlie	877	+	104	86796743	70526
chr15	86726217	86926217	harbor1	chr15	86803740	86803964	DNA/hAT-Charlie	932	+	112	86803852	77635
chr15	86726217	86926217	harbor1	chr15	86814052	86814397	DNA/hAT-Charlie	2073	+	172	86814224	88007
chr15	86726217	86926217	harbor1	chr15	86818258	86818588	DNA/hAT-Charlie	1780	+	165	86818423	92206
chr15	28613423	28813423	harbor1	chr15	28639709	28640030	DNA/hAT-Charlie	1035	+	160	28639869	26446
chr15	28613423	28813423	harbor1	chr15	28658993	28659131	DNA/hAT-Charlie	461	+	69	28659062	45639
chr15	28613423	28813423	harbor1	chr15	28661822	28661995	DNA/hAT-Charlie	905	+	86	28661908	48485
chr15	76168578	76368578	harbor1	chr15	76254525	76255055	DNA/hAT-Charlie	2001	+	265	76254790	86212
chr15	76168578	76368578	harbor1	chr15	76255057	76255975	DNA/hAT-Charlie	4860	+	459	76255516	86938
chr15	76168578	76368578	harbor1	chr15	76256284	76256676	DNA/hAT-Charlie	4860	+	196	76256480	87902
chr15	76168578	76368578	harbor1	chr15	76257057	76257076	DNA/hAT-Charlie	4860	+	10	76257067	88489
chr15	76168578	76368578	harbor1	chr15	76261748	76261866	DNA/hAT-Charlie	563	+	59	76261807	93229
chr15	58634147	58834147	harbor1	chr15	58676512	58676668	DNA/hAT-Charlie	626	+	78	58676590	42443
chr15	58634147	58834147	harbor1	chr15	58676832	58676995	DNA/hAT-Charlie	679	+	82	58676914	42767
chr15	58634147	58834147	harbor1	chr15	58729373	58729546	DNA/hAT-Charlie	530	+	86	58729459	95312
chr15	58634147	58834147	harbor1	chr15	58730301	58730422	DNA/hAT-Charlie	504	+	60	58730361	96214
chr15	40983413	41183413	harbor1	chr15	41015218	41015392	DNA/hAT-Charlie	855	+	87	41015305	31892
chr15	40983413	41183413	harbor1	chr15	41055729	41055916	DNA/hAT-Charlie	846	+	94	41055823	72410
chr15	44177255	44377255	harbor1	chr15	44220695	44220870	DNA/hAT-Charlie	892	+	88	44220783	43528
chr15	44177255	44377255	harbor1	chr15	44235408	44235827	DNA/hAT-Charlie	1507	+	210	44235618	58363
chr15	92553602	92753602	harbor1	chr15	92608966	92609095	DNA/hAT-Charlie	486	+	64	92609030	55428
chr15	62775878	62975878	harbor1	chr15	62790059	62790393	DNA/hAT-Charlie	666	+	167	62790226	14348
chr15	62775878	62975878	harbor1	chr15	62800815	62801086	DNA/hAT-Charlie	615	+	136	62800951	25073
chr15	62775878	62975878	harbor1	chr15	62848144	62848392	DNA/hAT-Charlie	533	+	124	62848268	72390
chr15	62775878	62975878	harbor1	chr15	62866107	62866314	DNA/hAT-Charlie	521	+	104	62866211	90333
chr15	101167986	101367986	harbor1	chr15	101198718	101198924	DNA/hAT-Charlie	626	+	103	101198821	30835
chr15	63247604	63447604	harbor1	chr15	63272907	63273229	DNA/hAT-Charlie	2280	+	161	63273068	25464
chr15	63247604	63447604	harbor1	chr15	63277932	63278109	DNA/hAT-Charlie	538	+	88	63278020	30416
chr15	63247604	63447604	harbor1	chr15	63322123	63322477	DNA/hAT-Charlie	1434	+	177	63322300	74696
chr15	63247604	63447604	harbor1	chr15	63335051	63335264	DNA/hAT-Charlie	957	+	106	63335157	87553
chr15	63247604	63447604	harbor1	chr15	63341260	63341605	DNA/hAT-Charlie	2413	+	172	63341432	93828
chr15	28494160	28694160	harbor1	chr15	28578600	28578807	DNA/hAT-Charlie	1344	+	104	28578704	84544
chr15	72619893	72819893	harbor1	chr15	72624196	72624499	DNA/hAT-Charlie	1901	+	152	72624348	4455
chr15	72619893	72819893	harbor1	chr15	72627482	72627643	DNA/hAT-Charlie	993	+	80	72627562	7669
chr15	72619893	72819893	harbor1	chr15	72634565	72634743	DNA/hAT-Charlie	815	+	89	72634654	14761
chr15	86967639	87167639	harbor1	chr15	87041606	87041942	DNA/hAT-Charlie	2226	+	168	87041774	74135
chr15	36549110	36749110	harbor1	chr15	36574416	36574705	DNA/hAT-Charlie	887	+	144	36574560	25450
chr15	27528623	27728623	harbor1	chr15	27605679	27605884	DNA/hAT-Charlie	766	+	102	27605781	77158
chr15	26562414	26762414	harbor1	chr15	26656488	26656828	DNA/hAT-Charlie	2140	+	170	26656658	94244
chr15	63141428	63341428	harbor1	chr15	63151724	63152007	DNA/hAT-Charlie	1648	+	142	63151866	10438
chr15	63141428	63341428	harbor1	chr15	63152269	63152457	DNA/hAT-Charlie	1648	+	94	63152363	10935
chr15	63141428	63341428	harbor1	chr15	63163572	63163699	DNA/hAT-Charlie	576	+	64	63163636	22208
chr15	63141428	63341428	harbor1	chr15	63163964	63164059	DNA/hAT-Charlie	504	+	48	63164012	22584
chr15	63141428	63341428	harbor1	chr15	63166074	63166208	DNA/hAT-Charlie	495	+	67	63166141	24713
chr15	63141428	63341428	harbor1	chr15	63183733	63183959	DNA/hAT-Charlie	1893	+	113	63183846	42418
chr15	63141428	63341428	harbor1	chr15	63184261	63184376	DNA/hAT-Charlie	1893	+	58	63184319	42891
chr15	63141428	63341428	harbor1	chr15	63194729	63194920	DNA/hAT-Charlie	862	+	96	63194825	53397
chr15	63141428	63341428	harbor1	chr15	63197748	63197910	DNA/hAT-Charlie	546	+	81	63197829	56401
chr15	63141428	63341428	harbor1	chr15	63219381	63219671	DNA/hAT-Charlie	647	+	145	63219526	78098
chr15	30893670	31093670	harbor1	chr15	30902060	30902241	DNA/hAT-Charlie	934	+	90	30902150	8480
chr15	30893670	31093670	harbor1	chr15	30912685	30912885	DNA/hAT-Charlie	1049	+	100	30912785	19115
chr15	30893670	31093670	harbor1	chr15	30913046	30913379	DNA/hAT-Charlie	2270	+	166	30913212	19542
chr15	30893670	31093670	harbor1	chr15	30979849	30980055	DNA/hAT-Charlie	980	+	103	30979952	86282
chr15	30893670	31093670	harbor1	chr15	30990093	30990330	DNA/hAT-Charlie	532	+	118	30990211	96541
chr15	72486905	72686905	harbor1	chr15	72489309	72489689	DNA/hAT-Charlie	1564	+	190	72489499	2594
chr15	72486905	72686905	harbor1	chr15	72490303	72490623	DNA/hAT-Charlie	1899	+	160	72490463	3558
chr15	72486905	72686905	harbor1	chr15	72493216	72493718	DNA/hAT-Charlie	1005	+	251	72493467	6562
chr15	72486905	72686905	harbor1	chr15	72562225	72562374	DNA/hAT-Charlie	605	+	74	72562299	75394
chr15	72486905	72686905	harbor1	chr15	72579519	72579695	DNA/hAT-Charlie	745	+	88	72579607	92702
chr15	79143436	79343436	harbor1	chr15	79146932	79147109	DNA/hAT-Charlie	771	+	88	79147020	3584
chr15	79143436	79343436	harbor1	chr15	79158483	79158705	DNA/hAT-Charlie	523	+	111	79158594	15158
chr15	79143436	79343436	harbor1	chr15	79175887	79176112	DNA/hAT-Charlie	955	+	112	79175999	32563
chr15	79143436	79343436	harbor1	chr15	79178130	79178284	DNA/hAT-Charlie	796	+	77	79178207	34771
chr15	79143436	79343436	harbor1	chr15	79192878	79193035	DNA/hAT-Charlie	439	+	78	79192956	49520
chr15	79143436	79343436	harbor1	chr15	79216321	79216489	DNA/hAT-Charlie	853	+	84	79216405	72969
chr15	79143436	79343436	harbor1	chr15	79228745	79228966	DNA/hAT-Charlie	1270	+	110	79228855	85419
chr15	40765275	40965275	harbor1	chr15	40811338	40811547	DNA/hAT-Charlie	972	+	104	40811442	46167
chr15	40765275	40965275	harbor1	chr15	40827123	40827226	DNA/hAT-Charlie	846	+	52	40827175	61900
chr15	40765275	40965275	harbor1	chr15	40827531	40827633	DNA/hAT-Charlie	846	+	51	40827582	62307
chr15	40765275	40965275	harbor1	chr15	40861428	40861706	DNA/hAT-Charlie	449	+	139	40861567	96292
chr15	65234502	65434502	harbor1	chr15	65269496	65269822	DNA/hAT-Charlie	705	+	163	65269659	35157
chr15	65234502	65434502	harbor1	chr15	65279810	65279937	DNA/hAT-Charlie	583	+	64	65279874	45372
chr15	65234502	65434502	harbor1	chr15	65299331	65299431	DNA/hAT-Charlie	697	+	50	65299381	64879
chr15	68051711	68251711	harbor1	chr15	68063690	68064919	DNA/hAT-Charlie	6018	+	614	68064304	12593
chr15	68051711	68251711	harbor1	chr15	68065042	68065192	DNA/hAT-Charlie	6018	+	75	68065117	13406
chr15	68051711	68251711	harbor1	chr15	68070556	68070802	DNA/hAT-Charlie	1469	+	123	68070679	18968
chr15	68051711	68251711	harbor1	chr15	68070921	68071014	DNA/hAT-Charlie	1469	+	46	68070967	19256
chr15	68051711	68251711	harbor1	chr15	68087502	68087702	DNA/hAT-Charlie	623	+	100	68087602	35891
chr15	68051711	68251711	harbor1	chr15	68109887	68110146	DNA/hAT-Charlie	506	+	130	68110017	58306
chr15	61813587	62013587	harbor1	chr15	61828263	61828431	DNA/hAT-Charlie	472	+	84	61828347	14760
chr15	61813587	62013587	harbor1	chr15	61861291	61861505	DNA/hAT-Charlie	812	+	107	61861398	47811
chr15	61813587	62013587	harbor1	chr15	61869799	61869929	DNA/hAT-Charlie	861	+	65	61869864	56277
chr15	61813587	62013587	harbor1	chr15	61907991	61908157	DNA/hAT-Charlie	647	+	83	61908074	94487
chr15	90922971	91122971	harbor1	chr15	90938413	90938603	DNA/hAT-Charlie	682	+	95	90938508	15537
chr15	90922971	91122971	harbor1	chr15	91018588	91018787	DNA/hAT-Charlie	1147	+	100	91018688	95717
chr15	62403359	62603359	harbor1	chr15	62412086	62412243	DNA/hAT-Charlie	768	+	78	62412164	8805
chr15	62403359	62603359	harbor1	chr15	62414429	62414609	DNA/hAT-Charlie	818	+	90	62414519	11160
chr15	62403359	62603359	harbor1	chr15	62418534	62418546	DNA/hAT-Charlie	2156	+	6	62418540	15181
chr15	62403359	62603359	harbor1	chr15	62418979	62419351	DNA/hAT-Charlie	2156	+	186	62419165	15806
chr15	62403359	62603359	harbor1	chr15	62446930	62447104	DNA/hAT-Charlie	613	+	87	62447017	43658
chr15	26632141	26832141	harbor1	chr15	26667676	26667854	DNA/hAT-Charlie	933	+	89	26667765	35624
chr15	26632141	26832141	harbor1	chr15	26656488	26656828	DNA/hAT-Charlie	2140	+	170	26656658	24517
chr15	55071191	55271191	harbor1	chr15	55111447	55111575	DNA/hAT-Charlie	687	+	64	55111511	40320
chr15	55071191	55271191	harbor1	chr15	55111879	55111936	DNA/hAT-Charlie	751	+	28	55111907	40716
chr15	55071191	55271191	harbor1	chr15	55125866	55125976	DNA/hAT-Charlie	533	+	55	55125921	54730
chr15	55071191	55271191	harbor1	chr15	55126066	55126169	DNA/hAT-Charlie	533	+	52	55126118	54927
chr15	55071191	55271191	harbor1	chr15	55127036	55127249	DNA/hAT-Charlie	1363	+	106	55127142	55951
chr15	55071191	55271191	harbor1	chr15	55129942	55130085	DNA/hAT-Charlie	508	+	72	55130014	58823
chr15	55071191	55271191	harbor1	chr15	55152392	55152530	DNA/hAT-Charlie	889	+	69	55152461	81270
chr15	97143696	97343696	harbor1	chr15	97143681	97143840	DNA/hAT-Charlie	683	+	80	97143761	65
chr15	91811351	92011351	harbor1	chr15	91875751	91875956	DNA/hAT-Charlie	794	+	102	91875853	64502
chr15	91811351	92011351	harbor1	chr15	91893071	91893266	DNA/hAT-Charlie	875	+	98	91893169	81818
chr15	91811351	92011351	harbor1	chr15	91898663	91898891	DNA/hAT-Charlie	619	+	114	91898777	87426
chr15	91811351	92011351	harbor1	chr15	91909237	91909458	DNA/hAT-Charlie	1009	+	110	91909347	97996
chr15	28071869	28271869	harbor1	chr15	28136618	28136812	DNA/hAT-Charlie	836	+	97	28136715	64846
chr15	96234397	96434397	harbor1	chr15	96255710	96255877	DNA/hAT-Charlie	710	+	84	96255794	21397
chr15	84631386	84831386	harbor1	chr15	84656453	84656644	DNA/hAT-Charlie	939	+	96	84656549	25163
chr15	84631386	84831386	harbor1	chr15	84727288	84727458	DNA/hAT-Charlie	722	+	85	84727373	95987
chr15	61832560	62032560	harbor1	chr15	61861291	61861505	DNA/hAT-Charlie	812	+	107	61861398	28838
chr15	61832560	62032560	harbor1	chr15	61869799	61869929	DNA/hAT-Charlie	861	+	65	61869864	37304
chr15	61832560	62032560	harbor1	chr15	61907991	61908157	DNA/hAT-Charlie	647	+	83	61908074	75514
chr15	61832560	62032560	harbor1	chr15	61914186	61914287	DNA/hAT-Charlie	567	+	50	61914236	81676
chr15	61832560	62032560	harbor1	chr15	61914909	61914954	DNA/hAT-Charlie	567	+	22	61914931	82371
chr15	38985749	39185749	harbor1	chr15	38986806	38987007	DNA/hAT-Charlie	995	+	100	38986906	1157
chr15	38985749	39185749	harbor1	chr15	39028803	39029025	DNA/hAT-Charlie	1294	+	111	39028914	43165
chr15	38985749	39185749	harbor1	chr15	39029021	39029275	DNA/hAT-Charlie	1754	+	127	39029148	43399
chr15	38985749	39185749	harbor1	chr15	39065171	39065381	DNA/hAT-Charlie	976	+	105	39065276	79527
chr15	65374381	65574381	harbor1	chr15	65406123	65406394	DNA/hAT-Charlie	760	+	136	65406259	31878
chr15	65374381	65574381	harbor1	chr15	65408455	65408704	DNA/hAT-Charlie	647	+	124	65408579	34198
chr15	65374381	65574381	harbor1	chr15	65426868	65426936	DNA/hAT-Charlie	488	+	34	65426902	52521
chr15	65374381	65574381	harbor1	chr15	65427248	65427349	DNA/hAT-Charlie	488	+	50	65427298	52917
chr15	65374381	65574381	harbor1	chr15	65447228	65448102	DNA/hAT-Charlie	3900	+	437	65447665	73284
chr15	65374381	65574381	harbor1	chr15	65449325	65449415	DNA/hAT-Charlie	2165	+	45	65449370	74989
chr15	65374381	65574381	harbor1	chr15	65449710	65449974	DNA/hAT-Charlie	2165	+	132	65449842	75461
chr15	65374381	65574381	harbor1	chr15	65450267	65450408	DNA/hAT-Charlie	2165	+	70	65450337	75956
chr15	47728354	47928354	harbor1	chr15	47777156	47777273	DNA/hAT-Charlie	467	+	58	47777214	48860
chr15	47728354	47928354	harbor1	chr15	47783173	47783351	DNA/hAT-Charlie	561	+	89	47783262	54908
chr15	47728354	47928354	harbor1	chr15	47804091	47804232	DNA/hAT-Charlie	806	+	70	47804161	75807
chr15	47728354	47928354	harbor1	chr15	47804538	47804577	DNA/hAT-Charlie	806	+	20	47804558	76204
chr15	34596325	34796325	harbor1	chr15	34658798	34658913	DNA/hAT-Charlie	523	+	58	34658856	62531
chr15	34596325	34796325	harbor1	chr15	34678973	34679222	DNA/hAT-Charlie	508	+	124	34679097	82772
chr15	34596325	34796325	harbor1	chr15	34680642	34680834	DNA/hAT-Charlie	655	+	96	34680738	84413
chr15	39785612	39985612	harbor1	chr15	39853627	39853846	DNA/hAT-Charlie	1198	+	110	39853737	68125
chr15	39785612	39985612	harbor1	chr15	39881590	39883044	DNA/hAT-Charlie	3810	+	727	39882317	96705
chr15	39785612	39985612	harbor1	chr15	39883071	39883386	DNA/hAT-Charlie	504	+	158	39883229	97617
chr15	39785612	39985612	harbor1	chr15	39883530	39883662	DNA/hAT-Charlie	504	+	66	39883596	97984
chr15	46132878	46332878	harbor1	chr15	46216590	46217300	DNA/hAT-Charlie	1315	+	355	46216945	84067
chr15	80771436	80971436	harbor1	chr15	80793552	80793838	DNA/hAT-Charlie	546	+	143	80793695	22259
chr15	80771436	80971436	harbor1	chr15	80818691	80818857	DNA/hAT-Charlie	445	+	83	80818774	47338
chr15	80771436	80971436	harbor1	chr15	80865042	80865171	DNA/hAT-Charlie	918	+	64	80865106	93670
chr15	80771436	80971436	harbor1	chr15	80865480	80865567	DNA/hAT-Charlie	918	+	44	80865524	94088
chr15	80771436	80971436	harbor1	chr15	80865571	80865764	DNA/hAT-Charlie	1269	+	96	80865667	94231
chr15	80771436	80971436	harbor1	chr15	80867117	80867241	DNA/hAT-Charlie	613	+	62	80867179	95743
chr15	80771436	80971436	harbor1	chr15	80868451	80868551	DNA/hAT-Charlie	456	+	50	80868501	97065
chr15	71703398	71903398	harbor1	chr15	71709745	71709919	DNA/hAT-Charlie	798	+	87	71709832	6434
chr15	92875520	93075520	harbor1	chr15	92892344	92892506	DNA/hAT-Charlie	501	+	81	92892425	16905
chr15	92875520	93075520	harbor1	chr15	92913377	92913566	DNA/hAT-Charlie	632	+	94	92913471	37951
chr15	92875520	93075520	harbor1	chr15	92938141	92938508	DNA/hAT-Charlie	1586	+	184	92938325	62805
chr15	31808954	32008954	harbor1	chr15	31813540	31813748	DNA/hAT-Charlie	601	+	104	31813644	4690
chr15	44102278	44302278	harbor1	chr15	44108019	44108206	DNA/hAT-Charlie	527	+	94	44108113	5835
chr15	76073857	76273857	harbor1	chr15	76110325	76110519	DNA/hAT-Charlie	1331	+	97	76110422	36565
chr15	76073857	76273857	harbor1	chr15	76127837	76128014	DNA/hAT-Charlie	798	+	88	76127925	54068
chr15	20770586	20970586	harbor1	chr15	20791785	20791970	DNA/hAT-Charlie	1017	+	92	20791877	21291
chr15	20770586	20970586	harbor1	chr15	20844297	20844394	DNA/hAT-Charlie	541	+	48	20844345	73759
chr15	20770586	20970586	harbor1	chr15	20851548	20851761	DNA/hAT-Charlie	923	+	106	20851654	81068
chr15	20770586	20970586	harbor1	chr15	20853499	20854025	DNA/hAT-Charlie	3258	+	263	20853762	83176
chr15	72836684	73036684	harbor1	chr15	72917993	72918111	DNA/hAT-Charlie	676	+	59	72918052	81368
chr15	72836684	73036684	harbor1	chr15	72918119	72918462	DNA/hAT-Charlie	1817	+	172	72918291	81607
chr15	93792469	93992469	harbor1	chr15	93857903	93858057	DNA/hAT-Charlie	481	+	77	93857980	65511
chr15	93792469	93992469	harbor1	chr15	93868888	93869036	DNA/hAT-Charlie	497	+	74	93868962	76493
chr15	93792469	93992469	harbor1	chr15	93879902	93880079	DNA/hAT-Charlie	820	+	88	93879990	87521
chr15	66396819	66596819	harbor1	chr15	66456997	66457114	DNA/hAT-Charlie	1228	+	58	66457055	60236
chr15	66396819	66596819	harbor1	chr15	66457419	66457614	DNA/hAT-Charlie	1228	+	98	66457517	60698
chr15	66856183	67056183	harbor1	chr15	66919068	66919228	DNA/hAT-Charlie	646	+	80	66919148	62965
chr15	80728786	80928786	harbor1	chr15	80793552	80793838	DNA/hAT-Charlie	546	+	143	80793695	64909
chr15	80728786	80928786	harbor1	chr15	80818691	80818857	DNA/hAT-Charlie	445	+	83	80818774	89988
chr15	34880896	35080896	harbor1	chr15	34921002	34921155	DNA/hAT-Charlie	926	+	76	34921078	40182
chr15	34880896	35080896	harbor1	chr15	34921454	34921662	DNA/hAT-Charlie	926	+	104	34921558	40662
chr15	34880896	35080896	harbor1	chr15	34924094	34924435	DNA/hAT-Charlie	1792	+	170	34924264	43368
chr15	34880896	35080896	harbor1	chr15	34924731	34924881	DNA/hAT-Charlie	1792	+	75	34924806	43910
chr15	34880896	35080896	harbor1	chr15	34976899	34977054	DNA/hAT-Charlie	541	+	78	34976977	96081
chr15	44457077	44657077	harbor1	chr15	44485047	44485257	DNA/hAT-Charlie	1083	+	105	44485152	28075
chr15	30823857	31023857	harbor1	chr15	30892294	30892719	DNA/hAT-Charlie	1617	+	212	30892506	68649
chr15	30823857	31023857	harbor1	chr15	30902060	30902241	DNA/hAT-Charlie	934	+	90	30902150	78293
chr15	30823857	31023857	harbor1	chr15	30912685	30912885	DNA/hAT-Charlie	1049	+	100	30912785	88928
chr15	30823857	31023857	harbor1	chr15	30913046	30913379	DNA/hAT-Charlie	2270	+	166	30913212	89355
chr15	59365067	59565067	harbor1	chr15	59416755	59416970	DNA/hAT-Charlie	804	+	108	59416863	51796
chr15	59365067	59565067	harbor1	chr15	59441297	59441507	DNA/hAT-Charlie	992	+	105	59441402	76335
chr15	59365067	59565067	harbor1	chr15	59458928	59459006	DNA/hAT-Charlie	960	+	39	59458967	93900
chr15	59365067	59565067	harbor1	chr15	59459299	59459583	DNA/hAT-Charlie	960	+	142	59459441	94374
chr15	61156147	61356147	harbor1	chr15	61179180	61179647	DNA/hAT-Charlie	2079	+	234	61179414	23267
chr15	61156147	61356147	harbor1	chr15	61233859	61234161	DNA/hAT-Charlie	1190	+	151	61234010	77863
chr15	61156147	61356147	harbor1	chr15	61237459	61237547	DNA/hAT-Charlie	439	+	44	61237503	81356
chr15	61156147	61356147	harbor1	chr15	61238077	61238264	DNA/hAT-Charlie	1033	+	94	61238171	82024
chr15	61156147	61356147	harbor1	chr15	61251084	61252597	DNA/hAT-Charlie	3453	+	756	61251840	95693
chr15	96474421	96674421	harbor1	chr15	96490333	96490757	DNA/hAT-Charlie	1286	+	212	96490545	16124
chr15	32530656	32730656	harbor1	chr15	32551526	32552041	DNA/hAT-Charlie	3589	+	258	32551784	21128
chr15	32530656	32730656	harbor1	chr15	32574725	32575265	DNA/hAT-Charlie	3926	+	270	32574995	44339
chr15	32530656	32730656	harbor1	chr15	32575897	32576674	DNA/hAT-Charlie	3926	+	388	32576285	45629
chr15	32530656	32730656	harbor1	chr15	32591426	32591642	DNA/hAT-Charlie	892	+	108	32591534	60878
chr15	52608918	52808918	harbor1	chr15	52676305	52676463	DNA/hAT-Charlie	483	+	79	52676384	67466
chr15	52608918	52808918	harbor1	chr15	52684131	52684248	DNA/hAT-Charlie	559	+	58	52684189	75271
chr15	52608918	52808918	harbor1	chr15	52684878	52685114	DNA/hAT-Charlie	743	+	118	52684996	76078
chr15	52608918	52808918	harbor1	chr15	52696474	52696955	DNA/hAT-Charlie	1321	+	240	52696714	87796
chr15	70875822	71075822	harbor1	chr15	70913735	70914262	DNA/hAT-Charlie	1038	+	264	70913999	38177
chr15	70875822	71075822	harbor1	chr15	70938851	70939119	DNA/hAT-Charlie	520	+	134	70938985	63163
chr15	70875822	71075822	harbor1	chr15	70947610	70947775	DNA/hAT-Charlie	727	+	82	70947692	71870
chr15	70875822	71075822	harbor1	chr15	70965946	70966122	DNA/hAT-Charlie	964	+	88	70966034	90212
chr15	70875822	71075822	harbor1	chr15	70966245	70966778	DNA/hAT-Charlie	2391	+	266	70966511	90689
chr15	70875822	71075822	harbor1	chr15	70974619	70974829	DNA/hAT-Charlie	942	+	105	70974724	98902
chr15	46161745	46361745	harbor1	chr15	46216590	46217300	DNA/hAT-Charlie	1315	+	355	46216945	55200
chr15	47606592	47806592	harbor1	chr15	47619530	47619712	DNA/hAT-Charlie	764	+	91	47619621	13029
chr15	47606592	47806592	harbor1	chr15	47693549	47693652	DNA/hAT-Charlie	507	+	52	47693601	87009
chr15	47606592	47806592	harbor1	chr15	47693959	47694034	DNA/hAT-Charlie	507	+	38	47693997	87405
chr15	47606592	47806592	harbor1	chr15	47694053	47694240	DNA/hAT-Charlie	783	+	94	47694147	87555
chr15	79028865	79228865	harbor1	chr15	79041068	79041318	DNA/hAT-Charlie	713	+	125	79041193	12328
chr15	79028865	79228865	harbor1	chr15	79047246	79047353	DNA/hAT-Charlie	498	+	54	79047300	18435
chr15	79028865	79228865	harbor1	chr15	79094395	79094571	DNA/hAT-Charlie	1014	+	88	79094483	65618
chr15	90266358	90466358	harbor1	chr15	90339006	90339139	DNA/hAT-Charlie	623	+	66	90339072	72714
chr15	90266358	90466358	harbor1	chr15	90363452	90363524	DNA/hAT-Charlie	477	+	36	90363488	97130
chr15	95457477	95657477	harbor1	chr15	95468139	95468344	DNA/hAT-Charlie	669	+	102	95468241	10764
chr15	95457477	95657477	harbor1	chr15	95523336	95523531	DNA/hAT-Charlie	849	+	98	95523434	65957
chr15	95457477	95657477	harbor1	chr15	95538200	95538403	DNA/hAT-Charlie	650	+	102	95538302	80825
chr15	95457477	95657477	harbor1	chr15	95543486	95543649	DNA/hAT-Charlie	717	+	82	95543568	86091
chr15	95457477	95657477	harbor1	chr15	95543829	95543985	DNA/hAT-Charlie	646	+	78	95543907	86430
chr15	21277014	21477014	harbor1	chr15	21360872	21361057	DNA/hAT-Charlie	1017	+	92	21360964	83950
chr15	91482213	91682213	harbor1	chr15	91485842	91486042	DNA/hAT-Charlie	755	+	100	91485942	3729
chr15	91482213	91682213	harbor1	chr15	91538937	91539134	DNA/hAT-Charlie	999	+	98	91539035	56822
chr15	91482213	91682213	harbor1	chr15	91551976	91552055	DNA/hAT-Charlie	903	+	40	91552016	69803
chr15	91482213	91682213	harbor1	chr15	91552368	91552591	DNA/hAT-Charlie	903	+	112	91552480	70267
chr15	91482213	91682213	harbor1	chr15	91572822	91572991	DNA/hAT-Charlie	602	+	84	91572906	90693
chr15	61927989	62127989	harbor1	chr15	61992741	61992930	DNA/hAT-Charlie	565	+	94	61992835	64846
chr15	61927989	62127989	harbor1	chr15	62009500	62009680	DNA/hAT-Charlie	812	+	90	62009590	81601
chr15	82905903	83105903	harbor1	chr15	82936444	82936568	DNA/hAT-Charlie	625	+	62	82936506	30603
chr15	82905903	83105903	harbor1	chr15	82936853	82936881	DNA/hAT-Charlie	625	+	14	82936867	30964
chr15	82905903	83105903	harbor1	chr15	82964852	82965002	DNA/hAT-Charlie	517	+	75	82964927	59024
chr16	56881910	57081910	harbor1	chr16	56896116	56896462	DNA/hAT-Charlie	613	+	173	56896289	14379
chr16	56881910	57081910	harbor1	chr16	56896746	56896811	DNA/hAT-Charlie	613	+	32	56896778	14868
chr16	56881910	57081910	harbor1	chr16	56897105	56897179	DNA/hAT-Charlie	613	+	37	56897142	15232
chr16	56881910	57081910	harbor1	chr16	56898850	56899013	DNA/hAT-Charlie	905	+	82	56898932	17022
chr16	56881910	57081910	harbor1	chr16	56903401	56903615	DNA/hAT-Charlie	981	+	107	56903508	21598
chr16	56881910	57081910	harbor1	chr16	56941300	56941517	DNA/hAT-Charlie	1091	+	108	56941408	59498
chr16	56881910	57081910	harbor1	chr16	56952216	56952376	DNA/hAT-Charlie	481	+	80	56952296	70386
chr16	56881910	57081910	harbor1	chr16	56961379	56961760	DNA/hAT-Charlie	683	+	190	56961569	79659
chr16	58140733	58340733	harbor1	chr16	58171653	58171781	DNA/hAT-Charlie	961	+	64	58171717	30984
chr16	58140733	58340733	harbor1	chr16	58172123	58172179	DNA/hAT-Charlie	961	+	28	58172151	31418
chr16	58140733	58340733	harbor1	chr16	58206922	58207163	DNA/hAT-Charlie	748	+	120	58207042	66309
chr16	58140733	58340733	harbor1	chr16	58207985	58208196	DNA/hAT-Charlie	2054	+	106	58208091	67358
chr16	58140733	58340733	harbor1	chr16	58208490	58208617	DNA/hAT-Charlie	2054	+	64	58208554	67821
chr16	58140733	58340733	harbor1	chr16	58215312	58215519	DNA/hAT-Charlie	937	+	104	58215416	74683
chr16	13887673	14087673	harbor1	chr16	13898703	13898784	DNA/hAT-Charlie	436	+	40	13898743	11070
chr16	13887673	14087673	harbor1	chr16	13907216	13907397	DNA/hAT-Charlie	660	+	90	13907306	19633
chr16	13887673	14087673	harbor1	chr16	13946625	13946738	DNA/hAT-Charlie	677	+	56	13946681	59008
chr16	13887673	14087673	harbor1	chr16	13947062	13947120	DNA/hAT-Charlie	677	+	29	13947091	59418
chr16	49445737	49645737	harbor1	chr16	49470918	49471167	DNA/hAT-Charlie	580	+	124	49471042	25305
chr16	69313553	69513553	harbor1	chr16	69313560	69313808	DNA/hAT-Charlie	1195	+	124	69313684	131
chr16	69313553	69513553	harbor1	chr16	69367699	69368021	DNA/hAT-Charlie	444	+	161	69367860	54307
chr16	69313553	69513553	harbor1	chr16	69400553	69400750	DNA/hAT-Charlie	1094	+	98	69400651	87098
chr16	80712211	80912211	harbor1	chr16	80723614	80723824	DNA/hAT-Charlie	738	+	105	80723719	11508
chr16	80712211	80912211	harbor1	chr16	80761100	80761251	DNA/hAT-Charlie	630	+	76	80761176	48965
chr16	47307011	47507011	harbor1	chr16	47317536	47317689	DNA/hAT-Charlie	474	+	76	47317612	10601
chr16	47307011	47507011	harbor1	chr16	47371663	47371873	DNA/hAT-Charlie	987	+	105	47371768	64757
chr16	47307011	47507011	harbor1	chr16	47397511	47397712	DNA/hAT-Charlie	919	+	100	47397611	90600
chr16	47307011	47507011	harbor1	chr16	47403910	47404148	DNA/hAT-Charlie	1472	+	119	47404029	97018
chr16	77929189	78129189	harbor1	chr16	77940844	77941099	DNA/hAT-Charlie	1029	+	128	77940972	11783
chr16	77929189	78129189	harbor1	chr16	77944029	77944239	DNA/hAT-Charlie	1029	+	105	77944134	14945
chr16	77929189	78129189	harbor1	chr16	77955219	77955428	DNA/hAT-Charlie	1200	+	104	77955323	26134
chr16	77929189	78129189	harbor1	chr16	77965919	77966227	DNA/hAT-Charlie	1002	+	154	77966073	36884
chr16	51923230	52123230	harbor1	chr16	51954265	51954441	DNA/hAT-Charlie	677	+	88	51954353	31123
chr16	51923230	52123230	harbor1	chr16	52000683	52000758	DNA/hAT-Charlie	1615	+	38	52000721	77491
chr16	51923230	52123230	harbor1	chr16	52001022	52001274	DNA/hAT-Charlie	1615	+	126	52001148	77918
chr16	67362829	67562829	harbor1	chr16	67380809	67380941	DNA/hAT-Charlie	670	+	66	67380875	18046
chr16	67362829	67562829	harbor1	chr16	67382860	67382938	DNA/hAT-Charlie	530	+	39	67382899	20070
chr16	79602834	79802834	harbor1	chr16	79648476	79648803	DNA/hAT-Charlie	1201	+	164	79648640	45806
chr16	79602834	79802834	harbor1	chr16	79649216	79649404	DNA/hAT-Charlie	964	+	94	79649310	46476
chr16	79602834	79802834	harbor1	chr16	79649900	79650113	DNA/hAT-Charlie	1104	+	106	79650006	47172
chr16	49432289	49632289	harbor1	chr16	49470918	49471167	DNA/hAT-Charlie	580	+	124	49471042	38753
chr16	76193814	76393814	harbor1	chr16	76210721	76210924	DNA/hAT-Charlie	742	+	102	76210823	17009
chr16	76193814	76393814	harbor1	chr16	76224382	76224564	DNA/hAT-Charlie	1045	+	91	76224473	30659
chr16	76193814	76393814	harbor1	chr16	76224904	76225048	DNA/hAT-Charlie	1045	+	72	76224976	31162
chr16	76193814	76393814	harbor1	chr16	76241300	76241774	DNA/hAT-Charlie	1660	+	237	76241537	47723
chr16	76193814	76393814	harbor1	chr16	76261819	76261930	DNA/hAT-Charlie	540	+	56	76261875	68061
chr16	76193814	76393814	harbor1	chr16	76281708	76282038	DNA/hAT-Charlie	662	+	165	76281873	88059
chr16	76193814	76393814	harbor1	chr16	76234729	76234902	DNA/hAT-Charlie	800	+	86	76234815	41001
chr16	73584247	73784247	harbor1	chr16	73625435	73625630	DNA/hAT-Charlie	775	+	98	73625533	41286
chr16	73584247	73784247	harbor1	chr16	73656077	73656268	DNA/hAT-Charlie	910	+	96	73656173	71926
chr16	64645887	64845887	harbor1	chr16	64729106	64729308	DNA/hAT-Charlie	735	+	101	64729207	83320
chr16	64645887	64845887	harbor1	chr16	64729328	64729470	DNA/hAT-Charlie	570	+	71	64729399	83512
chr16	70087682	70287682	harbor1	chr16	70101993	70102196	DNA/hAT-Charlie	877	+	102	70102095	14413
chr16	70087682	70287682	harbor1	chr16	70124471	70124644	DNA/hAT-Charlie	890	+	86	70124557	36875
chr16	34664025	34864025	harbor1	chr16	34683682	34683870	DNA/hAT-Charlie	514	+	94	34683776	19751
chr16	88707085	88907085	harbor1	chr16	88797555	88797674	DNA/hAT-Charlie	652	+	60	88797615	90530
chr16	88707085	88907085	harbor1	chr16	88797970	88798052	DNA/hAT-Charlie	652	+	41	88798011	90926
chr16	19370081	19570081	harbor1	chr16	19378649	19378844	DNA/hAT-Charlie	973	+	98	19378747	8666
chr16	19370081	19570081	harbor1	chr16	19415339	19415578	DNA/hAT-Charlie	1023	+	120	19415459	45378
chr16	19370081	19570081	harbor1	chr16	19430591	19430808	DNA/hAT-Charlie	559	+	108	19430699	60618
chr16	19370081	19570081	harbor1	chr16	19446215	19446438	DNA/hAT-Charlie	615	+	112	19446327	76246
chr16	61723498	61923498	harbor1	chr16	61762519	61762698	DNA/hAT-Charlie	586	+	90	61762609	39111
chr16	61723498	61923498	harbor1	chr16	61762805	61762927	DNA/hAT-Charlie	627	+	61	61762866	39368
chr16	61723498	61923498	harbor1	chr16	61772732	61772871	DNA/hAT-Charlie	660	+	70	61772802	49304
chr16	61723498	61923498	harbor1	chr16	61798392	61798589	DNA/hAT-Charlie	726	+	98	61798490	74992
chr16	24359459	24559459	harbor1	chr16	24391482	24391633	DNA/hAT-Charlie	805	+	76	24391558	32099
chr16	24049670	24249670	harbor1	chr16	24089177	24089362	DNA/hAT-Charlie	569	+	92	24089269	39599
chr16	24049670	24249670	harbor1	chr16	24095002	24095123	DNA/hAT-Charlie	500	+	60	24095062	45392
chr16	24049670	24249670	harbor1	chr16	24107878	24108165	DNA/hAT-Charlie	686	+	144	24108022	58352
chr16	33878584	34078584	harbor1	chr16	33911773	33911963	DNA/hAT-Charlie	937	+	95	33911868	33284
chr16	33878584	34078584	harbor1	chr16	33920674	33920850	DNA/hAT-Charlie	928	+	88	33920762	42178
chr16	33878584	34078584	harbor1	chr16	33922731	33922918	DNA/hAT-Charlie	545	+	94	33922825	44241
chr16	33878584	34078584	harbor1	chr16	33929137	33929257	DNA/hAT-Charlie	560	+	60	33929197	50613
chr16	7793838	7993838	harbor1	chr16	7804341	7804522	DNA/hAT-Charlie	537	+	90	7804431	10593
chr16	7793838	7993838	harbor1	chr16	7806724	7807249	DNA/hAT-Charlie	3965	+	262	7806986	13148
chr16	7793838	7993838	harbor1	chr16	7861851	7862144	DNA/hAT-Charlie	608	+	146	7861997	68159
chr16	7793838	7993838	harbor1	chr16	7884220	7884263	DNA/hAT-Charlie	842	+	22	7884242	90404
chr16	7793838	7993838	harbor1	chr16	7890234	7890446	DNA/hAT-Charlie	659	+	106	7890340	96502
chr16	7793838	7993838	harbor1	chr16	7893273	7893429	DNA/hAT-Charlie	623	+	78	7893351	99513
chr16	8221279	8421279	harbor1	chr16	8253855	8254064	DNA/hAT-Charlie	982	+	104	8253959	32680
chr16	8221279	8421279	harbor1	chr16	8284176	8284381	DNA/hAT-Charlie	724	+	102	8284278	62999
chr16	8221279	8421279	harbor1	chr16	8292045	8292325	DNA/hAT-Charlie	1110	+	140	8292185	70906
chr16	55614412	55814412	harbor1	chr16	55671455	55671819	DNA/hAT-Charlie	1949	+	182	55671637	57225
chr16	55614412	55814412	harbor1	chr16	55675575	55675768	DNA/hAT-Charlie	1007	+	96	55675671	61259
chr16	55614412	55814412	harbor1	chr16	55690665	55690843	DNA/hAT-Charlie	607	+	89	55690754	76342
chr16	7293371	7493371	harbor1	chr16	7296096	7296446	DNA/hAT-Charlie	850	+	175	7296271	2900
chr16	7293371	7493371	harbor1	chr16	7323970	7324014	DNA/hAT-Charlie	596	+	22	7323992	30621
chr16	7293371	7493371	harbor1	chr16	7324044	7324171	DNA/hAT-Charlie	596	+	64	7324108	30737
chr16	7293371	7493371	harbor1	chr16	7328862	7329193	DNA/hAT-Charlie	1213	+	166	7329028	35657
chr16	7293371	7493371	harbor1	chr16	7347087	7347203	DNA/hAT-Charlie	484	+	58	7347145	53774
chr16	7293371	7493371	harbor1	chr16	7347563	7347626	DNA/hAT-Charlie	484	+	32	7347595	54224
chr16	7293371	7493371	harbor1	chr16	7365461	7365617	DNA/hAT-Charlie	693	+	78	7365539	72168
chr16	7293371	7493371	harbor1	chr16	7372502	7372662	DNA/hAT-Charlie	548	+	80	7372582	79211
chr16	58889190	59089190	harbor1	chr16	58934993	58935164	DNA/hAT-Charlie	677	+	86	58935079	45889
chr16	58889190	59089190	harbor1	chr16	58941964	58942487	DNA/hAT-Charlie	3300	+	262	58942226	53036
chr16	58889190	59089190	harbor1	chr16	58962845	58963037	DNA/hAT-Charlie	515	+	96	58962941	73751
chr16	26607425	26807425	harbor1	chr16	26615056	26615206	DNA/hAT-Charlie	443	+	75	26615131	7706
chr16	26607425	26807425	harbor1	chr16	26641010	26641270	DNA/hAT-Charlie	577	+	130	26641140	33715
chr16	26607425	26807425	harbor1	chr16	26676676	26676739	DNA/hAT-Charlie	437	+	32	26676708	69283
chr16	26607425	26807425	harbor1	chr16	26677053	26677190	DNA/hAT-Charlie	437	+	68	26677121	69696
chr16	75951932	76151932	harbor1	chr16	76023968	76024155	DNA/hAT-Charlie	978	+	94	76024062	72130
chr16	24815739	25015739	harbor1	chr16	24844184	24844341	DNA/hAT-Charlie	486	+	78	24844262	28523
chr16	24815739	25015739	harbor1	chr16	24856075	24856324	DNA/hAT-Charlie	799	+	124	24856199	40460
chr16	24815739	25015739	harbor1	chr16	24903071	24903180	DNA/hAT-Charlie	555	+	54	24903125	87386
chr16	62074492	62274492	harbor1	chr16	62094259	62094459	DNA/hAT-Charlie	995	+	100	62094359	19867
chr16	62074492	62274492	harbor1	chr16	62141298	62141458	DNA/hAT-Charlie	665	+	80	62141378	66886
chr16	34390514	34590514	harbor1	chr16	34396524	34396704	DNA/hAT-Charlie	714	+	90	34396614	6100
chr16	34390514	34590514	harbor1	chr16	34407626	34407852	DNA/hAT-Charlie	446	+	113	34407739	17225
chr16	84903021	85103021	harbor1	chr16	84925607	84925784	DNA/hAT-Charlie	842	+	88	84925695	22674
chr16	957634	1157634	harbor1	chr16	1026321	1026495	DNA/hAT-Charlie	588	+	87	1026408	68774
chr16	51684505	51884505	harbor1	chr16	51687887	51688092	DNA/hAT-Charlie	472	+	102	51687989	3484
chr16	51684505	51884505	harbor1	chr16	51710524	51710650	DNA/hAT-Charlie	502	+	63	51710587	26082
chr16	51684505	51884505	harbor1	chr16	51737577	51737727	DNA/hAT-Charlie	585	+	75	51737652	53147
chr16	51684505	51884505	harbor1	chr16	51745780	51745942	DNA/hAT-Charlie	569	+	81	51745861	61356
chr16	58305647	58505647	harbor1	chr16	58320861	58321483	DNA/hAT-Charlie	3631	+	311	58321172	15525
chr16	58305647	58505647	harbor1	chr16	58321795	58321904	DNA/hAT-Charlie	3631	+	54	58321849	16202
chr16	58305647	58505647	harbor1	chr16	58322209	58322313	DNA/hAT-Charlie	3631	+	52	58322261	16614
chr16	58305647	58505647	harbor1	chr16	58322669	58322909	DNA/hAT-Charlie	897	+	120	58322789	17142
chr16	58305647	58505647	harbor1	chr16	58323379	58323462	DNA/hAT-Charlie	512	+	42	58323421	17774
chr16	58305647	58505647	harbor1	chr16	58329750	58329845	DNA/hAT-Charlie	626	+	48	58329798	24151
chr16	58305647	58505647	harbor1	chr16	58330557	58330642	DNA/hAT-Charlie	626	+	42	58330599	24952
chr16	4602401	4802401	harbor1	chr16	4627127	4627400	DNA/hAT-Charlie	510	+	136	4627263	24862
chr16	4602401	4802401	harbor1	chr16	4631417	4631591	DNA/hAT-Charlie	871	+	87	4631504	29103
chr16	74245451	74445451	harbor1	chr16	74295270	74295402	DNA/hAT-Charlie	868	+	66	74295336	49885
chr16	3958529	4158529	harbor1	chr16	3979636	3980095	DNA/hAT-Charlie	645	+	230	3979866	21337
chr16	3958529	4158529	harbor1	chr16	4006094	4006318	DNA/hAT-Charlie	996	+	112	4006206	47677
chr16	3958529	4158529	harbor1	chr16	4020113	4020279	DNA/hAT-Charlie	641	+	83	4020196	61667
chr16	75969728	76169728	harbor1	chr16	76023968	76024155	DNA/hAT-Charlie	978	+	94	76024062	54334
chr16	75969728	76169728	harbor1	chr16	76068408	76068619	DNA/hAT-Charlie	1010	+	106	76068514	98786
chr16	85019393	85219393	harbor1	chr16	85040222	85040375	DNA/hAT-Charlie	708	+	76	85040298	20905
chr16	85019393	85219393	harbor1	chr16	85062610	85062787	DNA/hAT-Charlie	585	+	88	85062698	43305
chr16	85019393	85219393	harbor1	chr16	85069679	85069836	DNA/hAT-Charlie	676	+	78	85069757	50364
chr16	81488942	81688942	harbor1	chr16	81511879	81512189	DNA/hAT-Charlie	1753	+	155	81512034	23092
chr16	81488942	81688942	harbor1	chr16	81522076	81522211	DNA/hAT-Charlie	538	+	68	81522144	33202
chr16	81488942	81688942	harbor1	chr16	81526221	81526728	DNA/hAT-Charlie	2376	+	254	81526475	37533
chr16	81488942	81688942	harbor1	chr16	81563436	81563596	DNA/hAT-Charlie	790	+	80	81563516	74574
chr16	86896888	87096888	harbor1	chr16	86945693	86946098	DNA/hAT-Charlie	963	+	202	86945895	49007
chr16	86896888	87096888	harbor1	chr16	86974556	86974832	DNA/hAT-Charlie	1093	+	138	86974694	77806
chr16	86896888	87096888	harbor1	chr16	86991987	86992174	DNA/hAT-Charlie	576	+	94	86992081	95193
chr16	86942864	87142864	harbor1	chr16	86945693	86946098	DNA/hAT-Charlie	963	+	202	86945895	3031
chr16	86942864	87142864	harbor1	chr16	86974556	86974832	DNA/hAT-Charlie	1093	+	138	86974694	31830
chr16	86942864	87142864	harbor1	chr16	86991987	86992174	DNA/hAT-Charlie	576	+	94	86992081	49217
chr16	86942864	87142864	harbor1	chr16	87021533	87021588	DNA/hAT-Charlie	435	+	28	87021561	78697
chr16	86942864	87142864	harbor1	chr16	87021865	87021968	DNA/hAT-Charlie	435	+	52	87021917	79053
chr16	86942864	87142864	harbor1	chr16	87035198	87035398	DNA/hAT-Charlie	819	+	100	87035298	92434
chr16	9452859	9652859	harbor1	chr16	9457251	9457473	DNA/hAT-Charlie	797	+	111	9457362	4503
chr16	9452859	9652859	harbor1	chr16	9458237	9458307	DNA/hAT-Charlie	554	+	35	9458272	5413
chr16	9452859	9652859	harbor1	chr16	9458649	9458796	DNA/hAT-Charlie	554	+	74	9458723	5864
chr16	9452859	9652859	harbor1	chr16	9478188	9478362	DNA/hAT-Charlie	544	+	87	9478275	25416
chr16	9452859	9652859	harbor1	chr16	9499528	9499758	DNA/hAT-Charlie	958	+	115	9499643	46784
chr16	9452859	9652859	harbor1	chr16	9486312	9486524	DNA/hAT-Charlie	1063	+	106	9486418	33559
chr16	9452859	9652859	harbor1	chr16	9519054	9519379	DNA/hAT-Charlie	851	+	162	9519216	66357
chr16	80429872	80629872	harbor1	chr16	80501730	80501947	DNA/hAT-Charlie	1093	+	108	80501838	71966
chr16	80429872	80629872	harbor1	chr16	80517198	80517455	DNA/hAT-Charlie	832	+	128	80517326	87454
chr16	80429872	80629872	harbor1	chr16	80517848	80518108	DNA/hAT-Charlie	808	+	130	80517978	88106
chr16	80429872	80629872	harbor1	chr16	80518877	80519035	DNA/hAT-Charlie	560	+	79	80518956	89084
chr16	80429872	80629872	harbor1	chr16	80524463	80524853	DNA/hAT-Charlie	626	+	195	80524658	94786
chr16	29589503	29789503	harbor1	chr16	29651850	29652044	DNA/hAT-Charlie	730	+	97	29651947	62444
chr16	55984509	56184509	harbor1	chr16	56004921	56005061	DNA/hAT-Charlie	842	+	70	56004991	20482
chr16	55984509	56184509	harbor1	chr16	56018038	56018328	DNA/hAT-Charlie	683	+	145	56018183	33674
chr16	55984509	56184509	harbor1	chr16	56039467	56039606	DNA/hAT-Charlie	516	+	70	56039537	55028
chr16	55984509	56184509	harbor1	chr16	56039798	56039916	DNA/hAT-Charlie	516	+	59	56039857	55348
chr16	55984509	56184509	harbor1	chr16	56044230	56044590	DNA/hAT-Charlie	682	+	180	56044410	59901
chr16	55984509	56184509	harbor1	chr16	56050113	56050569	DNA/hAT-Charlie	2948	+	228	56050341	65832
chr16	55984509	56184509	harbor1	chr16	56062998	56063058	DNA/hAT-Charlie	1327	+	30	56063028	78519
chr16	55984509	56184509	harbor1	chr16	56063059	56063404	DNA/hAT-Charlie	2105	+	172	56063231	78722
chr16	55984509	56184509	harbor1	chr16	56063405	56063634	DNA/hAT-Charlie	1327	+	114	56063519	79010
chr16	55984509	56184509	harbor1	chr16	56074983	56075216	DNA/hAT-Charlie	1082	+	116	56075099	90590
chr16	19224920	19424920	harbor1	chr16	19245190	19245401	DNA/hAT-Charlie	1173	+	106	19245296	20376
chr16	19224920	19424920	harbor1	chr16	19253084	19253271	DNA/hAT-Charlie	977	+	94	19253178	28258
chr16	19224920	19424920	harbor1	chr16	19258284	19258358	DNA/hAT-Charlie	790	+	37	19258321	33401
chr16	19224920	19424920	harbor1	chr16	19258671	19258812	DNA/hAT-Charlie	790	+	70	19258741	33821
chr16	19224920	19424920	harbor1	chr16	19266246	19266458	DNA/hAT-Charlie	913	+	106	19266352	41432
chr16	19224920	19424920	harbor1	chr16	19282258	19282427	DNA/hAT-Charlie	884	+	84	19282342	57422
chr16	19224920	19424920	harbor1	chr16	19282721	19282753	DNA/hAT-Charlie	884	+	16	19282737	57817
chr16	19224920	19424920	harbor1	chr16	19284065	19284265	DNA/hAT-Charlie	485	+	100	19284165	59245
chr16	19224920	19424920	harbor1	chr16	19319171	19319262	DNA/hAT-Charlie	1205	+	46	19319217	94297
chr16	19224920	19424920	harbor1	chr16	19319586	19319783	DNA/hAT-Charlie	1205	+	98	19319684	94764
chr16	82759528	82959528	harbor1	chr16	82794050	82794292	DNA/hAT-Charlie	1341	+	121	82794171	34643
chr16	82759528	82959528	harbor1	chr16	82831049	82831209	DNA/hAT-Charlie	792	+	80	82831129	71601
chr16	82759528	82959528	harbor1	chr16	82831213	82831494	DNA/hAT-Charlie	502	+	140	82831353	71825
chr16	82759528	82959528	harbor1	chr16	82834772	82834980	DNA/hAT-Charlie	564	+	104	82834876	75348
chr16	66163207	66363207	harbor1	chr16	66178717	66179477	DNA/hAT-Charlie	1709	+	380	66179097	15890
chr16	66163207	66363207	harbor1	chr16	66184318	66184518	DNA/hAT-Charlie	1090	+	100	66184418	21211
chr16	66163207	66363207	harbor1	chr16	66225600	66225731	DNA/hAT-Charlie	460	+	66	66225666	62459
chr16	66163207	66363207	harbor1	chr16	66250085	66250215	DNA/hAT-Charlie	1456	+	65	66250150	86943
chr16	66163207	66363207	harbor1	chr16	66250520	66250689	DNA/hAT-Charlie	1456	+	84	66250604	87397
chr16	9322201	9522201	harbor1	chr16	9324647	9324781	DNA/hAT-Charlie	670	+	67	9324714	2513
chr16	9322201	9522201	harbor1	chr16	9327168	9327331	DNA/hAT-Charlie	560	+	82	9327250	5049
chr16	9322201	9522201	harbor1	chr16	9367558	9367690	DNA/hAT-Charlie	457	+	66	9367624	45423
chr16	9322201	9522201	harbor1	chr16	9374576	9374769	DNA/hAT-Charlie	720	+	96	9374672	52471
chr16	9322201	9522201	harbor1	chr16	9403510	9403657	DNA/hAT-Charlie	721	+	74	9403584	81383
chr16	9322201	9522201	harbor1	chr16	9413767	9413920	DNA/hAT-Charlie	685	+	76	9413843	91642
chr16	9322201	9522201	harbor1	chr16	9414751	9414904	DNA/hAT-Charlie	814	+	76	9414827	92626
chr16	9322201	9522201	harbor1	chr16	9421205	9421537	DNA/hAT-Charlie	787	+	166	9421371	99170
chr16	28109361	28309361	harbor1	chr16	28134287	28134445	DNA/hAT-Charlie	503	+	79	28134366	25005
chr16	28109361	28309361	harbor1	chr16	28158244	28158671	DNA/hAT-Charlie	1889	+	214	28158458	49097
chr16	28109361	28309361	harbor1	chr16	28158682	28158848	DNA/hAT-Charlie	700	+	83	28158765	49404
chr16	28109361	28309361	harbor1	chr16	28182590	28182912	DNA/hAT-Charlie	917	+	161	28182751	73390
chr16	67032093	67232093	harbor1	chr16	67051244	67051389	DNA/hAT-Charlie	469	+	72	67051316	19223
chr16	67032093	67232093	harbor1	chr16	67052195	67052287	DNA/hAT-Charlie	478	+	46	67052241	20148
chr16	67032093	67232093	harbor1	chr16	67052591	67052668	DNA/hAT-Charlie	478	+	38	67052629	20536
chr16	56986575	57186575	harbor1	chr16	56995858	56996164	DNA/hAT-Charlie	980	+	153	56996011	9436
chr16	56986575	57186575	harbor1	chr16	56996482	56996528	DNA/hAT-Charlie	980	+	23	56996505	9930
chr16	56986575	57186575	harbor1	chr16	57012424	57012761	DNA/hAT-Charlie	1843	+	168	57012592	26017
chr16	56986575	57186575	harbor1	chr16	57054102	57054316	DNA/hAT-Charlie	1039	+	107	57054209	67634
chr16	56986575	57186575	harbor1	chr16	57067941	57068065	DNA/hAT-Charlie	441	+	62	57068003	81428
chr16	56986575	57186575	harbor1	chr16	57080235	57080481	DNA/hAT-Charlie	925	+	123	57080358	93783
chr16	56986575	57186575	harbor1	chr16	57080767	57080862	DNA/hAT-Charlie	925	+	48	57080815	94240
chr16	56986575	57186575	harbor1	chr16	57086420	57086497	DNA/hAT-Charlie	471	+	38	57086458	99883
chr16	80420143	80620143	harbor1	chr16	80501730	80501947	DNA/hAT-Charlie	1093	+	108	80501838	81695
chr16	80420143	80620143	harbor1	chr16	80517198	80517455	DNA/hAT-Charlie	832	+	128	80517326	97183
chr16	80420143	80620143	harbor1	chr16	80517848	80518108	DNA/hAT-Charlie	808	+	130	80517978	97835
chr16	80420143	80620143	harbor1	chr16	80518877	80519035	DNA/hAT-Charlie	560	+	79	80518956	98813
chr16	15917384	16117384	harbor1	chr16	15939704	15939859	DNA/hAT-Charlie	716	+	78	15939782	22398
chr16	15917384	16117384	harbor1	chr16	15973280	15973494	DNA/hAT-Charlie	1066	+	107	15973387	56003
chr16	15917384	16117384	harbor1	chr16	15978745	15978944	DNA/hAT-Charlie	799	+	100	15978845	61461
chr16	15917384	16117384	harbor1	chr16	15986328	15986665	DNA/hAT-Charlie	2156	+	168	15986496	69112
chr16	15917384	16117384	harbor1	chr16	15991886	15992403	DNA/hAT-Charlie	3308	+	258	15992144	74760
chr16	15917384	16117384	harbor1	chr16	15993454	15993662	DNA/hAT-Charlie	975	+	104	15993558	76174
chr16	15917384	16117384	harbor1	chr16	16009996	16010037	DNA/hAT-Charlie	445	+	20	16010016	92632
chr16	15917384	16117384	harbor1	chr16	16010342	16010411	DNA/hAT-Charlie	445	+	34	16010376	92992
chr16	15917384	16117384	harbor1	chr16	16013990	16014161	DNA/hAT-Charlie	718	+	86	16014076	96692
chr16	15917384	16117384	harbor1	chr16	15941532	15941644	DNA/hAT-Charlie	765	+	56	15941588	24204
chr16	15917384	16117384	harbor1	chr16	15957894	15958065	DNA/hAT-Charlie	636	+	86	15957980	40596
chr16	16986656	17186656	harbor1	chr16	16996937	16997071	DNA/hAT-Charlie	646	+	67	16997004	10348
chr16	16986656	17186656	harbor1	chr16	16997404	16997506	DNA/hAT-Charlie	646	+	51	16997455	10799
chr16	16986656	17186656	harbor1	chr16	17010640	17010912	DNA/hAT-Charlie	1132	+	136	17010776	24120
chr16	16986656	17186656	harbor1	chr16	17036805	17037024	DNA/hAT-Charlie	1162	+	110	17036915	50259
chr16	16986656	17186656	harbor1	chr16	17057680	17057777	DNA/hAT-Charlie	443	+	48	17057728	71072
chr16	16986656	17186656	harbor1	chr16	17061477	17061689	DNA/hAT-Charlie	1080	+	106	17061583	74927
chr16	16986656	17186656	harbor1	chr16	17073685	17073883	DNA/hAT-Charlie	743	+	99	17073784	87128
chr16	16986656	17186656	harbor1	chr16	17074421	17074632	DNA/hAT-Charlie	648	+	106	17074527	87871
chr16	24345382	24545382	harbor1	chr16	24391482	24391633	DNA/hAT-Charlie	805	+	76	24391558	46176
chr16	25959518	26159518	harbor1	chr16	25966951	25967120	DNA/hAT-Charlie	876	+	84	25967035	7517
chr16	25959518	26159518	harbor1	chr16	25968253	25968477	DNA/hAT-Charlie	464	+	112	25968365	8847
chr16	25959518	26159518	harbor1	chr16	25979271	25979792	DNA/hAT-Charlie	3505	+	260	25979531	20013
chr16	25959518	26159518	harbor1	chr16	26007062	26007319	DNA/hAT-Charlie	561	+	128	26007190	47672
chr16	25959518	26159518	harbor1	chr16	26015863	26016083	DNA/hAT-Charlie	901	+	110	26015973	56455
chr16	25959518	26159518	harbor1	chr16	26016331	26016712	DNA/hAT-Charlie	847	+	190	26016521	57003
chr16	25959518	26159518	harbor1	chr16	26020656	26020815	DNA/hAT-Charlie	894	+	80	26020736	61218
chr16	25959518	26159518	harbor1	chr16	26021169	26021483	DNA/hAT-Charlie	690	+	157	26021326	61808
chr16	25959518	26159518	harbor1	chr16	26048471	26048534	DNA/hAT-Charlie	925	+	32	26048503	88985
chr16	25959518	26159518	harbor1	chr16	26048846	26049274	DNA/hAT-Charlie	925	+	214	26049060	89542
chr16	81663464	81863464	harbor1	chr16	81705927	81706076	DNA/hAT-Charlie	448	+	74	81706001	42537
chr16	81663464	81863464	harbor1	chr16	81723554	81723662	DNA/hAT-Charlie	480	+	54	81723608	60144
chr16	81663464	81863464	harbor1	chr16	81724135	81724149	DNA/hAT-Charlie	480	+	7	81724142	60678
chr16	81663464	81863464	harbor1	chr16	81724467	81724529	DNA/hAT-Charlie	480	+	31	81724498	61034
chr16	81663464	81863464	harbor1	chr16	81724674	81724816	DNA/hAT-Charlie	634	+	71	81724745	61281
chr16	66181324	66381324	harbor1	chr16	66184318	66184518	DNA/hAT-Charlie	1090	+	100	66184418	3094
chr16	66181324	66381324	harbor1	chr16	66225600	66225731	DNA/hAT-Charlie	460	+	66	66225666	44342
chr16	66181324	66381324	harbor1	chr16	66250085	66250215	DNA/hAT-Charlie	1456	+	65	66250150	68826
chr16	66181324	66381324	harbor1	chr16	66250520	66250689	DNA/hAT-Charlie	1456	+	84	66250604	69280
chr16	14579114	14779114	harbor1	chr16	14591439	14591643	DNA/hAT-Charlie	953	+	102	14591541	12427
chr16	48686600	48886600	harbor1	chr16	48686946	48687447	DNA/hAT-Charlie	1837	+	250	48687196	596
chr16	48686600	48886600	harbor1	chr16	48695578	48695816	DNA/hAT-Charlie	740	+	119	48695697	9097
chr16	48686600	48886600	harbor1	chr16	48697215	48697304	DNA/hAT-Charlie	620	+	44	48697259	10659
chr16	48686600	48886600	harbor1	chr16	48697700	48697839	DNA/hAT-Charlie	556	+	70	48697770	11170
chr16	89972999	90172999	harbor1	chr16	90051115	90051572	DNA/hAT-Charlie	2836	+	228	90051343	78344
chr16	77738416	77938416	harbor1	chr16	77749756	77749855	DNA/hAT-Charlie	552	+	50	77749806	11390
chr16	77738416	77938416	harbor1	chr16	77749853	77750006	DNA/hAT-Charlie	824	+	76	77749929	11513
chr16	77738416	77938416	harbor1	chr16	77759886	77760048	DNA/hAT-Charlie	697	+	81	77759967	21551
chr16	77738416	77938416	harbor1	chr16	77773953	77774334	DNA/hAT-Charlie	722	+	190	77774143	35727
chr16	77738416	77938416	harbor1	chr16	77777698	77777891	DNA/hAT-Charlie	723	+	96	77777794	39378
chr16	77738416	77938416	harbor1	chr16	77778201	77778287	DNA/hAT-Charlie	723	+	43	77778244	39828
chr16	77738416	77938416	harbor1	chr16	77808030	77808546	DNA/hAT-Charlie	3682	+	258	77808288	69872
chr16	77738416	77938416	harbor1	chr16	77810231	77810415	DNA/hAT-Charlie	985	+	92	77810323	71907
chr16	77738416	77938416	harbor1	chr16	77826236	77826554	DNA/hAT-Charlie	808	+	159	77826395	87979
chr16	30148552	30348552	harbor1	chr16	30163444	30163624	DNA/hAT-Charlie	799	+	90	30163534	14982
chr16	62422319	62622319	harbor1	chr16	62434326	62434485	DNA/hAT-Charlie	534	+	80	62434406	12087
chr16	60363063	60563063	harbor1	chr16	60409596	60409788	DNA/hAT-Charlie	652	+	96	60409692	46629
chr16	60363063	60563063	harbor1	chr16	60412896	60413051	DNA/hAT-Charlie	535	+	78	60412974	49911
chr16	60363063	60563063	harbor1	chr16	60424128	60424338	DNA/hAT-Charlie	936	+	105	60424233	61170
chr16	5333005	5533005	harbor1	chr16	5333243	5333468	DNA/hAT-Charlie	975	+	112	5333355	350
chr16	5333005	5533005	harbor1	chr16	5374819	5374969	DNA/hAT-Charlie	709	+	75	5374894	41889
chr16	5333005	5533005	harbor1	chr16	5375125	5375281	DNA/hAT-Charlie	564	+	78	5375203	42198
chr16	5333005	5533005	harbor1	chr16	5415565	5415815	DNA/hAT-Charlie	991	+	125	5415690	82685
chr16	61956355	62156355	harbor1	chr16	61994618	61994802	DNA/hAT-Charlie	737	+	92	61994710	38355
chr16	61956355	62156355	harbor1	chr16	62040085	62040250	DNA/hAT-Charlie	520	+	82	62040167	83812
chr16	61956355	62156355	harbor1	chr16	62048826	62049202	DNA/hAT-Charlie	838	+	188	62049014	92659
chr16	46942874	47142874	harbor1	chr16	46960224	46960397	DNA/hAT-Charlie	633	+	86	46960310	17436
chr16	46942874	47142874	harbor1	chr16	46966591	46966725	DNA/hAT-Charlie	508	+	67	46966658	23784
chr16	46942874	47142874	harbor1	chr16	47013316	47013538	DNA/hAT-Charlie	1351	+	111	47013427	70553
chr16	55509407	55709407	harbor1	chr16	55568500	55568669	DNA/hAT-Charlie	614	+	84	55568584	59177
chr16	55509407	55709407	harbor1	chr16	55580679	55581023	DNA/hAT-Charlie	2295	+	172	55580851	71444
chr16	55509407	55709407	harbor1	chr16	55606588	55606737	DNA/hAT-Charlie	549	+	74	55606662	97255
chr16	55509407	55709407	harbor1	chr16	55606750	55607153	DNA/hAT-Charlie	1481	+	202	55606952	97545
chr16	51546322	51746322	harbor1	chr16	51548284	51548552	DNA/hAT-Charlie	616	+	134	51548418	2096
chr16	51546322	51746322	harbor1	chr16	51584253	51584561	DNA/hAT-Charlie	2089	+	154	51584407	38085
chr16	51546322	51746322	harbor1	chr16	51584869	51585561	DNA/hAT-Charlie	2089	+	346	51585215	38893
chr16	51546322	51746322	harbor1	chr16	51587290	51587474	DNA/hAT-Charlie	605	+	92	51587382	41060
chr16	51546322	51746322	harbor1	chr16	51631226	51631557	DNA/hAT-Charlie	1429	+	166	51631392	85070
chr16	51546322	51746322	harbor1	chr16	51633441	51633637	DNA/hAT-Charlie	2303	+	98	51633539	87217
chr16	51546322	51746322	harbor1	chr16	51633944	51634310	DNA/hAT-Charlie	2303	+	183	51634127	87805
chr16	31762241	31962241	harbor1	chr16	31855502	31855829	DNA/hAT-Charlie	1773	+	164	31855666	93425
chr16	85258191	85458191	harbor1	chr16	85285326	85285400	DNA/hAT-Charlie	445	+	37	85285363	27172
chr16	85258191	85458191	harbor1	chr16	85285713	85285815	DNA/hAT-Charlie	445	+	51	85285764	27573
chr16	85258191	85458191	harbor1	chr16	85345125	85345436	DNA/hAT-Charlie	1567	+	156	85345281	87090
chr16	23715962	23915962	harbor1	chr16	23731021	23731139	DNA/hAT-Charlie	552	+	59	23731080	15118
chr16	23715962	23915962	harbor1	chr16	23741840	23742161	DNA/hAT-Charlie	1532	+	160	23742000	26038
chr16	23715962	23915962	harbor1	chr16	23756655	23756874	DNA/hAT-Charlie	1219	+	110	23756765	40803
chr16	54977151	55177151	harbor1	chr16	55004360	55004581	DNA/hAT-Charlie	1053	+	110	55004470	27319
chr16	54977151	55177151	harbor1	chr16	55020515	55020724	DNA/hAT-Charlie	517	+	104	55020619	43468
chr16	54977151	55177151	harbor1	chr16	55039801	55039920	DNA/hAT-Charlie	561	+	60	55039861	62710
chr16	54977151	55177151	harbor1	chr16	55041371	55041590	DNA/hAT-Charlie	562	+	110	55041481	64330
chr16	54977151	55177151	harbor1	chr16	55041725	55041900	DNA/hAT-Charlie	863	+	88	55041813	64662
chr16	56009382	56209382	harbor1	chr16	56018038	56018328	DNA/hAT-Charlie	683	+	145	56018183	8801
chr16	56009382	56209382	harbor1	chr16	56039467	56039606	DNA/hAT-Charlie	516	+	70	56039537	30155
chr16	56009382	56209382	harbor1	chr16	56039798	56039916	DNA/hAT-Charlie	516	+	59	56039857	30475
chr16	56009382	56209382	harbor1	chr16	56044230	56044590	DNA/hAT-Charlie	682	+	180	56044410	35028
chr16	56009382	56209382	harbor1	chr16	56050113	56050569	DNA/hAT-Charlie	2948	+	228	56050341	40959
chr16	56009382	56209382	harbor1	chr16	56062998	56063058	DNA/hAT-Charlie	1327	+	30	56063028	53646
chr16	56009382	56209382	harbor1	chr16	56063059	56063404	DNA/hAT-Charlie	2105	+	172	56063231	53849
chr16	56009382	56209382	harbor1	chr16	56063405	56063634	DNA/hAT-Charlie	1327	+	114	56063519	54137
chr16	56009382	56209382	harbor1	chr16	56074983	56075216	DNA/hAT-Charlie	1082	+	116	56075099	65717
chr16	56009382	56209382	harbor1	chr16	56088191	56088527	DNA/hAT-Charlie	2101	+	168	56088359	78977
chr16	4856635	5056635	harbor1	chr16	4948394	4948537	DNA/hAT-Charlie	660	+	72	4948466	91831
chr16	51637790	51837790	harbor1	chr16	51676986	51677071	DNA/hAT-Charlie	449	+	42	51677028	39238
chr16	51637790	51837790	harbor1	chr16	51687887	51688092	DNA/hAT-Charlie	472	+	102	51687989	50199
chr16	51637790	51837790	harbor1	chr16	51710524	51710650	DNA/hAT-Charlie	502	+	63	51710587	72797
chr16	51637790	51837790	harbor1	chr16	51737577	51737727	DNA/hAT-Charlie	585	+	75	51737652	99862
chr16	62985236	63185236	harbor1	chr16	63056589	63056705	DNA/hAT-Charlie	468	+	58	63056647	71411
chr16	62985236	63185236	harbor1	chr16	63062291	63062512	DNA/hAT-Charlie	1067	+	110	63062401	77165
chr16	66775587	66975587	harbor1	chr16	66829775	66829872	DNA/hAT-Charlie	544	+	48	66829823	54236
chr16	66775587	66975587	harbor1	chr16	66834050	66834120	DNA/hAT-Charlie	750	+	35	66834085	58498
chr16	66775587	66975587	harbor1	chr16	66834417	66834427	DNA/hAT-Charlie	750	+	5	66834422	58835
chr16	66775587	66975587	harbor1	chr16	66834886	66834987	DNA/hAT-Charlie	750	+	50	66834936	59349
chr16	66775587	66975587	harbor1	chr16	66830274	66830476	DNA/hAT-Charlie	860	+	101	66830375	54788
chr16	12630057	12830057	harbor1	chr16	12644750	12644957	DNA/hAT-Charlie	1133	+	104	12644854	14797
chr16	12630057	12830057	harbor1	chr16	12646052	12646182	DNA/hAT-Charlie	787	+	65	12646117	16060
chr16	12630057	12830057	harbor1	chr16	12648055	12648178	DNA/hAT-Charlie	764	+	62	12648117	18060
chr16	12630057	12830057	harbor1	chr16	12648476	12648536	DNA/hAT-Charlie	764	+	30	12648506	18449
chr16	12630057	12830057	harbor1	chr16	12686961	12687154	DNA/hAT-Charlie	461	+	96	12687057	57000
chr16	12630057	12830057	harbor1	chr16	12697600	12697792	DNA/hAT-Charlie	910	+	96	12697696	67639
chr16	12630057	12830057	harbor1	chr16	12715893	12715968	DNA/hAT-Charlie	597	+	38	12715931	85874
chr16	5519386	5719386	harbor1	chr16	5532381	5532507	DNA/hAT-Charlie	609	+	63	5532444	13058
chr16	5519386	5719386	harbor1	chr16	5540728	5540843	DNA/hAT-Charlie	634	+	58	5540786	21400
chr16	5519386	5719386	harbor1	chr16	5541150	5541213	DNA/hAT-Charlie	634	+	32	5541182	21796
chr16	5519386	5719386	harbor1	chr16	5599635	5599854	DNA/hAT-Charlie	532	+	110	5599745	80359
chr16	15183001	15383001	harbor1	chr16	15223495	15223707	DNA/hAT-Charlie	914	+	106	15223601	40600
chr16	15183001	15383001	harbor1	chr16	15270239	15270394	DNA/hAT-Charlie	498	+	78	15270317	87316
chr16	15183001	15383001	harbor1	chr16	15274093	15274289	DNA/hAT-Charlie	956	+	98	15274191	91190
chr16	10693662	10893662	harbor1	chr16	10728358	10728512	DNA/hAT-Charlie	671	+	77	10728435	34773
chr16	25616178	25816178	harbor1	chr16	25642447	25642648	DNA/hAT-Charlie	454	+	100	25642547	26369
chr16	25616178	25816178	harbor1	chr16	25648138	25648441	DNA/hAT-Charlie	1330	+	152	25648290	32112
chr16	25616178	25816178	harbor1	chr16	25697330	25697589	DNA/hAT-Charlie	910	+	130	25697460	81282
chr16	25616178	25816178	harbor1	chr16	25624485	25624769	DNA/hAT-Charlie	484	+	142	25624627	8449
chr16	23000252	23200252	harbor1	chr16	23007368	23007602	DNA/hAT-Charlie	1303	+	117	23007485	7233
chr16	23000252	23200252	harbor1	chr16	23007868	23007922	DNA/hAT-Charlie	1303	+	27	23007895	7643
chr16	23000252	23200252	harbor1	chr16	23027804	23027880	DNA/hAT-Charlie	736	+	38	23027842	27590
chr16	23000252	23200252	harbor1	chr16	23028191	23028271	DNA/hAT-Charlie	736	+	40	23028231	27979
chr16	23000252	23200252	harbor1	chr16	23035559	23035762	DNA/hAT-Charlie	880	+	102	23035661	35409
chr16	23000252	23200252	harbor1	chr16	23050110	23050262	DNA/hAT-Charlie	486	+	76	23050186	49934
chr16	23000252	23200252	harbor1	chr16	23062958	23063109	DNA/hAT-Charlie	617	+	76	23063034	62782
chr16	23000252	23200252	harbor1	chr16	23074133	23074348	DNA/hAT-Charlie	1084	+	108	23074241	73989
chr16	23000252	23200252	harbor1	chr16	23075499	23075710	DNA/hAT-Charlie	556	+	106	23075605	75353
chr16	23000252	23200252	harbor1	chr16	23084344	23084480	DNA/hAT-Charlie	727	+	68	23084412	84160
chr16	67599532	67799532	harbor1	chr16	67603014	67603110	DNA/hAT-Charlie	685	+	48	67603062	3530
chr16	67599532	67799532	harbor1	chr16	67604311	67604332	DNA/hAT-Charlie	685	+	10	67604321	4789
chr16	67599532	67799532	harbor1	chr16	67604641	67604730	DNA/hAT-Charlie	685	+	44	67604685	5153
chr16	67599532	67799532	harbor1	chr16	67604765	67604851	DNA/hAT-Charlie	685	+	43	67604808	5276
chr16	79103533	79303533	harbor1	chr16	79106071	79106232	DNA/hAT-Charlie	842	+	80	79106151	2618
chr16	79103533	79303533	harbor1	chr16	79190676	79190891	DNA/hAT-Charlie	1145	+	108	79190784	87251
chr16	79103533	79303533	harbor1	chr16	79202009	79202228	DNA/hAT-Charlie	1043	+	110	79202119	98586
chr16	15572848	15772848	harbor1	chr16	15633302	15633359	DNA/hAT-Charlie	501	+	28	15633330	60482
chr16	15572848	15772848	harbor1	chr16	15640714	15640889	DNA/hAT-Charlie	903	+	88	15640802	67954
chr16	81726050	81926050	harbor1	chr16	81790741	81790966	DNA/hAT-Charlie	865	+	112	81790853	64803
chr16	31793772	31993772	harbor1	chr16	31855502	31855829	DNA/hAT-Charlie	1773	+	164	31855666	61894
chr16	31793772	31993772	harbor1	chr16	31886302	31886616	DNA/hAT-Charlie	1902	+	157	31886459	92687
chr16	18584927	18784927	harbor1	chr16	18604995	18605165	DNA/hAT-Charlie	1010	+	85	18605080	20153
chr16	18584927	18784927	harbor1	chr16	18607818	18607912	DNA/hAT-Charlie	487	+	47	18607865	22938
chr16	18584927	18784927	harbor1	chr16	18646297	18646695	DNA/hAT-Charlie	1976	+	199	18646496	61569
chr16	18584927	18784927	harbor1	chr16	18676278	18676496	DNA/hAT-Charlie	1015	+	109	18676387	91460
chr16	6442710	6642710	harbor1	chr16	6465643	6465793	DNA/hAT-Charlie	598	+	75	6465718	23008
chr16	3861613	4061613	harbor1	chr16	3874427	3874628	DNA/hAT-Charlie	849	+	100	3874527	12914
chr16	22094488	22294488	harbor1	chr16	22095999	22096217	DNA/hAT-Charlie	1207	+	109	22096108	1620
chr16	22094488	22294488	harbor1	chr16	22105495	22105681	DNA/hAT-Charlie	541	+	93	22105588	11100
chr16	22094488	22294488	harbor1	chr16	22107189	22107377	DNA/hAT-Charlie	1079	+	94	22107283	12795
chr16	50726345	50926345	harbor1	chr16	50764685	50764892	DNA/hAT-Charlie	995	+	104	50764789	38444
chr16	50726345	50926345	harbor1	chr16	50804979	50805070	DNA/hAT-Charlie	718	+	46	50805025	78680
chr16	50726345	50926345	harbor1	chr16	50805319	50805430	DNA/hAT-Charlie	718	+	56	50805375	79030
chr16	17359444	17559444	harbor1	chr16	17366071	17366241	DNA/hAT-Charlie	537	+	85	17366156	6712
chr16	17359444	17559444	harbor1	chr16	17370636	17370992	DNA/hAT-Charlie	772	+	178	17370814	11370
chr16	17359444	17559444	harbor1	chr16	17376134	17376340	DNA/hAT-Charlie	921	+	103	17376237	16793
chr16	17359444	17559444	harbor1	chr16	17382326	17382488	DNA/hAT-Charlie	600	+	81	17382407	22963
chr16	17359444	17559444	harbor1	chr16	17384391	17384705	DNA/hAT-Charlie	658	+	157	17384548	25104
chr16	17359444	17559444	harbor1	chr16	17396923	17397118	DNA/hAT-Charlie	968	+	98	17397021	37577
chr16	17359444	17559444	harbor1	chr16	17424361	17424524	DNA/hAT-Charlie	456	+	82	17424443	64999
chr16	17359444	17559444	harbor1	chr16	17426591	17426808	DNA/hAT-Charlie	1053	+	108	17426699	67255
chr16	17359444	17559444	harbor1	chr16	17441293	17441529	DNA/hAT-Charlie	471	+	118	17441411	81967
chr16	69948732	70148732	harbor1	chr16	69967221	69967369	DNA/hAT-Charlie	737	+	74	69967295	18563
chr16	69948732	70148732	harbor1	chr16	70006146	70006535	DNA/hAT-Charlie	1914	+	194	70006340	57608
chr16	71702800	71902800	harbor1	chr16	71710627	71710722	DNA/hAT-Charlie	476	+	48	71710675	7875
chr16	71702800	71902800	harbor1	chr16	71737809	71738020	DNA/hAT-Charlie	846	+	106	71737915	35115
chr16	71702800	71902800	harbor1	chr16	71761130	71761306	DNA/hAT-Charlie	958	+	88	71761218	58418
chr16	32068129	32268129	harbor1	chr16	32082882	32083072	DNA/hAT-Charlie	1294	+	95	32082977	14848
chr16	32068129	32268129	harbor1	chr16	32143647	32143829	DNA/hAT-Charlie	562	+	91	32143738	75609
chr16	54735970	54935970	harbor1	chr16	54801849	54802179	DNA/hAT-Charlie	585	+	165	54802014	66044
chr16	54735970	54935970	harbor1	chr16	54833040	54833233	DNA/hAT-Charlie	995	+	96	54833136	97166
chr16	26860412	27060412	harbor1	chr16	26892756	26892972	DNA/hAT-Charlie	965	+	108	26892864	32452
chr16	26860412	27060412	harbor1	chr16	26914972	26915262	DNA/hAT-Charlie	842	+	145	26915117	54705
chr16	16507035	16707035	harbor1	chr16	16519544	16519759	DNA/hAT-Charlie	887	+	108	16519652	12617
chr16	16507035	16707035	harbor1	chr16	16526246	16526430	DNA/hAT-Charlie	784	+	92	16526338	19303
chr16	16507035	16707035	harbor1	chr16	16542792	16543010	DNA/hAT-Charlie	948	+	109	16542901	35866
chr16	84053191	84253191	harbor1	chr16	84059907	84060060	DNA/hAT-Charlie	498	+	76	84059983	6792
chr16	84053191	84253191	harbor1	chr16	84089229	84089355	DNA/hAT-Charlie	538	+	63	84089292	36101
chr16	84053191	84253191	harbor1	chr16	84126336	84126541	DNA/hAT-Charlie	922	+	102	84126438	73247
chr16	18237448	18437448	harbor1	chr16	18248588	18248679	DNA/hAT-Charlie	1136	+	46	18248634	11186
chr16	18237448	18437448	harbor1	chr16	18249015	18249239	DNA/hAT-Charlie	1136	+	112	18249127	11679
chr16	18237448	18437448	harbor1	chr16	18335060	18335194	DNA/hAT-Charlie	558	+	67	18335127	97679
chr16	18237448	18437448	harbor1	chr16	18335500	18335544	DNA/hAT-Charlie	558	+	22	18335522	98074
chr16	18237448	18437448	harbor1	chr16	18300720	18301013	DNA/hAT-Charlie	1349	+	146	18300866	63418
chr16	53736710	53936710	harbor1	chr16	53740936	53741270	DNA/hAT-Charlie	1384	+	167	53741103	4393
chr16	53736710	53936710	harbor1	chr16	53742822	53743024	DNA/hAT-Charlie	673	+	101	53742923	6213
chr16	53736710	53936710	harbor1	chr16	53750539	53750672	DNA/hAT-Charlie	574	+	66	53750605	13895
chr16	3629754	3829754	harbor1	chr16	3673124	3673406	DNA/hAT-Charlie	595	+	141	3673265	43511
chr16	3629754	3829754	harbor1	chr16	3678203	3678382	DNA/hAT-Charlie	624	+	90	3678293	48539
chr16	86458047	86658047	harbor1	chr16	86467833	86468007	DNA/hAT-Charlie	514	+	87	86467920	9873
chr16	86458047	86658047	harbor1	chr16	86543722	86544238	DNA/hAT-Charlie	3623	+	258	86543980	85933
chr16	86458047	86658047	harbor1	chr16	86549151	86549292	DNA/hAT-Charlie	530	+	70	86549221	91174
chr16	86458047	86658047	harbor1	chr16	86550911	86551311	DNA/hAT-Charlie	1255	+	200	86551111	93064
chr16	4944311	5144311	harbor1	chr16	4948394	4948537	DNA/hAT-Charlie	660	+	72	4948466	4155
chr16	4944311	5144311	harbor1	chr16	5019064	5019287	DNA/hAT-Charlie	1442	+	112	5019176	74865
chr16	4944311	5144311	harbor1	chr16	5024598	5024739	DNA/hAT-Charlie	757	+	70	5024668	80357
chr16	19828706	20028706	harbor1	chr16	19854069	19854231	DNA/hAT-Charlie	476	+	81	19854150	25444
chr16	19828706	20028706	harbor1	chr16	19863801	19863998	DNA/hAT-Charlie	1033	+	98	19863899	35193
chr16	19828706	20028706	harbor1	chr16	19876189	19876401	DNA/hAT-Charlie	1124	+	106	19876295	47589
chr16	19828706	20028706	harbor1	chr16	19892945	19893210	DNA/hAT-Charlie	1603	+	132	19893077	64371
chr16	19828706	20028706	harbor1	chr16	19893618	19893754	DNA/hAT-Charlie	1603	+	68	19893686	64980
chr16	19828706	20028706	harbor1	chr16	19912067	19912191	DNA/hAT-Charlie	511	+	62	19912129	83423
chr16	6513760	6713760	harbor1	chr16	6581924	6582125	DNA/hAT-Charlie	753	+	100	6582024	68264
chr16	68058243	68258243	harbor1	chr16	68152681	68153116	DNA/hAT-Charlie	1842	+	218	68152899	94656
chr16	68058243	68258243	harbor1	chr16	68153436	68153501	DNA/hAT-Charlie	1842	+	32	68153468	95225
chr16	17060009	17260009	harbor1	chr16	17061477	17061689	DNA/hAT-Charlie	1080	+	106	17061583	1574
chr16	17060009	17260009	harbor1	chr16	17073685	17073883	DNA/hAT-Charlie	743	+	99	17073784	13775
chr16	17060009	17260009	harbor1	chr16	17074421	17074632	DNA/hAT-Charlie	648	+	106	17074527	14518
chr16	17060009	17260009	harbor1	chr16	17109569	17109779	DNA/hAT-Charlie	1107	+	105	17109674	49665
chr16	17060009	17260009	harbor1	chr16	17129223	17129261	DNA/hAT-Charlie	794	+	19	17129242	69233
chr16	17060009	17260009	harbor1	chr16	17129655	17129801	DNA/hAT-Charlie	794	+	73	17129728	69719
chr16	17060009	17260009	harbor1	chr16	17135063	17135309	DNA/hAT-Charlie	678	+	123	17135186	75177
chr16	17060009	17260009	harbor1	chr16	17137853	17137951	DNA/hAT-Charlie	449	+	49	17137902	77893
chr16	17060009	17260009	harbor1	chr16	17104677	17104935	DNA/hAT-Charlie	636	+	129	17104806	44797
chr16	23054934	23254934	harbor1	chr16	23062958	23063109	DNA/hAT-Charlie	617	+	76	23063034	8100
chr16	23054934	23254934	harbor1	chr16	23074133	23074348	DNA/hAT-Charlie	1084	+	108	23074241	19307
chr16	23054934	23254934	harbor1	chr16	23075499	23075710	DNA/hAT-Charlie	556	+	106	23075605	20671
chr16	23054934	23254934	harbor1	chr16	23084344	23084480	DNA/hAT-Charlie	727	+	68	23084412	29478
chr16	23054934	23254934	harbor1	chr16	23128921	23129174	DNA/hAT-Charlie	836	+	126	23129047	74113
chr16	23054934	23254934	harbor1	chr16	23140272	23140474	DNA/hAT-Charlie	1135	+	101	23140373	85439
chr16	23054934	23254934	harbor1	chr16	23144272	23144417	DNA/hAT-Charlie	439	+	72	23144344	89410
chr16	23054934	23254934	harbor1	chr16	23145205	23145369	DNA/hAT-Charlie	749	+	82	23145287	90353
chr16	20627857	20827857	harbor1	chr16	20628994	20629229	DNA/hAT-Charlie	568	+	118	20629112	1255
chr16	20627857	20827857	harbor1	chr16	20682555	20682704	DNA/hAT-Charlie	548	+	74	20682629	54772
chr16	20627857	20827857	harbor1	chr16	20712158	20712322	DNA/hAT-Charlie	968	+	82	20712240	84383
chr16	11368435	11568435	harbor1	chr16	11397224	11397282	DNA/hAT-Charlie	795	+	29	11397253	28818
chr16	11368435	11568435	harbor1	chr16	11397572	11397724	DNA/hAT-Charlie	795	+	76	11397648	29213
chr16	11368435	11568435	harbor1	chr16	11409353	11409545	DNA/hAT-Charlie	728	+	96	11409449	41014
chr16	11368435	11568435	harbor1	chr16	11418703	11418823	DNA/hAT-Charlie	468	+	60	11418763	50328
chr16	11368435	11568435	harbor1	chr16	11420722	11420879	DNA/hAT-Charlie	542	+	78	11420800	52365
chr16	11368435	11568435	harbor1	chr16	11432997	11433216	DNA/hAT-Charlie	1288	+	110	11433107	64672
chr16	11368435	11568435	harbor1	chr16	11444420	11444632	DNA/hAT-Charlie	871	+	106	11444526	76091
chr16	11368435	11568435	harbor1	chr16	11466260	11466393	DNA/hAT-Charlie	560	+	66	11466326	97891
chr16	11368435	11568435	harbor1	chr16	11466689	11466738	DNA/hAT-Charlie	560	+	24	11466713	98278
chr16	55756540	55956540	harbor1	chr16	55775776	55776098	DNA/hAT-Charlie	1443	+	161	55775937	19397
chr16	55756540	55956540	harbor1	chr16	55803625	55803769	DNA/hAT-Charlie	498	+	72	55803697	47157
chr16	22393635	22593635	harbor1	chr16	22404611	22404740	DNA/hAT-Charlie	974	+	64	22404675	11040
chr16	22393635	22593635	harbor1	chr16	22418550	22418680	DNA/hAT-Charlie	763	+	65	22418615	24980
chr16	22393635	22593635	harbor1	chr16	22433699	22433910	DNA/hAT-Charlie	863	+	106	22433805	40170
chr16	5125381	5325381	harbor1	chr16	5135037	5135189	DNA/hAT-Charlie	704	+	76	5135113	9732
chr16	5125381	5325381	harbor1	chr16	5136840	5137060	DNA/hAT-Charlie	1177	+	110	5136950	11569
chr16	5125381	5325381	harbor1	chr16	5143859	5144072	DNA/hAT-Charlie	1118	+	106	5143965	18584
chr16	5125381	5325381	harbor1	chr16	5177810	5177908	DNA/hAT-Charlie	447	+	49	5177859	52478
chr16	5125381	5325381	harbor1	chr16	5179228	5179311	DNA/hAT-Charlie	439	+	42	5179270	53889
chr16	5125381	5325381	harbor1	chr16	5179678	5179711	DNA/hAT-Charlie	439	+	16	5179694	54313
chr16	7783580	7983580	harbor1	chr16	7804341	7804522	DNA/hAT-Charlie	537	+	90	7804431	20851
chr16	7783580	7983580	harbor1	chr16	7806724	7807249	DNA/hAT-Charlie	3965	+	262	7806986	23406
chr16	7783580	7983580	harbor1	chr16	7861851	7862144	DNA/hAT-Charlie	608	+	146	7861997	78417
chr16	89794575	89994575	harbor1	chr16	89823679	89823875	DNA/hAT-Charlie	1335	+	98	89823777	29202
chr16	89794575	89994575	harbor1	chr16	89864403	89864560	DNA/hAT-Charlie	460	+	78	89864481	69906
chr16	61490246	61690246	harbor1	chr16	61504798	61504978	DNA/hAT-Charlie	839	+	90	61504888	14642
chr16	61490246	61690246	harbor1	chr16	61566425	61566612	DNA/hAT-Charlie	869	+	94	61566519	76273
chr16	61490246	61690246	harbor1	chr16	61567179	61567211	DNA/hAT-Charlie	869	+	16	61567195	76949
chr16	28590347	28790347	harbor1	chr16	28647057	28647158	DNA/hAT-Charlie	1133	+	50	28647107	56760
chr16	28590347	28790347	harbor1	chr16	28647783	28647896	DNA/hAT-Charlie	1133	+	56	28647839	57492
chr16	78827007	79027007	harbor1	chr16	78840908	78841344	DNA/hAT-Charlie	1038	+	218	78841126	14119
chr16	78827007	79027007	harbor1	chr16	78841674	78841896	DNA/hAT-Charlie	600	+	111	78841785	14778
chr16	78827007	79027007	harbor1	chr16	78869506	78869674	DNA/hAT-Charlie	547	+	84	78869590	42583
chr16	23385694	23585694	harbor1	chr16	23386530	23386683	DNA/hAT-Charlie	627	+	76	23386606	912
chr16	23385694	23585694	harbor1	chr16	23403944	23404101	DNA/hAT-Charlie	493	+	78	23404022	18328
chr16	23385694	23585694	harbor1	chr16	23441232	23441292	DNA/hAT-Charlie	794	+	30	23441262	55568
chr16	23385694	23585694	harbor1	chr16	23441591	23441731	DNA/hAT-Charlie	794	+	70	23441661	55967
chr16	18477944	18677944	harbor1	chr16	18499500	18499751	DNA/hAT-Charlie	553	+	126	18499626	21682
chr16	18477944	18677944	harbor1	chr16	18502106	18502289	DNA/hAT-Charlie	681	+	92	18502198	24254
chr16	18477944	18677944	harbor1	chr16	18502294	18502422	DNA/hAT-Charlie	626	+	64	18502358	24414
chr16	18477944	18677944	harbor1	chr16	18510152	18510436	DNA/hAT-Charlie	523	+	142	18510294	32350
chr16	18477944	18677944	harbor1	chr16	18511805	18511969	DNA/hAT-Charlie	498	+	82	18511887	33943
chr16	18477944	18677944	harbor1	chr16	18511994	18512139	DNA/hAT-Charlie	471	+	72	18512066	34122
chr16	18477944	18677944	harbor1	chr16	18534244	18534547	DNA/hAT-Charlie	913	+	152	18534396	56452
chr16	18477944	18677944	harbor1	chr16	18513859	18514074	DNA/hAT-Charlie	548	+	108	18513967	36023
chr16	13138332	13338332	harbor1	chr16	13150544	13150682	DNA/hAT-Charlie	673	+	69	13150613	12281
chr16	13138332	13338332	harbor1	chr16	13173532	13173741	DNA/hAT-Charlie	778	+	104	13173636	35304
chr16	13138332	13338332	harbor1	chr16	13201109	13201202	DNA/hAT-Charlie	1225	+	46	13201155	62823
chr16	13138332	13338332	harbor1	chr16	13201525	13201649	DNA/hAT-Charlie	1225	+	62	13201587	63255
chr16	31259753	31459753	harbor1	chr16	31260756	31261090	DNA/hAT-Charlie	1241	+	167	31260923	1170
chr16	31259753	31459753	harbor1	chr16	31262155	31262233	DNA/hAT-Charlie	587	+	39	31262194	2441
chr16	31259753	31459753	harbor1	chr16	31262704	31262799	DNA/hAT-Charlie	587	+	48	31262752	2999
chr16	31259753	31459753	harbor1	chr16	31276083	31276270	DNA/hAT-Charlie	587	+	94	31276177	16424
chr16	31259753	31459753	harbor1	chr16	31337704	31337863	DNA/hAT-Charlie	489	+	80	31337784	78031
chr16	29345942	29545942	harbor1	chr16	29415103	29415492	DNA/hAT-Charlie	1938	+	194	29415297	69355
chr16	80762550	80962550	harbor1	chr16	80823013	80823343	DNA/hAT-Charlie	2308	+	165	80823178	60628
chr16	14543174	14743174	harbor1	chr16	14561286	14561386	DNA/hAT-Charlie	562	+	50	14561336	18162
chr16	14543174	14743174	harbor1	chr16	14591439	14591643	DNA/hAT-Charlie	953	+	102	14591541	48367
chr16	5272409	5472409	harbor1	chr16	5289412	5289641	DNA/hAT-Charlie	701	+	114	5289526	17117
chr16	5272409	5472409	harbor1	chr16	5297725	5298036	DNA/hAT-Charlie	757	+	156	5297881	25472
chr16	5272409	5472409	harbor1	chr16	5333243	5333468	DNA/hAT-Charlie	975	+	112	5333355	60946
chr17	53469706	53669706	harbor1	chr17	53525809	53525980	DNA/hAT-Charlie	681	+	86	53525895	56189
chr17	49618180	49818180	harbor1	chr17	49621488	49621743	DNA/hAT-Charlie	677	+	128	49621616	3436
chr17	49618180	49818180	harbor1	chr17	49662905	49663074	DNA/hAT-Charlie	6145	+	84	49662989	44809
chr17	49618180	49818180	harbor1	chr17	49663075	49663409	DNA/hAT-Charlie	1920	+	167	49663242	45062
chr17	49618180	49818180	harbor1	chr17	49663410	49664617	DNA/hAT-Charlie	6145	+	604	49664014	45834
chr17	50352094	50552094	harbor1	chr17	50392925	50393107	DNA/hAT-Charlie	1042	+	91	50393016	40922
chr17	71898852	72098852	harbor1	chr17	71900065	71900235	DNA/hAT-Charlie	589	+	85	71900150	1298
chr17	71898852	72098852	harbor1	chr17	71947990	71948088	DNA/hAT-Charlie	490	+	49	71948039	49187
chr17	71898852	72098852	harbor1	chr17	71962374	71962622	DNA/hAT-Charlie	1768	+	124	71962498	63646
chr17	81795964	81995964	harbor1	chr17	81861662	81861750	DNA/hAT-Charlie	589	+	44	81861706	65742
chr17	81795964	81995964	harbor1	chr17	81862059	81862173	DNA/hAT-Charlie	589	+	57	81862116	66152
chr17	81795964	81995964	harbor1	chr17	81862791	81862868	DNA/hAT-Charlie	589	+	38	81862829	66865
chr17	29062749	29262749	harbor1	chr17	29063022	29063158	DNA/hAT-Charlie	557	+	68	29063090	341
chr17	29062749	29262749	harbor1	chr17	29142498	29142675	DNA/hAT-Charlie	980	+	88	29142586	79837
chr17	6933584	7133584	harbor1	chr17	7025284	7025453	DNA/hAT-Charlie	758	+	84	7025368	91784
chr17	36112097	36312097	harbor1	chr17	36118994	36119517	DNA/hAT-Charlie	3800	+	262	36119256	7159
chr17	36112097	36312097	harbor1	chr17	36138856	36139188	DNA/hAT-Charlie	1447	+	166	36139022	26925
chr17	27986699	28186699	harbor1	chr17	28031177	28031292	DNA/hAT-Charlie	828	+	58	28031235	44536
chr17	27986699	28186699	harbor1	chr17	28031813	28031880	DNA/hAT-Charlie	828	+	34	28031847	45148
chr17	27986699	28186699	harbor1	chr17	28050410	28050553	DNA/hAT-Charlie	633	+	72	28050482	63783
chr17	12440074	12640074	harbor1	chr17	12470738	12470941	DNA/hAT-Charlie	938	+	102	12470840	30766
chr17	12440074	12640074	harbor1	chr17	12517534	12517692	DNA/hAT-Charlie	736	+	79	12517613	77539
chr17	72962286	73162286	harbor1	chr17	72966470	72966557	DNA/hAT-Charlie	3330	+	44	72966514	4228
chr17	72962286	73162286	harbor1	chr17	72966869	72967293	DNA/hAT-Charlie	3330	+	212	72967081	4795
chr17	72962286	73162286	harbor1	chr17	72984519	72984689	DNA/hAT-Charlie	796	+	85	72984604	22318
chr17	72962286	73162286	harbor1	chr17	72986572	72986715	DNA/hAT-Charlie	627	+	72	72986644	24358
chr17	72962286	73162286	harbor1	chr17	73006349	73006568	DNA/hAT-Charlie	768	+	110	73006459	44173
chr17	72962286	73162286	harbor1	chr17	73013585	73013781	DNA/hAT-Charlie	1184	+	98	73013683	51397
chr17	72962286	73162286	harbor1	chr17	73031980	73032203	DNA/hAT-Charlie	1160	+	112	73032092	69806
chr17	61817030	62017030	harbor1	chr17	61817559	61817719	DNA/hAT-Charlie	589	+	80	61817639	609
chr17	61817030	62017030	harbor1	chr17	61820309	61820648	DNA/hAT-Charlie	591	+	170	61820479	3449
chr17	61817030	62017030	harbor1	chr17	61851839	61852067	DNA/hAT-Charlie	840	+	114	61851953	34923
chr17	61817030	62017030	harbor1	chr17	61879382	61879568	DNA/hAT-Charlie	1021	+	93	61879475	62445
chr17	61817030	62017030	harbor1	chr17	61879864	61880003	DNA/hAT-Charlie	1021	+	70	61879934	62904
chr17	61817030	62017030	harbor1	chr17	61910795	61910936	DNA/hAT-Charlie	517	+	70	61910865	93835
chr17	61817030	62017030	harbor1	chr17	61910935	61911081	DNA/hAT-Charlie	570	+	73	61911008	93978
chr17	61817030	62017030	harbor1	chr17	61911270	61911426	DNA/hAT-Charlie	720	+	78	61911348	94318
chr17	31549001	31749001	harbor1	chr17	31605952	31606102	DNA/hAT-Charlie	493	+	75	31606027	57026
chr17	49793583	49993583	harbor1	chr17	49797557	49797851	DNA/hAT-Charlie	841	+	147	49797704	4121
chr17	49793583	49993583	harbor1	chr17	49834666	49834778	DNA/hAT-Charlie	528	+	56	49834722	41139
chr17	49793583	49993583	harbor1	chr17	49835027	49835186	DNA/hAT-Charlie	528	+	80	49835107	41524
chr17	75396099	75596099	harbor1	chr17	75453871	75453952	DNA/hAT-Charlie	615	+	40	75453911	57812
chr17	7697627	7897627	harbor1	chr17	7752860	7753029	DNA/hAT-Charlie	755	+	84	7752944	55317
chr17	8396369	8596369	harbor1	chr17	8420960	8421225	DNA/hAT-Charlie	624	+	132	8421092	24723
chr17	33785461	33985461	harbor1	chr17	33810315	33810498	DNA/hAT-Charlie	644	+	92	33810407	24946
chr17	33785461	33985461	harbor1	chr17	33818501	33818727	DNA/hAT-Charlie	1109	+	113	33818614	33153
chr17	33785461	33985461	harbor1	chr17	33820057	33820179	DNA/hAT-Charlie	559	+	61	33820118	34657
chr17	33785461	33985461	harbor1	chr17	33820181	33820492	DNA/hAT-Charlie	1270	+	156	33820337	34876
chr17	33785461	33985461	harbor1	chr17	33838725	33838889	DNA/hAT-Charlie	571	+	82	33838807	53346
chr17	33785461	33985461	harbor1	chr17	33850335	33850788	DNA/hAT-Charlie	1132	+	226	33850561	65100
chr17	33785461	33985461	harbor1	chr17	33863654	33863892	DNA/hAT-Charlie	1315	+	119	33863773	78312
chr17	33785461	33985461	harbor1	chr17	33864207	33864399	DNA/hAT-Charlie	1315	+	96	33864303	78842
chr17	2007981	2207981	harbor1	chr17	2038435	2038744	DNA/hAT-Charlie	1797	+	154	2038589	30608
chr17	9397947	9597947	harbor1	chr17	9411738	9411956	DNA/hAT-Charlie	548	+	109	9411847	13900
chr17	9397947	9597947	harbor1	chr17	9438350	9438501	DNA/hAT-Charlie	761	+	76	9438426	40479
chr17	9397947	9597947	harbor1	chr17	9481651	9481985	DNA/hAT-Charlie	2242	+	167	9481818	83871
chr17	34477470	34677470	harbor1	chr17	34537780	34537987	DNA/hAT-Charlie	1187	+	104	34537884	60414
chr17	69596742	69796742	harbor1	chr17	69643994	69644202	DNA/hAT-Charlie	1494	+	104	69644098	47356
chr17	29442999	29642999	harbor1	chr17	29480982	29481195	DNA/hAT-Charlie	1106	+	106	29481088	38089
chr17	6359288	6559288	harbor1	chr17	6386212	6386382	DNA/hAT-Charlie	1106	+	85	6386297	27009
chr17	6359288	6559288	harbor1	chr17	6440900	6441071	DNA/hAT-Charlie	525	+	86	6440986	81698
chr17	6359288	6559288	harbor1	chr17	6456471	6456638	DNA/hAT-Charlie	846	+	84	6456555	97267
chr17	57428377	57628377	harbor1	chr17	57524911	57525076	DNA/hAT-Charlie	561	+	82	57524993	96616
chr17	71732756	71932756	harbor1	chr17	71786730	71786929	DNA/hAT-Charlie	1305	+	100	71786830	54074
chr17	71732756	71932756	harbor1	chr17	71832235	71832423	DNA/hAT-Charlie	675	+	94	71832329	99573
chr17	22271651	22471651	harbor1	chr17	22319610	22319877	DNA/hAT-Charlie	1089	+	134	22319744	48093
chr17	22271651	22471651	harbor1	chr17	22367794	22367967	DNA/hAT-Charlie	499	+	86	22367880	96229
chr17	57878223	58078223	harbor1	chr17	57879138	57879302	DNA/hAT-Charlie	527	+	82	57879220	997
chr17	57878223	58078223	harbor1	chr17	57918169	57918455	DNA/hAT-Charlie	706	+	143	57918312	40089
chr17	57878223	58078223	harbor1	chr17	57918598	57918780	DNA/hAT-Charlie	713	+	91	57918689	40466
chr17	57878223	58078223	harbor1	chr17	57920168	57920332	DNA/hAT-Charlie	783	+	82	57920250	42027
chr17	57878223	58078223	harbor1	chr17	57929403	57929603	DNA/hAT-Charlie	683	+	100	57929503	51280
chr17	69894440	70094440	harbor1	chr17	69899372	69899599	DNA/hAT-Charlie	491	+	114	69899486	5046
chr17	69894440	70094440	harbor1	chr17	69902336	69902518	DNA/hAT-Charlie	640	+	91	69902427	7987
chr17	69894440	70094440	harbor1	chr17	69905191	69905269	DNA/hAT-Charlie	749	+	39	69905230	10790
chr17	69894440	70094440	harbor1	chr17	69905573	69905690	DNA/hAT-Charlie	749	+	58	69905631	11191
chr17	33538029	33738029	harbor1	chr17	33619037	33619224	DNA/hAT-Charlie	549	+	94	33619131	81102
chr17	33538029	33738029	harbor1	chr17	33587025	33587261	DNA/hAT-Charlie	1158	+	118	33587143	49114
chr17	33538029	33738029	harbor1	chr17	33619307	33620181	DNA/hAT-Charlie	3343	+	437	33619744	81715
chr17	75796497	75996497	harbor1	chr17	75799997	75800069	DNA/hAT-Charlie	905	+	36	75800033	3536
chr17	75796497	75996497	harbor1	chr17	75800367	75800456	DNA/hAT-Charlie	905	+	44	75800411	3914
chr17	75796497	75996497	harbor1	chr17	75800762	75800906	DNA/hAT-Charlie	905	+	72	75800834	4337
chr17	75796497	75996497	harbor1	chr17	75801223	75801349	DNA/hAT-Charlie	577	+	63	75801286	4789
chr17	75796497	75996497	harbor1	chr17	75802557	75802844	DNA/hAT-Charlie	1229	+	144	75802701	6204
chr17	75796497	75996497	harbor1	chr17	75803450	75804175	DNA/hAT-Charlie	3818	+	362	75803812	7315
chr17	75796497	75996497	harbor1	chr17	75804473	75804555	DNA/hAT-Charlie	3818	+	41	75804514	8017
chr17	75796497	75996497	harbor1	chr17	75804851	75804910	DNA/hAT-Charlie	3818	+	30	75804881	8384
chr17	75796497	75996497	harbor1	chr17	75805422	75805512	DNA/hAT-Charlie	731	+	45	75805467	8970
chr17	75796497	75996497	harbor1	chr17	75805846	75805957	DNA/hAT-Charlie	731	+	56	75805902	9405
chr17	46417069	46617069	harbor1	chr17	46433436	46433660	DNA/hAT-Charlie	687	+	112	46433548	16479
chr17	46417069	46617069	harbor1	chr17	46452471	46452578	DNA/hAT-Charlie	487	+	54	46452525	35456
chr17	46417069	46617069	harbor1	chr17	46479209	46479409	DNA/hAT-Charlie	699	+	100	46479309	62240
chr17	46417069	46617069	harbor1	chr17	46488007	46488424	DNA/hAT-Charlie	3517	+	208	46488215	71146
chr17	46417069	46617069	harbor1	chr17	46488719	46488818	DNA/hAT-Charlie	3517	+	50	46488769	71700
chr17	42164946	42364946	harbor1	chr17	42260039	42260165	DNA/hAT-Charlie	680	+	63	42260102	95156
chr17	42164946	42364946	harbor1	chr17	42260175	42260413	DNA/hAT-Charlie	1388	+	119	42260294	95348
chr17	42164946	42364946	harbor1	chr17	42260678	42260848	DNA/hAT-Charlie	1388	+	85	42260763	95817
chr17	8708227	8908227	harbor1	chr17	8733860	8734328	DNA/hAT-Charlie	1857	+	234	8734094	25867
chr17	8708227	8908227	harbor1	chr17	8734821	8734997	DNA/hAT-Charlie	766	+	88	8734909	26682
chr17	8708227	8908227	harbor1	chr17	8788850	8789074	DNA/hAT-Charlie	655	+	112	8788962	80735
chr17	54145149	54345149	harbor1	chr17	54176363	54176481	DNA/hAT-Charlie	501	+	59	54176422	31273
chr17	35179891	35379891	harbor1	chr17	35256832	35257153	DNA/hAT-Charlie	1931	+	160	35256992	77101
chr17	53787733	53987733	harbor1	chr17	53793840	53794034	DNA/hAT-Charlie	557	+	97	53793937	6204
chr17	53787733	53987733	harbor1	chr17	53820055	53820240	DNA/hAT-Charlie	866	+	92	53820147	32414
chr17	53787733	53987733	harbor1	chr17	53825246	53825400	DNA/hAT-Charlie	841	+	77	53825323	37590
chr17	53787733	53987733	harbor1	chr17	53825721	53825799	DNA/hAT-Charlie	841	+	39	53825760	38027
chr17	53787733	53987733	harbor1	chr17	53882694	53882891	DNA/hAT-Charlie	613	+	98	53882792	95059
chr17	53984220	54184220	harbor1	chr17	54011872	54012066	DNA/hAT-Charlie	734	+	97	54011969	27749
chr17	45854010	46054010	harbor1	chr17	45859220	45859293	DNA/hAT-Charlie	933	+	36	45859256	5246
chr17	45854010	46054010	harbor1	chr17	45859607	45859727	DNA/hAT-Charlie	933	+	60	45859667	5657
chr17	45854010	46054010	harbor1	chr17	45889857	45890014	DNA/hAT-Charlie	548	+	78	45889935	35925
chr17	45854010	46054010	harbor1	chr17	45899158	45899344	DNA/hAT-Charlie	776	+	93	45899251	45241
chr17	15715815	15915815	harbor1	chr17	15719229	15719393	DNA/hAT-Charlie	643	+	82	15719311	3496
chr17	15715815	15915815	harbor1	chr17	15752158	15752318	DNA/hAT-Charlie	602	+	80	15752238	36423
chr17	70902390	71102390	harbor1	chr17	70912379	70912572	DNA/hAT-Charlie	1129	+	96	70912475	10085
chr17	70902390	71102390	harbor1	chr17	70912656	70912753	DNA/hAT-Charlie	1129	+	48	70912704	10314
chr17	70902390	71102390	harbor1	chr17	70936629	70936847	DNA/hAT-Charlie	696	+	109	70936738	34348
chr17	70902390	71102390	harbor1	chr17	70955423	70955857	DNA/hAT-Charlie	502	+	217	70955640	53250
chr17	70902390	71102390	harbor1	chr17	70961865	70962202	DNA/hAT-Charlie	990	+	168	70962033	59643
chr17	70902390	71102390	harbor1	chr17	70976620	70976818	DNA/hAT-Charlie	878	+	99	70976719	74329
chr17	70902390	71102390	harbor1	chr17	70976826	70977023	DNA/hAT-Charlie	841	+	98	70976924	74534
chr17	63352799	63552799	harbor1	chr17	63367296	63367516	DNA/hAT-Charlie	1491	+	110	63367406	14607
chr17	63352799	63552799	harbor1	chr17	63431332	63431812	DNA/hAT-Charlie	3140	+	240	63431572	78773
chr17	7106342	7306342	harbor1	chr17	7201328	7201532	DNA/hAT-Charlie	808	+	102	7201430	95088
chr17	55569191	55769191	harbor1	chr17	55571722	55571929	DNA/hAT-Charlie	678	+	104	55571826	2635
chr17	55569191	55769191	harbor1	chr17	55611910	55612130	DNA/hAT-Charlie	1477	+	110	55612020	42829
chr17	55569191	55769191	harbor1	chr17	55639860	55640058	DNA/hAT-Charlie	908	+	99	55639959	70768
chr17	12267707	12467707	harbor1	chr17	12290566	12290740	DNA/hAT-Charlie	498	+	87	12290653	22946
chr17	12267707	12467707	harbor1	chr17	12318388	12318583	DNA/hAT-Charlie	716	+	98	12318486	50779
chr17	5177369	5377369	harbor1	chr17	5179672	5179965	DNA/hAT-Charlie	764	+	146	5179818	2449
chr17	5177369	5377369	harbor1	chr17	5197952	5198209	DNA/hAT-Charlie	1348	+	128	5198080	20711
chr17	5177369	5377369	harbor1	chr17	5198576	5198888	DNA/hAT-Charlie	1859	+	156	5198732	21363
chr17	5177369	5377369	harbor1	chr17	5247692	5248153	DNA/hAT-Charlie	3019	+	230	5247922	70553
chr17	5177369	5377369	harbor1	chr17	5263543	5263698	DNA/hAT-Charlie	841	+	78	5263621	86252
chr17	15603045	15803045	harbor1	chr17	15611325	15611623	DNA/hAT-Charlie	703	+	149	15611474	8429
chr17	15603045	15803045	harbor1	chr17	15617973	15618047	DNA/hAT-Charlie	699	+	37	15618010	14965
chr17	15603045	15803045	harbor1	chr17	15618341	15618455	DNA/hAT-Charlie	699	+	57	15618398	15353
chr17	15603045	15803045	harbor1	chr17	15658510	15658646	DNA/hAT-Charlie	489	+	68	15658578	55533
chr17	15603045	15803045	harbor1	chr17	15667096	15667542	DNA/hAT-Charlie	1841	+	223	15667319	64274
chr17	15603045	15803045	harbor1	chr17	15690277	15690536	DNA/hAT-Charlie	1147	+	130	15690407	87362
chr17	15603045	15803045	harbor1	chr17	15690839	15690887	DNA/hAT-Charlie	1147	+	24	15690863	87818
chr17	66116854	66316854	harbor1	chr17	66215288	66215453	DNA/hAT-Charlie	831	+	82	66215370	98516
chr17	2033096	2233096	harbor1	chr17	2038435	2038744	DNA/hAT-Charlie	1797	+	154	2038589	5493
chr17	55405051	55605051	harbor1	chr17	55412814	55412940	DNA/hAT-Charlie	576	+	63	55412877	7826
chr17	55405051	55605051	harbor1	chr17	55427858	55428251	DNA/hAT-Charlie	2114	+	196	55428054	23003
chr17	55405051	55605051	harbor1	chr17	55439156	55439311	DNA/hAT-Charlie	745	+	78	55439234	34183
chr17	55405051	55605051	harbor1	chr17	55439335	55439506	DNA/hAT-Charlie	1059	+	86	55439421	34370
chr17	55405051	55605051	harbor1	chr17	55441592	55441805	DNA/hAT-Charlie	1140	+	106	55441698	36647
chr17	55405051	55605051	harbor1	chr17	55443099	55443309	DNA/hAT-Charlie	673	+	105	55443204	38153
chr17	44381467	44581467	harbor1	chr17	44420171	44420284	DNA/hAT-Charlie	487	+	56	44420227	38760
chr17	44381467	44581467	harbor1	chr17	44420606	44420792	DNA/hAT-Charlie	571	+	93	44420699	39232
chr17	39481929	39681929	harbor1	chr17	39509050	39509180	DNA/hAT-Charlie	538	+	65	39509115	27186
chr17	50966884	51166884	harbor1	chr17	50985075	50985274	DNA/hAT-Charlie	731	+	100	50985175	18291
chr17	50966884	51166884	harbor1	chr17	50986132	50986326	DNA/hAT-Charlie	749	+	97	50986229	19345
chr17	50966884	51166884	harbor1	chr17	51022394	51022541	DNA/hAT-Charlie	574	+	74	51022468	55584
chr17	50966884	51166884	harbor1	chr17	51043445	51043611	DNA/hAT-Charlie	503	+	83	51043528	76644
chr17	50966884	51166884	harbor1	chr17	51057521	51058261	DNA/hAT-Charlie	941	+	370	51057891	91007
chr17	50966884	51166884	harbor1	chr17	51058517	51058579	DNA/hAT-Charlie	941	+	31	51058548	91664
chr17	79927268	80127268	harbor1	chr17	79994769	79995007	DNA/hAT-Charlie	506	+	119	79994888	67620
chr17	79927268	80127268	harbor1	chr17	79998860	79998973	DNA/hAT-Charlie	910	+	56	79998916	71648
chr17	79927268	80127268	harbor1	chr17	79999270	79999396	DNA/hAT-Charlie	910	+	63	79999333	72065
chr17	46278017	46478017	harbor1	chr17	46303010	46303195	DNA/hAT-Charlie	710	+	92	46303102	25085
chr17	46278017	46478017	harbor1	chr17	46305773	46305984	DNA/hAT-Charlie	1011	+	106	46305879	27862
chr17	56047537	56247537	harbor1	chr17	56066320	56066581	DNA/hAT-Charlie	1302	+	130	56066450	18913
chr17	56047537	56247537	harbor1	chr17	56067302	56067393	DNA/hAT-Charlie	1302	+	46	56067348	19811
chr17	56047537	56247537	harbor1	chr17	56087690	56087899	DNA/hAT-Charlie	904	+	104	56087794	40257
chr17	56047537	56247537	harbor1	chr17	56101530	56101706	DNA/hAT-Charlie	545	+	88	56101618	54081
chr17	56047537	56247537	harbor1	chr17	56105806	56106018	DNA/hAT-Charlie	721	+	106	56105912	58375
chr17	11647981	11847981	harbor1	chr17	11647814	11648000	DNA/hAT-Charlie	847	+	93	11647907	74
chr17	11647981	11847981	harbor1	chr17	11682645	11682802	DNA/hAT-Charlie	728	+	78	11682723	34742
chr17	11647981	11847981	harbor1	chr17	11692580	11692921	DNA/hAT-Charlie	1648	+	170	11692750	44769
chr17	11647981	11847981	harbor1	chr17	11693212	11693237	DNA/hAT-Charlie	1648	+	12	11693224	45243
chr17	11647981	11847981	harbor1	chr17	11693559	11693710	DNA/hAT-Charlie	1648	+	76	11693635	45654
chr17	11647981	11847981	harbor1	chr17	11726340	11726518	DNA/hAT-Charlie	575	+	89	11726429	78448
chr17	11647981	11847981	harbor1	chr17	11734126	11734266	DNA/hAT-Charlie	785	+	70	11734196	86215
chr17	72984408	73184408	harbor1	chr17	72984519	72984689	DNA/hAT-Charlie	796	+	85	72984604	196
chr17	72984408	73184408	harbor1	chr17	72986572	72986715	DNA/hAT-Charlie	627	+	72	72986644	2236
chr17	72984408	73184408	harbor1	chr17	73006349	73006568	DNA/hAT-Charlie	768	+	110	73006459	22051
chr17	72984408	73184408	harbor1	chr17	73013585	73013781	DNA/hAT-Charlie	1184	+	98	73013683	29275
chr17	72984408	73184408	harbor1	chr17	73031980	73032203	DNA/hAT-Charlie	1160	+	112	73032092	47684
chr17	71541085	71741085	harbor1	chr17	71635542	71635748	DNA/hAT-Charlie	833	+	103	71635645	94560
chr17	15502708	15702708	harbor1	chr17	15539073	15539250	DNA/hAT-Charlie	786	+	88	15539161	36453
chr17	15502708	15702708	harbor1	chr17	15547906	15548154	DNA/hAT-Charlie	808	+	124	15548030	45322
chr17	15502708	15702708	harbor1	chr17	15548465	15548506	DNA/hAT-Charlie	808	+	20	15548485	45777
chr17	15502708	15702708	harbor1	chr17	15548504	15548713	DNA/hAT-Charlie	1302	+	104	15548608	45900
chr17	15502708	15702708	harbor1	chr17	15549022	15549179	DNA/hAT-Charlie	1302	+	78	15549100	46392
chr17	15502708	15702708	harbor1	chr17	15551569	15551786	DNA/hAT-Charlie	1514	+	108	15551677	48969
chr17	15502708	15702708	harbor1	chr17	15599238	15599454	DNA/hAT-Charlie	1156	+	108	15599346	96638
chr17	62933694	63133694	harbor1	chr17	62964135	62964280	DNA/hAT-Charlie	524	+	72	62964207	30513
chr17	62933694	63133694	harbor1	chr17	62971650	62971967	DNA/hAT-Charlie	1863	+	158	62971808	38114
chr17	62933694	63133694	harbor1	chr17	62973727	62974058	DNA/hAT-Charlie	1509	+	166	62973893	40199
chr17	62933694	63133694	harbor1	chr17	62999574	62999737	DNA/hAT-Charlie	983	+	82	62999656	65962
chr17	68656542	68856542	harbor1	chr17	68737272	68737447	DNA/hAT-Charlie	917	+	88	68737360	80818
chr17	42975210	43175210	harbor1	chr17	43052141	43052278	DNA/hAT-Charlie	898	+	68	43052209	76999
chr17	42975210	43175210	harbor1	chr17	43052445	43052508	DNA/hAT-Charlie	898	+	32	43052477	77267
chr17	31677766	31877766	harbor1	chr17	31705103	31705242	DNA/hAT-Charlie	607	+	70	31705173	27407
chr17	31677766	31877766	harbor1	chr17	31747389	31747507	DNA/hAT-Charlie	502	+	59	31747448	69682
chr17	31677766	31877766	harbor1	chr17	31748964	31749171	DNA/hAT-Charlie	943	+	104	31749068	71302
chr17	31677766	31877766	harbor1	chr17	31749896	31750055	DNA/hAT-Charlie	747	+	80	31749976	72210
chr17	49787107	49987107	harbor1	chr17	49797557	49797851	DNA/hAT-Charlie	841	+	147	49797704	10597
chr17	49787107	49987107	harbor1	chr17	49834666	49834778	DNA/hAT-Charlie	528	+	56	49834722	47615
chr17	49787107	49987107	harbor1	chr17	49835027	49835186	DNA/hAT-Charlie	528	+	80	49835107	48000
chr17	70890380	71090380	harbor1	chr17	70912379	70912572	DNA/hAT-Charlie	1129	+	96	70912475	22095
chr17	70890380	71090380	harbor1	chr17	70912656	70912753	DNA/hAT-Charlie	1129	+	48	70912704	22324
chr17	70890380	71090380	harbor1	chr17	70936629	70936847	DNA/hAT-Charlie	696	+	109	70936738	46358
chr17	70890380	71090380	harbor1	chr17	70955423	70955857	DNA/hAT-Charlie	502	+	217	70955640	65260
chr17	70890380	71090380	harbor1	chr17	70961865	70962202	DNA/hAT-Charlie	990	+	168	70962033	71653
chr17	70890380	71090380	harbor1	chr17	70976620	70976818	DNA/hAT-Charlie	878	+	99	70976719	86339
chr17	70890380	71090380	harbor1	chr17	70976826	70977023	DNA/hAT-Charlie	841	+	98	70976924	86544
chr17	20244798	20444798	harbor1	chr17	20280573	20280766	DNA/hAT-Charlie	988	+	96	20280669	35871
chr17	20244798	20444798	harbor1	chr17	20299915	20300097	DNA/hAT-Charlie	746	+	91	20300006	55208
chr17	37748822	37948822	harbor1	chr17	37755843	37755988	DNA/hAT-Charlie	961	+	72	37755915	7093
chr17	37748822	37948822	harbor1	chr17	37778580	37778650	DNA/hAT-Charlie	488	+	35	37778615	29793
chr17	37748822	37948822	harbor1	chr17	37833451	37833595	DNA/hAT-Charlie	666	+	72	37833523	84701
chr17	37748822	37948822	harbor1	chr17	37835990	37836203	DNA/hAT-Charlie	978	+	106	37836096	87274
chr17	58148256	58348256	harbor1	chr17	58166209	58166363	DNA/hAT-Charlie	758	+	77	58166286	18030
chr17	58148256	58348256	harbor1	chr17	58239706	58239864	DNA/hAT-Charlie	865	+	79	58239785	91529
chr17	58148256	58348256	harbor1	chr17	58247165	58247367	DNA/hAT-Charlie	1300	+	101	58247266	99010
chr17	9276099	9476099	harbor1	chr17	9341119	9341255	DNA/hAT-Charlie	515	+	68	9341187	65088
chr17	9276099	9476099	harbor1	chr17	9344895	9345147	DNA/hAT-Charlie	487	+	126	9345021	68922
chr17	9276099	9476099	harbor1	chr17	9345450	9345498	DNA/hAT-Charlie	487	+	24	9345474	69375
chr17	9276099	9476099	harbor1	chr17	9365139	9365394	DNA/hAT-Charlie	698	+	128	9365267	89168
chr17	46705895	46905895	harbor1	chr17	46705721	46706138	DNA/hAT-Charlie	3498	+	208	46705929	34
chr17	46705895	46905895	harbor1	chr17	46706432	46706531	DNA/hAT-Charlie	3498	+	50	46706482	587
chr17	45716242	45916242	harbor1	chr17	45754625	45754976	DNA/hAT-Charlie	1269	+	176	45754801	38559
chr17	45716242	45916242	harbor1	chr17	45780677	45780774	DNA/hAT-Charlie	575	+	48	45780725	64483
chr17	45716242	45916242	harbor1	chr17	45781086	45781203	DNA/hAT-Charlie	575	+	58	45781144	64902
chr17	19770894	19970894	harbor1	chr17	19820503	19820658	DNA/hAT-Charlie	817	+	78	19820581	49687
chr17	19770894	19970894	harbor1	chr17	19865108	19865277	DNA/hAT-Charlie	503	+	84	19865192	94298
chr17	22327966	22527966	harbor1	chr17	22367794	22367967	DNA/hAT-Charlie	499	+	86	22367880	39914
chr17	22320892	22520892	harbor1	chr17	22367794	22367967	DNA/hAT-Charlie	499	+	86	22367880	46988
chr17	46789698	46989698	harbor1	chr17	46830768	46830994	DNA/hAT-Charlie	773	+	113	46830881	41183
chr17	67333299	67533299	harbor1	chr17	67336878	67337054	DNA/hAT-Charlie	686	+	88	67336966	3667
chr17	67333299	67533299	harbor1	chr17	67357794	67357916	DNA/hAT-Charlie	603	+	61	67357855	24556
chr17	67333299	67533299	harbor1	chr17	67358221	67358285	DNA/hAT-Charlie	603	+	32	67358253	24954
chr17	67333299	67533299	harbor1	chr17	67358598	67358724	DNA/hAT-Charlie	603	+	63	67358661	25362
chr17	67333299	67533299	harbor1	chr17	67414508	67414675	DNA/hAT-Charlie	840	+	84	67414592	81293
chr17	4530503	4730503	harbor1	chr17	4553424	4553730	DNA/hAT-Charlie	1181	+	153	4553577	23074
chr17	4530503	4730503	harbor1	chr17	4563336	4563505	DNA/hAT-Charlie	644	+	84	4563420	32917
chr17	22106778	22306778	harbor1	chr17	22133524	22134648	DNA/hAT-Charlie	4254	+	562	22134086	27308
chr17	22106778	22306778	harbor1	chr17	22134948	22135263	DNA/hAT-Charlie	4254	+	158	22135106	28328
chr17	32501399	32701399	harbor1	chr17	32537261	32537478	DNA/hAT-Charlie	1300	+	108	32537369	35970
chr17	32501399	32701399	harbor1	chr17	32557798	32557891	DNA/hAT-Charlie	613	+	46	32557844	56445
chr17	33996929	34196929	harbor1	chr17	34009316	34009640	DNA/hAT-Charlie	1564	+	162	34009478	12549
chr17	33996929	34196929	harbor1	chr17	34066311	34066491	DNA/hAT-Charlie	790	+	90	34066401	69472
chr17	33996929	34196929	harbor1	chr17	34074059	34074236	DNA/hAT-Charlie	914	+	88	34074147	77218
chr17	9965586	10165586	harbor1	chr17	9968308	9968466	DNA/hAT-Charlie	649	+	79	9968387	2801
chr17	9965586	10165586	harbor1	chr17	10017629	10017854	DNA/hAT-Charlie	1084	+	112	10017741	52155
chr17	7486706	7686706	harbor1	chr17	7489329	7489784	DNA/hAT-Charlie	1746	+	228	7489557	2851
chr17	7486706	7686706	harbor1	chr17	7490077	7490165	DNA/hAT-Charlie	1746	+	44	7490121	3415
chr17	29811746	30011746	harbor1	chr17	29862967	29863200	DNA/hAT-Charlie	992	+	116	29863083	51337
chr17	29811746	30011746	harbor1	chr17	29864794	29864970	DNA/hAT-Charlie	957	+	88	29864882	53136
chr17	69182244	69382244	harbor1	chr17	69220753	69220958	DNA/hAT-Charlie	1052	+	102	69220855	38611
chr17	69182244	69382244	harbor1	chr17	69236749	69236927	DNA/hAT-Charlie	1006	+	89	69236838	54594
chr17	9056494	9256494	harbor1	chr17	9105987	9106091	DNA/hAT-Charlie	547	+	52	9106039	49545
chr17	9056494	9256494	harbor1	chr17	9107653	9107872	DNA/hAT-Charlie	1293	+	110	9107763	51269
chr17	9056494	9256494	harbor1	chr17	9134476	9134622	DNA/hAT-Charlie	489	+	73	9134549	78055
chr17	16729059	16929059	harbor1	chr17	16752053	16752390	DNA/hAT-Charlie	2228	+	168	16752221	23162
chr17	16729059	16929059	harbor1	chr17	16789824	16790138	DNA/hAT-Charlie	528	+	157	16789981	60922
chr17	16729059	16929059	harbor1	chr17	16798851	16798901	DNA/hAT-Charlie	654	+	25	16798876	69817
chr17	16729059	16929059	harbor1	chr17	16799217	16799355	DNA/hAT-Charlie	654	+	69	16799286	70227
chr17	16729059	16929059	harbor1	chr17	16804605	16804940	DNA/hAT-Charlie	1890	+	168	16804773	75714
chr17	16729059	16929059	harbor1	chr17	16813793	16814112	DNA/hAT-Charlie	996	+	160	16813953	84894
chr17	79909137	80109137	harbor1	chr17	79994769	79995007	DNA/hAT-Charlie	506	+	119	79994888	85751
chr17	79909137	80109137	harbor1	chr17	79998860	79998973	DNA/hAT-Charlie	910	+	56	79998916	89779
chr17	79909137	80109137	harbor1	chr17	79999270	79999396	DNA/hAT-Charlie	910	+	63	79999333	90196
chr17	31177298	31377298	harbor1	chr17	31193112	31193283	DNA/hAT-Charlie	668	+	86	31193198	15900
chr17	40003806	40203806	harbor1	chr17	40041866	40042082	DNA/hAT-Charlie	828	+	108	40041974	38168
chr17	40003806	40203806	harbor1	chr17	40048235	40048425	DNA/hAT-Charlie	819	+	95	40048330	44524
chr17	40003806	40203806	harbor1	chr17	40048406	40048544	DNA/hAT-Charlie	517	+	69	40048475	44669
chr17	37943282	38143282	harbor1	chr17	37995023	37995140	DNA/hAT-Charlie	586	+	58	37995081	51799
chr17	37943282	38143282	harbor1	chr17	37995440	37995591	DNA/hAT-Charlie	586	+	76	37995516	52234
chr17	56651249	56851249	harbor1	chr17	56668019	56668511	DNA/hAT-Charlie	3695	+	246	56668265	17016
chr17	56651249	56851249	harbor1	chr17	56668508	56668956	DNA/hAT-Charlie	3264	+	224	56668732	17483
chr17	56651249	56851249	harbor1	chr17	56709443	56709674	DNA/hAT-Charlie	730	+	116	56709559	58310
chr17	56651249	56851249	harbor1	chr17	56709901	56710061	DNA/hAT-Charlie	548	+	80	56709981	58732
chr17	27380691	27580691	harbor1	chr17	27454369	27454561	DNA/hAT-Charlie	791	+	96	27454465	73774
chr17	19786486	19986486	harbor1	chr17	19820503	19820658	DNA/hAT-Charlie	817	+	78	19820581	34095
chr17	19786486	19986486	harbor1	chr17	19865108	19865277	DNA/hAT-Charlie	503	+	84	19865192	78706
chr17	19786486	19986486	harbor1	chr17	19875740	19875873	DNA/hAT-Charlie	583	+	66	19875806	89320
chr17	66139623	66339623	harbor1	chr17	66215288	66215453	DNA/hAT-Charlie	831	+	82	66215370	75747
chr17	66139623	66339623	harbor1	chr17	66221871	66222039	DNA/hAT-Charlie	793	+	84	66221955	82332
chr17	70909182	71109182	harbor1	chr17	70912379	70912572	DNA/hAT-Charlie	1129	+	96	70912475	3293
chr17	70909182	71109182	harbor1	chr17	70912656	70912753	DNA/hAT-Charlie	1129	+	48	70912704	3522
chr17	70909182	71109182	harbor1	chr17	70936629	70936847	DNA/hAT-Charlie	696	+	109	70936738	27556
chr17	70909182	71109182	harbor1	chr17	70955423	70955857	DNA/hAT-Charlie	502	+	217	70955640	46458
chr17	70909182	71109182	harbor1	chr17	70961865	70962202	DNA/hAT-Charlie	990	+	168	70962033	52851
chr17	70909182	71109182	harbor1	chr17	70976620	70976818	DNA/hAT-Charlie	878	+	99	70976719	67537
chr17	70909182	71109182	harbor1	chr17	70976826	70977023	DNA/hAT-Charlie	841	+	98	70976924	67742
chr17	45932555	46132555	harbor1	chr17	45954050	45954360	DNA/hAT-Charlie	1518	+	155	45954205	21650
chr17	45932555	46132555	harbor1	chr17	45985410	45985637	DNA/hAT-Charlie	706	+	114	45985524	52969
chr17	45932555	46132555	harbor1	chr17	46016796	46016910	DNA/hAT-Charlie	605	+	57	46016853	84298
chr17	43941403	44141403	harbor1	chr17	43979141	43979335	DNA/hAT-Charlie	892	+	97	43979238	37835
chr17	9897832	10097832	harbor1	chr17	9920527	9920689	DNA/hAT-Charlie	548	+	81	9920608	22776
chr17	9897832	10097832	harbor1	chr17	9930051	9930231	DNA/hAT-Charlie	582	+	90	9930141	32309
chr17	9897832	10097832	harbor1	chr17	9954588	9954813	DNA/hAT-Charlie	1102	+	112	9954700	56868
chr17	9897832	10097832	harbor1	chr17	9968308	9968466	DNA/hAT-Charlie	649	+	79	9968387	70555
chr17	14493502	14693502	harbor1	chr17	14573238	14573389	DNA/hAT-Charlie	723	+	76	14573314	79812
chr17	3650975	3850975	harbor1	chr17	3701139	3701347	DNA/hAT-Charlie	1332	+	104	3701243	50268
chr17	3650975	3850975	harbor1	chr17	3706906	3707134	DNA/hAT-Charlie	651	+	114	3707020	56045
chr17	3650975	3850975	harbor1	chr17	3738542	3738736	DNA/hAT-Charlie	866	+	97	3738639	87664
chr17	76309489	76509489	harbor1	chr17	76368530	76368731	DNA/hAT-Charlie	982	+	100	76368630	59141
chr17	44521766	44721766	harbor1	chr17	44535346	44535562	DNA/hAT-Charlie	1043	+	108	44535454	13688
chr17	44521766	44721766	harbor1	chr17	44571756	44571969	DNA/hAT-Charlie	642	+	106	44571862	50096
chr17	44521766	44721766	harbor1	chr17	44604381	44604571	DNA/hAT-Charlie	702	+	95	44604476	82710
chr17	69142312	69342312	harbor1	chr17	69178375	69178558	DNA/hAT-Charlie	922	+	92	69178467	36155
chr17	69142312	69342312	harbor1	chr17	69220753	69220958	DNA/hAT-Charlie	1052	+	102	69220855	78543
chr17	69142312	69342312	harbor1	chr17	69236749	69236927	DNA/hAT-Charlie	1006	+	89	69236838	94526
chr17	29820474	30020474	harbor1	chr17	29862967	29863200	DNA/hAT-Charlie	992	+	116	29863083	42609
chr17	29820474	30020474	harbor1	chr17	29864794	29864970	DNA/hAT-Charlie	957	+	88	29864882	44408
chr17	16215482	16415482	harbor1	chr17	16297839	16298134	DNA/hAT-Charlie	1906	+	148	16297987	82505
chr17	45583272	45783272	harbor1	chr17	45676162	45676343	DNA/hAT-Charlie	766	+	90	45676252	92980
chr17	45583272	45783272	harbor1	chr17	45676365	45676511	DNA/hAT-Charlie	496	+	73	45676438	93166
chr17	40904185	41104185	harbor1	chr17	40914060	40914210	DNA/hAT-Charlie	867	+	75	40914135	9950
chr17	54447618	54647618	harbor1	chr17	54468015	54468168	DNA/hAT-Charlie	648	+	76	54468091	20473
chr17	54447618	54647618	harbor1	chr17	54470928	54471828	DNA/hAT-Charlie	3160	+	450	54471378	23760
chr17	54447618	54647618	harbor1	chr17	54496867	54497082	DNA/hAT-Charlie	967	+	108	54496975	49357
chr17	54447618	54647618	harbor1	chr17	54497080	54497218	DNA/hAT-Charlie	523	+	69	54497149	49531
chr17	54447618	54647618	harbor1	chr17	54501657	54501830	DNA/hAT-Charlie	800	+	86	54501743	54125
chr17	27594861	27794861	harbor1	chr17	27627180	27627395	DNA/hAT-Charlie	1236	+	108	27627288	32427
chr17	27594861	27794861	harbor1	chr17	27636813	27637046	DNA/hAT-Charlie	824	+	116	27636929	42068
chr17	27594861	27794861	harbor1	chr17	27665042	27665486	DNA/hAT-Charlie	866	+	222	27665264	70403
chr17	5886404	6086404	harbor1	chr17	5887247	5887490	DNA/hAT-Charlie	1051	+	122	5887369	965
chr17	5886404	6086404	harbor1	chr17	5893558	5893770	DNA/hAT-Charlie	1162	+	106	5893664	7260
chr17	5886404	6086404	harbor1	chr17	5982514	5982829	DNA/hAT-Charlie	1412	+	158	5982672	96268
chr17	5886404	6086404	harbor1	chr17	5983827	5984867	DNA/hAT-Charlie	4411	+	520	5984347	97943
chr17	36968946	37168946	harbor1	chr17	37052564	37052833	DNA/hAT-Charlie	544	+	134	37052698	83752
chr17	36968946	37168946	harbor1	chr17	37052818	37053597	DNA/hAT-Charlie	2790	+	390	37053208	84262
chr17	36968946	37168946	harbor1	chr17	37053874	37054031	DNA/hAT-Charlie	2790	+	78	37053952	85006
chr17	29631516	29831516	harbor1	chr17	29667385	29667678	DNA/hAT-Charlie	1897	+	146	29667531	36015
chr17	29631516	29831516	harbor1	chr17	29682335	29682491	DNA/hAT-Charlie	858	+	78	29682413	50897
chr17	29631516	29831516	harbor1	chr17	29692776	29692954	DNA/hAT-Charlie	683	+	89	29692865	61349
chr17	29631516	29831516	harbor1	chr17	29694002	29694199	DNA/hAT-Charlie	1365	+	98	29694100	62584
chr17	29631516	29831516	harbor1	chr17	29717101	29717145	DNA/hAT-Charlie	492	+	22	29717123	85607
chr17	29631516	29831516	harbor1	chr17	29717436	29717560	DNA/hAT-Charlie	492	+	62	29717498	85982
chr17	73000928	73200928	harbor1	chr17	73006349	73006568	DNA/hAT-Charlie	768	+	110	73006459	5531
chr17	73000928	73200928	harbor1	chr17	73013585	73013781	DNA/hAT-Charlie	1184	+	98	73013683	12755
chr17	73000928	73200928	harbor1	chr17	73031980	73032203	DNA/hAT-Charlie	1160	+	112	73032092	31164
chr17	73000928	73200928	harbor1	chr17	73090963	73091122	DNA/hAT-Charlie	699	+	80	73091043	90115
chr17	71324586	71524586	harbor1	chr17	71350327	71350478	DNA/hAT-Charlie	751	+	76	71350403	25817
chr17	71324586	71524586	harbor1	chr17	71350509	71350559	DNA/hAT-Charlie	751	+	25	71350534	25948
chr17	71324586	71524586	harbor1	chr17	71376188	71376373	DNA/hAT-Charlie	975	+	92	71376280	51694
chr17	71324586	71524586	harbor1	chr17	71406696	71406890	DNA/hAT-Charlie	775	+	97	71406793	82207
chr17	76921341	77121341	harbor1	chr17	76951415	76951624	DNA/hAT-Charlie	654	+	104	76951519	30178
chr17	76921341	77121341	harbor1	chr17	76979500	76979602	DNA/hAT-Charlie	702	+	51	76979551	58210
chr17	76921341	77121341	harbor1	chr17	77002996	77003090	DNA/hAT-Charlie	570	+	47	77003043	81702
chr17	76177263	76377263	harbor1	chr17	76209386	76209606	DNA/hAT-Charlie	1478	+	110	76209496	32233
chr17	73480771	73680771	harbor1	chr17	73485564	73485891	DNA/hAT-Charlie	962	+	164	73485728	4957
chr17	73480771	73680771	harbor1	chr17	73487527	73487669	DNA/hAT-Charlie	638	+	71	73487598	6827
chr17	73480771	73680771	harbor1	chr17	73495283	73495495	DNA/hAT-Charlie	887	+	106	73495389	14618
chr17	73480771	73680771	harbor1	chr17	73532077	73532269	DNA/hAT-Charlie	891	+	96	73532173	51402
chr17	29403712	29603712	harbor1	chr17	29480982	29481195	DNA/hAT-Charlie	1106	+	106	29481088	77376
chr17	47383409	47583409	harbor1	chr17	47408715	47408903	DNA/hAT-Charlie	1032	+	94	47408809	25400
chr17	22527676	22727676	harbor1	chr17	22546420	22546792	DNA/hAT-Charlie	1799	+	186	22546606	18930
chr17	60226045	60426045	harbor1	chr17	60227100	60227258	DNA/hAT-Charlie	529	+	79	60227179	1134
chr17	60226045	60426045	harbor1	chr17	60227566	60227579	DNA/hAT-Charlie	529	+	6	60227572	1527
chr17	60226045	60426045	harbor1	chr17	60227711	60227762	DNA/hAT-Charlie	529	+	26	60227737	1692
chr17	9532773	9732773	harbor1	chr17	9580118	9580324	DNA/hAT-Charlie	1283	+	103	9580221	47448
chr17	9532773	9732773	harbor1	chr17	9585165	9585293	DNA/hAT-Charlie	725	+	64	9585229	52456
chr17	9532773	9732773	harbor1	chr17	9593306	9593435	DNA/hAT-Charlie	649	+	64	9593370	60597
chr17	57103266	57303266	harbor1	chr17	57119179	57119332	DNA/hAT-Charlie	772	+	76	57119255	15989
chr17	57103266	57303266	harbor1	chr17	57126822	57126981	DNA/hAT-Charlie	726	+	80	57126902	23636
chr17	57103266	57303266	harbor1	chr17	57130019	57130117	DNA/hAT-Charlie	550	+	49	57130068	26802
chr17	57103266	57303266	harbor1	chr17	57152755	57152898	DNA/hAT-Charlie	649	+	72	57152827	49561
chr17	12513426	12713426	harbor1	chr17	12517534	12517692	DNA/hAT-Charlie	736	+	79	12517613	4187
chr17	64603850	64803850	harbor1	chr17	64677550	64677733	DNA/hAT-Charlie	953	+	92	64677642	73792
chr17	56826075	57026075	harbor1	chr17	56826567	56826685	DNA/hAT-Charlie	568	+	59	56826626	551
chr17	56826075	57026075	harbor1	chr17	56827411	56827501	DNA/hAT-Charlie	490	+	45	56827456	1381
chr17	56826075	57026075	harbor1	chr17	56837039	56837112	DNA/hAT-Charlie	533	+	36	56837075	11000
chr17	56826075	57026075	harbor1	chr17	56878845	56878990	DNA/hAT-Charlie	774	+	72	56878917	52842
chr17	56826075	57026075	harbor1	chr17	56884848	56885114	DNA/hAT-Charlie	640	+	133	56884981	58906
chr17	56826075	57026075	harbor1	chr17	56896748	56896822	DNA/hAT-Charlie	755	+	37	56896785	70710
chr17	56826075	57026075	harbor1	chr17	56897121	56897237	DNA/hAT-Charlie	755	+	58	56897179	71104
chr17	56826075	57026075	harbor1	chr17	56898492	56898681	DNA/hAT-Charlie	493	+	94	56898586	72511
chr17	56826075	57026075	harbor1	chr17	56905434	56905676	DNA/hAT-Charlie	1148	+	121	56905555	79480
chr17	56826075	57026075	harbor1	chr17	56905982	56906061	DNA/hAT-Charlie	1148	+	40	56906022	79947
chr17	9740100	9940100	harbor1	chr17	9777692	9778049	DNA/hAT-Charlie	766	+	178	9777870	37770
chr17	9740100	9940100	harbor1	chr17	9815417	9815684	DNA/hAT-Charlie	685	+	134	9815551	75451
chr17	9740100	9940100	harbor1	chr17	9830591	9830924	DNA/hAT-Charlie	1705	+	166	9830757	90657
chr17	9740100	9940100	harbor1	chr17	9830923	9831041	DNA/hAT-Charlie	690	+	59	9830982	90882
chr17	46653259	46853259	harbor1	chr17	46670174	46670281	DNA/hAT-Charlie	526	+	54	46670228	16969
chr17	46653259	46853259	harbor1	chr17	46696904	46697111	DNA/hAT-Charlie	763	+	104	46697008	43749
chr17	46653259	46853259	harbor1	chr17	46705721	46706138	DNA/hAT-Charlie	3498	+	208	46705929	52670
chr17	46653259	46853259	harbor1	chr17	46706432	46706531	DNA/hAT-Charlie	3498	+	50	46706482	53223
chr17	37244261	37444261	harbor1	chr17	37336983	37337133	DNA/hAT-Charlie	729	+	75	37337058	92797
chr17	40271155	40471155	harbor1	chr17	40290324	40290498	DNA/hAT-Charlie	1004	+	87	40290411	19256
chr17	40271155	40471155	harbor1	chr17	40360522	40360744	DNA/hAT-Charlie	988	+	111	40360633	89478
chr18	42738455	42938455	harbor1	chr18	42821455	42821667	DNA/hAT-Charlie	906	+	106	42821561	83106
chr18	35210360	35410360	harbor1	chr18	35269634	35269749	DNA/hAT-Charlie	497	+	58	35269692	59332
chr18	35210360	35410360	harbor1	chr18	35280479	35281081	DNA/hAT-Charlie	1040	+	301	35280780	70420
chr18	35210360	35410360	harbor1	chr18	35289777	35289936	DNA/hAT-Charlie	665	+	80	35289857	79497
chr18	35210360	35410360	harbor1	chr18	35301286	35301454	DNA/hAT-Charlie	622	+	84	35301370	91010
chr18	41901500	42101500	harbor1	chr18	41952653	41953172	DNA/hAT-Charlie	1079	+	260	41952913	51413
chr18	41901500	42101500	harbor1	chr18	41959048	41959172	DNA/hAT-Charlie	417	+	62	41959110	57610
chr18	56818500	57018500	harbor1	chr18	56892476	56892691	DNA/hAT-Charlie	1014	+	108	56892584	74084
chr18	54461882	54661882	harbor1	chr18	54488839	54489141	DNA/hAT-Charlie	1230	+	151	54488990	27108
chr18	54461882	54661882	harbor1	chr18	54490278	54490598	DNA/hAT-Charlie	1485	+	160	54490438	28556
chr18	54461882	54661882	harbor1	chr18	54516775	54516916	DNA/hAT-Charlie	408	+	70	54516845	54963
chr18	13467190	13667190	harbor1	chr18	13478172	13478306	DNA/hAT-Charlie	435	+	67	13478239	11049
chr18	50337984	50537984	harbor1	chr18	50391394	50391594	DNA/hAT-Charlie	1031	+	100	50391494	53510
chr18	50337984	50537984	harbor1	chr18	50431795	50431962	DNA/hAT-Charlie	877	+	84	50431879	93895
chr18	50337984	50537984	harbor1	chr18	50431963	50432458	DNA/hAT-Charlie	3430	+	248	50432211	94227
chr18	50337984	50537984	harbor1	chr18	50432464	50432530	DNA/hAT-Charlie	417	+	33	50432497	94513
chr18	42234288	42434288	harbor1	chr18	42299942	42300011	DNA/hAT-Charlie	576	+	34	42299976	65688
chr18	42234288	42434288	harbor1	chr18	42300299	42300430	DNA/hAT-Charlie	576	+	66	42300365	66077
chr18	37157020	37357020	harbor1	chr18	37166326	37166540	DNA/hAT-Charlie	1359	+	107	37166433	9413
chr18	37157020	37357020	harbor1	chr18	37183291	37183445	DNA/hAT-Charlie	435	+	77	37183368	26348
chr18	27078795	27278795	harbor1	chr18	27110813	27110994	DNA/hAT-Charlie	919	+	90	27110903	32108
chr18	27078795	27278795	harbor1	chr18	27135590	27135709	DNA/hAT-Charlie	538	+	60	27135650	56855
chr18	27078795	27278795	harbor1	chr18	27135966	27136151	DNA/hAT-Charlie	946	+	92	27136058	57263
chr18	27078795	27278795	harbor1	chr18	27142028	27142249	DNA/hAT-Charlie	1220	+	110	27142138	63343
chr18	7806814	8006814	harbor1	chr18	7825324	7825449	DNA/hAT-Charlie	431	+	62	7825386	18572
chr18	7806814	8006814	harbor1	chr18	7882073	7882370	DNA/hAT-Charlie	895	+	148	7882221	75407
chr18	7806814	8006814	harbor1	chr18	7887629	7887813	DNA/hAT-Charlie	760	+	92	7887721	80907
chr18	21516089	21716089	harbor1	chr18	21521591	21521721	DNA/hAT-Charlie	594	+	65	21521656	5567
chr18	21516089	21716089	harbor1	chr18	21522017	21522086	DNA/hAT-Charlie	594	+	34	21522051	5962
chr18	21516089	21716089	harbor1	chr18	21537681	21537838	DNA/hAT-Charlie	436	+	78	21537759	21670
chr18	21516089	21716089	harbor1	chr18	21568922	21569039	DNA/hAT-Charlie	625	+	58	21568980	52891
chr18	21516089	21716089	harbor1	chr18	21596271	21596344	DNA/hAT-Charlie	476	+	36	21596307	80218
chr18	21516089	21716089	harbor1	chr18	21597007	21597372	DNA/hAT-Charlie	1440	+	182	21597189	81100
chr18	21516089	21716089	harbor1	chr18	21597510	21597703	DNA/hAT-Charlie	880	+	96	21597606	81517
chr18	21516089	21716089	harbor1	chr18	21607809	21607913	DNA/hAT-Charlie	502	+	52	21607861	91772
chr18	21516089	21716089	harbor1	chr18	21608211	21608237	DNA/hAT-Charlie	502	+	13	21608224	92135
chr18	21516089	21716089	harbor1	chr18	21608543	21608576	DNA/hAT-Charlie	502	+	16	21608559	92470
chr18	21516089	21716089	harbor1	chr18	21609254	21609365	DNA/hAT-Charlie	473	+	56	21609310	93221
chr18	27730688	27930688	harbor1	chr18	27743996	27744163	DNA/hAT-Charlie	698	+	84	27744080	13392
chr18	27730688	27930688	harbor1	chr18	27794905	27795044	DNA/hAT-Charlie	564	+	70	27794975	64287
chr18	27730688	27930688	harbor1	chr18	27800303	27800481	DNA/hAT-Charlie	799	+	89	27800392	69704
chr18	40089458	40289458	harbor1	chr18	40170853	40171079	DNA/hAT-Charlie	915	+	113	40170966	81508
chr18	40089458	40289458	harbor1	chr18	40171430	40171512	DNA/hAT-Charlie	915	+	41	40171471	82013
chr18	63463590	63663590	harbor1	chr18	63486609	63486820	DNA/hAT-Charlie	936	+	106	63486715	23125
chr18	63463590	63663590	harbor1	chr18	63509261	63509416	DNA/hAT-Charlie	462	+	78	63509339	45749
chr18	63463590	63663590	harbor1	chr18	63509682	63509740	DNA/hAT-Charlie	462	+	29	63509711	46121
chr18	63463590	63663590	harbor1	chr18	63510041	63510127	DNA/hAT-Charlie	462	+	43	63510084	46494
chr18	80045975	80245975	harbor1	chr18	80057662	80058012	DNA/hAT-Charlie	2262	+	175	80057837	11862
chr18	80045975	80245975	harbor1	chr18	80076058	80076575	DNA/hAT-Charlie	3350	+	258	80076316	30341
chr18	80045975	80245975	harbor1	chr18	80125174	80125255	DNA/hAT-Charlie	634	+	40	80125214	79239
chr18	80045975	80245975	harbor1	chr18	80125819	80125995	DNA/hAT-Charlie	634	+	88	80125907	79932
chr18	80045975	80245975	harbor1	chr18	80135156	80135479	DNA/hAT-Charlie	1262	+	162	80135318	89343
chr18	35931463	36131463	harbor1	chr18	35941683	35941824	DNA/hAT-Charlie	434	+	70	35941753	10290
chr18	35931463	36131463	harbor1	chr18	35954366	35954397	DNA/hAT-Charlie	731	+	16	35954382	22919
chr18	35931463	36131463	harbor1	chr18	35954688	35954837	DNA/hAT-Charlie	731	+	74	35954762	23299
chr18	35931463	36131463	harbor1	chr18	35961966	35962311	DNA/hAT-Charlie	2361	+	172	35962138	30675
chr18	35931463	36131463	harbor1	chr18	35988703	35988824	DNA/hAT-Charlie	450	+	60	35988763	57300
chr18	35931463	36131463	harbor1	chr18	35989306	35989453	DNA/hAT-Charlie	924	+	74	35989380	57917
chr18	35931463	36131463	harbor1	chr18	35989643	35989686	DNA/hAT-Charlie	924	+	22	35989665	58202
chr18	35931463	36131463	harbor1	chr18	36009692	36009881	DNA/hAT-Charlie	1024	+	94	36009786	78323
chr18	77509509	77709509	harbor1	chr18	77586898	77587067	DNA/hAT-Charlie	692	+	84	77586982	77473
chr18	714665	914665	harbor1	chr18	737646	737735	DNA/hAT-Charlie	407	+	44	737690	23025
chr18	714665	914665	harbor1	chr18	785079	785267	DNA/hAT-Charlie	1347	+	94	785173	70508
chr18	37467285	37667285	harbor1	chr18	37525858	37526051	DNA/hAT-Charlie	749	+	96	37525954	58669
chr18	37467285	37667285	harbor1	chr18	37531367	37531688	DNA/hAT-Charlie	1033	+	160	37531527	64242
chr18	37467285	37667285	harbor1	chr18	37539649	37539862	DNA/hAT-Charlie	632	+	106	37539755	72470
chr18	52895766	53095766	harbor1	chr18	52915901	52916049	DNA/hAT-Charlie	404	+	74	52915975	20209
chr18	52895766	53095766	harbor1	chr18	52916023	52917000	DNA/hAT-Charlie	3870	+	488	52916511	20745
chr18	52895766	53095766	harbor1	chr18	52917331	52917495	DNA/hAT-Charlie	3870	+	82	52917413	21647
chr18	52895766	53095766	harbor1	chr18	52939948	52940123	DNA/hAT-Charlie	782	+	88	52940036	44270
chr18	52895766	53095766	harbor1	chr18	52944596	52944773	DNA/hAT-Charlie	420	+	88	52944684	48918
chr18	52895766	53095766	harbor1	chr18	52945774	52946074	DNA/hAT-Charlie	618	+	150	52945924	50158
chr18	52895766	53095766	harbor1	chr18	52958874	52959089	DNA/hAT-Charlie	1438	+	108	52958982	63216
chr18	54816422	55016422	harbor1	chr18	54905709	54906212	DNA/hAT-Charlie	3408	+	252	54905961	89539
chr18	60020517	60220517	harbor1	chr18	60020497	60020672	DNA/hAT-Charlie	581	+	88	60020585	68
chr18	60020517	60220517	harbor1	chr18	60104915	60105075	DNA/hAT-Charlie	697	+	80	60104995	84478
chr18	7142668	7342668	harbor1	chr18	7159924	7160047	DNA/hAT-Charlie	619	+	62	7159986	17318
chr18	7142668	7342668	harbor1	chr18	7160036	7160185	DNA/hAT-Charlie	615	+	74	7160110	17442
chr18	7142668	7342668	harbor1	chr18	7160194	7160331	DNA/hAT-Charlie	669	+	68	7160262	17594
chr18	21118813	21318813	harbor1	chr18	21135036	21135212	DNA/hAT-Charlie	774	+	88	21135124	16311
chr18	21118813	21318813	harbor1	chr18	21177460	21177568	DNA/hAT-Charlie	457	+	54	21177514	58701
chr18	21118813	21318813	harbor1	chr18	21177848	21177969	DNA/hAT-Charlie	457	+	60	21177908	59095
chr18	21118813	21318813	harbor1	chr18	21217407	21217450	DNA/hAT-Charlie	548	+	22	21217429	98616
chr18	21118813	21318813	harbor1	chr18	21217754	21217968	DNA/hAT-Charlie	548	+	107	21217861	99048
chr18	54700461	54900461	harbor1	chr18	54770173	54770690	DNA/hAT-Charlie	3365	+	258	54770431	69970
chr18	54700461	54900461	harbor1	chr18	54779632	54779727	DNA/hAT-Charlie	469	+	48	54779680	79219
chr18	54700461	54900461	harbor1	chr18	54780757	54780850	DNA/hAT-Charlie	432	+	46	54780803	80342
chr18	46854643	47054643	harbor1	chr18	46856563	46856726	DNA/hAT-Charlie	768	+	82	46856645	2002
chr18	46854643	47054643	harbor1	chr18	46937545	46937663	DNA/hAT-Charlie	491	+	59	46937604	82961
chr18	49904717	50104717	harbor1	chr18	49933536	49933753	DNA/hAT-Charlie	1182	+	108	49933644	28927
chr18	49904717	50104717	harbor1	chr18	49953590	49953692	DNA/hAT-Charlie	465	+	51	49953641	48924
chr18	49904717	50104717	harbor1	chr18	49982604	49982797	DNA/hAT-Charlie	839	+	96	49982700	77983
chr18	49904717	50104717	harbor1	chr18	49999705	49999894	DNA/hAT-Charlie	1009	+	94	49999799	95082
chr19	47482549	47682549	harbor1	chr19	47556610	47556745	DNA/hAT-Charlie	928	+	68	47556678	74129
chr19	47482549	47682549	harbor1	chr19	47557058	47557175	DNA/hAT-Charlie	928	+	58	47557116	74567
chr19	47482549	47682549	harbor1	chr19	47565351	47565878	DNA/hAT-Charlie	1286	+	264	47565615	83066
chr19	47482549	47682549	harbor1	chr19	47570609	47570794	DNA/hAT-Charlie	686	+	92	47570701	88152
chr19	28445798	28645798	harbor1	chr19	28463064	28463395	DNA/hAT-Charlie	1192	+	166	28463230	17432
chr19	28445798	28645798	harbor1	chr19	28541789	28541991	DNA/hAT-Charlie	945	+	101	28541890	96092
chr19	41216457	41416457	harbor1	chr19	41236853	41237058	DNA/hAT-Charlie	1443	+	102	41236955	20498
chr19	41216457	41416457	harbor1	chr19	41245932	41246161	DNA/hAT-Charlie	1055	+	114	41246046	29589
chr19	13154689	13354689	harbor1	chr19	13173571	13173858	DNA/hAT-Charlie	944	+	144	13173715	19026
chr19	13154689	13354689	harbor1	chr19	13176360	13176666	DNA/hAT-Charlie	1438	+	153	13176513	21824
chr19	13154689	13354689	harbor1	chr19	13231376	13231560	DNA/hAT-Charlie	856	+	92	13231468	76779
chr19	7060625	7260625	harbor1	chr19	7069950	7070173	DNA/hAT-Charlie	912	+	112	7070062	9437
chr19	7060625	7260625	harbor1	chr19	7140288	7140498	DNA/hAT-Charlie	938	+	105	7140393	79768
chr19	7060625	7260625	harbor1	chr19	7156418	7156637	DNA/hAT-Charlie	717	+	110	7156528	95903
chr19	656527	856527	harbor1	chr19	707462	707683	DNA/hAT-Charlie	1285	+	110	707572	51045
chr19	49773314	49973314	harbor1	chr19	49838175	49839413	DNA/hAT-Charlie	3934	+	619	49838794	65480
chr19	49773314	49973314	harbor1	chr19	49839486	49840475	DNA/hAT-Charlie	3257	+	494	49839980	66666
chr19	14273712	14473712	harbor1	chr19	14345767	14345853	DNA/hAT-Charlie	932	+	43	14345810	72098
chr19	14273712	14473712	harbor1	chr19	14346161	14346224	DNA/hAT-Charlie	932	+	32	14346193	72481
chr19	14273712	14473712	harbor1	chr19	14346360	14346441	DNA/hAT-Charlie	932	+	40	14346400	72688
chr19	37808839	38008839	harbor1	chr19	37834040	37834236	DNA/hAT-Charlie	1008	+	98	37834138	25299
chr19	3958548	4158548	harbor1	chr19	4050564	4050815	DNA/hAT-Charlie	790	+	126	4050690	92142
chr19	41079508	41279508	harbor1	chr19	41111730	41111946	DNA/hAT-Charlie	759	+	108	41111838	32330
chr19	41079508	41279508	harbor1	chr19	41169202	41169468	DNA/hAT-Charlie	935	+	133	41169335	89827
chr19	37626247	37826247	harbor1	chr19	37646391	37646553	DNA/hAT-Charlie	873	+	81	37646472	20225
chr19	37626247	37826247	harbor1	chr19	37646896	37647037	DNA/hAT-Charlie	873	+	70	37646966	20719
chr19	16555131	16755131	harbor1	chr19	16607653	16607838	DNA/hAT-Charlie	1248	+	92	16607745	52614
chr19	16555131	16755131	harbor1	chr19	16608679	16608842	DNA/hAT-Charlie	788	+	82	16608761	53630
chr19	16555131	16755131	harbor1	chr19	16654468	16654542	DNA/hAT-Charlie	1378	+	37	16654505	99374
chr19	16555131	16755131	harbor1	chr19	16654681	16654938	DNA/hAT-Charlie	1378	+	128	16654809	99678
chr19	7562915	7762915	harbor1	chr19	7583266	7583481	DNA/hAT-Charlie	1122	+	108	7583374	20459
chr19	7562915	7762915	harbor1	chr19	7600993	7601307	DNA/hAT-Charlie	1050	+	157	7601150	38235
chr19	7562915	7762915	harbor1	chr19	7602106	7602326	DNA/hAT-Charlie	946	+	110	7602216	39301
chr19	35210497	35410497	harbor1	chr19	35285392	35285597	DNA/hAT-Charlie	1253	+	102	35285494	74997
chr19	56325301	56525301	harbor1	chr19	56408302	56408500	DNA/hAT-Charlie	918	+	99	56408401	83100
chr19	56325301	56525301	harbor1	chr19	56421063	56421240	DNA/hAT-Charlie	653	+	88	56421151	95850
chr19	52143326	52343326	harbor1	chr19	52197057	52197340	DNA/hAT-Charlie	701	+	142	52197199	53873
chr19	52143326	52343326	harbor1	chr19	52199527	52199739	DNA/hAT-Charlie	782	+	106	52199633	56307
chr19	53925332	54125332	harbor1	chr19	53947902	53948344	DNA/hAT-Charlie	1312	+	221	53948123	22791
chr19	53925332	54125332	harbor1	chr19	53948624	53948670	DNA/hAT-Charlie	1312	+	23	53948647	23315
chr19	53925332	54125332	harbor1	chr19	53956414	53956643	DNA/hAT-Charlie	1148	+	114	53956528	31196
chr19	13676657	13876657	harbor1	chr19	13749305	13749571	DNA/hAT-Charlie	1138	+	133	13749438	72781
chr19	41571189	41771189	harbor1	chr19	41595140	41595299	DNA/hAT-Charlie	686	+	80	41595220	24031
chr19	41571189	41771189	harbor1	chr19	41647879	41648102	DNA/hAT-Charlie	823	+	112	41647991	76802
chr19	40965245	41165245	harbor1	chr19	41051504	41051799	DNA/hAT-Charlie	932	+	148	41051652	86407
chr19	34554775	34754775	harbor1	chr19	34631275	34631434	DNA/hAT-Charlie	971	+	80	34631355	76580
chr19	38936056	39136056	harbor1	chr19	38998845	38999062	DNA/hAT-Charlie	988	+	108	38998953	62897
chr19	28035407	28235407	harbor1	chr19	28134348	28134627	DNA/hAT-Charlie	746	+	140	28134488	99081
chr19	4011150	4211150	harbor1	chr19	4050564	4050815	DNA/hAT-Charlie	790	+	126	4050690	39540
chr19	36376642	36576642	harbor1	chr19	36419046	36419255	DNA/hAT-Charlie	1272	+	104	36419150	42508
chr19	36376642	36576642	harbor1	chr19	36420226	36420269	DNA/hAT-Charlie	1272	+	22	36420248	43606
chr19	36376642	36576642	harbor1	chr19	36450740	36450937	DNA/hAT-Charlie	898	+	98	36450838	74196
chr19	55466121	55666121	harbor1	chr19	55494073	55494280	DNA/hAT-Charlie	899	+	104	55494177	28056
chr19	55466121	55666121	harbor1	chr19	55513614	55513825	DNA/hAT-Charlie	1041	+	106	55513720	47599
chr19	55466121	55666121	harbor1	chr19	55562286	55562517	DNA/hAT-Charlie	1339	+	116	55562402	96281
chr19	5910858	6110858	harbor1	chr19	5927399	5927595	DNA/hAT-Charlie	654	+	98	5927497	16639
chr19	5910858	6110858	harbor1	chr19	5969991	5970213	DNA/hAT-Charlie	768	+	111	5970102	59244
chr19	5910858	6110858	harbor1	chr19	5970455	5970670	DNA/hAT-Charlie	707	+	108	5970563	59705
chr19	5910858	6110858	harbor1	chr19	5973344	5973565	DNA/hAT-Charlie	859	+	110	5973454	62596
chr19	5910858	6110858	harbor1	chr19	5980257	5980520	DNA/hAT-Charlie	946	+	132	5980389	69531
chr19	5910858	6110858	harbor1	chr19	5997758	5997942	DNA/hAT-Charlie	683	+	92	5997850	86992
chr19	5910858	6110858	harbor1	chr19	6004504	6004708	DNA/hAT-Charlie	669	+	102	6004606	93748
chr19	7218773	7418773	harbor1	chr19	7225769	7225979	DNA/hAT-Charlie	751	+	105	7225874	7101
chr19	7218773	7418773	harbor1	chr19	7266987	7267209	DNA/hAT-Charlie	1203	+	111	7267098	48325
chr19	7218773	7418773	harbor1	chr19	7289799	7289963	DNA/hAT-Charlie	688	+	82	7289881	71108
chr19	7218773	7418773	harbor1	chr19	7241679	7241846	DNA/hAT-Charlie	775	+	84	7241763	22990
chr19	14975828	15175828	harbor1	chr19	14977247	14977467	DNA/hAT-Charlie	1232	+	110	14977357	1529
chr19	14975828	15175828	harbor1	chr19	15031187	15031407	DNA/hAT-Charlie	1035	+	110	15031297	55469
chr19	14975828	15175828	harbor1	chr19	15059343	15059562	DNA/hAT-Charlie	1055	+	110	15059453	83625
chr19	50805796	51005796	harbor1	chr19	50846922	50847005	DNA/hAT-Charlie	1756	+	42	50846964	41168
chr19	50805796	51005796	harbor1	chr19	50847316	50847663	DNA/hAT-Charlie	1756	+	174	50847490	41694
chr19	50805796	51005796	harbor1	chr19	50847970	50847980	DNA/hAT-Charlie	1756	+	5	50847975	42179
chr19	50805796	51005796	harbor1	chr19	50848280	50848342	DNA/hAT-Charlie	1756	+	31	50848311	42515
chr19	29189802	29389802	harbor1	chr19	29201505	29201635	DNA/hAT-Charlie	670	+	65	29201570	11768
chr19	34654273	34854273	harbor1	chr19	34661720	34661870	DNA/hAT-Charlie	1529	+	75	34661795	7522
chr19	34654273	34854273	harbor1	chr19	34662180	34662263	DNA/hAT-Charlie	1529	+	42	34662222	7949
chr19	34654273	34854273	harbor1	chr19	34680325	34680539	DNA/hAT-Charlie	846	+	107	34680432	26159
chr19	34654273	34854273	harbor1	chr19	34736550	34736769	DNA/hAT-Charlie	989	+	110	34736660	82387
chr19	35796805	35996805	harbor1	chr19	35828187	35828254	DNA/hAT-Charlie	1270	+	34	35828221	31416
chr19	35796805	35996805	harbor1	chr19	35828564	35828827	DNA/hAT-Charlie	1270	+	132	35828696	31891
chr19	35796805	35996805	harbor1	chr19	35859232	35859441	DNA/hAT-Charlie	1588	+	104	35859336	62531
chr19	55633364	55833364	harbor1	chr19	55639114	55639306	DNA/hAT-Charlie	987	+	96	55639210	5846
chr19	55633364	55833364	harbor1	chr19	55681470	55681658	DNA/hAT-Charlie	901	+	94	55681564	48200
chr19	28530660	28730660	harbor1	chr19	28541789	28541991	DNA/hAT-Charlie	945	+	101	28541890	11230
chr19	50968686	51168686	harbor1	chr19	51008553	51008838	DNA/hAT-Charlie	773	+	142	51008695	40009
chr19	50968686	51168686	harbor1	chr19	51021025	51021211	DNA/hAT-Charlie	721	+	93	51021118	52432
chr19	39817801	40017801	harbor1	chr19	39880661	39880829	DNA/hAT-Charlie	638	+	84	39880745	62944
chr19	39817801	40017801	harbor1	chr19	39896912	39897080	DNA/hAT-Charlie	638	+	84	39896996	79195
chr19	39817801	40017801	harbor1	chr19	39909732	39909902	DNA/hAT-Charlie	796	+	85	39909817	92016
chr19	39817801	40017801	harbor1	chr19	39910195	39910261	DNA/hAT-Charlie	796	+	33	39910228	92427
chr19	33134650	33334650	harbor1	chr19	33155748	33155929	DNA/hAT-Charlie	823	+	90	33155838	21188
chr19	38125761	38325761	harbor1	chr19	38126379	38126538	DNA/hAT-Charlie	817	+	80	38126459	698
chr19	38125761	38325761	harbor1	chr19	38126836	38126849	DNA/hAT-Charlie	817	+	6	38126842	1081
chr19	5837695	6037695	harbor1	chr19	5927399	5927595	DNA/hAT-Charlie	654	+	98	5927497	89802
chr19	8304944	8504944	harbor1	chr19	8347808	8348014	DNA/hAT-Charlie	855	+	103	8347911	42967
chr19	56196735	56396735	harbor1	chr19	56264615	56264796	DNA/hAT-Charlie	995	+	90	56264705	67970
chr19	56196735	56396735	harbor1	chr19	56290256	56290445	DNA/hAT-Charlie	949	+	94	56290350	93615
chr19	56196735	56396735	harbor1	chr19	56293683	56293905	DNA/hAT-Charlie	1057	+	111	56293794	97059
chr19	32762850	32962850	harbor1	chr19	32767859	32768196	DNA/hAT-Charlie	1419	+	168	32768027	5177
chr19	17675571	17875571	harbor1	chr19	17767608	17767847	DNA/hAT-Charlie	921	+	120	17767728	92157
chr19	53303709	53503709	harbor1	chr19	53324993	53325324	DNA/hAT-Charlie	2109	+	166	53325159	21450
chr19	56394621	56594621	harbor1	chr19	56408302	56408500	DNA/hAT-Charlie	918	+	99	56408401	13780
chr19	56394621	56594621	harbor1	chr19	56421063	56421240	DNA/hAT-Charlie	653	+	88	56421151	26530
chr19	56394621	56594621	harbor1	chr19	56432610	56432774	DNA/hAT-Charlie	827	+	82	56432692	38071
chr19	56394621	56594621	harbor1	chr19	56443906	56444135	DNA/hAT-Charlie	916	+	114	56444020	49399
chr19	56394621	56594621	harbor1	chr19	56463934	56464242	DNA/hAT-Charlie	1164	+	154	56464088	69467
chr19	56394621	56594621	harbor1	chr19	56464519	56464620	DNA/hAT-Charlie	749	+	50	56464569	69948
chr19	56394621	56594621	harbor1	chr19	56473533	56473745	DNA/hAT-Charlie	1130	+	106	56473639	79018
chr19	56394621	56594621	harbor1	chr19	56475458	56475686	DNA/hAT-Charlie	960	+	114	56475572	80951
chr19	6990165	7190165	harbor1	chr19	7069950	7070173	DNA/hAT-Charlie	912	+	112	7070062	79897
chr19	17314753	17514753	harbor1	chr19	17399930	17399962	DNA/hAT-Charlie	678	+	16	17399946	85193
chr19	17314753	17514753	harbor1	chr19	17400255	17400344	DNA/hAT-Charlie	678	+	44	17400299	85546
chr19	17314753	17514753	harbor1	chr19	17400659	17400742	DNA/hAT-Charlie	678	+	42	17400701	85948
chr19	53393358	53593358	harbor1	chr19	53426511	53426841	DNA/hAT-Charlie	1983	+	165	53426676	33318
chr19	33332835	33532835	harbor1	chr19	33365779	33366108	DNA/hAT-Charlie	1780	+	164	33365943	33108
chr19	13614302	13814302	harbor1	chr19	13640834	13640973	DNA/hAT-Charlie	724	+	70	13640904	26602
chr19	13614302	13814302	harbor1	chr19	13648622	13648791	DNA/hAT-Charlie	877	+	84	13648706	34404
chr19	13614302	13814302	harbor1	chr19	13649452	13649810	DNA/hAT-Charlie	1513	+	179	13649631	35329
chr19	13614302	13814302	harbor1	chr19	13669899	13670488	DNA/hAT-Charlie	2104	+	294	13670193	55891
chr19	37696421	37896421	harbor1	chr19	37759863	37760109	DNA/hAT-Charlie	648	+	123	37759986	63565
chr19	20823878	21023878	harbor1	chr19	20922581	20922868	DNA/hAT-Charlie	1192	+	144	20922725	98847
chr19	22500253	22700253	harbor1	chr19	22593060	22593226	DNA/hAT-Charlie	768	+	83	22593143	92890
chr19	32079229	32279229	harbor1	chr19	32170169	32170341	DNA/hAT-Charlie	720	+	86	32170255	91026
chr19	33481664	33681664	harbor1	chr19	33516687	33516921	DNA/hAT-Charlie	845	+	117	33516804	35140
chr19	50999784	51199784	harbor1	chr19	51008553	51008838	DNA/hAT-Charlie	773	+	142	51008695	8911
chr19	50999784	51199784	harbor1	chr19	51021025	51021211	DNA/hAT-Charlie	721	+	93	51021118	21334
chr19	50999784	51199784	harbor1	chr19	51072271	51072491	DNA/hAT-Charlie	765	+	110	51072381	72597
chr19	50999784	51199784	harbor1	chr19	51095499	51095797	DNA/hAT-Charlie	1028	+	149	51095648	95864
chr19	55947572	56147572	harbor1	chr19	55952966	55953447	DNA/hAT-Charlie	3508	+	240	55953206	5634
chr19	55947572	56147572	harbor1	chr19	55957136	55957342	DNA/hAT-Charlie	933	+	103	55957239	9667
chr19	55947572	56147572	harbor1	chr19	55992591	55992775	DNA/hAT-Charlie	649	+	92	55992683	45111
chr19	55947572	56147572	harbor1	chr19	56024830	56025326	DNA/hAT-Charlie	3395	+	248	56025078	77506
chr19	36439830	36639830	harbor1	chr19	36450740	36450937	DNA/hAT-Charlie	898	+	98	36450838	11008
chr19	36439830	36639830	harbor1	chr19	36522509	36522674	DNA/hAT-Charlie	756	+	82	36522591	82761
chr19	43581101	43781101	harbor1	chr19	43587390	43587624	DNA/hAT-Charlie	1365	+	117	43587507	6406
chr19	43581101	43781101	harbor1	chr19	43587928	43588036	DNA/hAT-Charlie	1365	+	54	43587982	6881
chr19	43581101	43781101	harbor1	chr19	43601118	43601332	DNA/hAT-Charlie	1102	+	107	43601225	20124
chr19	43581101	43781101	harbor1	chr19	43649773	43650008	DNA/hAT-Charlie	1666	+	118	43649891	68790
chr19	43581101	43781101	harbor1	chr19	43650625	43650752	DNA/hAT-Charlie	1666	+	64	43650689	69588
chr19	43581101	43781101	harbor1	chr19	43651050	43651074	DNA/hAT-Charlie	1666	+	12	43651062	69961
chr19	43581101	43781101	harbor1	chr19	43651375	43651437	DNA/hAT-Charlie	1666	+	31	43651406	70305
chr19	43581101	43781101	harbor1	chr19	43651736	43651791	DNA/hAT-Charlie	1666	+	28	43651764	70663
chr19	32259246	32459246	harbor1	chr19	32305062	32305229	DNA/hAT-Charlie	831	+	84	32305146	45900
chr19	20918264	21118264	harbor1	chr19	20922581	20922868	DNA/hAT-Charlie	1192	+	144	20922725	4461
chr19	28409130	28609130	harbor1	chr19	28411047	28411249	DNA/hAT-Charlie	761	+	101	28411148	2018
chr19	28409130	28609130	harbor1	chr19	28439329	28439463	DNA/hAT-Charlie	743	+	67	28439396	30266
chr19	28409130	28609130	harbor1	chr19	28463064	28463395	DNA/hAT-Charlie	1192	+	166	28463230	54100
chr19	30991070	31191070	harbor1	chr19	31008978	31009147	DNA/hAT-Charlie	914	+	84	31009062	17992
chr19	30991070	31191070	harbor1	chr19	31011554	31012150	DNA/hAT-Charlie	3392	+	298	31011852	20782
chr19	30991070	31191070	harbor1	chr19	31019388	31019585	DNA/hAT-Charlie	745	+	98	31019486	28416
chr19	42950171	43150171	harbor1	chr19	42973381	42973594	DNA/hAT-Charlie	1280	+	106	42973487	23316
chr19	42345833	42545833	harbor1	chr19	42440827	42441055	DNA/hAT-Charlie	930	+	114	42440941	95108
chr19	50589266	50789266	harbor1	chr19	50684577	50685035	DNA/hAT-Charlie	1437	+	229	50684806	95540
chr19	40991912	41191912	harbor1	chr19	41051504	41051799	DNA/hAT-Charlie	932	+	148	41051652	59740
chr19	30168394	30368394	harbor1	chr19	30259396	30259567	DNA/hAT-Charlie	888	+	86	30259482	91088
chr19	49521314	49721314	harbor1	chr19	49563921	49564090	DNA/hAT-Charlie	759	+	84	49564005	42691
chr19	49521314	49721314	harbor1	chr19	49602937	49603142	DNA/hAT-Charlie	912	+	102	49603039	81725
chr19	21071426	21271426	harbor1	chr19	21081523	21081784	DNA/hAT-Charlie	640	+	130	21081653	10227
chr19	21071426	21271426	harbor1	chr19	21141338	21141627	DNA/hAT-Charlie	818	+	144	21141482	70056
chr19	6810243	7010243	harbor1	chr19	6899191	6899390	DNA/hAT-Charlie	1069	+	100	6899291	89048
chr19	44988977	45188977	harbor1	chr19	45082921	45083072	DNA/hAT-Charlie	668	+	76	45082997	94020
chr19	44988977	45188977	harbor1	chr19	45085391	45085565	DNA/hAT-Charlie	685	+	87	45085478	96501
chr19	47474313	47674313	harbor1	chr19	47481588	47481802	DNA/hAT-Charlie	1225	+	107	47481695	7382
chr19	47474313	47674313	harbor1	chr19	47556610	47556745	DNA/hAT-Charlie	928	+	68	47556678	82365
chr19	47474313	47674313	harbor1	chr19	47557058	47557175	DNA/hAT-Charlie	928	+	58	47557116	82803
chr19	47474313	47674313	harbor1	chr19	47565351	47565878	DNA/hAT-Charlie	1286	+	264	47565615	91302
chr19	47474313	47674313	harbor1	chr19	47570609	47570794	DNA/hAT-Charlie	686	+	92	47570701	96388
chr19	29137626	29337626	harbor1	chr19	29142011	29142210	DNA/hAT-Charlie	1019	+	100	29142111	4485
chr19	29137626	29337626	harbor1	chr19	29153260	29153442	DNA/hAT-Charlie	1040	+	91	29153351	15725
chr19	29137626	29337626	harbor1	chr19	29201505	29201635	DNA/hAT-Charlie	670	+	65	29201570	63944
chr19	8751329	8951329	harbor1	chr19	8795182	8795375	DNA/hAT-Charlie	1353	+	96	8795278	43949
chr19	21992273	22192273	harbor1	chr19	22051005	22051089	DNA/hAT-Charlie	741	+	42	22051047	58774
chr19	21992273	22192273	harbor1	chr19	22051388	22051591	DNA/hAT-Charlie	741	+	102	22051490	59217
chr19	5880368	6080368	harbor1	chr19	5927399	5927595	DNA/hAT-Charlie	654	+	98	5927497	47129
chr19	5880368	6080368	harbor1	chr19	5969991	5970213	DNA/hAT-Charlie	768	+	111	5970102	89734
chr19	5880368	6080368	harbor1	chr19	5970455	5970670	DNA/hAT-Charlie	707	+	108	5970563	90195
chr19	5880368	6080368	harbor1	chr19	5973344	5973565	DNA/hAT-Charlie	859	+	110	5973454	93086
chr19	9449408	9649408	harbor1	chr19	9472328	9472878	DNA/hAT-Charlie	3124	+	275	9472603	23195
chr19	9449408	9649408	harbor1	chr19	9484340	9484495	DNA/hAT-Charlie	817	+	78	9484418	35010
chr19	15225501	15425501	harbor1	chr19	15278143	15278252	DNA/hAT-Charlie	1151	+	54	15278197	52696
chr19	15225501	15425501	harbor1	chr19	15278572	15278777	DNA/hAT-Charlie	1151	+	102	15278674	53173
chr19	40713154	40913154	harbor1	chr19	40731138	40731438	DNA/hAT-Charlie	1763	+	150	40731288	18134
chr19	42426741	42626741	harbor1	chr19	42440827	42441055	DNA/hAT-Charlie	930	+	114	42440941	14200
chr19	34694532	34894532	harbor1	chr19	34736550	34736769	DNA/hAT-Charlie	989	+	110	34736660	42128
chr19	21100068	21300068	harbor1	chr19	21141338	21141627	DNA/hAT-Charlie	818	+	144	21141482	41414
chr19	34483331	34683331	harbor1	chr19	34546717	34547055	DNA/hAT-Charlie	2140	+	169	34546886	63555
chr19	4482298	4682298	harbor1	chr19	4515586	4515791	DNA/hAT-Charlie	1047	+	102	4515688	33390
chr19	41158657	41358657	harbor1	chr19	41169202	41169468	DNA/hAT-Charlie	935	+	133	41169335	10678
chr19	41158657	41358657	harbor1	chr19	41236853	41237058	DNA/hAT-Charlie	1443	+	102	41236955	78298
chr19	41158657	41358657	harbor1	chr19	41245932	41246161	DNA/hAT-Charlie	1055	+	114	41246046	87389
chr19	16914335	17114335	harbor1	chr19	16951262	16951592	DNA/hAT-Charlie	1441	+	165	16951427	37092
chr19	16914335	17114335	harbor1	chr19	16969285	16969441	DNA/hAT-Charlie	845	+	78	16969363	55028
chr19	16914335	17114335	harbor1	chr19	16978523	16978711	DNA/hAT-Charlie	729	+	94	16978617	64282
chr19	16914335	17114335	harbor1	chr19	16979865	16980078	DNA/hAT-Charlie	760	+	106	16979971	65636
chr19	16914335	17114335	harbor1	chr19	16988739	16989275	DNA/hAT-Charlie	3613	+	268	16989007	74672
chr19	56362587	56562587	harbor1	chr19	56408302	56408500	DNA/hAT-Charlie	918	+	99	56408401	45814
chr19	56362587	56562587	harbor1	chr19	56421063	56421240	DNA/hAT-Charlie	653	+	88	56421151	58564
chr19	56362587	56562587	harbor1	chr19	56432610	56432774	DNA/hAT-Charlie	827	+	82	56432692	70105
chr19	56362587	56562587	harbor1	chr19	56443906	56444135	DNA/hAT-Charlie	916	+	114	56444020	81433
chr19	7722928	7922928	harbor1	chr19	7733322	7733439	DNA/hAT-Charlie	978	+	58	7733380	10452
chr19	7722928	7922928	harbor1	chr19	7733209	7733287	DNA/hAT-Charlie	978	+	39	7733248	10320
chr19	57180036	57380036	harbor1	chr19	57245411	57245497	DNA/hAT-Charlie	758	+	43	57245454	65418
chr19	57180036	57380036	harbor1	chr19	57245793	57245945	DNA/hAT-Charlie	758	+	76	57245869	65833
chr19	53241691	53441691	harbor1	chr19	53324993	53325324	DNA/hAT-Charlie	2109	+	166	53325159	83468
chr19	33204124	33404124	harbor1	chr19	33236420	33236529	DNA/hAT-Charlie	766	+	54	33236474	32350
chr19	33204124	33404124	harbor1	chr19	33259922	33259983	DNA/hAT-Charlie	660	+	30	33259952	55828
chr19	33204124	33404124	harbor1	chr19	33260273	33260425	DNA/hAT-Charlie	660	+	76	33260349	56225
chr19	11291347	11491347	harbor1	chr19	11333998	11334146	DNA/hAT-Charlie	789	+	74	11334072	42725
chr19	22031557	22231557	harbor1	chr19	22051005	22051089	DNA/hAT-Charlie	741	+	42	22051047	19490
chr19	22031557	22231557	harbor1	chr19	22051388	22051591	DNA/hAT-Charlie	741	+	102	22051490	19933
chr19	36730255	36930255	harbor1	chr19	36810870	36811075	DNA/hAT-Charlie	1076	+	102	36810972	80717
chr19	51641907	51841907	harbor1	chr19	51722144	51722262	DNA/hAT-Charlie	657	+	59	51722203	80296
chr19	51641907	51841907	harbor1	chr19	51722265	51722515	DNA/hAT-Charlie	1080	+	125	51722390	80483
chr19	51641907	51841907	harbor1	chr19	51722542	51722827	DNA/hAT-Charlie	1159	+	142	51722684	80777
chr19	51641907	51841907	harbor1	chr19	51722828	51722960	DNA/hAT-Charlie	679	+	66	51722894	80987
chr19	6894692	7094692	harbor1	chr19	6899191	6899390	DNA/hAT-Charlie	1069	+	100	6899291	4599
chr19	6894692	7094692	harbor1	chr19	6916803	6916984	DNA/hAT-Charlie	642	+	90	6916893	22201
chr19	6894692	7094692	harbor1	chr19	6925443	6925664	DNA/hAT-Charlie	751	+	110	6925553	30861
chr19	6894692	7094692	harbor1	chr19	6933329	6933385	DNA/hAT-Charlie	774	+	28	6933357	38665
chr19	6894692	7094692	harbor1	chr19	6933687	6933867	DNA/hAT-Charlie	774	+	90	6933777	39085
chr19	6894692	7094692	harbor1	chr19	6941166	6941316	DNA/hAT-Charlie	699	+	75	6941241	46549
chr19	6894692	7094692	harbor1	chr19	6961910	6962105	DNA/hAT-Charlie	950	+	98	6962008	67316
chr19	6894692	7094692	harbor1	chr19	6976331	6976530	DNA/hAT-Charlie	853	+	100	6976431	81739
chr19	6894692	7094692	harbor1	chr19	6989681	6989945	DNA/hAT-Charlie	1082	+	132	6989813	95121
chr19	6570303	6770303	harbor1	chr19	6635563	6635765	DNA/hAT-Charlie	743	+	101	6635664	65361
chr19	46561691	46761691	harbor1	chr19	46588751	46588955	DNA/hAT-Charlie	665	+	102	46588853	27162
chr19	6756897	6956897	harbor1	chr19	6792759	6792947	DNA/hAT-Charlie	742	+	94	6792853	35956
chr19	1443478	1643478	harbor1	chr19	1494296	1494528	DNA/hAT-Charlie	797	+	116	1494412	50934
chr19	1443478	1643478	harbor1	chr19	1538724	1538937	DNA/hAT-Charlie	773	+	106	1538830	95352
chr19	49576415	49776415	harbor1	chr19	49602937	49603142	DNA/hAT-Charlie	912	+	102	49603039	26624
chr19	49576415	49776415	harbor1	chr19	49628054	49628237	DNA/hAT-Charlie	1392	+	92	49628146	51731
chr19	49576415	49776415	harbor1	chr19	49633482	49633556	DNA/hAT-Charlie	859	+	37	49633519	57104
chr19	49576415	49776415	harbor1	chr19	49633852	49633923	DNA/hAT-Charlie	859	+	36	49633888	57473
chr19	49576415	49776415	harbor1	chr19	49634564	49634628	DNA/hAT-Charlie	859	+	32	49634596	58181
chr19	49576415	49776415	harbor1	chr19	49660214	49660517	DNA/hAT-Charlie	1846	+	152	49660366	83951
chr19	41982887	42182887	harbor1	chr19	42012552	42012593	DNA/hAT-Charlie	978	+	20	42012572	29685
chr19	41982887	42182887	harbor1	chr19	42012885	42013069	DNA/hAT-Charlie	978	+	92	42012977	30090
chr19	41982887	42182887	harbor1	chr19	42016880	42017176	DNA/hAT-Charlie	876	+	148	42017028	34141
chr19	41982887	42182887	harbor1	chr19	42017273	42017534	DNA/hAT-Charlie	1065	+	130	42017403	34516
chr19	41982887	42182887	harbor1	chr19	42028754	42028897	DNA/hAT-Charlie	689	+	72	42028826	45939
chr19	18481957	18681957	harbor1	chr19	18562958	18563172	DNA/hAT-Charlie	1374	+	107	18563065	81108
chr19	48215829	48415829	harbor1	chr19	48227878	48228396	DNA/hAT-Charlie	3572	+	259	48228137	12308
chr19	48215829	48415829	harbor1	chr19	48314440	48314662	DNA/hAT-Charlie	891	+	111	48314551	98722
chr19	16630285	16830285	harbor1	chr19	16654468	16654542	DNA/hAT-Charlie	1378	+	37	16654505	24220
chr19	16630285	16830285	harbor1	chr19	16654681	16654938	DNA/hAT-Charlie	1378	+	128	16654809	24524
chr19	16630285	16830285	harbor1	chr19	16672829	16673040	DNA/hAT-Charlie	1155	+	106	16672935	42650
chr19	16630285	16830285	harbor1	chr19	16702780	16702892	DNA/hAT-Charlie	1013	+	56	16702836	72551
chr19	16630285	16830285	harbor1	chr19	16703204	16703323	DNA/hAT-Charlie	1013	+	60	16703264	72979
chr19	16630285	16830285	harbor1	chr19	16720506	16720562	DNA/hAT-Charlie	641	+	28	16720534	90249
chr19	16630285	16830285	harbor1	chr19	16721150	16721323	DNA/hAT-Charlie	641	+	86	16721236	90951
chr19	39765492	39965492	harbor1	chr19	39801967	39802177	DNA/hAT-Charlie	972	+	105	39802072	36580
chr19	39765492	39965492	harbor1	chr19	39803313	39803503	DNA/hAT-Charlie	746	+	95	39803408	37916
chr19	10662765	10862765	harbor1	chr19	10674964	10675171	DNA/hAT-Charlie	671	+	104	10675068	12303
chr19	10662765	10862765	harbor1	chr19	10690379	10690577	DNA/hAT-Charlie	677	+	99	10690478	27713
chr19	3556167	3756167	harbor1	chr19	3654440	3654533	DNA/hAT-Charlie	927	+	46	3654486	98319
chr19	3556167	3756167	harbor1	chr19	3655443	3655669	DNA/hAT-Charlie	927	+	113	3655556	99389
chr19	58241878	58441878	harbor1	chr19	58296689	58296898	DNA/hAT-Charlie	1034	+	104	58296793	54915
chr19	58241878	58441878	harbor1	chr19	58297815	58298018	DNA/hAT-Charlie	702	+	102	58297917	56039
chr19	58241878	58441878	harbor1	chr19	58298625	58298680	DNA/hAT-Charlie	702	+	28	58298653	56775
chr19	58241878	58441878	harbor1	chr19	58324387	58324598	DNA/hAT-Charlie	1476	+	106	58324493	82615
chr19	56915880	57115880	harbor1	chr19	56925077	56925214	DNA/hAT-Charlie	715	+	68	56925145	9265
chr19	56915880	57115880	harbor1	chr19	56925289	56925503	DNA/hAT-Charlie	872	+	107	56925396	9516
chr19	56915880	57115880	harbor1	chr19	56927841	56927996	DNA/hAT-Charlie	790	+	78	56927919	12039
chr19	56915880	57115880	harbor1	chr19	56933664	56933835	DNA/hAT-Charlie	683	+	86	56933750	17870
chr19	56915880	57115880	harbor1	chr19	56943020	56943245	DNA/hAT-Charlie	1007	+	112	56943132	27252
chr19	56915880	57115880	harbor1	chr19	56956890	56957102	DNA/hAT-Charlie	875	+	106	56956996	41116
chr19	56915880	57115880	harbor1	chr19	56974227	56974452	DNA/hAT-Charlie	712	+	112	56974339	58459
chr19	56119293	56319293	harbor1	chr19	56142408	56142601	DNA/hAT-Charlie	799	+	96	56142504	23211
chr19	38926373	39126373	harbor1	chr19	38998845	38999062	DNA/hAT-Charlie	988	+	108	38998953	72580
chr19	31963613	32163613	harbor1	chr19	32009711	32010186	DNA/hAT-Charlie	3071	+	238	32009949	46336
chr19	13757844	13957844	harbor1	chr19	13822298	13822557	DNA/hAT-Charlie	1157	+	130	13822428	64584
chr19	13975376	14175376	harbor1	chr19	14025440	14025541	DNA/hAT-Charlie	1126	+	50	14025490	50114
chr19	13975376	14175376	harbor1	chr19	14025845	14025950	DNA/hAT-Charlie	1126	+	52	14025897	50521
chr19	13975376	14175376	harbor1	chr19	14026925	14027044	DNA/hAT-Charlie	650	+	60	14026985	51609
chr19	13975376	14175376	harbor1	chr19	14027346	14027407	DNA/hAT-Charlie	650	+	30	14027376	52000
chr19	6080964	6280964	harbor1	chr19	6094610	6094846	DNA/hAT-Charlie	958	+	118	6094728	13764
chr19	6080964	6280964	harbor1	chr19	6095141	6095203	DNA/hAT-Charlie	958	+	31	6095172	14208
chr19	6080964	6280964	harbor1	chr19	6095748	6096087	DNA/hAT-Charlie	1713	+	170	6095918	14954
chr19	6080964	6280964	harbor1	chr19	6099863	6100031	DNA/hAT-Charlie	830	+	84	6099947	18983
chr19	6080964	6280964	harbor1	chr19	6111451	6111665	DNA/hAT-Charlie	999	+	107	6111558	30594
chr19	13200607	13400607	harbor1	chr19	13231376	13231560	DNA/hAT-Charlie	856	+	92	13231468	30861
chr19	13200607	13400607	harbor1	chr19	13261831	13262283	DNA/hAT-Charlie	770	+	226	13262057	61450
chr19	13200607	13400607	harbor1	chr19	13295811	13296105	DNA/hAT-Charlie	1058	+	147	13295958	95351
chr19	13200607	13400607	harbor1	chr19	13296106	13296275	DNA/hAT-Charlie	925	+	84	13296190	95583
chr19	40147367	40347367	harbor1	chr19	40240733	40240774	DNA/hAT-Charlie	772	+	20	40240753	93386
chr19	40147367	40347367	harbor1	chr19	40241088	40241241	DNA/hAT-Charlie	772	+	76	40241164	93797
chr19	45740949	45940949	harbor1	chr19	45787175	45787505	DNA/hAT-Charlie	2076	+	165	45787340	46391
chr19	45740949	45940949	harbor1	chr19	45788273	45788453	DNA/hAT-Charlie	684	+	90	45788363	47414
chr19	34733123	34933123	harbor1	chr19	34736550	34736769	DNA/hAT-Charlie	989	+	110	34736660	3537
chr19	15971985	16171985	harbor1	chr19	16058962	16059146	DNA/hAT-Charlie	673	+	92	16059054	87069
chr19	15514843	15714843	harbor1	chr19	15545700	15545997	DNA/hAT-Charlie	725	+	148	15545848	31005
chr19	15514843	15714843	harbor1	chr19	15546276	15546288	DNA/hAT-Charlie	725	+	6	15546282	31439
chr19	15514843	15714843	harbor1	chr19	15554811	15555019	DNA/hAT-Charlie	658	+	104	15554915	40072
chr19	39573345	39773345	harbor1	chr19	39626677	39626830	DNA/hAT-Charlie	708	+	76	39626753	53408
chr19	2977483	3177483	harbor1	chr19	2996131	2996330	DNA/hAT-Charlie	645	+	100	2996231	18748
chr19	2977483	3177483	harbor1	chr19	3075480	3075683	DNA/hAT-Charlie	854	+	102	3075582	98099
chr19	9288968	9488968	harbor1	chr19	9304485	9304643	DNA/hAT-Charlie	788	+	79	9304564	15596
chr19	9288968	9488968	harbor1	chr19	9304941	9304997	DNA/hAT-Charlie	788	+	28	9304969	16001
chr19	43442362	43642362	harbor1	chr19	43510792	43511292	DNA/hAT-Charlie	3621	+	250	43511042	68680
chr19	43442362	43642362	harbor1	chr19	43522031	43522152	DNA/hAT-Charlie	1166	+	60	43522091	79729
chr19	43442362	43642362	harbor1	chr19	43522444	43522465	DNA/hAT-Charlie	1166	+	10	43522454	80092
chr19	43442362	43642362	harbor1	chr19	43522768	43522964	DNA/hAT-Charlie	1166	+	98	43522866	80504
chr19	31221106	31421106	harbor1	chr19	31312642	31313088	DNA/hAT-Charlie	1609	+	223	31312865	91759
chr19	635259	835259	harbor1	chr19	707462	707683	DNA/hAT-Charlie	1285	+	110	707572	72313
chr19	2607956	2807956	harbor1	chr19	2613640	2613840	DNA/hAT-Charlie	787	+	100	2613740	5784
chr19	2607956	2807956	harbor1	chr19	2619224	2619428	DNA/hAT-Charlie	1048	+	102	2619326	11370
chr19	2607956	2807956	harbor1	chr19	2626688	2626931	DNA/hAT-Charlie	631	+	122	2626810	18854
chr19	2607956	2807956	harbor1	chr19	2635883	2636083	DNA/hAT-Charlie	703	+	100	2635983	28027
chr19	2607956	2807956	harbor1	chr19	2656627	2656824	DNA/hAT-Charlie	847	+	98	2656725	48769
chr19	2607956	2807956	harbor1	chr19	2669527	2669726	DNA/hAT-Charlie	817	+	100	2669627	61671
chr19	2607956	2807956	harbor1	chr19	2677291	2677490	DNA/hAT-Charlie	734	+	100	2677391	69435
chr19	2607956	2807956	harbor1	chr19	2677730	2677935	DNA/hAT-Charlie	951	+	102	2677832	69876
chr19	2053643	2253643	harbor1	chr19	2088049	2088263	DNA/hAT-Charlie	806	+	107	2088156	34513
chr19	18674548	18874548	harbor1	chr19	18686817	18687011	DNA/hAT-Charlie	815	+	97	18686914	12366
chr19	18674548	18874548	harbor1	chr19	18695446	18695583	DNA/hAT-Charlie	821	+	68	18695514	20966
chr19	18674548	18874548	harbor1	chr19	18695892	18695972	DNA/hAT-Charlie	821	+	40	18695932	21384
chr19	5150412	5350412	harbor1	chr19	5155724	5155942	DNA/hAT-Charlie	933	+	109	5155833	5421
chr19	5150412	5350412	harbor1	chr19	5197007	5197190	DNA/hAT-Charlie	932	+	92	5197099	46687
chr19	39420354	39620354	harbor1	chr19	39465506	39465725	DNA/hAT-Charlie	1185	+	110	39465616	45262
chr19	39420354	39620354	harbor1	chr19	39491080	39491167	DNA/hAT-Charlie	670	+	44	39491124	70770
chr19	39420354	39620354	harbor1	chr19	39491467	39491537	DNA/hAT-Charlie	670	+	35	39491502	71148
chr19	3880114	4080114	harbor1	chr19	3942919	3943091	DNA/hAT-Charlie	629	+	86	3943005	62891
chr19	3880114	4080114	harbor1	chr19	3948690	3948889	DNA/hAT-Charlie	712	+	100	3948790	68676
chr19	38911780	39111780	harbor1	chr19	38998845	38999062	DNA/hAT-Charlie	988	+	108	38998953	87173
chr19	46916338	47116338	harbor1	chr19	46982691	46982762	DNA/hAT-Charlie	789	+	36	46982727	66389
chr19	46916338	47116338	harbor1	chr19	46983085	46983196	DNA/hAT-Charlie	789	+	56	46983141	66803
chr19	2951870	3151870	harbor1	chr19	2961165	2961359	DNA/hAT-Charlie	866	+	97	2961262	9392
chr19	2951870	3151870	harbor1	chr19	2973327	2973530	DNA/hAT-Charlie	1035	+	102	2973429	21559
chr19	2951870	3151870	harbor1	chr19	2996131	2996330	DNA/hAT-Charlie	645	+	100	2996231	44361
chr19	1546663	1746663	harbor1	chr19	1634754	1634969	DNA/hAT-Charlie	871	+	108	1634862	88199
chr19	28418004	28618004	harbor1	chr19	28439329	28439463	DNA/hAT-Charlie	743	+	67	28439396	21392
chr19	28418004	28618004	harbor1	chr19	28463064	28463395	DNA/hAT-Charlie	1192	+	166	28463230	45226
chr19	41567792	41767792	harbor1	chr19	41595140	41595299	DNA/hAT-Charlie	686	+	80	41595220	27428
chr19	41567792	41767792	harbor1	chr19	41647879	41648102	DNA/hAT-Charlie	823	+	112	41647991	80199
chr19	6023673	6223673	harbor1	chr19	6033828	6034065	DNA/hAT-Charlie	715	+	118	6033946	10273
chr19	6023673	6223673	harbor1	chr19	6034660	6034709	DNA/hAT-Charlie	715	+	24	6034684	11011
chr19	6023673	6223673	harbor1	chr19	6043498	6043713	DNA/hAT-Charlie	1188	+	108	6043606	19933
chr19	6023673	6223673	harbor1	chr19	6094610	6094846	DNA/hAT-Charlie	958	+	118	6094728	71055
chr19	6023673	6223673	harbor1	chr19	6095141	6095203	DNA/hAT-Charlie	958	+	31	6095172	71499
chr19	6023673	6223673	harbor1	chr19	6095748	6096087	DNA/hAT-Charlie	1713	+	170	6095918	72245
chr19	6023673	6223673	harbor1	chr19	6099863	6100031	DNA/hAT-Charlie	830	+	84	6099947	76274
chr19	6023673	6223673	harbor1	chr19	6111451	6111665	DNA/hAT-Charlie	999	+	107	6111558	87885
chr19	41617577	41817577	harbor1	chr19	41647879	41648102	DNA/hAT-Charlie	823	+	112	41647991	30414
chr19	42004847	42204847	harbor1	chr19	42012552	42012593	DNA/hAT-Charlie	978	+	20	42012572	7725
chr19	42004847	42204847	harbor1	chr19	42012885	42013069	DNA/hAT-Charlie	978	+	92	42012977	8130
chr19	42004847	42204847	harbor1	chr19	42016880	42017176	DNA/hAT-Charlie	876	+	148	42017028	12181
chr19	42004847	42204847	harbor1	chr19	42017273	42017534	DNA/hAT-Charlie	1065	+	130	42017403	12556
chr19	42004847	42204847	harbor1	chr19	42028754	42028897	DNA/hAT-Charlie	689	+	72	42028826	23979
chr19	47792511	47992511	harbor1	chr19	47831366	47831629	DNA/hAT-Charlie	1417	+	132	47831498	38987
chr19	55887288	56087288	harbor1	chr19	55952966	55953447	DNA/hAT-Charlie	3508	+	240	55953206	65918
chr19	55887288	56087288	harbor1	chr19	55957136	55957342	DNA/hAT-Charlie	933	+	103	55957239	69951
chr19	5002459	5202459	harbor1	chr19	5017293	5017490	DNA/hAT-Charlie	728	+	98	5017391	14932
chr19	6210428	6410428	harbor1	chr19	6248965	6249327	DNA/hAT-Charlie	1307	+	181	6249146	38718
chr19	55305174	55505174	harbor1	chr19	55310550	55310735	DNA/hAT-Charlie	824	+	92	55310642	5468
chr19	54022377	54222377	harbor1	chr19	54026839	54027039	DNA/hAT-Charlie	1066	+	100	54026939	4562
chr19	54022377	54222377	harbor1	chr19	54040164	54040310	DNA/hAT-Charlie	682	+	73	54040237	17860
chr19	54022377	54222377	harbor1	chr19	54104554	54104728	DNA/hAT-Charlie	917	+	87	54104641	82264
chr19	54022377	54222377	harbor1	chr19	54105034	54105144	DNA/hAT-Charlie	917	+	55	54105089	82712
chr19	56370133	56570133	harbor1	chr19	56408302	56408500	DNA/hAT-Charlie	918	+	99	56408401	38268
chr19	56370133	56570133	harbor1	chr19	56421063	56421240	DNA/hAT-Charlie	653	+	88	56421151	51018
chr19	56370133	56570133	harbor1	chr19	56432610	56432774	DNA/hAT-Charlie	827	+	82	56432692	62559
chr19	56370133	56570133	harbor1	chr19	56443906	56444135	DNA/hAT-Charlie	916	+	114	56444020	73887
chr19	56370133	56570133	harbor1	chr19	56463934	56464242	DNA/hAT-Charlie	1164	+	154	56464088	93955
chr19	56370133	56570133	harbor1	chr19	56464519	56464620	DNA/hAT-Charlie	749	+	50	56464569	94436
chr19	10512676	10712676	harbor1	chr19	10610137	10610298	DNA/hAT-Charlie	630	+	80	10610217	97541
chr19	28651332	28851332	harbor1	chr19	28748204	28748508	DNA/hAT-Charlie	1745	+	152	28748356	97024
chr19	11403276	11603276	harbor1	chr19	11408724	11408771	DNA/hAT-Charlie	782	+	24	11408748	5472
chr19	11403276	11603276	harbor1	chr19	11409537	11409936	DNA/hAT-Charlie	782	+	200	11409737	6461
chr19	11403276	11603276	harbor1	chr19	11410301	11410411	DNA/hAT-Charlie	782	+	55	11410356	7080
chr19	54840869	55040869	harbor1	chr19	54917639	54917832	DNA/hAT-Charlie	698	+	96	54917735	76866
chr19	53316204	53516204	harbor1	chr19	53324993	53325324	DNA/hAT-Charlie	2109	+	166	53325159	8955
chr19	8935483	9135483	harbor1	chr19	8942177	8942388	DNA/hAT-Charlie	1145	+	106	8942283	6800
chr19	8935483	9135483	harbor1	chr19	9017196	9017408	DNA/hAT-Charlie	1096	+	106	9017302	81819
chr19	36324180	36524180	harbor1	chr19	36344558	36344893	DNA/hAT-Charlie	2233	+	168	36344726	20546
chr19	36324180	36524180	harbor1	chr19	36363503	36363707	DNA/hAT-Charlie	1060	+	102	36363605	39425
chr19	36324180	36524180	harbor1	chr19	36364004	36364032	DNA/hAT-Charlie	1060	+	14	36364018	39838
chr19	36324180	36524180	harbor1	chr19	36419046	36419255	DNA/hAT-Charlie	1272	+	104	36419150	94970
chr19	36324180	36524180	harbor1	chr19	36420226	36420269	DNA/hAT-Charlie	1272	+	22	36420248	96068
chr19	31486039	31686039	harbor1	chr19	31510127	31510505	DNA/hAT-Charlie	1025	+	189	31510316	24277
chr19	5675194	5875194	harbor1	chr19	5722593	5722786	DNA/hAT-Charlie	641	+	96	5722689	47495
chr19	5675194	5875194	harbor1	chr19	5736212	5736417	DNA/hAT-Charlie	951	+	102	5736314	61120
chr19	11408349	11608349	harbor1	chr19	11408724	11408771	DNA/hAT-Charlie	782	+	24	11408748	399
chr19	11408349	11608349	harbor1	chr19	11409537	11409936	DNA/hAT-Charlie	782	+	200	11409737	1388
chr19	11408349	11608349	harbor1	chr19	11410301	11410411	DNA/hAT-Charlie	782	+	55	11410356	2007
chr19	52122439	52322439	harbor1	chr19	52197057	52197340	DNA/hAT-Charlie	701	+	142	52197199	74760
chr19	52122439	52322439	harbor1	chr19	52199527	52199739	DNA/hAT-Charlie	782	+	106	52199633	77194
chr19	28012743	28212743	harbor1	chr19	28020163	28020376	DNA/hAT-Charlie	930	+	106	28020269	7526
chr19	1	185454	harbor1	chr19	68877	69126	DNA/hAT-Charlie	1396	+	124	69001	69000
chr19	1	185454	harbor1	chr19	78654	79040	DNA/hAT-Charlie	1683	+	193	78847	78846
chr19	33238845	33438845	harbor1	chr19	33259922	33259983	DNA/hAT-Charlie	660	+	30	33259952	21107
chr19	33238845	33438845	harbor1	chr19	33260273	33260425	DNA/hAT-Charlie	660	+	76	33260349	21504
chr19	2056652	2256652	harbor1	chr19	2088049	2088263	DNA/hAT-Charlie	806	+	107	2088156	31504
chr19	39120163	39320163	harbor1	chr19	39181905	39182079	DNA/hAT-Charlie	772	+	87	39181992	61829
chr19	39120163	39320163	harbor1	chr19	39210989	39211158	DNA/hAT-Charlie	770	+	84	39211073	90910
chr19	49526081	49726081	harbor1	chr19	49563921	49564090	DNA/hAT-Charlie	759	+	84	49564005	37924
chr19	49526081	49726081	harbor1	chr19	49602937	49603142	DNA/hAT-Charlie	912	+	102	49603039	76958
chr19	50757605	50957605	harbor1	chr19	50846922	50847005	DNA/hAT-Charlie	1756	+	42	50846964	89359
chr19	50757605	50957605	harbor1	chr19	50847316	50847663	DNA/hAT-Charlie	1756	+	174	50847490	89885
chr19	50757605	50957605	harbor1	chr19	50847970	50847980	DNA/hAT-Charlie	1756	+	5	50847975	90370
chr19	50757605	50957605	harbor1	chr19	50848280	50848342	DNA/hAT-Charlie	1756	+	31	50848311	90706
chr19	8977792	9177792	harbor1	chr19	9017196	9017408	DNA/hAT-Charlie	1096	+	106	9017302	39510
chr19	56017306	56217306	harbor1	chr19	56024830	56025326	DNA/hAT-Charlie	3395	+	248	56025078	7772
chr19	56017306	56217306	harbor1	chr19	56078481	56078667	DNA/hAT-Charlie	1419	+	93	56078574	61268
chr19	56017306	56217306	harbor1	chr19	56090466	56090540	DNA/hAT-Charlie	628	+	37	56090503	73197
chr19	56017306	56217306	harbor1	chr19	56090837	56090950	DNA/hAT-Charlie	628	+	56	56090893	73587
chr19	5543445	5743445	harbor1	chr19	5603707	5603971	DNA/hAT-Charlie	1055	+	132	5603839	60394
chr19	5543445	5743445	harbor1	chr19	5617591	5617777	DNA/hAT-Charlie	744	+	93	5617684	74239
chr19	13485073	13685073	harbor1	chr19	13488882	13488993	DNA/hAT-Charlie	674	+	56	13488938	3865
chr19	13485073	13685073	harbor1	chr19	13489310	13489363	DNA/hAT-Charlie	674	+	26	13489336	4263
chr19	13485073	13685073	harbor1	chr19	13527855	13527962	DNA/hAT-Charlie	1193	+	54	13527909	42836
chr19	13485073	13685073	harbor1	chr19	13528263	13528454	DNA/hAT-Charlie	1193	+	96	13528359	43286
chr19	13485073	13685073	harbor1	chr19	13549633	13549840	DNA/hAT-Charlie	881	+	104	13549737	64664
chr19	13485073	13685073	harbor1	chr19	13577200	13577368	DNA/hAT-Charlie	975	+	84	13577284	92211
chr19	13485073	13685073	harbor1	chr19	13577632	13578021	DNA/hAT-Charlie	975	+	194	13577826	92753
chr19	13485073	13685073	harbor1	chr19	13578326	13578579	DNA/hAT-Charlie	692	+	126	13578452	93379
chr19	45739566	45939566	harbor1	chr19	45787175	45787505	DNA/hAT-Charlie	2076	+	165	45787340	47774
chr19	45739566	45939566	harbor1	chr19	45788273	45788453	DNA/hAT-Charlie	684	+	90	45788363	48797
chr19	30078968	30278968	harbor1	chr19	30086482	30086592	DNA/hAT-Charlie	662	+	55	30086537	7569
chr19	30078968	30278968	harbor1	chr19	30086898	30087062	DNA/hAT-Charlie	662	+	82	30086980	8012
chr19	29633896	29833896	harbor1	chr19	29662057	29662337	DNA/hAT-Charlie	1024	+	140	29662197	28301
chr19	29633896	29833896	harbor1	chr19	29692174	29692454	DNA/hAT-Charlie	1074	+	140	29692314	58418
chr19	29633896	29833896	harbor1	chr19	29692865	29692904	DNA/hAT-Charlie	1074	+	20	29692885	58989
chr19	29633896	29833896	harbor1	chr19	29713619	29713819	DNA/hAT-Charlie	637	+	100	29713719	79823
chr19	20941815	21141815	harbor1	chr19	21018936	21019219	DNA/hAT-Charlie	940	+	142	21019078	77263
chr19	52111875	52311875	harbor1	chr19	52197057	52197340	DNA/hAT-Charlie	701	+	142	52197199	85324
chr19	52111875	52311875	harbor1	chr19	52199527	52199739	DNA/hAT-Charlie	782	+	106	52199633	87758
chr19	54122449	54322449	harbor1	chr19	54175282	54175464	DNA/hAT-Charlie	737	+	91	54175373	52924
chr19	35290969	35490969	harbor1	chr19	35314900	35315080	DNA/hAT-Charlie	1014	+	90	35314990	24021
chr19	35290969	35490969	harbor1	chr19	35315971	35316452	DNA/hAT-Charlie	3022	+	240	35316211	25242
chr19	21522910	21722910	harbor1	chr19	21578309	21578525	DNA/hAT-Charlie	1108	+	108	21578417	55507
chr19	53592477	53792477	harbor1	chr19	53610633	53610852	DNA/hAT-Charlie	1430	+	110	53610743	18266
chr19	6409173	6609173	harbor1	chr19	6504770	6504786	DNA/hAT-Charlie	947	+	8	6504778	95605
chr19	6409173	6609173	harbor1	chr19	6504835	6505075	DNA/hAT-Charlie	947	+	120	6504955	95782
chr19	14114448	14314448	harbor1	chr19	14200415	14200600	DNA/hAT-Charlie	810	+	92	14200507	86059
chr20	37100629	37300629	harbor1	chr20	37124319	37124424	DNA/hAT-Charlie	667	+	52	37124371	23742
chr20	37100629	37300629	harbor1	chr20	37124735	37124804	DNA/hAT-Charlie	667	+	34	37124769	24140
chr20	37100629	37300629	harbor1	chr20	37128637	37128838	DNA/hAT-Charlie	1517	+	100	37128737	28108
chr20	37100629	37300629	harbor1	chr20	37159341	37159545	DNA/hAT-Charlie	459	+	102	37159443	58814
chr20	37100629	37300629	harbor1	chr20	37177661	37177871	DNA/hAT-Charlie	1126	+	105	37177766	77137
chr20	37100629	37300629	harbor1	chr20	37189363	37189490	DNA/hAT-Charlie	518	+	64	37189427	88798
chr20	14587768	14787768	harbor1	chr20	14614333	14614502	DNA/hAT-Charlie	545	+	84	14614417	26649
chr20	14587768	14787768	harbor1	chr20	14651026	14651214	DNA/hAT-Charlie	555	+	94	14651120	63352
chr20	9510451	9710451	harbor1	chr20	9523882	9524129	DNA/hAT-Charlie	1124	+	124	9524006	13555
chr20	9510451	9710451	harbor1	chr20	9524148	9524311	DNA/hAT-Charlie	521	+	82	9524230	13779
chr20	9510451	9710451	harbor1	chr20	9524322	9524520	DNA/hAT-Charlie	502	+	99	9524421	13970
chr20	9510451	9710451	harbor1	chr20	9533792	9534171	DNA/hAT-Charlie	1374	+	190	9533982	23531
chr20	9510451	9710451	harbor1	chr20	9547730	9547888	DNA/hAT-Charlie	719	+	79	9547809	37358
chr20	9510451	9710451	harbor1	chr20	9561862	9562019	DNA/hAT-Charlie	728	+	78	9561940	51489
chr20	9510451	9710451	harbor1	chr20	9576338	9576558	DNA/hAT-Charlie	981	+	110	9576448	65997
chr20	9510451	9710451	harbor1	chr20	9590357	9590553	DNA/hAT-Charlie	834	+	98	9590455	80004
chr20	9510451	9710451	harbor1	chr20	9594006	9594154	DNA/hAT-Charlie	457	+	74	9594080	83629
chr20	9510451	9710451	harbor1	chr20	9594174	9594336	DNA/hAT-Charlie	977	+	81	9594255	83804
chr20	9510451	9710451	harbor1	chr20	9596680	9596821	DNA/hAT-Charlie	494	+	70	9596750	86299
chr20	9510451	9710451	harbor1	chr20	9551730	9551881	DNA/hAT-Charlie	700	+	76	9551806	41355
chr20	745667	945667	harbor1	chr20	825589	825740	DNA/hAT-Charlie	424	+	76	825665	79998
chr20	745667	945667	harbor1	chr20	843347	843554	DNA/hAT-Charlie	1002	+	104	843451	97784
chr20	61037334	61237334	harbor1	chr20	61056247	61056471	DNA/hAT-Charlie	641	+	112	61056359	19025
chr20	61037334	61237334	harbor1	chr20	61072484	61072658	DNA/hAT-Charlie	509	+	87	61072571	35237
chr20	61037334	61237334	harbor1	chr20	61108060	61108266	DNA/hAT-Charlie	757	+	103	61108163	70829
chr20	59911549	60111549	harbor1	chr20	59917915	59919045	DNA/hAT-Charlie	5484	+	565	59918480	6931
chr20	59911549	60111549	harbor1	chr20	59949814	59949883	DNA/hAT-Charlie	416	+	34	59949848	38299
chr20	59911549	60111549	harbor1	chr20	59996948	59997152	DNA/hAT-Charlie	1123	+	102	59997050	85501
chr20	47896679	48096679	harbor1	chr20	47906381	47906638	DNA/hAT-Charlie	511	+	128	47906509	9830
chr20	47896679	48096679	harbor1	chr20	47942021	47942211	DNA/hAT-Charlie	830	+	95	47942116	45437
chr20	47896679	48096679	harbor1	chr20	47948994	47949381	DNA/hAT-Charlie	1704	+	194	47949188	52509
chr20	47896679	48096679	harbor1	chr20	47949757	47949966	DNA/hAT-Charlie	1704	+	104	47949861	53182
chr20	47896679	48096679	harbor1	chr20	47970944	47971165	DNA/hAT-Charlie	588	+	110	47971054	74375
chr20	47896679	48096679	harbor1	chr20	47983228	47983403	DNA/hAT-Charlie	436	+	88	47983316	86637
chr20	47896679	48096679	harbor1	chr20	47984780	47984937	DNA/hAT-Charlie	556	+	78	47984858	88179
chr20	47896679	48096679	harbor1	chr20	47985794	47985942	DNA/hAT-Charlie	630	+	74	47985868	89189
chr20	25075738	25275738	harbor1	chr20	25080349	25080633	DNA/hAT-Charlie	628	+	142	25080491	4753
chr20	25075738	25275738	harbor1	chr20	25089253	25089430	DNA/hAT-Charlie	697	+	88	25089341	13603
chr20	25075738	25275738	harbor1	chr20	25100777	25100997	DNA/hAT-Charlie	972	+	110	25100887	25149
chr20	63189484	63389484	harbor1	chr20	63212725	63212939	DNA/hAT-Charlie	910	+	107	63212832	23348
chr20	295379	495379	harbor1	chr20	295777	295983	DNA/hAT-Charlie	514	+	103	295880	501
chr20	295379	495379	harbor1	chr20	385528	385682	DNA/hAT-Charlie	744	+	77	385605	90226
chr20	54499841	54699841	harbor1	chr20	54505207	54505420	DNA/hAT-Charlie	857	+	106	54505313	5472
chr20	54499841	54699841	harbor1	chr20	54547083	54547304	DNA/hAT-Charlie	1154	+	110	54547193	47352
chr20	54499841	54699841	harbor1	chr20	54547937	54548140	DNA/hAT-Charlie	1114	+	102	54548039	48198
chr20	54499841	54699841	harbor1	chr20	54597226	54597422	DNA/hAT-Charlie	953	+	98	54597324	97483
chr20	35099396	35299396	harbor1	chr20	35134122	35134386	DNA/hAT-Charlie	788	+	132	35134254	34858
chr20	35796677	35996677	harbor1	chr20	35840661	35840785	DNA/hAT-Charlie	524	+	62	35840723	44046
chr20	35796677	35996677	harbor1	chr20	35864748	35864923	DNA/hAT-Charlie	865	+	88	35864836	68159
chr20	35796677	35996677	harbor1	chr20	35865184	35865207	DNA/hAT-Charlie	865	+	12	35865196	68519
chr20	35796677	35996677	harbor1	chr20	35865427	35865486	DNA/hAT-Charlie	421	+	30	35865457	68780
chr20	35796677	35996677	harbor1	chr20	35866304	35866469	DNA/hAT-Charlie	607	+	82	35866386	69709
chr20	40892260	41092260	harbor1	chr20	40898360	40898747	DNA/hAT-Charlie	1684	+	194	40898554	6294
chr20	40892260	41092260	harbor1	chr20	40940419	40940474	DNA/hAT-Charlie	497	+	28	40940447	48187
chr20	40892260	41092260	harbor1	chr20	40940795	40940910	DNA/hAT-Charlie	497	+	58	40940853	48593
chr20	40892260	41092260	harbor1	chr20	40941545	40941698	DNA/hAT-Charlie	816	+	76	40941621	49361
chr20	40892260	41092260	harbor1	chr20	40955678	40955843	DNA/hAT-Charlie	1004	+	82	40955760	63500
chr20	40892260	41092260	harbor1	chr20	40955842	40955984	DNA/hAT-Charlie	1480	+	71	40955913	63653
chr20	40892260	41092260	harbor1	chr20	40956290	40956561	DNA/hAT-Charlie	1480	+	136	40956426	64166
chr20	40892260	41092260	harbor1	chr20	40981067	40981582	DNA/hAT-Charlie	3734	+	258	40981325	89065
chr20	11128006	11328006	harbor1	chr20	11192056	11192372	DNA/hAT-Charlie	1351	+	158	11192214	64208
chr20	11128006	11328006	harbor1	chr20	11208773	11208944	DNA/hAT-Charlie	698	+	86	11208859	80853
chr20	11128006	11328006	harbor1	chr20	11213227	11213387	DNA/hAT-Charlie	899	+	80	11213307	85301
chr20	16775678	16975678	harbor1	chr20	16800619	16801072	DNA/hAT-Charlie	3627	+	226	16800845	25167
chr20	16775678	16975678	harbor1	chr20	16801411	16802068	DNA/hAT-Charlie	3627	+	328	16801739	26061
chr20	16775678	16975678	harbor1	chr20	16803964	16804096	DNA/hAT-Charlie	479	+	66	16804030	28352
chr20	16775678	16975678	harbor1	chr20	16834611	16834864	DNA/hAT-Charlie	831	+	126	16834737	59059
chr20	8219152	8419152	harbor1	chr20	8218810	8219335	DNA/hAT-Charlie	1173	+	262	8219072	80
chr20	8219152	8419152	harbor1	chr20	8229663	8229739	DNA/hAT-Charlie	468	+	38	8229701	10549
chr20	8219152	8419152	harbor1	chr20	8230085	8230191	DNA/hAT-Charlie	468	+	53	8230138	10986
chr20	8219152	8419152	harbor1	chr20	8255136	8255299	DNA/hAT-Charlie	431	+	82	8255218	36066
chr20	8219152	8419152	harbor1	chr20	8277554	8277664	DNA/hAT-Charlie	507	+	55	8277609	58457
chr20	40726298	40926298	harbor1	chr20	40728648	40728753	DNA/hAT-Charlie	520	+	52	40728700	2402
chr20	40726298	40926298	harbor1	chr20	40730705	40730936	DNA/hAT-Charlie	443	+	116	40730821	4523
chr20	40726298	40926298	harbor1	chr20	40738000	40738204	DNA/hAT-Charlie	1199	+	102	40738102	11804
chr20	40726298	40926298	harbor1	chr20	40752211	40752368	DNA/hAT-Charlie	484	+	78	40752289	25991
chr20	40726298	40926298	harbor1	chr20	40765065	40765199	DNA/hAT-Charlie	959	+	67	40765132	38834
chr20	40726298	40926298	harbor1	chr20	40765532	40765594	DNA/hAT-Charlie	959	+	31	40765563	39265
chr20	40726298	40926298	harbor1	chr20	40784318	40784625	DNA/hAT-Charlie	729	+	154	40784472	58174
chr20	40726298	40926298	harbor1	chr20	40788339	40788464	DNA/hAT-Charlie	469	+	62	40788401	62103
chr20	40726298	40926298	harbor1	chr20	40817159	40817369	DNA/hAT-Charlie	1307	+	105	40817264	90966
chr20	52274212	52474212	harbor1	chr20	52275378	52275697	DNA/hAT-Charlie	1695	+	160	52275538	1326
chr20	52274212	52474212	harbor1	chr20	52276601	52276730	DNA/hAT-Charlie	492	+	64	52276665	2453
chr20	52274212	52474212	harbor1	chr20	52297414	52297601	DNA/hAT-Charlie	1102	+	94	52297508	23296
chr20	52274212	52474212	harbor1	chr20	52297909	52297948	DNA/hAT-Charlie	1102	+	20	52297929	23717
chr20	52274212	52474212	harbor1	chr20	52300417	52300630	DNA/hAT-Charlie	838	+	106	52300523	26311
chr20	52274212	52474212	harbor1	chr20	52304628	52304849	DNA/hAT-Charlie	842	+	110	52304738	30526
chr20	52274212	52474212	harbor1	chr20	52315142	52315361	DNA/hAT-Charlie	1169	+	110	52315252	41040
chr20	52274212	52474212	harbor1	chr20	52322104	52322294	DNA/hAT-Charlie	583	+	95	52322199	47987
chr20	52274212	52474212	harbor1	chr20	52333324	52333521	DNA/hAT-Charlie	700	+	98	52333422	59210
chr20	52274212	52474212	harbor1	chr20	52343919	52344141	DNA/hAT-Charlie	905	+	111	52344030	69818
chr20	52274212	52474212	harbor1	chr20	52356326	52356575	DNA/hAT-Charlie	706	+	124	52356450	82238
chr20	52274212	52474212	harbor1	chr20	52365837	52366058	DNA/hAT-Charlie	1048	+	110	52365947	91735
chr20	52274212	52474212	harbor1	chr20	52313933	52314149	DNA/hAT-Charlie	939	+	108	52314041	39829
chr20	52008519	52208519	harbor1	chr20	52028449	52028661	DNA/hAT-Charlie	1243	+	106	52028555	20036
chr20	52008519	52208519	harbor1	chr20	52028957	52029080	DNA/hAT-Charlie	1243	+	62	52029019	20500
chr20	52008519	52208519	harbor1	chr20	52040437	52040571	DNA/hAT-Charlie	834	+	67	52040504	31985
chr20	52008519	52208519	harbor1	chr20	52040899	52040975	DNA/hAT-Charlie	834	+	38	52040937	32418
chr20	52008519	52208519	harbor1	chr20	52041381	52041510	DNA/hAT-Charlie	440	+	64	52041445	32926
chr20	52008519	52208519	harbor1	chr20	52062979	52063154	DNA/hAT-Charlie	798	+	88	52063067	54548
chr20	52008519	52208519	harbor1	chr20	52077685	52078051	DNA/hAT-Charlie	1103	+	183	52077868	69349
chr20	52008519	52208519	harbor1	chr20	52081938	52082165	DNA/hAT-Charlie	657	+	114	52082052	73533
chr20	52008519	52208519	harbor1	chr20	52082706	52082843	DNA/hAT-Charlie	694	+	68	52082774	74255
chr20	52008519	52208519	harbor1	chr20	52093442	52093729	DNA/hAT-Charlie	954	+	144	52093586	85067
chr20	52008519	52208519	harbor1	chr20	52101767	52101837	DNA/hAT-Charlie	827	+	35	52101802	93283
chr20	52008519	52208519	harbor1	chr20	52102126	52102228	DNA/hAT-Charlie	827	+	51	52102177	93658
chr20	52008519	52208519	harbor1	chr20	52105436	52105580	DNA/hAT-Charlie	954	+	72	52105508	96989
chr20	52008519	52208519	harbor1	chr20	52105585	52105642	DNA/hAT-Charlie	421	+	28	52105613	97094
chr20	52008519	52208519	harbor1	chr20	52100978	52101197	DNA/hAT-Charlie	890	+	110	52101088	92569
chr20	55794425	55994425	harbor1	chr20	55819924	55820156	DNA/hAT-Charlie	438	+	116	55820040	25615
chr20	55794425	55994425	harbor1	chr20	55825825	55826030	DNA/hAT-Charlie	988	+	102	55825927	31502
chr20	33291219	33491219	harbor1	chr20	33305620	33305787	DNA/hAT-Charlie	512	+	84	33305704	14485
chr20	45243742	45443742	harbor1	chr20	45257014	45257214	DNA/hAT-Charlie	767	+	100	45257114	13372
chr20	45243742	45443742	harbor1	chr20	45272977	45273124	DNA/hAT-Charlie	419	+	74	45273051	29309
chr20	45243742	45443742	harbor1	chr20	45294466	45294628	DNA/hAT-Charlie	671	+	81	45294547	50805
chr20	45243742	45443742	harbor1	chr20	45294692	45295236	DNA/hAT-Charlie	3544	+	272	45294964	51222
chr20	45243742	45443742	harbor1	chr20	45295261	45295389	DNA/hAT-Charlie	958	+	64	45295325	51583
chr20	45243742	45443742	harbor1	chr20	45295686	45295750	DNA/hAT-Charlie	958	+	32	45295718	51976
chr20	45243742	45443742	harbor1	chr20	45320454	45320498	DNA/hAT-Charlie	442	+	22	45320476	76734
chr20	45243742	45443742	harbor1	chr20	45320803	45320927	DNA/hAT-Charlie	442	+	62	45320865	77123
chr20	45243742	45443742	harbor1	chr20	45323914	45324111	DNA/hAT-Charlie	958	+	98	45324012	80270
chr20	45243742	45443742	harbor1	chr20	45325710	45325885	DNA/hAT-Charlie	657	+	88	45325798	82056
chr20	16418786	16618786	harbor1	chr20	16444276	16444614	DNA/hAT-Charlie	1047	+	169	16444445	25659
chr20	16418786	16618786	harbor1	chr20	16445742	16445999	DNA/hAT-Charlie	670	+	128	16445870	27084
chr20	16418786	16618786	harbor1	chr20	16461929	16461967	DNA/hAT-Charlie	1033	+	19	16461948	43162
chr20	16418786	16618786	harbor1	chr20	16462253	16462599	DNA/hAT-Charlie	1033	+	173	16462426	43640
chr20	16418786	16618786	harbor1	chr20	16463606	16463980	DNA/hAT-Charlie	1532	+	187	16463793	45007
chr20	16418786	16618786	harbor1	chr20	16464014	16464654	DNA/hAT-Charlie	1600	+	320	16464334	45548
chr20	16418786	16618786	harbor1	chr20	16472081	16472289	DNA/hAT-Charlie	747	+	104	16472185	53399
chr20	3988836	4188836	harbor1	chr20	4061336	4061642	DNA/hAT-Charlie	1485	+	153	4061489	72653
chr20	3988836	4188836	harbor1	chr20	4061908	4062046	DNA/hAT-Charlie	1485	+	69	4061977	73141
chr20	41427017	41627017	harbor1	chr20	41427016	41427171	DNA/hAT-Charlie	611	+	78	41427094	77
chr20	46232914	46432914	harbor1	chr20	46236130	46236308	DNA/hAT-Charlie	804	+	89	46236219	3305
chr20	46232914	46432914	harbor1	chr20	46285378	46285599	DNA/hAT-Charlie	1040	+	110	46285488	52574
chr20	46232914	46432914	harbor1	chr20	46290265	46290480	DNA/hAT-Charlie	1561	+	108	46290373	57459
chr20	6221885	6421885	harbor1	chr20	6229733	6229909	DNA/hAT-Charlie	859	+	88	6229821	7936
chr20	6221885	6421885	harbor1	chr20	6230247	6230430	DNA/hAT-Charlie	762	+	92	6230339	8454
chr20	6221885	6421885	harbor1	chr20	6237054	6237269	DNA/hAT-Charlie	1093	+	108	6237162	15277
chr20	6221885	6421885	harbor1	chr20	6246127	6246324	DNA/hAT-Charlie	1054	+	98	6246225	24340
chr20	24471337	24671337	harbor1	chr20	24527736	24527911	DNA/hAT-Charlie	728	+	88	24527824	56487
chr20	53958343	54158343	harbor1	chr20	53967941	53968025	DNA/hAT-Charlie	467	+	42	53967983	9640
chr20	53958343	54158343	harbor1	chr20	53968156	53968267	DNA/hAT-Charlie	467	+	56	53968212	9869
chr20	53958343	54158343	harbor1	chr20	53988983	53989222	DNA/hAT-Charlie	569	+	120	53989103	30760
chr20	53958343	54158343	harbor1	chr20	53991793	53992269	DNA/hAT-Charlie	1137	+	238	53992031	33688
chr20	53958343	54158343	harbor1	chr20	54000170	54000317	DNA/hAT-Charlie	569	+	74	54000244	41901
chr20	53958343	54158343	harbor1	chr20	54005528	54005704	DNA/hAT-Charlie	697	+	88	54005616	47273
chr20	53958343	54158343	harbor1	chr20	54019281	54019482	DNA/hAT-Charlie	682	+	100	54019381	61038
chr20	28492254	28692254	harbor1	chr20	28587626	28587777	DNA/hAT-Charlie	580	+	76	28587702	95448
chr20	55856912	56056912	harbor1	chr20	55920858	55921069	DNA/hAT-Charlie	872	+	106	55920964	64052
chr20	55856912	56056912	harbor1	chr20	55949224	55949364	DNA/hAT-Charlie	646	+	70	55949294	92382
chr20	30631167	30831167	harbor1	chr20	30697461	30697585	DNA/hAT-Charlie	409	+	62	30697523	66356
chr20	38160723	38360723	harbor1	chr20	38224515	38224717	DNA/hAT-Charlie	874	+	101	38224616	63893
chr20	38160723	38360723	harbor1	chr20	38226369	38226530	DNA/hAT-Charlie	767	+	80	38226449	65726
chr20	38160723	38360723	harbor1	chr20	38230423	38230606	DNA/hAT-Charlie	910	+	92	38230515	69792
chr20	38160723	38360723	harbor1	chr20	38257624	38257900	DNA/hAT-Charlie	1227	+	138	38257762	97039
chr20	38160723	38360723	harbor1	chr20	38258200	38258327	DNA/hAT-Charlie	1227	+	64	38258264	97541
chr20	48401914	48601914	harbor1	chr20	48420553	48420739	DNA/hAT-Charlie	544	+	93	48420646	18732
chr20	48401914	48601914	harbor1	chr20	48422693	48422870	DNA/hAT-Charlie	744	+	88	48422781	20867
chr20	48401914	48601914	harbor1	chr20	48423162	48423219	DNA/hAT-Charlie	744	+	28	48423190	21276
chr20	48401914	48601914	harbor1	chr20	48427367	48427663	DNA/hAT-Charlie	1286	+	148	48427515	25601
chr20	48401914	48601914	harbor1	chr20	48439316	48439585	DNA/hAT-Charlie	440	+	134	48439450	37536
chr20	48401914	48601914	harbor1	chr20	48440937	48441274	DNA/hAT-Charlie	2528	+	168	48441105	39191
chr20	48401914	48601914	harbor1	chr20	48449630	48449747	DNA/hAT-Charlie	400	+	58	48449688	47774
chr20	48401914	48601914	harbor1	chr20	48450432	48450557	DNA/hAT-Charlie	400	+	62	48450494	48580
chr20	10030518	10230518	harbor1	chr20	10045292	10045499	DNA/hAT-Charlie	623	+	104	10045396	14878
chr20	10030518	10230518	harbor1	chr20	10126720	10126895	DNA/hAT-Charlie	1029	+	88	10126808	96290
chr20	10030518	10230518	harbor1	chr20	10128375	10128533	DNA/hAT-Charlie	626	+	79	10128454	97936
chr20	10030518	10230518	harbor1	chr20	10128542	10128723	DNA/hAT-Charlie	926	+	90	10128632	98114
chr20	52379422	52579422	harbor1	chr20	52386296	52386752	DNA/hAT-Charlie	2296	+	228	52386524	7102
chr20	52379422	52579422	harbor1	chr20	52397120	52397345	DNA/hAT-Charlie	934	+	112	52397232	17810
chr20	52379422	52579422	harbor1	chr20	52411725	52411933	DNA/hAT-Charlie	1095	+	104	52411829	32407
chr20	52379422	52579422	harbor1	chr20	52415554	52415686	DNA/hAT-Charlie	862	+	66	52415620	36198
chr20	52379422	52579422	harbor1	chr20	52417187	52417344	DNA/hAT-Charlie	863	+	78	52417265	37843
chr20	52379422	52579422	harbor1	chr20	52427470	52427700	DNA/hAT-Charlie	605	+	115	52427585	48163
chr20	52379422	52579422	harbor1	chr20	52432871	52433014	DNA/hAT-Charlie	438	+	72	52432943	53521
chr20	52379422	52579422	harbor1	chr20	52433407	52433611	DNA/hAT-Charlie	996	+	102	52433509	54087
chr20	52379422	52579422	harbor1	chr20	52436564	52436730	DNA/hAT-Charlie	515	+	83	52436647	57225
chr20	52379422	52579422	harbor1	chr20	52438395	52438610	DNA/hAT-Charlie	1151	+	108	52438503	59081
chr20	52379422	52579422	harbor1	chr20	52448848	52449131	DNA/hAT-Charlie	636	+	142	52448990	69568
chr20	52379422	52579422	harbor1	chr20	52452389	52452466	DNA/hAT-Charlie	444	+	38	52452427	73005
chr20	52379422	52579422	harbor1	chr20	52460361	52460891	DNA/hAT-Charlie	1437	+	265	52460626	81204
chr20	52379422	52579422	harbor1	chr20	52469883	52470049	DNA/hAT-Charlie	460	+	83	52469966	90544
chr20	52379422	52579422	harbor1	chr20	52472817	52473009	DNA/hAT-Charlie	459	+	96	52472913	93491
chr20	50997772	51197772	harbor1	chr20	51011393	51011594	DNA/hAT-Charlie	948	+	100	51011493	13721
chr20	50997772	51197772	harbor1	chr20	51012642	51012929	DNA/hAT-Charlie	939	+	144	51012786	15014
chr20	50997772	51197772	harbor1	chr20	51026727	51026936	DNA/hAT-Charlie	554	+	104	51026831	29059
chr20	50997772	51197772	harbor1	chr20	51029396	51029673	DNA/hAT-Charlie	1043	+	138	51029534	31762
chr20	50997772	51197772	harbor1	chr20	51046139	51046344	DNA/hAT-Charlie	1158	+	102	51046241	48469
chr20	59001141	59201141	harbor1	chr20	59047723	59047930	DNA/hAT-Charlie	890	+	104	59047827	46686
chr20	59001141	59201141	harbor1	chr20	59068009	59068309	DNA/hAT-Charlie	1387	+	150	59068159	67018
chr20	59001141	59201141	harbor1	chr20	59084277	59084477	DNA/hAT-Charlie	603	+	100	59084377	83236
chr20	59001141	59201141	harbor1	chr20	59087051	59087270	DNA/hAT-Charlie	1085	+	110	59087161	86020
chr20	59001141	59201141	harbor1	chr20	59094122	59094367	DNA/hAT-Charlie	508	+	122	59094244	93103
chr20	58248545	58448545	harbor1	chr20	58293793	58294013	DNA/hAT-Charlie	508	+	110	58293903	45358
chr20	58248545	58448545	harbor1	chr20	58303696	58303897	DNA/hAT-Charlie	870	+	100	58303796	55251
chr20	58248545	58448545	harbor1	chr20	58313755	58313962	DNA/hAT-Charlie	876	+	104	58313859	65314
chr20	36003339	36203339	harbor1	chr20	36027444	36027672	DNA/hAT-Charlie	712	+	114	36027558	24219
chr20	36003339	36203339	harbor1	chr20	36067114	36067188	DNA/hAT-Charlie	776	+	37	36067151	63812
chr20	36003339	36203339	harbor1	chr20	36067423	36067562	DNA/hAT-Charlie	776	+	70	36067493	64154
chr20	36003339	36203339	harbor1	chr20	36095713	36095761	DNA/hAT-Charlie	622	+	24	36095737	92398
chr20	36003339	36203339	harbor1	chr20	36096048	36096160	DNA/hAT-Charlie	622	+	56	36096104	92765
chr20	22038090	22238090	harbor1	chr20	22038646	22038726	DNA/hAT-Charlie	401	+	40	22038686	596
chr20	22038090	22238090	harbor1	chr20	22047414	22047791	DNA/hAT-Charlie	1526	+	188	22047602	9512
chr20	22038090	22238090	harbor1	chr20	22073760	22073968	DNA/hAT-Charlie	719	+	104	22073864	35774
chr20	54215015	54415015	harbor1	chr20	54222108	54222386	DNA/hAT-Charlie	558	+	139	54222247	7232
chr20	54215015	54415015	harbor1	chr20	54246928	54247032	DNA/hAT-Charlie	513	+	52	54246980	31965
chr20	54215015	54415015	harbor1	chr20	54247825	54248041	DNA/hAT-Charlie	911	+	108	54247933	32918
chr20	54215015	54415015	harbor1	chr20	54252506	54252697	DNA/hAT-Charlie	738	+	96	54252602	37587
chr20	54215015	54415015	harbor1	chr20	54266297	54266533	DNA/hAT-Charlie	419	+	118	54266415	51400
chr20	54215015	54415015	harbor1	chr20	54291890	54291985	DNA/hAT-Charlie	480	+	48	54291938	76923
chr20	52827509	53027509	harbor1	chr20	52836385	52836576	DNA/hAT-Charlie	843	+	96	52836481	8972
chr20	52827509	53027509	harbor1	chr20	52852476	52852695	DNA/hAT-Charlie	950	+	110	52852586	25077
chr20	52827509	53027509	harbor1	chr20	52858625	52858814	DNA/hAT-Charlie	807	+	94	52858719	31210
chr20	52827509	53027509	harbor1	chr20	52868283	52868324	DNA/hAT-Charlie	1610	+	20	52868303	40794
chr20	52827509	53027509	harbor1	chr20	52868638	52869045	DNA/hAT-Charlie	1610	+	204	52868842	41333
chr20	52827509	53027509	harbor1	chr20	52885869	52886050	DNA/hAT-Charlie	654	+	90	52885959	58450
chr20	52827509	53027509	harbor1	chr20	52892041	52892264	DNA/hAT-Charlie	740	+	112	52892153	64644
chr20	52827509	53027509	harbor1	chr20	52900398	52900718	DNA/hAT-Charlie	1153	+	160	52900558	73049
chr20	13475083	13675083	harbor1	chr20	13515405	13515551	DNA/hAT-Charlie	784	+	73	13515478	40395
chr20	13475083	13675083	harbor1	chr20	13539796	13540152	DNA/hAT-Charlie	829	+	178	13539974	64891
chr20	13475083	13675083	harbor1	chr20	13558425	13558522	DNA/hAT-Charlie	410	+	48	13558473	83390
chr20	13475083	13675083	harbor1	chr20	13558518	13558924	DNA/hAT-Charlie	1114	+	203	13558721	83638
chr20	53709583	53909583	harbor1	chr20	53712893	53713055	DNA/hAT-Charlie	532	+	81	53712974	3391
chr20	53709583	53909583	harbor1	chr20	53741721	53741894	DNA/hAT-Charlie	590	+	86	53741807	32224
chr20	53709583	53909583	harbor1	chr20	53773675	53773853	DNA/hAT-Charlie	808	+	89	53773764	64181
chr20	53709583	53909583	harbor1	chr20	53779429	53779502	DNA/hAT-Charlie	465	+	36	53779465	69882
chr20	53709583	53909583	harbor1	chr20	53801994	53802277	DNA/hAT-Charlie	1059	+	142	53802136	92553
chr20	21489436	21689436	harbor1	chr20	21499033	21499137	DNA/hAT-Charlie	409	+	52	21499085	9649
chr20	21489436	21689436	harbor1	chr20	21500563	21500710	DNA/hAT-Charlie	624	+	74	21500637	11201
chr20	21489436	21689436	harbor1	chr20	21533551	21533675	DNA/hAT-Charlie	400	+	62	21533613	44177
chr20	21489436	21689436	harbor1	chr20	21542368	21542683	DNA/hAT-Charlie	1259	+	158	21542526	53090
chr20	21489436	21689436	harbor1	chr20	21543532	21543835	DNA/hAT-Charlie	778	+	152	21543684	54248
chr20	21489436	21689436	harbor1	chr20	21570908	21571000	DNA/hAT-Charlie	430	+	46	21570954	81518
chr20	21489436	21689436	harbor1	chr20	21588132	21588340	DNA/hAT-Charlie	1079	+	104	21588236	98800
chr20	44313649	44513649	harbor1	chr20	44313514	44313763	DNA/hAT-Charlie	800	+	124	44313638	11
chr20	44313649	44513649	harbor1	chr20	44386574	44386788	DNA/hAT-Charlie	1052	+	107	44386681	73032
chr20	44313649	44513649	harbor1	chr20	44384192	44384378	DNA/hAT-Charlie	479	+	93	44384285	70636
chr20	889859	1089859	harbor1	chr20	891845	892013	DNA/hAT-Charlie	636	+	84	891929	2070
chr20	889859	1089859	harbor1	chr20	893109	893372	DNA/hAT-Charlie	934	+	132	893241	3382
chr20	889859	1089859	harbor1	chr20	902296	902783	DNA/hAT-Charlie	1596	+	244	902540	12681
chr20	889859	1089859	harbor1	chr20	963084	963458	DNA/hAT-Charlie	532	+	187	963271	73412
chr20	889859	1089859	harbor1	chr20	963541	963713	DNA/hAT-Charlie	628	+	86	963627	73768
chr20	889859	1089859	harbor1	chr20	976793	977021	DNA/hAT-Charlie	597	+	114	976907	87048
chr20	16978792	17178792	harbor1	chr20	16983057	16983358	DNA/hAT-Charlie	1755	+	150	16983207	4415
chr20	16978792	17178792	harbor1	chr20	16997038	16997189	DNA/hAT-Charlie	631	+	76	16997114	18322
chr20	16978792	17178792	harbor1	chr20	17013017	17013232	DNA/hAT-Charlie	1100	+	108	17013125	34333
chr20	16978792	17178792	harbor1	chr20	17023836	17023930	DNA/hAT-Charlie	410	+	47	17023883	45091
chr20	16978792	17178792	harbor1	chr20	17023931	17024280	DNA/hAT-Charlie	2038	+	174	17024105	45313
chr20	16978792	17178792	harbor1	chr20	17024281	17024322	DNA/hAT-Charlie	410	+	20	17024301	45509
chr20	16978792	17178792	harbor1	chr20	17049042	17049327	DNA/hAT-Charlie	818	+	142	17049184	70392
chr20	16978792	17178792	harbor1	chr20	17049804	17049993	DNA/hAT-Charlie	635	+	94	17049898	71106
chr20	4199183	4399183	harbor1	chr20	4199859	4199930	DNA/hAT-Charlie	669	+	36	4199895	712
chr20	4199183	4399183	harbor1	chr20	4222239	4222380	DNA/hAT-Charlie	583	+	70	4222309	23126
chr20	4199183	4399183	harbor1	chr20	4222989	4223101	DNA/hAT-Charlie	454	+	56	4223045	23862
chr20	4199183	4399183	harbor1	chr20	4223216	4223430	DNA/hAT-Charlie	825	+	107	4223323	24140
chr20	52133261	52333261	harbor1	chr20	52134794	52134853	DNA/hAT-Charlie	1258	+	30	52134824	1563
chr20	52133261	52333261	harbor1	chr20	52135164	52135425	DNA/hAT-Charlie	1258	+	130	52135294	2033
chr20	52133261	52333261	harbor1	chr20	52136325	52136777	DNA/hAT-Charlie	1209	+	226	52136551	3290
chr20	52133261	52333261	harbor1	chr20	52137065	52137213	DNA/hAT-Charlie	1209	+	74	52137139	3878
chr20	52133261	52333261	harbor1	chr20	52154727	52154920	DNA/hAT-Charlie	1085	+	96	52154823	21562
chr20	52133261	52333261	harbor1	chr20	52168403	52168586	DNA/hAT-Charlie	1114	+	92	52168495	35234
chr20	52133261	52333261	harbor1	chr20	52198222	52198427	DNA/hAT-Charlie	555	+	102	52198324	65063
chr20	52133261	52333261	harbor1	chr20	52224536	52224839	DNA/hAT-Charlie	1305	+	152	52224688	91427
chr20	52133261	52333261	harbor1	chr20	52228565	52228895	DNA/hAT-Charlie	1821	+	165	52228730	95469
chr20	4288513	4488513	harbor1	chr20	4357249	4357394	DNA/hAT-Charlie	763	+	72	4357321	68808
chr20	4288513	4488513	harbor1	chr20	4357403	4357515	DNA/hAT-Charlie	1071	+	56	4357459	68946
chr20	4288513	4488513	harbor1	chr20	4358038	4358130	DNA/hAT-Charlie	1071	+	46	4358084	69571
chr20	4288513	4488513	harbor1	chr20	4363585	4363742	DNA/hAT-Charlie	530	+	78	4363663	75150
chr20	4288513	4488513	harbor1	chr20	4372304	4372475	DNA/hAT-Charlie	622	+	86	4372390	83877
chr20	4288513	4488513	harbor1	chr20	4379554	4379678	DNA/hAT-Charlie	458	+	62	4379616	91103
chr20	43649659	43849659	harbor1	chr20	43725379	43725594	DNA/hAT-Charlie	1082	+	108	43725487	75828
chr20	43649659	43849659	harbor1	chr20	43728095	43728303	DNA/hAT-Charlie	905	+	104	43728199	78540
chr20	45816552	46016552	harbor1	chr20	45837257	45837448	DNA/hAT-Charlie	542	+	96	45837353	20801
chr20	45816552	46016552	harbor1	chr20	45845682	45845827	DNA/hAT-Charlie	848	+	72	45845754	29202
chr20	45816552	46016552	harbor1	chr20	45846138	45846204	DNA/hAT-Charlie	848	+	33	45846171	29619
chr20	45816552	46016552	harbor1	chr20	45901064	45901244	DNA/hAT-Charlie	975	+	90	45901154	84602
chr20	38458967	38658967	harbor1	chr20	38473713	38473894	DNA/hAT-Charlie	715	+	90	38473803	14836
chr20	38458967	38658967	harbor1	chr20	38477080	38477293	DNA/hAT-Charlie	625	+	106	38477186	18219
chr20	38458967	38658967	harbor1	chr20	38484565	38484705	DNA/hAT-Charlie	454	+	70	38484635	25668
chr20	38458967	38658967	harbor1	chr20	38548329	38548589	DNA/hAT-Charlie	423	+	130	38548459	89492
chr20	32123577	32323577	harbor1	chr20	32125455	32125598	DNA/hAT-Charlie	628	+	72	32125527	1950
chr20	32123577	32323577	harbor1	chr20	32126204	32126365	DNA/hAT-Charlie	1018	+	80	32126284	2707
chr20	32123577	32323577	harbor1	chr20	32162406	32162618	DNA/hAT-Charlie	1257	+	106	32162512	38935
chr20	48877355	49077355	harbor1	chr20	48916133	48916269	DNA/hAT-Charlie	466	+	68	48916201	38846
chr20	48877355	49077355	harbor1	chr20	48940702	48940917	DNA/hAT-Charlie	1042	+	108	48940810	63455
chr20	48877355	49077355	harbor1	chr20	48944806	48944885	DNA/hAT-Charlie	1037	+	40	48944846	67491
chr20	48877355	49077355	harbor1	chr20	48945250	48945389	DNA/hAT-Charlie	1037	+	70	48945320	67965
chr20	48877355	49077355	harbor1	chr20	48959902	48960027	DNA/hAT-Charlie	622	+	62	48959964	82609
chr20	48877355	49077355	harbor1	chr20	48962471	48962573	DNA/hAT-Charlie	622	+	51	48962522	85167
chr20	48877355	49077355	harbor1	chr20	48964805	48965011	DNA/hAT-Charlie	441	+	103	48964908	87553
chr20	48877355	49077355	harbor1	chr20	48971989	48972124	DNA/hAT-Charlie	451	+	68	48972057	94702
chr20	48877355	49077355	harbor1	chr20	48973715	48973844	DNA/hAT-Charlie	452	+	64	48973779	96424
chr20	10985608	11185608	harbor1	chr20	10986796	10986980	DNA/hAT-Charlie	783	+	92	10986888	1280
chr20	10985608	11185608	harbor1	chr20	10990222	10990374	DNA/hAT-Charlie	719	+	76	10990298	4690
chr20	10985608	11185608	harbor1	chr20	10996312	10996451	DNA/hAT-Charlie	714	+	70	10996382	10774
chr20	10985608	11185608	harbor1	chr20	10996452	10996802	DNA/hAT-Charlie	2009	+	175	10996627	11019
chr20	10985608	11185608	harbor1	chr20	10996803	10996839	DNA/hAT-Charlie	714	+	18	10996821	11213
chr20	10985608	11185608	harbor1	chr20	10997189	10997299	DNA/hAT-Charlie	471	+	55	10997244	11636
chr20	10985608	11185608	harbor1	chr20	10997612	10997659	DNA/hAT-Charlie	471	+	24	10997636	12028
chr20	10985608	11185608	harbor1	chr20	11003460	11003623	DNA/hAT-Charlie	608	+	82	11003542	17934
chr20	10985608	11185608	harbor1	chr20	11042481	11042598	DNA/hAT-Charlie	434	+	58	11042539	56931
chr20	10985608	11185608	harbor1	chr20	11053573	11053608	DNA/hAT-Charlie	599	+	18	11053591	67983
chr20	10985608	11185608	harbor1	chr20	11053990	11054245	DNA/hAT-Charlie	599	+	128	11054118	68510
chr20	10985608	11185608	harbor1	chr20	11074303	11074369	DNA/hAT-Charlie	434	+	33	11074336	88728
chr20	10985608	11185608	harbor1	chr20	11074793	11074850	DNA/hAT-Charlie	434	+	28	11074821	89213
chr20	10985608	11185608	harbor1	chr20	11074964	11075119	DNA/hAT-Charlie	557	+	78	11075042	89434
chr20	10985608	11185608	harbor1	chr20	11079609	11079917	DNA/hAT-Charlie	1151	+	154	11079763	94155
chr20	10985608	11185608	harbor1	chr20	11083030	11083681	DNA/hAT-Charlie	946	+	326	11083356	97748
chr20	10985608	11185608	harbor1	chr20	11042751	11042910	DNA/hAT-Charlie	504	+	80	11042831	57223
chr20	54634082	54834082	harbor1	chr20	54643947	54644119	DNA/hAT-Charlie	813	+	86	54644033	9951
chr20	54634082	54834082	harbor1	chr20	54649681	54649893	DNA/hAT-Charlie	966	+	106	54649787	15705
chr20	54634082	54834082	harbor1	chr20	54657491	54657656	DNA/hAT-Charlie	840	+	82	54657573	23491
chr20	54634082	54834082	harbor1	chr20	54658820	54659375	DNA/hAT-Charlie	2308	+	278	54659098	25016
chr20	54634082	54834082	harbor1	chr20	54667786	54667964	DNA/hAT-Charlie	475	+	89	54667875	33793
chr20	54634082	54834082	harbor1	chr20	54719427	54719575	DNA/hAT-Charlie	419	+	74	54719501	85419
chr20	54634082	54834082	harbor1	chr20	54720639	54720895	DNA/hAT-Charlie	474	+	128	54720767	86685
chr20	34388387	34588387	harbor1	chr20	34458059	34458308	DNA/hAT-Charlie	574	+	124	34458183	69796
chr20	17792169	17992169	harbor1	chr20	17795323	17795501	DNA/hAT-Charlie	492	+	89	17795412	3243
chr20	17792169	17992169	harbor1	chr20	17801805	17801979	DNA/hAT-Charlie	504	+	87	17801892	9723
chr20	17792169	17992169	harbor1	chr20	17827396	17827542	DNA/hAT-Charlie	600	+	73	17827469	35300
chr20	17792169	17992169	harbor1	chr20	17864806	17865011	DNA/hAT-Charlie	925	+	102	17864908	72739
chr20	24247870	24447870	harbor1	chr20	24277835	24277994	DNA/hAT-Charlie	512	+	80	24277915	30045
chr20	24247870	24447870	harbor1	chr20	24346826	24347058	DNA/hAT-Charlie	761	+	116	24346942	99072
chr20	24247870	24447870	harbor1	chr20	24347341	24347464	DNA/hAT-Charlie	761	+	62	24347403	99533
chr20	38117564	38317564	harbor1	chr20	38127560	38127886	DNA/hAT-Charlie	1468	+	163	38127723	10159
chr20	38117564	38317564	harbor1	chr20	38140445	38140864	DNA/hAT-Charlie	1242	+	210	38140655	23091
chr20	38117564	38317564	harbor1	chr20	38150425	38150508	DNA/hAT-Charlie	475	+	42	38150467	32903
chr20	38278937	38478937	harbor1	chr20	38306808	38306900	DNA/hAT-Charlie	1046	+	46	38306854	27917
chr20	38278937	38478937	harbor1	chr20	38307223	38307440	DNA/hAT-Charlie	1046	+	108	38307331	28394
chr20	38278937	38478937	harbor1	chr20	38342294	38342429	DNA/hAT-Charlie	467	+	68	38342362	63425
chr20	38278937	38478937	harbor1	chr20	38352327	38352448	DNA/hAT-Charlie	428	+	60	38352387	73450
chr20	38278937	38478937	harbor1	chr20	38352824	38352992	DNA/hAT-Charlie	595	+	84	38352908	73971
chr20	41770379	41970379	harbor1	chr20	41773307	41773522	DNA/hAT-Charlie	1150	+	108	41773415	3036
chr20	41770379	41970379	harbor1	chr20	41786257	41786595	DNA/hAT-Charlie	1451	+	169	41786426	16047
chr20	41770379	41970379	harbor1	chr20	41790725	41791075	DNA/hAT-Charlie	663	+	175	41790900	20521
chr20	41770379	41970379	harbor1	chr20	41791247	41791382	DNA/hAT-Charlie	690	+	68	41791315	20936
chr20	41770379	41970379	harbor1	chr20	41801069	41801256	DNA/hAT-Charlie	884	+	94	41801163	30784
chr20	41770379	41970379	harbor1	chr20	41826104	41826269	DNA/hAT-Charlie	796	+	82	41826186	55807
chr20	41770379	41970379	harbor1	chr20	41837165	41837341	DNA/hAT-Charlie	943	+	88	41837253	66874
chr20	41770379	41970379	harbor1	chr20	41863381	41863599	DNA/hAT-Charlie	1078	+	109	41863490	93111
chr20	4764491	4964491	harbor1	chr20	4770138	4770264	DNA/hAT-Charlie	623	+	63	4770201	5710
chr20	4764491	4964491	harbor1	chr20	4773445	4773553	DNA/hAT-Charlie	452	+	54	4773499	9008
chr20	4764491	4964491	harbor1	chr20	4773585	4773723	DNA/hAT-Charlie	775	+	69	4773654	9163
chr20	4764491	4964491	harbor1	chr20	4811370	4811494	DNA/hAT-Charlie	526	+	62	4811432	46941
chr20	4764491	4964491	harbor1	chr20	4848149	4848504	DNA/hAT-Charlie	2199	+	178	4848327	83836
chr20	8532838	8732838	harbor1	chr20	8543076	8543187	DNA/hAT-Charlie	541	+	56	8543132	10294
chr20	8532838	8732838	harbor1	chr20	8560419	8560548	DNA/hAT-Charlie	411	+	64	8560483	27645
chr20	8532838	8732838	harbor1	chr20	8592881	8593049	DNA/hAT-Charlie	655	+	84	8592965	60127
chr20	8532838	8732838	harbor1	chr20	8603552	8603727	DNA/hAT-Charlie	976	+	88	8603640	70802
chr20	15172802	15372802	harbor1	chr20	15186620	15187110	DNA/hAT-Charlie	1235	+	245	15186865	14063
chr20	15172802	15372802	harbor1	chr20	15212796	15213000	DNA/hAT-Charlie	731	+	102	15212898	40096
chr20	15172802	15372802	harbor1	chr20	15237213	15237533	DNA/hAT-Charlie	904	+	160	15237373	64571
chr20	15172802	15372802	harbor1	chr20	15238008	15238118	DNA/hAT-Charlie	430	+	55	15238063	65261
chr20	15172802	15372802	harbor1	chr20	15249534	15250036	DNA/hAT-Charlie	1658	+	251	15249785	76983
chr20	15172802	15372802	harbor1	chr20	15253234	15253361	DNA/hAT-Charlie	631	+	64	15253298	80496
chr20	15172802	15372802	harbor1	chr20	15236939	15237160	DNA/hAT-Charlie	710	+	110	15237049	64247
chr20	53491436	53691436	harbor1	chr20	53502949	53503175	DNA/hAT-Charlie	704	+	113	53503062	11626
chr20	53491436	53691436	harbor1	chr20	53512540	53512691	DNA/hAT-Charlie	709	+	76	53512616	21180
chr20	53491436	53691436	harbor1	chr20	53513512	53513616	DNA/hAT-Charlie	405	+	52	53513564	22128
chr20	53491436	53691436	harbor1	chr20	53515019	53515116	DNA/hAT-Charlie	509	+	48	53515067	23631
chr20	53491436	53691436	harbor1	chr20	53517223	53517699	DNA/hAT-Charlie	3031	+	238	53517461	26025
chr20	53491436	53691436	harbor1	chr20	53521322	53521480	DNA/hAT-Charlie	734	+	79	53521401	29965
chr20	53491436	53691436	harbor1	chr20	53531569	53531768	DNA/hAT-Charlie	1008	+	100	53531669	40233
chr20	53491436	53691436	harbor1	chr20	53531776	53531933	DNA/hAT-Charlie	722	+	78	53531854	40418
chr20	53491436	53691436	harbor1	chr20	53531974	53532105	DNA/hAT-Charlie	434	+	66	53532040	40604
chr20	53491436	53691436	harbor1	chr20	53535843	53536045	DNA/hAT-Charlie	655	+	101	53535944	44508
chr20	53491436	53691436	harbor1	chr20	53546944	53547152	DNA/hAT-Charlie	731	+	104	53547048	55612
chr20	53598138	53798138	harbor1	chr20	53637001	53637173	DNA/hAT-Charlie	1409	+	86	53637087	38949
chr20	53598138	53798138	harbor1	chr20	53637481	53637620	DNA/hAT-Charlie	1409	+	70	53637551	39413
chr20	53598138	53798138	harbor1	chr20	53645398	53645570	DNA/hAT-Charlie	590	+	86	53645484	47346
chr20	53598138	53798138	harbor1	chr20	53677613	53677926	DNA/hAT-Charlie	628	+	156	53677769	79631
chr20	53598138	53798138	harbor1	chr20	53694660	53694875	DNA/hAT-Charlie	744	+	108	53694768	96630
chr20	52368674	52568674	harbor1	chr20	52376315	52376696	DNA/hAT-Charlie	845	+	190	52376505	7831
chr20	52368674	52568674	harbor1	chr20	52378152	52378337	DNA/hAT-Charlie	717	+	92	52378244	9570
chr20	52368674	52568674	harbor1	chr20	52386296	52386752	DNA/hAT-Charlie	2296	+	228	52386524	17850
chr20	52368674	52568674	harbor1	chr20	52397120	52397345	DNA/hAT-Charlie	934	+	112	52397232	28558
chr20	52368674	52568674	harbor1	chr20	52411725	52411933	DNA/hAT-Charlie	1095	+	104	52411829	43155
chr20	52368674	52568674	harbor1	chr20	52415554	52415686	DNA/hAT-Charlie	862	+	66	52415620	46946
chr20	52368674	52568674	harbor1	chr20	52417187	52417344	DNA/hAT-Charlie	863	+	78	52417265	48591
chr20	52368674	52568674	harbor1	chr20	52427470	52427700	DNA/hAT-Charlie	605	+	115	52427585	58911
chr20	52368674	52568674	harbor1	chr20	52432871	52433014	DNA/hAT-Charlie	438	+	72	52432943	64269
chr20	52368674	52568674	harbor1	chr20	52433407	52433611	DNA/hAT-Charlie	996	+	102	52433509	64835
chr20	52368674	52568674	harbor1	chr20	52436564	52436730	DNA/hAT-Charlie	515	+	83	52436647	67973
chr20	52368674	52568674	harbor1	chr20	52438395	52438610	DNA/hAT-Charlie	1151	+	108	52438503	69829
chr20	52368674	52568674	harbor1	chr20	52448848	52449131	DNA/hAT-Charlie	636	+	142	52448990	80316
chr20	52368674	52568674	harbor1	chr20	52452389	52452466	DNA/hAT-Charlie	444	+	38	52452427	83753
chr20	52368674	52568674	harbor1	chr20	52460361	52460891	DNA/hAT-Charlie	1437	+	265	52460626	91952
chr20	3749752	3949752	harbor1	chr20	3762658	3762830	DNA/hAT-Charlie	633	+	86	3762744	12992
chr20	3749752	3949752	harbor1	chr20	3792943	3793175	DNA/hAT-Charlie	863	+	116	3793059	43307
chr20	3749752	3949752	harbor1	chr20	3844542	3844589	DNA/hAT-Charlie	785	+	24	3844566	94814
chr20	3749752	3949752	harbor1	chr20	3844900	3844964	DNA/hAT-Charlie	785	+	32	3844932	95180
chr20	3749752	3949752	harbor1	chr20	3845277	3845373	DNA/hAT-Charlie	785	+	48	3845325	95573
chr21	14701832	14901832	harbor1	chr21	14703408	14703521	DNA/hAT-Charlie	503	+	56	14703464	1632
chr21	14701832	14901832	harbor1	chr21	14731941	14732111	DNA/hAT-Charlie	570	+	85	14732026	30194
chr21	14701832	14901832	harbor1	chr21	14741380	14741509	DNA/hAT-Charlie	538	+	64	14741444	39612
chr21	14701832	14901832	harbor1	chr21	14770458	14770553	DNA/hAT-Charlie	521	+	48	14770506	68674
chr21	15538027	15738027	harbor1	chr21	15612562	15612780	DNA/hAT-Charlie	1293	+	109	15612671	74644
chr21	22522653	22722653	harbor1	chr21	22525311	22525628	DNA/hAT-Charlie	1398	+	158	22525469	2816
chr21	22522653	22722653	harbor1	chr21	22586838	22587628	DNA/hAT-Charlie	3386	+	395	22587233	64580
chr21	22522653	22722653	harbor1	chr21	22587952	22588505	DNA/hAT-Charlie	3386	+	276	22588228	65575
chr21	36005838	36205838	harbor1	chr21	36029375	36029531	DNA/hAT-Charlie	539	+	78	36029453	23615
chr21	36005838	36205838	harbor1	chr21	36068211	36068412	DNA/hAT-Charlie	979	+	100	36068311	62473
chr21	37348637	37548637	harbor1	chr21	37350603	37350827	DNA/hAT-Charlie	1086	+	112	37350715	2078
chr21	37348637	37548637	harbor1	chr21	37386179	37386380	DNA/hAT-Charlie	1263	+	100	37386279	37642
chr21	37348637	37548637	harbor1	chr21	37394470	37394801	DNA/hAT-Charlie	2248	+	166	37394636	45999
chr21	37348637	37548637	harbor1	chr21	37395430	37395536	DNA/hAT-Charlie	549	+	53	37395483	46846
chr21	37348637	37548637	harbor1	chr21	37439454	37439743	DNA/hAT-Charlie	1507	+	144	37439598	90961
chr21	37348637	37548637	harbor1	chr21	37447457	37447638	DNA/hAT-Charlie	908	+	90	37447547	98910
chr21	42083860	42283860	harbor1	chr21	42166848	42167190	DNA/hAT-Charlie	1275	+	171	42167019	83159
chr21	31951876	32151876	harbor1	chr21	31975487	31976419	DNA/hAT-Charlie	1543	+	466	31975953	24077
chr21	31951876	32151876	harbor1	chr21	31977112	31977273	DNA/hAT-Charlie	541	+	80	31977192	25316
chr21	31951876	32151876	harbor1	chr21	31983791	31983961	DNA/hAT-Charlie	888	+	85	31983876	32000
chr21	31951876	32151876	harbor1	chr21	32027975	32028164	DNA/hAT-Charlie	661	+	94	32028069	76193
chr21	34627057	34827057	harbor1	chr21	34677827	34678147	DNA/hAT-Charlie	1596	+	160	34677987	50930
chr21	34627057	34827057	harbor1	chr21	34725972	34726137	DNA/hAT-Charlie	484	+	82	34726054	98997
chr21	26046952	26246952	harbor1	chr21	26047756	26048034	DNA/hAT-Charlie	1031	+	139	26047895	943
chr21	26046952	26246952	harbor1	chr21	26048342	26048374	DNA/hAT-Charlie	1031	+	16	26048358	1406
chr21	26046952	26246952	harbor1	chr21	26126603	26126771	DNA/hAT-Charlie	681	+	84	26126687	79735
chr21	10112149	10312149	harbor1	chr21	10117428	10117578	DNA/hAT-Charlie	652	+	75	10117503	5354
chr21	13179579	13379579	harbor1	chr21	13201407	13201594	DNA/hAT-Charlie	766	+	94	13201501	21922
chr21	28917077	29117077	harbor1	chr21	28987599	28987861	DNA/hAT-Charlie	1023	+	131	28987730	70653
chr21	28917077	29117077	harbor1	chr21	28988170	28988184	DNA/hAT-Charlie	1023	+	7	28988177	71100
chr21	28917077	29117077	harbor1	chr21	28988483	28988684	DNA/hAT-Charlie	1023	+	100	28988583	71506
chr21	28917077	29117077	harbor1	chr21	28988994	28989546	DNA/hAT-Charlie	1023	+	276	28989270	72193
chr21	5626133	5826133	harbor1	chr21	5695600	5695795	DNA/hAT-Charlie	1283	+	98	5695698	69565
chr21	30089444	30289444	harbor1	chr21	30174614	30174742	DNA/hAT-Charlie	599	+	64	30174678	85234
chr21	30089444	30289444	harbor1	chr21	30180777	30180951	DNA/hAT-Charlie	725	+	87	30180864	91420
chr21	30089444	30289444	harbor1	chr21	30182622	30183268	DNA/hAT-Charlie	1404	+	323	30182945	93501
chr21	24459332	24659332	harbor1	chr21	24509980	24510202	DNA/hAT-Charlie	1569	+	111	24510091	50759
chr21	28827894	29027894	harbor1	chr21	28895470	28895812	DNA/hAT-Charlie	2200	+	171	28895641	67747
chr21	28827894	29027894	harbor1	chr21	28896650	28896773	DNA/hAT-Charlie	959	+	62	28896712	68818
chr21	28827894	29027894	harbor1	chr21	28897072	28897238	DNA/hAT-Charlie	959	+	83	28897155	69261
chr21	39047235	39247235	harbor1	chr21	39053863	39054076	DNA/hAT-Charlie	1152	+	106	39053969	6734
chr21	39047235	39247235	harbor1	chr21	39068232	39068342	DNA/hAT-Charlie	595	+	55	39068287	21052
chr21	39047235	39247235	harbor1	chr21	39081918	39082351	DNA/hAT-Charlie	1519	+	216	39082134	34899
chr21	39047235	39247235	harbor1	chr21	39085027	39085143	DNA/hAT-Charlie	680	+	58	39085085	37850
chr21	39047235	39247235	harbor1	chr21	39099802	39100240	DNA/hAT-Charlie	2699	+	219	39100021	52786
chr21	39047235	39247235	harbor1	chr21	39100235	39100691	DNA/hAT-Charlie	3352	+	228	39100463	53228
chr21	39047235	39247235	harbor1	chr21	39104499	39104722	DNA/hAT-Charlie	525	+	112	39104611	57376
chr21	39047235	39247235	harbor1	chr21	39104735	39104920	DNA/hAT-Charlie	1691	+	92	39104827	57592
chr21	39047235	39247235	harbor1	chr21	39105245	39105393	DNA/hAT-Charlie	1691	+	74	39105319	58084
chr21	39047235	39247235	harbor1	chr21	39126674	39126879	DNA/hAT-Charlie	896	+	102	39126776	79541
chr21	39047235	39247235	harbor1	chr21	39141155	39141339	DNA/hAT-Charlie	677	+	92	39141247	94012
chr21	26791196	26991196	harbor1	chr21	26835791	26836029	DNA/hAT-Charlie	941	+	119	26835910	44714
chr21	26791196	26991196	harbor1	chr21	26851680	26851887	DNA/hAT-Charlie	926	+	104	26851784	60588
chr21	39405883	39605883	harbor1	chr21	39433976	39434497	DNA/hAT-Charlie	1106	+	260	39434236	28353
chr21	39405883	39605883	harbor1	chr21	39463634	39463806	DNA/hAT-Charlie	660	+	86	39463720	57837
chr21	26760630	26960630	harbor1	chr21	26835791	26836029	DNA/hAT-Charlie	941	+	119	26835910	75280
chr21	26760630	26960630	harbor1	chr21	26851680	26851887	DNA/hAT-Charlie	926	+	104	26851784	91154
chr21	29058413	29258413	harbor1	chr21	29075163	29075379	DNA/hAT-Charlie	876	+	108	29075271	16858
chr21	29058413	29258413	harbor1	chr21	29094091	29094302	DNA/hAT-Charlie	1216	+	106	29094197	35784
chr21	29058413	29258413	harbor1	chr21	29103091	29103306	DNA/hAT-Charlie	1095	+	108	29103199	44786
chr21	29058413	29258413	harbor1	chr21	29124601	29124807	DNA/hAT-Charlie	762	+	103	29124704	66291
chr21	29058413	29258413	harbor1	chr21	29124807	29124973	DNA/hAT-Charlie	843	+	83	29124890	66477
chr21	29058413	29258413	harbor1	chr21	29126216	29126449	DNA/hAT-Charlie	676	+	116	29126332	67919
chr21	29058413	29258413	harbor1	chr21	29126758	29126815	DNA/hAT-Charlie	676	+	28	29126786	68373
chr21	13248638	13448638	harbor1	chr21	13279416	13279772	DNA/hAT-Charlie	839	+	178	13279594	30956
chr21	13248638	13448638	harbor1	chr21	13317458	13317676	DNA/hAT-Charlie	829	+	109	13317567	68929
chr22	38474943	38674943	harbor1	chr22	38478199	38478263	DNA/hAT-Charlie	452	+	32	38478231	3288
chr22	38474943	38674943	harbor1	chr22	38478563	38478629	DNA/hAT-Charlie	452	+	33	38478596	3653
chr22	38474943	38674943	harbor1	chr22	38478941	38478982	DNA/hAT-Charlie	452	+	20	38478961	4018
chr22	38474943	38674943	harbor1	chr22	38493108	38493190	DNA/hAT-Charlie	832	+	41	38493149	18206
chr22	38474943	38674943	harbor1	chr22	38493477	38493637	DNA/hAT-Charlie	832	+	80	38493557	18614
chr22	38474943	38674943	harbor1	chr22	38567352	38567544	DNA/hAT-Charlie	1019	+	96	38567448	92505
chr22	44952498	45152498	harbor1	chr22	44971001	44971140	DNA/hAT-Charlie	540	+	70	44971071	18573
chr22	24972654	25172654	harbor1	chr22	25045270	25045487	DNA/hAT-Charlie	1024	+	108	25045378	72724
chr22	24972654	25172654	harbor1	chr22	25058100	25058198	DNA/hAT-Charlie	469	+	49	25058149	85495
chr22	24972654	25172654	harbor1	chr22	25070670	25070888	DNA/hAT-Charlie	671	+	109	25070779	98125
chr22	25608820	25808820	harbor1	chr22	25635018	25635206	DNA/hAT-Charlie	1032	+	94	25635112	26292
chr22	25608820	25808820	harbor1	chr22	25671798	25672009	DNA/hAT-Charlie	1094	+	106	25671904	63084
chr22	25608820	25808820	harbor1	chr22	25673761	25674000	DNA/hAT-Charlie	710	+	120	25673881	65061
chr22	25608820	25808820	harbor1	chr22	25683014	25683222	DNA/hAT-Charlie	799	+	104	25683118	74298
chr22	25608820	25808820	harbor1	chr22	25699400	25699594	DNA/hAT-Charlie	929	+	97	25699497	90677
chr22	25798460	25998460	harbor1	chr22	25798297	25798493	DNA/hAT-Charlie	1023	+	98	25798395	65
chr22	25798460	25998460	harbor1	chr22	25819413	25819781	DNA/hAT-Charlie	957	+	184	25819597	21137
chr22	25798460	25998460	harbor1	chr22	25843252	25843517	DNA/hAT-Charlie	478	+	132	25843384	44924
chr22	25798460	25998460	harbor1	chr22	25851039	25851282	DNA/hAT-Charlie	540	+	122	25851161	52701
chr22	25798460	25998460	harbor1	chr22	25870663	25870834	DNA/hAT-Charlie	921	+	86	25870749	72289
chr22	25798460	25998460	harbor1	chr22	25875536	25875720	DNA/hAT-Charlie	1132	+	92	25875628	77168
chr22	25798460	25998460	harbor1	chr22	25879072	25879301	DNA/hAT-Charlie	1143	+	114	25879186	80726
chr22	34960747	35160747	harbor1	chr22	34965617	34965873	DNA/hAT-Charlie	1315	+	128	34965745	4998
chr22	34960747	35160747	harbor1	chr22	34982265	34982459	DNA/hAT-Charlie	752	+	97	34982362	21615
chr22	34960747	35160747	harbor1	chr22	34998394	34998620	DNA/hAT-Charlie	1135	+	113	34998507	37760
chr22	34960747	35160747	harbor1	chr22	34998615	34998659	DNA/hAT-Charlie	571	+	22	34998637	37890
chr22	34960747	35160747	harbor1	chr22	34998959	34999078	DNA/hAT-Charlie	571	+	60	34999019	38272
chr22	34960747	35160747	harbor1	chr22	35000601	35000686	DNA/hAT-Charlie	1427	+	42	35000643	39896
chr22	34960747	35160747	harbor1	chr22	35000998	35001255	DNA/hAT-Charlie	1427	+	128	35001126	40379
chr22	34960747	35160747	harbor1	chr22	35010651	35010760	DNA/hAT-Charlie	470	+	54	35010705	49958
chr22	34960747	35160747	harbor1	chr22	35017036	35017254	DNA/hAT-Charlie	957	+	109	35017145	56398
chr22	34960747	35160747	harbor1	chr22	35031764	35032034	DNA/hAT-Charlie	1276	+	135	35031899	71152
chr22	34960747	35160747	harbor1	chr22	35051603	35051863	DNA/hAT-Charlie	915	+	130	35051733	90986
chr22	34960747	35160747	harbor1	chr22	35053096	35053264	DNA/hAT-Charlie	670	+	84	35053180	92433
chr22	34960747	35160747	harbor1	chr22	35053353	35053468	DNA/hAT-Charlie	429	+	58	35053411	92664
chr22	48834009	49034009	harbor1	chr22	48833964	48834600	DNA/hAT-Charlie	961	+	318	48834282	273
chr22	31630915	31830915	harbor1	chr22	31698571	31698638	DNA/hAT-Charlie	476	+	34	31698605	67690
chr22	31630915	31830915	harbor1	chr22	31698931	31699055	DNA/hAT-Charlie	476	+	62	31698993	68078
chr22	31630915	31830915	harbor1	chr22	31699338	31699353	DNA/hAT-Charlie	476	+	8	31699346	68431
chr22	31630915	31830915	harbor1	chr22	31699646	31700139	DNA/hAT-Charlie	1304	+	246	31699892	68977
chr22	31630915	31830915	harbor1	chr22	31700148	31700364	DNA/hAT-Charlie	891	+	108	31700256	69341
chr22	31630915	31830915	harbor1	chr22	31723855	31724379	DNA/hAT-Charlie	3635	+	262	31724117	93202
chr22	27398645	27598645	harbor1	chr22	27419727	27419970	DNA/hAT-Charlie	688	+	122	27419849	21204
chr22	27398645	27598645	harbor1	chr22	27420268	27420385	DNA/hAT-Charlie	688	+	58	27420326	21681
chr22	27398645	27598645	harbor1	chr22	27423326	27423453	DNA/hAT-Charlie	545	+	64	27423390	24745
chr22	27398645	27598645	harbor1	chr22	27426650	27426779	DNA/hAT-Charlie	437	+	64	27426714	28069
chr22	27398645	27598645	harbor1	chr22	27463559	27463714	DNA/hAT-Charlie	495	+	78	27463637	64992
chr22	27398645	27598645	harbor1	chr22	27482260	27482596	DNA/hAT-Charlie	1296	+	168	27482428	83783
chr22	27398645	27598645	harbor1	chr22	27484523	27484646	DNA/hAT-Charlie	663	+	62	27484585	85940
chr22	27398645	27598645	harbor1	chr22	27493958	27494189	DNA/hAT-Charlie	790	+	116	27494074	95429
chr22	17057474	17257474	harbor1	chr22	17081024	17081176	DNA/hAT-Charlie	448	+	76	17081100	23626
chr22	17057474	17257474	harbor1	chr22	17081266	17081593	DNA/hAT-Charlie	1534	+	164	17081430	23956
chr22	17057474	17257474	harbor1	chr22	17082289	17082381	DNA/hAT-Charlie	802	+	46	17082335	24861
chr22	17057474	17257474	harbor1	chr22	17082510	17082628	DNA/hAT-Charlie	802	+	59	17082569	25095
chr22	17057474	17257474	harbor1	chr22	17083066	17083245	DNA/hAT-Charlie	802	+	90	17083156	25682
chr22	17057474	17257474	harbor1	chr22	17083567	17083687	DNA/hAT-Charlie	537	+	60	17083627	26153
chr22	17057474	17257474	harbor1	chr22	17099402	17099577	DNA/hAT-Charlie	766	+	88	17099490	42016
chr22	17057474	17257474	harbor1	chr22	17141899	17142093	DNA/hAT-Charlie	2071	+	97	17141996	84522
chr22	17057474	17257474	harbor1	chr22	17142226	17142832	DNA/hAT-Charlie	2071	+	303	17142529	85055
chr22	50670269	50870269	harbor1	chr22	50694192	50694374	DNA/hAT-Charlie	771	+	91	50694283	24014
chr22	25044341	25244341	harbor1	chr22	25045270	25045487	DNA/hAT-Charlie	1024	+	108	25045378	1037
chr22	25044341	25244341	harbor1	chr22	25058100	25058198	DNA/hAT-Charlie	469	+	49	25058149	13808
chr22	25044341	25244341	harbor1	chr22	25070670	25070888	DNA/hAT-Charlie	671	+	109	25070779	26438
chr22	25044341	25244341	harbor1	chr22	25075133	25075353	DNA/hAT-Charlie	1063	+	110	25075243	30902
chr22	25044341	25244341	harbor1	chr22	25097412	25097458	DNA/hAT-Charlie	497	+	23	25097435	53094
chr22	25044341	25244341	harbor1	chr22	25097769	25097868	DNA/hAT-Charlie	497	+	50	25097819	53478
chr22	21702152	21902152	harbor1	chr22	21791991	21792146	DNA/hAT-Charlie	473	+	78	21792069	89917
chr22	21702152	21902152	harbor1	chr22	21792138	21792438	DNA/hAT-Charlie	1423	+	150	21792288	90136
chr22	21702152	21902152	harbor1	chr22	21792916	21793059	DNA/hAT-Charlie	1471	+	72	21792988	90836
chr22	21702152	21902152	harbor1	chr22	21793679	21793801	DNA/hAT-Charlie	1471	+	61	21793740	91588
chr22	21702152	21902152	harbor1	chr22	21794104	21794169	DNA/hAT-Charlie	1471	+	32	21794136	91984
chr22	21702152	21902152	harbor1	chr22	21794466	21794503	DNA/hAT-Charlie	1471	+	18	21794484	92332
chr22	35207759	35407759	harbor1	chr22	35212972	35213087	DNA/hAT-Charlie	568	+	58	35213030	5271
chr22	35207759	35407759	harbor1	chr22	35215088	35215180	DNA/hAT-Charlie	821	+	46	35215134	7375
chr22	35207759	35407759	harbor1	chr22	35215458	35215599	DNA/hAT-Charlie	821	+	70	35215528	7769
chr22	35207759	35407759	harbor1	chr22	35270080	35270580	DNA/hAT-Charlie	3271	+	250	35270330	62571
chr22	35207759	35407759	harbor1	chr22	35271670	35271906	DNA/hAT-Charlie	915	+	118	35271788	64029
chr22	35207759	35407759	harbor1	chr22	35298997	35299145	DNA/hAT-Charlie	507	+	74	35299071	91312
chr22	24074093	24274093	harbor1	chr22	24076955	24077117	DNA/hAT-Charlie	832	+	81	24077036	2943
chr22	24074093	24274093	harbor1	chr22	24111281	24111613	DNA/hAT-Charlie	2076	+	166	24111447	37354
chr22	23731916	23931916	harbor1	chr22	23747175	23747517	DNA/hAT-Charlie	2290	+	171	23747346	15430
chr22	45007269	45207269	harbor1	chr22	45053524	45053715	DNA/hAT-Charlie	522	+	96	45053620	46351
chr22	45007269	45207269	harbor1	chr22	45089354	45089414	DNA/hAT-Charlie	541	+	30	45089384	82115
chr22	45007269	45207269	harbor1	chr22	45089715	45089794	DNA/hAT-Charlie	541	+	40	45089755	82486
chr22	45007269	45207269	harbor1	chr22	45090089	45090180	DNA/hAT-Charlie	541	+	46	45090135	82866
chr22	45007269	45207269	harbor1	chr22	45103993	45104263	DNA/hAT-Charlie	431	+	135	45104128	96859
chr22	25299456	25499456	harbor1	chr22	25359589	25359767	DNA/hAT-Charlie	675	+	89	25359678	60222
chr22	22178314	22378314	harbor1	chr22	22196994	22197208	DNA/hAT-Charlie	1265	+	107	22197101	18787
chr22	44965786	45165786	harbor1	chr22	44971001	44971140	DNA/hAT-Charlie	540	+	70	44971071	5285
chr22	44965786	45165786	harbor1	chr22	45053524	45053715	DNA/hAT-Charlie	522	+	96	45053620	87834
chr22	41067104	41267104	harbor1	chr22	41115194	41115408	DNA/hAT-Charlie	937	+	107	41115301	48197
chr22	41067104	41267104	harbor1	chr22	41144810	41145099	DNA/hAT-Charlie	470	+	144	41144954	77850
chr22	21423024	21623024	harbor1	chr22	21427044	21427283	DNA/hAT-Charlie	1143	+	120	21427164	4140
chr22	21423024	21623024	harbor1	chr22	21484775	21485056	DNA/hAT-Charlie	716	+	140	21484915	61891
chr22	10820773	11020773	harbor1	chr22	10845893	10846089	DNA/hAT-Charlie	580	+	98	10845991	25218
chr22	30277412	30477412	harbor1	chr22	30359564	30359813	DNA/hAT-Charlie	854	+	124	30359688	82276
chr22	11831464	12031464	harbor1	chr22	11861097	11861395	DNA/hAT-Charlie	1063	+	149	11861246	29782
chr22	33488232	33688232	harbor1	chr22	33538904	33539106	DNA/hAT-Charlie	526	+	101	33539005	50773
chr22	33488232	33688232	harbor1	chr22	33550337	33550500	DNA/hAT-Charlie	797	+	82	33550419	62187
chr22	33488232	33688232	harbor1	chr22	33551198	33551263	DNA/hAT-Charlie	797	+	32	33551230	62998
chr22	33488232	33688232	harbor1	chr22	33582065	33582259	DNA/hAT-Charlie	916	+	97	33582162	93930
chr22	41912210	42112210	harbor1	chr22	41960578	41960740	DNA/hAT-Charlie	517	+	81	41960659	48449
chr22	41912210	42112210	harbor1	chr22	41981154	41981337	DNA/hAT-Charlie	836	+	92	41981246	69036
chr22	41912210	42112210	harbor1	chr22	41983144	41983371	DNA/hAT-Charlie	782	+	114	41983258	71048
chr22	30590009	30790009	harbor1	chr22	30590636	30590809	DNA/hAT-Charlie	639	+	86	30590722	713
chr22	25698935	25898935	harbor1	chr22	25699400	25699594	DNA/hAT-Charlie	929	+	97	25699497	562
chr22	25698935	25898935	harbor1	chr22	25716765	25717081	DNA/hAT-Charlie	1928	+	158	25716923	17988
chr22	25698935	25898935	harbor1	chr22	25746620	25746796	DNA/hAT-Charlie	779	+	88	25746708	47773
chr22	25698935	25898935	harbor1	chr22	25749878	25750092	DNA/hAT-Charlie	893	+	107	25749985	51050
chr22	25698935	25898935	harbor1	chr22	25770423	25770588	DNA/hAT-Charlie	534	+	82	25770505	71570
chr22	25698935	25898935	harbor1	chr22	25798297	25798493	DNA/hAT-Charlie	1023	+	98	25798395	99460
chr22	20550945	20750945	harbor1	chr22	20559957	20560169	DNA/hAT-Charlie	1001	+	106	20560063	9118
chr22	20550945	20750945	harbor1	chr22	20647183	20647367	DNA/hAT-Charlie	703	+	92	20647275	96330
chr22	30404053	30604053	harbor1	chr22	30473512	30473712	DNA/hAT-Charlie	606	+	100	30473612	69559
chr22	30404053	30604053	harbor1	chr22	30493535	30493663	DNA/hAT-Charlie	432	+	64	30493599	89546
chr22	30404053	30604053	harbor1	chr22	30497816	30498003	DNA/hAT-Charlie	739	+	94	30497910	93857
chr22	31102681	31302681	harbor1	chr22	31162670	31162756	DNA/hAT-Charlie	899	+	43	31162713	60032
chr22	31102681	31302681	harbor1	chr22	31163064	31163317	DNA/hAT-Charlie	899	+	126	31163190	60509
chr22	22628590	22828590	harbor1	chr22	22662818	22663012	DNA/hAT-Charlie	427	+	97	22662915	34325
chr22	22628590	22828590	harbor1	chr22	22695814	22696005	DNA/hAT-Charlie	523	+	96	22695910	67320
chr22	22628590	22828590	harbor1	chr22	22706119	22706304	DNA/hAT-Charlie	446	+	92	22706211	77621
chr22	22628590	22828590	harbor1	chr22	22708786	22709134	DNA/hAT-Charlie	821	+	174	22708960	80370
chr22	22628590	22828590	harbor1	chr22	22691606	22692172	DNA/hAT-Charlie	1182	+	283	22691889	63299
chr22	42583743	42783743	harbor1	chr22	42625743	42625986	DNA/hAT-Charlie	830	+	122	42625865	42122
chr22	42583743	42783743	harbor1	chr22	42656888	42656971	DNA/hAT-Charlie	489	+	42	42656930	73187
chr22	42583743	42783743	harbor1	chr22	42659629	42660162	DNA/hAT-Charlie	3858	+	266	42659895	76152
chr22	34654208	34854208	harbor1	chr22	34751100	34751294	DNA/hAT-Charlie	561	+	97	34751197	96989
chr22	28916431	29116431	harbor1	chr22	28995697	28995777	DNA/hAT-Charlie	856	+	40	28995737	79306
chr22	28916431	29116431	harbor1	chr22	28996076	28996109	DNA/hAT-Charlie	856	+	16	28996092	79661
chr22	28916431	29116431	harbor1	chr22	28996239	28996403	DNA/hAT-Charlie	856	+	82	28996321	79890
chr22	28916431	29116431	harbor1	chr22	28996383	28996495	DNA/hAT-Charlie	546	+	56	28996439	80008
chr22	28916431	29116431	harbor1	chr22	28997322	28997442	DNA/hAT-Charlie	508	+	60	28997382	80951
chr22	38178953	38378953	harbor1	chr22	38187506	38187699	DNA/hAT-Charlie	796	+	96	38187602	8649
chr22	38178953	38378953	harbor1	chr22	38257171	38257858	DNA/hAT-Charlie	1339	+	344	38257515	78562
chr22	12703536	12903536	harbor1	chr22	12706016	12706249	DNA/hAT-Charlie	533	+	116	12706132	2596
chr22	41929738	42129738	harbor1	chr22	41960578	41960740	DNA/hAT-Charlie	517	+	81	41960659	30921
chr22	41929738	42129738	harbor1	chr22	41981154	41981337	DNA/hAT-Charlie	836	+	92	41981246	51508
chr22	41929738	42129738	harbor1	chr22	41983144	41983371	DNA/hAT-Charlie	782	+	114	41983258	53520
chr22	41929738	42129738	harbor1	chr22	42022797	42023041	DNA/hAT-Charlie	727	+	122	42022919	93181
chr22	41929738	42129738	harbor1	chr22	42025261	42025452	DNA/hAT-Charlie	1233	+	96	42025357	95619
chr22	16657817	16857817	harbor1	chr22	16672054	16672212	DNA/hAT-Charlie	721	+	79	16672133	14316
chr22	25881652	26081652	harbor1	chr22	25908053	25908145	DNA/hAT-Charlie	428	+	46	25908099	26447
chr22	25881652	26081652	harbor1	chr22	25932865	25932941	DNA/hAT-Charlie	475	+	38	25932903	51251
chr22	25881652	26081652	harbor1	chr22	25969432	25969610	DNA/hAT-Charlie	880	+	89	25969521	87869
chr22	25881652	26081652	harbor1	chr22	25972476	25972581	DNA/hAT-Charlie	454	+	52	25972528	90876
chr22	25881652	26081652	harbor1	chr22	25976031	25976248	DNA/hAT-Charlie	1113	+	108	25976139	94487
chr22	44513119	44713119	harbor1	chr22	44548677	44548858	DNA/hAT-Charlie	607	+	90	44548767	35648
chr22	46860591	47060591	harbor1	chr22	46933690	46933852	DNA/hAT-Charlie	439	+	81	46933771	73180
chr22	16649737	16849737	harbor1	chr22	16672054	16672212	DNA/hAT-Charlie	721	+	79	16672133	22396
chr22	29629137	29829137	harbor1	chr22	29631941	29632098	DNA/hAT-Charlie	802	+	78	29632019	2882
chrX	104453727	104653727	harbor1	chrX	104460924	104461049	DNA/hAT-Charlie	585	+	62	104460986	7259
chrX	104453727	104653727	harbor1	chrX	104484523	104484756	DNA/hAT-Charlie	1498	+	116	104484639	30912
chrX	104453727	104653727	harbor1	chrX	104501813	104501920	DNA/hAT-Charlie	540	+	54	104501867	48140
chrX	104453727	104653727	harbor1	chrX	104505128	104505425	DNA/hAT-Charlie	978	+	148	104505276	51549
chrX	104453727	104653727	harbor1	chrX	104506887	104507123	DNA/hAT-Charlie	768	+	118	104507005	53278
chrX	83312689	83512689	harbor1	chrX	83324573	83324891	DNA/hAT-Charlie	1550	+	159	83324732	12043
chrX	83312689	83512689	harbor1	chrX	83325154	83325318	DNA/hAT-Charlie	551	+	82	83325236	12547
chrX	83312689	83512689	harbor1	chrX	83356477	83357066	DNA/hAT-Charlie	2112	+	294	83356771	44082
chrX	83312689	83512689	harbor1	chrX	83357396	83357631	DNA/hAT-Charlie	1125	+	118	83357514	44825
chrX	83312689	83512689	harbor1	chrX	83358028	83358210	DNA/hAT-Charlie	607	+	91	83358119	45430
chrX	96090398	96290398	harbor1	chrX	96101931	96102125	DNA/hAT-Charlie	601	+	97	96102028	11630
chrX	96090398	96290398	harbor1	chrX	96161504	96161636	DNA/hAT-Charlie	519	+	66	96161570	71172
chrX	114785578	114985578	harbor1	chrX	114818641	114818856	DNA/hAT-Charlie	1047	+	108	114818749	33171
chrX	138945206	139145206	harbor1	chrX	138979692	138979805	DNA/hAT-Charlie	504	+	56	138979748	34542
chrX	138945206	139145206	harbor1	chrX	138979860	138980027	DNA/hAT-Charlie	785	+	84	138979944	34738
chrX	120441822	120641822	harbor1	chrX	120461406	120461591	DNA/hAT-Charlie	559	+	92	120461498	19676
chrX	70886401	71086401	harbor1	chrX	70899198	70899517	DNA/hAT-Charlie	1387	+	160	70899358	12957
chrX	70886401	71086401	harbor1	chrX	70904651	70904979	DNA/hAT-Charlie	1529	+	164	70904815	18414
chrX	70886401	71086401	harbor1	chrX	70975648	70975741	DNA/hAT-Charlie	610	+	46	70975694	89293
chrX	70886401	71086401	harbor1	chrX	70978284	70978501	DNA/hAT-Charlie	778	+	108	70978392	91991
chrX	70886401	71086401	harbor1	chrX	70978606	70978728	DNA/hAT-Charlie	587	+	61	70978667	92266
chrX	70886401	71086401	harbor1	chrX	70979490	70979701	DNA/hAT-Charlie	863	+	106	70979596	93195
chrX	70886401	71086401	harbor1	chrX	70975400	70975512	DNA/hAT-Charlie	610	+	56	70975456	89055
chrX	141870043	142070043	harbor1	chrX	141944342	141944658	DNA/hAT-Charlie	1279	+	158	141944500	74457
chrX	15810184	16010184	harbor1	chrX	15858359	15858581	DNA/hAT-Charlie	1099	+	111	15858470	48286
chrX	15810184	16010184	harbor1	chrX	15904742	15904928	DNA/hAT-Charlie	1109	+	93	15904835	94651
chrX	12236283	12436283	harbor1	chrX	12236852	12237058	DNA/hAT-Charlie	1037	+	103	12236955	672
chrX	12236283	12436283	harbor1	chrX	12237955	12238106	DNA/hAT-Charlie	735	+	76	12238031	1748
chrX	12236283	12436283	harbor1	chrX	12240051	12240266	DNA/hAT-Charlie	997	+	108	12240159	3876
chrX	12236283	12436283	harbor1	chrX	12262069	12262249	DNA/hAT-Charlie	813	+	90	12262159	25876
chrX	12236283	12436283	harbor1	chrX	12269584	12269818	DNA/hAT-Charlie	773	+	117	12269701	33418
chrX	12236283	12436283	harbor1	chrX	12315796	12316016	DNA/hAT-Charlie	1159	+	110	12315906	79623
chrX	12236283	12436283	harbor1	chrX	12319092	12319231	DNA/hAT-Charlie	685	+	70	12319162	82879
chrX	12236283	12436283	harbor1	chrX	12325668	12325829	DNA/hAT-Charlie	708	+	80	12325748	89465
chrX	77439260	77639260	harbor1	chrX	77440567	77440897	DNA/hAT-Charlie	1011	+	165	77440732	1472
chrX	77439260	77639260	harbor1	chrX	77458141	77458283	DNA/hAT-Charlie	615	+	71	77458212	18952
chrX	77439260	77639260	harbor1	chrX	77491045	77491209	DNA/hAT-Charlie	804	+	82	77491127	51867
chrX	77439260	77639260	harbor1	chrX	77536944	77537136	DNA/hAT-Charlie	943	+	96	77537040	97780
chrX	154546018	154746018	harbor1	chrX	154633427	154633815	DNA/hAT-Charlie	2054	+	194	154633621	87603
chrX	153929940	154129940	harbor1	chrX	153973136	153973330	DNA/hAT-Charlie	528	+	97	153973233	43293
chrX	83114404	83314404	harbor1	chrX	83167300	83167632	DNA/hAT-Charlie	1779	+	166	83167466	53062
chrX	3494403	3694403	harbor1	chrX	3497250	3497388	DNA/hAT-Charlie	525	+	69	3497319	2916
chrX	3494403	3694403	harbor1	chrX	3541680	3541865	DNA/hAT-Charlie	956	+	92	3541772	47369
chrX	3494403	3694403	harbor1	chrX	3549741	3549913	DNA/hAT-Charlie	683	+	86	3549827	55424
chrX	3494403	3694403	harbor1	chrX	3567636	3567815	DNA/hAT-Charlie	688	+	90	3567726	73323
chrX	3494403	3694403	harbor1	chrX	3582158	3582325	DNA/hAT-Charlie	694	+	84	3582242	87839
chrX	3494403	3694403	harbor1	chrX	3584670	3584829	DNA/hAT-Charlie	933	+	80	3584750	90347
chrX	93138540	93338540	harbor1	chrX	93225301	93225744	DNA/hAT-Charlie	1469	+	222	93225523	86983
