H_chr	H_start	H_end	Harbor	TE_chr	TE_start	TE_end	TE	score	TE_strand	TE_half	TE_middle_pos	TE_dis
chr1	85236785	85436785	harbor2	chr1	85261684	85262092	LINE/L2	990	+	204	85261888	25103
chr1	85236785	85436785	harbor2	chr1	85263041	85263318	LINE/L2	501	+	138	85263179	26394
chr1	85236785	85436785	harbor2	chr1	85273160	85274207	LINE/L2	500	+	524	85273684	36899
chr1	85236785	85436785	harbor2	chr1	85291096	85291273	LINE/L2	427	+	88	85291184	54399
chr1	83434866	83634866	harbor2	chr1	83479543	83479695	LINE/L2	3813	+	76	83479619	44753
chr1	83434866	83634866	harbor2	chr1	83479881	83481792	LINE/L2	3813	+	956	83480837	45971
chr1	83434866	83634866	harbor2	chr1	83504961	83506354	LINE/L2	1716	+	696	83505657	70791
chr1	83434866	83634866	harbor2	chr1	83533595	83533783	LINE/L2	456	+	94	83533689	98823
chr1	83434866	83634866	harbor2	chr1	83534464	83535178	LINE/L2	1178	+	357	83534821	99955
chr1	83434866	83634866	harbor2	chr1	83476451	83476748	LINE/L2	636	+	148	83476599	41733
chr1	223639212	223839212	harbor2	chr1	223668012	223668551	LINE/L2	625	+	270	223668282	29070
chr1	223639212	223839212	harbor2	chr1	223677511	223677539	LINE/L2	597	+	14	223677525	38313
chr1	223639212	223839212	harbor2	chr1	223677852	223678091	LINE/L2	597	+	120	223677972	38760
chr1	181675233	181875233	harbor2	chr1	181702122	181702965	LINE/L2	1462	+	422	181702544	27311
chr1	181675233	181875233	harbor2	chr1	181703094	181703184	LINE/L2	1282	+	45	181703139	27906
chr1	181675233	181875233	harbor2	chr1	181748749	181748914	LINE/L2	502	+	82	181748831	73598
chr1	178027537	178227537	harbor2	chr1	178072762	178072999	LINE/L2	1676	+	118	178072880	45343
chr1	178027537	178227537	harbor2	chr1	178073368	178073696	LINE/L2	1676	+	164	178073532	45995
chr1	178027537	178227537	harbor2	chr1	178074124	178074322	LINE/L2	468	+	99	178074223	46686
chr1	178027537	178227537	harbor2	chr1	178084743	178085237	LINE/L2	440	+	247	178084990	57453
chr1	179174585	179374585	harbor2	chr1	179181616	179181771	LINE/L2	1942	+	78	179181694	7109
chr1	179174585	179374585	harbor2	chr1	179182097	179182516	LINE/L2	1942	+	210	179182307	7722
chr1	179174585	179374585	harbor2	chr1	179187807	179188260	LINE/L2	960	+	226	179188033	13448
chr1	179174585	179374585	harbor2	chr1	179188560	179188775	LINE/L2	960	+	108	179188668	14083
chr1	237881455	238081455	harbor2	chr1	237906555	237906658	LINE/L2	439	+	52	237906607	25152
chr1	247524244	247724244	harbor2	chr1	247533059	247533249	LINE/L2	526	+	95	247533154	8910
chr1	247524244	247724244	harbor2	chr1	247533883	247533944	LINE/L2	526	+	30	247533913	9669
chr1	247524244	247724244	harbor2	chr1	247533918	247534321	LINE/L2	980	+	202	247534120	9876
chr1	247524244	247724244	harbor2	chr1	247538320	247538449	LINE/L2	736	+	64	247538384	14140
chr1	247524244	247724244	harbor2	chr1	247538870	247539015	LINE/L2	736	+	72	247538942	14698
chr1	247524244	247724244	harbor2	chr1	247539822	247540084	LINE/L2	728	+	131	247539953	15709
chr1	247524244	247724244	harbor2	chr1	247540331	247540624	LINE/L2	728	+	146	247540477	16233
chr1	247524244	247724244	harbor2	chr1	247556769	247557053	LINE/L2	501	+	142	247556911	32667
chr1	213652921	213852921	harbor2	chr1	213672235	213672922	LINE/L2	703	+	344	213672579	19658
chr1	213652921	213852921	harbor2	chr1	213695047	213695171	LINE/L2	549	+	62	213695109	42188
chr1	216714048	216914048	harbor2	chr1	216741515	216741706	LINE/L2	428	+	96	216741611	27563
chr1	216714048	216914048	harbor2	chr1	216759863	216760206	LINE/L2	745	+	172	216760035	45987
chr1	107497052	107697052	harbor2	chr1	107514349	107514794	LINE/L2	859	+	222	107514571	17519
chr1	107497052	107697052	harbor2	chr1	107523120	107523615	LINE/L2	775	+	248	107523368	26316
chr1	107497052	107697052	harbor2	chr1	107534386	107534600	LINE/L2	471	+	107	107534493	37441
chr1	107497052	107697052	harbor2	chr1	107540399	107541396	LINE/L2	1019	+	498	107540897	43845
chr1	107497052	107697052	harbor2	chr1	107545866	107546391	LINE/L2	481	+	262	107546128	49076
chr1	107497052	107697052	harbor2	chr1	107548589	107549129	LINE/L2	764	+	270	107548859	51807
chr1	107497052	107697052	harbor2	chr1	107549181	107549577	LINE/L2	764	+	198	107549379	52327
chr1	107497052	107697052	harbor2	chr1	107549740	107549854	LINE/L2	440	+	57	107549797	52745
chr1	107497052	107697052	harbor2	chr1	107558061	107558356	LINE/L2	537	+	148	107558209	61157
chr1	107497052	107697052	harbor2	chr1	107558340	107558473	LINE/L2	588	+	66	107558406	61354
chr1	107497052	107697052	harbor2	chr1	107559089	107559719	LINE/L2	1578	+	315	107559404	62352
chr1	107497052	107697052	harbor2	chr1	107560109	107560174	LINE/L2	1578	+	32	107560141	63089
chr1	107497052	107697052	harbor2	chr1	107560242	107560506	LINE/L2	600	+	132	107560374	63322
chr1	107497052	107697052	harbor2	chr1	107562499	107563007	LINE/L2	527	+	254	107562753	65701
chr1	107497052	107697052	harbor2	chr1	107585131	107585682	LINE/L2	1391	+	276	107585407	88355
chr1	107497052	107697052	harbor2	chr1	107586072	107586344	LINE/L2	600	+	136	107586208	89156
chr1	107497052	107697052	harbor2	chr1	107590509	107590992	LINE/L2	664	+	242	107590751	93699
chr1	107497052	107697052	harbor2	chr1	107591010	107591409	LINE/L2	464	+	200	107591210	94158
chr1	107497052	107697052	harbor2	chr1	107594235	107594368	LINE/L2	602	+	66	107594301	97249
chr1	113830100	114030100	harbor2	chr1	113833934	113834232	LINE/L2	414	+	149	113834083	3983
chr1	113830100	114030100	harbor2	chr1	113838963	113839238	LINE/L2	805	+	138	113839101	9001
chr1	113830100	114030100	harbor2	chr1	113870026	113870159	LINE/L2	519	+	66	113870092	39992
chr1	113830100	114030100	harbor2	chr1	113909030	113909203	LINE/L2	536	+	86	113909116	79016
chr1	113830100	114030100	harbor2	chr1	113918085	113918608	LINE/L2	740	+	262	113918347	88247
chr1	209361823	209561823	harbor2	chr1	209380679	209381013	LINE/L2	597	+	167	209380846	19023
chr1	209361823	209561823	harbor2	chr1	209388087	209388397	LINE/L2	440	+	155	209388242	26419
chr1	218223925	218423925	harbor2	chr1	218242308	218242335	LINE/L2	433	+	14	218242322	18397
chr1	218223925	218423925	harbor2	chr1	218242498	218242573	LINE/L2	433	+	38	218242536	18611
chr1	218223925	218423925	harbor2	chr1	218265612	218265925	LINE/L2	448	+	156	218265768	41843
chr1	218223925	218423925	harbor2	chr1	218271076	218271495	LINE/L2	1201	+	210	218271286	47361
chr1	218223925	218423925	harbor2	chr1	218271834	218272500	LINE/L2	1201	+	333	218272167	48242
chr1	218223925	218423925	harbor2	chr1	218286104	218286711	LINE/L2	544	+	304	218286408	62483
chr1	240507613	240707613	harbor2	chr1	240508127	240508258	LINE/L2	571	+	66	240508193	580
chr1	240507613	240707613	harbor2	chr1	240597563	240597694	LINE/L2	591	+	66	240597629	90016
chr1	23715438	23915438	harbor2	chr1	23804919	23805766	LINE/L2	2162	+	424	23805343	89905
chr1	23715438	23915438	harbor2	chr1	23805848	23805947	LINE/L2	746	+	50	23805898	90460
chr1	23715438	23915438	harbor2	chr1	23806253	23806827	LINE/L2	1261	+	287	23806540	91102
chr1	57565137	57765137	harbor2	chr1	57599981	57600302	LINE/L2	459	+	160	57600141	35004
chr1	57565137	57765137	harbor2	chr1	57611581	57612195	LINE/L2	716	+	307	57611888	46751
chr1	57565137	57765137	harbor2	chr1	57612243	57612268	LINE/L2	579	+	12	57612255	47118
chr1	57565137	57765137	harbor2	chr1	57612785	57612900	LINE/L2	579	+	58	57612843	47706
chr1	57565137	57765137	harbor2	chr1	57616071	57616498	LINE/L2	532	+	214	57616285	51148
chr1	174449313	174649313	harbor2	chr1	174492658	174493077	LINE/L2	419	+	210	174492868	43555
chr1	174449313	174649313	harbor2	chr1	174509629	174510184	LINE/L2	443	+	278	174509907	60594
chr1	174449313	174649313	harbor2	chr1	174510258	174510394	LINE/L2	484	+	68	174510326	61013
chr1	170157294	170357294	harbor2	chr1	170174214	170174451	LINE/L2	448	+	118	170174332	17038
chr1	170157294	170357294	harbor2	chr1	170199126	170199379	LINE/L2	498	+	126	170199252	41958
chr1	170157294	170357294	harbor2	chr1	170200025	170200103	LINE/L2	498	+	39	170200064	42770
chr1	170157294	170357294	harbor2	chr1	170220193	170220748	LINE/L2	511	+	278	170220471	63177
chr1	170157294	170357294	harbor2	chr1	170222553	170222829	LINE/L2	795	+	138	170222691	65397
chr1	170157294	170357294	harbor2	chr1	170223194	170223623	LINE/L2	696	+	214	170223408	66114
chr1	170157294	170357294	harbor2	chr1	170241400	170241989	LINE/L2	829	+	294	170241694	84400
chr1	170157294	170357294	harbor2	chr1	170256972	170257113	LINE/L2	441	+	70	170257042	99748
chr1	239853196	240053196	harbor2	chr1	239931930	239932327	LINE/L2	698	+	198	239932128	78932
chr1	194213516	194413516	harbor2	chr1	194285884	194286348	LINE/L2	1154	+	232	194286116	72600
chr1	245342135	245542135	harbor2	chr1	245345217	245345533	LINE/L2	2540	+	158	245345375	3240
chr1	245342135	245542135	harbor2	chr1	245346285	245347301	LINE/L2	2540	+	508	245346793	4658
chr1	245342135	245542135	harbor2	chr1	245347614	245348357	LINE/L2	2540	+	372	245347986	5851
chr1	245342135	245542135	harbor2	chr1	245348722	245349164	LINE/L2	1056	+	221	245348943	6808
chr1	245342135	245542135	harbor2	chr1	245431825	245432131	LINE/L2	468	+	153	245431978	89843
chr1	245342135	245542135	harbor2	chr1	245432519	245432704	LINE/L2	591	+	92	245432611	90476
chr1	245342135	245542135	harbor2	chr1	245435418	245435604	LINE/L2	448	+	93	245435511	93376
chr1	239353691	239553691	harbor2	chr1	239407077	239407401	LINE/L2	906	+	162	239407239	53548
chr1	239353691	239553691	harbor2	chr1	239434295	239434643	LINE/L2	608	+	174	239434469	80778
chr1	172903948	173103948	harbor2	chr1	172918969	172920424	LINE/L2	2401	+	728	172919697	15749
chr1	172903948	173103948	harbor2	chr1	172966216	172966292	LINE/L2	842	+	38	172966254	62306
chr1	172903948	173103948	harbor2	chr1	172975873	172976136	LINE/L2	740	+	132	172976005	72057
chr1	172903948	173103948	harbor2	chr1	172965637	172965909	LINE/L2	842	+	136	172965773	61825
chr1	235595329	235795329	harbor2	chr1	235641803	235642018	LINE/L2	432	+	108	235641911	46582
chr1	235595329	235795329	harbor2	chr1	235659711	235659893	LINE/L2	507	+	91	235659802	64473
chr1	235595329	235795329	harbor2	chr1	235660182	235660450	LINE/L2	555	+	134	235660316	64987
chr1	223533943	223733943	harbor2	chr1	223534663	223535108	LINE/L2	472	+	222	223534885	942
chr1	223533943	223733943	harbor2	chr1	223614443	223614799	LINE/L2	482	+	178	223614621	80678
chr1	216480807	216680807	harbor2	chr1	216527935	216528050	LINE/L2	543	+	58	216527993	47186
chr1	216480807	216680807	harbor2	chr1	216539442	216539729	LINE/L2	539	+	144	216539586	58779
chr1	118918529	119118529	harbor2	chr1	118942286	118942376	LINE/L2	453	+	45	118942331	23802
chr1	118918529	119118529	harbor2	chr1	119012014	119013180	LINE/L2	6340	+	583	119012597	94068
chr1	118918529	119118529	harbor2	chr1	119013641	119014186	LINE/L2	6340	+	272	119013913	95384
chr1	118918529	119118529	harbor2	chr1	119014506	119015224	LINE/L2	6340	+	359	119014865	96336
chr1	118918529	119118529	harbor2	chr1	119015605	119015813	LINE/L2	1521	+	104	119015709	97180
chr1	168838826	169038826	harbor2	chr1	168873333	168873642	LINE/L2	446	+	154	168873487	34661
chr1	168838826	169038826	harbor2	chr1	168878833	168879667	LINE/L2	1083	+	417	168879250	40424
chr1	168838826	169038826	harbor2	chr1	168920252	168920541	LINE/L2	567	+	144	168920396	81570
chr1	179824754	180024754	harbor2	chr1	179867927	179868226	LINE/L2	842	+	150	179868077	43323
chr1	179824754	180024754	harbor2	chr1	179878473	179878692	LINE/L2	729	+	110	179878583	53829
chr1	231655327	231855327	harbor2	chr1	231699456	231700185	LINE/L2	1246	+	364	231699820	44493
chr1	231655327	231855327	harbor2	chr1	231700646	231700770	LINE/L2	822	+	62	231700708	45381
chr1	231655327	231855327	harbor2	chr1	231741827	231742238	LINE/L2	1122	+	206	231742033	86706
chr1	231655327	231855327	harbor2	chr1	231754894	231755212	LINE/L2	730	+	159	231755053	99726
chr1	88435331	88635331	harbor2	chr1	88445527	88445647	LINE/L2	440	+	60	88445587	10256
chr1	88435331	88635331	harbor2	chr1	88482658	88483712	LINE/L2	2449	+	527	88483185	47854
chr1	88435331	88635331	harbor2	chr1	88522467	88523458	LINE/L2	1703	+	496	88522963	87632
chr1	195067331	195267331	harbor2	chr1	195100278	195100619	LINE/L2	546	+	170	195100448	33117
chr1	87888360	88088360	harbor2	chr1	87964600	87964794	LINE/L2	478	+	97	87964697	76337
chr1	240711816	240911816	harbor2	chr1	240810029	240810280	LINE/L2	422	+	126	240810155	98339
chr1	243362159	243562159	harbor2	chr1	243406486	243407180	LINE/L2	581	+	347	243406833	44674
chr1	243362159	243562159	harbor2	chr1	243448558	243448845	LINE/L2	418	+	144	243448702	86543
chr1	243362159	243562159	harbor2	chr1	243452933	243453063	LINE/L2	536	+	65	243452998	90839
chr1	247566504	247766504	harbor2	chr1	247653639	247654118	LINE/L2	731	+	240	247653879	87375
chr1	247566504	247766504	harbor2	chr1	247654679	247654794	LINE/L2	731	+	58	247654737	88233
chr1	181095157	181295157	harbor2	chr1	181111510	181111750	LINE/L2	670	+	120	181111630	16473
chr1	181095157	181295157	harbor2	chr1	181164752	181164840	LINE/L2	576	+	44	181164796	69639
chr1	181095157	181295157	harbor2	chr1	181165211	181165300	LINE/L2	576	+	44	181165255	70098
chr1	181095157	181295157	harbor2	chr1	181179765	181179908	LINE/L2	458	+	72	181179837	84680
chr1	181095157	181295157	harbor2	chr1	181191516	181191679	LINE/L2	643	+	82	181191598	96441
chr1	187534147	187734147	harbor2	chr1	187544098	187544610	LINE/L2	540	+	256	187544354	10207
chr1	232152947	232352947	harbor2	chr1	232217142	232217641	LINE/L2	565	+	250	232217392	64445
chr1	232152947	232352947	harbor2	chr1	232224834	232225033	LINE/L2	633	+	100	232224934	71987
chr1	167129795	167329795	harbor2	chr1	167169047	167169369	LINE/L2	865	+	161	167169208	39413
chr1	167129795	167329795	harbor2	chr1	167169951	167169986	LINE/L2	865	+	18	167169969	40174
chr1	167129795	167329795	harbor2	chr1	167195764	167196103	LINE/L2	449	+	170	167195934	66139
chr1	76260370	76460370	harbor2	chr1	76308990	76309333	LINE/L2	622	+	172	76309162	48792
chr1	76260370	76460370	harbor2	chr1	76344382	76344609	LINE/L2	725	+	114	76344496	84126
chr1	76260370	76460370	harbor2	chr1	76345641	76346200	LINE/L2	872	+	280	76345921	85551
chr1	76260370	76460370	harbor2	chr1	76352446	76353437	LINE/L2	1381	+	496	76352942	92572
chr1	76260370	76460370	harbor2	chr1	76358111	76358830	LINE/L2	786	+	360	76358471	98101
chr1	76260370	76460370	harbor2	chr1	76359884	76359994	LINE/L2	412	+	55	76359939	99569
chr1	185028550	185228550	harbor2	chr1	185093442	185094131	LINE/L2	2960	+	344	185093786	65236
chr1	185028550	185228550	harbor2	chr1	185094441	185094802	LINE/L2	2960	+	180	185094621	66071
chr1	185028550	185228550	harbor2	chr1	185095318	185095681	LINE/L2	754	+	182	185095500	66950
chr1	238308423	238508423	harbor2	chr1	238316751	238317032	LINE/L2	408	+	140	238316891	8468
chr1	238308423	238508423	harbor2	chr1	238317414	238317667	LINE/L2	456	+	126	238317540	9117
chr1	238308423	238508423	harbor2	chr1	238404347	238405072	LINE/L2	2878	+	362	238404709	96286
chr1	238308423	238508423	harbor2	chr1	238402998	238404065	LINE/L2	2878	+	534	238403532	95109
chr1	232561820	232761820	harbor2	chr1	232638363	232639069	LINE/L2	621	+	353	232638716	76896
chr1	235282553	235482553	harbor2	chr1	235320373	235321124	LINE/L2	1068	+	376	235320749	38196
chr1	235282553	235482553	harbor2	chr1	235322337	235322778	LINE/L2	551	+	220	235322557	40004
chr1	235282553	235482553	harbor2	chr1	235368937	235369226	LINE/L2	766	+	144	235369081	86528
chr1	235282553	235482553	harbor2	chr1	235369848	235370249	LINE/L2	766	+	200	235370048	87495
chr1	245311543	245511543	harbor2	chr1	245345217	245345533	LINE/L2	2540	+	158	245345375	33832
chr1	245311543	245511543	harbor2	chr1	245346285	245347301	LINE/L2	2540	+	508	245346793	35250
chr1	245311543	245511543	harbor2	chr1	245347614	245348357	LINE/L2	2540	+	372	245347986	36443
chr1	245311543	245511543	harbor2	chr1	245348722	245349164	LINE/L2	1056	+	221	245348943	37400
chr1	212945932	213145932	harbor2	chr1	213005694	213006179	LINE/L2	1224	+	242	213005936	60004
chr1	212945932	213145932	harbor2	chr1	213014582	213014774	LINE/L2	407	+	96	213014678	68746
chr1	86465300	86665300	harbor2	chr1	86471911	86472512	LINE/L2	1168	+	300	86472211	6911
chr1	172255479	172455479	harbor2	chr1	172279503	172280467	LINE/L2	1386	+	482	172279985	24506
chr1	172255479	172455479	harbor2	chr1	172284451	172284590	LINE/L2	430	+	70	172284521	29042
chr1	218261884	218461884	harbor2	chr1	218265612	218265925	LINE/L2	448	+	156	218265768	3884
chr1	218261884	218461884	harbor2	chr1	218271076	218271495	LINE/L2	1201	+	210	218271286	9402
chr1	218261884	218461884	harbor2	chr1	218271834	218272500	LINE/L2	1201	+	333	218272167	10283
chr1	218261884	218461884	harbor2	chr1	218286104	218286711	LINE/L2	544	+	304	218286408	24524
chr1	218261884	218461884	harbor2	chr1	218330076	218330185	LINE/L2	440	+	54	218330130	68246
chr1	218261884	218461884	harbor2	chr1	218353424	218353615	LINE/L2	679	+	96	218353520	91636
chr1	218261884	218461884	harbor2	chr1	218353914	218354191	LINE/L2	679	+	138	218354052	92168
chr1	194452348	194652348	harbor2	chr1	194468121	194468459	LINE/L2	466	+	169	194468290	15942
chr1	194452348	194652348	harbor2	chr1	194511886	194512109	LINE/L2	520	+	112	194511998	59650
chr1	245832758	246032758	harbor2	chr1	245916383	245916872	LINE/L2	1675	+	244	245916627	83869
chr1	245832758	246032758	harbor2	chr1	245917436	245917757	LINE/L2	1675	+	160	245917596	84838
chr1	245832758	246032758	harbor2	chr1	245923539	245923862	LINE/L2	432	+	162	245923701	90943
chr1	241559101	241759101	harbor2	chr1	241648872	241649045	LINE/L2	463	+	86	241648958	89857
chr1	241559101	241759101	harbor2	chr1	241649733	241650980	LINE/L2	3009	+	624	241650357	91256
chr1	241559101	241759101	harbor2	chr1	241656516	241656664	LINE/L2	497	+	74	241656590	97489
chr1	241559101	241759101	harbor2	chr1	241656964	241657097	LINE/L2	497	+	66	241657030	97929
chr1	241559101	241759101	harbor2	chr1	241657219	241657666	LINE/L2	497	+	224	241657443	98342
chr1	115597040	115797040	harbor2	chr1	115598628	115598930	LINE/L2	502	+	151	115598779	1739
chr1	115597040	115797040	harbor2	chr1	115613393	115614419	LINE/L2	1409	+	513	115613906	16866
chr1	115597040	115797040	harbor2	chr1	115629917	115630134	LINE/L2	816	+	108	115630025	32985
chr1	247598332	247798332	harbor2	chr1	247653639	247654118	LINE/L2	731	+	240	247653879	55547
chr1	247598332	247798332	harbor2	chr1	247654679	247654794	LINE/L2	731	+	58	247654737	56405
chr1	231376587	231576587	harbor2	chr1	231395900	231396246	LINE/L2	454	+	173	231396073	19486
chr1	231376587	231576587	harbor2	chr1	231396552	231397130	LINE/L2	454	+	289	231396841	20254
chr1	231376587	231576587	harbor2	chr1	231412862	231412982	LINE/L2	632	+	60	231412922	36335
chr1	231376587	231576587	harbor2	chr1	231412988	231413075	LINE/L2	987	+	44	231413032	36445
chr1	231376587	231576587	harbor2	chr1	231413345	231413750	LINE/L2	987	+	202	231413547	36960
chr1	214928069	215128069	harbor2	chr1	214941967	214942414	LINE/L2	663	+	224	214942191	14122
chr1	214928069	215128069	harbor2	chr1	214988721	214989973	LINE/L2	2555	+	626	214989347	61278
chr1	214928069	215128069	harbor2	chr1	214990979	214992281	LINE/L2	2969	+	651	214991630	63561
chr1	214928069	215128069	harbor2	chr1	214992588	214992792	LINE/L2	979	+	102	214992690	64621
chr1	185008672	185208672	harbor2	chr1	185018040	185018290	LINE/L2	825	+	125	185018165	9493
chr1	185008672	185208672	harbor2	chr1	185019537	185019684	LINE/L2	616	+	74	185019611	10939
chr1	185008672	185208672	harbor2	chr1	185093442	185094131	LINE/L2	2960	+	344	185093786	85114
chr1	185008672	185208672	harbor2	chr1	185094441	185094802	LINE/L2	2960	+	180	185094621	85949
chr1	185008672	185208672	harbor2	chr1	185095318	185095681	LINE/L2	754	+	182	185095500	86828
chr1	240618957	240818957	harbor2	chr1	240694254	240694453	LINE/L2	454	+	100	240694354	75397
chr1	240618957	240818957	harbor2	chr1	240706537	240706839	LINE/L2	547	+	151	240706688	87731
chr1	172897804	173097804	harbor2	chr1	172918969	172920424	LINE/L2	2401	+	728	172919697	21893
chr1	172897804	173097804	harbor2	chr1	172966216	172966292	LINE/L2	842	+	38	172966254	68450
chr1	172897804	173097804	harbor2	chr1	172975873	172976136	LINE/L2	740	+	132	172976005	78201
chr1	172897804	173097804	harbor2	chr1	172965637	172965909	LINE/L2	842	+	136	172965773	67969
chr1	173330502	173530502	harbor2	chr1	173351085	173351404	LINE/L2	476	+	160	173351245	20743
chr1	173330502	173530502	harbor2	chr1	173404526	173404634	LINE/L2	1145	+	54	173404580	74078
chr1	173330502	173530502	harbor2	chr1	173404932	173405151	LINE/L2	1145	+	110	173405042	74540
chr1	36359369	36559369	harbor2	chr1	36359714	36360231	LINE/L2	599	+	258	36359972	603
chr1	36359369	36559369	harbor2	chr1	36390209	36390382	LINE/L2	465	+	86	36390295	30926
chr1	36359369	36559369	harbor2	chr1	36390679	36390917	LINE/L2	465	+	119	36390798	31429
chr1	36359369	36559369	harbor2	chr1	36419142	36419506	LINE/L2	404	+	182	36419324	59955
chr1	36359369	36559369	harbor2	chr1	36454842	36454983	LINE/L2	421	+	70	36454912	95543
chr1	36359369	36559369	harbor2	chr1	36455357	36455604	LINE/L2	421	+	124	36455481	96112
chr1	245948405	246148405	harbor2	chr1	245958331	245958763	LINE/L2	494	+	216	245958547	10142
chr1	245948405	246148405	harbor2	chr1	245984300	245984505	LINE/L2	517	+	102	245984402	35997
chr1	245948405	246148405	harbor2	chr1	245984686	245985478	LINE/L2	517	+	396	245985082	36677
chr1	36439499	36639499	harbor2	chr1	36454842	36454983	LINE/L2	421	+	70	36454912	15413
chr1	36439499	36639499	harbor2	chr1	36455357	36455604	LINE/L2	421	+	124	36455481	15982
chr1	36439499	36639499	harbor2	chr1	36472855	36473213	LINE/L2	1126	+	179	36473034	33535
chr1	36439499	36639499	harbor2	chr1	36483972	36484673	LINE/L2	1586	+	350	36484322	44823
chr1	36439499	36639499	harbor2	chr1	36487216	36487359	LINE/L2	415	+	72	36487288	47789
chr1	36439499	36639499	harbor2	chr1	36492026	36492247	LINE/L2	410	+	110	36492136	52637
chr1	36439499	36639499	harbor2	chr1	36538953	36539432	LINE/L2	1250	+	240	36539193	99694
chr1	114944279	115144279	harbor2	chr1	114998334	114998540	LINE/L2	635	+	103	114998437	54158
chr1	202037199	202237199	harbor2	chr1	202044610	202045181	LINE/L2	925	+	286	202044896	7697
chr1	202037199	202237199	harbor2	chr1	202062977	202063214	LINE/L2	450	+	118	202063095	25896
chr1	202037199	202237199	harbor2	chr1	202063317	202063492	LINE/L2	456	+	88	202063405	26206
chr1	202037199	202237199	harbor2	chr1	202091193	202091469	LINE/L2	443	+	138	202091331	54132
chr1	202037199	202237199	harbor2	chr1	202093651	202094284	LINE/L2	608	+	316	202093967	56768
chr1	202037199	202237199	harbor2	chr1	202101138	202101501	LINE/L2	478	+	182	202101320	64121
chr1	202037199	202237199	harbor2	chr1	202116395	202116510	LINE/L2	544	+	58	202116453	79254
chr1	202037199	202237199	harbor2	chr1	202121426	202122052	LINE/L2	560	+	313	202121739	84540
chr1	235679347	235879347	harbor2	chr1	235750846	235751045	LINE/L2	430	+	100	235750946	71599
chr1	235679347	235879347	harbor2	chr1	235763757	235764350	LINE/L2	519	+	296	235764053	84706
chr1	40086215	40286215	harbor2	chr1	40095665	40096405	LINE/L2	1458	+	370	40096035	9820
chr1	40086215	40286215	harbor2	chr1	40117727	40117852	LINE/L2	421	+	62	40117789	31574
chr1	40086215	40286215	harbor2	chr1	40118146	40118435	LINE/L2	866	+	144	40118290	32075
chr1	40086215	40286215	harbor2	chr1	40118780	40118970	LINE/L2	866	+	95	40118875	32660
chr1	40086215	40286215	harbor2	chr1	40119514	40119671	LINE/L2	629	+	78	40119592	33377
chr1	40086215	40286215	harbor2	chr1	40120472	40120602	LINE/L2	629	+	65	40120537	34322
chr1	40086215	40286215	harbor2	chr1	40146948	40147384	LINE/L2	1575	+	218	40147166	60951
chr1	40086215	40286215	harbor2	chr1	40147736	40148192	LINE/L2	1575	+	228	40147964	61749
chr1	40086215	40286215	harbor2	chr1	40148535	40148590	LINE/L2	1575	+	28	40148563	62348
chr1	40086215	40286215	harbor2	chr1	40157278	40157841	LINE/L2	788	+	282	40157560	71345
chr1	40086215	40286215	harbor2	chr1	40165900	40166236	LINE/L2	415	+	168	40166068	79853
chr1	40086215	40286215	harbor2	chr1	40167604	40167842	LINE/L2	439	+	119	40167723	81508
chr1	66780247	66980247	harbor2	chr1	66790344	66790603	LINE/L2	484	+	130	66790474	10227
chr1	66780247	66980247	harbor2	chr1	66807803	66808160	LINE/L2	577	+	178	66807981	27734
chr1	230019583	230219583	harbor2	chr1	230052306	230052836	LINE/L2	584	+	265	230052571	32988
chr1	230019583	230219583	harbor2	chr1	230053414	230053455	LINE/L2	418	+	20	230053434	33851
chr1	230019583	230219583	harbor2	chr1	230054073	230054165	LINE/L2	418	+	46	230054119	34536
chr1	246220510	246420510	harbor2	chr1	246293804	246294195	LINE/L2	619	+	196	246294000	73490
chr1	173501886	173701886	harbor2	chr1	173520405	173520603	LINE/L2	587	+	99	173520504	18618
chr1	173501886	173701886	harbor2	chr1	173523402	173523511	LINE/L2	1412	+	54	173523456	21570
chr1	173501886	173701886	harbor2	chr1	173571308	173571785	LINE/L2	1350	+	238	173571546	69660
chr1	173501886	173701886	harbor2	chr1	173522724	173523090	LINE/L2	1412	+	183	173522907	21021
chr1	95391895	95591895	harbor2	chr1	95438939	95439122	LINE/L2	557	+	92	95439031	47136
chr1	95391895	95591895	harbor2	chr1	95439418	95439539	LINE/L2	557	+	60	95439478	47583
chr1	248377263	248577263	harbor2	chr1	248429599	248430769	LINE/L2	1033	+	585	248430184	52921
chr1	247890396	248090396	harbor2	chr1	247924789	247924979	LINE/L2	417	+	95	247924884	34488
chr1	172655810	172855810	harbor2	chr1	172667379	172667894	LINE/L2	828	+	258	172667637	11827
chr1	172655810	172855810	harbor2	chr1	172683064	172683168	LINE/L2	419	+	52	172683116	27306
chr1	172655810	172855810	harbor2	chr1	172706187	172707128	LINE/L2	459	+	470	172706657	50847
chr1	172655810	172855810	harbor2	chr1	172709414	172709911	LINE/L2	649	+	248	172709662	53852
chr1	181809342	182009342	harbor2	chr1	181895749	181896649	LINE/L2	1137	+	450	181896199	86857
chr1	181809342	182009342	harbor2	chr1	181898404	181898810	LINE/L2	414	+	203	181898607	89265
chr1	181809342	182009342	harbor2	chr1	181895089	181895492	LINE/L2	1137	+	202	181895291	85949
chr1	245851156	246051156	harbor2	chr1	245916383	245916872	LINE/L2	1675	+	244	245916627	65471
chr1	245851156	246051156	harbor2	chr1	245917436	245917757	LINE/L2	1675	+	160	245917596	66440
chr1	245851156	246051156	harbor2	chr1	245923539	245923862	LINE/L2	432	+	162	245923701	72545
chr1	222805769	223005769	harbor2	chr1	222807245	222807476	LINE/L2	422	+	116	222807361	1592
chr1	222805769	223005769	harbor2	chr1	222808016	222808101	LINE/L2	422	+	42	222808058	2289
chr1	152050291	152250291	harbor2	chr1	152057896	152058033	LINE/L2	487	+	68	152057964	7673
chr1	152050291	152250291	harbor2	chr1	152063916	152064262	LINE/L2	1106	+	173	152064089	13798
chr1	152050291	152250291	harbor2	chr1	152064567	152065114	LINE/L2	1106	+	274	152064841	14550
chr1	152050291	152250291	harbor2	chr1	152065363	152065438	LINE/L2	438	+	38	152065401	15110
chr1	152050291	152250291	harbor2	chr1	152065604	152066046	LINE/L2	527	+	221	152065825	15534
chr1	152050291	152250291	harbor2	chr1	152073309	152073776	LINE/L2	1302	+	234	152073543	23252
chr1	152050291	152250291	harbor2	chr1	152098004	152098141	LINE/L2	1686	+	68	152098072	47781
chr1	152050291	152250291	harbor2	chr1	152098565	152098930	LINE/L2	1686	+	182	152098747	48456
chr1	152050291	152250291	harbor2	chr1	152099314	152099642	LINE/L2	1686	+	164	152099478	49187
chr1	152050291	152250291	harbor2	chr1	152099992	152100337	LINE/L2	1686	+	172	152100164	49873
chr1	152050291	152250291	harbor2	chr1	152100636	152101484	LINE/L2	1686	+	424	152101060	50769
chr1	152050291	152250291	harbor2	chr1	152137259	152137810	LINE/L2	1540	+	276	152137535	87244
chr1	231146247	231346247	harbor2	chr1	231224525	231224932	LINE/L2	643	+	204	231224729	78482
chr1	231146247	231346247	harbor2	chr1	231234494	231235145	LINE/L2	792	+	326	231234820	88573
chr1	231146247	231346247	harbor2	chr1	231244864	231245256	LINE/L2	530	+	196	231245060	98813
chr1	231146247	231346247	harbor2	chr1	231245546	231245579	LINE/L2	530	+	16	231245562	99315
chr1	191437176	191637176	harbor2	chr1	191526326	191526715	LINE/L2	735	+	194	191526520	89344
chr1	187440259	187640259	harbor2	chr1	187509652	187510533	LINE/L2	1990	+	440	187510092	69833
chr1	187440259	187640259	harbor2	chr1	187523766	187524504	LINE/L2	1078	+	369	187524135	83876
chr1	244095961	244295961	harbor2	chr1	244104308	244104796	LINE/L2	738	+	244	244104552	8591
chr1	244095961	244295961	harbor2	chr1	244169371	244169703	LINE/L2	419	+	166	244169537	73576
chr1	244095961	244295961	harbor2	chr1	244176124	244176448	LINE/L2	650	+	162	244176286	80325
chr1	244095961	244295961	harbor2	chr1	244195154	244195606	LINE/L2	516	+	226	244195380	99419
chr1	145599117	145799117	harbor2	chr1	145609828	145610154	LINE/L2	527	+	163	145609991	10874
chr1	145599117	145799117	harbor2	chr1	145610401	145610774	LINE/L2	682	+	186	145610587	11470
chr1	145599117	145799117	harbor2	chr1	145612928	145613745	LINE/L2	634	+	408	145613336	14219
chr1	145599117	145799117	harbor2	chr1	145614238	145614493	LINE/L2	691	+	128	145614366	15249
chr1	145599117	145799117	harbor2	chr1	145625654	145625975	LINE/L2	640	+	160	145625814	26697
chr1	154425596	154625596	harbor2	chr1	154495598	154495764	LINE/L2	491	+	83	154495681	70085
chr1	154425596	154625596	harbor2	chr1	154514583	154514675	LINE/L2	827	+	46	154514629	89033
chr1	154425596	154625596	harbor2	chr1	154515298	154515718	LINE/L2	827	+	210	154515508	89912
chr1	154425596	154625596	harbor2	chr1	154522674	154522923	LINE/L2	577	+	124	154522798	97202
chr1	154425596	154625596	harbor2	chr1	154523202	154523355	LINE/L2	577	+	76	154523278	97682
chr1	154425596	154625596	harbor2	chr1	154523536	154523851	LINE/L2	644	+	158	154523694	98098
chr1	154425596	154625596	harbor2	chr1	154451837	154452539	LINE/L2	1285	+	351	154452188	26592
chr1	104619708	104819708	harbor2	chr1	104637740	104638173	LINE/L2	443	+	216	104637956	18248
chr1	104619708	104819708	harbor2	chr1	104711437	104711713	LINE/L2	493	+	138	104711575	91867
chr1	104619708	104819708	harbor2	chr1	104711967	104712092	LINE/L2	493	+	62	104712029	92321
chr1	198328657	198528657	harbor2	chr1	198330240	198330678	LINE/L2	459	+	219	198330459	1802
chr1	198328657	198528657	harbor2	chr1	198389393	198389510	LINE/L2	425	+	58	198389451	60794
chr1	198328657	198528657	harbor2	chr1	198416632	198417749	LINE/L2	2174	+	558	198417190	88533
chr1	198328657	198528657	harbor2	chr1	198417790	198417905	LINE/L2	755	+	58	198417848	89191
chr1	247451404	247651404	harbor2	chr1	247533059	247533249	LINE/L2	526	+	95	247533154	81750
chr1	247451404	247651404	harbor2	chr1	247533883	247533944	LINE/L2	526	+	30	247533913	82509
chr1	247451404	247651404	harbor2	chr1	247533918	247534321	LINE/L2	980	+	202	247534120	82716
chr1	247451404	247651404	harbor2	chr1	247538320	247538449	LINE/L2	736	+	64	247538384	86980
chr1	247451404	247651404	harbor2	chr1	247538870	247539015	LINE/L2	736	+	72	247538942	87538
chr1	247451404	247651404	harbor2	chr1	247539822	247540084	LINE/L2	728	+	131	247539953	88549
chr1	247451404	247651404	harbor2	chr1	247540331	247540624	LINE/L2	728	+	146	247540477	89073
chr1	143899942	144099942	harbor2	chr1	143926581	143926913	LINE/L2	852	+	166	143926747	26805
chr1	143899942	144099942	harbor2	chr1	143946686	143947035	LINE/L2	749	+	174	143946860	46918
chr1	143899942	144099942	harbor2	chr1	143984714	143985084	LINE/L2	535	+	185	143984899	84957
chr1	164322431	164522431	harbor2	chr1	164374554	164374849	LINE/L2	588	+	148	164374702	52271
chr1	164322431	164522431	harbor2	chr1	164386847	164386967	LINE/L2	647	+	60	164386907	64476
chr1	164322431	164522431	harbor2	chr1	164387269	164387545	LINE/L2	647	+	138	164387407	64976
chr1	164322431	164522431	harbor2	chr1	164387674	164387920	LINE/L2	647	+	123	164387797	65366
chr1	164322431	164522431	harbor2	chr1	164389190	164389230	LINE/L2	1641	+	20	164389210	66779
chr1	164322431	164522431	harbor2	chr1	164389524	164391609	LINE/L2	1641	+	1042	164390566	68135
chr1	237384465	237584465	harbor2	chr1	237441922	237442052	LINE/L2	404	+	65	237441987	57522
chr1	237384465	237584465	harbor2	chr1	237463208	237463337	LINE/L2	411	+	64	237463272	78807
chr1	64527261	64727261	harbor2	chr1	64539640	64539759	LINE/L2	470	+	60	64539700	12439
chr1	64527261	64727261	harbor2	chr1	64557526	64557819	LINE/L2	668	+	146	64557672	30411
chr1	64527261	64727261	harbor2	chr1	64558097	64558298	LINE/L2	668	+	100	64558197	30936
chr1	64527261	64727261	harbor2	chr1	64566006	64566329	LINE/L2	863	+	162	64566168	38907
chr1	248423421	248623421	harbor2	chr1	248482273	248482773	LINE/L2	714	+	250	248482523	59102
chr1	248423421	248623421	harbor2	chr1	248429599	248430769	LINE/L2	1033	+	585	248430184	6763
chr1	239570054	239770054	harbor2	chr1	239574143	239574737	LINE/L2	708	+	297	239574440	4386
chr1	239570054	239770054	harbor2	chr1	239582677	239583027	LINE/L2	637	+	175	239582852	12798
chr1	239570054	239770054	harbor2	chr1	239599014	239599581	LINE/L2	566	+	284	239599298	29244
chr1	239570054	239770054	harbor2	chr1	239599942	239600227	LINE/L2	566	+	142	239600084	30030
chr1	239570054	239770054	harbor2	chr1	239635069	239635419	LINE/L2	434	+	175	239635244	65190
chr1	239570054	239770054	harbor2	chr1	239635699	239635855	LINE/L2	519	+	78	239635777	65723
chr1	181805898	182005898	harbor2	chr1	181895749	181896649	LINE/L2	1137	+	450	181896199	90301
chr1	181805898	182005898	harbor2	chr1	181898404	181898810	LINE/L2	414	+	203	181898607	92709
chr1	181805898	182005898	harbor2	chr1	181895089	181895492	LINE/L2	1137	+	202	181895291	89393
chr1	200611413	200811413	harbor2	chr1	200613188	200613570	LINE/L2	722	+	191	200613379	1966
chr1	200611413	200811413	harbor2	chr1	200652983	200654036	LINE/L2	1348	+	526	200653509	42096
chr1	200611413	200811413	harbor2	chr1	200680770	200681184	LINE/L2	591	+	207	200680977	69564
chr1	44370169	44570169	harbor2	chr1	44375720	44375878	LINE/L2	478	+	79	44375799	5630
chr1	44370169	44570169	harbor2	chr1	44387045	44387321	LINE/L2	525	+	138	44387183	17014
chr1	44370169	44570169	harbor2	chr1	44400855	44401080	LINE/L2	515	+	112	44400967	30798
chr1	44370169	44570169	harbor2	chr1	44402507	44402836	LINE/L2	568	+	164	44402671	32502
chr1	44370169	44570169	harbor2	chr1	44441999	44442126	LINE/L2	413	+	64	44442063	71894
chr1	44370169	44570169	harbor2	chr1	44442443	44442514	LINE/L2	413	+	36	44442479	72310
chr1	44370169	44570169	harbor2	chr1	44456641	44457001	LINE/L2	501	+	180	44456821	86652
chr1	44370169	44570169	harbor2	chr1	44464853	44465093	LINE/L2	438	+	120	44464973	94804
chr1	247557914	247757914	harbor2	chr1	247653639	247654118	LINE/L2	731	+	240	247653879	95965
chr1	247557914	247757914	harbor2	chr1	247654679	247654794	LINE/L2	731	+	58	247654737	96823
chr1	189882304	190082304	harbor2	chr1	189916138	189916398	LINE/L2	693	+	130	189916268	33964
chr1	189882304	190082304	harbor2	chr1	189921991	189922281	LINE/L2	696	+	145	189922136	39832
chr1	189882304	190082304	harbor2	chr1	189922613	189922948	LINE/L2	553	+	168	189922781	40477
chr1	189882304	190082304	harbor2	chr1	189946821	189947008	LINE/L2	593	+	94	189946915	64611
chr1	189882304	190082304	harbor2	chr1	189947146	189947688	LINE/L2	846	+	271	189947417	65113
chr1	189882304	190082304	harbor2	chr1	189947806	189948078	LINE/L2	564	+	136	189947942	65638
chr1	200225745	200425745	harbor2	chr1	200229075	200229494	LINE/L2	563	+	210	200229285	3540
chr1	200225745	200425745	harbor2	chr1	200229976	200230309	LINE/L2	763	+	166	200230142	4397
chr1	200225745	200425745	harbor2	chr1	200236367	200236784	LINE/L2	699	+	208	200236575	10830
chr1	200225745	200425745	harbor2	chr1	200254680	200254836	LINE/L2	410	+	78	200254758	29013
chr1	200225745	200425745	harbor2	chr1	200255129	200255392	LINE/L2	538	+	132	200255261	29516
chr1	200225745	200425745	harbor2	chr1	200259242	200259649	LINE/L2	622	+	204	200259446	33701
chr1	200225745	200425745	harbor2	chr1	200267918	200268378	LINE/L2	972	+	230	200268148	42403
chr1	200225745	200425745	harbor2	chr1	200268687	200268954	LINE/L2	879	+	134	200268821	43076
chr1	200225745	200425745	harbor2	chr1	200297674	200297712	LINE/L2	472	+	19	200297693	71948
chr1	200225745	200425745	harbor2	chr1	200297864	200298573	LINE/L2	472	+	354	200298218	72473
chr1	200225745	200425745	harbor2	chr1	200310584	200310980	LINE/L2	571	+	198	200310782	85037
chr1	243095345	243295345	harbor2	chr1	243133091	243133312	LINE/L2	418	+	110	243133201	37856
chr1	243095345	243295345	harbor2	chr1	243181694	243181953	LINE/L2	453	+	130	243181824	86479
chr1	243095345	243295345	harbor2	chr1	243182373	243182466	LINE/L2	453	+	46	243182419	87074
chr1	144244969	144444969	harbor2	chr1	144272169	144272628	LINE/L2	750	+	230	144272399	27430
chr1	144244969	144444969	harbor2	chr1	144284798	144285284	LINE/L2	881	+	243	144285041	40072
chr1	144244969	144444969	harbor2	chr1	144285592	144285783	LINE/L2	881	+	96	144285688	40719
chr1	144244969	144444969	harbor2	chr1	144306702	144307468	LINE/L2	867	+	383	144307085	62116
chr1	185836540	186036540	harbor2	chr1	185842080	185842266	LINE/L2	511	+	93	185842173	5633
chr1	185836540	186036540	harbor2	chr1	185846676	185847667	LINE/L2	1124	+	496	185847172	10632
chr1	185836540	186036540	harbor2	chr1	185847974	185849245	LINE/L2	1124	+	636	185848610	12070
chr1	242473934	242673934	harbor2	chr1	242474232	242474644	LINE/L2	557	+	206	242474438	504
chr1	242473934	242673934	harbor2	chr1	242474768	242475067	LINE/L2	407	+	150	242474918	984
chr1	242473934	242673934	harbor2	chr1	242502030	242502351	LINE/L2	611	+	160	242502190	28256
chr1	242473934	242673934	harbor2	chr1	242570507	242570665	LINE/L2	487	+	79	242570586	96652
chr1	55998891	56198891	harbor2	chr1	56026403	56026693	LINE/L2	1075	+	145	56026548	27657
chr1	55998891	56198891	harbor2	chr1	56066683	56066985	LINE/L2	730	+	151	56066834	67943
chr1	200258718	200458718	harbor2	chr1	200259242	200259649	LINE/L2	622	+	204	200259446	728
chr1	200258718	200458718	harbor2	chr1	200267918	200268378	LINE/L2	972	+	230	200268148	9430
chr1	200258718	200458718	harbor2	chr1	200268687	200268954	LINE/L2	879	+	134	200268821	10103
chr1	200258718	200458718	harbor2	chr1	200297674	200297712	LINE/L2	472	+	19	200297693	38975
chr1	200258718	200458718	harbor2	chr1	200297864	200298573	LINE/L2	472	+	354	200298218	39500
chr1	200258718	200458718	harbor2	chr1	200310584	200310980	LINE/L2	571	+	198	200310782	52064
chr1	242606595	242806595	harbor2	chr1	242626194	242626829	LINE/L2	723	+	318	242626512	19917
chr1	242606595	242806595	harbor2	chr1	242631524	242631764	LINE/L2	646	+	120	242631644	25049
chr1	242606595	242806595	harbor2	chr1	242678040	242678356	LINE/L2	602	+	158	242678198	71603
chr1	225024407	225224407	harbor2	chr1	225051979	225052187	LINE/L2	525	+	104	225052083	27676
chr1	225024407	225224407	harbor2	chr1	225083441	225083707	LINE/L2	860	+	133	225083574	59167
chr1	221903777	222103777	harbor2	chr1	221915692	221915982	LINE/L2	647	+	145	221915837	12060
chr1	66653305	66853305	harbor2	chr1	66655159	66655489	LINE/L2	617	+	165	66655324	2019
chr1	66653305	66853305	harbor2	chr1	66721857	66722506	LINE/L2	1035	+	324	66722181	68876
chr1	66653305	66853305	harbor2	chr1	66730436	66730976	LINE/L2	718	+	270	66730706	77401
chr1	66653305	66853305	harbor2	chr1	66731057	66731210	LINE/L2	405	+	76	66731133	77828
chr1	107408456	107608456	harbor2	chr1	107494478	107495347	LINE/L2	1016	+	434	107494912	86456
chr1	82768688	82968688	harbor2	chr1	82797734	82798403	LINE/L2	992	+	334	82798068	29380
chr1	82768688	82968688	harbor2	chr1	82799217	82799613	LINE/L2	637	+	198	82799415	30727
chr1	82768688	82968688	harbor2	chr1	82833623	82834246	LINE/L2	417	+	312	82833935	65247
chr1	164842370	165042370	harbor2	chr1	164885680	164886048	LINE/L2	1226	+	184	164885864	43494
chr1	243746763	243946763	harbor2	chr1	243771148	243771427	LINE/L2	420	+	140	243771288	24525
chr1	243746763	243946763	harbor2	chr1	243796398	243796750	LINE/L2	554	+	176	243796574	49811
chr1	243746763	243946763	harbor2	chr1	243797163	243797177	LINE/L2	486	+	7	243797170	50407
chr1	243746763	243946763	harbor2	chr1	243805982	243806356	LINE/L2	404	+	187	243806169	59406
chr1	229011022	229211022	harbor2	chr1	229090735	229090783	LINE/L2	532	+	24	229090759	79737
chr1	229011022	229211022	harbor2	chr1	229091095	229091131	LINE/L2	532	+	18	229091113	80091
chr1	229011022	229211022	harbor2	chr1	229091424	229091576	LINE/L2	532	+	76	229091500	80478
chr1	215210141	215410141	harbor2	chr1	215210846	215211679	LINE/L2	1367	+	416	215211262	1121
chr1	215210141	215410141	harbor2	chr1	215239816	215240230	LINE/L2	510	+	207	215240023	29882
chr1	244372121	244572121	harbor2	chr1	244426680	244427027	LINE/L2	864	+	174	244426854	54733
chr1	192413260	192613260	harbor2	chr1	192471954	192472496	LINE/L2	1643	+	271	192472225	58965
chr1	192413260	192613260	harbor2	chr1	192472523	192473667	LINE/L2	1643	+	572	192473095	59835
chr1	184898608	185098608	harbor2	chr1	184898626	184898805	LINE/L2	912	+	90	184898716	108
chr1	184898608	185098608	harbor2	chr1	184951343	184952051	LINE/L2	2079	+	354	184951697	53089
chr1	184898608	185098608	harbor2	chr1	184975485	184975640	LINE/L2	490	+	78	184975563	76955
chr1	184898608	185098608	harbor2	chr1	184975678	184976060	LINE/L2	895	+	191	184975869	77261
chr1	184898608	185098608	harbor2	chr1	184976119	184976223	LINE/L2	479	+	52	184976171	77563
chr1	79255836	79455836	harbor2	chr1	79302826	79303482	LINE/L2	1074	+	328	79303154	47318
chr1	183793100	183993100	harbor2	chr1	183810789	183811006	LINE/L2	555	+	108	183810897	17797
chr1	183793100	183993100	harbor2	chr1	183818339	183818728	LINE/L2	444	+	194	183818533	25433
chr1	183793100	183993100	harbor2	chr1	183826308	183826556	LINE/L2	665	+	124	183826432	33332
chr1	183793100	183993100	harbor2	chr1	183829676	183830099	LINE/L2	829	+	212	183829888	36788
chr1	183793100	183993100	harbor2	chr1	183840499	183840580	LINE/L2	454	+	40	183840539	47439
chr1	183793100	183993100	harbor2	chr1	183840913	183841181	LINE/L2	454	+	134	183841047	47947
chr1	183793100	183993100	harbor2	chr1	183860374	183860883	LINE/L2	1205	+	254	183860628	67528
chr1	185988450	186188450	harbor2	chr1	186002591	186003169	LINE/L2	760	+	289	186002880	14430
chr1	185988450	186188450	harbor2	chr1	186007999	186008239	LINE/L2	471	+	120	186008119	19669
chr1	185988450	186188450	harbor2	chr1	186066695	186067346	LINE/L2	486	+	326	186067021	78571
chr1	217624939	217824939	harbor2	chr1	217659869	217660425	LINE/L2	489	+	278	217660147	35208
chr1	217624939	217824939	harbor2	chr1	217688568	217688944	LINE/L2	447	+	188	217688756	63817
chr1	222989637	223189637	harbor2	chr1	223053764	223055247	LINE/L2	3754	+	742	223054506	64869
chr1	222989637	223189637	harbor2	chr1	223063346	223063732	LINE/L2	1101	+	193	223063539	73902
chr1	144233986	144433986	harbor2	chr1	144272169	144272628	LINE/L2	750	+	230	144272399	38413
chr1	144233986	144433986	harbor2	chr1	144284798	144285284	LINE/L2	881	+	243	144285041	51055
chr1	144233986	144433986	harbor2	chr1	144285592	144285783	LINE/L2	881	+	96	144285688	51702
chr1	144233986	144433986	harbor2	chr1	144306702	144307468	LINE/L2	867	+	383	144307085	73099
chr1	55932620	56132620	harbor2	chr1	55968638	55968970	LINE/L2	520	+	166	55968804	36184
chr1	55932620	56132620	harbor2	chr1	55996927	55997305	LINE/L2	423	+	189	55997116	64496
chr1	55932620	56132620	harbor2	chr1	56026403	56026693	LINE/L2	1075	+	145	56026548	93928
chr1	237003724	237203724	harbor2	chr1	237035617	237035919	LINE/L2	777	+	151	237035768	32044
chr1	237003724	237203724	harbor2	chr1	237036034	237036056	LINE/L2	777	+	11	237036045	32321
chr1	237003724	237203724	harbor2	chr1	237036184	237036350	LINE/L2	777	+	83	237036267	32543
chr1	232677111	232877111	harbor2	chr1	232702547	232703648	LINE/L2	1147	+	550	232703097	25986
chr1	232677111	232877111	harbor2	chr1	232717252	232717768	LINE/L2	498	+	258	232717510	40399
chr1	232677111	232877111	harbor2	chr1	232729735	232729984	LINE/L2	770	+	124	232729859	52748
chr1	232677111	232877111	harbor2	chr1	232730291	232730707	LINE/L2	770	+	208	232730499	53388
chr1	232677111	232877111	harbor2	chr1	232774002	232774127	LINE/L2	601	+	62	232774064	96953
chr1	232677111	232877111	harbor2	chr1	232701850	232702171	LINE/L2	784	+	160	232702010	24899
chr1	232677111	232877111	harbor2	chr1	232718331	232718553	LINE/L2	498	+	111	232718442	41331
chr1	198647514	198847514	harbor2	chr1	198671125	198671920	LINE/L2	561	+	398	198671523	24009
chr1	198647514	198847514	harbor2	chr1	198691764	198692017	LINE/L2	499	+	126	198691890	44376
chr1	198647514	198847514	harbor2	chr1	198727271	198727471	LINE/L2	456	+	100	198727371	79857
chr1	198647514	198847514	harbor2	chr1	198730301	198730503	LINE/L2	592	+	101	198730402	82888
chr1	205885743	206085743	harbor2	chr1	205916469	205916587	LINE/L2	462	+	59	205916528	30785
chr1	205885743	206085743	harbor2	chr1	205959518	205959610	LINE/L2	437	+	46	205959564	73821
chr1	205885743	206085743	harbor2	chr1	205967268	205967764	LINE/L2	416	+	248	205967516	81773
chr1	205885743	206085743	harbor2	chr1	205968353	205968525	LINE/L2	558	+	86	205968439	82696
chr1	205885743	206085743	harbor2	chr1	205977678	205978078	LINE/L2	973	+	200	205977878	92135
chr1	205885743	206085743	harbor2	chr1	205930310	205931066	LINE/L2	679	+	378	205930688	44945
chr1	69841007	70041007	harbor2	chr1	69863166	69863493	LINE/L2	610	+	164	69863330	22323
chr1	69841007	70041007	harbor2	chr1	69863697	69864315	LINE/L2	587	+	309	69864006	22999
chr1	69841007	70041007	harbor2	chr1	69897295	69897610	LINE/L2	1108	+	158	69897453	56446
chr1	69841007	70041007	harbor2	chr1	69922655	69922788	LINE/L2	408	+	66	69922721	81714
chr1	69841007	70041007	harbor2	chr1	69928962	69930281	LINE/L2	1558	+	660	69929622	88615
chr1	235623434	235823434	harbor2	chr1	235641803	235642018	LINE/L2	432	+	108	235641911	18477
chr1	235623434	235823434	harbor2	chr1	235659711	235659893	LINE/L2	507	+	91	235659802	36368
chr1	235623434	235823434	harbor2	chr1	235660182	235660450	LINE/L2	555	+	134	235660316	36882
chr1	242274026	242474026	harbor2	chr1	242278629	242278795	LINE/L2	449	+	83	242278712	4686
chr1	242274026	242474026	harbor2	chr1	242322223	242322527	LINE/L2	498	+	152	242322375	48349
chr1	242274026	242474026	harbor2	chr1	242322887	242323064	LINE/L2	498	+	88	242322975	48949
chr1	113179548	113379548	harbor2	chr1	113193391	113193707	LINE/L2	540	+	158	113193549	14001
chr1	113179548	113379548	harbor2	chr1	113264083	113264426	LINE/L2	1114	+	172	113264255	84707
chr1	113179548	113379548	harbor2	chr1	113264735	113265309	LINE/L2	1114	+	287	113265022	85474
chr1	113179548	113379548	harbor2	chr1	113266805	113267126	LINE/L2	768	+	160	113266965	87417
chr1	113179548	113379548	harbor2	chr1	113267695	113267894	LINE/L2	542	+	100	113267795	88247
chr1	113179548	113379548	harbor2	chr1	113268456	113268750	LINE/L2	481	+	147	113268603	89055
chr1	187470261	187670261	harbor2	chr1	187509652	187510533	LINE/L2	1990	+	440	187510092	39831
chr1	187470261	187670261	harbor2	chr1	187523766	187524504	LINE/L2	1078	+	369	187524135	53874
chr1	187470261	187670261	harbor2	chr1	187544098	187544610	LINE/L2	540	+	256	187544354	74093
chr1	230339685	230539685	harbor2	chr1	230399823	230400549	LINE/L2	996	+	363	230400186	60501
chr1	230339685	230539685	harbor2	chr1	230413709	230413924	LINE/L2	414	+	108	230413817	74132
chr1	230339685	230539685	harbor2	chr1	230417563	230417838	LINE/L2	468	+	138	230417701	78016
chr1	168291066	168491066	harbor2	chr1	168313966	168314427	LINE/L2	415	+	230	168314196	23130
chr1	238677994	238877994	harbor2	chr1	238700243	238700625	LINE/L2	413	+	191	238700434	22440
chr1	238677994	238877994	harbor2	chr1	238770698	238770951	LINE/L2	520	+	126	238770824	92830
chr1	238677994	238877994	harbor2	chr1	238771243	238771401	LINE/L2	520	+	79	238771322	93328
chr1	118109234	118309234	harbor2	chr1	118131203	118131626	LINE/L2	946	+	212	118131415	22181
chr1	118109234	118309234	harbor2	chr1	118140543	118141274	LINE/L2	493	+	366	118140909	31675
chr1	199810339	200010339	harbor2	chr1	199814025	199814727	LINE/L2	1377	+	351	199814376	4037
chr1	199810339	200010339	harbor2	chr1	199823657	199823953	LINE/L2	580	+	148	199823805	13466
chr1	199810339	200010339	harbor2	chr1	199847657	199847959	LINE/L2	704	+	151	199847808	37469
chr1	199810339	200010339	harbor2	chr1	199848266	199848552	LINE/L2	443	+	143	199848409	38070
chr1	199810339	200010339	harbor2	chr1	199871358	199871684	LINE/L2	599	+	163	199871521	61182
chr1	226120827	226320827	harbor2	chr1	226134517	226135223	LINE/L2	830	+	353	226134870	14043
chr1	121235311	121435311	harbor2	chr1	121264402	121264823	LINE/L2	564	+	210	121264612	29301
chr1	165052531	165252531	harbor2	chr1	165058378	165058707	LINE/L2	527	+	164	165058542	6011
chr1	165052531	165252531	harbor2	chr1	165133500	165133936	LINE/L2	960	+	218	165133718	81187
chr1	228917927	229117927	harbor2	chr1	228924762	228925071	LINE/L2	419	+	154	228924916	6989
chr1	228917927	229117927	harbor2	chr1	228997481	228998085	LINE/L2	896	+	302	228997783	79856
chr1	52056818	52256818	harbor2	chr1	52063739	52064392	LINE/L2	968	+	326	52064065	7247
chr1	52056818	52256818	harbor2	chr1	52120256	52120308	LINE/L2	519	+	26	52120282	63464
chr1	52056818	52256818	harbor2	chr1	52120601	52120884	LINE/L2	519	+	142	52120743	63925
chr1	52056818	52256818	harbor2	chr1	52127931	52128885	LINE/L2	661	+	477	52128408	71590
chr1	152136836	152336836	harbor2	chr1	152137259	152137810	LINE/L2	1540	+	276	152137535	699
chr1	152136836	152336836	harbor2	chr1	152170983	152171305	LINE/L2	869	+	161	152171144	34308
chr1	152136836	152336836	harbor2	chr1	152228690	152228935	LINE/L2	851	+	122	152228812	91976
chr1	163043195	163243195	harbor2	chr1	163052531	163052753	LINE/L2	546	+	111	163052642	9447
chr1	163043195	163243195	harbor2	chr1	163061582	163062106	LINE/L2	577	+	262	163061844	18649
chr1	163043195	163243195	harbor2	chr1	163065560	163065825	LINE/L2	456	+	132	163065692	22497
chr1	163043195	163243195	harbor2	chr1	163066365	163066724	LINE/L2	805	+	180	163066545	23350
chr1	163043195	163243195	harbor2	chr1	163083794	163084608	LINE/L2	464	+	407	163084201	41006
chr1	217184339	217384339	harbor2	chr1	217239264	217239677	LINE/L2	1136	+	206	217239470	55131
chr1	182524918	182724918	harbor2	chr1	182535386	182535775	LINE/L2	826	+	194	182535580	10662
chr1	182524918	182724918	harbor2	chr1	182569710	182570734	LINE/L2	1834	+	512	182570222	45304
chr1	182524918	182724918	harbor2	chr1	182600698	182601435	LINE/L2	765	+	368	182601066	76148
chr1	204675813	204875813	harbor2	chr1	204678454	204679007	LINE/L2	903	+	276	204678730	2917
chr1	204675813	204875813	harbor2	chr1	204681583	204681693	LINE/L2	484	+	55	204681638	5825
chr1	204675813	204875813	harbor2	chr1	204682957	204683055	LINE/L2	405	+	49	204683006	7193
chr1	204675813	204875813	harbor2	chr1	204699574	204699824	LINE/L2	642	+	125	204699699	23886
chr1	204675813	204875813	harbor2	chr1	204765809	204766038	LINE/L2	426	+	114	204765923	90110
chr1	239182052	239382052	harbor2	chr1	239204409	239204652	LINE/L2	445	+	122	239204531	22479
chr1	216601103	216801103	harbor2	chr1	216625935	216626847	LINE/L2	502	+	456	216626391	25288
chr1	212511727	212711727	harbor2	chr1	212517890	212518015	LINE/L2	584	+	62	212517952	6225
chr1	212511727	212711727	harbor2	chr1	212600561	212600857	LINE/L2	410	+	148	212600709	88982
chr1	220330149	220530149	harbor2	chr1	220362146	220362634	LINE/L2	516	+	244	220362390	32241
chr1	220330149	220530149	harbor2	chr1	220376809	220377052	LINE/L2	564	+	122	220376931	46782
chr1	220330149	220530149	harbor2	chr1	220394652	220394926	LINE/L2	1212	+	137	220394789	64640
chr1	220330149	220530149	harbor2	chr1	220395276	220395838	LINE/L2	1329	+	281	220395557	65408
chr1	56836709	57036709	harbor2	chr1	56922112	56922472	LINE/L2	880	+	180	56922292	85583
chr1	56836709	57036709	harbor2	chr1	56922836	56922942	LINE/L2	880	+	53	56922889	86180
chr1	56836709	57036709	harbor2	chr1	56929666	56930102	LINE/L2	498	+	218	56929884	93175
chr1	51237034	51437034	harbor2	chr1	51240006	51240634	LINE/L2	874	+	314	51240320	3286
chr1	51237034	51437034	harbor2	chr1	51297626	51298239	LINE/L2	462	+	306	51297932	60898
chr1	51237034	51437034	harbor2	chr1	51315658	51315867	LINE/L2	447	+	104	51315762	78728
chr1	51237034	51437034	harbor2	chr1	51322382	51322569	LINE/L2	727	+	94	51322476	85442
chr1	51237034	51437034	harbor2	chr1	51324910	51324974	LINE/L2	429	+	32	51324942	87908
chr1	51237034	51437034	harbor2	chr1	51325271	51325388	LINE/L2	429	+	58	51325329	88295
chr1	51237034	51437034	harbor2	chr1	51333560	51333704	LINE/L2	413	+	72	51333632	96598
chr1	197571289	197771289	harbor2	chr1	197571009	197571767	LINE/L2	798	+	379	197571388	99
chr1	197571289	197771289	harbor2	chr1	197601141	197601253	LINE/L2	496	+	56	197601197	29908
chr1	161097778	161297778	harbor2	chr1	161113953	161114373	LINE/L2	457	+	210	161114163	16385
chr1	161097778	161297778	harbor2	chr1	161126642	161127100	LINE/L2	676	+	229	161126871	29093
chr1	161097778	161297778	harbor2	chr1	161191733	161192023	LINE/L2	632	+	145	161191878	94100
chr1	149979090	150179090	harbor2	chr1	149985764	149986215	LINE/L2	731	+	226	149985990	6900
chr1	149979090	150179090	harbor2	chr1	150003277	150003682	LINE/L2	662	+	202	150003479	24389
chr1	149979090	150179090	harbor2	chr1	150030140	150030764	LINE/L2	519	+	312	150030452	51362
chr1	149979090	150179090	harbor2	chr1	150046222	150046444	LINE/L2	718	+	111	150046333	67243
chr1	149979090	150179090	harbor2	chr1	150046749	150046792	LINE/L2	718	+	22	150046771	67681
chr1	149979090	150179090	harbor2	chr1	150047085	150047572	LINE/L2	1254	+	244	150047329	68239
chr1	149979090	150179090	harbor2	chr1	150069821	150070331	LINE/L2	500	+	255	150070076	90986
chr1	214138646	214338646	harbor2	chr1	214140101	214140382	LINE/L2	496	+	140	214140241	1595
chr1	214138646	214338646	harbor2	chr1	214184545	214184931	LINE/L2	708	+	193	214184738	46092
chr1	214138646	214338646	harbor2	chr1	214204155	214204271	LINE/L2	658	+	58	214204213	65567
chr1	214138646	214338646	harbor2	chr1	214215322	214215964	LINE/L2	585	+	321	214215643	76997
chr1	214138646	214338646	harbor2	chr1	214231248	214231699	LINE/L2	590	+	226	214231474	92828
chr1	11234036	11434036	harbor2	chr1	11250366	11251615	LINE/L2	1241	+	624	11250990	16954
chr1	11234036	11434036	harbor2	chr1	11252746	11252882	LINE/L2	447	+	68	11252814	18778
chr1	11234036	11434036	harbor2	chr1	11253266	11253790	LINE/L2	688	+	262	11253528	19492
chr1	11234036	11434036	harbor2	chr1	11280763	11281490	LINE/L2	1249	+	364	11281127	47091
chr1	11234036	11434036	harbor2	chr1	11331936	11332131	LINE/L2	488	+	98	11332034	97998
chr1	11234036	11434036	harbor2	chr1	11332442	11332506	LINE/L2	488	+	32	11332474	98438
chr1	11234036	11434036	harbor2	chr1	11333122	11333632	LINE/L2	1027	+	255	11333377	99341
chr1	175381369	175581369	harbor2	chr1	175381737	175382274	LINE/L2	962	+	268	175382005	636
chr1	175381369	175581369	harbor2	chr1	175434735	175435059	LINE/L2	417	+	162	175434897	53528
chr1	175381369	175581369	harbor2	chr1	175450401	175450698	LINE/L2	621	+	148	175450549	69180
chr1	175381369	175581369	harbor2	chr1	175455736	175455888	LINE/L2	498	+	76	175455812	74443
chr1	175381369	175581369	harbor2	chr1	175456023	175456524	LINE/L2	1495	+	250	175456273	74904
chr1	240276024	240476024	harbor2	chr1	240281431	240281541	LINE/L2	405	+	55	240281486	5462
chr1	240276024	240476024	harbor2	chr1	240359952	240360547	LINE/L2	636	+	298	240360250	84226
chr1	235779671	235979671	harbor2	chr1	235785103	235785478	LINE/L2	569	+	188	235785291	5620
chr1	235779671	235979671	harbor2	chr1	235823497	235823981	LINE/L2	429	+	242	235823739	44068
chr1	235779671	235979671	harbor2	chr1	235842486	235842607	LINE/L2	468	+	60	235842546	62875
chr1	235779671	235979671	harbor2	chr1	235864333	235864649	LINE/L2	1258	+	158	235864491	84820
chr1	235779671	235979671	harbor2	chr1	235864945	235865509	LINE/L2	1368	+	282	235865227	85556
chr1	235779671	235979671	harbor2	chr1	235869694	235870028	LINE/L2	895	+	167	235869861	90190
chr1	235779671	235979671	harbor2	chr1	235870620	235870804	LINE/L2	726	+	92	235870712	91041
chr1	209472166	209672166	harbor2	chr1	209525522	209525847	LINE/L2	477	+	162	209525684	53518
chr1	209472166	209672166	harbor2	chr1	209525938	209526393	LINE/L2	523	+	228	209526166	54000
chr1	185353866	185553866	harbor2	chr1	185375159	185375998	LINE/L2	1373	+	420	185375579	21713
chr1	185353866	185553866	harbor2	chr1	185376208	185376399	LINE/L2	1373	+	96	185376304	22438
chr1	185353866	185553866	harbor2	chr1	185376405	185376839	LINE/L2	494	+	217	185376622	22756
chr1	82002432	82202432	harbor2	chr1	82051252	82051667	LINE/L2	469	+	208	82051460	49028
chr1	82002432	82202432	harbor2	chr1	82058295	82058512	LINE/L2	473	+	108	82058403	55971
chr1	82002432	82202432	harbor2	chr1	82074463	82075315	LINE/L2	1818	+	426	82074889	72457
chr1	242317646	242517646	harbor2	chr1	242322223	242322527	LINE/L2	498	+	152	242322375	4729
chr1	242317646	242517646	harbor2	chr1	242322887	242323064	LINE/L2	498	+	88	242322975	5329
chr1	242317646	242517646	harbor2	chr1	242396376	242396663	LINE/L2	1478	+	144	242396520	78874
chr1	242317646	242517646	harbor2	chr1	242396976	242397465	LINE/L2	1478	+	244	242397220	79574
chr1	242317646	242517646	harbor2	chr1	242400907	242401948	LINE/L2	1210	+	520	242401427	83781
chr1	154661658	154861658	harbor2	chr1	154743195	154743544	LINE/L2	494	+	174	154743369	81711
chr1	154661658	154861658	harbor2	chr1	154743927	154744234	LINE/L2	1045	+	154	154744081	82423
chr1	154661658	154861658	harbor2	chr1	154755013	154755184	LINE/L2	456	+	86	154755099	93441
chr1	154661658	154861658	harbor2	chr1	154756448	154756924	LINE/L2	509	+	238	154756686	95028
chr1	195485655	195685655	harbor2	chr1	195546360	195546746	LINE/L2	422	+	193	195546553	60898
chr1	218443782	218643782	harbor2	chr1	218489855	218490305	LINE/L2	651	+	225	218490080	46298
chr1	218443782	218643782	harbor2	chr1	218490381	218490655	LINE/L2	771	+	137	218490518	46736
chr1	218443782	218643782	harbor2	chr1	218492689	218493068	LINE/L2	484	+	190	218492879	49097
chr1	77186693	77386693	harbor2	chr1	77211034	77211278	LINE/L2	737	+	122	77211156	24463
chr1	77186693	77386693	harbor2	chr1	77262254	77262922	LINE/L2	1596	+	334	77262588	75895
chr1	77186693	77386693	harbor2	chr1	77263285	77263531	LINE/L2	586	+	123	77263408	76715
chr1	77186693	77386693	harbor2	chr1	77263547	77263871	LINE/L2	1090	+	162	77263709	77016
chr1	77186693	77386693	harbor2	chr1	77278005	77278812	LINE/L2	1646	+	404	77278409	91716
chr1	228952988	229152988	harbor2	chr1	228997481	228998085	LINE/L2	896	+	302	228997783	44795
chr1	114527150	114727150	harbor2	chr1	114592853	114592996	LINE/L2	893	+	72	114592925	65775
chr1	114527150	114727150	harbor2	chr1	114593133	114593502	LINE/L2	893	+	184	114593317	66167
chr1	241599865	241799865	harbor2	chr1	241648872	241649045	LINE/L2	463	+	86	241648958	49093
chr1	241599865	241799865	harbor2	chr1	241649733	241650980	LINE/L2	3009	+	624	241650357	50492
chr1	241599865	241799865	harbor2	chr1	241656516	241656664	LINE/L2	497	+	74	241656590	56725
chr1	241599865	241799865	harbor2	chr1	241656964	241657097	LINE/L2	497	+	66	241657030	57165
chr1	241599865	241799865	harbor2	chr1	241657219	241657666	LINE/L2	497	+	224	241657443	57578
chr1	241599865	241799865	harbor2	chr1	241686397	241686568	LINE/L2	461	+	86	241686483	86618
chr1	233840834	234040834	harbor2	chr1	233842570	233842842	LINE/L2	667	+	136	233842706	1872
chr1	233840834	234040834	harbor2	chr1	233892821	233892989	LINE/L2	573	+	84	233892905	52071
chr1	233840834	234040834	harbor2	chr1	233893370	233893649	LINE/L2	573	+	140	233893510	52676
chr1	233840834	234040834	harbor2	chr1	233865139	233866003	LINE/L2	1894	+	432	233865571	24737
chr1	234983094	235183094	harbor2	chr1	234990789	234991619	LINE/L2	917	+	415	234991204	8110
chr1	234983094	235183094	harbor2	chr1	235014439	235014662	LINE/L2	445	+	112	235014551	31457
chr1	234983094	235183094	harbor2	chr1	235017708	235018085	LINE/L2	800	+	188	235017896	34802
chr1	213635920	213835920	harbor2	chr1	213672235	213672922	LINE/L2	703	+	344	213672579	36659
chr1	213635920	213835920	harbor2	chr1	213695047	213695171	LINE/L2	549	+	62	213695109	59189
chr1	210268422	210468422	harbor2	chr1	210287198	210287300	LINE/L2	467	+	51	210287249	18827
chr1	210268422	210468422	harbor2	chr1	210288640	210289006	LINE/L2	645	+	183	210288823	20401
chr1	154807861	155007861	harbor2	chr1	154829896	154830076	LINE/L2	548	+	90	154829986	22125
chr1	154807861	155007861	harbor2	chr1	154838348	154838887	LINE/L2	515	+	270	154838618	30757
chr1	154807861	155007861	harbor2	chr1	154851437	154852028	LINE/L2	1649	+	296	154851733	43872
chr1	154807861	155007861	harbor2	chr1	154852846	154852982	LINE/L2	472	+	68	154852914	45053
chr1	154807861	155007861	harbor2	chr1	154874275	154874708	LINE/L2	653	+	216	154874491	66630
chr1	154807861	155007861	harbor2	chr1	154877986	154878109	LINE/L2	521	+	62	154878048	70187
chr1	154807861	155007861	harbor2	chr1	154887466	154887558	LINE/L2	563	+	46	154887512	79651
chr1	154807861	155007861	harbor2	chr1	154887861	154888313	LINE/L2	563	+	226	154888087	80226
chr1	154807861	155007861	harbor2	chr1	154899258	154899575	LINE/L2	792	+	158	154899416	91555
chr1	154807861	155007861	harbor2	chr1	154899889	154900416	LINE/L2	849	+	264	154900153	92292
chr1	179360560	179560560	harbor2	chr1	179377244	179377373	LINE/L2	417	+	64	179377308	16748
chr1	179360560	179560560	harbor2	chr1	179402271	179402976	LINE/L2	2241	+	352	179402623	42063
chr1	243691294	243891294	harbor2	chr1	243771148	243771427	LINE/L2	420	+	140	243771288	79994
chr1	172094351	172294351	harbor2	chr1	172103262	172103383	LINE/L2	406	+	60	172103322	8971
chr1	172094351	172294351	harbor2	chr1	172115236	172115951	LINE/L2	1143	+	358	172115594	21243
chr1	172094351	172294351	harbor2	chr1	172119408	172120087	LINE/L2	1050	+	340	172119748	25397
chr1	172094351	172294351	harbor2	chr1	172120449	172120945	LINE/L2	1050	+	248	172120697	26346
chr1	172094351	172294351	harbor2	chr1	172165977	172166225	LINE/L2	532	+	124	172166101	71750
chr1	166299022	166499022	harbor2	chr1	166395871	166396162	LINE/L2	544	+	146	166396017	96995
chr1	209242541	209442541	harbor2	chr1	209294398	209294562	LINE/L2	464	+	82	209294480	51939
chr1	209242541	209442541	harbor2	chr1	209299513	209299923	LINE/L2	896	+	205	209299718	57177
chr1	242733648	242933648	harbor2	chr1	242741263	242742126	LINE/L2	1767	+	432	242741695	8047
chr1	242733648	242933648	harbor2	chr1	242742427	242742564	LINE/L2	1094	+	68	242742495	8847
chr1	242733648	242933648	harbor2	chr1	242747520	242748316	LINE/L2	856	+	398	242747918	14270
chr1	242733648	242933648	harbor2	chr1	242770356	242770691	LINE/L2	613	+	168	242770524	36876
chr1	242733648	242933648	harbor2	chr1	242786149	242786323	LINE/L2	530	+	87	242786236	52588
chr1	242733648	242933648	harbor2	chr1	242786616	242786692	LINE/L2	530	+	38	242786654	53006
chr1	242733648	242933648	harbor2	chr1	242787016	242787966	LINE/L2	1396	+	475	242787491	53843
chr1	242733648	242933648	harbor2	chr1	242790826	242790960	LINE/L2	434	+	67	242790893	57245
chr1	242733648	242933648	harbor2	chr1	242822770	242822797	LINE/L2	949	+	14	242822784	89136
chr1	242733648	242933648	harbor2	chr1	242823093	242823311	LINE/L2	949	+	109	242823202	89554
chr1	247508419	247708419	harbor2	chr1	247533059	247533249	LINE/L2	526	+	95	247533154	24735
chr1	247508419	247708419	harbor2	chr1	247533883	247533944	LINE/L2	526	+	30	247533913	25494
chr1	247508419	247708419	harbor2	chr1	247533918	247534321	LINE/L2	980	+	202	247534120	25701
chr1	247508419	247708419	harbor2	chr1	247538320	247538449	LINE/L2	736	+	64	247538384	29965
chr1	247508419	247708419	harbor2	chr1	247538870	247539015	LINE/L2	736	+	72	247538942	30523
chr1	247508419	247708419	harbor2	chr1	247539822	247540084	LINE/L2	728	+	131	247539953	31534
chr1	247508419	247708419	harbor2	chr1	247540331	247540624	LINE/L2	728	+	146	247540477	32058
chr1	247508419	247708419	harbor2	chr1	247556769	247557053	LINE/L2	501	+	142	247556911	48492
chr1	178440239	178640239	harbor2	chr1	178506082	178506309	LINE/L2	459	+	114	178506196	65957
chr1	178440239	178640239	harbor2	chr1	178530452	178531061	LINE/L2	1117	+	304	178530756	90517
chr1	225893835	226093835	harbor2	chr1	225903607	225904196	LINE/L2	1090	+	294	225903901	10066
chr1	89454558	89654558	harbor2	chr1	89531977	89532347	LINE/L2	637	+	185	89532162	77604
chr1	162654864	162854864	harbor2	chr1	162673907	162674304	LINE/L2	908	+	198	162674105	19241
chr1	162654864	162854864	harbor2	chr1	162714608	162714850	LINE/L2	434	+	121	162714729	59865
chr1	162654864	162854864	harbor2	chr1	162734000	162734136	LINE/L2	418	+	68	162734068	79204
chr1	162654864	162854864	harbor2	chr1	162740381	162740779	LINE/L2	941	+	199	162740580	85716
chr1	117258018	117458018	harbor2	chr1	117265265	117265470	LINE/L2	406	+	102	117265367	7349
chr1	117258018	117458018	harbor2	chr1	117324076	117324569	LINE/L2	1080	+	246	117324322	66304
chr1	117258018	117458018	harbor2	chr1	117349929	117350195	LINE/L2	683	+	133	117350062	92044
chr1	211504587	211704587	harbor2	chr1	211509527	211509740	LINE/L2	501	+	106	211509633	5046
chr1	211504587	211704587	harbor2	chr1	211510051	211510219	LINE/L2	501	+	84	211510135	5548
chr1	211504587	211704587	harbor2	chr1	211529846	211530289	LINE/L2	576	+	222	211530068	25481
chr1	211504587	211704587	harbor2	chr1	211540171	211540478	LINE/L2	650	+	154	211540325	35738
chr1	211504587	211704587	harbor2	chr1	211541388	211541832	LINE/L2	755	+	222	211541610	37023
chr1	211504587	211704587	harbor2	chr1	211545006	211545359	LINE/L2	1141	+	176	211545182	40595
chr1	211504587	211704587	harbor2	chr1	211545637	211545682	LINE/L2	1141	+	22	211545659	41072
chr1	211504587	211704587	harbor2	chr1	211546496	211547116	LINE/L2	2869	+	310	211546806	42219
chr1	211504587	211704587	harbor2	chr1	211547418	211548345	LINE/L2	2869	+	464	211547882	43295
chr1	211504587	211704587	harbor2	chr1	211559936	211560341	LINE/L2	1381	+	202	211560138	55551
chr1	211504587	211704587	harbor2	chr1	211583932	211584293	LINE/L2	949	+	180	211584112	79525
chr1	233384298	233584298	harbor2	chr1	233392124	233392342	LINE/L2	431	+	109	233392233	7935
chr1	96665744	96865744	harbor2	chr1	96683524	96683650	LINE/L2	437	+	63	96683587	17843
chr1	96665744	96865744	harbor2	chr1	96706328	96706656	LINE/L2	649	+	164	96706492	40748
chr1	96665744	96865744	harbor2	chr1	96713101	96713357	LINE/L2	823	+	128	96713229	47485
chr1	184456653	184656653	harbor2	chr1	184554973	184555199	LINE/L2	439	+	113	184555086	98433
chr1	232793852	232993852	harbor2	chr1	232819706	232820136	LINE/L2	1558	+	215	232819921	26069
chr1	232793852	232993852	harbor2	chr1	232820665	232820953	LINE/L2	1558	+	144	232820809	26957
chr1	232793852	232993852	harbor2	chr1	232821004	232821654	LINE/L2	1558	+	325	232821329	27477
chr1	232793852	232993852	harbor2	chr1	232879617	232879858	LINE/L2	484	+	120	232879737	85885
chr1	232793852	232993852	harbor2	chr1	232880168	232880223	LINE/L2	484	+	28	232880196	86344
chr1	232793852	232993852	harbor2	chr1	232880510	232883318	LINE/L2	2509	+	1404	232881914	88062
chr1	239494288	239694288	harbor2	chr1	239574143	239574737	LINE/L2	708	+	297	239574440	80152
chr1	239494288	239694288	harbor2	chr1	239582677	239583027	LINE/L2	637	+	175	239582852	88564
chr1	99234566	99434566	harbor2	chr1	99242571	99242686	LINE/L2	541	+	58	99242629	8063
chr1	99234566	99434566	harbor2	chr1	99282020	99282387	LINE/L2	490	+	184	99282204	47638
chr1	99234566	99434566	harbor2	chr1	99282394	99282512	LINE/L2	569	+	59	99282453	47887
chr1	99234566	99434566	harbor2	chr1	99282517	99283154	LINE/L2	592	+	318	99282835	48269
chr1	99234566	99434566	harbor2	chr1	99314215	99314668	LINE/L2	798	+	226	99314441	79875
chr1	238228258	238428258	harbor2	chr1	238299293	238299393	LINE/L2	448	+	50	238299343	71085
chr1	238228258	238428258	harbor2	chr1	238316751	238317032	LINE/L2	408	+	140	238316891	88633
chr1	238228258	238428258	harbor2	chr1	238317414	238317667	LINE/L2	456	+	126	238317540	89282
chr1	179563681	179763681	harbor2	chr1	179582489	179582699	LINE/L2	642	+	105	179582594	18913
chr1	179563681	179763681	harbor2	chr1	179615132	179615302	LINE/L2	506	+	85	179615217	51536
chr1	179563681	179763681	harbor2	chr1	179642425	179642768	LINE/L2	637	+	172	179642597	78916
chr1	203442744	203642744	harbor2	chr1	203450914	203451106	LINE/L2	535	+	96	203451010	8266
chr1	203442744	203642744	harbor2	chr1	203451401	203451492	LINE/L2	535	+	46	203451447	8703
chr1	203442744	203642744	harbor2	chr1	203463139	203463336	LINE/L2	620	+	98	203463237	20493
chr1	203442744	203642744	harbor2	chr1	203524902	203525242	LINE/L2	500	+	170	203525072	82328
chr1	212450520	212650520	harbor2	chr1	212496154	212496819	LINE/L2	648	+	332	212496486	45966
chr1	212450520	212650520	harbor2	chr1	212517890	212518015	LINE/L2	584	+	62	212517952	67432
chr1	188506341	188706341	harbor2	chr1	188517057	188517674	LINE/L2	837	+	308	188517365	11024
chr1	188506341	188706341	harbor2	chr1	188534417	188534813	LINE/L2	640	+	198	188534615	28274
chr1	188506341	188706341	harbor2	chr1	188534849	188535766	LINE/L2	2050	+	458	188535307	28966
chr1	188506341	188706341	harbor2	chr1	188562359	188562656	LINE/L2	673	+	148	188562507	56166
chr1	179335867	179535867	harbor2	chr1	179377244	179377373	LINE/L2	417	+	64	179377308	41441
chr1	179335867	179535867	harbor2	chr1	179402271	179402976	LINE/L2	2241	+	352	179402623	66756
chr1	248110700	248310700	harbor2	chr1	248178584	248178828	LINE/L2	431	+	122	248178706	68006
chr1	49622486	49822486	harbor2	chr1	49686571	49686727	LINE/L2	496	+	78	49686649	64163
chr1	49622486	49822486	harbor2	chr1	49717383	49717800	LINE/L2	894	+	208	49717591	95105
chr1	157563162	157763162	harbor2	chr1	157578294	157578437	LINE/L2	663	+	72	157578366	15204
chr1	157563162	157763162	harbor2	chr1	157638335	157638719	LINE/L2	416	+	192	157638527	75365
chr1	105246022	105446022	harbor2	chr1	105290042	105290601	LINE/L2	683	+	280	105290322	44300
chr1	105246022	105446022	harbor2	chr1	105292422	105292848	LINE/L2	764	+	213	105292635	46613
chr1	105246022	105446022	harbor2	chr1	105296270	105296698	LINE/L2	558	+	214	105296484	50462
chr1	105246022	105446022	harbor2	chr1	105313647	105313891	LINE/L2	470	+	122	105313769	67747
chr1	239745667	239945667	harbor2	chr1	239798401	239798525	LINE/L2	478	+	62	239798463	52796
chr1	185598605	185798605	harbor2	chr1	185658100	185659064	LINE/L2	861	+	482	185658582	59977
chr1	185598605	185798605	harbor2	chr1	185671746	185672303	LINE/L2	622	+	278	185672024	73419
chr1	185598605	185798605	harbor2	chr1	185691933	185692191	LINE/L2	418	+	129	185692062	93457
chr1	185598605	185798605	harbor2	chr1	185692226	185692459	LINE/L2	598	+	116	185692342	93737
chr1	185598605	185798605	harbor2	chr1	185696347	185696913	LINE/L2	892	+	283	185696630	98025
chr1	89252704	89452704	harbor2	chr1	89280822	89281542	LINE/L2	753	+	360	89281182	28478
chr1	89252704	89452704	harbor2	chr1	89287401	89287986	LINE/L2	497	+	292	89287693	34989
chr1	195283504	195483504	harbor2	chr1	195302477	195302840	LINE/L2	705	+	182	195302659	19155
chr1	237289486	237489486	harbor2	chr1	237341451	237341670	LINE/L2	528	+	110	237341561	52075
chr1	237289486	237489486	harbor2	chr1	237375913	237376143	LINE/L2	478	+	115	237376028	86542
chr1	233721456	233921456	harbor2	chr1	233759992	233760481	LINE/L2	1257	+	244	233760236	38780
chr1	233721456	233921456	harbor2	chr1	233760865	233761100	LINE/L2	615	+	118	233760983	39527
chr1	173880763	174080763	harbor2	chr1	173915722	173916104	LINE/L2	469	+	191	173915913	35150
chr1	164499090	164699090	harbor2	chr1	164510105	164510860	LINE/L2	1793	+	378	164510483	11393
chr1	164499090	164699090	harbor2	chr1	164532116	164532628	LINE/L2	635	+	256	164532372	33282
chr1	164499090	164699090	harbor2	chr1	164533102	164533757	LINE/L2	667	+	328	164533430	34340
chr1	164499090	164699090	harbor2	chr1	164547357	164547529	LINE/L2	430	+	86	164547443	48353
chr1	164499090	164699090	harbor2	chr1	164548190	164548247	LINE/L2	674	+	28	164548218	49128
chr1	164499090	164699090	harbor2	chr1	164548556	164548913	LINE/L2	674	+	178	164548734	49644
chr1	164499090	164699090	harbor2	chr1	164549220	164549265	LINE/L2	674	+	22	164549242	50152
chr1	164499090	164699090	harbor2	chr1	164549270	164549808	LINE/L2	519	+	269	164549539	50449
chr1	60647439	60847439	harbor2	chr1	60702036	60702718	LINE/L2	688	+	341	60702377	54938
chr1	228655786	228855786	harbor2	chr1	228688037	228688160	LINE/L2	419	+	62	228688099	32313
chr1	228655786	228855786	harbor2	chr1	228722303	228722628	LINE/L2	1053	+	162	228722465	66679
chr1	228655786	228855786	harbor2	chr1	228722921	228723128	LINE/L2	908	+	104	228723025	67239
chr1	228655786	228855786	harbor2	chr1	228723751	228724215	LINE/L2	908	+	232	228723983	68197
chr1	210578299	210778299	harbor2	chr1	210599370	210600262	LINE/L2	852	+	446	210599816	21517
chr1	107255502	107455502	harbor2	chr1	107267871	107269635	LINE/L2	2899	+	882	107268753	13251
chr1	107255502	107455502	harbor2	chr1	107276349	107276748	LINE/L2	456	+	200	107276549	21047
chr1	107255502	107455502	harbor2	chr1	107289446	107289778	LINE/L2	436	+	166	107289612	34110
chr1	107255502	107455502	harbor2	chr1	107321044	107321317	LINE/L2	771	+	136	107321180	65678
chr1	107255502	107455502	harbor2	chr1	107348846	107349360	LINE/L2	641	+	257	107349103	93601
chr1	107255502	107455502	harbor2	chr1	107314995	107315892	LINE/L2	833	+	448	107315443	59941
chr1	223277474	223477474	harbor2	chr1	223297584	223297862	LINE/L2	466	+	139	223297723	20249
chr1	223277474	223477474	harbor2	chr1	223343081	223343407	LINE/L2	425	+	163	223343244	65770
chr1	112300492	112500492	harbor2	chr1	112367940	112368363	LINE/L2	1116	+	212	112368152	67660
chr1	112300492	112500492	harbor2	chr1	112378751	112379043	LINE/L2	526	+	146	112378897	78405
chr1	159319332	159519332	harbor2	chr1	159340671	159341039	LINE/L2	464	+	184	159340855	21523
chr1	180741127	180941127	harbor2	chr1	180777140	180777289	LINE/L2	405	+	74	180777214	36087
chr1	180741127	180941127	harbor2	chr1	180777378	180777561	LINE/L2	443	+	92	180777470	36343
chr1	180741127	180941127	harbor2	chr1	180778831	180779419	LINE/L2	669	+	294	180779125	37998
chr1	180741127	180941127	harbor2	chr1	180812086	180812645	LINE/L2	1978	+	280	180812366	71239
chr1	180741127	180941127	harbor2	chr1	180812949	180813597	LINE/L2	1978	+	324	180813273	72146
chr1	180741127	180941127	harbor2	chr1	180822032	180822616	LINE/L2	707	+	292	180822324	81197
chr1	189833316	190033316	harbor2	chr1	189916138	189916398	LINE/L2	693	+	130	189916268	82952
chr1	189833316	190033316	harbor2	chr1	189921991	189922281	LINE/L2	696	+	145	189922136	88820
chr1	189833316	190033316	harbor2	chr1	189922613	189922948	LINE/L2	553	+	168	189922781	89465
chr1	107967690	108167690	harbor2	chr1	108014169	108014415	LINE/L2	753	+	123	108014292	46602
chr1	107967690	108167690	harbor2	chr1	108014624	108014742	LINE/L2	753	+	59	108014683	46993
chr1	107967690	108167690	harbor2	chr1	108032859	108033537	LINE/L2	616	+	339	108033198	65508
chr1	107967690	108167690	harbor2	chr1	108037273	108037542	LINE/L2	467	+	134	108037407	69717
chr1	74840426	75040426	harbor2	chr1	74868041	74868309	LINE/L2	813	+	134	74868175	27749
chr1	74840426	75040426	harbor2	chr1	74888978	74889480	LINE/L2	483	+	251	74889229	48803
chr1	195565940	195765940	harbor2	chr1	195618363	195618852	LINE/L2	1004	+	244	195618607	52667
chr1	195565940	195765940	harbor2	chr1	195619194	195619545	LINE/L2	577	+	176	195619370	53430
chr1	233891345	234091345	harbor2	chr1	233892821	233892989	LINE/L2	573	+	84	233892905	1560
chr1	233891345	234091345	harbor2	chr1	233893370	233893649	LINE/L2	573	+	140	233893510	2165
chr1	103213189	103413189	harbor2	chr1	103239340	103239438	LINE/L2	579	+	49	103239389	26200
chr1	103213189	103413189	harbor2	chr1	103239751	103240202	LINE/L2	767	+	226	103239977	26788
chr1	103213189	103413189	harbor2	chr1	103262232	103262357	LINE/L2	482	+	62	103262294	49105
chr1	103213189	103413189	harbor2	chr1	103288471	103288819	LINE/L2	534	+	174	103288645	75456
chr1	103213189	103413189	harbor2	chr1	103289163	103289651	LINE/L2	534	+	244	103289407	76218
chr1	103213189	103413189	harbor2	chr1	103301891	103302782	LINE/L2	1195	+	446	103302337	89148
chr1	86535022	86735022	harbor2	chr1	86566219	86566475	LINE/L2	453	+	128	86566347	31325
chr1	86535022	86735022	harbor2	chr1	86587781	86588250	LINE/L2	588	+	234	86588015	52993
chr1	86535022	86735022	harbor2	chr1	86588686	86589120	LINE/L2	531	+	217	86588903	53881
chr1	86535022	86735022	harbor2	chr1	86619572	86619860	LINE/L2	476	+	144	86619716	84694
chr1	86535022	86735022	harbor2	chr1	86619883	86620585	LINE/L2	1356	+	351	86620234	85212
chr1	203341510	203541510	harbor2	chr1	203381530	203381908	LINE/L2	783	+	189	203381719	40209
chr1	203341510	203541510	harbor2	chr1	203434096	203434793	LINE/L2	692	+	348	203434444	92934
chr1	230695390	230895390	harbor2	chr1	230731299	230731583	LINE/L2	424	+	142	230731441	36051
chr1	230695390	230895390	harbor2	chr1	230777424	230778775	LINE/L2	2990	+	676	230778100	82710
chr1	172160997	172360997	harbor2	chr1	172165977	172166225	LINE/L2	532	+	124	172166101	5104
chr1	172160997	172360997	harbor2	chr1	172221590	172221965	LINE/L2	748	+	188	172221778	60781
chr1	172160997	172360997	harbor2	chr1	172230675	172231123	LINE/L2	661	+	224	172230899	69902
chr1	213588315	213788315	harbor2	chr1	213672235	213672922	LINE/L2	703	+	344	213672579	84264
chr1	239280898	239480898	harbor2	chr1	239287303	239287757	LINE/L2	517	+	227	239287530	6632
chr1	239280898	239480898	harbor2	chr1	239293780	239294852	LINE/L2	1695	+	536	239294316	13418
chr1	239280898	239480898	harbor2	chr1	239295076	239295421	LINE/L2	1377	+	172	239295248	14350
chr1	239280898	239480898	harbor2	chr1	239319008	239319580	LINE/L2	1176	+	286	239319294	38396
chr1	93624306	93824306	harbor2	chr1	93628172	93628888	LINE/L2	771	+	358	93628530	4224
chr1	93624306	93824306	harbor2	chr1	93654631	93655052	LINE/L2	816	+	210	93654841	30535
chr1	93624306	93824306	harbor2	chr1	93665455	93666203	LINE/L2	794	+	374	93665829	41523
chr1	93624306	93824306	harbor2	chr1	93672878	93673258	LINE/L2	469	+	190	93673068	48762
chr1	93624306	93824306	harbor2	chr1	93696287	93696705	LINE/L2	729	+	209	93696496	72190
chr1	241742348	241942348	harbor2	chr1	241788967	241789115	LINE/L2	441	+	74	241789041	46693
chr1	241742348	241942348	harbor2	chr1	241799951	241800074	LINE/L2	499	+	62	241800013	57665
chr1	241742348	241942348	harbor2	chr1	241810605	241810940	LINE/L2	837	+	168	241810773	68425
chr1	111666864	111866864	harbor2	chr1	111674412	111674986	LINE/L2	843	+	287	111674699	7835
chr1	111666864	111866864	harbor2	chr1	111699164	111699463	LINE/L2	792	+	150	111699314	32450
chr1	111666864	111866864	harbor2	chr1	111699769	111699913	LINE/L2	792	+	72	111699841	32977
chr1	111666864	111866864	harbor2	chr1	111699914	111700213	LINE/L2	3233	+	150	111700064	33200
chr1	111666864	111866864	harbor2	chr1	111700601	111701603	LINE/L2	3233	+	501	111701102	34238
chr1	111666864	111866864	harbor2	chr1	111734412	111734887	LINE/L2	404	+	238	111734650	67786
chr1	111666864	111866864	harbor2	chr1	111758443	111758928	LINE/L2	1130	+	242	111758685	91821
chr1	190209876	190409876	harbor2	chr1	190235415	190235977	LINE/L2	991	+	281	190235696	25820
chr1	107412770	107612770	harbor2	chr1	107494478	107495347	LINE/L2	1016	+	434	107494912	82142
chr1	220423985	220623985	harbor2	chr1	220459334	220459525	LINE/L2	608	+	96	220459430	35445
chr1	220423985	220623985	harbor2	chr1	220488573	220489024	LINE/L2	877	+	226	220488799	64814
chr1	220423985	220623985	harbor2	chr1	220497407	220497832	LINE/L2	472	+	212	220497619	73634
chr1	220423985	220623985	harbor2	chr1	220522226	220522346	LINE/L2	439	+	60	220522286	98301
chr1	187655702	187855702	harbor2	chr1	187675197	187675407	LINE/L2	471	+	105	187675302	19600
chr1	187655702	187855702	harbor2	chr1	187731228	187731588	LINE/L2	915	+	180	187731408	75706
chr1	232760383	232960383	harbor2	chr1	232774002	232774127	LINE/L2	601	+	62	232774064	13681
chr1	232760383	232960383	harbor2	chr1	232819706	232820136	LINE/L2	1558	+	215	232819921	59538
chr1	232760383	232960383	harbor2	chr1	232820665	232820953	LINE/L2	1558	+	144	232820809	60426
chr1	232760383	232960383	harbor2	chr1	232821004	232821654	LINE/L2	1558	+	325	232821329	60946
chr1	223133189	223333189	harbor2	chr1	223145022	223145561	LINE/L2	685	+	270	223145292	12103
chr1	223133189	223333189	harbor2	chr1	223153591	223154213	LINE/L2	651	+	311	223153902	20713
chr1	170865001	171065001	harbor2	chr1	170883926	170884519	LINE/L2	1042	+	296	170884222	19221
chr1	170865001	171065001	harbor2	chr1	170894498	170894611	LINE/L2	441	+	56	170894554	29553
chr1	170865001	171065001	harbor2	chr1	170919311	170919780	LINE/L2	1038	+	234	170919545	54544
chr1	170865001	171065001	harbor2	chr1	170920137	170920334	LINE/L2	1038	+	98	170920235	55234
chr1	242712003	242912003	harbor2	chr1	242714889	242715211	LINE/L2	978	+	161	242715050	3047
chr1	242712003	242912003	harbor2	chr1	242715517	242715658	LINE/L2	978	+	70	242715587	3584
chr1	242712003	242912003	harbor2	chr1	242716886	242716999	LINE/L2	632	+	56	242716942	4939
chr1	242712003	242912003	harbor2	chr1	242717310	242717482	LINE/L2	632	+	86	242717396	5393
chr1	242712003	242912003	harbor2	chr1	242741263	242742126	LINE/L2	1767	+	432	242741695	29692
chr1	242712003	242912003	harbor2	chr1	242742427	242742564	LINE/L2	1094	+	68	242742495	30492
chr1	242712003	242912003	harbor2	chr1	242747520	242748316	LINE/L2	856	+	398	242747918	35915
chr1	242712003	242912003	harbor2	chr1	242770356	242770691	LINE/L2	613	+	168	242770524	58521
chr1	242712003	242912003	harbor2	chr1	242786149	242786323	LINE/L2	530	+	87	242786236	74233
chr1	242712003	242912003	harbor2	chr1	242786616	242786692	LINE/L2	530	+	38	242786654	74651
chr1	242712003	242912003	harbor2	chr1	242787016	242787966	LINE/L2	1396	+	475	242787491	75488
chr1	242712003	242912003	harbor2	chr1	242790826	242790960	LINE/L2	434	+	67	242790893	78890
chr1	186265567	186465567	harbor2	chr1	186315419	186315964	LINE/L2	1300	+	272	186315691	50124
chr1	43831152	44031152	harbor2	chr1	43834200	43834647	LINE/L2	1140	+	224	43834424	3272
chr1	43831152	44031152	harbor2	chr1	43854215	43855046	LINE/L2	952	+	416	43854631	23479
chr2	221107524	221307524	harbor2	chr2	221132558	221132877	LINE/L2	436	+	160	221132718	25194
chr2	241306636	241506636	harbor2	chr2	241308889	241309342	LINE/L2	480	+	226	241309115	2479
chr2	177555837	177755837	harbor2	chr2	177640767	177641229	LINE/L2	770	+	231	177640998	85161
chr2	210034896	210234896	harbor2	chr2	210052484	210052793	LINE/L2	758	+	154	210052638	17742
chr2	210034896	210234896	harbor2	chr2	210081259	210081689	LINE/L2	484	+	215	210081474	46578
chr2	196527741	196727741	harbor2	chr2	196531701	196532019	LINE/L2	501	+	159	196531860	4119
chr2	196527741	196727741	harbor2	chr2	196587837	196588313	LINE/L2	1022	+	238	196588075	60334
chr2	196527741	196727741	harbor2	chr2	196617085	196617972	LINE/L2	604	+	444	196617529	89788
chr2	171865461	172065461	harbor2	chr2	171869964	171870152	LINE/L2	773	+	94	171870058	4597
chr2	131623531	131823531	harbor2	chr2	131714658	131714839	LINE/L2	454	+	90	131714748	91217
chr2	225496683	225696683	harbor2	chr2	225531163	225531576	LINE/L2	516	+	206	225531369	34686
chr2	225496683	225696683	harbor2	chr2	225555916	225556108	LINE/L2	438	+	96	225556012	59329
chr2	217805971	218005971	harbor2	chr2	217842023	217842237	LINE/L2	456	+	107	217842130	36159
chr2	217805971	218005971	harbor2	chr2	217842555	217842847	LINE/L2	783	+	146	217842701	36730
chr2	217805971	218005971	harbor2	chr2	217843106	217844464	LINE/L2	935	+	679	217843785	37814
chr2	217805971	218005971	harbor2	chr2	217847116	217847314	LINE/L2	457	+	99	217847215	41244
chr2	217805971	218005971	harbor2	chr2	217867619	217868121	LINE/L2	1501	+	251	217867870	61899
chr2	217805971	218005971	harbor2	chr2	217889467	217889798	LINE/L2	511	+	166	217889633	83662
chr2	217805971	218005971	harbor2	chr2	217890157	217890446	LINE/L2	623	+	144	217890301	84330
chr2	217805971	218005971	harbor2	chr2	217891597	217892097	LINE/L2	556	+	250	217891847	85876
chr2	217805971	218005971	harbor2	chr2	217892402	217892423	LINE/L2	556	+	10	217892412	86441
chr2	56279915	56479915	harbor2	chr2	56328402	56329447	LINE/L2	891	+	522	56328924	49009
chr2	56279915	56479915	harbor2	chr2	56333964	56334319	LINE/L2	727	+	178	56334142	54227
chr2	218241789	218441789	harbor2	chr2	218298941	218299103	LINE/L2	1225	+	81	218299022	57233
chr2	218241789	218441789	harbor2	chr2	218328282	218328578	LINE/L2	941	+	148	218328430	86641
chr2	218241789	218441789	harbor2	chr2	218300057	218300423	LINE/L2	1225	+	183	218300240	58451
chr2	155997332	156197332	harbor2	chr2	156020008	156020280	LINE/L2	454	+	136	156020144	22812
chr2	155997332	156197332	harbor2	chr2	156088615	156088858	LINE/L2	579	+	122	156088737	91405
chr2	155997332	156197332	harbor2	chr2	156091380	156092442	LINE/L2	4218	+	531	156091911	94579
chr2	155997332	156197332	harbor2	chr2	156092925	156094142	LINE/L2	4218	+	608	156093533	96201
chr2	155997332	156197332	harbor2	chr2	156095709	156095811	LINE/L2	558	+	51	156095760	98428
chr2	122889025	123089025	harbor2	chr2	122894739	122895215	LINE/L2	1253	+	238	122894977	5952
chr2	122889025	123089025	harbor2	chr2	122900699	122900819	LINE/L2	417	+	60	122900759	11734
chr2	122889025	123089025	harbor2	chr2	122966572	122966789	LINE/L2	495	+	108	122966680	77655
chr2	122889025	123089025	harbor2	chr2	122971766	122972230	LINE/L2	479	+	232	122971998	82973
chr2	164507673	164707673	harbor2	chr2	164539953	164540329	LINE/L2	1248	+	188	164540141	32468
chr2	164507673	164707673	harbor2	chr2	164540632	164540866	LINE/L2	1248	+	117	164540749	33076
chr2	164507673	164707673	harbor2	chr2	164556499	164556895	LINE/L2	511	+	198	164556697	49024
chr2	164507673	164707673	harbor2	chr2	164581980	164582402	LINE/L2	998	+	211	164582191	74518
chr2	164507673	164707673	harbor2	chr2	164582787	164583202	LINE/L2	964	+	208	164582995	75322
chr2	237819401	238019401	harbor2	chr2	237825534	237825737	LINE/L2	484	+	102	237825636	6235
chr2	222658626	222858626	harbor2	chr2	222661468	222661760	LINE/L2	525	+	146	222661614	2988
chr2	222658626	222858626	harbor2	chr2	222736971	222737179	LINE/L2	513	+	104	222737075	78449
chr2	223424772	223624772	harbor2	chr2	223430720	223430843	LINE/L2	450	+	62	223430782	6010
chr2	223424772	223624772	harbor2	chr2	223443439	223443667	LINE/L2	533	+	114	223443553	18781
chr2	223424772	223624772	harbor2	chr2	223444009	223444786	LINE/L2	1470	+	388	223444397	19625
chr2	220630416	220830416	harbor2	chr2	220666323	220666493	LINE/L2	702	+	85	220666408	35992
chr2	220630416	220830416	harbor2	chr2	220666787	220666981	LINE/L2	702	+	97	220666884	36468
chr2	220630416	220830416	harbor2	chr2	220668595	220669423	LINE/L2	454	+	414	220669009	38593
chr2	220630416	220830416	harbor2	chr2	220689763	220689877	LINE/L2	490	+	57	220689820	59404
chr2	220630416	220830416	harbor2	chr2	220690216	220690452	LINE/L2	490	+	118	220690334	59918
chr2	147463212	147663212	harbor2	chr2	147474905	147475674	LINE/L2	580	+	384	147475289	12077
chr2	147463212	147663212	harbor2	chr2	147476028	147476244	LINE/L2	580	+	108	147476136	12924
chr2	147463212	147663212	harbor2	chr2	147502754	147503083	LINE/L2	478	+	164	147502918	39706
chr2	147463212	147663212	harbor2	chr2	147525362	147525736	LINE/L2	491	+	187	147525549	62337
chr2	217892866	218092866	harbor2	chr2	217924035	217924550	LINE/L2	802	+	258	217924293	31427
chr2	217892866	218092866	harbor2	chr2	217929665	217930122	LINE/L2	462	+	228	217929893	37027
chr2	217892866	218092866	harbor2	chr2	217975598	217976277	LINE/L2	664	+	340	217975938	83072
chr2	217892866	218092866	harbor2	chr2	217980813	217981132	LINE/L2	495	+	160	217980973	88107
chr2	136938450	137138450	harbor2	chr2	136963985	136964223	LINE/L2	508	+	119	136964104	25654
chr2	136938450	137138450	harbor2	chr2	136964466	136964721	LINE/L2	648	+	128	136964594	26144
chr2	136938450	137138450	harbor2	chr2	136965030	136965234	LINE/L2	648	+	102	136965132	26682
chr2	136938450	137138450	harbor2	chr2	137014746	137015183	LINE/L2	578	+	218	137014964	76514
chr2	136938450	137138450	harbor2	chr2	137024710	137025432	LINE/L2	687	+	361	137025071	86621
chr2	136938450	137138450	harbor2	chr2	137027660	137027798	LINE/L2	552	+	69	137027729	89279
chr2	223319760	223519760	harbor2	chr2	223361698	223361822	LINE/L2	445	+	62	223361760	42000
chr2	227707502	227907502	harbor2	chr2	227800738	227800972	LINE/L2	572	+	117	227800855	93353
chr2	219500497	219700497	harbor2	chr2	219558838	219559018	LINE/L2	893	+	90	219558928	58431
chr2	180184112	180384112	harbor2	chr2	180194991	180195385	LINE/L2	487	+	197	180195188	11076
chr2	180184112	180384112	harbor2	chr2	180264179	180264659	LINE/L2	708	+	240	180264419	80307
chr2	180184112	180384112	harbor2	chr2	180266283	180266409	LINE/L2	444	+	63	180266346	82234
chr2	180184112	180384112	harbor2	chr2	180266790	180267258	LINE/L2	937	+	234	180267024	82912
chr2	180184112	180384112	harbor2	chr2	180267258	180267469	LINE/L2	456	+	106	180267364	83252
chr2	235560770	235760770	harbor2	chr2	235602418	235602701	LINE/L2	642	+	142	235602560	41790
chr2	235560770	235760770	harbor2	chr2	235603002	235603020	LINE/L2	642	+	9	235603011	42241
chr2	235560770	235760770	harbor2	chr2	235603381	235603519	LINE/L2	642	+	69	235603450	42680
chr2	235560770	235760770	harbor2	chr2	235620176	235620785	LINE/L2	462	+	304	235620480	59710
chr2	235560770	235760770	harbor2	chr2	235601872	235602072	LINE/L2	440	+	100	235601972	41202
chr2	52119616	52319616	harbor2	chr2	52119077	52119656	LINE/L2	826	+	290	52119367	249
chr2	202646408	202846408	harbor2	chr2	202697194	202697381	LINE/L2	436	+	94	202697288	50880
chr2	145992020	146192020	harbor2	chr2	146007177	146007598	LINE/L2	493	+	210	146007387	15367
chr2	145992020	146192020	harbor2	chr2	146082076	146082511	LINE/L2	686	+	218	146082294	90274
chr2	237488705	237688705	harbor2	chr2	237500528	237501060	LINE/L2	653	+	266	237500794	12089
chr2	159410390	159610390	harbor2	chr2	159502973	159503566	LINE/L2	529	+	296	159503269	92879
chr2	233823818	234023818	harbor2	chr2	233911078	233911774	LINE/L2	801	+	348	233911426	87608
chr2	186901366	187101366	harbor2	chr2	186913731	186914219	LINE/L2	832	+	244	186913975	12609
chr2	186901366	187101366	harbor2	chr2	186938971	186939128	LINE/L2	436	+	78	186939049	37683
chr2	217657933	217857933	harbor2	chr2	217690218	217690743	LINE/L2	729	+	262	217690480	32547
chr2	217657933	217857933	harbor2	chr2	217735308	217735961	LINE/L2	1140	+	326	217735634	77701
chr2	217657933	217857933	harbor2	chr2	217746265	217746908	LINE/L2	470	+	322	217746587	88654
chr2	210481910	210681910	harbor2	chr2	210496666	210496940	LINE/L2	614	+	137	210496803	14893
chr2	210481910	210681910	harbor2	chr2	210541928	210542881	LINE/L2	925	+	476	210542404	60494
chr2	210481910	210681910	harbor2	chr2	210543197	210543531	LINE/L2	508	+	167	210543364	61454
chr2	137853701	138053701	harbor2	chr2	137857942	137858142	LINE/L2	552	+	100	137858042	4341
chr2	236432858	236632858	harbor2	chr2	236505393	236505658	LINE/L2	474	+	132	236505525	72667
chr2	236432858	236632858	harbor2	chr2	236505662	236506276	LINE/L2	1130	+	307	236505969	73111
chr2	149786890	149986890	harbor2	chr2	149828553	149828748	LINE/L2	789	+	98	149828651	41761
chr2	149786890	149986890	harbor2	chr2	149829431	149829683	LINE/L2	789	+	126	149829557	42667
chr2	149786890	149986890	harbor2	chr2	149842077	149842614	LINE/L2	819	+	268	149842345	55455
chr2	57815971	58015971	harbor2	chr2	57882685	57882801	LINE/L2	502	+	58	57882743	66772
chr2	138171787	138371787	harbor2	chr2	138228202	138228671	LINE/L2	496	+	234	138228436	56649
chr2	141996710	142196710	harbor2	chr2	142019354	142020110	LINE/L2	1064	+	378	142019732	23022
chr2	214472167	214672167	harbor2	chr2	214517044	214517254	LINE/L2	695	+	105	214517149	44982
chr2	214472167	214672167	harbor2	chr2	214552167	214553186	LINE/L2	546	+	510	214552677	80510
chr2	214472167	214672167	harbor2	chr2	214553930	214554260	LINE/L2	446	+	165	214554095	81928
chr2	214472167	214672167	harbor2	chr2	214555451	214555556	LINE/L2	446	+	52	214555503	83336
chr2	214472167	214672167	harbor2	chr2	214557487	214558763	LINE/L2	448	+	638	214558125	85958
chr2	189661820	189861820	harbor2	chr2	189673196	189673667	LINE/L2	1129	+	236	189673432	11612
chr2	189661820	189861820	harbor2	chr2	189673841	189674276	LINE/L2	635	+	218	189674059	12239
chr2	189661820	189861820	harbor2	chr2	189696515	189696709	LINE/L2	431	+	97	189696612	34792
chr2	189661820	189861820	harbor2	chr2	189698953	189699137	LINE/L2	509	+	92	189699045	37225
chr2	189661820	189861820	harbor2	chr2	189724454	189724604	LINE/L2	426	+	75	189724529	62709
chr2	147424710	147624710	harbor2	chr2	147429567	147429787	LINE/L2	481	+	110	147429677	4967
chr2	147424710	147624710	harbor2	chr2	147474905	147475674	LINE/L2	580	+	384	147475289	50579
chr2	147424710	147624710	harbor2	chr2	147476028	147476244	LINE/L2	580	+	108	147476136	51426
chr2	147424710	147624710	harbor2	chr2	147502754	147503083	LINE/L2	478	+	164	147502918	78208
chr2	148810158	149010158	harbor2	chr2	148835708	148836272	LINE/L2	489	+	282	148835990	25832
chr2	148810158	149010158	harbor2	chr2	148854303	148854434	LINE/L2	595	+	66	148854369	44211
chr2	148810158	149010158	harbor2	chr2	148859667	148859922	LINE/L2	810	+	128	148859795	49637
chr2	148810158	149010158	harbor2	chr2	148909152	148909565	LINE/L2	491	+	206	148909358	99200
chr2	219568824	219768824	harbor2	chr2	219659525	219659916	LINE/L2	1266	+	196	219659721	90897
chr2	219568824	219768824	harbor2	chr2	219660756	219661123	LINE/L2	1121	+	184	219660940	92116
chr2	84614207	84814207	harbor2	chr2	84681692	84683310	LINE/L2	1599	+	809	84682501	68294
chr2	160728722	160928722	harbor2	chr2	160741362	160741773	LINE/L2	536	+	206	160741568	12846
chr2	160728722	160928722	harbor2	chr2	160746049	160747286	LINE/L2	1464	+	618	160746667	17945
chr2	210737037	210937037	harbor2	chr2	210752602	210753216	LINE/L2	535	+	307	210752909	15872
chr2	210737037	210937037	harbor2	chr2	210777515	210777727	LINE/L2	512	+	106	210777621	40584
chr2	226580562	226780562	harbor2	chr2	226595862	226596405	LINE/L2	751	+	272	226596134	15572
chr2	226580562	226780562	harbor2	chr2	226621459	226622111	LINE/L2	870	+	326	226621785	41223
chr2	226580562	226780562	harbor2	chr2	226634005	226634275	LINE/L2	637	+	135	226634140	53578
chr2	226580562	226780562	harbor2	chr2	226644433	226644815	LINE/L2	448	+	191	226644624	64062
chr2	239957143	240157143	harbor2	chr2	240012261	240012484	LINE/L2	502	+	112	240012373	55230
chr2	239957143	240157143	harbor2	chr2	240022448	240022589	LINE/L2	455	+	70	240022518	65375
chr2	239957143	240157143	harbor2	chr2	240040598	240040800	LINE/L2	690	+	101	240040699	83556
chr2	223784150	223984150	harbor2	chr2	223809065	223809362	LINE/L2	443	+	148	223809213	25063
chr2	223784150	223984150	harbor2	chr2	223809666	223809724	LINE/L2	442	+	29	223809695	25545
chr2	223784150	223984150	harbor2	chr2	223846745	223847100	LINE/L2	685	+	178	223846923	62773
chr2	165142667	165342667	harbor2	chr2	165144420	165144895	LINE/L2	1291	+	238	165144658	1991
chr2	165142667	165342667	harbor2	chr2	165191246	165191895	LINE/L2	848	+	324	165191570	48903
chr2	185544649	185744649	harbor2	chr2	185553022	185553417	LINE/L2	483	+	198	185553220	8571
chr2	185544649	185744649	harbor2	chr2	185619765	185620241	LINE/L2	926	+	238	185620003	75354
chr2	185544649	185744649	harbor2	chr2	185620735	185621129	LINE/L2	926	+	197	185620932	76283
chr2	242054892	242254892	harbor2	chr2	242092986	242093373	LINE/L2	529	+	194	242093180	38288
chr2	232235480	232435480	harbor2	chr2	232255814	232256163	LINE/L2	765	+	174	232255988	20508
chr2	232235480	232435480	harbor2	chr2	232294918	232296264	LINE/L2	761	+	673	232295591	60111
chr2	232235480	232435480	harbor2	chr2	232298963	232299834	LINE/L2	718	+	436	232299399	63919
chr2	232235480	232435480	harbor2	chr2	232306917	232307264	LINE/L2	459	+	174	232307091	71611
chr2	105815027	106015027	harbor2	chr2	105905055	105905324	LINE/L2	623	+	134	105905189	90162
chr2	105815027	106015027	harbor2	chr2	105914344	105914708	LINE/L2	566	+	182	105914526	99499
chr2	44174058	44374058	harbor2	chr2	44184235	44184685	LINE/L2	1237	+	225	44184460	10402
chr2	51098790	51298790	harbor2	chr2	51110755	51111183	LINE/L2	458	+	214	51110969	12179
chr2	51098790	51298790	harbor2	chr2	51115445	51115701	LINE/L2	541	+	128	51115573	16783
chr2	51098790	51298790	harbor2	chr2	51116022	51116325	LINE/L2	571	+	152	51116174	17384
chr2	51098790	51298790	harbor2	chr2	51119276	51119661	LINE/L2	469	+	192	51119468	20678
chr2	51098790	51298790	harbor2	chr2	51140036	51140262	LINE/L2	712	+	113	51140149	41359
chr2	51098790	51298790	harbor2	chr2	51140578	51141163	LINE/L2	1013	+	292	51140870	42080
chr2	157785407	157985407	harbor2	chr2	157802460	157802923	LINE/L2	433	+	232	157802692	17285
chr2	157785407	157985407	harbor2	chr2	157813991	157814133	LINE/L2	419	+	71	157814062	28655
chr2	157785407	157985407	harbor2	chr2	157853699	157854168	LINE/L2	559	+	234	157853933	68526
chr2	228036581	228236581	harbor2	chr2	228100974	228101324	LINE/L2	532	+	175	228101149	64568
chr2	146007713	146207713	harbor2	chr2	146082076	146082511	LINE/L2	686	+	218	146082294	74581
chr2	222285873	222485873	harbor2	chr2	222365121	222365237	LINE/L2	429	+	58	222365179	79306
chr2	222830527	223030527	harbor2	chr2	222895125	222895338	LINE/L2	546	+	106	222895231	64704
chr2	222830527	223030527	harbor2	chr2	222907797	222908147	LINE/L2	893	+	175	222907972	77445
chr2	222830527	223030527	harbor2	chr2	222920549	222921146	LINE/L2	1145	+	298	222920847	90320
chr2	152681588	152881588	harbor2	chr2	152733762	152733956	LINE/L2	526	+	97	152733859	52271
chr2	157980377	158180377	harbor2	chr2	158063122	158063397	LINE/L2	790	+	138	158063260	82883
chr2	104548284	104748284	harbor2	chr2	104620817	104621754	LINE/L2	958	+	468	104621285	73001
chr2	59195522	59395522	harbor2	chr2	59245379	59245598	LINE/L2	553	+	110	59245489	49967
chr2	59195522	59395522	harbor2	chr2	59246028	59246478	LINE/L2	748	+	225	59246253	50731
chr2	59195522	59395522	harbor2	chr2	59274564	59274675	LINE/L2	425	+	56	59274620	79098
chr2	175156201	175356201	harbor2	chr2	175193136	175193443	LINE/L2	1002	+	154	175193290	37089
chr2	175156201	175356201	harbor2	chr2	175193745	175193829	LINE/L2	1002	+	42	175193787	37586
chr2	175156201	175356201	harbor2	chr2	175243386	175243957	LINE/L2	693	+	286	175243672	87471
chr2	203944036	204144036	harbor2	chr2	204005380	204005979	LINE/L2	539	+	300	204005680	61644
chr2	51298428	51498428	harbor2	chr2	51338340	51338820	LINE/L2	470	+	240	51338580	40152
chr2	230087964	230287964	harbor2	chr2	230125873	230125997	LINE/L2	422	+	62	230125935	37971
chr2	230087964	230287964	harbor2	chr2	230186343	230186458	LINE/L2	434	+	58	230186401	98437
chr2	161814416	162014416	harbor2	chr2	161898668	161899610	LINE/L2	3492	+	471	161899139	84723
chr2	190193282	190393282	harbor2	chr2	190208980	190211040	LINE/L2	1304	+	1030	190210010	16728
chr2	190193282	190393282	harbor2	chr2	190211553	190211878	LINE/L2	487	+	162	190211715	18433
chr2	190193282	190393282	harbor2	chr2	190253608	190253879	LINE/L2	560	+	136	190253744	60462
chr2	190193282	190393282	harbor2	chr2	190253866	190254121	LINE/L2	1308	+	128	190253994	60712
chr2	190193282	190393282	harbor2	chr2	190254503	190254813	LINE/L2	1308	+	155	190254658	61376
chr2	190193282	190393282	harbor2	chr2	190255023	190255443	LINE/L2	1308	+	210	190255233	61951
chr2	190193282	190393282	harbor2	chr2	190263886	190264274	LINE/L2	1017	+	194	190264080	70798
chr2	190193282	190393282	harbor2	chr2	190271051	190271282	LINE/L2	704	+	116	190271167	77885
chr2	190193282	190393282	harbor2	chr2	190271590	190271948	LINE/L2	704	+	179	190271769	78487
chr2	190193282	190393282	harbor2	chr2	190271954	190272302	LINE/L2	487	+	174	190272128	78846
chr2	202602746	202802746	harbor2	chr2	202627987	202628189	LINE/L2	445	+	101	202628088	25342
chr2	202602746	202802746	harbor2	chr2	202628513	202628822	LINE/L2	445	+	154	202628667	25921
chr2	202602746	202802746	harbor2	chr2	202697194	202697381	LINE/L2	436	+	94	202697288	94542
chr2	137187473	137387473	harbor2	chr2	137248261	137248428	LINE/L2	451	+	84	137248345	60872
chr2	137187473	137387473	harbor2	chr2	137258371	137258617	LINE/L2	440	+	123	137258494	71021
chr2	137187473	137387473	harbor2	chr2	137259677	137259846	LINE/L2	435	+	84	137259761	72288
chr2	237983261	238183261	harbor2	chr2	238010566	238011579	LINE/L2	894	+	506	238011072	27811
chr2	206576457	206776457	harbor2	chr2	206638366	206639759	LINE/L2	1767	+	696	206639062	62605
chr2	206576457	206776457	harbor2	chr2	206639761	206640014	LINE/L2	499	+	126	206639887	63430
chr2	206576457	206776457	harbor2	chr2	206640319	206640366	LINE/L2	499	+	24	206640343	63886
chr2	206576457	206776457	harbor2	chr2	206640606	206640706	LINE/L2	430	+	50	206640656	64199
chr2	206576457	206776457	harbor2	chr2	206653705	206653876	LINE/L2	504	+	86	206653791	77334
chr2	206576457	206776457	harbor2	chr2	206667072	206667528	LINE/L2	929	+	228	206667300	90843
chr2	88717162	88917162	harbor2	chr2	88761549	88761805	LINE/L2	474	+	128	88761677	44515
chr2	235327843	235527843	harbor2	chr2	235367730	235368212	LINE/L2	948	+	241	235367971	40128
chr2	235327843	235527843	harbor2	chr2	235373998	235374278	LINE/L2	454	+	140	235374138	46295
chr2	168187282	168387282	harbor2	chr2	168251855	168251972	LINE/L2	624	+	58	168251913	64631
chr2	180370491	180570491	harbor2	chr2	180440316	180441063	LINE/L2	1205	+	374	180440690	70199
chr2	180370491	180570491	harbor2	chr2	180461761	180462507	LINE/L2	812	+	373	180462134	91643
chr2	75235873	75435873	harbor2	chr2	75256052	75256221	LINE/L2	608	+	84	75256136	20263
chr2	75235873	75435873	harbor2	chr2	75275228	75276131	LINE/L2	1427	+	452	75275680	39807
chr2	157121547	157321547	harbor2	chr2	157185957	157186268	LINE/L2	725	+	156	157186113	64566
chr2	227430707	227630707	harbor2	chr2	227463867	227464124	LINE/L2	911	+	128	227463995	33288
chr2	227430707	227630707	harbor2	chr2	227514798	227514922	LINE/L2	1069	+	62	227514860	84153
chr2	227430707	227630707	harbor2	chr2	227515221	227515851	LINE/L2	1069	+	315	227515536	84829
chr2	214070347	214270347	harbor2	chr2	214106786	214106914	LINE/L2	478	+	64	214106850	36503
chr2	214070347	214270347	harbor2	chr2	214106974	214107353	LINE/L2	655	+	190	214107164	36817
chr2	214070347	214270347	harbor2	chr2	214134219	214134581	LINE/L2	743	+	181	214134400	64053
chr2	168000046	168200046	harbor2	chr2	168054872	168055077	LINE/L2	428	+	102	168054974	54928
chr2	168000046	168200046	harbor2	chr2	168057608	168059181	LINE/L2	3071	+	786	168058394	58348
chr2	168000046	168200046	harbor2	chr2	168059774	168060019	LINE/L2	905	+	122	168059896	59850
chr2	168000046	168200046	harbor2	chr2	168072351	168072671	LINE/L2	903	+	160	168072511	72465
chr2	189621028	189821028	harbor2	chr2	189629239	189629572	LINE/L2	419	+	166	189629405	8377
chr2	189621028	189821028	harbor2	chr2	189632670	189633191	LINE/L2	851	+	260	189632930	11902
chr2	189621028	189821028	harbor2	chr2	189673196	189673667	LINE/L2	1129	+	236	189673432	52404
chr2	189621028	189821028	harbor2	chr2	189673841	189674276	LINE/L2	635	+	218	189674059	53031
chr2	189621028	189821028	harbor2	chr2	189696515	189696709	LINE/L2	431	+	97	189696612	75584
chr2	189621028	189821028	harbor2	chr2	189698953	189699137	LINE/L2	509	+	92	189699045	78017
chr2	126761804	126961804	harbor2	chr2	126840338	126840723	LINE/L2	811	+	192	126840530	78726
chr2	231714500	231914500	harbor2	chr2	231789932	231790080	LINE/L2	419	+	74	231790006	75506
chr2	215062130	215262130	harbor2	chr2	215062446	215063030	LINE/L2	892	+	292	215062738	608
chr2	195308671	195508671	harbor2	chr2	195406118	195406323	LINE/L2	674	+	102	195406220	97549
chr2	134986039	135186039	harbor2	chr2	134998546	134998699	LINE/L2	647	+	76	134998622	12583
chr2	30538778	30738778	harbor2	chr2	30575044	30575381	LINE/L2	496	+	168	30575212	36434
chr2	30538778	30738778	harbor2	chr2	30591751	30592105	LINE/L2	434	+	177	30591928	53150
chr2	232958026	233158026	harbor2	chr2	233047410	233047531	LINE/L2	470	+	60	233047470	89444
chr2	80662229	80862229	harbor2	chr2	80743012	80743464	LINE/L2	484	+	226	80743238	81009
chr2	80662229	80862229	harbor2	chr2	80743541	80743609	LINE/L2	484	+	34	80743575	81346
chr2	206379093	206579093	harbor2	chr2	206459818	206460104	LINE/L2	624	+	143	206459961	80868
chr2	206379093	206579093	harbor2	chr2	206469179	206470126	LINE/L2	2176	+	474	206469653	90560
chr2	180930014	181130014	harbor2	chr2	180939332	180940222	LINE/L2	1480	+	445	180939777	9763
chr2	180930014	181130014	harbor2	chr2	180960251	180960602	LINE/L2	422	+	176	180960427	30413
chr2	180930014	181130014	harbor2	chr2	180963059	180963515	LINE/L2	595	+	228	180963287	33273
chr2	124783512	124983512	harbor2	chr2	124866743	124868692	LINE/L2	2595	+	974	124867717	84205
chr2	142012740	142212740	harbor2	chr2	142019354	142020110	LINE/L2	1064	+	378	142019732	6992
chr2	47234697	47434697	harbor2	chr2	47246257	47246594	LINE/L2	662	+	168	47246425	11728
chr2	47234697	47434697	harbor2	chr2	47273426	47273741	LINE/L2	1650	+	158	47273584	38887
chr2	47234697	47434697	harbor2	chr2	47273873	47274149	LINE/L2	1650	+	138	47274011	39314
chr2	47234697	47434697	harbor2	chr2	47313228	47313558	LINE/L2	1254	+	165	47313393	78696
chr2	154370036	154570036	harbor2	chr2	154390846	154391013	LINE/L2	547	+	84	154390930	20894
chr2	154370036	154570036	harbor2	chr2	154406102	154406886	LINE/L2	890	+	392	154406494	36458
chr2	154370036	154570036	harbor2	chr2	154452911	154453337	LINE/L2	1140	+	213	154453124	83088
chr2	154370036	154570036	harbor2	chr2	154458477	154458966	LINE/L2	1222	+	244	154458721	88685
chr2	178129470	178329470	harbor2	chr2	178188464	178189264	LINE/L2	1352	+	400	178188864	59394
chr2	178129470	178329470	harbor2	chr2	178213117	178214169	LINE/L2	596	+	526	178213643	84173
chr2	223873712	224073712	harbor2	chr2	223909347	223910008	LINE/L2	797	+	330	223909677	35965
chr2	127310590	127510590	harbor2	chr2	127351462	127351865	LINE/L2	975	+	202	127351664	41074
chr2	169791976	169991976	harbor2	chr2	169794474	169794877	LINE/L2	845	+	202	169794676	2700
chr2	44089780	44289780	harbor2	chr2	44099167	44099298	LINE/L2	430	+	66	44099233	9453
chr2	44089780	44289780	harbor2	chr2	44099606	44100287	LINE/L2	430	+	340	44099946	10166
chr2	44089780	44289780	harbor2	chr2	44184235	44184685	LINE/L2	1237	+	225	44184460	94680
chr2	206423268	206623268	harbor2	chr2	206459818	206460104	LINE/L2	624	+	143	206459961	36693
chr2	206423268	206623268	harbor2	chr2	206469179	206470126	LINE/L2	2176	+	474	206469653	46385
chr2	153479060	153679060	harbor2	chr2	153556795	153557054	LINE/L2	554	+	130	153556925	77865
chr2	153479060	153679060	harbor2	chr2	153557392	153558143	LINE/L2	554	+	376	153557768	78708
chr2	160773273	160973273	harbor2	chr2	160836499	160836871	LINE/L2	510	+	186	160836685	63412
chr2	168486188	168686188	harbor2	chr2	168537625	168538747	LINE/L2	1915	+	561	168538186	51998
chr2	42626650	42826650	harbor2	chr2	42725135	42725255	LINE/L2	425	+	60	42725195	98545
chr2	102468938	102668938	harbor2	chr2	102523773	102524132	LINE/L2	473	+	180	102523953	55015
chr2	124335582	124535582	harbor2	chr2	124363300	124363588	LINE/L2	997	+	144	124363444	27862
chr2	124335582	124535582	harbor2	chr2	124363875	124364631	LINE/L2	997	+	378	124364253	28671
chr2	124335582	124535582	harbor2	chr2	124420361	124420501	LINE/L2	1200	+	70	124420431	84849
chr2	124335582	124535582	harbor2	chr2	124420903	124421687	LINE/L2	1200	+	392	124421295	85713
chr2	197408396	197608396	harbor2	chr2	197451776	197452048	LINE/L2	1002	+	136	197451912	43516
chr2	197408396	197608396	harbor2	chr2	197452372	197452647	LINE/L2	1002	+	138	197452510	44114
chr3	33635352	33835352	harbor2	chr3	33648863	33649430	LINE/L2	835	+	284	33649147	13795
chr3	33635352	33835352	harbor2	chr3	33714301	33714746	LINE/L2	831	+	222	33714523	79171
chr3	33635352	33835352	harbor2	chr3	33714873	33715167	LINE/L2	831	+	147	33715020	79668
chr3	33635352	33835352	harbor2	chr3	33715290	33715603	LINE/L2	938	+	156	33715446	80094
chr3	33635352	33835352	harbor2	chr3	33652426	33653063	LINE/L2	1253	+	318	33652744	17392
chr3	180017578	180217578	harbor2	chr3	180037496	180037777	LINE/L2	713	+	140	180037636	20058
chr3	180017578	180217578	harbor2	chr3	180044875	180045521	LINE/L2	570	+	323	180045198	27620
chr3	180017578	180217578	harbor2	chr3	180049474	180049609	LINE/L2	988	+	68	180049542	31964
chr3	180017578	180217578	harbor2	chr3	180049930	180050312	LINE/L2	988	+	191	180050121	32543
chr3	180017578	180217578	harbor2	chr3	180050847	180051787	LINE/L2	2226	+	470	180051317	33739
chr3	180017578	180217578	harbor2	chr3	180063493	180064128	LINE/L2	430	+	318	180063811	46233
chr3	156896875	157096875	harbor2	chr3	156934030	156934330	LINE/L2	818	+	150	156934180	37305
chr3	123706681	123906681	harbor2	chr3	123718455	123718940	LINE/L2	709	+	242	123718697	12016
chr3	123706681	123906681	harbor2	chr3	123734508	123734931	LINE/L2	399	+	212	123734720	28039
chr3	123706681	123906681	harbor2	chr3	123741864	123742236	LINE/L2	600	+	186	123742050	35369
chr3	123706681	123906681	harbor2	chr3	123769539	123769830	LINE/L2	418	+	146	123769685	63004
chr3	194522490	194722490	harbor2	chr3	194540487	194540868	LINE/L2	536	+	190	194540677	18187
chr3	194522490	194722490	harbor2	chr3	194551609	194551818	LINE/L2	1263	+	104	194551713	29223
chr3	194522490	194722490	harbor2	chr3	194552116	194552409	LINE/L2	1263	+	146	194552262	29772
chr3	194522490	194722490	harbor2	chr3	194552466	194552896	LINE/L2	1113	+	215	194552681	30191
chr3	194522490	194722490	harbor2	chr3	194558386	194558515	LINE/L2	389	+	64	194558450	35960
chr3	153893189	154093189	harbor2	chr3	153928234	153928328	LINE/L2	409	+	47	153928281	35092
chr3	153893189	154093189	harbor2	chr3	153967483	153968074	LINE/L2	1107	+	296	153967779	74590
chr3	140218809	140418809	harbor2	chr3	140232361	140232965	LINE/L2	604	+	302	140232663	13854
chr3	140218809	140418809	harbor2	chr3	140291257	140292272	LINE/L2	632	+	508	140291765	72956
chr3	184292703	184492703	harbor2	chr3	184300692	184300972	LINE/L2	438	+	140	184300832	8129
chr3	173703845	173903845	harbor2	chr3	173753110	173753928	LINE/L2	2432	+	409	173753519	49674
chr3	173703845	173903845	harbor2	chr3	173753977	173753997	LINE/L2	1361	+	10	173753987	50142
chr3	173703845	173903845	harbor2	chr3	173754340	173754645	LINE/L2	1361	+	152	173754492	50647
chr3	173703845	173903845	harbor2	chr3	173770977	173771243	LINE/L2	442	+	133	173771110	67265
chr3	173703845	173903845	harbor2	chr3	173793828	173794366	LINE/L2	403	+	269	173794097	90252
chr3	173703845	173903845	harbor2	chr3	173752310	173753109	LINE/L2	1372	+	400	173752710	48865
chr3	192055168	192255168	harbor2	chr3	192116613	192117440	LINE/L2	964	+	414	192117027	61859
chr3	147763687	147963687	harbor2	chr3	147774428	147774770	LINE/L2	845	+	171	147774599	10912
chr3	147763687	147963687	harbor2	chr3	147774993	147775372	LINE/L2	1152	+	190	147775183	11496
chr3	147763687	147963687	harbor2	chr3	147776436	147777038	LINE/L2	751	+	301	147776737	13050
chr3	147763687	147963687	harbor2	chr3	147777402	147777663	LINE/L2	724	+	130	147777532	13845
chr3	147763687	147963687	harbor2	chr3	147822234	147822714	LINE/L2	3332	+	240	147822474	58787
chr3	147763687	147963687	harbor2	chr3	147823013	147823333	LINE/L2	3332	+	160	147823173	59486
chr3	147763687	147963687	harbor2	chr3	147823447	147824317	LINE/L2	3332	+	435	147823882	60195
chr3	147763687	147963687	harbor2	chr3	147851599	147851752	LINE/L2	401	+	76	147851675	87988
chr3	174518543	174718543	harbor2	chr3	174518425	174518695	LINE/L2	454	+	135	174518560	17
chr3	194142880	194342880	harbor2	chr3	194152522	194152833	LINE/L2	393	+	156	194152678	9798
chr3	194142880	194342880	harbor2	chr3	194198916	194199317	LINE/L2	502	+	200	194199116	56236
chr3	194142880	194342880	harbor2	chr3	194226041	194226405	LINE/L2	490	+	182	194226223	83343
chr3	194142880	194342880	harbor2	chr3	194226560	194226675	LINE/L2	400	+	58	194226618	83738
chr3	194142880	194342880	harbor2	chr3	194227111	194227507	LINE/L2	806	+	198	194227309	84429
chr3	194142880	194342880	harbor2	chr3	194227810	194228055	LINE/L2	806	+	122	194227932	85052
chr3	194142880	194342880	harbor2	chr3	194228578	194228754	LINE/L2	607	+	88	194228666	85786
chr3	194222210	194422210	harbor2	chr3	194226041	194226405	LINE/L2	490	+	182	194226223	4013
chr3	194222210	194422210	harbor2	chr3	194226560	194226675	LINE/L2	400	+	58	194226618	4408
chr3	194222210	194422210	harbor2	chr3	194227111	194227507	LINE/L2	806	+	198	194227309	5099
chr3	194222210	194422210	harbor2	chr3	194227810	194228055	LINE/L2	806	+	122	194227932	5722
chr3	194222210	194422210	harbor2	chr3	194228578	194228754	LINE/L2	607	+	88	194228666	6456
chr3	194222210	194422210	harbor2	chr3	194274106	194274371	LINE/L2	395	+	132	194274238	52028
chr3	194222210	194422210	harbor2	chr3	194311892	194312047	LINE/L2	481	+	78	194311970	89760
chr3	194222210	194422210	harbor2	chr3	194312355	194312448	LINE/L2	481	+	46	194312401	90191
chr3	172082388	172282388	harbor2	chr3	172084798	172085039	LINE/L2	566	+	120	172084918	2530
chr3	186415162	186615162	harbor2	chr3	186414952	186415235	LINE/L2	1467	+	142	186415094	68
chr3	186415162	186615162	harbor2	chr3	186415659	186416193	LINE/L2	1467	+	267	186415926	764
chr3	186415162	186615162	harbor2	chr3	186416445	186416534	LINE/L2	1467	+	44	186416489	1327
chr3	178257860	178457860	harbor2	chr3	178300650	178300909	LINE/L2	469	+	130	178300780	42920
chr3	181725823	181925823	harbor2	chr3	181778167	181778467	LINE/L2	458	+	150	181778317	52494
chr3	181725823	181925823	harbor2	chr3	181793168	181793532	LINE/L2	437	+	182	181793350	67527
chr3	181725823	181925823	harbor2	chr3	181805569	181805710	LINE/L2	413	+	70	181805639	79816
chr3	181725823	181925823	harbor2	chr3	181807875	181808067	LINE/L2	441	+	96	181807971	82148
chr3	181725823	181925823	harbor2	chr3	181808263	181808491	LINE/L2	884	+	114	181808377	82554
chr3	181725823	181925823	harbor2	chr3	181808763	181809123	LINE/L2	884	+	180	181808943	83120
chr3	181725823	181925823	harbor2	chr3	181809425	181809738	LINE/L2	884	+	156	181809581	83758
chr3	181725823	181925823	harbor2	chr3	181820548	181821283	LINE/L2	769	+	368	181820916	95093
chr3	192576347	192776347	harbor2	chr3	192592901	192593570	LINE/L2	990	+	334	192593235	16888
chr3	192576347	192776347	harbor2	chr3	192610463	192611142	LINE/L2	1306	+	340	192610803	34456
chr3	192576347	192776347	harbor2	chr3	192650116	192650710	LINE/L2	438	+	297	192650413	74066
chr3	184220229	184420229	harbor2	chr3	184245929	184246398	LINE/L2	786	+	234	184246163	25934
chr3	184220229	184420229	harbor2	chr3	184246542	184246675	LINE/L2	399	+	66	184246608	26379
chr3	184220229	184420229	harbor2	chr3	184247598	184247844	LINE/L2	399	+	123	184247721	27492
chr3	184220229	184420229	harbor2	chr3	184248153	184248247	LINE/L2	399	+	47	184248200	27971
chr3	184220229	184420229	harbor2	chr3	184255755	184255987	LINE/L2	593	+	116	184255871	35642
chr3	184220229	184420229	harbor2	chr3	184300692	184300972	LINE/L2	438	+	140	184300832	80603
chr3	192149615	192349615	harbor2	chr3	192158042	192158310	LINE/L2	512	+	134	192158176	8561
chr3	192149615	192349615	harbor2	chr3	192158681	192159481	LINE/L2	1462	+	400	192159081	9466
chr3	192149615	192349615	harbor2	chr3	192160005	192160746	LINE/L2	598	+	370	192160375	10760
chr3	192149615	192349615	harbor2	chr3	192177653	192177950	LINE/L2	747	+	148	192177801	28186
chr3	192149615	192349615	harbor2	chr3	192241712	192241834	LINE/L2	445	+	61	192241773	92158
chr3	141850124	142050124	harbor2	chr3	141908414	141909171	LINE/L2	537	+	378	141908792	58668
chr3	188837705	189037705	harbor2	chr3	188905273	188905327	LINE/L2	391	+	27	188905300	67595
chr3	188837705	189037705	harbor2	chr3	188905607	188905834	LINE/L2	391	+	114	188905721	68016
chr3	186166894	186366894	harbor2	chr3	186171141	186171292	LINE/L2	431	+	76	186171217	4323
chr3	186166894	186366894	harbor2	chr3	186256350	186257092	LINE/L2	1236	+	371	186256721	89827
chr3	114679858	114879858	harbor2	chr3	114710305	114711349	LINE/L2	1256	+	522	114710827	30969
chr3	114679858	114879858	harbor2	chr3	114717613	114717935	LINE/L2	655	+	161	114717774	37916
chr3	114679858	114879858	harbor2	chr3	114753739	114753884	LINE/L2	449	+	72	114753811	73953
chr3	81839121	82039121	harbor2	chr3	81865667	81866131	LINE/L2	903	+	232	81865899	26778
chr3	81839121	82039121	harbor2	chr3	81904820	81905757	LINE/L2	1255	+	468	81905288	66167
chr3	108581324	108781324	harbor2	chr3	108638118	108638280	LINE/L2	497	+	81	108638199	56875
chr3	108581324	108781324	harbor2	chr3	108639046	108639309	LINE/L2	507	+	132	108639178	57854
chr3	160272170	160472170	harbor2	chr3	160276692	160277132	LINE/L2	613	+	220	160276912	4742
chr3	160272170	160472170	harbor2	chr3	160296430	160297084	LINE/L2	671	+	327	160296757	24587
chr3	160272170	160472170	harbor2	chr3	160299512	160300307	LINE/L2	942	+	398	160299910	27740
chr3	160272170	160472170	harbor2	chr3	160317083	160317201	LINE/L2	425	+	59	160317142	44972
chr3	160272170	160472170	harbor2	chr3	160343719	160343916	LINE/L2	475	+	98	160343817	71647
chr3	160272170	160472170	harbor2	chr3	160353549	160353878	LINE/L2	472	+	164	160353713	81543
chr3	189932515	190132515	harbor2	chr3	189959983	189960462	LINE/L2	934	+	240	189960223	27708
chr3	189932515	190132515	harbor2	chr3	190012306	190012510	LINE/L2	500	+	102	190012408	79893
chr3	129158473	129358473	harbor2	chr3	129191881	129192047	LINE/L2	466	+	83	129191964	33491
chr3	176316278	176516278	harbor2	chr3	176390480	176390918	LINE/L2	938	+	219	176390699	74421
chr3	176316278	176516278	harbor2	chr3	176391220	176391368	LINE/L2	938	+	74	176391294	75016
chr3	192730605	192930605	harbor2	chr3	192732792	192732915	LINE/L2	426	+	62	192732854	2249
chr3	177696616	177896616	harbor2	chr3	177708445	177708708	LINE/L2	506	+	132	177708577	11961
chr3	177696616	177896616	harbor2	chr3	177708723	177708858	LINE/L2	420	+	68	177708791	12175
chr3	177696616	177896616	harbor2	chr3	177709154	177709479	LINE/L2	420	+	162	177709316	12700
chr3	177696616	177896616	harbor2	chr3	177785781	177785954	LINE/L2	405	+	86	177785867	89251
chr3	177696616	177896616	harbor2	chr3	177785980	177786104	LINE/L2	405	+	62	177786042	89426
chr3	177696616	177896616	harbor2	chr3	177786661	177786867	LINE/L2	405	+	103	177786764	90148
chr3	124312167	124512167	harbor2	chr3	124312826	124312946	LINE/L2	557	+	60	124312886	719
chr3	124312167	124512167	harbor2	chr3	124316133	124316818	LINE/L2	1295	+	342	124316475	4308
chr3	124312167	124512167	harbor2	chr3	124356066	124356320	LINE/L2	803	+	127	124356193	44026
chr3	124312167	124512167	harbor2	chr3	124356634	124357885	LINE/L2	803	+	626	124357260	45093
chr3	42690649	42890649	harbor2	chr3	42693955	42695055	LINE/L2	1958	+	550	42694505	3856
chr3	42690649	42890649	harbor2	chr3	42706221	42706340	LINE/L2	393	+	60	42706281	15632
chr3	42690649	42890649	harbor2	chr3	42724214	42724410	LINE/L2	419	+	98	42724312	33663
chr3	42690649	42890649	harbor2	chr3	42761247	42761616	LINE/L2	1281	+	184	42761431	70782
chr3	42690649	42890649	harbor2	chr3	42695073	42696812	LINE/L2	784	+	870	42695943	5294
chr3	188719330	188919330	harbor2	chr3	188782638	188783269	LINE/L2	397	+	316	188782954	63624
chr3	188719330	188919330	harbor2	chr3	188783726	188783902	LINE/L2	397	+	88	188783814	64484
chr3	188719330	188919330	harbor2	chr3	188787481	188788117	LINE/L2	894	+	318	188787799	68469
chr3	188719330	188919330	harbor2	chr3	188791539	188791988	LINE/L2	552	+	224	188791763	72433
chr3	184718575	184918575	harbor2	chr3	184775251	184775351	LINE/L2	391	+	50	184775301	56726
chr3	184718575	184918575	harbor2	chr3	184762136	184762523	LINE/L2	681	+	194	184762330	43755
chr3	69567932	69767932	harbor2	chr3	69648144	69648719	LINE/L2	708	+	288	69648432	80500
chr3	164181606	164381606	harbor2	chr3	164264203	164264409	LINE/L2	420	+	103	164264306	82700
chr3	164181606	164381606	harbor2	chr3	164264839	164265122	LINE/L2	480	+	142	164264981	83375
chr3	130418039	130618039	harbor2	chr3	130421709	130421867	LINE/L2	418	+	79	130421788	3749
chr3	130418039	130618039	harbor2	chr3	130436314	130437993	LINE/L2	2646	+	840	130437154	19115
chr3	130418039	130618039	harbor2	chr3	130438295	130438385	LINE/L2	1104	+	45	130438340	20301
chr3	130418039	130618039	harbor2	chr3	130487656	130488019	LINE/L2	422	+	182	130487838	69799
chr3	130418039	130618039	harbor2	chr3	130511529	130512048	LINE/L2	765	+	260	130511789	93750
chr3	130418039	130618039	harbor2	chr3	130512063	130512371	LINE/L2	566	+	154	130512217	94178
chr3	130418039	130618039	harbor2	chr3	130512376	130512743	LINE/L2	492	+	184	130512560	94521
chr3	130418039	130618039	harbor2	chr3	130516186	130516532	LINE/L2	619	+	173	130516359	98320
chr3	182748486	182948486	harbor2	chr3	182802165	182802752	LINE/L2	1212	+	294	182802459	53973
chr3	182748486	182948486	harbor2	chr3	182830970	182831976	LINE/L2	1300	+	503	182831473	82987
chr3	182748486	182948486	harbor2	chr3	182840698	182841423	LINE/L2	933	+	362	182841060	92574
chr3	195325420	195525420	harbor2	chr3	195329356	195329843	LINE/L2	436	+	244	195329600	4180
chr3	195325420	195525420	harbor2	chr3	195337249	195337446	LINE/L2	544	+	98	195337347	11927
chr3	195325420	195525420	harbor2	chr3	195337747	195338288	LINE/L2	544	+	270	195338017	12597
chr3	195325420	195525420	harbor2	chr3	195417233	195417666	LINE/L2	662	+	216	195417449	92029
chr3	195325420	195525420	harbor2	chr3	195417954	195418408	LINE/L2	662	+	227	195418181	92761
chr3	99641127	99841127	harbor2	chr3	99649004	99649374	LINE/L2	643	+	185	99649189	8062
chr3	99641127	99841127	harbor2	chr3	99658201	99658638	LINE/L2	415	+	218	99658419	17292
chr3	99641127	99841127	harbor2	chr3	99664157	99664310	LINE/L2	589	+	76	99664233	23106
chr3	100682571	100882571	harbor2	chr3	100751848	100752066	LINE/L2	413	+	109	100751957	69386
chr3	100682571	100882571	harbor2	chr3	100763987	100764429	LINE/L2	578	+	221	100764208	81637
chr3	187821813	188021813	harbor2	chr3	187829863	187830639	LINE/L2	1168	+	388	187830251	8438
chr3	187821813	188021813	harbor2	chr3	187849805	187850304	LINE/L2	735	+	250	187850055	28242
chr3	187821813	188021813	harbor2	chr3	187904309	187905878	LINE/L2	602	+	784	187905093	83280
chr3	142894737	143094737	harbor2	chr3	142916112	142916806	LINE/L2	418	+	347	142916459	21722
chr3	142894737	143094737	harbor2	chr3	142925840	142926117	LINE/L2	600	+	138	142925978	31241
chr3	142894737	143094737	harbor2	chr3	142972548	142972936	LINE/L2	716	+	194	142972742	78005
chr3	142894737	143094737	harbor2	chr3	142977117	142977241	LINE/L2	438	+	62	142977179	82442
chr3	142894737	143094737	harbor2	chr3	142933821	142934039	LINE/L2	600	+	109	142933930	39193
chr3	129172198	129372198	harbor2	chr3	129191881	129192047	LINE/L2	466	+	83	129191964	19766
chr3	78376820	78576820	harbor2	chr3	78379268	78379717	LINE/L2	428	+	224	78379492	2672
chr3	78376820	78576820	harbor2	chr3	78379782	78380061	LINE/L2	397	+	140	78379922	3102
chr3	78376820	78576820	harbor2	chr3	78408973	78409228	LINE/L2	634	+	128	78409101	32281
chr3	105980377	106180377	harbor2	chr3	105985834	105986043	LINE/L2	563	+	104	105985938	5561
chr3	105980377	106180377	harbor2	chr3	106032108	106032701	LINE/L2	952	+	296	106032404	52027
chr3	105980377	106180377	harbor2	chr3	105987370	105989483	LINE/L2	3580	+	1056	105988426	8049
chr3	132431302	132631302	harbor2	chr3	132475711	132475921	LINE/L2	621	+	105	132475816	44514
chr3	132431302	132631302	harbor2	chr3	132476153	132477104	LINE/L2	1067	+	476	132476629	45327
chr3	132431302	132631302	harbor2	chr3	132530146	132530318	LINE/L2	456	+	86	132530232	98930
chr3	132710912	132910912	harbor2	chr3	132760214	132760599	LINE/L2	1435	+	192	132760406	49494
chr3	132710912	132910912	harbor2	chr3	132790836	132791509	LINE/L2	571	+	336	132791172	80260
chr3	132710912	132910912	harbor2	chr3	132806437	132806593	LINE/L2	466	+	78	132806515	95603
chr3	174820738	175020738	harbor2	chr3	174879672	174880730	LINE/L2	1826	+	529	174880201	59463
chr3	174820738	175020738	harbor2	chr3	174881595	174881754	LINE/L2	551	+	80	174881675	60937
chr3	143551626	143751626	harbor2	chr3	143551375	143551866	LINE/L2	553	+	246	143551621	5
chr3	143551626	143751626	harbor2	chr3	143554329	143555019	LINE/L2	860	+	345	143554674	3048
chr3	143551626	143751626	harbor2	chr3	143555381	143555489	LINE/L2	860	+	54	143555435	3809
chr3	174853697	175053697	harbor2	chr3	174879672	174880730	LINE/L2	1826	+	529	174880201	26504
chr3	174853697	175053697	harbor2	chr3	174881595	174881754	LINE/L2	551	+	80	174881675	27978
chr3	57304370	57504370	harbor2	chr3	57320204	57320346	LINE/L2	567	+	71	57320275	15905
chr3	57304370	57504370	harbor2	chr3	57388015	57388343	LINE/L2	668	+	164	57388179	83809
chr3	91495084	91695084	harbor2	chr3	91509052	91509457	LINE/L2	493	+	202	91509254	14170
chr3	194974835	195174835	harbor2	chr3	195051945	195052219	LINE/L2	564	+	137	195052082	77247
chr3	194974835	195174835	harbor2	chr3	195054992	195055760	LINE/L2	900	+	384	195055376	80541
chr3	194974835	195174835	harbor2	chr3	195056050	195056221	LINE/L2	662	+	86	195056136	81301
chr3	174984077	175184077	harbor2	chr3	175014167	175014542	LINE/L2	546	+	188	175014355	30278
chr3	174984077	175184077	harbor2	chr3	175033515	175034168	LINE/L2	1684	+	326	175033841	49764
chr3	174984077	175184077	harbor2	chr3	175034408	175034627	LINE/L2	993	+	110	175034518	50441
chr3	174984077	175184077	harbor2	chr3	175034870	175035035	LINE/L2	993	+	82	175034952	50875
chr3	174984077	175184077	harbor2	chr3	175066265	175066502	LINE/L2	620	+	118	175066383	82306
chr3	174984077	175184077	harbor2	chr3	175073865	175074149	LINE/L2	764	+	142	175074007	89930
chr3	115744367	115944367	harbor2	chr3	115758979	115759074	LINE/L2	421	+	48	115759027	14660
chr3	115744367	115944367	harbor2	chr3	115760183	115760426	LINE/L2	504	+	122	115760305	15938
chr3	115744367	115944367	harbor2	chr3	115816994	115817470	LINE/L2	1344	+	238	115817232	72865
chr3	115744367	115944367	harbor2	chr3	115826028	115826100	LINE/L2	421	+	36	115826064	81697
chr3	115744367	115944367	harbor2	chr3	115826406	115826674	LINE/L2	421	+	134	115826540	82173
chr3	176893865	177093865	harbor2	chr3	176899429	176899883	LINE/L2	884	+	227	176899656	5791
chr3	176893865	177093865	harbor2	chr3	176899921	176900091	LINE/L2	884	+	85	176900006	6141
chr3	176893865	177093865	harbor2	chr3	176900563	176900586	LINE/L2	884	+	12	176900575	6710
chr3	176893865	177093865	harbor2	chr3	176909315	176909695	LINE/L2	673	+	190	176909505	15640
chr3	191475634	191675634	harbor2	chr3	191505976	191506336	LINE/L2	555	+	180	191506156	30522
chr3	191475634	191675634	harbor2	chr3	191506793	191507205	LINE/L2	440	+	206	191506999	31365
chr3	191475634	191675634	harbor2	chr3	191564728	191565223	LINE/L2	718	+	248	191564976	89342
chr3	191475634	191675634	harbor2	chr3	191570994	191571855	LINE/L2	564	+	430	191571424	95790
chr3	161835301	162035301	harbor2	chr3	161869452	161870273	LINE/L2	1212	+	410	161869862	34561
chr3	164740484	164940484	harbor2	chr3	164753913	164754330	LINE/L2	493	+	208	164754121	13637
chr3	164740484	164940484	harbor2	chr3	164798116	164798722	LINE/L2	972	+	303	164798419	57935
chr3	164740484	164940484	harbor2	chr3	164799304	164799472	LINE/L2	516	+	84	164799388	58904
chr3	168274428	168474428	harbor2	chr3	168276313	168277079	LINE/L2	1302	+	383	168276696	2268
chr3	168274428	168474428	harbor2	chr3	168339341	168339630	LINE/L2	809	+	144	168339485	65057
chr3	168274428	168474428	harbor2	chr3	168345922	168346847	LINE/L2	1779	+	462	168346384	71956
chr3	131694563	131894563	harbor2	chr3	131709810	131710104	LINE/L2	563	+	147	131709957	15394
chr3	131694563	131894563	harbor2	chr3	131718393	131718854	LINE/L2	570	+	230	131718623	24060
chr3	131694563	131894563	harbor2	chr3	131720876	131721222	LINE/L2	627	+	173	131721049	26486
chr3	131694563	131894563	harbor2	chr3	131740287	131741213	LINE/L2	1711	+	463	131740750	46187
chr3	131694563	131894563	harbor2	chr3	131771022	131771202	LINE/L2	421	+	90	131771112	76549
chr3	131694563	131894563	harbor2	chr3	131785241	131785564	LINE/L2	444	+	162	131785403	90840
chr3	131694563	131894563	harbor2	chr3	131792927	131793405	LINE/L2	532	+	239	131793166	98603
chr3	131694563	131894563	harbor2	chr3	131793580	131793773	LINE/L2	508	+	96	131793676	99113
chr3	137000372	137200372	harbor2	chr3	137077400	137078511	LINE/L2	831	+	556	137077956	77584
chr3	137000372	137200372	harbor2	chr3	137091570	137092120	LINE/L2	1468	+	275	137091845	91473
chr3	137000372	137200372	harbor2	chr3	137092422	137093201	LINE/L2	1468	+	390	137092812	92440
chr3	192528866	192728866	harbor2	chr3	192546552	192546715	LINE/L2	519	+	82	192546634	17768
chr3	192528866	192728866	harbor2	chr3	192592901	192593570	LINE/L2	990	+	334	192593235	64369
chr3	192528866	192728866	harbor2	chr3	192610463	192611142	LINE/L2	1306	+	340	192610803	81937
chr3	102827992	103027992	harbor2	chr3	102890463	102890581	LINE/L2	395	+	59	102890522	62530
chr3	102827992	103027992	harbor2	chr3	102896184	102897827	LINE/L2	1621	+	822	102897006	69014
chr3	158296989	158496989	harbor2	chr3	158313239	158313342	LINE/L2	406	+	52	158313291	16302
chr3	158296989	158496989	harbor2	chr3	158378941	158379192	LINE/L2	849	+	126	158379067	82078
chr3	158296989	158496989	harbor2	chr3	158379500	158380038	LINE/L2	940	+	269	158379769	82780
chr3	186762604	186962604	harbor2	chr3	186805806	186805890	LINE/L2	449	+	42	186805848	43244
chr3	160693021	160893021	harbor2	chr3	160696193	160696862	LINE/L2	487	+	334	160696527	3506
chr3	160693021	160893021	harbor2	chr3	160726062	160726413	LINE/L2	1774	+	176	160726238	33217
chr3	160693021	160893021	harbor2	chr3	160726744	160727001	LINE/L2	1774	+	128	160726872	33851
chr3	174196473	174396473	harbor2	chr3	174209937	174210420	LINE/L2	741	+	242	174210179	13706
chr3	174196473	174396473	harbor2	chr3	174235875	174236086	LINE/L2	661	+	106	174235981	39508
chr3	152101744	152301744	harbor2	chr3	152114558	152114807	LINE/L2	579	+	124	152114682	12938
chr3	158265521	158465521	harbor2	chr3	158313239	158313342	LINE/L2	406	+	52	158313291	47770
chr3	191224515	191424515	harbor2	chr3	191270499	191270774	LINE/L2	1188	+	138	191270637	46122
chr3	191224515	191424515	harbor2	chr3	191271519	191271907	LINE/L2	1188	+	194	191271713	47198
chr3	191224515	191424515	harbor2	chr3	191273719	191273901	LINE/L2	560	+	91	191273810	49295
chr3	191224515	191424515	harbor2	chr3	191294670	191294746	LINE/L2	1214	+	38	191294708	70193
chr3	191224515	191424515	harbor2	chr3	191295056	191296254	LINE/L2	1214	+	599	191295655	71140
chr3	186683583	186883583	harbor2	chr3	186755930	186756195	LINE/L2	1001	+	132	186756062	72479
chr3	186683583	186883583	harbor2	chr3	186756501	186756743	LINE/L2	1001	+	121	186756622	73039
chr3	99962278	100162278	harbor2	chr3	100026584	100027362	LINE/L2	1605	+	389	100026973	64695
chr3	153492172	153692172	harbor2	chr3	153538187	153538394	LINE/L2	423	+	104	153538291	46119
chr3	153492172	153692172	harbor2	chr3	153581596	153582050	LINE/L2	791	+	227	153581823	89651
chr3	153492172	153692172	harbor2	chr3	153583104	153583362	LINE/L2	394	+	129	153583233	91061
chr3	142043927	142243927	harbor2	chr3	142087899	142088188	LINE/L2	806	+	144	142088043	44116
chr3	142043927	142243927	harbor2	chr3	142099156	142099419	LINE/L2	1341	+	132	142099288	55361
chr3	142043927	142243927	harbor2	chr3	142099719	142100011	LINE/L2	1341	+	146	142099865	55938
chr3	142043927	142243927	harbor2	chr3	142108720	142109198	LINE/L2	845	+	239	142108959	65032
chr3	112286983	112486983	harbor2	chr3	112365399	112365890	LINE/L2	1206	+	246	112365645	78662
chr3	112286983	112486983	harbor2	chr3	112375092	112375540	LINE/L2	802	+	224	112375316	88333
chr3	112286983	112486983	harbor2	chr3	112384824	112385694	LINE/L2	2018	+	435	112385259	98276
chr3	55468506	55668506	harbor2	chr3	55493323	55493656	LINE/L2	590	+	166	55493489	24983
chr3	55468506	55668506	harbor2	chr3	55523379	55523522	LINE/L2	424	+	72	55523451	54945
chr3	55468506	55668506	harbor2	chr3	55536126	55536520	LINE/L2	574	+	197	55536323	67817
chr3	55468506	55668506	harbor2	chr3	55545096	55545335	LINE/L2	491	+	120	55545216	76710
chr3	55468506	55668506	harbor2	chr3	55546224	55546617	LINE/L2	1103	+	196	55546420	77914
chr3	55468506	55668506	harbor2	chr3	55550052	55550469	LINE/L2	506	+	208	55550260	81754
chr3	55468506	55668506	harbor2	chr3	55557694	55557919	LINE/L2	521	+	112	55557806	89300
chr3	191566193	191766193	harbor2	chr3	191570994	191571855	LINE/L2	564	+	430	191571424	5231
chr3	191566193	191766193	harbor2	chr3	191608689	191609076	LINE/L2	403	+	194	191608883	42690
chr3	193740598	193940598	harbor2	chr3	193762155	193762359	LINE/L2	730	+	102	193762257	21659
chr3	193740598	193940598	harbor2	chr3	193762664	193763041	LINE/L2	730	+	188	193762852	22254
chr3	193740598	193940598	harbor2	chr3	193763561	193764478	LINE/L2	1232	+	458	193764019	23421
chr3	193740598	193940598	harbor2	chr3	193795589	193795858	LINE/L2	514	+	134	193795723	55125
chr3	193740598	193940598	harbor2	chr3	193796159	193796617	LINE/L2	514	+	229	193796388	55790
chr3	193740598	193940598	harbor2	chr3	193802804	193803289	LINE/L2	558	+	242	193803046	62448
chr3	193740598	193940598	harbor2	chr3	193808618	193809051	LINE/L2	490	+	216	193808834	68236
chr3	54757702	54957702	harbor2	chr3	54810893	54811465	LINE/L2	579	+	286	54811179	53477
chr3	54757702	54957702	harbor2	chr3	54811801	54811853	LINE/L2	579	+	26	54811827	54125
chr3	102198228	102398228	harbor2	chr3	102198042	102199026	LINE/L2	3023	+	492	102198534	306
chr3	102198228	102398228	harbor2	chr3	102199490	102199764	LINE/L2	644	+	137	102199627	1399
chr3	102198228	102398228	harbor2	chr3	102200057	102201375	LINE/L2	2446	+	659	102200716	2488
chr3	102198228	102398228	harbor2	chr3	102236288	102237115	LINE/L2	655	+	414	102236702	38474
chr3	102198228	102398228	harbor2	chr3	102240171	102240998	LINE/L2	588	+	414	102240585	42357
chr3	194784824	194984824	harbor2	chr3	194806158	194806487	LINE/L2	440	+	164	194806322	21498
chr3	194784824	194984824	harbor2	chr3	194822729	194823151	LINE/L2	517	+	211	194822940	38116
chr3	194784824	194984824	harbor2	chr3	194823339	194824046	LINE/L2	517	+	354	194823693	38869
chr3	194784824	194984824	harbor2	chr3	194851394	194851494	LINE/L2	395	+	50	194851444	66620
chr3	185694572	185894572	harbor2	chr3	185772087	185772259	LINE/L2	590	+	86	185772173	77601
chr3	179215299	179415299	harbor2	chr3	179272154	179272266	LINE/L2	446	+	56	179272210	56911
chr3	179215299	179415299	harbor2	chr3	179296371	179296391	LINE/L2	1040	+	10	179296381	81082
chr3	179215299	179415299	harbor2	chr3	179296691	179297134	LINE/L2	1040	+	222	179296913	81614
chr3	115318936	115518936	harbor2	chr3	115341605	115341919	LINE/L2	671	+	157	115341762	22826
chr3	115318936	115518936	harbor2	chr3	115380860	115381132	LINE/L2	730	+	136	115380996	62060
chr3	193212525	193412525	harbor2	chr3	193278105	193278237	LINE/L2	436	+	66	193278171	65646
chr3	196863918	197063918	harbor2	chr3	196874365	196874615	LINE/L2	592	+	125	196874490	10572
chr3	196863918	197063918	harbor2	chr3	196874883	196875113	LINE/L2	592	+	115	196874998	11080
chr3	173957326	174157326	harbor2	chr3	173983562	173983925	LINE/L2	518	+	182	173983744	26418
chr3	173957326	174157326	harbor2	chr3	174005332	174005446	LINE/L2	412	+	57	174005389	48063
chr3	197434790	197634790	harbor2	chr3	197435759	197436014	LINE/L2	686	+	128	197435887	1097
chr3	197434790	197634790	harbor2	chr3	197447470	197447572	LINE/L2	478	+	51	197447521	12731
chr3	197434790	197634790	harbor2	chr3	197479475	197479875	LINE/L2	939	+	200	197479675	44885
chr3	197434790	197634790	harbor2	chr3	197493487	197494290	LINE/L2	782	+	402	197493889	59099
chr3	197434790	197634790	harbor2	chr3	197527845	197528155	LINE/L2	834	+	155	197528000	93210
chr3	197434790	197634790	harbor2	chr3	197531874	197532201	LINE/L2	404	+	164	197532038	97248
chr3	153486213	153686213	harbor2	chr3	153538187	153538394	LINE/L2	423	+	104	153538291	52078
chr3	153486213	153686213	harbor2	chr3	153581596	153582050	LINE/L2	791	+	227	153581823	95610
chr3	153486213	153686213	harbor2	chr3	153583104	153583362	LINE/L2	394	+	129	153583233	97020
chr3	156031316	156231316	harbor2	chr3	156083014	156084243	LINE/L2	1698	+	614	156083628	52312
chr3	156031316	156231316	harbor2	chr3	156116091	156116410	LINE/L2	857	+	160	156116251	84935
chr3	75993788	76193788	harbor2	chr3	76068462	76069484	LINE/L2	2300	+	511	76068973	75185
chr3	75993788	76193788	harbor2	chr3	76082604	76082868	LINE/L2	444	+	132	76082736	88948
chr3	80137271	80337271	harbor2	chr3	80175771	80175954	LINE/L2	587	+	92	80175863	38592
chr3	138422083	138622083	harbor2	chr3	138431261	138431501	LINE/L2	612	+	120	138431381	9298
chr3	138422083	138622083	harbor2	chr3	138431937	138431959	LINE/L2	612	+	11	138431948	9865
chr3	138422083	138622083	harbor2	chr3	138442470	138442779	LINE/L2	463	+	154	138442624	20541
chr3	138422083	138622083	harbor2	chr3	138515842	138516095	LINE/L2	631	+	126	138515968	93885
chr3	138422083	138622083	harbor2	chr3	138516145	138516252	LINE/L2	428	+	54	138516199	94116
chr3	176377798	176577798	harbor2	chr3	176390480	176390918	LINE/L2	938	+	219	176390699	12901
chr3	176377798	176577798	harbor2	chr3	176391220	176391368	LINE/L2	938	+	74	176391294	13496
chr3	176377798	176577798	harbor2	chr3	176427155	176427502	LINE/L2	1026	+	174	176427329	49531
chr3	176377798	176577798	harbor2	chr3	176454479	176455171	LINE/L2	833	+	346	176454825	77027
chr3	122991355	123191355	harbor2	chr3	123031760	123032710	LINE/L2	2186	+	475	123032235	40880
chr3	108963622	109163622	harbor2	chr3	108990309	108990768	LINE/L2	920	+	230	108990539	26917
chr3	108963622	109163622	harbor2	chr3	109001417	109002148	LINE/L2	739	+	366	109001783	38161
chr3	108963622	109163622	harbor2	chr3	109002691	109003255	LINE/L2	463	+	282	109002973	39351
chr3	184217654	184417654	harbor2	chr3	184245929	184246398	LINE/L2	786	+	234	184246163	28509
chr3	184217654	184417654	harbor2	chr3	184246542	184246675	LINE/L2	399	+	66	184246608	28954
chr3	184217654	184417654	harbor2	chr3	184247598	184247844	LINE/L2	399	+	123	184247721	30067
chr3	184217654	184417654	harbor2	chr3	184248153	184248247	LINE/L2	399	+	47	184248200	30546
chr3	184217654	184417654	harbor2	chr3	184255755	184255987	LINE/L2	593	+	116	184255871	38217
chr3	184217654	184417654	harbor2	chr3	184300692	184300972	LINE/L2	438	+	140	184300832	83178
chr3	192575339	192775339	harbor2	chr3	192592901	192593570	LINE/L2	990	+	334	192593235	17896
chr3	192575339	192775339	harbor2	chr3	192610463	192611142	LINE/L2	1306	+	340	192610803	35464
chr3	192575339	192775339	harbor2	chr3	192650116	192650710	LINE/L2	438	+	297	192650413	75074
chr3	153547307	153747307	harbor2	chr3	153581596	153582050	LINE/L2	791	+	227	153581823	34516
chr3	153547307	153747307	harbor2	chr3	153583104	153583362	LINE/L2	394	+	129	153583233	35926
chr3	161595064	161795064	harbor2	chr3	161640245	161640685	LINE/L2	1020	+	220	161640465	45401
chr3	161595064	161795064	harbor2	chr3	161640864	161641537	LINE/L2	726	+	336	161641200	46136
chr3	161595064	161795064	harbor2	chr3	161662343	161662528	LINE/L2	440	+	92	161662435	67371
chr3	161595064	161795064	harbor2	chr3	161677790	161678102	LINE/L2	488	+	156	161677946	82882
chr3	161595064	161795064	harbor2	chr3	161676988	161677653	LINE/L2	513	+	332	161677320	82256
chr3	158946320	159146320	harbor2	chr3	158948706	158949091	LINE/L2	422	+	192	158948898	2578
chr3	158946320	159146320	harbor2	chr3	159009656	159009941	LINE/L2	676	+	142	159009798	63478
chr3	172633074	172833074	harbor2	chr3	172641809	172642116	LINE/L2	470	+	154	172641963	8889
chr3	172633074	172833074	harbor2	chr3	172701084	172701449	LINE/L2	643	+	182	172701266	68192
chr3	172633074	172833074	harbor2	chr3	172701764	172702062	LINE/L2	643	+	149	172701913	68839
chr3	172633074	172833074	harbor2	chr3	172725011	172725122	LINE/L2	484	+	56	172725067	91993
chr3	88682413	88882413	harbor2	chr3	88685884	88686070	LINE/L2	391	+	93	88685977	3564
chr3	121697415	121897415	harbor2	chr3	121700559	121701007	LINE/L2	756	+	224	121700783	3368
chr3	121697415	121897415	harbor2	chr3	121750702	121750745	LINE/L2	562	+	22	121750724	53309
chr3	121697415	121897415	harbor2	chr3	121751151	121751372	LINE/L2	562	+	110	121751261	53846
chr3	147777992	147977992	harbor2	chr3	147822234	147822714	LINE/L2	3332	+	240	147822474	44482
chr3	147777992	147977992	harbor2	chr3	147823013	147823333	LINE/L2	3332	+	160	147823173	45181
chr3	147777992	147977992	harbor2	chr3	147823447	147824317	LINE/L2	3332	+	435	147823882	45890
chr3	147777992	147977992	harbor2	chr3	147851599	147851752	LINE/L2	401	+	76	147851675	73683
chr3	146673254	146873254	harbor2	chr3	146677008	146677165	LINE/L2	662	+	78	146677086	3832
chr3	146673254	146873254	harbor2	chr3	146677533	146677897	LINE/L2	662	+	182	146677715	4461
chr3	189765879	189965879	harbor2	chr3	189853096	189853824	LINE/L2	1334	+	364	189853460	87581
chr3	197960514	198160514	harbor2	chr3	198001016	198001322	LINE/L2	402	+	153	198001169	40655
chr3	197960514	198160514	harbor2	chr3	198057168	198057341	LINE/L2	434	+	86	198057254	96740
chr3	169725217	169925217	harbor2	chr3	169751840	169752259	LINE/L2	440	+	210	169752050	26833
chr3	169725217	169925217	harbor2	chr3	169801215	169801723	LINE/L2	453	+	254	169801469	76252
chr3	169725217	169925217	harbor2	chr3	169802314	169802629	LINE/L2	426	+	158	169802472	77255
chr3	190773709	190973709	harbor2	chr3	190863371	190863494	LINE/L2	413	+	62	190863433	89724
chr3	197488270	197688270	harbor2	chr3	197493487	197494290	LINE/L2	782	+	402	197493889	5619
chr3	197488270	197688270	harbor2	chr3	197527845	197528155	LINE/L2	834	+	155	197528000	39730
chr3	197488270	197688270	harbor2	chr3	197531874	197532201	LINE/L2	404	+	164	197532038	43768
chr3	197488270	197688270	harbor2	chr3	197551922	197552929	LINE/L2	1453	+	504	197552426	64156
chr3	56676733	56876733	harbor2	chr3	56694152	56694296	LINE/L2	397	+	72	56694224	17491
chr3	56676733	56876733	harbor2	chr3	56694583	56694595	LINE/L2	397	+	6	56694589	17856
chr3	56676733	56876733	harbor2	chr3	56756367	56756545	LINE/L2	395	+	89	56756456	79723
chr3	56676733	56876733	harbor2	chr3	56756849	56757040	LINE/L2	395	+	96	56756945	80212
chr3	149106754	149306754	harbor2	chr3	149180795	149181422	LINE/L2	739	+	314	149181109	74355
chr3	149106754	149306754	harbor2	chr3	149185459	149185913	LINE/L2	963	+	227	149185686	78932
chr3	149106754	149306754	harbor2	chr3	149143125	149143597	LINE/L2	701	+	236	149143361	36607
chr3	170681530	170881530	harbor2	chr3	170707440	170707636	LINE/L2	398	+	98	170707538	26008
chr3	170681530	170881530	harbor2	chr3	170726384	170727260	LINE/L2	2168	+	438	170726822	45292
chr3	170681530	170881530	harbor2	chr3	170727674	170728737	LINE/L2	2271	+	532	170728206	46676
chr3	170681530	170881530	harbor2	chr3	170730348	170730585	LINE/L2	395	+	118	170730466	48936
chr3	170681530	170881530	harbor2	chr3	170766148	170767132	LINE/L2	846	+	492	170766640	85110
chr3	197108554	197308554	harbor2	chr3	197172405	197172558	LINE/L2	503	+	76	197172481	63927
chr3	78311001	78511001	harbor2	chr3	78372951	78373163	LINE/L2	1147	+	106	78373057	62056
chr3	78311001	78511001	harbor2	chr3	78373638	78374058	LINE/L2	1147	+	210	78373848	62847
chr3	78311001	78511001	harbor2	chr3	78379268	78379717	LINE/L2	428	+	224	78379492	68491
chr3	78311001	78511001	harbor2	chr3	78379782	78380061	LINE/L2	397	+	140	78379922	68921
chr3	78311001	78511001	harbor2	chr3	78408973	78409228	LINE/L2	634	+	128	78409101	98100
chr3	166610478	166810478	harbor2	chr3	166679197	166679724	LINE/L2	625	+	264	166679461	68983
chr3	146856426	147056426	harbor2	chr3	146861828	146862029	LINE/L2	413	+	100	146861928	5502
chr3	146856426	147056426	harbor2	chr3	146933106	146933675	LINE/L2	670	+	284	146933390	76964
chr4	179410745	179610745	harbor2	chr4	179493388	179493886	LINE/L2	690	+	249	179493637	82892
chr4	57528894	57728894	harbor2	chr4	57579311	57579746	LINE/L2	430	+	218	57579529	50635
chr4	57528894	57728894	harbor2	chr4	57606893	57607235	LINE/L2	513	+	171	57607064	78170
chr4	57528894	57728894	harbor2	chr4	57614242	57614837	LINE/L2	493	+	298	57614540	85646
chr4	185854361	186054361	harbor2	chr4	185859359	185859773	LINE/L2	437	+	207	185859566	5205
chr4	185854361	186054361	harbor2	chr4	185938554	185939513	LINE/L2	2217	+	480	185939034	84673
chr4	185854361	186054361	harbor2	chr4	185939810	185940869	LINE/L2	2217	+	530	185940340	85979
chr4	121875958	122075958	harbor2	chr4	121953117	121953825	LINE/L2	484	+	354	121953471	77513
chr4	121875958	122075958	harbor2	chr4	121963851	121963936	LINE/L2	3467	+	42	121963893	87935
chr4	121875958	122075958	harbor2	chr4	121964296	121964409	LINE/L2	3467	+	56	121964352	88394
chr4	121875958	122075958	harbor2	chr4	121964712	121965693	LINE/L2	3467	+	490	121965202	89244
chr4	151867175	152067175	harbor2	chr4	151890105	151890408	LINE/L2	593	+	152	151890257	23082
chr4	151867175	152067175	harbor2	chr4	151925581	151925886	LINE/L2	714	+	152	151925733	58558
chr4	151867175	152067175	harbor2	chr4	151926382	151926973	LINE/L2	726	+	296	151926678	59503
chr4	151867175	152067175	harbor2	chr4	151959806	151960049	LINE/L2	603	+	122	151959928	92753
chr4	161905581	162105581	harbor2	chr4	161909318	161910748	LINE/L2	1427	+	715	161910033	4452
chr4	161905581	162105581	harbor2	chr4	162004422	162004870	LINE/L2	509	+	224	162004646	99065
chr4	119055749	119255749	harbor2	chr4	119091445	119092290	LINE/L2	508	+	422	119091867	36118
chr4	119055749	119255749	harbor2	chr4	119126136	119126251	LINE/L2	437	+	58	119126194	70445
chr4	119055749	119255749	harbor2	chr4	119126331	119127197	LINE/L2	1821	+	433	119126764	71015
chr4	119055749	119255749	harbor2	chr4	119127484	119127567	LINE/L2	1375	+	42	119127526	71777
chr4	109287094	109487094	harbor2	chr4	109296372	109296550	LINE/L2	462	+	89	109296461	9367
chr4	109287094	109487094	harbor2	chr4	109304403	109304829	LINE/L2	735	+	213	109304616	17522
chr4	187310816	187510816	harbor2	chr4	187345435	187347173	LINE/L2	2880	+	869	187346304	35488
chr4	174823700	175023700	harbor2	chr4	174860065	174860452	LINE/L2	477	+	194	174860259	36559
chr4	165172284	165372284	harbor2	chr4	165193863	165194398	LINE/L2	1006	+	268	165194131	21847
chr4	165172284	165372284	harbor2	chr4	165204980	165205589	LINE/L2	1473	+	304	165205284	33000
chr4	165172284	165372284	harbor2	chr4	165217718	165218745	LINE/L2	1915	+	514	165218232	45948
chr4	165172284	165372284	harbor2	chr4	165226219	165226583	LINE/L2	451	+	182	165226401	54117
chr4	152082577	152282577	harbor2	chr4	152114291	152114485	LINE/L2	460	+	97	152114388	31811
chr4	152082577	152282577	harbor2	chr4	152114529	152114572	LINE/L2	460	+	22	152114551	31974
chr4	185453674	185653674	harbor2	chr4	185468426	185468984	LINE/L2	1570	+	279	185468705	15031
chr4	185453674	185653674	harbor2	chr4	185526651	185527097	LINE/L2	550	+	223	185526874	73200
chr4	58027995	58227995	harbor2	chr4	58056419	58056895	LINE/L2	960	+	238	58056657	28662
chr4	58027995	58227995	harbor2	chr4	58080577	58080728	LINE/L2	599	+	76	58080653	52658
chr4	58027995	58227995	harbor2	chr4	58080855	58081170	LINE/L2	807	+	158	58081013	53018
chr4	179089414	179289414	harbor2	chr4	179138504	179139168	LINE/L2	1163	+	332	179138836	49422
chr4	179089414	179289414	harbor2	chr4	179139205	179140879	LINE/L2	2492	+	837	179140042	50628
chr4	179089414	179289414	harbor2	chr4	179157351	179157709	LINE/L2	791	+	179	179157530	68116
chr4	154344083	154544083	harbor2	chr4	154345592	154345796	LINE/L2	469	+	102	154345694	1611
chr4	154344083	154544083	harbor2	chr4	154360922	154361038	LINE/L2	608	+	58	154360980	16897
chr4	154344083	154544083	harbor2	chr4	154384183	154384469	LINE/L2	664	+	143	154384326	40243
chr4	154344083	154544083	harbor2	chr4	154391240	154391408	LINE/L2	536	+	84	154391324	47241
chr4	154344083	154544083	harbor2	chr4	154421319	154421373	LINE/L2	1724	+	27	154421346	77263
chr4	154344083	154544083	harbor2	chr4	154421691	154422946	LINE/L2	1724	+	628	154422319	78236
chr4	154344083	154544083	harbor2	chr4	154442233	154443808	LINE/L2	2453	+	788	154443021	98938
chr4	154344083	154544083	harbor2	chr4	154386094	154386731	LINE/L2	1077	+	318	154386412	42329
chr4	177039932	177239932	harbor2	chr4	177082875	177083721	LINE/L2	545	+	423	177083298	43366
chr4	177039932	177239932	harbor2	chr4	177124856	177125377	LINE/L2	800	+	260	177125116	85184
chr4	130510100	130710100	harbor2	chr4	130527532	130528075	LINE/L2	568	+	272	130527804	17704
chr4	168612068	168812068	harbor2	chr4	168628310	168628925	LINE/L2	1337	+	308	168628618	16550
chr4	187333683	187533683	harbor2	chr4	187345435	187347173	LINE/L2	2880	+	869	187346304	12621
chr4	33356515	33556515	harbor2	chr4	33369626	33370096	LINE/L2	451	+	235	33369861	13346
chr4	33356515	33556515	harbor2	chr4	33430950	33431316	LINE/L2	1046	+	183	33431133	74618
chr4	33356515	33556515	harbor2	chr4	33444150	33444521	LINE/L2	537	+	186	33444336	87821
chr4	153043869	153243869	harbor2	chr4	153113224	153113695	LINE/L2	731	+	236	153113460	69591
chr4	159996176	160196176	harbor2	chr4	160094683	160094966	LINE/L2	635	+	142	160094825	98649
chr4	109647825	109847825	harbor2	chr4	109721683	109722341	LINE/L2	2231	+	329	109722012	74187
chr4	109647825	109847825	harbor2	chr4	109722704	109722925	LINE/L2	788	+	110	109722814	74989
chr4	109647825	109847825	harbor2	chr4	109725890	109726288	LINE/L2	1109	+	199	109726089	78264
chr4	109647825	109847825	harbor2	chr4	109726292	109726622	LINE/L2	1341	+	165	109726457	78632
chr4	109647825	109847825	harbor2	chr4	109727932	109728026	LINE/L2	432	+	47	109727979	80154
chr4	109647825	109847825	harbor2	chr4	109728021	109728386	LINE/L2	1156	+	182	109728203	80378
chr4	109647825	109847825	harbor2	chr4	109746922	109747126	LINE/L2	423	+	102	109747024	99199
chr4	188424485	188624485	harbor2	chr4	188486873	188487598	LINE/L2	434	+	362	188487235	62750
chr4	140506263	140706263	harbor2	chr4	140523174	140523504	LINE/L2	850	+	165	140523339	17076
chr4	140506263	140706263	harbor2	chr4	140529556	140530031	LINE/L2	1164	+	238	140529794	23531
chr4	140506263	140706263	harbor2	chr4	140544447	140544857	LINE/L2	437	+	205	140544652	38389
chr4	140506263	140706263	harbor2	chr4	140544942	140545492	LINE/L2	808	+	275	140545217	38954
chr4	140506263	140706263	harbor2	chr4	140565164	140565811	LINE/L2	604	+	324	140565488	59225
chr4	140506263	140706263	harbor2	chr4	140584230	140584637	LINE/L2	572	+	204	140584434	78171
chr4	124972812	125172812	harbor2	chr4	124981870	124982068	LINE/L2	548	+	99	124981969	9157
chr4	124972812	125172812	harbor2	chr4	124982412	124982747	LINE/L2	790	+	168	124982580	9768
chr4	124972812	125172812	harbor2	chr4	125002244	125003808	LINE/L2	1606	+	782	125003026	30214
chr4	124972812	125172812	harbor2	chr4	125004264	125004596	LINE/L2	508	+	166	125004430	31618
chr4	178886762	179086762	harbor2	chr4	178982844	178983242	LINE/L2	708	+	199	178983043	96281
chr4	154671835	154871835	harbor2	chr4	154680718	154681052	LINE/L2	859	+	167	154680885	9050
chr4	154671835	154871835	harbor2	chr4	154681811	154682849	LINE/L2	965	+	519	154682330	10495
chr4	154671835	154871835	harbor2	chr4	154688472	154689837	LINE/L2	2601	+	682	154689154	17319
chr4	154671835	154871835	harbor2	chr4	154694755	154694861	LINE/L2	440	+	53	154694808	22973
chr4	154671835	154871835	harbor2	chr4	154695347	154695450	LINE/L2	456	+	52	154695399	23564
chr4	154671835	154871835	harbor2	chr4	154732693	154733600	LINE/L2	673	+	454	154733147	61312
chr4	130299544	130499544	harbor2	chr4	130366360	130366856	LINE/L2	519	+	248	130366608	67064
chr4	180151781	180351781	harbor2	chr4	180199299	180199642	LINE/L2	983	+	172	180199471	47690
chr4	189291574	189491574	harbor2	chr4	189300013	189300244	LINE/L2	432	+	116	189300129	8555
chr4	189291574	189491574	harbor2	chr4	189301552	189302222	LINE/L2	741	+	335	189301887	10313
chr4	189291574	189491574	harbor2	chr4	189376298	189376585	LINE/L2	765	+	144	189376442	84868
chr4	189291574	189491574	harbor2	chr4	189376813	189376955	LINE/L2	765	+	71	189376884	85310
chr4	189291574	189491574	harbor2	chr4	189383994	189384424	LINE/L2	497	+	215	189384209	92635
chr4	177051446	177251446	harbor2	chr4	177082875	177083721	LINE/L2	545	+	423	177083298	31852
chr4	177051446	177251446	harbor2	chr4	177124856	177125377	LINE/L2	800	+	260	177125116	73670
chr4	184244382	184444382	harbor2	chr4	184269752	184270444	LINE/L2	1374	+	346	184270098	25716
chr4	141559591	141759591	harbor2	chr4	141576053	141576767	LINE/L2	1421	+	357	141576410	16819
chr4	141559591	141759591	harbor2	chr4	141577222	141577589	LINE/L2	882	+	184	141577406	17815
chr4	141559591	141759591	harbor2	chr4	141577768	141578002	LINE/L2	871	+	117	141577885	18294
chr4	141559591	141759591	harbor2	chr4	141578485	141578514	LINE/L2	871	+	14	141578499	18908
chr4	141559591	141759591	harbor2	chr4	141643149	141644238	LINE/L2	2364	+	544	141643693	84102
chr4	141559591	141759591	harbor2	chr4	141646161	141646555	LINE/L2	870	+	197	141646358	86767
chr4	141559591	141759591	harbor2	chr4	141646794	141646948	LINE/L2	599	+	77	141646871	87280
chr4	161542686	161742686	harbor2	chr4	161583824	161584805	LINE/L2	1346	+	490	161584314	41628
chr4	161542686	161742686	harbor2	chr4	161586123	161586845	LINE/L2	1009	+	361	161586484	43798
chr4	101613330	101813330	harbor2	chr4	101699662	101700183	LINE/L2	1124	+	260	101699922	86592
chr4	101613330	101813330	harbor2	chr4	101700354	101700517	LINE/L2	1124	+	82	101700436	87106
chr4	104273120	104473120	harbor2	chr4	104279106	104281013	LINE/L2	2614	+	954	104280060	6940
chr4	104273120	104473120	harbor2	chr4	104290033	104290488	LINE/L2	675	+	228	104290261	17141
chr4	104273120	104473120	harbor2	chr4	104331015	104331269	LINE/L2	562	+	127	104331142	58022
chr4	104273120	104473120	harbor2	chr4	104331830	104332107	LINE/L2	585	+	138	104331968	58848
chr4	104273120	104473120	harbor2	chr4	104372134	104372441	LINE/L2	480	+	154	104372288	99168
chr4	53120112	53320112	harbor2	chr4	53158284	53158637	LINE/L2	599	+	176	53158460	38348
chr4	53120112	53320112	harbor2	chr4	53165587	53165829	LINE/L2	810	+	121	53165708	45596
chr4	53120112	53320112	harbor2	chr4	53190299	53190741	LINE/L2	1211	+	221	53190520	70408
chr4	53120112	53320112	harbor2	chr4	53219997	53220206	LINE/L2	529	+	104	53220101	99989
chr4	101155520	101355520	harbor2	chr4	101164095	101164441	LINE/L2	863	+	173	101164268	8748
chr4	101155520	101355520	harbor2	chr4	101224811	101225361	LINE/L2	1102	+	275	101225086	69566
chr4	164512770	164712770	harbor2	chr4	164530393	164531084	LINE/L2	1252	+	346	164530739	17969
chr4	164512770	164712770	harbor2	chr4	164531608	164532151	LINE/L2	1252	+	272	164531880	19110
chr4	63650230	63850230	harbor2	chr4	63725668	63725819	LINE/L2	441	+	76	63725744	75514
chr4	95534468	95734468	harbor2	chr4	95552004	95552327	LINE/L2	668	+	162	95552166	17698
chr4	95534468	95734468	harbor2	chr4	95591018	95591438	LINE/L2	661	+	210	95591228	56760
chr4	95534468	95734468	harbor2	chr4	95626307	95626702	LINE/L2	732	+	198	95626505	92037
chr4	95534468	95734468	harbor2	chr4	95629370	95630336	LINE/L2	898	+	483	95629853	95385
chr4	95534468	95734468	harbor2	chr4	95551358	95551542	LINE/L2	471	+	92	95551450	16982
chr4	70954344	71154344	harbor2	chr4	71024027	71024159	LINE/L2	487	+	66	71024093	69749
chr4	178411078	178611078	harbor2	chr4	178419937	178420587	LINE/L2	896	+	325	178420262	9184
chr5	181073602	181273602	harbor2	chr5	181085416	181085727	LINE/L2	677	+	156	181085572	11970
chr5	181073602	181273602	harbor2	chr5	181126047	181126413	LINE/L2	1145	+	183	181126230	52628
chr5	181073602	181273602	harbor2	chr5	181126931	181127259	LINE/L2	409	+	164	181127095	53493
chr5	181073602	181273602	harbor2	chr5	181127903	181128192	LINE/L2	475	+	144	181128047	54445
chr5	181073602	181273602	harbor2	chr5	181128222	181128936	LINE/L2	519	+	357	181128579	54977
chr5	176921320	177121320	harbor2	chr5	176921109	176921398	LINE/L2	918	+	144	176921253	67
chr5	176921320	177121320	harbor2	chr5	176921408	176922286	LINE/L2	1454	+	439	176921847	527
chr5	176921320	177121320	harbor2	chr5	176936413	176937063	LINE/L2	1335	+	325	176936738	15418
chr5	176921320	177121320	harbor2	chr5	176948510	176948717	LINE/L2	482	+	104	176948614	27294
chr5	176921320	177121320	harbor2	chr5	176971073	176971192	LINE/L2	490	+	60	176971133	49813
chr5	176921320	177121320	harbor2	chr5	177020128	177020435	LINE/L2	1225	+	154	177020282	98962
chr5	176921320	177121320	harbor2	chr5	177020730	177020874	LINE/L2	1225	+	72	177020802	99482
chr5	82401398	82601398	harbor2	chr5	82490831	82491175	LINE/L2	401	+	172	82491003	89605
chr5	31458572	31658572	harbor2	chr5	31527324	31527493	LINE/L2	806	+	84	31527408	68836
chr5	31458572	31658572	harbor2	chr5	31527840	31528675	LINE/L2	806	+	418	31528258	69686
chr5	31458572	31658572	harbor2	chr5	31530668	31530954	LINE/L2	562	+	143	31530811	72239
chr5	161766411	161966411	harbor2	chr5	161782103	161782516	LINE/L2	468	+	206	161782309	15898
chr5	161766411	161966411	harbor2	chr5	161796963	161797097	LINE/L2	471	+	67	161797030	30619
chr5	161766411	161966411	harbor2	chr5	161802255	161802424	LINE/L2	423	+	84	161802339	35928
chr5	161766411	161966411	harbor2	chr5	161804778	161805142	LINE/L2	463	+	182	161804960	38549
chr5	161766411	161966411	harbor2	chr5	161806427	161806577	LINE/L2	473	+	75	161806502	40091
chr5	161766411	161966411	harbor2	chr5	161813130	161813180	LINE/L2	981	+	25	161813155	46744
chr5	161766411	161966411	harbor2	chr5	161813481	161813805	LINE/L2	981	+	162	161813643	47232
chr5	161766411	161966411	harbor2	chr5	161862114	161862488	LINE/L2	397	+	187	161862301	95890
chr5	145988895	146188895	harbor2	chr5	146009211	146009672	LINE/L2	438	+	230	146009441	20546
chr5	177002174	177202174	harbor2	chr5	177020128	177020435	LINE/L2	1225	+	154	177020282	18108
chr5	177002174	177202174	harbor2	chr5	177020730	177020874	LINE/L2	1225	+	72	177020802	18628
chr5	177002174	177202174	harbor2	chr5	177037211	177038074	LINE/L2	1964	+	432	177037643	35469
chr5	177002174	177202174	harbor2	chr5	177072995	177073233	LINE/L2	490	+	119	177073114	70940
chr5	177002174	177202174	harbor2	chr5	177083548	177083662	LINE/L2	399	+	57	177083605	81431
chr5	177002174	177202174	harbor2	chr5	177083968	177084054	LINE/L2	399	+	43	177084011	81837
chr5	105934595	106134595	harbor2	chr5	105934918	105935350	LINE/L2	422	+	216	105935134	539
chr5	159589011	159789011	harbor2	chr5	159595460	159595602	LINE/L2	1578	+	71	159595531	6520
chr5	159589011	159789011	harbor2	chr5	159595968	159596243	LINE/L2	1578	+	138	159596106	7095
chr5	159589011	159789011	harbor2	chr5	159597236	159597327	LINE/L2	1578	+	46	159597282	8271
chr5	159589011	159789011	harbor2	chr5	159597638	159598008	LINE/L2	1578	+	185	159597823	8812
chr5	159589011	159789011	harbor2	chr5	159598395	159599137	LINE/L2	1578	+	371	159598766	9755
chr5	159589011	159789011	harbor2	chr5	159603038	159603324	LINE/L2	541	+	143	159603181	14170
chr5	159589011	159789011	harbor2	chr5	159618966	159619105	LINE/L2	424	+	70	159619036	30025
chr5	159589011	159789011	harbor2	chr5	159633597	159633971	LINE/L2	642	+	187	159633784	44773
chr5	159589011	159789011	harbor2	chr5	159634275	159634362	LINE/L2	531	+	44	159634319	45308
chr5	159589011	159789011	harbor2	chr5	159634401	159634480	LINE/L2	531	+	40	159634441	45430
chr5	159589011	159789011	harbor2	chr5	159651148	159652065	LINE/L2	943	+	458	159651606	62595
chr5	159589011	159789011	harbor2	chr5	159664865	159665025	LINE/L2	458	+	80	159664945	75934
chr5	159589011	159789011	harbor2	chr5	159668950	159669182	LINE/L2	694	+	116	159669066	80055
chr5	159589011	159789011	harbor2	chr5	159596537	159596709	LINE/L2	1578	+	86	159596623	7612
chr5	118836607	119036607	harbor2	chr5	118912364	118912782	LINE/L2	672	+	209	118912573	75966
chr5	142828247	143028247	harbor2	chr5	142883634	142883978	LINE/L2	442	+	172	142883806	55559
chr5	177904189	178104189	harbor2	chr5	177925453	177925604	LINE/L2	1162	+	76	177925529	21340
chr5	177904189	178104189	harbor2	chr5	177925952	177926292	LINE/L2	1162	+	170	177926122	21933
chr5	167891917	168091917	harbor2	chr5	167894339	167894667	LINE/L2	407	+	164	167894503	2586
chr5	167891917	168091917	harbor2	chr5	167940747	167940919	LINE/L2	655	+	86	167940833	48916
chr5	159756297	159956297	harbor2	chr5	159769205	159769451	LINE/L2	486	+	123	159769328	13031
chr5	159756297	159956297	harbor2	chr5	159778340	159778451	LINE/L2	394	+	56	159778396	22099
chr5	159756297	159956297	harbor2	chr5	159794777	159795360	LINE/L2	538	+	292	159795069	38772
chr5	159756297	159956297	harbor2	chr5	159796388	159796508	LINE/L2	403	+	60	159796448	40151
chr5	159756297	159956297	harbor2	chr5	159836856	159838388	LINE/L2	2451	+	766	159837622	81325
chr5	159756297	159956297	harbor2	chr5	159838864	159839023	LINE/L2	705	+	80	159838944	82647
chr5	159756297	159956297	harbor2	chr5	159845041	159845361	LINE/L2	542	+	160	159845201	88904
chr5	180973011	181173011	harbor2	chr5	180996655	180996978	LINE/L2	417	+	162	180996817	23806
chr5	61111041	61311041	harbor2	chr5	61132122	61132283	LINE/L2	553	+	80	61132202	21161
chr5	61111041	61311041	harbor2	chr5	61140304	61140469	LINE/L2	598	+	82	61140386	29345
chr5	61111041	61311041	harbor2	chr5	61140652	61140946	LINE/L2	598	+	147	61140799	29758
chr5	61111041	61311041	harbor2	chr5	61203448	61203818	LINE/L2	748	+	185	61203633	92592
chr5	61111041	61311041	harbor2	chr5	61204912	61205107	LINE/L2	438	+	98	61205010	93969
chr5	61111041	61311041	harbor2	chr5	61208249	61208783	LINE/L2	875	+	267	61208516	97475
chr5	163637416	163837416	harbor2	chr5	163665049	163665463	LINE/L2	770	+	207	163665256	27840
chr5	163637416	163837416	harbor2	chr5	163666097	163666231	LINE/L2	587	+	67	163666164	28748
chr5	163637416	163837416	harbor2	chr5	163667584	163668022	LINE/L2	1097	+	219	163667803	30387
chr5	163637416	163837416	harbor2	chr5	163668541	163668816	LINE/L2	753	+	138	163668679	31263
chr5	163637416	163837416	harbor2	chr5	163679218	163679654	LINE/L2	839	+	218	163679436	42020
chr5	163637416	163837416	harbor2	chr5	163693113	163693237	LINE/L2	502	+	62	163693175	55759
chr5	163637416	163837416	harbor2	chr5	163694612	163694902	LINE/L2	476	+	145	163694757	57341
chr5	163637416	163837416	harbor2	chr5	163705287	163705893	LINE/L2	1105	+	303	163705590	68174
chr5	163637416	163837416	harbor2	chr5	163676026	163676474	LINE/L2	912	+	224	163676250	38834
chr5	126826315	127026315	harbor2	chr5	126884682	126885012	LINE/L2	767	+	165	126884847	58532
chr5	126826315	127026315	harbor2	chr5	126886644	126887193	LINE/L2	768	+	274	126886918	60603
chr5	126826315	127026315	harbor2	chr5	126887646	126888085	LINE/L2	768	+	220	126887866	61551
chr5	175697246	175897246	harbor2	chr5	175710018	175710286	LINE/L2	515	+	134	175710152	12906
chr5	175697246	175897246	harbor2	chr5	175754074	175754698	LINE/L2	513	+	312	175754386	57140
chr5	175697246	175897246	harbor2	chr5	175786807	175787300	LINE/L2	925	+	246	175787053	89807
chr5	144213599	144413599	harbor2	chr5	144214047	144214951	LINE/L2	703	+	452	144214499	900
chr5	144213599	144413599	harbor2	chr5	144248995	144249529	LINE/L2	529	+	267	144249262	35663
chr5	169999990	170199990	harbor2	chr5	170006687	170006812	LINE/L2	409	+	62	170006749	6759
chr5	169999990	170199990	harbor2	chr5	170027427	170027800	LINE/L2	435	+	186	170027613	27623
chr5	169999990	170199990	harbor2	chr5	170042186	170042929	LINE/L2	973	+	372	170042558	42568
chr5	169999990	170199990	harbor2	chr5	170051236	170051775	LINE/L2	701	+	270	170051506	51516
chr5	169999990	170199990	harbor2	chr5	170059493	170059747	LINE/L2	402	+	127	170059620	59630
chr5	150220775	150420775	harbor2	chr5	150249394	150249541	LINE/L2	546	+	74	150249468	28693
chr5	150220775	150420775	harbor2	chr5	150249848	150250132	LINE/L2	546	+	142	150249990	29215
chr5	150220775	150420775	harbor2	chr5	150253983	150254388	LINE/L2	659	+	202	150254185	33410
chr5	150220775	150420775	harbor2	chr5	150268168	150268666	LINE/L2	883	+	249	150268417	47642
chr5	150220775	150420775	harbor2	chr5	150299212	150299499	LINE/L2	475	+	144	150299356	78581
chr5	20852635	21052635	harbor2	chr5	20859195	20859870	LINE/L2	1043	+	338	20859533	6898
chr5	20852635	21052635	harbor2	chr5	20859874	20860230	LINE/L2	633	+	178	20860052	7417
chr5	20852635	21052635	harbor2	chr5	20943321	20943687	LINE/L2	440	+	183	20943504	90869
chr5	52189204	52389204	harbor2	chr5	52204517	52205120	LINE/L2	906	+	302	52204819	15615
chr5	52189204	52389204	harbor2	chr5	52226612	52227133	LINE/L2	1193	+	260	52226872	37668
chr5	101369248	101569248	harbor2	chr5	101405869	101406362	LINE/L2	446	+	246	101406115	36867
chr5	101369248	101569248	harbor2	chr5	101410265	101410748	LINE/L2	899	+	242	101410507	41259
chr5	94575234	94775234	harbor2	chr5	94643968	94644927	LINE/L2	733	+	480	94644448	69214
chr5	40531462	40731462	harbor2	chr5	40628738	40628960	LINE/L2	652	+	111	40628849	97387
chr5	179132808	179332808	harbor2	chr5	179202194	179202615	LINE/L2	430	+	210	179202404	69596
chr5	138841551	139041551	harbor2	chr5	138859346	138859597	LINE/L2	689	+	126	138859472	17921
chr5	138841551	139041551	harbor2	chr5	138926899	138927703	LINE/L2	846	+	402	138927301	85750
chr5	171824318	172024318	harbor2	chr5	171825706	171825824	LINE/L2	491	+	59	171825765	1447
chr5	104905028	105105028	harbor2	chr5	104947973	104948355	LINE/L2	473	+	191	104948164	43136
chr5	104905028	105105028	harbor2	chr5	104948645	104949090	LINE/L2	473	+	222	104948867	43839
chr5	133835261	134035261	harbor2	chr5	133885824	133886466	LINE/L2	1338	+	321	133886145	50884
chr5	133835261	134035261	harbor2	chr5	133888678	133888961	LINE/L2	1763	+	142	133888820	53559
chr5	133835261	134035261	harbor2	chr5	133924655	133925709	LINE/L2	1295	+	527	133925182	89921
chr5	133835261	134035261	harbor2	chr5	133889551	133890162	LINE/L2	1763	+	306	133889857	54596
chr5	122360405	122560405	harbor2	chr5	122413127	122413648	LINE/L2	420	+	260	122413387	52982
chr5	168783581	168983581	harbor2	chr5	168787396	168787783	LINE/L2	486	+	194	168787590	4009
chr5	168783581	168983581	harbor2	chr5	168794642	168795097	LINE/L2	640	+	228	168794870	11289
chr5	168783581	168983581	harbor2	chr5	168804796	168805239	LINE/L2	750	+	222	168805018	21437
chr5	173442534	173642534	harbor2	chr5	173453131	173453316	LINE/L2	494	+	92	173453223	10689
chr5	173442534	173642534	harbor2	chr5	173473128	173473516	LINE/L2	577	+	194	173473322	30788
chr5	173442534	173642534	harbor2	chr5	173511883	173513155	LINE/L2	2286	+	636	173512519	69985
chr5	173442534	173642534	harbor2	chr5	173524162	173524414	LINE/L2	739	+	126	173524288	81754
chr5	173442534	173642534	harbor2	chr5	173524915	173525038	LINE/L2	1358	+	62	173524977	82443
chr5	173442534	173642534	harbor2	chr5	173525402	173526080	LINE/L2	1358	+	339	173525741	83207
chr5	136916114	137116114	harbor2	chr5	136918008	136918146	LINE/L2	553	+	69	136918077	1963
chr5	136916114	137116114	harbor2	chr5	136923321	136923804	LINE/L2	685	+	242	136923563	7449
chr5	136916114	137116114	harbor2	chr5	136936644	136936876	LINE/L2	804	+	116	136936760	20646
chr5	136916114	137116114	harbor2	chr5	136997293	136997963	LINE/L2	606	+	335	136997628	81514
chr5	156503327	156703327	harbor2	chr5	156511267	156511560	LINE/L2	518	+	146	156511413	8086
chr5	156503327	156703327	harbor2	chr5	156527892	156528100	LINE/L2	421	+	104	156527996	24669
chr5	156503327	156703327	harbor2	chr5	156551038	156551359	LINE/L2	408	+	160	156551198	47871
chr5	156503327	156703327	harbor2	chr5	156583214	156583657	LINE/L2	588	+	222	156583436	80109
chr5	127471103	127671103	harbor2	chr5	127515373	127516077	LINE/L2	868	+	352	127515725	44622
chr5	127471103	127671103	harbor2	chr5	127519304	127520066	LINE/L2	524	+	381	127519685	48582
chr5	127471103	127671103	harbor2	chr5	127534137	127534987	LINE/L2	1708	+	425	127534562	63459
chr5	164357347	164557347	harbor2	chr5	164445057	164445694	LINE/L2	736	+	318	164445375	88028
chr5	164357347	164557347	harbor2	chr5	164447326	164447501	LINE/L2	603	+	88	164447414	90067
chr5	139313290	139513290	harbor2	chr5	139397438	139397547	LINE/L2	1006	+	54	139397492	84202
chr5	139313290	139513290	harbor2	chr5	139397851	139398044	LINE/L2	1006	+	96	139397947	84657
chr5	167911709	168111709	harbor2	chr5	167940747	167940919	LINE/L2	655	+	86	167940833	29124
chr5	70086314	70286314	harbor2	chr5	70124005	70124111	LINE/L2	400	+	53	70124058	37744
chr5	70086314	70286314	harbor2	chr5	70169470	70169682	LINE/L2	399	+	106	70169576	83262
chr5	95518556	95718556	harbor2	chr5	95545282	95546742	LINE/L2	1262	+	730	95546012	27456
chr5	95518556	95718556	harbor2	chr5	95547257	95547623	LINE/L2	1116	+	183	95547440	28884
chr5	95518556	95718556	harbor2	chr5	95564384	95565044	LINE/L2	1261	+	330	95564714	46158
chr5	95518556	95718556	harbor2	chr5	95565440	95565733	LINE/L2	562	+	146	95565586	47030
chr5	95518556	95718556	harbor2	chr5	95569932	95570372	LINE/L2	839	+	220	95570152	51596
chr5	95518556	95718556	harbor2	chr5	95589001	95589272	LINE/L2	615	+	136	95589137	70581
chr5	95518556	95718556	harbor2	chr5	95598518	95599150	LINE/L2	1476	+	316	95598834	80278
chr5	95518556	95718556	harbor2	chr5	95607355	95608050	LINE/L2	1261	+	348	95607703	89147
chr5	118920277	119120277	harbor2	chr5	118953896	118953988	LINE/L2	837	+	46	118953942	33665
chr5	118920277	119120277	harbor2	chr5	118954262	118954514	LINE/L2	837	+	126	118954388	34111
chr5	118920277	119120277	harbor2	chr5	118990384	118990547	LINE/L2	478	+	82	118990466	70189
chr5	162608921	162808921	harbor2	chr5	162613233	162614516	LINE/L2	2847	+	642	162613875	4954
chr5	162608921	162808921	harbor2	chr5	162614533	162614901	LINE/L2	548	+	184	162614717	5796
chr5	162608921	162808921	harbor2	chr5	162656336	162656657	LINE/L2	572	+	160	162656496	47575
chr5	124542505	124742505	harbor2	chr5	124593735	124593922	LINE/L2	440	+	94	124593829	51324
chr5	124542505	124742505	harbor2	chr5	124624937	124625049	LINE/L2	679	+	56	124624993	82488
chr5	124542505	124742505	harbor2	chr5	124626160	124626356	LINE/L2	679	+	98	124626258	83753
chr5	124542505	124742505	harbor2	chr5	124636143	124636506	LINE/L2	1095	+	182	124636325	93820
chr5	160658958	160858958	harbor2	chr5	160698048	160698369	LINE/L2	394	+	160	160698208	39250
chr5	160658958	160858958	harbor2	chr5	160700781	160701335	LINE/L2	743	+	277	160701058	42100
chr5	160658958	160858958	harbor2	chr5	160724587	160725075	LINE/L2	1495	+	244	160724831	65873
chr5	160658958	160858958	harbor2	chr5	160750368	160751187	LINE/L2	470	+	410	160750778	91820
chr5	114127597	114327597	harbor2	chr5	114167377	114167597	LINE/L2	420	+	110	114167487	39890
chr5	114127597	114327597	harbor2	chr5	114225523	114225615	LINE/L2	564	+	46	114225569	97972
chr5	153729797	153929797	harbor2	chr5	153745027	153745278	LINE/L2	421	+	126	153745153	15356
chr5	153729797	153929797	harbor2	chr5	153787721	153787832	LINE/L2	606	+	56	153787777	57980
chr5	153729797	153929797	harbor2	chr5	153788099	153788516	LINE/L2	606	+	208	153788307	58510
chr5	153729797	153929797	harbor2	chr5	153818595	153819008	LINE/L2	599	+	206	153818801	89004
chr5	153729797	153929797	harbor2	chr5	153828765	153829272	LINE/L2	711	+	254	153829019	99222
chr5	125025909	125225909	harbor2	chr5	125069267	125069395	LINE/L2	666	+	64	125069331	43422
chr5	125025909	125225909	harbor2	chr5	125069755	125069902	LINE/L2	666	+	74	125069829	43920
chr5	125025909	125225909	harbor2	chr5	125084637	125084869	LINE/L2	1505	+	116	125084753	58844
chr5	125025909	125225909	harbor2	chr5	125085248	125085274	LINE/L2	1505	+	13	125085261	59352
chr5	125025909	125225909	harbor2	chr5	125085580	125085899	LINE/L2	1505	+	160	125085740	59831
chr5	125025909	125225909	harbor2	chr5	125087146	125087556	LINE/L2	889	+	205	125087351	61442
chr5	125025909	125225909	harbor2	chr5	125111180	125112013	LINE/L2	597	+	416	125111596	85687
chr5	137063624	137263624	harbor2	chr5	137092488	137092683	LINE/L2	432	+	98	137092586	28962
chr5	137063624	137263624	harbor2	chr5	137106605	137107300	LINE/L2	666	+	348	137106953	43329
chr5	137063624	137263624	harbor2	chr5	137109644	137110064	LINE/L2	584	+	210	137109854	46230
chr5	55075675	55275675	harbor2	chr5	55094653	55094880	LINE/L2	577	+	114	55094767	19092
chr5	55075675	55275675	harbor2	chr5	55118888	55119066	LINE/L2	632	+	89	55118977	43302
chr5	152085270	152285270	harbor2	chr5	152094452	152094593	LINE/L2	462	+	70	152094522	9252
chr5	152085270	152285270	harbor2	chr5	152163649	152164010	LINE/L2	477	+	180	152163829	78559
chr5	151857548	152057548	harbor2	chr5	151910801	151911007	LINE/L2	524	+	103	151910904	53356
chr5	151857548	152057548	harbor2	chr5	151945531	151945768	LINE/L2	585	+	118	151945649	88101
chr5	114120565	114320565	harbor2	chr5	114124578	114125064	LINE/L2	1137	+	243	114124821	4256
chr5	114120565	114320565	harbor2	chr5	114167377	114167597	LINE/L2	420	+	110	114167487	46922
chr5	171176720	171376720	harbor2	chr5	171211229	171211269	LINE/L2	460	+	20	171211249	34529
chr5	171176720	171376720	harbor2	chr5	171211561	171211713	LINE/L2	460	+	76	171211637	34917
chr5	171176720	171376720	harbor2	chr5	171238741	171239085	LINE/L2	714	+	172	171238913	62193
chr5	171176720	171376720	harbor2	chr5	171246938	171247044	LINE/L2	476	+	53	171246991	70271
chr5	126835857	127035857	harbor2	chr5	126884682	126885012	LINE/L2	767	+	165	126884847	48990
chr5	126835857	127035857	harbor2	chr5	126886644	126887193	LINE/L2	768	+	274	126886918	51061
chr5	126835857	127035857	harbor2	chr5	126887646	126888085	LINE/L2	768	+	220	126887866	52009
chr5	180587314	180787314	harbor2	chr5	180604215	180604673	LINE/L2	577	+	229	180604444	17130
chr5	180587314	180787314	harbor2	chr5	180636194	180636819	LINE/L2	467	+	312	180636506	49192
chr5	136458615	136658615	harbor2	chr5	136468044	136468412	LINE/L2	1109	+	184	136468228	9613
chr5	136458615	136658615	harbor2	chr5	136485456	136486128	LINE/L2	934	+	336	136485792	27177
chr5	136458615	136658615	harbor2	chr5	136534451	136534788	LINE/L2	434	+	168	136534619	76004
chr5	136458615	136658615	harbor2	chr5	136535099	136535116	LINE/L2	434	+	8	136535107	76492
chr5	123064590	123264590	harbor2	chr5	123085055	123085241	LINE/L2	431	+	93	123085148	20558
chr5	123064590	123264590	harbor2	chr5	123145287	123145429	LINE/L2	540	+	71	123145358	80768
chr5	165094344	165294344	harbor2	chr5	165118710	165119322	LINE/L2	654	+	306	165119016	24672
chr5	165094344	165294344	harbor2	chr5	165157745	165158277	LINE/L2	827	+	266	165158011	63667
chr5	165094344	165294344	harbor2	chr5	165165634	165165985	LINE/L2	799	+	176	165165810	71466
chr5	165094344	165294344	harbor2	chr5	165169362	165169552	LINE/L2	447	+	95	165169457	75113
chr5	118015574	118215574	harbor2	chr5	118088412	118089091	LINE/L2	696	+	340	118088752	73178
chr5	118015574	118215574	harbor2	chr5	118103525	118103652	LINE/L2	401	+	64	118103589	88015
chr5	174853857	175053857	harbor2	chr5	174870482	174871137	LINE/L2	1366	+	328	174870810	16953
chr5	174853857	175053857	harbor2	chr5	174871345	174871377	LINE/L2	695	+	16	174871361	17504
chr5	174853857	175053857	harbor2	chr5	174871436	174871861	LINE/L2	695	+	212	174871648	17791
chr5	174853857	175053857	harbor2	chr5	174937772	174938083	LINE/L2	410	+	156	174937928	84071
chr5	174853857	175053857	harbor2	chr5	174948527	174948863	LINE/L2	409	+	168	174948695	94838
chr5	161804975	162004975	harbor2	chr5	161804778	161805142	LINE/L2	463	+	182	161804960	15
chr5	161804975	162004975	harbor2	chr5	161806427	161806577	LINE/L2	473	+	75	161806502	1527
chr5	161804975	162004975	harbor2	chr5	161813130	161813180	LINE/L2	981	+	25	161813155	8180
chr5	161804975	162004975	harbor2	chr5	161813481	161813805	LINE/L2	981	+	162	161813643	8668
chr5	161804975	162004975	harbor2	chr5	161862114	161862488	LINE/L2	397	+	187	161862301	57326
chr5	161804975	162004975	harbor2	chr5	161877804	161878152	LINE/L2	630	+	174	161877978	73003
chr5	161804975	162004975	harbor2	chr5	161882019	161882369	LINE/L2	751	+	175	161882194	77219
chr5	151143263	151343263	harbor2	chr5	151143675	151143788	LINE/L2	459	+	56	151143731	468
chr5	151143263	151343263	harbor2	chr5	151186805	151187111	LINE/L2	604	+	153	151186958	43695
chr5	168449687	168649687	harbor2	chr5	168485905	168486154	LINE/L2	465	+	124	168486029	36342
chr5	168449687	168649687	harbor2	chr5	168538510	168538701	LINE/L2	594	+	96	168538606	88919
chr5	126152987	126352987	harbor2	chr5	126180875	126180897	LINE/L2	506	+	11	126180886	27899
chr5	126152987	126352987	harbor2	chr5	126181365	126181520	LINE/L2	506	+	78	126181443	28456
chr5	126152987	126352987	harbor2	chr5	126181980	126182800	LINE/L2	855	+	410	126182390	29403
chr5	61047037	61247037	harbor2	chr5	61077997	61078314	LINE/L2	680	+	158	61078155	31118
chr5	61047037	61247037	harbor2	chr5	61098733	61098937	LINE/L2	600	+	102	61098835	51798
chr5	61047037	61247037	harbor2	chr5	61132122	61132283	LINE/L2	553	+	80	61132202	85165
chr5	61047037	61247037	harbor2	chr5	61140304	61140469	LINE/L2	598	+	82	61140386	93349
chr5	61047037	61247037	harbor2	chr5	61140652	61140946	LINE/L2	598	+	147	61140799	93762
chr5	132619090	132819090	harbor2	chr5	132644194	132644350	LINE/L2	486	+	78	132644272	25182
chr5	132619090	132819090	harbor2	chr5	132644624	132644775	LINE/L2	1209	+	76	132644700	25610
chr5	132619090	132819090	harbor2	chr5	132645030	132645344	LINE/L2	1209	+	157	132645187	26097
chr5	132619090	132819090	harbor2	chr5	132645414	132645544	LINE/L2	548	+	65	132645479	26389
chr5	132619090	132819090	harbor2	chr5	132646200	132646533	LINE/L2	1365	+	166	132646366	27276
chr5	132619090	132819090	harbor2	chr5	132646878	132647023	LINE/L2	1365	+	72	132646950	27860
chr5	132619090	132819090	harbor2	chr5	132651249	132651456	LINE/L2	1198	+	104	132651353	32263
chr5	132619090	132819090	harbor2	chr5	132651813	132652151	LINE/L2	1198	+	169	132651982	32892
chr5	116550415	116750415	harbor2	chr5	116559859	116560453	LINE/L2	475	+	297	116560156	9741
chr5	116550415	116750415	harbor2	chr5	116578343	116578434	LINE/L2	462	+	46	116578389	27974
chr5	116550415	116750415	harbor2	chr5	116578604	116579603	LINE/L2	462	+	500	116579104	28689
chr5	116550415	116750415	harbor2	chr5	116579916	116580120	LINE/L2	462	+	102	116580018	29603
chr5	116550415	116750415	harbor2	chr5	116580429	116580710	LINE/L2	462	+	140	116580569	30154
chr5	116550415	116750415	harbor2	chr5	116581056	116581661	LINE/L2	698	+	302	116581358	30943
chr5	116550415	116750415	harbor2	chr5	116583997	116584805	LINE/L2	1400	+	404	116584401	33986
chr5	116550415	116750415	harbor2	chr5	116594400	116595023	LINE/L2	934	+	312	116594712	44297
chr5	71982624	72182624	harbor2	chr5	72001879	72002015	LINE/L2	520	+	68	72001947	19323
chr5	71982624	72182624	harbor2	chr5	72024218	72024376	LINE/L2	553	+	79	72024297	41673
chr5	71982624	72182624	harbor2	chr5	72038785	72039335	LINE/L2	1835	+	275	72039060	56436
chr5	71982624	72182624	harbor2	chr5	72039652	72039902	LINE/L2	1209	+	125	72039777	57153
chr5	71982624	72182624	harbor2	chr5	72068219	72068539	LINE/L2	527	+	160	72068379	85755
chr5	111847443	112047443	harbor2	chr5	111857661	111857794	LINE/L2	574	+	66	111857727	10284
chr5	83878015	84078015	harbor2	chr5	83894698	83894945	LINE/L2	414	+	124	83894822	16807
chr5	83878015	84078015	harbor2	chr5	83936456	83936701	LINE/L2	418	+	122	83936578	58563
chr5	90721858	90921858	harbor2	chr5	90725912	90726653	LINE/L2	1633	+	370	90726282	4424
chr5	90721858	90921858	harbor2	chr5	90726684	90727094	LINE/L2	1633	+	205	90726889	5031
chr5	90721858	90921858	harbor2	chr5	90727313	90727620	LINE/L2	539	+	154	90727467	5609
chr5	90721858	90921858	harbor2	chr5	90727751	90727897	LINE/L2	539	+	73	90727824	5966
chr5	90721858	90921858	harbor2	chr5	90748656	90748927	LINE/L2	529	+	136	90748792	26934
chr5	155389242	155589242	harbor2	chr5	155400200	155400689	LINE/L2	455	+	244	155400444	11202
chr5	155389242	155589242	harbor2	chr5	155443704	155444070	LINE/L2	539	+	183	155443887	54645
chr5	155389242	155589242	harbor2	chr5	155452843	155452966	LINE/L2	491	+	62	155452905	63663
chr5	155389242	155589242	harbor2	chr5	155452990	155453519	LINE/L2	498	+	264	155453254	64012
chr5	155389242	155589242	harbor2	chr5	155461333	155461482	LINE/L2	445	+	74	155461407	72165
chr5	155389242	155589242	harbor2	chr5	155466750	155467141	LINE/L2	733	+	196	155466946	77704
chr5	155389242	155589242	harbor2	chr5	155467371	155467688	LINE/L2	693	+	158	155467529	78287
chr5	155389242	155589242	harbor2	chr5	155478620	155479106	LINE/L2	681	+	243	155478863	89621
chr5	144690452	144890452	harbor2	chr5	144699782	144700517	LINE/L2	723	+	368	144700150	9698
chr5	144690452	144890452	harbor2	chr5	144710216	144710606	LINE/L2	450	+	195	144710411	19959
chr5	144690452	144890452	harbor2	chr5	144763665	144764255	LINE/L2	471	+	295	144763960	73508
chr5	147461876	147661876	harbor2	chr5	147470546	147471016	LINE/L2	761	+	235	147470781	8905
chr5	147461876	147661876	harbor2	chr5	147538547	147538723	LINE/L2	721	+	88	147538635	76759
chr5	147461876	147661876	harbor2	chr5	147539873	147539997	LINE/L2	446	+	62	147539935	78059
chr5	160319745	160519745	harbor2	chr5	160330381	160330660	LINE/L2	1817	+	140	160330521	10776
chr5	160319745	160519745	harbor2	chr5	160330953	160331211	LINE/L2	1817	+	129	160331082	11337
chr5	160319745	160519745	harbor2	chr5	160331524	160331844	LINE/L2	1817	+	160	160331684	11939
chr5	160319745	160519745	harbor2	chr5	160332013	160332287	LINE/L2	745	+	137	160332150	12405
chr5	160319745	160519745	harbor2	chr5	160332292	160332967	LINE/L2	1152	+	338	160332630	12885
chr5	160319745	160519745	harbor2	chr5	160335427	160335570	LINE/L2	1409	+	72	160335499	15754
chr5	160319745	160519745	harbor2	chr5	160335882	160336196	LINE/L2	1409	+	157	160336039	16294
chr5	160319745	160519745	harbor2	chr5	160336634	160336993	LINE/L2	1562	+	180	160336814	17069
chr5	160319745	160519745	harbor2	chr5	160337319	160337587	LINE/L2	1562	+	134	160337453	17708
chr5	160319745	160519745	harbor2	chr5	160341101	160341525	LINE/L2	1271	+	212	160341313	21568
chr5	160319745	160519745	harbor2	chr5	160343665	160344019	LINE/L2	399	+	177	160343842	24097
chr5	160319745	160519745	harbor2	chr5	160348760	160349004	LINE/L2	619	+	122	160348882	29137
chr5	160319745	160519745	harbor2	chr5	160361703	160362060	LINE/L2	605	+	178	160361881	42136
chr5	160319745	160519745	harbor2	chr5	160416194	160416820	LINE/L2	1102	+	313	160416507	96762
chr5	160319745	160519745	harbor2	chr5	160417176	160417209	LINE/L2	1102	+	16	160417192	97447
chr5	160319745	160519745	harbor2	chr5	160333633	160334433	LINE/L2	2091	+	400	160334033	14288
chr5	160319745	160519745	harbor2	chr5	160415636	160415887	LINE/L2	1102	+	126	160415762	96017
chr5	124424350	124624350	harbor2	chr5	124450421	124450669	LINE/L2	609	+	124	124450545	26195
chr5	124424350	124624350	harbor2	chr5	124476340	124476842	LINE/L2	785	+	251	124476591	52241
chr5	162483327	162683327	harbor2	chr5	162484503	162485056	LINE/L2	761	+	276	162484779	1452
chr5	162483327	162683327	harbor2	chr5	162502404	162502709	LINE/L2	433	+	152	162502556	19229
chr5	162483327	162683327	harbor2	chr5	162535120	162535233	LINE/L2	1012	+	56	162535176	51849
chr5	162483327	162683327	harbor2	chr5	162535523	162535893	LINE/L2	1012	+	185	162535708	52381
chr5	162483327	162683327	harbor2	chr5	162555277	162555424	LINE/L2	491	+	74	162555351	72024
chr5	167263623	167463623	harbor2	chr5	167315944	167316283	LINE/L2	716	+	170	167316114	52491
chr5	167263623	167463623	harbor2	chr5	167328491	167329005	LINE/L2	953	+	257	167328748	65125
chr5	167263623	167463623	harbor2	chr5	167357745	167358206	LINE/L2	660	+	230	167357975	94352
chr5	167263623	167463623	harbor2	chr5	167358454	167358803	LINE/L2	1877	+	174	167358628	95005
chr5	167263623	167463623	harbor2	chr5	167358853	167359560	LINE/L2	1877	+	354	167359207	95584
chr5	167263623	167463623	harbor2	chr5	167360264	167360411	LINE/L2	473	+	74	167360338	96715
chr5	178983177	179183177	harbor2	chr5	179030853	179031755	LINE/L2	918	+	451	179031304	48127
chr5	178983177	179183177	harbor2	chr5	179055907	179056251	LINE/L2	900	+	172	179056079	72902
chr5	178983177	179183177	harbor2	chr5	179056850	179057035	LINE/L2	447	+	92	179056942	73765
chr5	166197600	166397600	harbor2	chr5	166211825	166212752	LINE/L2	466	+	464	166212289	14689
chr5	166197600	166397600	harbor2	chr5	166213057	166213312	LINE/L2	466	+	128	166213185	15585
chr5	166197600	166397600	harbor2	chr5	166265663	166266048	LINE/L2	952	+	192	166265855	68255
chr5	166197600	166397600	harbor2	chr5	166266313	166266694	LINE/L2	565	+	190	166266503	68903
chr5	166197600	166397600	harbor2	chr5	166285532	166285929	LINE/L2	667	+	198	166285730	88130
chr5	166197600	166397600	harbor2	chr5	166295375	166295552	LINE/L2	409	+	88	166295463	97863
chr5	166197600	166397600	harbor2	chr5	166296931	166297408	LINE/L2	720	+	238	166297169	99569
chr5	166197600	166397600	harbor2	chr5	166248377	166248721	LINE/L2	494	+	172	166248549	50949
chr5	97130270	97330270	harbor2	chr5	97171518	97171696	LINE/L2	432	+	89	97171607	41337
chr5	97130270	97330270	harbor2	chr5	97171888	97172981	LINE/L2	2457	+	546	97172434	42164
chr5	97130270	97330270	harbor2	chr5	97182183	97182655	LINE/L2	427	+	236	97182419	52149
chr5	97130270	97330270	harbor2	chr5	97215353	97215515	LINE/L2	633	+	81	97215434	85164
chr5	97130270	97330270	harbor2	chr5	97215889	97215998	LINE/L2	633	+	54	97215943	85673
chr5	180036602	180236602	harbor2	chr5	180046630	180046886	LINE/L2	458	+	128	180046758	10156
chr5	180036602	180236602	harbor2	chr5	180059080	180059514	LINE/L2	455	+	217	180059297	22695
chr5	180036602	180236602	harbor2	chr5	180095172	180095480	LINE/L2	703	+	154	180095326	58724
chr5	169119782	169319782	harbor2	chr5	169130543	169130652	LINE/L2	478	+	54	169130597	10815
chr5	169119782	169319782	harbor2	chr5	169134122	169134568	LINE/L2	689	+	223	169134345	14563
chr5	169119782	169319782	harbor2	chr5	169134765	169135006	LINE/L2	576	+	120	169134885	15103
chr5	169119782	169319782	harbor2	chr5	169144131	169144575	LINE/L2	493	+	222	169144353	24571
chr5	169119782	169319782	harbor2	chr5	169165593	169165975	LINE/L2	1022	+	191	169165784	46002
chr5	169119782	169319782	harbor2	chr5	169211282	169211616	LINE/L2	1088	+	167	169211449	91667
chr5	169119782	169319782	harbor2	chr5	169213532	169213834	LINE/L2	1003	+	151	169213683	93901
chr5	169119782	169319782	harbor2	chr5	169214884	169215418	LINE/L2	450	+	267	169215151	95369
chr5	38740800	38940800	harbor2	chr5	38754584	38754940	LINE/L2	786	+	178	38754762	13962
chr5	38740800	38940800	harbor2	chr5	38790048	38790184	LINE/L2	488	+	68	38790116	49316
chr5	38740800	38940800	harbor2	chr5	38793567	38794053	LINE/L2	606	+	243	38793810	53010
chr5	179805175	180005175	harbor2	chr5	179881176	179881496	LINE/L2	468	+	160	179881336	76161
chr5	179805175	180005175	harbor2	chr5	179884965	179885131	LINE/L2	862	+	83	179885048	79873
chr5	179805175	180005175	harbor2	chr5	179885752	179886363	LINE/L2	1100	+	306	179886058	80883
chr5	151692759	151892759	harbor2	chr5	151752481	151752594	LINE/L2	474	+	56	151752537	59778
chr5	53423315	53623315	harbor2	chr5	53448646	53448885	LINE/L2	651	+	120	53448766	25451
chr5	53423315	53623315	harbor2	chr5	53471551	53471747	LINE/L2	533	+	98	53471649	48334
chr5	53423315	53623315	harbor2	chr5	53471805	53472116	LINE/L2	462	+	156	53471961	48646
chr5	161360024	161560024	harbor2	chr5	161374244	161374580	LINE/L2	659	+	168	161374412	14388
chr5	161360024	161560024	harbor2	chr5	161374587	161374959	LINE/L2	727	+	186	161374773	14749
chr5	161360024	161560024	harbor2	chr5	161412372	161412917	LINE/L2	446	+	272	161412644	52620
chr5	161360024	161560024	harbor2	chr5	161413064	161413179	LINE/L2	399	+	58	161413122	53098
chr5	155149715	155349715	harbor2	chr5	155175787	155175938	LINE/L2	450	+	76	155175863	26148
chr5	155149715	155349715	harbor2	chr5	155220895	155221076	LINE/L2	506	+	90	155220985	71270
chr5	155149715	155349715	harbor2	chr5	155233225	155233432	LINE/L2	552	+	104	155233329	83614
chr5	120151233	120351233	harbor2	chr5	120166855	120167201	LINE/L2	438	+	173	120167028	15795
chr5	120151233	120351233	harbor2	chr5	120202831	120203112	LINE/L2	506	+	140	120202971	51738
chr5	112815799	113015799	harbor2	chr5	112824803	112825550	LINE/L2	716	+	374	112825177	9378
chr5	112815799	113015799	harbor2	chr5	112881403	112881771	LINE/L2	2715	+	184	112881587	65788
chr5	112815799	113015799	harbor2	chr5	112882071	112882634	LINE/L2	2715	+	282	112882353	66554
chr5	112815799	113015799	harbor2	chr5	112882790	112883035	LINE/L2	548	+	122	112882912	67113
chr5	112815799	113015799	harbor2	chr5	112883608	112884380	LINE/L2	2128	+	386	112883994	68195
chr5	112815799	113015799	harbor2	chr5	112884682	112884998	LINE/L2	549	+	158	112884840	69041
chr5	57931646	58131646	harbor2	chr5	57935790	57936531	LINE/L2	1312	+	370	57936160	4514
chr5	57931646	58131646	harbor2	chr5	58014549	58015219	LINE/L2	783	+	335	58014884	83238
chr5	173476958	173676958	harbor2	chr5	173511883	173513155	LINE/L2	2286	+	636	173512519	35561
chr5	173476958	173676958	harbor2	chr5	173524162	173524414	LINE/L2	739	+	126	173524288	47330
chr5	173476958	173676958	harbor2	chr5	173524915	173525038	LINE/L2	1358	+	62	173524977	48019
chr5	173476958	173676958	harbor2	chr5	173525402	173526080	LINE/L2	1358	+	339	173525741	48783
chr5	113969908	114169908	harbor2	chr5	113971856	113972211	LINE/L2	837	+	178	113972034	2126
chr5	113969908	114169908	harbor2	chr5	113972601	113973270	LINE/L2	486	+	334	113972935	3027
chr5	113969908	114169908	harbor2	chr5	113979691	113980085	LINE/L2	602	+	197	113979888	9980
chr5	113969908	114169908	harbor2	chr5	113988452	113988961	LINE/L2	450	+	254	113988706	18798
chr5	113969908	114169908	harbor2	chr5	113998889	113999258	LINE/L2	400	+	184	113999073	29165
chr5	177855315	178055315	harbor2	chr5	177879416	177879713	LINE/L2	606	+	148	177879564	24249
chr5	177855315	178055315	harbor2	chr5	177925453	177925604	LINE/L2	1162	+	76	177925529	70214
chr5	177855315	178055315	harbor2	chr5	177925952	177926292	LINE/L2	1162	+	170	177926122	70807
chr6	154853193	155053193	harbor2	chr6	154942514	154942671	LINE/L2	439	+	78	154942592	89399
chr6	147752902	147952902	harbor2	chr6	147778179	147778623	LINE/L2	1196	+	222	147778401	25499
chr6	134559762	134759762	harbor2	chr6	134562546	134562776	LINE/L2	666	+	115	134562661	2899
chr6	134559762	134759762	harbor2	chr6	134608263	134608975	LINE/L2	436	+	356	134608619	48857
chr6	134559762	134759762	harbor2	chr6	134647941	134648351	LINE/L2	667	+	205	134648146	88384
chr6	32911606	33111606	harbor2	chr6	32957844	32958244	LINE/L2	602	+	200	32958044	46438
chr6	117391994	117591994	harbor2	chr6	117400618	117401443	LINE/L2	1669	+	412	117401030	9036
chr6	117391994	117591994	harbor2	chr6	117401603	117401737	LINE/L2	489	+	67	117401670	9676
chr6	117391994	117591994	harbor2	chr6	117401913	117402606	LINE/L2	1112	+	346	117402259	10265
chr6	117391994	117591994	harbor2	chr6	117402916	117403033	LINE/L2	1112	+	58	117402974	10980
chr6	117391994	117591994	harbor2	chr6	117416828	117417625	LINE/L2	706	+	398	117417226	25232
chr6	117391994	117591994	harbor2	chr6	117486473	117486778	LINE/L2	1133	+	152	117486625	94631
chr6	117391994	117591994	harbor2	chr6	117487122	117487210	LINE/L2	1133	+	44	117487166	95172
chr6	87619038	87819038	harbor2	chr6	87646490	87647735	LINE/L2	2101	+	622	87647112	28074
chr6	64360058	64560058	harbor2	chr6	64382039	64382524	LINE/L2	664	+	242	64382281	22223
chr6	146996369	147196369	harbor2	chr6	147028765	147028954	LINE/L2	524	+	94	147028859	32490
chr6	146996369	147196369	harbor2	chr6	147043293	147043552	LINE/L2	497	+	130	147043423	47054
chr6	146996369	147196369	harbor2	chr6	147045656	147045891	LINE/L2	502	+	118	147045774	49405
chr6	146996369	147196369	harbor2	chr6	147048890	147049732	LINE/L2	1883	+	421	147049311	52942
chr6	146996369	147196369	harbor2	chr6	147095339	147095802	LINE/L2	541	+	232	147095571	99202
chr6	169805082	170005082	harbor2	chr6	169850494	169850784	LINE/L2	637	+	145	169850639	45557
chr6	167018813	167218813	harbor2	chr6	167107954	167108635	LINE/L2	1110	+	340	167108294	89481
chr6	167018813	167218813	harbor2	chr6	167110017	167110816	LINE/L2	1036	+	400	167110417	91604
chr6	147994489	148194489	harbor2	chr6	148075774	148076125	LINE/L2	523	+	176	148075950	81461
chr6	126158213	126358213	harbor2	chr6	126179431	126179585	LINE/L2	492	+	77	126179508	21295
chr6	126158213	126358213	harbor2	chr6	126209873	126209981	LINE/L2	483	+	54	126209927	51714
chr6	126158213	126358213	harbor2	chr6	126210595	126210862	LINE/L2	483	+	134	126210729	52516
chr6	126158213	126358213	harbor2	chr6	126248513	126248775	LINE/L2	453	+	131	126248644	90431
chr6	160076132	160276132	harbor2	chr6	160133266	160133502	LINE/L2	420	+	118	160133384	57252
chr6	160076132	160276132	harbor2	chr6	160137893	160138102	LINE/L2	543	+	104	160137997	61865
chr6	168167081	168367081	harbor2	chr6	168216392	168216593	LINE/L2	426	+	100	168216492	49411
chr6	136668064	136868064	harbor2	chr6	136676115	136676261	LINE/L2	425	+	73	136676188	8124
chr6	136668064	136868064	harbor2	chr6	136699110	136699612	LINE/L2	678	+	251	136699361	31297
chr6	109862555	110062555	harbor2	chr6	109942980	109944041	LINE/L2	1437	+	530	109943510	80955
chr6	109862555	110062555	harbor2	chr6	109957169	109957514	LINE/L2	1094	+	172	109957341	94786
chr6	109862555	110062555	harbor2	chr6	109958390	109958587	LINE/L2	520	+	98	109958488	95933
chr6	156251792	156451792	harbor2	chr6	156269667	156270511	LINE/L2	546	+	422	156270089	18297
chr6	156251792	156451792	harbor2	chr6	156309867	156310219	LINE/L2	672	+	176	156310043	58251
chr6	64803152	65003152	harbor2	chr6	64824978	64825428	LINE/L2	870	+	225	64825203	22051
chr6	168080923	168280923	harbor2	chr6	168089964	168090755	LINE/L2	553	+	396	168090360	9437
chr6	168080923	168280923	harbor2	chr6	168102465	168102695	LINE/L2	424	+	115	168102580	21657
chr6	164838514	165038514	harbor2	chr6	164885865	164886274	LINE/L2	629	+	204	164886069	47555
chr6	164838514	165038514	harbor2	chr6	164896495	164897451	LINE/L2	534	+	478	164896973	58459
chr6	143322697	143522697	harbor2	chr6	143325154	143325679	LINE/L2	1062	+	262	143325416	2719
chr6	170559918	170759918	harbor2	chr6	170628537	170629230	LINE/L2	492	+	346	170628883	68965
chr6	117397691	117597691	harbor2	chr6	117400618	117401443	LINE/L2	1669	+	412	117401030	3339
chr6	117397691	117597691	harbor2	chr6	117401603	117401737	LINE/L2	489	+	67	117401670	3979
chr6	117397691	117597691	harbor2	chr6	117401913	117402606	LINE/L2	1112	+	346	117402259	4568
chr6	117397691	117597691	harbor2	chr6	117402916	117403033	LINE/L2	1112	+	58	117402974	5283
chr6	117397691	117597691	harbor2	chr6	117416828	117417625	LINE/L2	706	+	398	117417226	19535
chr6	117397691	117597691	harbor2	chr6	117486473	117486778	LINE/L2	1133	+	152	117486625	88934
chr6	117397691	117597691	harbor2	chr6	117487122	117487210	LINE/L2	1133	+	44	117487166	89475
chr6	137038447	137238447	harbor2	chr6	137069537	137069827	LINE/L2	480	+	145	137069682	31235
chr6	137038447	137238447	harbor2	chr6	137078087	137078570	LINE/L2	621	+	242	137078329	39882
chr6	125615891	125815891	harbor2	chr6	125682867	125683552	LINE/L2	1081	+	342	125683209	67318
chr6	142768397	142968397	harbor2	chr6	142828295	142828444	LINE/L2	428	+	74	142828369	59972
chr6	142768397	142968397	harbor2	chr6	142828730	142828851	LINE/L2	428	+	60	142828790	60393
chr6	142768397	142968397	harbor2	chr6	142858388	142858517	LINE/L2	442	+	64	142858452	90055
chr6	116415250	116615250	harbor2	chr6	116485115	116485689	LINE/L2	513	+	287	116485402	70152
chr6	116415250	116615250	harbor2	chr6	116498627	116499950	LINE/L2	489	+	662	116499289	84039
chr6	160075488	160275488	harbor2	chr6	160133266	160133502	LINE/L2	420	+	118	160133384	57896
chr6	160075488	160275488	harbor2	chr6	160137893	160138102	LINE/L2	543	+	104	160137997	62509
chr6	166757498	166957498	harbor2	chr6	166807302	166807930	LINE/L2	647	+	314	166807616	50118
chr6	166757498	166957498	harbor2	chr6	166808416	166808572	LINE/L2	465	+	78	166808494	50996
chr6	120198271	120398271	harbor2	chr6	120220000	120220216	LINE/L2	413	+	108	120220108	21837
chr6	120198271	120398271	harbor2	chr6	120246109	120247212	LINE/L2	2002	+	552	120246661	48390
chr6	166596510	166796510	harbor2	chr6	166643637	166643999	LINE/L2	403	+	181	166643818	47308
chr6	138742411	138942411	harbor2	chr6	138753020	138753279	LINE/L2	1058	+	130	138753150	10739
chr6	138742411	138942411	harbor2	chr6	138753577	138753723	LINE/L2	1058	+	73	138753650	11239
chr6	138742411	138942411	harbor2	chr6	138769020	138769339	LINE/L2	697	+	160	138769180	26769
chr6	138742411	138942411	harbor2	chr6	138771129	138771291	LINE/L2	422	+	81	138771210	28799
chr6	138742411	138942411	harbor2	chr6	138771596	138771915	LINE/L2	422	+	160	138771756	29345
chr6	138742411	138942411	harbor2	chr6	138775691	138775849	LINE/L2	458	+	79	138775770	33359
chr6	138742411	138942411	harbor2	chr6	138819400	138819612	LINE/L2	594	+	106	138819506	77095
chr6	138742411	138942411	harbor2	chr6	138830618	138831535	LINE/L2	851	+	458	138831076	88665
chr6	125604701	125804701	harbor2	chr6	125682867	125683552	LINE/L2	1081	+	342	125683209	78508
chr6	121407771	121607771	harbor2	chr6	121459616	121459913	LINE/L2	410	+	148	121459764	51993
chr6	121407771	121607771	harbor2	chr6	121468815	121469031	LINE/L2	412	+	108	121468923	61152
chr6	121407771	121607771	harbor2	chr6	121469354	121469489	LINE/L2	412	+	68	121469422	61651
chr6	158458891	158658891	harbor2	chr6	158530235	158530384	LINE/L2	419	+	74	158530309	71418
chr6	156640321	156840321	harbor2	chr6	156653687	156653895	LINE/L2	559	+	104	156653791	13470
chr6	156640321	156840321	harbor2	chr6	156653940	156654001	LINE/L2	559	+	30	156653970	13649
chr6	156640321	156840321	harbor2	chr6	156682514	156682797	LINE/L2	465	+	142	156682656	42335
chr6	156640321	156840321	harbor2	chr6	156695873	156696224	LINE/L2	408	+	176	156696049	55728
chr6	156640321	156840321	harbor2	chr6	156696551	156696724	LINE/L2	408	+	86	156696637	56316
chr6	170375891	170575891	harbor2	chr6	170407870	170408921	LINE/L2	1125	+	526	170408396	32505
chr6	120178455	120378455	harbor2	chr6	120220000	120220216	LINE/L2	413	+	108	120220108	41653
chr6	120178455	120378455	harbor2	chr6	120246109	120247212	LINE/L2	2002	+	552	120246661	68206
chr6	163858386	164058386	harbor2	chr6	163876958	163877282	LINE/L2	490	+	162	163877120	18734
chr6	162897383	163097383	harbor2	chr6	162900615	162901055	LINE/L2	642	+	220	162900835	3452
chr6	52232936	52432936	harbor2	chr6	52313758	52313936	LINE/L2	405	+	89	52313847	80911
chr6	52232936	52432936	harbor2	chr6	52314256	52314552	LINE/L2	405	+	148	52314404	81468
chr6	140734169	140934169	harbor2	chr6	140775730	140775996	LINE/L2	720	+	133	140775863	41694
chr6	132518305	132718305	harbor2	chr6	132549537	132549899	LINE/L2	506	+	181	132549718	31413
chr6	132518305	132718305	harbor2	chr6	132593183	132593425	LINE/L2	537	+	121	132593304	74999
chr6	165866052	166066052	harbor2	chr6	165887201	165887560	LINE/L2	986	+	180	165887381	21329
chr6	165866052	166066052	harbor2	chr6	165888584	165888717	LINE/L2	1032	+	66	165888650	22598
chr6	165866052	166066052	harbor2	chr6	165909967	165910151	LINE/L2	550	+	92	165910059	44007
chr6	165866052	166066052	harbor2	chr6	165887597	165888281	LINE/L2	1146	+	342	165887939	21887
chr6	100687550	100887550	harbor2	chr6	100722535	100722651	LINE/L2	415	+	58	100722593	35043
chr6	117141258	117341258	harbor2	chr6	117156343	117156562	LINE/L2	730	+	110	117156453	15195
chr6	117141258	117341258	harbor2	chr6	117161754	117162307	LINE/L2	1334	+	276	117162030	20772
chr6	133039814	133239814	harbor2	chr6	133096997	133097562	LINE/L2	580	+	282	133097279	57465
chr6	133039814	133239814	harbor2	chr6	133107090	133107415	LINE/L2	432	+	162	133107252	67438
chr6	133039814	133239814	harbor2	chr6	133129421	133129727	LINE/L2	612	+	153	133129574	89760
chr6	40958407	41158407	harbor2	chr6	40966336	40966553	LINE/L2	499	+	108	40966444	8037
chr6	40958407	41158407	harbor2	chr6	41029471	41029610	LINE/L2	409	+	70	41029541	71134
chr6	40958407	41158407	harbor2	chr6	41039919	41040076	LINE/L2	452	+	78	41039997	81590
chr6	40958407	41158407	harbor2	chr6	41051837	41052409	LINE/L2	1468	+	286	41052123	93716
chr6	40958407	41158407	harbor2	chr6	41056629	41056761	LINE/L2	456	+	66	41056695	98288
chr6	154028228	154228228	harbor2	chr6	154077762	154078360	LINE/L2	686	+	299	154078061	49833
chr6	154669208	154869208	harbor2	chr6	154703204	154703613	LINE/L2	825	+	204	154703408	34200
chr6	99849662	100049662	harbor2	chr6	99853282	99853413	LINE/L2	436	+	66	99853348	3686
chr6	99849662	100049662	harbor2	chr6	99853612	99853766	LINE/L2	436	+	77	99853689	4027
chr6	99849662	100049662	harbor2	chr6	99944817	99945290	LINE/L2	707	+	236	99945053	95391
chr6	136112426	136312426	harbor2	chr6	136124633	136124752	LINE/L2	493	+	60	136124693	12267
chr6	136112426	136312426	harbor2	chr6	136145597	136146033	LINE/L2	1114	+	218	136145815	33389
chr6	136112426	136312426	harbor2	chr6	136166099	136166357	LINE/L2	1092	+	129	136166228	53802
chr6	136112426	136312426	harbor2	chr6	136166775	136167298	LINE/L2	1092	+	262	136167037	54611
chr6	136112426	136312426	harbor2	chr6	136167647	136167754	LINE/L2	993	+	54	136167701	55275
chr6	136112426	136312426	harbor2	chr6	136168400	136168507	LINE/L2	431	+	54	136168454	56028
chr6	71396240	71596240	harbor2	chr6	71473169	71473745	LINE/L2	1154	+	288	71473457	77217
chr6	71396240	71596240	harbor2	chr6	71481533	71482263	LINE/L2	1004	+	365	71481898	85658
chr6	151647523	151847523	harbor2	chr6	151670081	151670523	LINE/L2	645	+	221	151670302	22779
chr6	151647523	151847523	harbor2	chr6	151679635	151680034	LINE/L2	612	+	200	151679835	32312
chr6	151647523	151847523	harbor2	chr6	151680719	151680850	LINE/L2	702	+	66	151680785	33262
chr6	121739027	121939027	harbor2	chr6	121784569	121784777	LINE/L2	494	+	104	121784673	45646
chr6	121739027	121939027	harbor2	chr6	121785040	121785291	LINE/L2	494	+	126	121785166	46139
chr6	121739027	121939027	harbor2	chr6	121785278	121785675	LINE/L2	611	+	198	121785476	46449
chr6	101347768	101547768	harbor2	chr6	101363547	101363722	LINE/L2	410	+	88	101363635	15867
chr6	101347768	101547768	harbor2	chr6	101367891	101368093	LINE/L2	497	+	101	101367992	20224
chr6	101347768	101547768	harbor2	chr6	101390029	101390185	LINE/L2	539	+	78	101390107	42339
chr6	23470817	23670817	harbor2	chr6	23470690	23471104	LINE/L2	787	+	207	23470897	80
chr6	23470817	23670817	harbor2	chr6	23501126	23501367	LINE/L2	495	+	120	23501246	30429
chr6	23470817	23670817	harbor2	chr6	23511460	23511972	LINE/L2	506	+	256	23511716	40899
chr6	23470817	23670817	harbor2	chr6	23521239	23521486	LINE/L2	449	+	124	23521363	50546
chr6	23470817	23670817	harbor2	chr6	23545986	23546362	LINE/L2	474	+	188	23546174	75357
chr6	136670815	136870815	harbor2	chr6	136676115	136676261	LINE/L2	425	+	73	136676188	5373
chr6	136670815	136870815	harbor2	chr6	136699110	136699612	LINE/L2	678	+	251	136699361	28546
chr6	161316516	161516516	harbor2	chr6	161379894	161380409	LINE/L2	496	+	258	161380152	63636
chr6	161316516	161516516	harbor2	chr6	161384134	161384262	LINE/L2	468	+	64	161384198	67682
chr6	54323020	54523020	harbor2	chr6	54356773	54358462	LINE/L2	2796	+	844	54357617	34597
chr6	54323020	54523020	harbor2	chr6	54375754	54376110	LINE/L2	414	+	178	54375932	52912
chr6	54323020	54523020	harbor2	chr6	54389071	54389497	LINE/L2	500	+	213	54389284	66264
chr6	54323020	54523020	harbor2	chr6	54412722	54413078	LINE/L2	527	+	178	54412900	89880
chr6	54323020	54523020	harbor2	chr6	54420518	54420811	LINE/L2	479	+	146	54420664	97644
chr6	82833365	83033365	harbor2	chr6	82889615	82889854	LINE/L2	451	+	120	82889735	56370
chr6	145366836	145566836	harbor2	chr6	145388196	145388522	LINE/L2	765	+	163	145388359	21523
chr6	145366836	145566836	harbor2	chr6	145389088	145389197	LINE/L2	765	+	54	145389142	22306
chr6	145366836	145566836	harbor2	chr6	145389492	145389674	LINE/L2	765	+	91	145389583	22747
chr6	141947491	142147491	harbor2	chr6	141965627	141965974	LINE/L2	1052	+	174	141965801	18310
chr6	152370457	152570457	harbor2	chr6	152370965	152371091	LINE/L2	625	+	63	152371028	571
chr6	152370457	152570457	harbor2	chr6	152390805	152391049	LINE/L2	410	+	122	152390927	20470
chr6	152370457	152570457	harbor2	chr6	152405926	152406117	LINE/L2	465	+	96	152406022	35565
chr6	152370457	152570457	harbor2	chr6	152415277	152415655	LINE/L2	598	+	189	152415466	45009
chr6	152370457	152570457	harbor2	chr6	152423468	152424173	LINE/L2	792	+	352	152423820	53363
chr6	134063581	134263581	harbor2	chr6	134098763	134099503	LINE/L2	587	+	370	134099133	35552
chr6	149453618	149653618	harbor2	chr6	149547238	149547717	LINE/L2	1244	+	240	149547478	93860
chr6	113261684	113461684	harbor2	chr6	113297002	113297348	LINE/L2	502	+	173	113297175	35491
chr6	113261684	113461684	harbor2	chr6	113318976	113319267	LINE/L2	781	+	146	113319122	57438
chr6	113261684	113461684	harbor2	chr6	113336744	113337020	LINE/L2	840	+	138	113336882	75198
chr6	113261684	113461684	harbor2	chr6	113337340	113337489	LINE/L2	483	+	74	113337414	75730
chr6	113261684	113461684	harbor2	chr6	113337686	113337887	LINE/L2	834	+	100	113337786	76102
chr6	131091366	131291366	harbor2	chr6	131097917	131098454	LINE/L2	1378	+	268	131098185	6819
chr6	131091366	131291366	harbor2	chr6	131098767	131098951	LINE/L2	890	+	92	131098859	7493
chr6	131091366	131291366	harbor2	chr6	131178813	131179168	LINE/L2	445	+	178	131178991	87625
chr6	131091366	131291366	harbor2	chr6	131179474	131179602	LINE/L2	445	+	64	131179538	88172
chr6	131091366	131291366	harbor2	chr6	131179914	131179943	LINE/L2	445	+	14	131179928	88562
chr6	140810647	141010647	harbor2	chr6	140855740	140856167	LINE/L2	1658	+	214	140855954	45307
chr6	146555565	146755565	harbor2	chr6	146585718	146585920	LINE/L2	414	+	101	146585819	30254
chr6	146555565	146755565	harbor2	chr6	146588788	146589883	LINE/L2	2383	+	548	146589336	33771
chr6	146555565	146755565	harbor2	chr6	146600393	146600860	LINE/L2	1062	+	234	146600627	45062
chr6	146555565	146755565	harbor2	chr6	146628535	146628875	LINE/L2	460	+	170	146628705	73140
chr6	146555565	146755565	harbor2	chr6	146632935	146633761	LINE/L2	1085	+	413	146633348	77783
chr6	154264818	154464818	harbor2	chr6	154268462	154269148	LINE/L2	439	+	343	154268805	3987
chr6	135040120	135240120	harbor2	chr6	135060816	135061312	LINE/L2	503	+	248	135061064	20944
chr6	135040120	135240120	harbor2	chr6	135076923	135077312	LINE/L2	433	+	194	135077117	36997
chr6	135040120	135240120	harbor2	chr6	135088322	135088585	LINE/L2	432	+	132	135088454	48334
chr6	128975435	129175435	harbor2	chr6	129067462	129068142	LINE/L2	1338	+	340	129067802	92367
chr6	154031366	154231366	harbor2	chr6	154077762	154078360	LINE/L2	686	+	299	154078061	46695
chr6	99309516	99509516	harbor2	chr6	99381121	99381651	LINE/L2	1243	+	265	99381386	71870
chr6	99309516	99509516	harbor2	chr6	99381946	99382187	LINE/L2	933	+	120	99382066	72550
chr6	138174642	138374642	harbor2	chr6	138191431	138191782	LINE/L2	446	+	176	138191607	16965
chr6	138174642	138374642	harbor2	chr6	138192940	138193550	LINE/L2	607	+	305	138193245	18603
chr6	109200460	109400460	harbor2	chr6	109230671	109231109	LINE/L2	439	+	219	109230890	30430
chr6	109200460	109400460	harbor2	chr6	109278271	109278848	LINE/L2	1002	+	288	109278559	78099
chr6	109200460	109400460	harbor2	chr6	109279147	109279552	LINE/L2	1002	+	202	109279349	78889
chr6	163383938	163583938	harbor2	chr6	163455942	163456424	LINE/L2	913	+	241	163456183	72245
chr6	163383938	163583938	harbor2	chr6	163458378	163458477	LINE/L2	443	+	50	163458428	74490
chr6	133797457	133997457	harbor2	chr6	133814744	133814847	LINE/L2	413	+	52	133814796	17339
chr6	133797457	133997457	harbor2	chr6	133815234	133815813	LINE/L2	438	+	290	133815524	18067
chr6	133797457	133997457	harbor2	chr6	133822644	133823394	LINE/L2	1826	+	375	133823019	25562
chr6	133797457	133997457	harbor2	chr6	133824154	133824442	LINE/L2	1745	+	144	133824298	26841
chr6	133797457	133997457	harbor2	chr6	133824820	133825089	LINE/L2	1745	+	134	133824954	27497
chr6	133797457	133997457	harbor2	chr6	133825708	133826324	LINE/L2	1745	+	308	133826016	28559
chr6	158748514	158948514	harbor2	chr6	158808008	158808081	LINE/L2	406	+	36	158808044	59530
chr6	158748514	158948514	harbor2	chr6	158810365	158810539	LINE/L2	413	+	87	158810452	61938
chr6	158748514	158948514	harbor2	chr6	158812695	158813426	LINE/L2	737	+	366	158813061	64547
chr6	158748514	158948514	harbor2	chr6	158826107	158826449	LINE/L2	504	+	171	158826278	77764
chr6	158748514	158948514	harbor2	chr6	158827012	158827124	LINE/L2	504	+	56	158827068	78554
chr6	158748514	158948514	harbor2	chr6	158842813	158843158	LINE/L2	761	+	172	158842985	94471
chr6	40351030	40551030	harbor2	chr6	40403714	40404401	LINE/L2	1268	+	344	40404058	53028
chr6	40351030	40551030	harbor2	chr6	40411497	40411955	LINE/L2	990	+	229	40411726	60696
chr6	40351030	40551030	harbor2	chr6	40417902	40418545	LINE/L2	756	+	322	40418224	67194
chr6	40351030	40551030	harbor2	chr6	40433277	40433498	LINE/L2	759	+	110	40433387	82357
chr6	40351030	40551030	harbor2	chr6	40433955	40434233	LINE/L2	670	+	139	40434094	83064
chr6	54952777	55152777	harbor2	chr6	55002486	55003425	LINE/L2	809	+	470	55002956	50179
chr6	54952777	55152777	harbor2	chr6	55016730	55017256	LINE/L2	1348	+	263	55016993	64216
chr6	54952777	55152777	harbor2	chr6	55035380	55036189	LINE/L2	904	+	404	55035784	83007
chr6	158289474	158489474	harbor2	chr6	158321070	158321729	LINE/L2	476	+	330	158321400	31926
chr6	96721693	96921693	harbor2	chr6	96751791	96752044	LINE/L2	837	+	126	96751917	30224
chr6	96721693	96921693	harbor2	chr6	96753724	96754659	LINE/L2	1771	+	468	96754192	32499
chr6	159816175	160016175	harbor2	chr6	159838427	159838779	LINE/L2	448	+	176	159838603	22428
chr6	159816175	160016175	harbor2	chr6	159902735	159903724	LINE/L2	1986	+	494	159903229	87054
chr6	159816175	160016175	harbor2	chr6	159904259	159905219	LINE/L2	956	+	480	159904739	88564
chr6	159816175	160016175	harbor2	chr6	159910392	159910598	LINE/L2	441	+	103	159910495	94320
chr6	159816175	160016175	harbor2	chr6	159911669	159911995	LINE/L2	607	+	163	159911832	95657
chr6	157056258	157256258	harbor2	chr6	157125570	157125803	LINE/L2	442	+	116	157125686	69428
chr6	157056258	157256258	harbor2	chr6	157140839	157141048	LINE/L2	514	+	104	157140943	84685
chr6	81507147	81707147	harbor2	chr6	81540527	81540678	LINE/L2	424	+	76	81540603	33456
chr6	81507147	81707147	harbor2	chr6	81568910	81569229	LINE/L2	540	+	160	81569070	61923
chr6	81507147	81707147	harbor2	chr6	81525850	81526887	LINE/L2	617	+	518	81526368	19221
chr6	112807492	113007492	harbor2	chr6	112834576	112834837	LINE/L2	764	+	130	112834706	27214
chr6	112807492	113007492	harbor2	chr6	112863719	112864331	LINE/L2	453	+	306	112864025	56533
chr6	112807492	113007492	harbor2	chr6	112888790	112889854	LINE/L2	1340	+	532	112889322	81830
chr6	138118626	138318626	harbor2	chr6	138166909	138167939	LINE/L2	1039	+	515	138167424	48798
chr6	138118626	138318626	harbor2	chr6	138191431	138191782	LINE/L2	446	+	176	138191607	72981
chr6	138118626	138318626	harbor2	chr6	138192940	138193550	LINE/L2	607	+	305	138193245	74619
chr6	164323621	164523621	harbor2	chr6	164420212	164421040	LINE/L2	793	+	414	164420626	97005
chr6	167436237	167636237	harbor2	chr6	167486703	167486838	LINE/L2	681	+	68	167486771	50534
chr6	167436237	167636237	harbor2	chr6	167487218	167487522	LINE/L2	681	+	152	167487370	51133
chr6	150052694	150252694	harbor2	chr6	150126998	150127184	LINE/L2	580	+	93	150127091	74397
chr6	150052694	150252694	harbor2	chr6	150150789	150151509	LINE/L2	526	+	360	150151149	98455
chr6	160064466	160264466	harbor2	chr6	160066880	160067557	LINE/L2	810	+	338	160067218	2752
chr6	160064466	160264466	harbor2	chr6	160133266	160133502	LINE/L2	420	+	118	160133384	68918
chr6	160064466	160264466	harbor2	chr6	160137893	160138102	LINE/L2	543	+	104	160137997	73531
chr6	133063806	133263806	harbor2	chr6	133096997	133097562	LINE/L2	580	+	282	133097279	33473
chr6	133063806	133263806	harbor2	chr6	133107090	133107415	LINE/L2	432	+	162	133107252	43446
chr6	133063806	133263806	harbor2	chr6	133129421	133129727	LINE/L2	612	+	153	133129574	65768
chr6	75257980	75457980	harbor2	chr6	75274683	75274741	LINE/L2	2098	+	29	75274712	16732
chr6	75257980	75457980	harbor2	chr6	75275028	75275754	LINE/L2	2098	+	363	75275391	17411
chr6	75257980	75457980	harbor2	chr6	75276634	75277104	LINE/L2	1096	+	235	75276869	18889
chr6	75257980	75457980	harbor2	chr6	75290024	75290360	LINE/L2	612	+	168	75290192	32212
chr6	75257980	75457980	harbor2	chr6	75309331	75310275	LINE/L2	545	+	472	75309803	51823
chr6	75257980	75457980	harbor2	chr6	75320087	75320225	LINE/L2	435	+	69	75320156	62176
chr6	75257980	75457980	harbor2	chr6	75327092	75327453	LINE/L2	1373	+	180	75327272	69292
chr6	46453536	46653536	harbor2	chr6	46460500	46460771	LINE/L2	463	+	136	46460636	7100
chr6	46453536	46653536	harbor2	chr6	46489070	46489441	LINE/L2	494	+	186	46489256	35720
chr6	123604277	123804277	harbor2	chr6	123659830	123660483	LINE/L2	2257	+	326	123660156	55879
chr6	123604277	123804277	harbor2	chr6	123661242	123661424	LINE/L2	2257	+	91	123661333	57056
chr6	123604277	123804277	harbor2	chr6	123661733	123662057	LINE/L2	2257	+	162	123661895	57618
chr6	123604277	123804277	harbor2	chr6	123662524	123662762	LINE/L2	430	+	119	123662643	58366
chr6	123604277	123804277	harbor2	chr6	123690760	123691055	LINE/L2	492	+	148	123690908	86631
chr6	123604277	123804277	harbor2	chr6	123691072	123691383	LINE/L2	539	+	156	123691228	86951
chr6	167655624	167855624	harbor2	chr6	167742162	167742281	LINE/L2	443	+	60	167742222	86598
chr6	161055761	161255761	harbor2	chr6	161082645	161083409	LINE/L2	1386	+	382	161083027	27266
chr6	105165346	105365346	harbor2	chr6	105212532	105212807	LINE/L2	468	+	138	105212670	47324
chr6	105165346	105365346	harbor2	chr6	105255009	105255263	LINE/L2	1802	+	127	105255136	89790
chr6	105165346	105365346	harbor2	chr6	105255574	105256274	LINE/L2	1802	+	350	105255924	90578
chr6	144464360	144664360	harbor2	chr6	144540480	144540714	LINE/L2	780	+	117	144540597	76237
chr6	144464360	144664360	harbor2	chr6	144540962	144541302	LINE/L2	1144	+	170	144541132	76772
chr6	144464360	144664360	harbor2	chr6	144544559	144544871	LINE/L2	499	+	156	144544715	80355
chr6	144464360	144664360	harbor2	chr6	144545059	144545737	LINE/L2	1055	+	339	144545398	81038
chr6	144464360	144664360	harbor2	chr6	144545994	144546082	LINE/L2	825	+	44	144546038	81678
chr6	158267681	158467681	harbor2	chr6	158273233	158273642	LINE/L2	639	+	204	158273437	5756
chr6	158267681	158467681	harbor2	chr6	158274327	158274494	LINE/L2	428	+	84	158274411	6730
chr6	158267681	158467681	harbor2	chr6	158274802	158274865	LINE/L2	428	+	32	158274834	7153
chr6	158267681	158467681	harbor2	chr6	158321070	158321729	LINE/L2	476	+	330	158321400	53719
chr6	123724269	123924269	harbor2	chr6	123730847	123731133	LINE/L2	696	+	143	123730990	6721
chr6	123724269	123924269	harbor2	chr6	123774472	123775775	LINE/L2	2033	+	652	123775124	50855
chr6	123724269	123924269	harbor2	chr6	123778947	123779151	LINE/L2	600	+	102	123779049	54780
chr6	123724269	123924269	harbor2	chr6	123781857	123782893	LINE/L2	734	+	518	123782375	58106
chr6	163221141	163421141	harbor2	chr6	163245565	163246649	LINE/L2	1345	+	542	163246107	24966
chr6	132759691	132959691	harbor2	chr6	132769005	132769299	LINE/L2	594	+	147	132769152	9461
chr6	132759691	132959691	harbor2	chr6	132834384	132835052	LINE/L2	3906	+	334	132834718	75027
chr6	132759691	132959691	harbor2	chr6	132835367	132836012	LINE/L2	3906	+	322	132835689	75998
chr6	125733260	125933260	harbor2	chr6	125769187	125769738	LINE/L2	571	+	276	125769463	36203
chr6	71937132	72137132	harbor2	chr6	71998268	71998597	LINE/L2	526	+	164	71998432	61300
chr6	44714436	44914436	harbor2	chr6	44717418	44718026	LINE/L2	859	+	304	44717722	3286
chr6	44714436	44914436	harbor2	chr6	44782721	44783021	LINE/L2	1119	+	150	44782871	68435
chr6	44714436	44914436	harbor2	chr6	44797245	44797417	LINE/L2	492	+	86	44797331	82895
chr6	61443781	61643781	harbor2	chr6	61526902	61527298	LINE/L2	594	+	198	61527100	83319
chr6	61443781	61643781	harbor2	chr6	61528309	61528559	LINE/L2	733	+	125	61528434	84653
chr6	75266533	75466533	harbor2	chr6	75274683	75274741	LINE/L2	2098	+	29	75274712	8179
chr6	75266533	75466533	harbor2	chr6	75275028	75275754	LINE/L2	2098	+	363	75275391	8858
chr6	75266533	75466533	harbor2	chr6	75276634	75277104	LINE/L2	1096	+	235	75276869	10336
chr6	75266533	75466533	harbor2	chr6	75290024	75290360	LINE/L2	612	+	168	75290192	23659
chr6	75266533	75466533	harbor2	chr6	75309331	75310275	LINE/L2	545	+	472	75309803	43270
chr6	75266533	75466533	harbor2	chr6	75320087	75320225	LINE/L2	435	+	69	75320156	53623
chr6	75266533	75466533	harbor2	chr6	75327092	75327453	LINE/L2	1373	+	180	75327272	60739
chr6	168029120	168229120	harbor2	chr6	168089964	168090755	LINE/L2	553	+	396	168090360	61240
chr6	168029120	168229120	harbor2	chr6	168102465	168102695	LINE/L2	424	+	115	168102580	73460
chr6	98349827	98549827	harbor2	chr6	98443217	98443545	LINE/L2	774	+	164	98443381	93554
chr6	98349827	98549827	harbor2	chr6	98444167	98444420	LINE/L2	2989	+	126	98444293	94466
chr6	98349827	98549827	harbor2	chr6	98444758	98445508	LINE/L2	2989	+	375	98445133	95306
chr6	98349827	98549827	harbor2	chr6	98446888	98447815	LINE/L2	1338	+	464	98447352	97525
chr6	50335995	50535995	harbor2	chr6	50418666	50419475	LINE/L2	701	+	404	50419070	83075
chr6	156748774	156948774	harbor2	chr6	156826248	156826519	LINE/L2	414	+	136	156826384	77610
chr6	170632755	170832755	harbor2	chr6	170671085	170671434	LINE/L2	572	+	174	170671259	38504
chr6	170632755	170832755	harbor2	chr6	170692783	170692984	LINE/L2	510	+	100	170692883	60128
chr7	143347054	143547054	harbor2	chr7	143373994	143375125	LINE/L2	627	+	566	143374560	27506
chr7	34074399	34274399	harbor2	chr7	34164857	34165266	LINE/L2	1211	+	204	34165061	90662
chr7	81272803	81472803	harbor2	chr7	81304389	81304717	LINE/L2	891	+	164	81304553	31750
chr7	84310437	84510437	harbor2	chr7	84341512	84341792	LINE/L2	451	+	140	84341652	31215
chr7	100678309	100878309	harbor2	chr7	100699176	100699397	LINE/L2	886	+	110	100699286	20977
chr7	100678309	100878309	harbor2	chr7	100717350	100717522	LINE/L2	661	+	86	100717436	39127
chr7	100678309	100878309	harbor2	chr7	100717838	100718003	LINE/L2	661	+	82	100717920	39611
chr7	141088105	141288105	harbor2	chr7	141159199	141159369	LINE/L2	458	+	85	141159284	71179
chr7	141088105	141288105	harbor2	chr7	141173262	141173380	LINE/L2	487	+	59	141173321	85216
chr7	134833240	135033240	harbor2	chr7	134861589	134861702	LINE/L2	575	+	56	134861645	28405
chr7	134833240	135033240	harbor2	chr7	134914606	134915021	LINE/L2	492	+	208	134914814	81574
chr7	137471679	137671679	harbor2	chr7	137482173	137482629	LINE/L2	955	+	228	137482401	10722
chr7	137471679	137671679	harbor2	chr7	137513047	137513528	LINE/L2	1181	+	240	137513287	41608
chr7	137471679	137671679	harbor2	chr7	137514625	137515433	LINE/L2	986	+	404	137515029	43350
chr7	153923444	154123444	harbor2	chr7	154015163	154016236	LINE/L2	1115	+	536	154015699	92255
chr7	125789340	125989340	harbor2	chr7	125854236	125855192	LINE/L2	1206	+	478	125854714	65374
chr7	125789340	125989340	harbor2	chr7	125856141	125856488	LINE/L2	508	+	174	125856315	66975
chr7	125789340	125989340	harbor2	chr7	125856648	125856996	LINE/L2	454	+	174	125856822	67482
chr7	125789340	125989340	harbor2	chr7	125857916	125858223	LINE/L2	533	+	154	125858070	68730
chr7	125789340	125989340	harbor2	chr7	125888086	125888391	LINE/L2	474	+	152	125888238	98898
chr7	148575030	148775030	harbor2	chr7	148642707	148643182	LINE/L2	558	+	238	148642945	67915
chr7	148575030	148775030	harbor2	chr7	148643736	148644152	LINE/L2	483	+	208	148643944	68914
chr7	148575030	148775030	harbor2	chr7	148645093	148645622	LINE/L2	478	+	264	148645357	70327
chr7	148575030	148775030	harbor2	chr7	148635628	148635895	LINE/L2	445	+	134	148635762	60732
chr7	68075046	68275046	harbor2	chr7	68099061	68099276	LINE/L2	676	+	108	68099169	24123
chr7	130145931	130345931	harbor2	chr7	130178585	130178765	LINE/L2	973	+	90	130178675	32744
chr7	130145931	130345931	harbor2	chr7	130179088	130179246	LINE/L2	973	+	79	130179167	33236
chr7	153623871	153823871	harbor2	chr7	153718490	153718948	LINE/L2	1039	+	229	153718719	94848
chr7	153623871	153823871	harbor2	chr7	153719260	153719466	LINE/L2	1039	+	103	153719363	95492
chr7	135379173	135579173	harbor2	chr7	135417615	135417787	LINE/L2	463	+	86	135417701	38528
chr7	145473053	145673053	harbor2	chr7	145509054	145509234	LINE/L2	505	+	90	145509144	36091
chr7	145473053	145673053	harbor2	chr7	145526767	145527362	LINE/L2	749	+	298	145527065	54012
chr7	145473053	145673053	harbor2	chr7	145473079	145473707	LINE/L2	1099	+	314	145473393	340
chr7	123244286	123444286	harbor2	chr7	123254478	123254921	LINE/L2	1398	+	222	123254700	10414
chr7	123244286	123444286	harbor2	chr7	123257364	123257567	LINE/L2	506	+	102	123257466	13180
chr7	123244286	123444286	harbor2	chr7	123263979	123264224	LINE/L2	674	+	122	123264101	19815
chr7	36761576	36961576	harbor2	chr7	36812471	36813709	LINE/L2	2956	+	619	36813090	51514
chr7	108085840	108285840	harbor2	chr7	108112885	108113376	LINE/L2	1099	+	246	108113131	27291
chr7	108085840	108285840	harbor2	chr7	108155499	108155751	LINE/L2	511	+	126	108155625	69785
chr7	154433924	154633924	harbor2	chr7	154479809	154480972	LINE/L2	1691	+	582	154480391	46467
chr7	155564555	155764555	harbor2	chr7	155646569	155646910	LINE/L2	433	+	170	155646739	82184
chr7	155564555	155764555	harbor2	chr7	155656823	155657050	LINE/L2	588	+	114	155656937	92382
chr7	138885366	139085366	harbor2	chr7	138965865	138966095	LINE/L2	485	+	115	138965980	80614
chr7	134825766	135025766	harbor2	chr7	134861589	134861702	LINE/L2	575	+	56	134861645	35879
chr7	134825766	135025766	harbor2	chr7	134914606	134915021	LINE/L2	492	+	208	134914814	89048
chr7	151590692	151790692	harbor2	chr7	151662221	151662627	LINE/L2	518	+	203	151662424	71732
chr7	39285867	39485867	harbor2	chr7	39311345	39311584	LINE/L2	823	+	120	39311465	25598
chr7	39285867	39485867	harbor2	chr7	39313077	39313578	LINE/L2	928	+	250	39313327	27460
chr7	39285867	39485867	harbor2	chr7	39384577	39384823	LINE/L2	492	+	123	39384700	98833
chr7	126327114	126527114	harbor2	chr7	126341006	126341695	LINE/L2	698	+	344	126341350	14236
chr7	126327114	126527114	harbor2	chr7	126392044	126392466	LINE/L2	1665	+	211	126392255	65141
chr7	126327114	126527114	harbor2	chr7	126392790	126393173	LINE/L2	1665	+	192	126392982	65868
chr7	126327114	126527114	harbor2	chr7	126393364	126393773	LINE/L2	487	+	204	126393568	66454
chr7	79360313	79560313	harbor2	chr7	79372481	79372602	LINE/L2	515	+	60	79372541	12228
chr7	127673361	127873361	harbor2	chr7	127682691	127682872	LINE/L2	791	+	90	127682781	9420
chr7	133216138	133416138	harbor2	chr7	133223030	133223384	LINE/L2	887	+	177	133223207	7069
chr7	133216138	133416138	harbor2	chr7	133267243	133267724	LINE/L2	989	+	240	133267483	51345
chr7	154982640	155182640	harbor2	chr7	155023726	155024081	LINE/L2	673	+	178	155023904	41264
chr7	154982640	155182640	harbor2	chr7	155024842	155025299	LINE/L2	492	+	228	155025070	42430
chr7	154982640	155182640	harbor2	chr7	155025615	155025908	LINE/L2	492	+	146	155025761	43121
chr7	71270501	71470501	harbor2	chr7	71275960	71276197	LINE/L2	596	+	118	71276078	5577
chr7	71270501	71470501	harbor2	chr7	71319183	71319801	LINE/L2	640	+	309	71319492	48991
chr7	143873197	144073197	harbor2	chr7	143968770	143969088	LINE/L2	749	+	159	143968929	95732
chr7	143873197	144073197	harbor2	chr7	143969690	143970062	LINE/L2	799	+	186	143969876	96679
chr7	69591430	69791430	harbor2	chr7	69689233	69689343	LINE/L2	515	+	55	69689288	97858
chr7	69591430	69791430	harbor2	chr7	69689993	69690180	LINE/L2	515	+	94	69690087	98657
chr7	140576854	140776854	harbor2	chr7	140638604	140639030	LINE/L2	518	+	213	140638817	61963
chr7	134775112	134975112	harbor2	chr7	134819222	134819528	LINE/L2	444	+	153	134819375	44263
chr7	134775112	134975112	harbor2	chr7	134861589	134861702	LINE/L2	575	+	56	134861645	86533
chr7	108250940	108450940	harbor2	chr7	108325487	108325811	LINE/L2	1097	+	162	108325649	74709
chr7	108250940	108450940	harbor2	chr7	108349771	108350266	LINE/L2	810	+	248	108350019	99079
chr7	134860919	135060919	harbor2	chr7	134861589	134861702	LINE/L2	575	+	56	134861645	726
chr7	134860919	135060919	harbor2	chr7	134914606	134915021	LINE/L2	492	+	208	134914814	53895
chr7	142468918	142668918	harbor2	chr7	142566307	142566645	LINE/L2	1119	+	169	142566476	97558
chr7	78904852	79104852	harbor2	chr7	78983652	78984943	LINE/L2	2176	+	646	78984298	79446
chr7	52522581	52722581	harbor2	chr7	52531438	52531983	LINE/L2	461	+	272	52531710	9129
chr7	129165780	129365780	harbor2	chr7	129232978	129233182	LINE/L2	522	+	102	129233080	67300
chr7	129165780	129365780	harbor2	chr7	129233477	129233487	LINE/L2	522	+	5	129233482	67702
chr7	129165780	129365780	harbor2	chr7	129233784	129234037	LINE/L2	522	+	126	129233910	68130
chr7	129165780	129365780	harbor2	chr7	129234659	129234671	LINE/L2	522	+	6	129234665	68885
chr7	129165780	129365780	harbor2	chr7	129234796	129235030	LINE/L2	522	+	117	129234913	69133
chr7	138511604	138711604	harbor2	chr7	138514232	138514727	LINE/L2	592	+	248	138514480	2876
chr7	106542437	106742437	harbor2	chr7	106546273	106546532	LINE/L2	645	+	130	106546403	3966
chr7	106542437	106742437	harbor2	chr7	106605738	106606045	LINE/L2	802	+	154	106605892	63455
chr7	106542437	106742437	harbor2	chr7	106606481	106606833	LINE/L2	1727	+	176	106606657	64220
chr7	106542437	106742437	harbor2	chr7	106607151	106607517	LINE/L2	1727	+	183	106607334	64897
chr7	100501569	100701569	harbor2	chr7	100534982	100535231	LINE/L2	692	+	124	100535106	33537
chr7	100501569	100701569	harbor2	chr7	100536054	100536082	LINE/L2	692	+	14	100536068	34499
chr7	100501569	100701569	harbor2	chr7	100538279	100538465	LINE/L2	632	+	93	100538372	36803
chr7	106548645	106748645	harbor2	chr7	106605738	106606045	LINE/L2	802	+	154	106605892	57247
chr7	106548645	106748645	harbor2	chr7	106606481	106606833	LINE/L2	1727	+	176	106606657	58012
chr7	106548645	106748645	harbor2	chr7	106607151	106607517	LINE/L2	1727	+	183	106607334	58689
chr7	34222224	34422224	harbor2	chr7	34260679	34260860	LINE/L2	518	+	90	34260769	38545
chr7	34222224	34422224	harbor2	chr7	34260888	34261027	LINE/L2	518	+	70	34260958	38734
chr7	34222224	34422224	harbor2	chr7	34269722	34270047	LINE/L2	547	+	162	34269884	47660
chr7	34222224	34422224	harbor2	chr7	34313130	34313365	LINE/L2	600	+	118	34313248	91024
chr7	154941378	155141378	harbor2	chr7	155023726	155024081	LINE/L2	673	+	178	155023904	82526
chr7	154941378	155141378	harbor2	chr7	155024842	155025299	LINE/L2	492	+	228	155025070	83692
chr7	154941378	155141378	harbor2	chr7	155025615	155025908	LINE/L2	492	+	146	155025761	84383
chr7	132637756	132837756	harbor2	chr7	132650240	132650382	LINE/L2	570	+	71	132650311	12555
chr7	132637756	132837756	harbor2	chr7	132679609	132679740	LINE/L2	471	+	66	132679675	41919
chr7	111752459	111952459	harbor2	chr7	111817635	111818670	LINE/L2	2883	+	518	111818153	65694
chr7	111752459	111952459	harbor2	chr7	111830971	111831473	LINE/L2	607	+	251	111831222	78763
chr7	111752459	111952459	harbor2	chr7	111831789	111831920	LINE/L2	607	+	66	111831855	79396
chr7	131757430	131957430	harbor2	chr7	131757548	131757679	LINE/L2	512	+	66	131757614	184
chr7	131757430	131957430	harbor2	chr7	131777025	131777389	LINE/L2	777	+	182	131777207	19777
chr7	131757430	131957430	harbor2	chr7	131845326	131845407	LINE/L2	464	+	40	131845366	87936
chr7	123584971	123784971	harbor2	chr7	123637194	123638346	LINE/L2	883	+	576	123637770	52799
chr7	123584971	123784971	harbor2	chr7	123638646	123638979	LINE/L2	766	+	166	123638812	53841
chr7	123584971	123784971	harbor2	chr7	123650745	123650992	LINE/L2	469	+	124	123650869	65898
chr7	123584971	123784971	harbor2	chr7	123652037	123652315	LINE/L2	905	+	139	123652176	67205
chr7	123584971	123784971	harbor2	chr7	123670650	123670752	LINE/L2	525	+	51	123670701	85730
chr7	123584971	123784971	harbor2	chr7	123671065	123671417	LINE/L2	525	+	176	123671241	86270
chr7	107757520	107957520	harbor2	chr7	107769830	107770000	LINE/L2	938	+	85	107769915	12395
chr7	107757520	107957520	harbor2	chr7	107770558	107770750	LINE/L2	938	+	96	107770654	13134
chr7	107757520	107957520	harbor2	chr7	107803710	107803879	LINE/L2	916	+	84	107803794	46274
chr7	107757520	107957520	harbor2	chr7	107804000	107805113	LINE/L2	916	+	556	107804556	47036
chr7	107757520	107957520	harbor2	chr7	107830219	107830963	LINE/L2	666	+	372	107830591	73071
chr7	140197844	140397844	harbor2	chr7	140235654	140235782	LINE/L2	533	+	64	140235718	37874
chr7	140197844	140397844	harbor2	chr7	140236044	140236095	LINE/L2	533	+	26	140236070	38226
chr7	140197844	140397844	harbor2	chr7	140283667	140283856	LINE/L2	638	+	94	140283761	85917
chr7	140197844	140397844	harbor2	chr7	140284360	140284533	LINE/L2	496	+	86	140284446	86602
chr7	77126223	77326223	harbor2	chr7	77188916	77190111	LINE/L2	1565	+	598	77189514	63291
chr7	124578158	124778158	harbor2	chr7	124584988	124585179	LINE/L2	2217	+	96	124585084	6926
chr7	124578158	124778158	harbor2	chr7	124585217	124585774	LINE/L2	2217	+	278	124585495	7337
chr7	124578158	124778158	harbor2	chr7	124586227	124587200	LINE/L2	2217	+	486	124586713	8555
chr7	124578158	124778158	harbor2	chr7	124596107	124596786	LINE/L2	1372	+	340	124596447	18289
chr7	124578158	124778158	harbor2	chr7	124596946	124597359	LINE/L2	981	+	206	124597152	18994
chr7	124578158	124778158	harbor2	chr7	124637499	124637901	LINE/L2	1651	+	201	124637700	59542
chr7	124578158	124778158	harbor2	chr7	124638141	124638732	LINE/L2	1651	+	296	124638437	60279
chr7	124578158	124778158	harbor2	chr7	124658888	124659220	LINE/L2	492	+	166	124659054	80896
chr7	124578158	124778158	harbor2	chr7	124583731	124583967	LINE/L2	624	+	118	124583849	5691
chr7	124578158	124778158	harbor2	chr7	124648679	124649746	LINE/L2	2082	+	534	124649213	71055
chr7	123062364	123262364	harbor2	chr7	123147859	123148412	LINE/L2	615	+	276	123148135	85771
chr7	123062364	123262364	harbor2	chr7	123149767	123151033	LINE/L2	1299	+	633	123150400	88036
chr7	123062364	123262364	harbor2	chr7	123151823	123152004	LINE/L2	591	+	90	123151913	89549
chr7	41910497	42110497	harbor2	chr7	41993340	41993683	LINE/L2	736	+	172	41993512	83015
chr7	41910497	42110497	harbor2	chr7	42003014	42003124	LINE/L2	537	+	55	42003069	92572
chr7	118192898	118392898	harbor2	chr7	118227952	118228332	LINE/L2	816	+	190	118228142	35244
chr7	118192898	118392898	harbor2	chr7	118228557	118229500	LINE/L2	1970	+	472	118229029	36131
chr7	152712452	152912452	harbor2	chr7	152757210	152757578	LINE/L2	722	+	184	152757394	44942
chr7	140548804	140748804	harbor2	chr7	140638604	140639030	LINE/L2	518	+	213	140638817	90013
chr7	69877572	70077572	harbor2	chr7	69913624	69914230	LINE/L2	480	+	303	69913927	36355
chr7	69877572	70077572	harbor2	chr7	69942159	69942300	LINE/L2	543	+	70	69942229	64657
chr7	93960603	94160603	harbor2	chr7	93963426	93963611	LINE/L2	670	+	92	93963518	2915
chr7	93960603	94160603	harbor2	chr7	94030745	94031463	LINE/L2	998	+	359	94031104	70501
chr7	147695910	147895910	harbor2	chr7	147773556	147774299	LINE/L2	1229	+	372	147773928	78018
chr7	147695910	147895910	harbor2	chr7	147790098	147790420	LINE/L2	458	+	161	147790259	94349
chr7	108176499	108376499	harbor2	chr7	108186167	108186573	LINE/L2	1596	+	203	108186370	9871
chr7	108176499	108376499	harbor2	chr7	108187111	108187536	LINE/L2	1596	+	212	108187323	10824
chr7	108176499	108376499	harbor2	chr7	108188453	108188585	LINE/L2	514	+	66	108188519	12020
chr7	108176499	108376499	harbor2	chr7	108226949	108227212	LINE/L2	478	+	132	108227081	50582
chr7	108176499	108376499	harbor2	chr7	108229106	108229275	LINE/L2	755	+	84	108229190	52691
chr7	108176499	108376499	harbor2	chr7	108229425	108229748	LINE/L2	755	+	162	108229587	53088
chr7	108176499	108376499	harbor2	chr7	108230151	108230718	LINE/L2	1134	+	284	108230435	53936
chr7	108176499	108376499	harbor2	chr7	108241515	108241675	LINE/L2	588	+	80	108241595	65096
chr7	141565929	141765929	harbor2	chr7	141565653	141565942	LINE/L2	1018	+	144	141565797	132
chr7	141565929	141765929	harbor2	chr7	141566027	141566387	LINE/L2	486	+	180	141566207	278
chr7	141565929	141765929	harbor2	chr7	141586958	141587884	LINE/L2	932	+	463	141587421	21492
chr7	141565929	141765929	harbor2	chr7	141631500	141631863	LINE/L2	1185	+	182	141631682	65753
chr7	141565929	141765929	harbor2	chr7	141646901	141647520	LINE/L2	883	+	310	141647211	81282
chr7	141565929	141765929	harbor2	chr7	141648063	141648407	LINE/L2	491	+	172	141648235	82306
chr7	116815448	117015448	harbor2	chr7	116818821	116820162	LINE/L2	1753	+	670	116819491	4043
chr7	116815448	117015448	harbor2	chr7	116852105	116852315	LINE/L2	616	+	105	116852210	36762
chr7	44413868	44613868	harbor2	chr7	44471888	44472172	LINE/L2	588	+	142	44472030	58162
chr7	136576774	136776774	harbor2	chr7	136647263	136647465	LINE/L2	526	+	101	136647364	70590
chr7	136576774	136776774	harbor2	chr7	136649053	136649459	LINE/L2	442	+	203	136649256	72482
chr7	147815470	148015470	harbor2	chr7	147836303	147836771	LINE/L2	665	+	234	147836537	21067
chr7	130015509	130215509	harbor2	chr7	130052777	130052961	LINE/L2	505	+	92	130052869	37360
chr7	130015509	130215509	harbor2	chr7	130053299	130053562	LINE/L2	774	+	132	130053431	37922
chr7	130015509	130215509	harbor2	chr7	130054838	130054869	LINE/L2	524	+	16	130054854	39345
chr7	130015509	130215509	harbor2	chr7	130055052	130055204	LINE/L2	524	+	76	130055128	39619
chr7	130015509	130215509	harbor2	chr7	130055508	130055562	LINE/L2	524	+	27	130055535	40026
chr7	130015509	130215509	harbor2	chr7	130073716	130074359	LINE/L2	479	+	322	130074038	58529
chr7	130015509	130215509	harbor2	chr7	130082614	130083340	LINE/L2	520	+	363	130082977	67468
chr7	130015509	130215509	harbor2	chr7	130083818	130084183	LINE/L2	493	+	182	130084000	68491
chr7	130015509	130215509	harbor2	chr7	130095910	130096098	LINE/L2	482	+	94	130096004	80495
chr7	130015509	130215509	harbor2	chr7	130100240	130100506	LINE/L2	539	+	133	130100373	84864
chr7	30230387	30430387	harbor2	chr7	30278117	30278679	LINE/L2	561	+	281	30278398	48011
chr7	145234781	145434781	harbor2	chr7	145242663	145243416	LINE/L2	777	+	376	145243039	8258
chr7	79231160	79431160	harbor2	chr7	79310631	79311240	LINE/L2	2491	+	304	79310935	79775
chr7	79231160	79431160	harbor2	chr7	79311462	79312133	LINE/L2	2491	+	336	79311798	80638
chr7	79231160	79431160	harbor2	chr7	79312178	79312748	LINE/L2	786	+	285	79312463	81303
chr7	81882661	82082661	harbor2	chr7	81942193	81942860	LINE/L2	457	+	334	81942527	59866
chr7	81882661	82082661	harbor2	chr7	81953100	81953502	LINE/L2	744	+	201	81953301	70640
chr7	81882661	82082661	harbor2	chr7	81952502	81952905	LINE/L2	756	+	202	81952704	70043
chr7	135355644	135555644	harbor2	chr7	135417615	135417787	LINE/L2	463	+	86	135417701	62057
chr7	111278166	111478166	harbor2	chr7	111290679	111290827	LINE/L2	580	+	74	111290753	12587
chr7	111278166	111478166	harbor2	chr7	111290859	111291005	LINE/L2	580	+	73	111290932	12766
chr7	111278166	111478166	harbor2	chr7	111302130	111302406	LINE/L2	564	+	138	111302268	24102
chr7	111278166	111478166	harbor2	chr7	111320733	111320984	LINE/L2	508	+	126	111320859	42693
chr7	111278166	111478166	harbor2	chr7	111343859	111344474	LINE/L2	509	+	308	111344167	66001
chr7	111278166	111478166	harbor2	chr7	111363591	111364149	LINE/L2	480	+	279	111363870	85704
chr7	111278166	111478166	harbor2	chr7	111279888	111280585	LINE/L2	876	+	348	111280236	2070
chr7	145991526	146191526	harbor2	chr7	146010765	146011131	LINE/L2	819	+	183	146010948	19422
chr7	145991526	146191526	harbor2	chr7	146011916	146012241	LINE/L2	673	+	162	146012078	20552
chr8	106208465	106408465	harbor2	chr8	106227082	106227546	LINE/L2	490	+	232	106227314	18849
chr8	106208465	106408465	harbor2	chr8	106294816	106295031	LINE/L2	433	+	108	106294924	86459
chr8	118930682	119130682	harbor2	chr8	118946693	118946931	LINE/L2	470	+	119	118946812	16130
chr8	118930682	119130682	harbor2	chr8	118972426	118972764	LINE/L2	689	+	169	118972595	41913
chr8	118930682	119130682	harbor2	chr8	118973132	118973206	LINE/L2	689	+	37	118973169	42487
chr8	118930682	119130682	harbor2	chr8	118973770	118974282	LINE/L2	846	+	256	118974026	43344
chr8	118930682	119130682	harbor2	chr8	119022526	119023389	LINE/L2	1356	+	432	119022958	92276
chr8	108165434	108365434	harbor2	chr8	108249552	108250679	LINE/L2	2015	+	564	108250116	84682
chr8	108165434	108365434	harbor2	chr8	108262309	108262711	LINE/L2	394	+	201	108262510	97076
chr8	108165434	108365434	harbor2	chr8	108262845	108263377	LINE/L2	1139	+	266	108263111	97677
chr8	64779174	64979174	harbor2	chr8	64795373	64795834	LINE/L2	622	+	230	64795603	16429
chr8	64779174	64979174	harbor2	chr8	64808717	64808833	LINE/L2	413	+	58	64808775	29601
chr8	64779174	64979174	harbor2	chr8	64809722	64810952	LINE/L2	821	+	615	64810337	31163
chr8	64779174	64979174	harbor2	chr8	64859116	64859573	LINE/L2	642	+	228	64859344	80170
chr8	126848017	127048017	harbor2	chr8	126886021	126886530	LINE/L2	759	+	254	126886275	38258
chr8	126848017	127048017	harbor2	chr8	126886908	126886961	LINE/L2	759	+	26	126886934	38917
chr8	126848017	127048017	harbor2	chr8	126887554	126888158	LINE/L2	376	+	302	126887856	39839
chr8	126848017	127048017	harbor2	chr8	126892319	126892593	LINE/L2	467	+	137	126892456	44439
chr8	126848017	127048017	harbor2	chr8	126895719	126896111	LINE/L2	813	+	196	126895915	47898
chr8	126848017	127048017	harbor2	chr8	126896393	126896889	LINE/L2	893	+	248	126896641	48624
chr8	126848017	127048017	harbor2	chr8	126940160	126940527	LINE/L2	901	+	184	126940344	92327
chr8	143800055	144000055	harbor2	chr8	143842976	143843454	LINE/L2	682	+	239	143843215	43160
chr8	119941684	120141684	harbor2	chr8	119944975	119945164	LINE/L2	370	+	94	119945069	3385
chr8	119941684	120141684	harbor2	chr8	120025553	120025929	LINE/L2	550	+	188	120025741	84057
chr8	92854671	93054671	harbor2	chr8	92868411	92868578	LINE/L2	551	+	84	92868495	13824
chr8	92854671	93054671	harbor2	chr8	92869012	92869251	LINE/L2	659	+	120	92869132	14461
chr8	122251802	122451802	harbor2	chr8	122291152	122291498	LINE/L2	415	+	173	122291325	39523
chr8	108904432	109104432	harbor2	chr8	108905938	108906222	LINE/L2	1096	+	142	108906080	1648
chr8	108904432	109104432	harbor2	chr8	108945492	108945768	LINE/L2	519	+	138	108945630	41198
chr8	108904432	109104432	harbor2	chr8	108948660	108949043	LINE/L2	489	+	192	108948852	44420
chr8	108904432	109104432	harbor2	chr8	108962982	108963527	LINE/L2	563	+	272	108963254	58822
chr8	108904432	109104432	harbor2	chr8	108996718	108997258	LINE/L2	401	+	270	108996988	92556
chr8	136811473	137011473	harbor2	chr8	136841664	136841950	LINE/L2	617	+	143	136841807	30334
chr8	136811473	137011473	harbor2	chr8	136894605	136895160	LINE/L2	514	+	278	136894883	83410
chr8	136811473	137011473	harbor2	chr8	136899006	136899264	LINE/L2	437	+	129	136899135	87662
chr8	83658035	83858035	harbor2	chr8	83702563	83702793	LINE/L2	695	+	115	83702678	44643
chr8	83658035	83858035	harbor2	chr8	83706665	83707861	LINE/L2	2130	+	598	83707263	49228
chr8	83658035	83858035	harbor2	chr8	83749397	83749577	LINE/L2	375	+	90	83749487	91452
chr8	83658035	83858035	harbor2	chr8	83752191	83753042	LINE/L2	667	+	426	83752617	94582
chr8	138789940	138989940	harbor2	chr8	138820846	138820914	LINE/L2	405	+	34	138820880	30940
chr8	138789940	138989940	harbor2	chr8	138824337	138824522	LINE/L2	409	+	92	138824429	34489
chr8	138789940	138989940	harbor2	chr8	138888799	138888909	LINE/L2	404	+	55	138888854	98914
chr8	60394043	60594043	harbor2	chr8	60398750	60399366	LINE/L2	1643	+	308	60399058	5015
chr8	60394043	60594043	harbor2	chr8	60400568	60400730	LINE/L2	451	+	81	60400649	6606
chr8	60394043	60594043	harbor2	chr8	60428662	60429117	LINE/L2	1664	+	228	60428890	34847
chr8	60394043	60594043	harbor2	chr8	60429564	60429684	LINE/L2	960	+	60	60429624	35581
chr8	60394043	60594043	harbor2	chr8	60429974	60429986	LINE/L2	960	+	6	60429980	35937
chr8	60394043	60594043	harbor2	chr8	60430013	60430561	LINE/L2	960	+	274	60430287	36244
chr8	60394043	60594043	harbor2	chr8	60430870	60430954	LINE/L2	867	+	42	60430912	36869
chr8	59244790	59444790	harbor2	chr8	59248772	59249285	LINE/L2	924	+	256	59249028	4238
chr8	59244790	59444790	harbor2	chr8	59252059	59252471	LINE/L2	610	+	206	59252265	7475
chr8	59244790	59444790	harbor2	chr8	59316852	59317153	LINE/L2	768	+	150	59317002	72212
chr8	59244790	59444790	harbor2	chr8	59334939	59335162	LINE/L2	670	+	112	59335051	90261
chr8	131612658	131812658	harbor2	chr8	131631066	131631185	LINE/L2	396	+	60	131631126	18468
chr8	131612658	131812658	harbor2	chr8	131648617	131649191	LINE/L2	1802	+	287	131648904	36246
chr8	131612658	131812658	harbor2	chr8	131649703	131649949	LINE/L2	1802	+	123	131649826	37168
chr8	131612658	131812658	harbor2	chr8	131703243	131703417	LINE/L2	368	+	87	131703330	90672
chr8	70555451	70755451	harbor2	chr8	70601097	70601629	LINE/L2	679	+	266	70601363	45912
chr8	70555451	70755451	harbor2	chr8	70633467	70633700	LINE/L2	383	+	116	70633583	78132
chr8	111913913	112113913	harbor2	chr8	111925269	111925527	LINE/L2	607	+	129	111925398	11485
chr8	111913913	112113913	harbor2	chr8	111996717	111997192	LINE/L2	2343	+	238	111996955	83042
chr8	111913913	112113913	harbor2	chr8	111997491	111998191	LINE/L2	2343	+	350	111997841	83928
chr8	111913913	112113913	harbor2	chr8	111998182	111998315	LINE/L2	554	+	66	111998248	84335
chr8	115792420	115992420	harbor2	chr8	115797792	115797985	LINE/L2	368	+	96	115797888	5468
chr8	115792420	115992420	harbor2	chr8	115803720	115804122	LINE/L2	536	+	201	115803921	11501
chr8	115792420	115992420	harbor2	chr8	115834255	115834489	LINE/L2	412	+	117	115834372	41952
chr8	115792420	115992420	harbor2	chr8	115845762	115846970	LINE/L2	1849	+	604	115846366	53946
chr8	115792420	115992420	harbor2	chr8	115848298	115849008	LINE/L2	718	+	355	115848653	56233
chr8	115792420	115992420	harbor2	chr8	115852131	115852484	LINE/L2	651	+	176	115852307	59887
chr8	115792420	115992420	harbor2	chr8	115853367	115855485	LINE/L2	3389	+	1059	115854426	62006
chr8	115792420	115992420	harbor2	chr8	115855806	115856048	LINE/L2	1069	+	121	115855927	63507
chr8	115792420	115992420	harbor2	chr8	115886625	115887047	LINE/L2	419	+	211	115886836	94416
chr8	90219208	90419208	harbor2	chr8	90291185	90291391	LINE/L2	699	+	103	90291288	72080
chr8	90219208	90419208	harbor2	chr8	90293332	90293606	LINE/L2	531	+	137	90293469	74261
chr8	90219208	90419208	harbor2	chr8	90297585	90298414	LINE/L2	886	+	414	90297999	78791
chr8	90219208	90419208	harbor2	chr8	90308746	90308916	LINE/L2	409	+	85	90308831	89623
chr8	90219208	90419208	harbor2	chr8	90291392	90293318	LINE/L2	4392	+	963	90292355	73147
chr8	101635464	101835464	harbor2	chr8	101648717	101649092	LINE/L2	371	+	188	101648905	13441
chr8	101635464	101835464	harbor2	chr8	101655895	101656234	LINE/L2	931	+	170	101656065	20601
chr8	101635464	101835464	harbor2	chr8	101727105	101727468	LINE/L2	423	+	182	101727287	91823
chr8	101635464	101835464	harbor2	chr8	101727648	101727845	LINE/L2	457	+	98	101727746	92282
chr8	125999393	126199393	harbor2	chr8	126089360	126089839	LINE/L2	648	+	240	126089600	90207
chr8	119461796	119661796	harbor2	chr8	119487277	119488275	LINE/L2	1348	+	499	119487776	25980
chr8	119461796	119661796	harbor2	chr8	119488878	119489051	LINE/L2	1348	+	86	119488964	27168
chr8	119461796	119661796	harbor2	chr8	119544329	119544775	LINE/L2	657	+	223	119544552	82756
chr8	109646305	109846305	harbor2	chr8	109646733	109647245	LINE/L2	653	+	256	109646989	684
chr8	109646305	109846305	harbor2	chr8	109653504	109655150	LINE/L2	1025	+	823	109654327	8022
chr8	109646305	109846305	harbor2	chr8	109711974	109712461	LINE/L2	651	+	244	109712218	65913
chr8	139336514	139536514	harbor2	chr8	139370457	139370680	LINE/L2	729	+	112	139370569	34055
chr8	139336514	139536514	harbor2	chr8	139371002	139371287	LINE/L2	729	+	142	139371144	34630
chr8	139336514	139536514	harbor2	chr8	139417312	139417426	LINE/L2	412	+	57	139417369	80855
chr8	139336514	139536514	harbor2	chr8	139429708	139429993	LINE/L2	394	+	142	139429850	93336
chr8	129740478	129940478	harbor2	chr8	129745019	129745553	LINE/L2	1401	+	267	129745286	4808
chr8	34234136	34434136	harbor2	chr8	34266547	34266712	LINE/L2	638	+	82	34266629	32493
chr8	83279564	83479564	harbor2	chr8	83304314	83305538	LINE/L2	1741	+	612	83304926	25362
chr8	83279564	83479564	harbor2	chr8	83371046	83371639	LINE/L2	840	+	296	83371342	91778
chr8	134602053	134802053	harbor2	chr8	134659610	134659753	LINE/L2	454	+	72	134659682	57629
chr8	66791204	66991204	harbor2	chr8	66795730	66795993	LINE/L2	603	+	132	66795862	4658
chr8	66791204	66991204	harbor2	chr8	66848178	66849593	LINE/L2	1217	+	708	66848886	57682
chr8	66791204	66991204	harbor2	chr8	66849879	66850302	LINE/L2	1217	+	212	66850091	58887
chr8	66791204	66991204	harbor2	chr8	66872478	66872675	LINE/L2	447	+	98	66872576	81372
chr8	52847118	53047118	harbor2	chr8	52903417	52903803	LINE/L2	1018	+	193	52903610	56492
chr8	121120761	121320761	harbor2	chr8	121148404	121148720	LINE/L2	417	+	158	121148562	27801
chr8	121120761	121320761	harbor2	chr8	121150869	121151012	LINE/L2	425	+	72	121150941	30180
chr8	121120761	121320761	harbor2	chr8	121151003	121151340	LINE/L2	825	+	168	121151171	30410
chr8	121120761	121320761	harbor2	chr8	121169399	121170686	LINE/L2	2695	+	644	121170043	49282
chr8	104256930	104456930	harbor2	chr8	104285208	104285372	LINE/L2	419	+	82	104285290	28360
chr8	104256930	104456930	harbor2	chr8	104292230	104292393	LINE/L2	455	+	82	104292312	35382
chr8	104199899	104399899	harbor2	chr8	104209453	104209727	LINE/L2	696	+	137	104209590	9691
chr8	104199899	104399899	harbor2	chr8	104212918	104213039	LINE/L2	403	+	60	104212978	13079
chr8	104199899	104399899	harbor2	chr8	104213321	104213578	LINE/L2	403	+	128	104213449	13550
chr8	104199899	104399899	harbor2	chr8	104216752	104216878	LINE/L2	680	+	63	104216815	16916
chr8	104199899	104399899	harbor2	chr8	104221833	104222335	LINE/L2	1277	+	251	104222084	22185
chr8	104199899	104399899	harbor2	chr8	104285208	104285372	LINE/L2	419	+	82	104285290	85391
chr8	104199899	104399899	harbor2	chr8	104292230	104292393	LINE/L2	455	+	82	104292312	92413
chr8	135665959	135865959	harbor2	chr8	135688634	135688980	LINE/L2	450	+	173	135688807	22848
chr8	135665959	135865959	harbor2	chr8	135716713	135716858	LINE/L2	421	+	72	135716785	50826
chr8	137010071	137210071	harbor2	chr8	137043617	137044082	LINE/L2	453	+	232	137043849	33778
chr8	140484073	140684073	harbor2	chr8	140500543	140500831	LINE/L2	471	+	144	140500687	16614
chr8	140484073	140684073	harbor2	chr8	140509762	140509903	LINE/L2	586	+	70	140509832	25759
chr8	140484073	140684073	harbor2	chr8	140509102	140509455	LINE/L2	586	+	176	140509278	25205
chr8	21130615	21330615	harbor2	chr8	21162013	21162991	LINE/L2	1237	+	489	21162502	31887
chr8	21130615	21330615	harbor2	chr8	21205093	21205323	LINE/L2	433	+	115	21205208	74593
chr8	21130615	21330615	harbor2	chr8	21218091	21218449	LINE/L2	436	+	179	21218270	87655
chr8	131591598	131791598	harbor2	chr8	131631066	131631185	LINE/L2	396	+	60	131631126	39528
chr8	131591598	131791598	harbor2	chr8	131648617	131649191	LINE/L2	1802	+	287	131648904	57306
chr8	131591598	131791598	harbor2	chr8	131649703	131649949	LINE/L2	1802	+	123	131649826	58228
chr8	109192330	109392330	harbor2	chr8	109196780	109197071	LINE/L2	1412	+	146	109196926	4596
chr8	109192330	109392330	harbor2	chr8	109197504	109197956	LINE/L2	1412	+	226	109197730	5400
chr8	127348380	127548380	harbor2	chr8	127379065	127379232	LINE/L2	493	+	84	127379149	30769
chr8	127348380	127548380	harbor2	chr8	127386894	127387881	LINE/L2	2462	+	494	127387388	39008
chr8	107925272	108125272	harbor2	chr8	107953828	107954095	LINE/L2	518	+	134	107953962	28690
chr8	107925272	108125272	harbor2	chr8	107979686	107979978	LINE/L2	539	+	146	107979832	54560
chr8	111967363	112167363	harbor2	chr8	111996717	111997192	LINE/L2	2343	+	238	111996955	29592
chr8	111967363	112167363	harbor2	chr8	111997491	111998191	LINE/L2	2343	+	350	111997841	30478
chr8	111967363	112167363	harbor2	chr8	111998182	111998315	LINE/L2	554	+	66	111998248	30885
chr8	132968794	133168794	harbor2	chr8	132992742	132993026	LINE/L2	521	+	142	132992884	24090
chr8	132968794	133168794	harbor2	chr8	133035836	133036400	LINE/L2	557	+	282	133036118	67324
chr8	63312357	63512357	harbor2	chr8	63332086	63332201	LINE/L2	527	+	58	63332144	19787
chr8	63312357	63512357	harbor2	chr8	63402635	63403225	LINE/L2	488	+	295	63402930	90573
chr8	85537303	85737303	harbor2	chr8	85559162	85560144	LINE/L2	835	+	491	85559653	22350
chr8	105947177	106147177	harbor2	chr8	105953119	105953375	LINE/L2	497	+	128	105953247	6070
chr8	40368612	40568612	harbor2	chr8	40405433	40405722	LINE/L2	1485	+	144	40405577	36965
chr8	40368612	40568612	harbor2	chr8	40406329	40406679	LINE/L2	1485	+	175	40406504	37892
chr8	40368612	40568612	harbor2	chr8	40407107	40407568	LINE/L2	1082	+	230	40407337	38725
chr8	40368612	40568612	harbor2	chr8	40408144	40408282	LINE/L2	429	+	69	40408213	39601
chr8	128058087	128258087	harbor2	chr8	128083946	128084644	LINE/L2	906	+	349	128084295	26208
chr8	128058087	128258087	harbor2	chr8	128101535	128102268	LINE/L2	1198	+	366	128101901	43814
chr8	86639356	86839356	harbor2	chr8	86654100	86654634	LINE/L2	370	+	267	86654367	15011
chr8	86639356	86839356	harbor2	chr8	86655457	86655780	LINE/L2	420	+	162	86655619	16263
chr8	38776023	38976023	harbor2	chr8	38811215	38811436	LINE/L2	439	+	110	38811325	35302
chr8	38776023	38976023	harbor2	chr8	38812513	38812930	LINE/L2	445	+	208	38812721	36698
chr8	38776023	38976023	harbor2	chr8	38841939	38842256	LINE/L2	448	+	158	38842097	66074
chr8	83716537	83916537	harbor2	chr8	83749397	83749577	LINE/L2	375	+	90	83749487	32950
chr8	83716537	83916537	harbor2	chr8	83752191	83753042	LINE/L2	667	+	426	83752617	36080
chr8	103245934	103445934	harbor2	chr8	103257155	103257306	LINE/L2	427	+	76	103257231	11297
chr8	103245934	103445934	harbor2	chr8	103303028	103303583	LINE/L2	552	+	278	103303306	57372
chr8	103245934	103445934	harbor2	chr8	103330551	103330773	LINE/L2	425	+	111	103330662	84728
chr8	123036703	123236703	harbor2	chr8	123038847	123039675	LINE/L2	549	+	414	123039261	2558
chr8	123036703	123236703	harbor2	chr8	123047888	123048011	LINE/L2	680	+	62	123047950	11247
chr8	123036703	123236703	harbor2	chr8	123048253	123048367	LINE/L2	833	+	57	123048310	11607
chr8	123036703	123236703	harbor2	chr8	123048669	123048998	LINE/L2	833	+	164	123048833	12130
chr8	123036703	123236703	harbor2	chr8	123052299	123052568	LINE/L2	752	+	134	123052433	15730
chr8	123036703	123236703	harbor2	chr8	123082346	123082575	LINE/L2	412	+	114	123082460	45757
chr8	123036703	123236703	harbor2	chr8	123083556	123083878	LINE/L2	403	+	161	123083717	47014
chr8	123036703	123236703	harbor2	chr8	123095906	123096300	LINE/L2	790	+	197	123096103	59400
chr8	123036703	123236703	harbor2	chr8	123096446	123096699	LINE/L2	415	+	126	123096572	59869
chr8	65537470	65737470	harbor2	chr8	65558473	65559162	LINE/L2	743	+	344	65558817	21347
chr8	65537470	65737470	harbor2	chr8	65595359	65595616	LINE/L2	430	+	128	65595487	58017
chr8	65537470	65737470	harbor2	chr8	65607537	65607647	LINE/L2	461	+	55	65607592	70122
chr8	131166543	131366543	harbor2	chr8	131179039	131179185	LINE/L2	405	+	73	131179112	12569
chr8	131166543	131366543	harbor2	chr8	131208149	131208256	LINE/L2	427	+	54	131208203	41660
chr8	131166543	131366543	harbor2	chr8	131208730	131209015	LINE/L2	427	+	142	131208872	42329
chr8	131166543	131366543	harbor2	chr8	131209403	131209559	LINE/L2	427	+	78	131209481	42938
chr8	131166543	131366543	harbor2	chr8	131245243	131245943	LINE/L2	1296	+	350	131245593	79050
chr8	78564748	78764748	harbor2	chr8	78578643	78579520	LINE/L2	1667	+	438	78579081	14333
chr8	78564748	78764748	harbor2	chr8	78608250	78608594	LINE/L2	393	+	172	78608422	43674
chr8	128928583	129128583	harbor2	chr8	128963777	128964105	LINE/L2	403	+	164	128963941	35358
chr8	128928583	129128583	harbor2	chr8	128970508	128971196	LINE/L2	811	+	344	128970852	42269
chr8	128928583	129128583	harbor2	chr8	129012452	129012840	LINE/L2	458	+	194	129012646	84063
chr8	53435652	53635652	harbor2	chr8	53452998	53453400	LINE/L2	744	+	201	53453199	17547
chr8	53435652	53635652	harbor2	chr8	53453416	53453592	LINE/L2	667	+	88	53453504	17852
chr8	53435652	53635652	harbor2	chr8	53453632	53453749	LINE/L2	667	+	58	53453690	18038
chr8	53435652	53635652	harbor2	chr8	53502502	53503137	LINE/L2	835	+	318	53502820	67168
chr8	31978400	32178400	harbor2	chr8	32070580	32071278	LINE/L2	370	+	349	32070929	92529
chr8	97173533	97373533	harbor2	chr8	97182148	97182237	LINE/L2	374	+	44	97182192	8659
chr8	97173533	97373533	harbor2	chr8	97218638	97219517	LINE/L2	1746	+	440	97219078	45545
chr8	97173533	97373533	harbor2	chr8	97226422	97227074	LINE/L2	380	+	326	97226748	53215
chr8	97173533	97373533	harbor2	chr8	97234761	97234967	LINE/L2	501	+	103	97234864	61331
chr8	122992816	123192816	harbor2	chr8	122995687	122996083	LINE/L2	435	+	198	122995885	3069
chr8	122992816	123192816	harbor2	chr8	123038847	123039675	LINE/L2	549	+	414	123039261	46445
chr8	122992816	123192816	harbor2	chr8	123047888	123048011	LINE/L2	680	+	62	123047950	55134
chr8	122992816	123192816	harbor2	chr8	123048253	123048367	LINE/L2	833	+	57	123048310	55494
chr8	122992816	123192816	harbor2	chr8	123048669	123048998	LINE/L2	833	+	164	123048833	56017
chr8	122992816	123192816	harbor2	chr8	123052299	123052568	LINE/L2	752	+	134	123052433	59617
chr8	122992816	123192816	harbor2	chr8	123082346	123082575	LINE/L2	412	+	114	123082460	89644
chr8	122992816	123192816	harbor2	chr8	123083556	123083878	LINE/L2	403	+	161	123083717	90901
chr8	144913422	145113422	harbor2	chr8	144924088	144924651	LINE/L2	804	+	282	144924370	10948
chr8	144913422	145113422	harbor2	chr8	144925351	144925660	LINE/L2	549	+	154	144925505	12083
chr8	144913422	145113422	harbor2	chr8	144932793	144933003	LINE/L2	409	+	105	144932898	19476
chr8	122624213	122824213	harbor2	chr8	122661697	122661979	LINE/L2	1052	+	141	122661838	37625
chr8	122624213	122824213	harbor2	chr8	122662405	122662734	LINE/L2	1052	+	164	122662569	38356
chr8	122624213	122824213	harbor2	chr8	122665599	122666249	LINE/L2	1226	+	325	122665924	41711
chr8	122624213	122824213	harbor2	chr8	122666544	122666591	LINE/L2	1226	+	24	122666568	42355
chr8	122624213	122824213	harbor2	chr8	122688019	122688200	LINE/L2	687	+	90	122688109	63896
chr8	122624213	122824213	harbor2	chr8	122699352	122699465	LINE/L2	452	+	56	122699408	75195
chr8	122624213	122824213	harbor2	chr8	122715434	122715606	LINE/L2	369	+	86	122715520	91307
chr8	122624213	122824213	harbor2	chr8	122716194	122716319	LINE/L2	423	+	62	122716256	92043
chr8	122624213	122824213	harbor2	chr8	122666915	122667592	LINE/L2	1233	+	338	122667253	43040
chr8	131606213	131806213	harbor2	chr8	131631066	131631185	LINE/L2	396	+	60	131631126	24913
chr8	131606213	131806213	harbor2	chr8	131648617	131649191	LINE/L2	1802	+	287	131648904	42691
chr8	131606213	131806213	harbor2	chr8	131649703	131649949	LINE/L2	1802	+	123	131649826	43613
chr8	131606213	131806213	harbor2	chr8	131703243	131703417	LINE/L2	368	+	87	131703330	97117
chr8	118419566	118619566	harbor2	chr8	118446771	118447294	LINE/L2	1137	+	262	118447033	27467
chr8	118419566	118619566	harbor2	chr8	118448028	118448500	LINE/L2	1211	+	236	118448264	28698
chr8	118419566	118619566	harbor2	chr8	118455004	118455278	LINE/L2	546	+	137	118455141	35575
chr8	118419566	118619566	harbor2	chr8	118455413	118455798	LINE/L2	1210	+	192	118455605	36039
chr8	118419566	118619566	harbor2	chr8	118460893	118461295	LINE/L2	486	+	201	118461094	41528
chr8	118419566	118619566	harbor2	chr8	118479028	118479281	LINE/L2	880	+	126	118479154	59588
chr8	118419566	118619566	harbor2	chr8	118479630	118479878	LINE/L2	784	+	124	118479754	60188
chr8	118419566	118619566	harbor2	chr8	118491008	118491470	LINE/L2	404	+	231	118491239	71673
chr8	118419566	118619566	harbor2	chr8	118494581	118494875	LINE/L2	408	+	147	118494728	75162
chr8	118419566	118619566	harbor2	chr8	118455836	118456403	LINE/L2	1210	+	284	118456120	36554
chr8	113712483	113912483	harbor2	chr8	113752718	113752824	LINE/L2	427	+	53	113752771	40288
chr8	85482121	85682121	harbor2	chr8	85502845	85504194	LINE/L2	1687	+	674	85503519	21398
chr8	85482121	85682121	harbor2	chr8	85509822	85510045	LINE/L2	386	+	112	85509934	27813
chr8	85482121	85682121	harbor2	chr8	85511733	85512077	LINE/L2	424	+	172	85511905	29784
chr8	85482121	85682121	harbor2	chr8	85522083	85522642	LINE/L2	555	+	280	85522363	40242
chr8	85482121	85682121	harbor2	chr8	85559162	85560144	LINE/L2	835	+	491	85559653	77532
chr8	115793057	115993057	harbor2	chr8	115797792	115797985	LINE/L2	368	+	96	115797888	4831
chr8	115793057	115993057	harbor2	chr8	115803720	115804122	LINE/L2	536	+	201	115803921	10864
chr8	115793057	115993057	harbor2	chr8	115834255	115834489	LINE/L2	412	+	117	115834372	41315
chr8	115793057	115993057	harbor2	chr8	115845762	115846970	LINE/L2	1849	+	604	115846366	53309
chr8	115793057	115993057	harbor2	chr8	115848298	115849008	LINE/L2	718	+	355	115848653	55596
chr8	115793057	115993057	harbor2	chr8	115852131	115852484	LINE/L2	651	+	176	115852307	59250
chr8	115793057	115993057	harbor2	chr8	115853367	115855485	LINE/L2	3389	+	1059	115854426	61369
chr8	115793057	115993057	harbor2	chr8	115855806	115856048	LINE/L2	1069	+	121	115855927	62870
chr8	115793057	115993057	harbor2	chr8	115886625	115887047	LINE/L2	419	+	211	115886836	93779
chr8	137851357	138051357	harbor2	chr8	137851301	137852104	LINE/L2	483	+	402	137851703	346
chr8	137851357	138051357	harbor2	chr8	137895196	137896372	LINE/L2	2312	+	588	137895784	44427
chr8	137851357	138051357	harbor2	chr8	137932818	137933053	LINE/L2	663	+	118	137932936	81579
chr8	137851357	138051357	harbor2	chr8	137933086	137933320	LINE/L2	582	+	117	137933203	81846
chr8	87673781	87873781	harbor2	chr8	87757752	87757942	LINE/L2	376	+	95	87757847	84066
chr8	133694195	133894195	harbor2	chr8	133697218	133697643	LINE/L2	689	+	212	133697430	3235
chr8	133694195	133894195	harbor2	chr8	133724167	133724618	LINE/L2	505	+	226	133724393	30198
chr8	133694195	133894195	harbor2	chr8	133752400	133752985	LINE/L2	717	+	292	133752692	58497
chr8	28051271	28251271	harbor2	chr8	28086582	28086930	LINE/L2	955	+	174	28086756	35485
chr8	28051271	28251271	harbor2	chr8	28087680	28087969	LINE/L2	1639	+	144	28087824	36553
chr8	28051271	28251271	harbor2	chr8	28088147	28088477	LINE/L2	1639	+	165	28088312	37041
chr8	28051271	28251271	harbor2	chr8	28088763	28088918	LINE/L2	1639	+	78	28088841	37570
chr8	81433329	81633329	harbor2	chr8	81516169	81516732	LINE/L2	1593	+	282	81516451	83122
chr8	13813751	14013751	harbor2	chr8	13815457	13816179	LINE/L2	493	+	361	13815818	2067
chr8	13813751	14013751	harbor2	chr8	13893348	13894049	LINE/L2	1017	+	350	13893698	79947
chr8	69729267	69929267	harbor2	chr8	69744312	69744694	LINE/L2	528	+	191	69744503	15236
chr8	69729267	69929267	harbor2	chr8	69750478	69750893	LINE/L2	599	+	208	69750686	21419
chr8	69729267	69929267	harbor2	chr8	69766042	69766869	LINE/L2	1348	+	414	69766456	37189
chr8	69729267	69929267	harbor2	chr8	69773819	69774141	LINE/L2	769	+	161	69773980	44713
chr8	69729267	69929267	harbor2	chr8	69802628	69802987	LINE/L2	374	+	180	69802808	73541
chr8	141717402	141917402	harbor2	chr8	141728205	141728530	LINE/L2	460	+	162	141728367	10965
chr8	112812475	113012475	harbor2	chr8	112853567	112853779	LINE/L2	437	+	106	112853673	41198
chr8	112812475	113012475	harbor2	chr8	112860460	112861093	LINE/L2	607	+	316	112860776	48301
chr8	112812475	113012475	harbor2	chr8	112865734	112865866	LINE/L2	533	+	66	112865800	53325
chr8	112812475	113012475	harbor2	chr8	112884910	112885198	LINE/L2	380	+	144	112885054	72579
chr8	112812475	113012475	harbor2	chr8	112892596	112892974	LINE/L2	799	+	189	112892785	80310
chr8	112812475	113012475	harbor2	chr8	112896484	112897363	LINE/L2	416	+	440	112896924	84449
chr8	136759594	136959594	harbor2	chr8	136841664	136841950	LINE/L2	617	+	143	136841807	82213
chr8	133392409	133592409	harbor2	chr8	133419496	133419833	LINE/L2	474	+	168	133419664	27255
chr8	133392409	133592409	harbor2	chr8	133430705	133430936	LINE/L2	701	+	116	133430821	38412
chr8	133392409	133592409	harbor2	chr8	133431869	133432036	LINE/L2	392	+	84	133431953	39544
chr8	133392409	133592409	harbor2	chr8	133444651	133444767	LINE/L2	501	+	58	133444709	52300
chr8	133392409	133592409	harbor2	chr8	133474097	133474408	LINE/L2	406	+	156	133474253	81844
chr8	133392409	133592409	harbor2	chr8	133474428	133474961	LINE/L2	466	+	266	133474694	82285
chr8	133392409	133592409	harbor2	chr8	133475431	133475478	LINE/L2	466	+	24	133475455	83046
chr8	133392409	133592409	harbor2	chr8	133478593	133478915	LINE/L2	565	+	161	133478754	86345
chr8	133392409	133592409	harbor2	chr8	133431266	133431481	LINE/L2	701	+	108	133431374	38965
chr8	124291924	124491924	harbor2	chr8	124318805	124319135	LINE/L2	843	+	165	124318970	27046
chr8	124291924	124491924	harbor2	chr8	124319148	124319334	LINE/L2	518	+	93	124319241	27317
chr8	124291924	124491924	harbor2	chr8	124356466	124356704	LINE/L2	668	+	119	124356585	64661
chr8	124291924	124491924	harbor2	chr8	124357008	124357312	LINE/L2	668	+	152	124357160	65236
chr8	131538625	131738625	harbor2	chr8	131631066	131631185	LINE/L2	396	+	60	131631126	92501
chr8	137994976	138194976	harbor2	chr8	138012358	138012712	LINE/L2	410	+	177	138012535	17559
chr8	137994976	138194976	harbor2	chr8	138013253	138013386	LINE/L2	410	+	66	138013319	18343
chr8	137994976	138194976	harbor2	chr8	138055529	138055793	LINE/L2	480	+	132	138055661	60685
chr8	137994976	138194976	harbor2	chr8	138056304	138057339	LINE/L2	823	+	518	138056822	61846
chr8	137994976	138194976	harbor2	chr8	138065414	138066089	LINE/L2	1049	+	338	138065752	70776
chr8	127955550	128155550	harbor2	chr8	128030624	128030735	LINE/L2	377	+	56	128030680	75130
chr8	127955550	128155550	harbor2	chr8	128044154	128044427	LINE/L2	685	+	136	128044290	88740
chr8	104586968	104786968	harbor2	chr8	104596132	104596236	LINE/L2	441	+	52	104596184	9216
chr8	104586968	104786968	harbor2	chr8	104603101	104603297	LINE/L2	460	+	98	104603199	16231
chr8	104586968	104786968	harbor2	chr8	104622780	104622937	LINE/L2	447	+	78	104622858	35890
chr8	104586968	104786968	harbor2	chr8	104628545	104628936	LINE/L2	442	+	196	104628741	41773
chr8	104586968	104786968	harbor2	chr8	104646501	104646685	LINE/L2	539	+	92	104646593	59625
chr8	104586968	104786968	harbor2	chr8	104647233	104647430	LINE/L2	542	+	98	104647331	60363
chr8	104586968	104786968	harbor2	chr8	104649459	104649871	LINE/L2	535	+	206	104649665	62697
chr8	104586968	104786968	harbor2	chr8	104643952	104645346	LINE/L2	2982	+	697	104644649	57681
chr8	74276742	74476742	harbor2	chr8	74295088	74295255	LINE/L2	384	+	84	74295172	18430
chr8	74276742	74476742	harbor2	chr8	74303289	74303587	LINE/L2	546	+	149	74303438	26696
chr8	74276742	74476742	harbor2	chr8	74303748	74304220	LINE/L2	546	+	236	74303984	27242
chr8	74276742	74476742	harbor2	chr8	74349175	74349431	LINE/L2	524	+	128	74349303	72561
chr8	141691577	141891577	harbor2	chr8	141728205	141728530	LINE/L2	460	+	162	141728367	36790
chr8	136365675	136565675	harbor2	chr8	136380902	136381225	LINE/L2	426	+	162	136381064	15389
chr8	136365675	136565675	harbor2	chr8	136448607	136448967	LINE/L2	639	+	180	136448787	83112
chr8	134687359	134887359	harbor2	chr8	134707129	134707385	LINE/L2	498	+	128	134707257	19898
chr8	134687359	134887359	harbor2	chr8	134721552	134721861	LINE/L2	441	+	154	134721706	34347
chr8	134687359	134887359	harbor2	chr8	134762531	134763085	LINE/L2	825	+	277	134762808	75449
chr8	134687359	134887359	harbor2	chr8	134763173	134763720	LINE/L2	886	+	274	134763447	76088
chr8	134687359	134887359	harbor2	chr8	134741361	134742117	LINE/L2	392	+	378	134741739	54380
chr8	76504478	76704478	harbor2	chr8	76543707	76543897	LINE/L2	426	+	95	76543802	39324
chr8	76504478	76704478	harbor2	chr8	76544227	76544462	LINE/L2	426	+	118	76544345	39867
chr8	76504478	76704478	harbor2	chr8	76547373	76547873	LINE/L2	922	+	250	76547623	43145
chr8	76504478	76704478	harbor2	chr8	76546046	76547395	LINE/L2	1719	+	674	76546720	42242
chr8	41896222	42096222	harbor2	chr8	41898734	41899185	LINE/L2	717	+	226	41898960	2738
chr8	41896222	42096222	harbor2	chr8	41907467	41908489	LINE/L2	1329	+	511	41907978	11756
chr8	41896222	42096222	harbor2	chr8	41909239	41909446	LINE/L2	413	+	104	41909343	13121
chr8	41896222	42096222	harbor2	chr8	41915826	41916079	LINE/L2	540	+	126	41915952	19730
chr8	41896222	42096222	harbor2	chr8	41960765	41961476	LINE/L2	5152	+	356	41961121	64899
chr8	41896222	42096222	harbor2	chr8	41961774	41963197	LINE/L2	5152	+	712	41962486	66264
chr8	41896222	42096222	harbor2	chr8	41969390	41970206	LINE/L2	1035	+	408	41969798	73576
chr8	41896222	42096222	harbor2	chr8	41973612	41974031	LINE/L2	377	+	210	41973822	77600
chr8	41896222	42096222	harbor2	chr8	41994218	41994775	LINE/L2	912	+	278	41994496	98274
chr8	41896222	42096222	harbor2	chr8	41995085	41995134	LINE/L2	912	+	24	41995109	98887
chr8	54227342	54427342	harbor2	chr8	54272067	54272250	LINE/L2	435	+	92	54272159	44817
chr8	54227342	54427342	harbor2	chr8	54272564	54272886	LINE/L2	435	+	161	54272725	45383
chr8	54227342	54427342	harbor2	chr8	54300475	54300862	LINE/L2	483	+	194	54300669	73327
chr8	83506021	83706021	harbor2	chr8	83569905	83570967	LINE/L2	1227	+	531	83570436	64415
chr8	81163964	81363964	harbor2	chr8	81209503	81209861	LINE/L2	498	+	179	81209682	45718
chr8	81163964	81363964	harbor2	chr8	81229402	81229923	LINE/L2	1607	+	260	81229662	65698
chr8	111603804	111803804	harbor2	chr8	111604866	111605759	LINE/L2	1330	+	446	111605312	1508
chr8	111603804	111803804	harbor2	chr8	111627309	111627860	LINE/L2	431	+	276	111627585	23781
chr8	111603804	111803804	harbor2	chr8	111661740	111662292	LINE/L2	667	+	276	111662016	58212
chr8	114326662	114526662	harbor2	chr8	114330883	114331144	LINE/L2	511	+	130	114331013	4351
chr8	114326662	114526662	harbor2	chr8	114331323	114331635	LINE/L2	855	+	156	114331479	4817
chr8	108471765	108671765	harbor2	chr8	108569614	108569981	LINE/L2	989	+	184	108569798	98033
chr8	88834263	89034263	harbor2	chr8	88882461	88883116	LINE/L2	681	+	328	88882789	48526
chr8	138107804	138307804	harbor2	chr8	138113502	138113663	LINE/L2	522	+	80	138113582	5778
chr8	138107804	138307804	harbor2	chr8	138136660	138136935	LINE/L2	403	+	138	138136798	28994
chr8	138107804	138307804	harbor2	chr8	138174700	138175018	LINE/L2	644	+	159	138174859	67055
chr8	138107804	138307804	harbor2	chr8	138175203	138175501	LINE/L2	446	+	149	138175352	67548
chr8	71526168	71726168	harbor2	chr8	71538222	71538374	LINE/L2	462	+	76	71538298	12130
chr8	71526168	71726168	harbor2	chr8	71596536	71596728	LINE/L2	387	+	96	71596632	70464
chr8	75409963	75609963	harbor2	chr8	75420087	75420603	LINE/L2	657	+	258	75420345	10382
chr8	75409963	75609963	harbor2	chr8	75454489	75454905	LINE/L2	739	+	208	75454697	44734
chr8	75409963	75609963	harbor2	chr8	75484415	75484789	LINE/L2	597	+	187	75484602	74639
chr8	110040239	110240239	harbor2	chr8	110097250	110097488	LINE/L2	369	+	119	110097369	57130
chr8	144791189	144991189	harbor2	chr8	144817173	144817545	LINE/L2	582	+	186	144817359	26170
chr8	144791189	144991189	harbor2	chr8	144817841	144818064	LINE/L2	582	+	112	144817953	26764
chr8	107602859	107802859	harbor2	chr8	107611431	107611689	LINE/L2	485	+	129	107611560	8701
chr8	107602859	107802859	harbor2	chr8	107624655	107624963	LINE/L2	454	+	154	107624809	21950
chr8	107602859	107802859	harbor2	chr8	107631598	107631770	LINE/L2	426	+	86	107631684	28825
chr8	107602859	107802859	harbor2	chr8	107700012	107700410	LINE/L2	410	+	199	107700211	97352
chr8	136067400	136267400	harbor2	chr8	136069627	136069916	LINE/L2	471	+	144	136069771	2371
chr8	136067400	136267400	harbor2	chr8	136070378	136071020	LINE/L2	962	+	321	136070699	3299
chr8	136067400	136267400	harbor2	chr8	136108704	136108880	LINE/L2	412	+	88	136108792	41392
chr8	136067400	136267400	harbor2	chr8	136109604	136109791	LINE/L2	412	+	94	136109698	42298
chr8	136067400	136267400	harbor2	chr8	136111141	136111280	LINE/L2	436	+	70	136111211	43811
chr8	128332732	128532732	harbor2	chr8	128354371	128355478	LINE/L2	1556	+	554	128354925	22193
chr8	128332732	128532732	harbor2	chr8	128369328	128369750	LINE/L2	544	+	211	128369539	36807
chr8	128332732	128532732	harbor2	chr8	128387616	128387842	LINE/L2	518	+	113	128387729	54997
chr8	128332732	128532732	harbor2	chr8	128415091	128415709	LINE/L2	973	+	309	128415400	82668
chr8	128332732	128532732	harbor2	chr8	128425224	128425820	LINE/L2	596	+	298	128425522	92790
chr8	105143614	105343614	harbor2	chr8	105218517	105218834	LINE/L2	789	+	158	105218675	75061
chr8	144399151	144599151	harbor2	chr8	144406189	144406717	LINE/L2	783	+	264	144406453	7302
chr8	128154020	128354020	harbor2	chr8	128163731	128164133	LINE/L2	575	+	201	128163932	9912
chr8	128154020	128354020	harbor2	chr8	128170073	128170318	LINE/L2	454	+	122	128170195	16175
chr8	128154020	128354020	harbor2	chr8	128192612	128192828	LINE/L2	858	+	108	128192720	38700
chr8	128154020	128354020	harbor2	chr8	128224985	128225381	LINE/L2	529	+	198	128225183	71163
chr8	128154020	128354020	harbor2	chr8	128231001	128231394	LINE/L2	1284	+	196	128231197	77177
chr8	128154020	128354020	harbor2	chr8	128231699	128231911	LINE/L2	1284	+	106	128231805	77785
chr8	128154020	128354020	harbor2	chr8	128251238	128251696	LINE/L2	871	+	229	128251467	97447
chr8	85107879	85307879	harbor2	chr8	85132199	85132224	LINE/L2	500	+	12	85132211	24332
chr8	85107879	85307879	harbor2	chr8	85132789	85132919	LINE/L2	500	+	65	85132854	24975
chr8	85107879	85307879	harbor2	chr8	85133453	85134353	LINE/L2	1601	+	450	85133903	26024
chr8	85107879	85307879	harbor2	chr8	85197816	85199170	LINE/L2	3123	+	677	85198493	90614
chr8	85107879	85307879	harbor2	chr8	85199139	85199523	LINE/L2	809	+	192	85199331	91452
chr8	125487789	125687789	harbor2	chr8	125528031	125528539	LINE/L2	530	+	254	125528285	40496
chr8	125487789	125687789	harbor2	chr8	125550273	125550389	LINE/L2	402	+	58	125550331	62542
chr8	125487789	125687789	harbor2	chr8	125569432	125569687	LINE/L2	417	+	128	125569560	81771
chr8	125487789	125687789	harbor2	chr8	125571579	125571694	LINE/L2	476	+	58	125571637	83848
chr8	36351779	36551779	harbor2	chr8	36368729	36369044	LINE/L2	379	+	158	36368887	17108
chr8	36351779	36551779	harbor2	chr8	36420704	36420953	LINE/L2	808	+	124	36420828	69049
chr8	36351779	36551779	harbor2	chr8	36423445	36423819	LINE/L2	415	+	187	36423632	71853
chr8	36351779	36551779	harbor2	chr8	36424369	36424724	LINE/L2	892	+	178	36424547	72768
chr8	36351779	36551779	harbor2	chr8	36428685	36429027	LINE/L2	426	+	171	36428856	77077
chr8	36351779	36551779	harbor2	chr8	36429238	36429392	LINE/L2	453	+	77	36429315	77536
chr8	126352903	126552903	harbor2	chr8	126437019	126437865	LINE/L2	1352	+	423	126437442	84539
chr8	126352903	126552903	harbor2	chr8	126438167	126438206	LINE/L2	756	+	20	126438187	85284
chr8	126352903	126552903	harbor2	chr8	126438525	126438614	LINE/L2	756	+	44	126438569	85666
chr8	126352903	126552903	harbor2	chr8	126450565	126450801	LINE/L2	493	+	118	126450683	97780
chr8	52480106	52680106	harbor2	chr8	52542566	52543013	LINE/L2	578	+	224	52542790	62684
chr8	103088136	103288136	harbor2	chr8	103130248	103130997	LINE/L2	1033	+	374	103130622	42486
chr8	103088136	103288136	harbor2	chr8	103145699	103145812	LINE/L2	455	+	56	103145755	57619
chr8	103088136	103288136	harbor2	chr8	103151978	103152649	LINE/L2	715	+	336	103152314	64178
chr8	91339462	91539462	harbor2	chr8	91341648	91341916	LINE/L2	655	+	134	91341782	2320
chr8	91339462	91539462	harbor2	chr8	91342230	91342406	LINE/L2	396	+	88	91342318	2856
chr8	141085042	141285042	harbor2	chr8	141088549	141088726	LINE/L2	410	+	88	141088637	3595
chr8	141085042	141285042	harbor2	chr8	141147395	141147813	LINE/L2	373	+	209	141147604	62562
chr8	141085042	141285042	harbor2	chr8	141159415	141159687	LINE/L2	478	+	136	141159551	74509
chr8	137803723	138003723	harbor2	chr8	137836194	137837105	LINE/L2	1055	+	456	137836650	32927
chr8	137803723	138003723	harbor2	chr8	137851301	137852104	LINE/L2	483	+	402	137851703	47980
chr8	137803723	138003723	harbor2	chr8	137895196	137896372	LINE/L2	2312	+	588	137895784	92061
chr8	137504807	137704807	harbor2	chr8	137580667	137581061	LINE/L2	374	+	197	137580864	76057
chr8	137504807	137704807	harbor2	chr8	137585637	137585922	LINE/L2	411	+	142	137585779	80972
chr8	137504807	137704807	harbor2	chr8	137576238	137576559	LINE/L2	447	+	160	137576398	71591
chr8	123991439	124191439	harbor2	chr8	124005308	124005710	LINE/L2	378	+	201	124005509	14070
chr8	123991439	124191439	harbor2	chr8	124077983	124078186	LINE/L2	634	+	102	124078085	86646
chr8	127526900	127726900	harbor2	chr8	127531116	127531401	LINE/L2	555	+	142	127531258	4358
chr8	127526900	127726900	harbor2	chr8	127551252	127551330	LINE/L2	370	+	39	127551291	24391
chr8	127526900	127726900	harbor2	chr8	127551337	127552041	LINE/L2	1354	+	352	127551689	24789
chr8	127526900	127726900	harbor2	chr8	127585079	127585355	LINE/L2	502	+	138	127585217	58317
chr8	127526900	127726900	harbor2	chr8	127585398	127585537	LINE/L2	502	+	70	127585468	58568
chr8	127526900	127726900	harbor2	chr8	127585846	127585939	LINE/L2	502	+	46	127585892	58992
chr8	127526900	127726900	harbor2	chr8	127610003	127610234	LINE/L2	385	+	116	127610119	83219
chr8	117481186	117681186	harbor2	chr8	117518719	117519496	LINE/L2	441	+	388	117519107	37921
chr8	117481186	117681186	harbor2	chr8	117548611	117548677	LINE/L2	395	+	33	117548644	67458
chr8	117481186	117681186	harbor2	chr8	117560231	117560669	LINE/L2	777	+	219	117560450	79264
chr8	117481186	117681186	harbor2	chr8	117505743	117507477	LINE/L2	2690	+	867	117506610	25424
chr8	140131467	140331467	harbor2	chr8	140153232	140153660	LINE/L2	529	+	214	140153446	21979
chr8	140131467	140331467	harbor2	chr8	140154010	140154880	LINE/L2	503	+	435	140154445	22978
chr8	140131467	140331467	harbor2	chr8	140159267	140159394	LINE/L2	455	+	64	140159331	27864
chr8	140131467	140331467	harbor2	chr8	140162405	140162541	LINE/L2	370	+	68	140162473	31006
chr8	140131467	140331467	harbor2	chr8	140209226	140209355	LINE/L2	422	+	64	140209290	77823
chr8	32317202	32517202	harbor2	chr8	32333842	32334248	LINE/L2	484	+	203	32334045	16843
chr8	32317202	32517202	harbor2	chr8	32379851	32380771	LINE/L2	871	+	460	32380311	63109
chr8	32317202	32517202	harbor2	chr8	32381059	32381142	LINE/L2	871	+	42	32381101	63899
chr8	32317202	32517202	harbor2	chr8	32381134	32381523	LINE/L2	648	+	194	32381328	64126
chr8	32317202	32517202	harbor2	chr8	32390087	32390312	LINE/L2	452	+	112	32390199	72997
chr8	32317202	32517202	harbor2	chr8	32390632	32390878	LINE/L2	452	+	123	32390755	73553
chr8	32317202	32517202	harbor2	chr8	32401351	32401553	LINE/L2	549	+	101	32401452	84250
chr8	121579772	121779772	harbor2	chr8	121590070	121590214	LINE/L2	1435	+	72	121590142	10370
chr8	121579772	121779772	harbor2	chr8	121590420	121590572	LINE/L2	1435	+	76	121590496	10724
chr8	121579772	121779772	harbor2	chr8	121590880	121591110	LINE/L2	1435	+	115	121590995	11223
chr8	87552542	87752542	harbor2	chr8	87643144	87643519	LINE/L2	564	+	188	87643332	90790
chr8	118380376	118580376	harbor2	chr8	118396374	118396560	LINE/L2	411	+	93	118396467	16091
chr8	118380376	118580376	harbor2	chr8	118446771	118447294	LINE/L2	1137	+	262	118447033	66657
chr8	118380376	118580376	harbor2	chr8	118448028	118448500	LINE/L2	1211	+	236	118448264	67888
chr8	118380376	118580376	harbor2	chr8	118455004	118455278	LINE/L2	546	+	137	118455141	74765
chr8	118380376	118580376	harbor2	chr8	118455413	118455798	LINE/L2	1210	+	192	118455605	75229
chr8	118380376	118580376	harbor2	chr8	118460893	118461295	LINE/L2	486	+	201	118461094	80718
chr8	118380376	118580376	harbor2	chr8	118479028	118479281	LINE/L2	880	+	126	118479154	98778
chr8	118380376	118580376	harbor2	chr8	118479630	118479878	LINE/L2	784	+	124	118479754	99378
chr8	118380376	118580376	harbor2	chr8	118455836	118456403	LINE/L2	1210	+	284	118456120	75744
chr8	123887206	124087206	harbor2	chr8	123896769	123897313	LINE/L2	1146	+	272	123897041	9835
chr8	139226797	139426797	harbor2	chr8	139310306	139310644	LINE/L2	370	+	169	139310475	83678
chr8	57062066	57262066	harbor2	chr8	57127727	57127964	LINE/L2	502	+	118	57127845	65779
chr8	57062066	57262066	harbor2	chr8	57135700	57136639	LINE/L2	1114	+	470	57136170	74104
chr8	57062066	57262066	harbor2	chr8	57153475	57153586	LINE/L2	510	+	56	57153531	91465
chr8	66072721	66272721	harbor2	chr8	66104791	66105029	LINE/L2	802	+	119	66104910	32189
chr8	66072721	66272721	harbor2	chr8	66125260	66125437	LINE/L2	377	+	88	66125348	52627
chr8	52715336	52915336	harbor2	chr8	52723353	52723584	LINE/L2	411	+	116	52723469	8133
chr8	52715336	52915336	harbor2	chr8	52789526	52790050	LINE/L2	478	+	262	52789788	74452
chr8	52715336	52915336	harbor2	chr8	52796221	52796871	LINE/L2	909	+	325	52796546	81210
chr8	52715336	52915336	harbor2	chr8	52796892	52797332	LINE/L2	496	+	220	52797112	81776
chr8	67819923	68019923	harbor2	chr8	67846173	67846504	LINE/L2	448	+	166	67846339	26416
chr8	67819923	68019923	harbor2	chr8	67851696	67851896	LINE/L2	379	+	100	67851796	31873
chr8	67819923	68019923	harbor2	chr8	67919639	67920194	LINE/L2	759	+	278	67919917	99994
chr8	67819923	68019923	harbor2	chr8	67911506	67912228	LINE/L2	784	+	361	67911867	91944
chr8	58758424	58958424	harbor2	chr8	58762220	58762371	LINE/L2	395	+	76	58762296	3872
chr8	58758424	58958424	harbor2	chr8	58771810	58772186	LINE/L2	802	+	188	58771998	13574
chr8	58758424	58958424	harbor2	chr8	58773044	58773180	LINE/L2	802	+	68	58773112	14688
chr8	58758424	58958424	harbor2	chr8	58824290	58824858	LINE/L2	536	+	284	58824574	66150
chr8	58758424	58958424	harbor2	chr8	58836838	58836927	LINE/L2	556	+	44	58836882	78458
chr8	58758424	58958424	harbor2	chr8	58840649	58841201	LINE/L2	391	+	276	58840925	82501
chr8	58758424	58958424	harbor2	chr8	58855280	58855638	LINE/L2	391	+	179	58855459	97035
chr8	58758424	58958424	harbor2	chr8	58856527	58856550	LINE/L2	477	+	12	58856539	98115
chr8	58758424	58958424	harbor2	chr8	58857004	58857133	LINE/L2	477	+	64	58857068	98644
chr8	135624091	135824091	harbor2	chr8	135628048	135628351	LINE/L2	432	+	152	135628200	4109
chr8	135624091	135824091	harbor2	chr8	135632111	135632665	LINE/L2	912	+	277	135632388	8297
chr8	135624091	135824091	harbor2	chr8	135632728	135633164	LINE/L2	873	+	218	135632946	8855
chr8	135624091	135824091	harbor2	chr8	135688634	135688980	LINE/L2	450	+	173	135688807	64716
chr8	135624091	135824091	harbor2	chr8	135716713	135716858	LINE/L2	421	+	72	135716785	92694
chr8	134503652	134703652	harbor2	chr8	134505068	134505304	LINE/L2	496	+	118	134505186	1534
chr8	134503652	134703652	harbor2	chr8	134508508	134508803	LINE/L2	677	+	148	134508656	5004
chr8	134503652	134703652	harbor2	chr8	134567059	134567436	LINE/L2	423	+	188	134567247	63595
chr8	134503652	134703652	harbor2	chr8	134569950	134570356	LINE/L2	489	+	203	134570153	66501
chr8	94861883	95061883	harbor2	chr8	94876668	94877173	LINE/L2	578	+	252	94876920	15037
chr8	94861883	95061883	harbor2	chr8	94878659	94879118	LINE/L2	377	+	230	94878889	17006
chr8	94861883	95061883	harbor2	chr8	94907872	94907960	LINE/L2	464	+	44	94907916	46033
chr8	120068491	120268491	harbor2	chr8	120162717	120163055	LINE/L2	445	+	169	120162886	94395
chr8	126045451	126245451	harbor2	chr8	126089360	126089839	LINE/L2	648	+	240	126089600	44149
chr8	126045451	126245451	harbor2	chr8	126103789	126103957	LINE/L2	474	+	84	126103873	58422
chr8	126045451	126245451	harbor2	chr8	126133085	126133338	LINE/L2	386	+	126	126133211	87760
chr8	138799288	138999288	harbor2	chr8	138820846	138820914	LINE/L2	405	+	34	138820880	21592
chr8	138799288	138999288	harbor2	chr8	138824337	138824522	LINE/L2	409	+	92	138824429	25141
chr8	138799288	138999288	harbor2	chr8	138888799	138888909	LINE/L2	404	+	55	138888854	89566
chr8	102781874	102981874	harbor2	chr8	102811603	102811701	LINE/L2	372	+	49	102811652	29778
chr8	102781874	102981874	harbor2	chr8	102880981	102881308	LINE/L2	535	+	164	102881145	99271
chr8	138679488	138879488	harbor2	chr8	138682577	138682689	LINE/L2	397	+	56	138682633	3145
chr8	138679488	138879488	harbor2	chr8	138682999	138683288	LINE/L2	397	+	144	138683143	3655
chr8	138679488	138879488	harbor2	chr8	138738959	138739685	LINE/L2	1033	+	363	138739322	59834
chr8	138679488	138879488	harbor2	chr8	138747391	138747794	LINE/L2	436	+	202	138747593	68105
chr8	138679488	138879488	harbor2	chr8	138776707	138776831	LINE/L2	557	+	62	138776769	97281
chr8	144318364	144518364	harbor2	chr8	144348529	144348782	LINE/L2	569	+	126	144348655	30291
chr8	144318364	144518364	harbor2	chr8	144406189	144406717	LINE/L2	783	+	264	144406453	88089
chr8	138099717	138299717	harbor2	chr8	138113502	138113663	LINE/L2	522	+	80	138113582	13865
chr8	138099717	138299717	harbor2	chr8	138136660	138136935	LINE/L2	403	+	138	138136798	37081
chr8	138099717	138299717	harbor2	chr8	138174700	138175018	LINE/L2	644	+	159	138174859	75142
chr8	138099717	138299717	harbor2	chr8	138175203	138175501	LINE/L2	446	+	149	138175352	75635
chr8	127597199	127797199	harbor2	chr8	127610003	127610234	LINE/L2	385	+	116	127610119	12920
chr8	127597199	127797199	harbor2	chr8	127627437	127627677	LINE/L2	368	+	120	127627557	30358
chr8	127597199	127797199	harbor2	chr8	127671261	127671648	LINE/L2	567	+	194	127671455	74256
chr8	127597199	127797199	harbor2	chr8	127671999	127672619	LINE/L2	1348	+	310	127672309	75110
chr8	127597199	127797199	harbor2	chr8	127675924	127676116	LINE/L2	458	+	96	127676020	78821
chr8	127597199	127797199	harbor2	chr8	127676583	127676777	LINE/L2	368	+	97	127676680	79481
chr8	127597199	127797199	harbor2	chr8	127685843	127686207	LINE/L2	467	+	182	127686025	88826
chr8	127597199	127797199	harbor2	chr8	127690096	127690636	LINE/L2	674	+	270	127690366	93167
chr8	122708832	122908832	harbor2	chr8	122715434	122715606	LINE/L2	369	+	86	122715520	6688
chr8	122708832	122908832	harbor2	chr8	122716194	122716319	LINE/L2	423	+	62	122716256	7424
chr8	109628355	109828355	harbor2	chr8	109632884	109633003	LINE/L2	419	+	60	109632944	4589
chr8	109628355	109828355	harbor2	chr8	109646733	109647245	LINE/L2	653	+	256	109646989	18634
chr8	109628355	109828355	harbor2	chr8	109653504	109655150	LINE/L2	1025	+	823	109654327	25972
chr8	109628355	109828355	harbor2	chr8	109711974	109712461	LINE/L2	651	+	244	109712218	83863
chr8	124087151	124287151	harbor2	chr8	124098821	124099826	LINE/L2	887	+	502	124099323	12172
chr8	132921795	133121795	harbor2	chr8	132934944	132935137	LINE/L2	456	+	96	132935040	13245
chr8	132921795	133121795	harbor2	chr8	132935444	132935710	LINE/L2	456	+	133	132935577	13782
chr8	132921795	133121795	harbor2	chr8	132992742	132993026	LINE/L2	521	+	142	132992884	71089
chr8	144907691	145107691	harbor2	chr8	144924088	144924651	LINE/L2	804	+	282	144924370	16679
chr8	144907691	145107691	harbor2	chr8	144925351	144925660	LINE/L2	549	+	154	144925505	17814
chr8	144907691	145107691	harbor2	chr8	144932793	144933003	LINE/L2	409	+	105	144932898	25207
chr8	80972715	81172715	harbor2	chr8	80980961	80981367	LINE/L2	615	+	203	80981164	8449
chr8	80972715	81172715	harbor2	chr8	80981377	80981862	LINE/L2	2986	+	242	80981619	8904
chr8	80972715	81172715	harbor2	chr8	80982166	80983519	LINE/L2	2986	+	676	80982842	10127
chr8	80972715	81172715	harbor2	chr8	81001040	81001329	LINE/L2	385	+	144	81001184	28469
chr8	80972715	81172715	harbor2	chr8	81010779	81011204	LINE/L2	705	+	212	81010991	38276
chr8	80972715	81172715	harbor2	chr8	81011563	81011613	LINE/L2	705	+	25	81011588	38873
chr8	139721502	139921502	harbor2	chr8	139777007	139777309	LINE/L2	421	+	151	139777158	55656
chr8	105677264	105877264	harbor2	chr8	105683655	105683960	LINE/L2	497	+	152	105683807	6543
chr8	105677264	105877264	harbor2	chr8	105691052	105691231	LINE/L2	437	+	90	105691142	13878
chr8	105677264	105877264	harbor2	chr8	105691548	105691809	LINE/L2	437	+	130	105691678	14414
chr8	115413793	115613793	harbor2	chr8	115461428	115461588	LINE/L2	453	+	80	115461508	47715
chr9	6839634	7039634	harbor2	chr9	6917237	6918002	LINE/L2	1854	+	382	6917619	77985
chr9	6839634	7039634	harbor2	chr9	6920955	6922126	LINE/L2	1946	+	586	6921541	81907
chr9	6839634	7039634	harbor2	chr9	6927961	6928446	LINE/L2	517	+	242	6928203	88569
chr9	61772198	61972198	harbor2	chr9	61796353	61796794	LINE/L2	650	+	220	61796573	24375
chr9	133995964	134195964	harbor2	chr9	134055136	134055405	LINE/L2	485	+	134	134055270	59306
chr9	133995964	134195964	harbor2	chr9	134070781	134070968	LINE/L2	402	+	94	134070875	74911
chr9	125505580	125705580	harbor2	chr9	125534522	125535061	LINE/L2	503	+	270	125534792	29212
chr9	125505580	125705580	harbor2	chr9	125573665	125574075	LINE/L2	693	+	205	125573870	68290
chr9	125505580	125705580	harbor2	chr9	125586177	125586749	LINE/L2	602	+	286	125586463	80883
chr9	125505580	125705580	harbor2	chr9	125588571	125589055	LINE/L2	760	+	242	125588813	83233
chr9	125505580	125705580	harbor2	chr9	125583205	125583506	LINE/L2	576	+	150	125583355	77775
chr9	125505580	125705580	harbor2	chr9	125566775	125567172	LINE/L2	587	+	198	125566973	61393
chr9	129171771	129371771	harbor2	chr9	129240643	129241124	LINE/L2	492	+	240	129240883	69112
chr9	129171771	129371771	harbor2	chr9	129245531	129245989	LINE/L2	558	+	229	129245760	73989
chr9	129171771	129371771	harbor2	chr9	129257060	129257513	LINE/L2	711	+	226	129257286	85515
chr9	129171771	129371771	harbor2	chr9	129260270	129260490	LINE/L2	400	+	110	129260380	88609
chr9	127519830	127719830	harbor2	chr9	127522530	127523072	LINE/L2	508	+	271	127522801	2971
chr9	127519830	127719830	harbor2	chr9	127587934	127588320	LINE/L2	1292	+	193	127588127	68297
chr9	127519830	127719830	harbor2	chr9	127588644	127588831	LINE/L2	1292	+	94	127588738	68908
chr9	127519830	127719830	harbor2	chr9	127601358	127601539	LINE/L2	489	+	90	127601448	81618
chr9	127519830	127719830	harbor2	chr9	127609839	127610236	LINE/L2	486	+	198	127610037	90207
chr9	87800991	88000991	harbor2	chr9	87836432	87836538	LINE/L2	393	+	53	87836485	35494
chr9	126283861	126483861	harbor2	chr9	126292061	126292521	LINE/L2	812	+	230	126292291	8430
chr9	126283861	126483861	harbor2	chr9	126298649	126299090	LINE/L2	675	+	220	126298869	15008
chr9	86395629	86595629	harbor2	chr9	86402787	86403300	LINE/L2	400	+	256	86403043	7414
chr9	86395629	86595629	harbor2	chr9	86432988	86433075	LINE/L2	404	+	44	86433032	37403
chr9	86395629	86595629	harbor2	chr9	86440950	86441060	LINE/L2	424	+	55	86441005	45376
chr9	134006116	134206116	harbor2	chr9	134055136	134055405	LINE/L2	485	+	134	134055270	49154
chr9	134006116	134206116	harbor2	chr9	134070781	134070968	LINE/L2	402	+	94	134070875	64759
chr9	131975283	132175283	harbor2	chr9	131984073	131984402	LINE/L2	673	+	164	131984237	8954
chr9	131975283	132175283	harbor2	chr9	131986838	131986910	LINE/L2	395	+	36	131986874	11591
chr9	131975283	132175283	harbor2	chr9	132012581	132012912	LINE/L2	595	+	166	132012747	37464
chr9	131975283	132175283	harbor2	chr9	132028052	132028501	LINE/L2	431	+	224	132028276	52993
chr9	62693597	62893597	harbor2	chr9	62700194	62700387	LINE/L2	594	+	96	62700290	6693
chr9	62693597	62893597	harbor2	chr9	62703490	62704285	LINE/L2	962	+	398	62703888	10291
chr9	62693597	62893597	harbor2	chr9	62747126	62747579	LINE/L2	521	+	226	62747352	53755
chr9	89188340	89388340	harbor2	chr9	89263532	89263664	LINE/L2	497	+	66	89263598	75258
chr9	118317055	118517055	harbor2	chr9	118317968	118318714	LINE/L2	1001	+	373	118318341	1286
chr9	118317055	118517055	harbor2	chr9	118378689	118379260	LINE/L2	625	+	286	118378975	61920
chr9	105638242	105838242	harbor2	chr9	105655166	105655286	LINE/L2	648	+	60	105655226	16984
chr9	105638242	105838242	harbor2	chr9	105707987	105708144	LINE/L2	784	+	78	105708065	69823
chr9	105638242	105838242	harbor2	chr9	105708464	105708904	LINE/L2	784	+	220	105708684	70442
chr9	105638242	105838242	harbor2	chr9	105724872	105725404	LINE/L2	686	+	266	105725138	86896
chr9	70822425	71022425	harbor2	chr9	70823165	70823348	LINE/L2	655	+	92	70823257	832
chr9	70822425	71022425	harbor2	chr9	70823431	70823795	LINE/L2	510	+	182	70823613	1188
chr9	70822425	71022425	harbor2	chr9	70836180	70836970	LINE/L2	1024	+	395	70836575	14150
chr9	70822425	71022425	harbor2	chr9	70872364	70872683	LINE/L2	643	+	160	70872524	50099
chr9	70822425	71022425	harbor2	chr9	70911257	70911848	LINE/L2	650	+	296	70911553	89128
chr9	117913215	118113215	harbor2	chr9	117933381	117933523	LINE/L2	591	+	71	117933452	20237
chr9	117913215	118113215	harbor2	chr9	117938495	117938921	LINE/L2	703	+	213	117938708	25493
chr9	117913215	118113215	harbor2	chr9	117954254	117954465	LINE/L2	630	+	106	117954360	41145
chr9	117913215	118113215	harbor2	chr9	117969742	117970233	LINE/L2	454	+	246	117969988	56773
chr9	117913215	118113215	harbor2	chr9	118005972	118006152	LINE/L2	500	+	90	118006062	92847
chr9	133245008	133445008	harbor2	chr9	133337879	133338138	LINE/L2	630	+	130	133338009	93001
chr9	14200108	14400108	harbor2	chr9	14267506	14267819	LINE/L2	474	+	156	14267662	67554
chr9	14200108	14400108	harbor2	chr9	14286670	14286787	LINE/L2	398	+	58	14286728	86620
chr9	91365178	91565178	harbor2	chr9	91459717	91459852	LINE/L2	399	+	68	91459785	94607
chr9	117135775	117335775	harbor2	chr9	117163765	117163995	LINE/L2	396	+	115	117163880	28105
chr9	117135775	117335775	harbor2	chr9	117177779	117178062	LINE/L2	394	+	142	117177921	42146
chr9	117135775	117335775	harbor2	chr9	117178106	117178363	LINE/L2	452	+	128	117178234	42459
chr9	117135775	117335775	harbor2	chr9	117190488	117191014	LINE/L2	1008	+	263	117190751	54976
chr9	117135775	117335775	harbor2	chr9	117227222	117227453	LINE/L2	397	+	116	117227338	91563
chr9	106084886	106284886	harbor2	chr9	106105346	106105690	LINE/L2	683	+	172	106105518	20632
chr9	106084886	106284886	harbor2	chr9	106106003	106106454	LINE/L2	683	+	226	106106229	21343
chr9	106084886	106284886	harbor2	chr9	106123530	106123855	LINE/L2	691	+	162	106123692	38806
chr9	106084886	106284886	harbor2	chr9	106124023	106124359	LINE/L2	973	+	168	106124191	39305
chr9	106084886	106284886	harbor2	chr9	106143633	106143739	LINE/L2	420	+	53	106143686	58800
chr9	106084886	106284886	harbor2	chr9	106150057	106150247	LINE/L2	408	+	95	106150152	65266
chr9	106084886	106284886	harbor2	chr9	106156907	106157474	LINE/L2	475	+	284	106157191	72305
chr9	106084886	106284886	harbor2	chr9	106174512	106174648	LINE/L2	407	+	68	106174580	89694
chr9	106084886	106284886	harbor2	chr9	106177253	106177598	LINE/L2	521	+	172	106177425	92539
chr9	138245892	138445892	harbor2	chr9	138308546	138309239	LINE/L2	500	+	346	138308892	63000
chr9	79996081	80196081	harbor2	chr9	80004790	80005133	LINE/L2	1084	+	172	80004962	8881
chr9	128614084	128814084	harbor2	chr9	128654370	128654559	LINE/L2	834	+	94	128654464	40380
chr9	128614084	128814084	harbor2	chr9	128654720	128655064	LINE/L2	834	+	172	128654892	40808
chr9	109367266	109567266	harbor2	chr9	109397218	109397337	LINE/L2	395	+	60	109397278	30012
chr9	109367266	109567266	harbor2	chr9	109459769	109460930	LINE/L2	1931	+	580	109460349	93083
chr9	109367266	109567266	harbor2	chr9	109465882	109466205	LINE/L2	708	+	162	109466044	98778
chr9	100513280	100713280	harbor2	chr9	100550503	100550834	LINE/L2	763	+	166	100550669	37389
chr9	100513280	100713280	harbor2	chr9	100563695	100563807	LINE/L2	469	+	56	100563751	50471
chr9	100513280	100713280	harbor2	chr9	100565188	100565729	LINE/L2	1702	+	270	100565458	52178
chr9	100513280	100713280	harbor2	chr9	100565988	100566689	LINE/L2	2024	+	350	100566338	53058
chr9	100513280	100713280	harbor2	chr9	100567018	100567604	LINE/L2	1013	+	293	100567311	54031
chr9	100513280	100713280	harbor2	chr9	100583082	100583611	LINE/L2	1708	+	264	100583346	70066
chr9	100513280	100713280	harbor2	chr9	100583944	100584409	LINE/L2	1708	+	232	100584176	70896
chr9	100513280	100713280	harbor2	chr9	100590643	100590804	LINE/L2	410	+	80	100590723	77443
chr9	100513280	100713280	harbor2	chr9	100596727	100597225	LINE/L2	639	+	249	100596976	83696
chr9	100513280	100713280	harbor2	chr9	100601929	100602479	LINE/L2	439	+	275	100602204	88924
chr9	111301942	111501942	harbor2	chr9	111320918	111321630	LINE/L2	1369	+	356	111321274	19332
chr9	111301942	111501942	harbor2	chr9	111386752	111386932	LINE/L2	479	+	90	111386842	84900
chr9	111301942	111501942	harbor2	chr9	111394881	111395108	LINE/L2	721	+	114	111394995	93053
chr9	70818910	71018910	harbor2	chr9	70821796	70822186	LINE/L2	964	+	195	70821991	3081
chr9	70818910	71018910	harbor2	chr9	70823165	70823348	LINE/L2	655	+	92	70823257	4347
chr9	70818910	71018910	harbor2	chr9	70823431	70823795	LINE/L2	510	+	182	70823613	4703
chr9	70818910	71018910	harbor2	chr9	70836180	70836970	LINE/L2	1024	+	395	70836575	17665
chr9	70818910	71018910	harbor2	chr9	70872364	70872683	LINE/L2	643	+	160	70872524	53614
chr9	70818910	71018910	harbor2	chr9	70911257	70911848	LINE/L2	650	+	296	70911553	92643
chr9	98767974	98967974	harbor2	chr9	98787210	98787590	LINE/L2	874	+	190	98787400	19426
chr9	98767974	98967974	harbor2	chr9	98795069	98795381	LINE/L2	620	+	156	98795225	27251
chr9	98767974	98967974	harbor2	chr9	98803799	98803907	LINE/L2	426	+	54	98803853	35879
chr9	134492700	134692700	harbor2	chr9	134515072	134515661	LINE/L2	426	+	294	134515366	22666
chr9	116929359	117129359	harbor2	chr9	116992893	116993062	LINE/L2	436	+	84	116992977	63618
chr9	116929359	117129359	harbor2	chr9	116993134	116993551	LINE/L2	507	+	208	116993342	63983
chr9	116929359	117129359	harbor2	chr9	117004981	117005071	LINE/L2	1871	+	45	117005026	75667
chr9	116929359	117129359	harbor2	chr9	117006237	117006834	LINE/L2	1871	+	298	117006535	77176
chr9	116929359	117129359	harbor2	chr9	117007085	117007329	LINE/L2	1127	+	122	117007207	77848
chr9	116929359	117129359	harbor2	chr9	117007534	117007664	LINE/L2	1127	+	65	117007599	78240
chr9	116929359	117129359	harbor2	chr9	117023262	117023700	LINE/L2	692	+	219	117023481	94122
chr9	132609057	132809057	harbor2	chr9	132616951	132617074	LINE/L2	457	+	62	132617013	7956
chr9	132609057	132809057	harbor2	chr9	132617142	132617513	LINE/L2	769	+	186	132617328	8271
chr9	132609057	132809057	harbor2	chr9	132664767	132665220	LINE/L2	614	+	226	132664993	55936
chr9	132609057	132809057	harbor2	chr9	132683996	132684330	LINE/L2	818	+	167	132684163	75106
chr9	132609057	132809057	harbor2	chr9	132684332	132685006	LINE/L2	1016	+	337	132684669	75612
chr9	71242022	71442022	harbor2	chr9	71242606	71242884	LINE/L2	423	+	139	71242745	723
chr9	71242022	71442022	harbor2	chr9	71267120	71267456	LINE/L2	624	+	168	71267288	25266
chr9	71242022	71442022	harbor2	chr9	71280640	71281102	LINE/L2	724	+	231	71280871	38849
chr9	71242022	71442022	harbor2	chr9	71320550	71321186	LINE/L2	964	+	318	71320868	78846
chr9	82614346	82814346	harbor2	chr9	82661534	82661874	LINE/L2	460	+	170	82661704	47358
chr9	131307406	131507406	harbor2	chr9	131346608	131346907	LINE/L2	592	+	150	131346758	39352
chr9	83965099	84165099	harbor2	chr9	84004462	84004843	LINE/L2	412	+	190	84004652	39553
chr9	83965099	84165099	harbor2	chr9	84046859	84047191	LINE/L2	485	+	166	84047025	81926
chr9	110082390	110282390	harbor2	chr9	110093653	110093924	LINE/L2	418	+	136	110093789	11399
chr9	110082390	110282390	harbor2	chr9	110094129	110094235	LINE/L2	418	+	53	110094182	11792
chr9	110082390	110282390	harbor2	chr9	110102978	110103327	LINE/L2	665	+	174	110103152	20762
chr9	131756660	131956660	harbor2	chr9	131795110	131795342	LINE/L2	486	+	116	131795226	38566
chr9	105279905	105479905	harbor2	chr9	105312197	105312519	LINE/L2	582	+	161	105312358	32453
chr9	105279905	105479905	harbor2	chr9	105326748	105327243	LINE/L2	543	+	248	105326996	47091
chr9	105279905	105479905	harbor2	chr9	105327622	105328015	LINE/L2	591	+	196	105327818	47913
chr9	105279905	105479905	harbor2	chr9	105329662	105330103	LINE/L2	651	+	220	105329882	49977
chr9	105279905	105479905	harbor2	chr9	105360021	105360481	LINE/L2	1089	+	230	105360251	80346
chr9	109700567	109900567	harbor2	chr9	109754531	109754547	LINE/L2	1344	+	8	109754539	53972
chr9	109700567	109900567	harbor2	chr9	109754898	109755524	LINE/L2	1344	+	313	109755211	54644
chr9	109700567	109900567	harbor2	chr9	109764068	109764512	LINE/L2	427	+	222	109764290	63723
chr9	117891421	118091421	harbor2	chr9	117903744	117904488	LINE/L2	2155	+	372	117904116	12695
chr9	117891421	118091421	harbor2	chr9	117904790	117905543	LINE/L2	2155	+	376	117905166	13745
chr9	117891421	118091421	harbor2	chr9	117933381	117933523	LINE/L2	591	+	71	117933452	42031
chr9	117891421	118091421	harbor2	chr9	117938495	117938921	LINE/L2	703	+	213	117938708	47287
chr9	117891421	118091421	harbor2	chr9	117954254	117954465	LINE/L2	630	+	106	117954360	62939
chr9	117891421	118091421	harbor2	chr9	117969742	117970233	LINE/L2	454	+	246	117969988	78567
chr9	113500555	113700555	harbor2	chr9	113534172	113534354	LINE/L2	415	+	91	113534263	33708
chr9	113500555	113700555	harbor2	chr9	113534993	113535147	LINE/L2	415	+	77	113535070	34515
chr9	113500555	113700555	harbor2	chr9	113563249	113563389	LINE/L2	606	+	70	113563319	62764
chr9	113500555	113700555	harbor2	chr9	113577632	113578010	LINE/L2	405	+	189	113577821	77266
chr9	109676786	109876786	harbor2	chr9	109754531	109754547	LINE/L2	1344	+	8	109754539	77753
chr9	109676786	109876786	harbor2	chr9	109754898	109755524	LINE/L2	1344	+	313	109755211	78425
chr9	109676786	109876786	harbor2	chr9	109764068	109764512	LINE/L2	427	+	222	109764290	87504
chr9	108938793	109138793	harbor2	chr9	108945080	108945173	LINE/L2	543	+	46	108945126	6333
chr9	108938793	109138793	harbor2	chr9	108945857	108945998	LINE/L2	543	+	70	108945927	7134
chr9	108938793	109138793	harbor2	chr9	108946337	108946766	LINE/L2	906	+	214	108946551	7758
chr9	108938793	109138793	harbor2	chr9	108977373	108977736	LINE/L2	429	+	182	108977555	38762
chr9	108938793	109138793	harbor2	chr9	108988079	108988089	LINE/L2	1486	+	5	108988084	49291
chr9	108938793	109138793	harbor2	chr9	108988384	108988732	LINE/L2	1486	+	174	108988558	49765
chr9	108938793	109138793	harbor2	chr9	108988723	108988863	LINE/L2	606	+	70	108988793	50000
chr9	108938793	109138793	harbor2	chr9	108997624	108998053	LINE/L2	1338	+	214	108997838	59045
chr9	108938793	109138793	harbor2	chr9	108998030	108998122	LINE/L2	906	+	46	108998076	59283
chr9	108938793	109138793	harbor2	chr9	108998342	108998584	LINE/L2	906	+	121	108998463	59670
chr9	109871215	110071215	harbor2	chr9	109874552	109875467	LINE/L2	596	+	458	109875010	3795
chr9	109871215	110071215	harbor2	chr9	109898980	109900044	LINE/L2	806	+	532	109899512	28297
chr9	109871215	110071215	harbor2	chr9	109967931	109968064	LINE/L2	398	+	66	109967997	96782
chr9	109871215	110071215	harbor2	chr9	109971118	109971225	LINE/L2	423	+	54	109971172	99957
chr9	70329039	70529039	harbor2	chr9	70358218	70358349	LINE/L2	436	+	66	70358284	29245
chr9	70329039	70529039	harbor2	chr9	70382438	70383855	LINE/L2	1652	+	708	70383146	54107
chr9	70329039	70529039	harbor2	chr9	70421948	70423141	LINE/L2	4227	+	596	70422544	93505
chr9	70329039	70529039	harbor2	chr9	70423454	70423731	LINE/L2	4227	+	138	70423592	94553
chr9	70329039	70529039	harbor2	chr9	70424040	70424163	LINE/L2	4227	+	62	70424102	95063
chr9	70329039	70529039	harbor2	chr9	70424284	70424349	LINE/L2	4227	+	32	70424316	95277
chr9	70329039	70529039	harbor2	chr9	70424698	70425486	LINE/L2	4227	+	394	70425092	96053
chr9	119355842	119555842	harbor2	chr9	119356069	119356519	LINE/L2	1127	+	225	119356294	452
chr9	119355842	119555842	harbor2	chr9	119362966	119363101	LINE/L2	392	+	68	119363034	7192
chr9	119355842	119555842	harbor2	chr9	119363402	119363723	LINE/L2	693	+	160	119363562	7720
chr9	119355842	119555842	harbor2	chr9	119363934	119363990	LINE/L2	693	+	28	119363962	8120
chr9	119355842	119555842	harbor2	chr9	119401671	119402114	LINE/L2	470	+	222	119401893	46051
chr9	119355842	119555842	harbor2	chr9	119406901	119407030	LINE/L2	400	+	64	119406965	51123
chr9	119355842	119555842	harbor2	chr9	119438726	119439278	LINE/L2	914	+	276	119439002	83160
chr9	110881716	111081716	harbor2	chr9	110881663	110882347	LINE/L2	719	+	342	110882005	289
chr9	110881716	111081716	harbor2	chr9	110884109	110884539	LINE/L2	448	+	215	110884324	2608
chr9	110881716	111081716	harbor2	chr9	110968484	110968793	LINE/L2	551	+	154	110968638	86922
chr9	71813459	72013459	harbor2	chr9	71864540	71864893	LINE/L2	451	+	176	71864716	51257
chr9	71813459	72013459	harbor2	chr9	71904046	71904330	LINE/L2	441	+	142	71904188	90729
chr9	89725639	89925639	harbor2	chr9	89737217	89737485	LINE/L2	605	+	134	89737351	11712
chr9	89725639	89925639	harbor2	chr9	89739046	89739206	LINE/L2	492	+	80	89739126	13487
chr9	81297213	81497213	harbor2	chr9	81309112	81309246	LINE/L2	631	+	67	81309179	11966
chr9	81297213	81497213	harbor2	chr9	81309458	81310067	LINE/L2	631	+	304	81309762	12549
chr9	81297213	81497213	harbor2	chr9	81314962	81315617	LINE/L2	1659	+	328	81315290	18077
chr9	81297213	81497213	harbor2	chr9	81315813	81315962	LINE/L2	590	+	74	81315887	18674
chr9	81297213	81497213	harbor2	chr9	81317049	81317080	LINE/L2	590	+	16	81317065	19852
chr9	81297213	81497213	harbor2	chr9	81317444	81317780	LINE/L2	590	+	168	81317612	20399
chr9	81297213	81497213	harbor2	chr9	81313196	81314388	LINE/L2	1659	+	596	81313792	16579
chr9	110833765	111033765	harbor2	chr9	110856562	110858072	LINE/L2	1264	+	755	110857317	23552
chr9	110833765	111033765	harbor2	chr9	110881663	110882347	LINE/L2	719	+	342	110882005	48240
chr9	110833765	111033765	harbor2	chr9	110884109	110884539	LINE/L2	448	+	215	110884324	50559
chr9	108970538	109170538	harbor2	chr9	108977373	108977736	LINE/L2	429	+	182	108977555	7017
chr9	108970538	109170538	harbor2	chr9	108988079	108988089	LINE/L2	1486	+	5	108988084	17546
chr9	108970538	109170538	harbor2	chr9	108988384	108988732	LINE/L2	1486	+	174	108988558	18020
chr9	108970538	109170538	harbor2	chr9	108988723	108988863	LINE/L2	606	+	70	108988793	18255
chr9	108970538	109170538	harbor2	chr9	108997624	108998053	LINE/L2	1338	+	214	108997838	27300
chr9	108970538	109170538	harbor2	chr9	108998030	108998122	LINE/L2	906	+	46	108998076	27538
chr9	108970538	109170538	harbor2	chr9	108998342	108998584	LINE/L2	906	+	121	108998463	27925
chr9	108970538	109170538	harbor2	chr9	109069606	109070681	LINE/L2	1082	+	538	109070144	99606
chr9	133701992	133901992	harbor2	chr9	133717741	133718061	LINE/L2	673	+	160	133717901	15909
chr9	133701992	133901992	harbor2	chr9	133718372	133718519	LINE/L2	673	+	74	133718446	16454
chr9	118973349	119173349	harbor2	chr9	119010848	119011057	LINE/L2	395	+	104	119010952	37603
chr9	118973349	119173349	harbor2	chr9	119024543	119025089	LINE/L2	601	+	273	119024816	51467
chr9	118973349	119173349	harbor2	chr9	119027540	119027987	LINE/L2	568	+	224	119027764	54415
chr9	132918176	133118176	harbor2	chr9	132932233	132932855	LINE/L2	546	+	311	132932544	14368
chr9	123100604	123300604	harbor2	chr9	123130765	123130967	LINE/L2	527	+	101	123130866	30262
chr9	123100604	123300604	harbor2	chr9	123131164	123131756	LINE/L2	766	+	296	123131460	30856
chr9	123100604	123300604	harbor2	chr9	123145890	123146043	LINE/L2	512	+	76	123145966	45362
chr9	123100604	123300604	harbor2	chr9	123193482	123193974	LINE/L2	807	+	246	123193728	93124
chr9	123100604	123300604	harbor2	chr9	123194085	123194499	LINE/L2	807	+	207	123194292	93688
chr9	123100604	123300604	harbor2	chr9	123194513	123194977	LINE/L2	420	+	232	123194745	94141
chr9	123100604	123300604	harbor2	chr9	123194986	123195334	LINE/L2	1062	+	174	123195160	94556
chr9	85284733	85484733	harbor2	chr9	85290964	85291159	LINE/L2	605	+	98	85291062	6329
chr9	122240584	122440584	harbor2	chr9	122271533	122271807	LINE/L2	423	+	137	122271670	31086
chr9	122240584	122440584	harbor2	chr9	122286847	122287338	LINE/L2	825	+	246	122287093	46509
chr9	122240584	122440584	harbor2	chr9	122305695	122305892	LINE/L2	545	+	98	122305793	65209
chr9	122240584	122440584	harbor2	chr9	122323149	122323319	LINE/L2	417	+	85	122323234	82650
chr9	122240584	122440584	harbor2	chr9	122335785	122336390	LINE/L2	987	+	302	122336087	95503
chr9	95871047	96071047	harbor2	chr9	95911265	95911420	LINE/L2	435	+	78	95911343	40296
chr9	132717881	132917881	harbor2	chr9	132752621	132753047	LINE/L2	452	+	213	132752834	34953
chr9	132717881	132917881	harbor2	chr9	132772229	132772277	LINE/L2	1747	+	24	132772253	54372
chr9	132717881	132917881	harbor2	chr9	132772636	132773608	LINE/L2	1747	+	486	132773122	55241
chr9	132717881	132917881	harbor2	chr9	132794365	132794691	LINE/L2	435	+	163	132794528	76647
chr9	132123633	132323633	harbor2	chr9	132140354	132140666	LINE/L2	440	+	156	132140510	16877
chr9	132123633	132323633	harbor2	chr9	132172532	132172659	LINE/L2	476	+	64	132172596	48963
chr9	132123633	132323633	harbor2	chr9	132211586	132211913	LINE/L2	484	+	164	132211750	88117
chr9	132123633	132323633	harbor2	chr9	132211960	132211970	LINE/L2	484	+	5	132211965	88332
chr9	72414895	72614895	harbor2	chr9	72440948	72441228	LINE/L2	424	+	140	72441088	26193
chr9	72414895	72614895	harbor2	chr9	72444878	72445113	LINE/L2	513	+	118	72444996	30101
chr9	72414895	72614895	harbor2	chr9	72459582	72459824	LINE/L2	1004	+	121	72459703	44808
chr9	72414895	72614895	harbor2	chr9	72460462	72460815	LINE/L2	849	+	176	72460638	45743
chr9	129780568	129980568	harbor2	chr9	129801184	129801487	LINE/L2	470	+	152	129801336	20768
chr9	129780568	129980568	harbor2	chr9	129815734	129816620	LINE/L2	645	+	443	129816177	35609
chr9	118238513	118438513	harbor2	chr9	118269633	118270084	LINE/L2	793	+	226	118269859	31346
chr9	118238513	118438513	harbor2	chr9	118270102	118270386	LINE/L2	521	+	142	118270244	31731
chr9	118238513	118438513	harbor2	chr9	118280587	118280709	LINE/L2	439	+	61	118280648	42135
chr9	118238513	118438513	harbor2	chr9	118291677	118291766	LINE/L2	421	+	44	118291721	53208
chr9	118238513	118438513	harbor2	chr9	118294027	118294165	LINE/L2	434	+	69	118294096	55583
chr9	118238513	118438513	harbor2	chr9	118294201	118294560	LINE/L2	557	+	180	118294381	55868
chr9	118238513	118438513	harbor2	chr9	118317968	118318714	LINE/L2	1001	+	373	118318341	79828
chr9	100451892	100651892	harbor2	chr9	100464078	100464600	LINE/L2	979	+	261	100464339	12447
chr9	100451892	100651892	harbor2	chr9	100465044	100465495	LINE/L2	546	+	226	100465270	13378
chr9	100451892	100651892	harbor2	chr9	100468153	100468291	LINE/L2	646	+	69	100468222	16330
chr9	100451892	100651892	harbor2	chr9	100468682	100468959	LINE/L2	687	+	138	100468820	16928
chr9	100451892	100651892	harbor2	chr9	100480997	100481371	LINE/L2	833	+	187	100481184	29292
chr9	100451892	100651892	harbor2	chr9	100550503	100550834	LINE/L2	763	+	166	100550669	98777
chr9	80770302	80970302	harbor2	chr9	80795202	80795387	LINE/L2	501	+	92	80795294	24992
chr9	119251666	119451666	harbor2	chr9	119263307	119263598	LINE/L2	419	+	146	119263453	11787
chr9	119251666	119451666	harbor2	chr9	119263908	119263928	LINE/L2	419	+	10	119263918	12252
chr9	119251666	119451666	harbor2	chr9	119268349	119268820	LINE/L2	495	+	236	119268585	16919
chr9	119251666	119451666	harbor2	chr9	119279267	119279566	LINE/L2	405	+	150	119279417	27751
chr9	119251666	119451666	harbor2	chr9	119339337	119339550	LINE/L2	593	+	106	119339443	87777
chr9	119725011	119925011	harbor2	chr9	119738256	119738667	LINE/L2	668	+	206	119738462	13451
chr9	119725011	119925011	harbor2	chr9	119771158	119771871	LINE/L2	517	+	356	119771514	46503
chr9	119725011	119925011	harbor2	chr9	119805806	119806873	LINE/L2	909	+	534	119806340	81329
chr9	131897088	132097088	harbor2	chr9	131984073	131984402	LINE/L2	673	+	164	131984237	87149
chr9	131897088	132097088	harbor2	chr9	131986838	131986910	LINE/L2	395	+	36	131986874	89786
chr9	133046911	133246911	harbor2	chr9	133109713	133109884	LINE/L2	481	+	86	133109799	62888
chr9	110419906	110619906	harbor2	chr9	110433772	110434002	LINE/L2	633	+	115	110433887	13981
chr9	110419906	110619906	harbor2	chr9	110477696	110478426	LINE/L2	1294	+	365	110478061	58155
chr9	110419906	110619906	harbor2	chr9	110494701	110495066	LINE/L2	606	+	182	110494883	74977
chr9	110419906	110619906	harbor2	chr9	110497125	110497556	LINE/L2	703	+	216	110497341	77435
chr9	110419906	110619906	harbor2	chr9	110505227	110505810	LINE/L2	858	+	292	110505519	85613
chr9	110419906	110619906	harbor2	chr9	110506442	110506628	LINE/L2	417	+	93	110506535	86629
chr9	110419906	110619906	harbor2	chr9	110476361	110477695	LINE/L2	2879	+	667	110477028	57122
chr9	132781938	132981938	harbor2	chr9	132794365	132794691	LINE/L2	435	+	163	132794528	12590
chr9	132781938	132981938	harbor2	chr9	132846369	132846483	LINE/L2	391	+	57	132846426	64488
chr9	132781938	132981938	harbor2	chr9	132855138	132855417	LINE/L2	403	+	140	132855278	73340
chr9	118479280	118679280	harbor2	chr9	118523086	118523366	LINE/L2	508	+	140	118523226	43946
chr9	118479280	118679280	harbor2	chr9	118568172	118568377	LINE/L2	1107	+	102	118568274	88994
chr9	118479280	118679280	harbor2	chr9	118568690	118569262	LINE/L2	1107	+	286	118568976	89696
chr9	115984281	116184281	harbor2	chr9	115984406	115985191	LINE/L2	1821	+	392	115984798	517
chr9	115984281	116184281	harbor2	chr9	115989130	115989476	LINE/L2	418	+	173	115989303	5022
chr9	115984281	116184281	harbor2	chr9	116012047	116012327	LINE/L2	419	+	140	116012187	27906
chr9	115984281	116184281	harbor2	chr9	116019185	116019623	LINE/L2	1280	+	219	116019404	35123
chr9	115984281	116184281	harbor2	chr9	116020046	116020766	LINE/L2	841	+	360	116020406	36125
chr9	115984281	116184281	harbor2	chr9	116053448	116054253	LINE/L2	3423	+	402	116053850	69569
chr9	115984281	116184281	harbor2	chr9	116054592	116055078	LINE/L2	3423	+	243	116054835	70554
chr9	115984281	116184281	harbor2	chr9	116055643	116055903	LINE/L2	3423	+	130	116055773	71492
chr9	115984281	116184281	harbor2	chr9	116077460	116077801	LINE/L2	573	+	170	116077630	93349
chr9	123011150	123211150	harbor2	chr9	123012653	123012759	LINE/L2	399	+	53	123012706	1556
chr9	123011150	123211150	harbor2	chr9	123067603	123067747	LINE/L2	393	+	72	123067675	56525
chr9	123011150	123211150	harbor2	chr9	123078665	123078896	LINE/L2	500	+	116	123078781	67631
chr9	67049230	67249230	harbor2	chr9	67115485	67115859	LINE/L2	536	+	187	67115672	66442
chr9	67049230	67249230	harbor2	chr9	67075977	67076169	LINE/L2	557	+	96	67076073	26843
chr9	27383537	27583537	harbor2	chr9	27388688	27389135	LINE/L2	852	+	224	27388912	5375
chr9	27383537	27583537	harbor2	chr9	27389316	27389767	LINE/L2	852	+	226	27389542	6005
chr9	27383537	27583537	harbor2	chr9	27399685	27400119	LINE/L2	439	+	217	27399902	16365
chr9	27383537	27583537	harbor2	chr9	27400286	27400697	LINE/L2	596	+	206	27400492	16955
chr9	27383537	27583537	harbor2	chr9	27402278	27402423	LINE/L2	443	+	72	27402350	18813
chr9	27383537	27583537	harbor2	chr9	27421471	27422091	LINE/L2	1218	+	310	27421781	38244
chr9	27383537	27583537	harbor2	chr9	27434217	27434852	LINE/L2	791	+	318	27434535	50998
chr9	27383537	27583537	harbor2	chr9	27435462	27435587	LINE/L2	552	+	62	27435524	51987
chr9	27383537	27583537	harbor2	chr9	27435901	27436154	LINE/L2	552	+	126	27436027	52490
chr9	27383537	27583537	harbor2	chr9	27477291	27477609	LINE/L2	930	+	159	27477450	93913
chr9	27383537	27583537	harbor2	chr9	27475803	27476181	LINE/L2	1179	+	189	27475992	92455
chr9	135144890	135344890	harbor2	chr9	135193078	135193613	LINE/L2	502	+	268	135193346	48456
chr9	106369535	106569535	harbor2	chr9	106375200	106375533	LINE/L2	1059	+	166	106375366	5831
chr9	106369535	106569535	harbor2	chr9	106422313	106422557	LINE/L2	1091	+	122	106422435	52900
chr9	106369535	106569535	harbor2	chr9	106422859	106423290	LINE/L2	1091	+	216	106423075	53540
chr9	106369535	106569535	harbor2	chr9	106461789	106462513	LINE/L2	1121	+	362	106462151	92616
chr9	106369535	106569535	harbor2	chr9	106468552	106468684	LINE/L2	433	+	66	106468618	99083
chr9	108547897	108747897	harbor2	chr9	108550586	108550831	LINE/L2	515	+	122	108550708	2811
chr9	108547897	108747897	harbor2	chr9	108579156	108579409	LINE/L2	424	+	126	108579282	31385
chr9	108547897	108747897	harbor2	chr9	108589041	108589419	LINE/L2	802	+	189	108589230	41333
chr9	108547897	108747897	harbor2	chr9	108616877	108617335	LINE/L2	474	+	229	108617106	69209
chr9	108547897	108747897	harbor2	chr9	108617750	108618077	LINE/L2	474	+	164	108617914	70017
chr9	108547897	108747897	harbor2	chr9	108641064	108641392	LINE/L2	629	+	164	108641228	93331
chr9	131317066	131517066	harbor2	chr9	131346608	131346907	LINE/L2	592	+	150	131346758	29692
chr9	125652003	125852003	harbor2	chr9	125659381	125659782	LINE/L2	1019	+	200	125659581	7578
chr9	125652003	125852003	harbor2	chr9	125660467	125660885	LINE/L2	914	+	209	125660676	8673
chr9	125652003	125852003	harbor2	chr9	125663102	125663646	LINE/L2	1527	+	272	125663374	11371
chr9	125652003	125852003	harbor2	chr9	125731456	125731786	LINE/L2	577	+	165	125731621	79618
chr9	125652003	125852003	harbor2	chr9	125732090	125732394	LINE/L2	577	+	152	125732242	80239
chr9	121279757	121479757	harbor2	chr9	121353677	121354130	LINE/L2	1141	+	226	121353903	74146
chr9	95515073	95715073	harbor2	chr9	95555353	95555746	LINE/L2	638	+	196	95555549	40476
chr9	95515073	95715073	harbor2	chr9	95589833	95590599	LINE/L2	2267	+	383	95590216	75143
chr9	95515073	95715073	harbor2	chr9	95590622	95590910	LINE/L2	695	+	144	95590766	75693
chr9	95515073	95715073	harbor2	chr9	95600049	95600295	LINE/L2	529	+	123	95600172	85099
chr9	95515073	95715073	harbor2	chr9	95600400	95600552	LINE/L2	545	+	76	95600476	85403
chr9	95515073	95715073	harbor2	chr9	95600697	95600901	LINE/L2	435	+	102	95600799	85726
chr9	109883190	110083190	harbor2	chr9	109898980	109900044	LINE/L2	806	+	532	109899512	16322
chr9	109883190	110083190	harbor2	chr9	109967931	109968064	LINE/L2	398	+	66	109967997	84807
chr9	109883190	110083190	harbor2	chr9	109971118	109971225	LINE/L2	423	+	54	109971172	87982
chr9	87208935	87408935	harbor2	chr9	87283577	87284210	LINE/L2	550	+	316	87283893	74958
chr9	87208935	87408935	harbor2	chr9	87295496	87295856	LINE/L2	405	+	180	87295676	86741
chr9	105919668	106119668	harbor2	chr9	105923739	105924541	LINE/L2	617	+	401	105924140	4472
chr9	105919668	106119668	harbor2	chr9	105927143	105927217	LINE/L2	539	+	37	105927180	7512
chr9	105919668	106119668	harbor2	chr9	105927755	105927916	LINE/L2	539	+	80	105927835	8167
chr9	121723821	121923821	harbor2	chr9	121724256	121724637	LINE/L2	429	+	190	121724446	625
chr9	121723821	121923821	harbor2	chr9	121738969	121739086	LINE/L2	449	+	58	121739027	15206
chr9	121723821	121923821	harbor2	chr9	121797099	121797365	LINE/L2	497	+	133	121797232	73411
chr9	132997285	133197285	harbor2	chr9	133029542	133029692	LINE/L2	460	+	75	133029617	32332
chr9	38175548	38375548	harbor2	chr9	38209053	38209273	LINE/L2	421	+	110	38209163	33615
chr9	38175548	38375548	harbor2	chr9	38215297	38215406	LINE/L2	439	+	54	38215351	39803
chr9	38175548	38375548	harbor2	chr9	38225042	38225318	LINE/L2	405	+	138	38225180	49632
chr9	127673319	127873319	harbor2	chr9	127680883	127680973	LINE/L2	849	+	45	127680928	7609
chr9	127673319	127873319	harbor2	chr9	127762955	127763427	LINE/L2	867	+	236	127763191	89872
chr9	127673319	127873319	harbor2	chr9	127764316	127764689	LINE/L2	709	+	186	127764502	91183
chr9	127673319	127873319	harbor2	chr9	127765174	127765447	LINE/L2	656	+	136	127765310	91991
chr9	127673319	127873319	harbor2	chr9	127765453	127765731	LINE/L2	535	+	139	127765592	92273
chr9	127673319	127873319	harbor2	chr9	127768620	127769215	LINE/L2	1107	+	298	127768918	95599
chr9	127673319	127873319	harbor2	chr9	127680331	127680586	LINE/L2	849	+	128	127680459	7140
chr9	127673319	127873319	harbor2	chr9	127762303	127762854	LINE/L2	875	+	276	127762579	89260
chr9	133252237	133452237	harbor2	chr9	133337879	133338138	LINE/L2	630	+	130	133338009	85772
chr9	122012853	122212853	harbor2	chr9	122072269	122072362	LINE/L2	446	+	46	122072315	59462
chr9	122012853	122212853	harbor2	chr9	122072656	122072988	LINE/L2	446	+	166	122072822	59969
chr9	122012853	122212853	harbor2	chr9	122076131	122076276	LINE/L2	428	+	72	122076203	63350
chr9	122012853	122212853	harbor2	chr9	122110675	122110923	LINE/L2	444	+	124	122110799	97946
chr9	124870898	125070898	harbor2	chr9	124893968	124894314	LINE/L2	631	+	173	124894141	23243
chr9	124870898	125070898	harbor2	chr9	124896054	124896131	LINE/L2	846	+	38	124896092	25194
chr9	124870898	125070898	harbor2	chr9	124896441	124896659	LINE/L2	846	+	109	124896550	25652
chr9	124870898	125070898	harbor2	chr9	124896943	124897334	LINE/L2	846	+	196	124897139	26241
chr9	124870898	125070898	harbor2	chr9	124897635	124897718	LINE/L2	664	+	42	124897677	26779
chr9	124870898	125070898	harbor2	chr9	124917673	124917859	LINE/L2	522	+	93	124917766	46868
chr9	124870898	125070898	harbor2	chr9	124918152	124918384	LINE/L2	549	+	116	124918268	47370
chr9	124870898	125070898	harbor2	chr9	124949411	124949461	LINE/L2	571	+	25	124949436	78538
chr9	124870898	125070898	harbor2	chr9	124949630	124949885	LINE/L2	571	+	128	124949758	78860
chr9	99499498	99699498	harbor2	chr9	99505897	99506326	LINE/L2	628	+	214	99506111	6613
chr9	99499498	99699498	harbor2	chr9	99512097	99512945	LINE/L2	1331	+	424	99512521	13023
chr9	99499498	99699498	harbor2	chr9	99560752	99561059	LINE/L2	406	+	154	99560906	61408
chr9	99499498	99699498	harbor2	chr9	99562908	99563392	LINE/L2	1272	+	242	99563150	63652
chr9	99499498	99699498	harbor2	chr9	99563593	99563870	LINE/L2	542	+	138	99563731	64233
chr9	99499498	99699498	harbor2	chr9	99580042	99580361	LINE/L2	639	+	160	99580202	80704
chr9	99499498	99699498	harbor2	chr9	99586082	99586401	LINE/L2	413	+	160	99586242	86744
chr9	137776208	137976208	harbor2	chr9	137873870	137874394	LINE/L2	698	+	262	137874132	97924
chr9	133029694	133229694	harbor2	chr9	133109713	133109884	LINE/L2	481	+	86	133109799	80105
chr9	130565910	130765910	harbor2	chr9	130592852	130593403	LINE/L2	591	+	276	130593128	27218
chr9	130565910	130765910	harbor2	chr9	130605234	130605368	LINE/L2	414	+	67	130605301	39391
chr9	130565910	130765910	harbor2	chr9	130658543	130658647	LINE/L2	492	+	52	130658595	92685
chr9	106473733	106673733	harbor2	chr9	106483760	106484234	LINE/L2	537	+	237	106483997	10264
chr9	106473733	106673733	harbor2	chr9	106503075	106503293	LINE/L2	413	+	109	106503184	29451
chr9	106473733	106673733	harbor2	chr9	106510945	106511080	LINE/L2	391	+	68	106511013	37280
chr9	97573307	97773307	harbor2	chr9	97613301	97613418	LINE/L2	564	+	58	97613359	40052
chr9	97573307	97773307	harbor2	chr9	97630536	97630658	LINE/L2	397	+	61	97630597	57290
chr9	97573307	97773307	harbor2	chr9	97630841	97631128	LINE/L2	1129	+	144	97630985	57678
chr9	97573307	97773307	harbor2	chr9	97631421	97631585	LINE/L2	1129	+	82	97631503	58196
chr9	97573307	97773307	harbor2	chr9	97631856	97631961	LINE/L2	1129	+	52	97631908	58601
chr9	97573307	97773307	harbor2	chr9	97632001	97632129	LINE/L2	442	+	64	97632065	58758
chr9	97573307	97773307	harbor2	chr9	97643458	97643985	LINE/L2	448	+	264	97643722	70415
chr9	83832502	84032502	harbor2	chr9	83927686	83927933	LINE/L2	415	+	124	83927810	95308
chr9	130476862	130676862	harbor2	chr9	130512286	130512539	LINE/L2	608	+	126	130512412	35550
chr9	115159525	115359525	harbor2	chr9	115213323	115213713	LINE/L2	1027	+	195	115213518	53993
chr9	115159525	115359525	harbor2	chr9	115215051	115215427	LINE/L2	406	+	188	115215239	55714
chr9	115159525	115359525	harbor2	chr9	115226224	115226873	LINE/L2	745	+	324	115226548	67023
chr9	115159525	115359525	harbor2	chr9	115226898	115227109	LINE/L2	419	+	106	115227004	67479
chr9	115159525	115359525	harbor2	chr9	115232323	115232916	LINE/L2	579	+	296	115232619	73094
chr9	115159525	115359525	harbor2	chr9	115232957	115233090	LINE/L2	411	+	66	115233023	73498
chr9	115159525	115359525	harbor2	chr9	115227833	115229002	LINE/L2	1272	+	584	115228417	68892
chr9	119589567	119789567	harbor2	chr9	119627597	119627848	LINE/L2	535	+	126	119627723	38156
chr9	119589567	119789567	harbor2	chr9	119627856	119628348	LINE/L2	948	+	246	119628102	38535
chr9	119589567	119789567	harbor2	chr9	119628891	119628970	LINE/L2	948	+	40	119628931	39364
chr9	119589567	119789567	harbor2	chr9	119630227	119630340	LINE/L2	431	+	56	119630283	40716
chr9	119589567	119789567	harbor2	chr9	119662945	119663372	LINE/L2	449	+	214	119663159	73592
chr9	119589567	119789567	harbor2	chr9	119686929	119687155	LINE/L2	489	+	113	119687042	97475
chr9	119589567	119789567	harbor2	chr9	119687624	119688249	LINE/L2	973	+	312	119687936	98369
chr9	118149696	118349696	harbor2	chr9	118160272	118160570	LINE/L2	2076	+	149	118160421	10725
chr9	118149696	118349696	harbor2	chr9	118180394	118181897	LINE/L2	2478	+	752	118181146	31450
chr9	118149696	118349696	harbor2	chr9	118232009	118233294	LINE/L2	1299	+	642	118232651	82955
chr9	118149696	118349696	harbor2	chr9	118160664	118161499	LINE/L2	2076	+	418	118161082	11386
chr9	113484107	113684107	harbor2	chr9	113534172	113534354	LINE/L2	415	+	91	113534263	50156
chr9	113484107	113684107	harbor2	chr9	113534993	113535147	LINE/L2	415	+	77	113535070	50963
chr9	113484107	113684107	harbor2	chr9	113563249	113563389	LINE/L2	606	+	70	113563319	79212
chr9	113484107	113684107	harbor2	chr9	113577632	113578010	LINE/L2	405	+	189	113577821	93714
chr9	81221419	81421419	harbor2	chr9	81258858	81259123	LINE/L2	418	+	132	81258990	37571
chr9	81221419	81421419	harbor2	chr9	81309112	81309246	LINE/L2	631	+	67	81309179	87760
chr9	81221419	81421419	harbor2	chr9	81309458	81310067	LINE/L2	631	+	304	81309762	88343
chr9	81221419	81421419	harbor2	chr9	81314962	81315617	LINE/L2	1659	+	328	81315290	93871
chr9	81221419	81421419	harbor2	chr9	81315813	81315962	LINE/L2	590	+	74	81315887	94468
chr9	81221419	81421419	harbor2	chr9	81317049	81317080	LINE/L2	590	+	16	81317065	95646
chr9	81221419	81421419	harbor2	chr9	81317444	81317780	LINE/L2	590	+	168	81317612	96193
chr9	81221419	81421419	harbor2	chr9	81313196	81314388	LINE/L2	1659	+	596	81313792	92373
chr9	5662104	5862104	harbor2	chr9	5730797	5731277	LINE/L2	814	+	240	5731037	68933
chr9	124230962	124430962	harbor2	chr9	124255656	124255777	LINE/L2	533	+	60	124255716	24754
chr9	124230962	124430962	harbor2	chr9	124256079	124256251	LINE/L2	533	+	86	124256165	25203
chr9	124230962	124430962	harbor2	chr9	124266583	124266733	LINE/L2	432	+	75	124266658	35696
chr9	124230962	124430962	harbor2	chr9	124279772	124279969	LINE/L2	400	+	98	124279870	48908
chr9	98713448	98913448	harbor2	chr9	98716814	98717284	LINE/L2	538	+	235	98717049	3601
chr9	98713448	98913448	harbor2	chr9	98732901	98733209	LINE/L2	398	+	154	98733055	19607
chr9	98713448	98913448	harbor2	chr9	98787210	98787590	LINE/L2	874	+	190	98787400	73952
chr9	98713448	98913448	harbor2	chr9	98795069	98795381	LINE/L2	620	+	156	98795225	81777
chr9	98713448	98913448	harbor2	chr9	98803799	98803907	LINE/L2	426	+	54	98803853	90405
chr9	85857890	86057890	harbor2	chr9	85942610	85943143	LINE/L2	684	+	266	85942876	84986
chr9	76208649	76408649	harbor2	chr9	76209315	76209541	LINE/L2	649	+	113	76209428	779
chr9	76208649	76408649	harbor2	chr9	76234885	76235170	LINE/L2	428	+	142	76235027	26378
chr9	76208649	76408649	harbor2	chr9	76259190	76259451	LINE/L2	876	+	130	76259320	50671
chr9	76208649	76408649	harbor2	chr9	76259489	76259684	LINE/L2	876	+	98	76259587	50938
chr9	76208649	76408649	harbor2	chr9	76276335	76276777	LINE/L2	663	+	221	76276556	67907
chr9	98441531	98641531	harbor2	chr9	98456225	98456587	LINE/L2	673	+	181	98456406	14875
chr9	98441531	98641531	harbor2	chr9	98482811	98483434	LINE/L2	663	+	312	98483123	41592
chr9	98441531	98641531	harbor2	chr9	98483536	98483974	LINE/L2	428	+	219	98483755	42224
chr9	98441531	98641531	harbor2	chr9	98524461	98524762	LINE/L2	810	+	150	98524611	83080
chr9	98441531	98641531	harbor2	chr9	98526176	98526624	LINE/L2	749	+	224	98526400	84869
chr9	128197107	128397107	harbor2	chr9	128201905	128202168	LINE/L2	696	+	132	128202037	4930
chr9	128197107	128397107	harbor2	chr9	128202518	128202905	LINE/L2	1057	+	194	128202712	5605
chr9	128197107	128397107	harbor2	chr9	128216012	128216230	LINE/L2	541	+	109	128216121	19014
chr9	128197107	128397107	harbor2	chr9	128240399	128240694	LINE/L2	448	+	148	128240547	43440
chr9	122322318	122522318	harbor2	chr9	122323149	122323319	LINE/L2	417	+	85	122323234	916
chr9	122322318	122522318	harbor2	chr9	122335785	122336390	LINE/L2	987	+	302	122336087	13769
chr9	122322318	122522318	harbor2	chr9	122342096	122342367	LINE/L2	442	+	136	122342232	19914
chr9	122322318	122522318	harbor2	chr9	122348660	122349004	LINE/L2	1039	+	172	122348832	26514
chr9	122322318	122522318	harbor2	chr9	122350925	122351292	LINE/L2	518	+	184	122351109	28791
chr9	86988386	87188386	harbor2	chr9	86989297	86989498	LINE/L2	474	+	100	86989397	1011
chr9	86988386	87188386	harbor2	chr9	87069317	87069459	LINE/L2	455	+	71	87069388	81002
chr9	86988386	87188386	harbor2	chr9	87078341	87078461	LINE/L2	476	+	60	87078401	90015
chr9	78032699	78232699	harbor2	chr9	78036074	78036189	LINE/L2	603	+	58	78036132	3433
chr9	78032699	78232699	harbor2	chr9	78122341	78123548	LINE/L2	2534	+	604	78122945	90246
chr9	78032699	78232699	harbor2	chr9	78125027	78125679	LINE/L2	2792	+	326	78125353	92654
chr9	78032699	78232699	harbor2	chr9	78125863	78126509	LINE/L2	2792	+	323	78126186	93487
chr9	123382303	123582303	harbor2	chr9	123427239	123427344	LINE/L2	391	+	52	123427291	44988
chr9	123382303	123582303	harbor2	chr9	123454076	123454217	LINE/L2	419	+	70	123454146	71843
chr9	123382303	123582303	harbor2	chr9	123460854	123460974	LINE/L2	401	+	60	123460914	78611
chr9	123382303	123582303	harbor2	chr9	123472746	123473180	LINE/L2	403	+	217	123472963	90660
chr9	123382303	123582303	harbor2	chr9	123480456	123480817	LINE/L2	769	+	180	123480636	98333
chr9	27491305	27691305	harbor2	chr9	27513257	27513740	LINE/L2	781	+	242	27513499	22194
chr9	27491305	27691305	harbor2	chr9	27516665	27517177	LINE/L2	500	+	256	27516921	25616
chr9	75773390	75973390	harbor2	chr9	75772967	75774882	LINE/L2	3592	+	958	75773925	535
chr9	75773390	75973390	harbor2	chr9	75781142	75781541	LINE/L2	666	+	200	75781342	7952
chr9	75773390	75973390	harbor2	chr9	75822431	75823002	LINE/L2	1176	+	286	75822717	49327
chr9	75773390	75973390	harbor2	chr9	75823084	75823276	LINE/L2	428	+	96	75823180	49790
chr9	75773390	75973390	harbor2	chr9	75837649	75838866	LINE/L2	983	+	608	75838257	64867
chr9	133970410	134170410	harbor2	chr9	134055136	134055405	LINE/L2	485	+	134	134055270	84860
chr9	117613313	117813313	harbor2	chr9	117636540	117636779	LINE/L2	399	+	120	117636660	23347
chr9	117613313	117813313	harbor2	chr9	117696956	117697084	LINE/L2	662	+	64	117697020	83707
chr9	117613313	117813313	harbor2	chr9	117697295	117697396	LINE/L2	662	+	50	117697345	84032
chr9	117613313	117813313	harbor2	chr9	117697617	117697908	LINE/L2	662	+	146	117697763	84450
chr9	117613313	117813313	harbor2	chr9	117705844	117705895	LINE/L2	742	+	26	117705870	92557
chr9	117613313	117813313	harbor2	chr9	117706205	117706524	LINE/L2	742	+	160	117706365	93052
chr9	117613313	117813313	harbor2	chr9	117706629	117706962	LINE/L2	496	+	166	117706795	93482
chr9	69606659	69806659	harbor2	chr9	69625121	69625535	LINE/L2	590	+	207	69625328	18669
chr9	69606659	69806659	harbor2	chr9	69630346	69630773	LINE/L2	563	+	214	69630560	23901
chr9	69606659	69806659	harbor2	chr9	69643814	69644276	LINE/L2	1313	+	231	69644045	37386
chr9	69606659	69806659	harbor2	chr9	69648667	69649429	LINE/L2	966	+	381	69649048	42389
chr9	69606659	69806659	harbor2	chr9	69666211	69666616	LINE/L2	1160	+	202	69666413	59754
chr9	128028605	128228605	harbor2	chr9	128109546	128110053	LINE/L2	963	+	254	128109800	81195
chr9	115743197	115943197	harbor2	chr9	115792847	115793930	LINE/L2	824	+	542	115793389	50192
chr9	115743197	115943197	harbor2	chr9	115794220	115794579	LINE/L2	824	+	180	115794400	51203
chr9	115743197	115943197	harbor2	chr9	115813353	115813933	LINE/L2	755	+	290	115813643	70446
chr9	115743197	115943197	harbor2	chr9	115828902	115829284	LINE/L2	417	+	191	115829093	85896
chr9	121870900	122070900	harbor2	chr9	121890446	121890782	LINE/L2	810	+	168	121890614	19714
chr9	121870900	122070900	harbor2	chr9	121899079	121899365	LINE/L2	848	+	143	121899222	28322
chr9	121870900	122070900	harbor2	chr9	121899404	121899417	LINE/L2	848	+	6	121899410	28510
chr9	121870900	122070900	harbor2	chr9	121899704	121899886	LINE/L2	848	+	91	121899795	28895
chr9	121870900	122070900	harbor2	chr9	121925428	121925799	LINE/L2	477	+	186	121925614	54714
chr9	121870900	122070900	harbor2	chr9	121942131	121942576	LINE/L2	764	+	222	121942353	71453
chr9	121870900	122070900	harbor2	chr9	121959342	121959908	LINE/L2	696	+	283	121959625	88725
chr9	121870900	122070900	harbor2	chr9	121880562	121880757	LINE/L2	466	+	98	121880660	9760
chr9	112086015	112286015	harbor2	chr9	112096242	112096363	LINE/L2	448	+	60	112096302	10287
chr9	86930419	87130419	harbor2	chr9	86937322	86937429	LINE/L2	472	+	54	86937376	6957
chr9	86930419	87130419	harbor2	chr9	86963635	86964290	LINE/L2	1457	+	328	86963963	33544
chr9	86930419	87130419	harbor2	chr9	86964323	86964697	LINE/L2	746	+	187	86964510	34091
chr9	86930419	87130419	harbor2	chr9	86989297	86989498	LINE/L2	474	+	100	86989397	58978
chr9	86930419	87130419	harbor2	chr9	86949685	86950245	LINE/L2	642	+	280	86949965	19546
chr9	128845792	129045792	harbor2	chr9	128885275	128885626	LINE/L2	558	+	176	128885451	39659
chr9	128845792	129045792	harbor2	chr9	128885876	128885946	LINE/L2	558	+	35	128885911	40119
chr9	128845792	129045792	harbor2	chr9	128925725	128926162	LINE/L2	667	+	218	128925943	80151
chr9	115326097	115526097	harbor2	chr9	115351494	115351985	LINE/L2	590	+	246	115351740	25643
chr9	75239177	75439177	harbor2	chr9	75290193	75290476	LINE/L2	515	+	142	75290335	51158
chr9	116662037	116862037	harbor2	chr9	116711443	116712497	LINE/L2	475	+	527	116711970	49933
chr9	116662037	116862037	harbor2	chr9	116715390	116715802	LINE/L2	811	+	206	116715596	53559
chr9	116662037	116862037	harbor2	chr9	116746720	116746936	LINE/L2	537	+	108	116746828	84791
chr9	116662037	116862037	harbor2	chr9	116759557	116759905	LINE/L2	664	+	174	116759731	97694
chr9	103861232	104061232	harbor2	chr9	103880080	103880226	LINE/L2	394	+	73	103880153	18921
chr9	103861232	104061232	harbor2	chr9	103899902	103900300	LINE/L2	508	+	199	103900101	38869
chr9	75844880	76044880	harbor2	chr9	75900825	75900941	LINE/L2	412	+	58	75900883	56003
chr9	75844880	76044880	harbor2	chr9	75944415	75944829	LINE/L2	930	+	207	75944622	99742
chr9	84618937	84818937	harbor2	chr9	84680540	84681443	LINE/L2	807	+	452	84680992	62055
chr9	84618937	84818937	harbor2	chr9	84681614	84681814	LINE/L2	490	+	100	84681714	62777
chr9	84618937	84818937	harbor2	chr9	84685592	84685964	LINE/L2	552	+	186	84685778	66841
chr9	84618937	84818937	harbor2	chr9	84655856	84656159	LINE/L2	400	+	152	84656008	37071
chr9	61698262	61898262	harbor2	chr9	61796353	61796794	LINE/L2	650	+	220	61796573	98311
chr9	69687220	69887220	harbor2	chr9	69740730	69740771	LINE/L2	1296	+	20	69740750	53530
chr9	69687220	69887220	harbor2	chr9	69741068	69741422	LINE/L2	1296	+	177	69741245	54025
chr9	85458883	85658883	harbor2	chr9	85479156	85479932	LINE/L2	715	+	388	85479544	20661
chr9	85458883	85658883	harbor2	chr9	85480206	85480810	LINE/L2	991	+	302	85480508	21625
chr9	116733952	116933952	harbor2	chr9	116746720	116746936	LINE/L2	537	+	108	116746828	12876
chr9	116733952	116933952	harbor2	chr9	116759557	116759905	LINE/L2	664	+	174	116759731	25779
chr9	116733952	116933952	harbor2	chr9	116785171	116785415	LINE/L2	636	+	122	116785293	51341
chr9	116733952	116933952	harbor2	chr9	116785541	116786467	LINE/L2	1153	+	463	116786004	52052
chr9	28376405	28576405	harbor2	chr9	28415291	28415536	LINE/L2	392	+	122	28415413	39008
chr9	28376405	28576405	harbor2	chr9	28417599	28417914	LINE/L2	440	+	158	28417757	41352
chr9	28376405	28576405	harbor2	chr9	28446507	28447158	LINE/L2	622	+	326	28446833	70428
chr9	41043103	41243103	harbor2	chr9	41055941	41056536	LINE/L2	1124	+	298	41056239	13136
chr9	41043103	41243103	harbor2	chr9	41057232	41057373	LINE/L2	414	+	70	41057302	14199
chr9	41043103	41243103	harbor2	chr9	41119395	41119691	LINE/L2	406	+	148	41119543	76440
chr9	133570776	133770776	harbor2	chr9	133599075	133599333	LINE/L2	429	+	129	133599204	28428
chr9	133570776	133770776	harbor2	chr9	133615871	133616055	LINE/L2	406	+	92	133615963	45187
chr9	64760974	64960974	harbor2	chr9	64777720	64778066	LINE/L2	456	+	173	64777893	16919
chr9	84298587	84498587	harbor2	chr9	84357004	84357186	LINE/L2	447	+	91	84357095	58508
chr9	99904739	100104739	harbor2	chr9	99958156	99958440	LINE/L2	530	+	142	99958298	53559
chr9	106073443	106273443	harbor2	chr9	106073596	106074196	LINE/L2	1102	+	300	106073896	453
chr9	106073443	106273443	harbor2	chr9	106105346	106105690	LINE/L2	683	+	172	106105518	32075
chr9	106073443	106273443	harbor2	chr9	106106003	106106454	LINE/L2	683	+	226	106106229	32786
chr9	106073443	106273443	harbor2	chr9	106123530	106123855	LINE/L2	691	+	162	106123692	50249
chr9	106073443	106273443	harbor2	chr9	106124023	106124359	LINE/L2	973	+	168	106124191	50748
chr9	106073443	106273443	harbor2	chr9	106143633	106143739	LINE/L2	420	+	53	106143686	70243
chr9	106073443	106273443	harbor2	chr9	106150057	106150247	LINE/L2	408	+	95	106150152	76709
chr9	106073443	106273443	harbor2	chr9	106156907	106157474	LINE/L2	475	+	284	106157191	83748
chr9	120533377	120733377	harbor2	chr9	120543134	120543401	LINE/L2	572	+	134	120543268	9891
chr9	120533377	120733377	harbor2	chr9	120558466	120559003	LINE/L2	562	+	268	120558734	25357
chr9	120533377	120733377	harbor2	chr9	120565334	120565982	LINE/L2	633	+	324	120565658	32281
chr9	120533377	120733377	harbor2	chr9	120581515	120581785	LINE/L2	516	+	135	120581650	48273
chr9	120533377	120733377	harbor2	chr9	120608467	120609579	LINE/L2	872	+	556	120609023	75646
chr9	86206953	86406953	harbor2	chr9	86297710	86298355	LINE/L2	543	+	322	86298032	91079
chr9	132809308	133009308	harbor2	chr9	132846369	132846483	LINE/L2	391	+	57	132846426	37118
chr9	132809308	133009308	harbor2	chr9	132855138	132855417	LINE/L2	403	+	140	132855278	45970
chr9	125877857	126077857	harbor2	chr9	125934718	125935165	LINE/L2	665	+	224	125934942	57085
chr9	125877857	126077857	harbor2	chr9	125945353	125945669	LINE/L2	483	+	158	125945511	67654
chr9	132175098	132375098	harbor2	chr9	132211586	132211913	LINE/L2	484	+	164	132211750	36652
chr9	132175098	132375098	harbor2	chr9	132211960	132211970	LINE/L2	484	+	5	132211965	36867
chr9	120695551	120895551	harbor2	chr9	120768087	120768480	LINE/L2	544	+	196	120768283	72732
chr9	120695551	120895551	harbor2	chr9	120774530	120775063	LINE/L2	537	+	266	120774796	79245
chr9	36146755	36346755	harbor2	chr9	36147425	36147565	LINE/L2	404	+	70	36147495	740
chr9	36146755	36346755	harbor2	chr9	36230252	36230462	LINE/L2	572	+	105	36230357	83602
chr9	36146755	36346755	harbor2	chr9	36231786	36232902	LINE/L2	796	+	558	36232344	85589
chr9	30103985	30303985	harbor2	chr9	30119702	30119882	LINE/L2	501	+	90	30119792	15807
chr9	77869414	78069414	harbor2	chr9	77881022	77881363	LINE/L2	437	+	170	77881192	11778
chr9	123151996	123351996	harbor2	chr9	123193482	123193974	LINE/L2	807	+	246	123193728	41732
chr9	123151996	123351996	harbor2	chr9	123194085	123194499	LINE/L2	807	+	207	123194292	42296
chr9	123151996	123351996	harbor2	chr9	123194513	123194977	LINE/L2	420	+	232	123194745	42749
chr9	123151996	123351996	harbor2	chr9	123194986	123195334	LINE/L2	1062	+	174	123195160	43164
chr9	123151996	123351996	harbor2	chr9	123202889	123203073	LINE/L2	1117	+	92	123202981	50985
chr9	123151996	123351996	harbor2	chr9	123203369	123203689	LINE/L2	1117	+	160	123203529	51533
chr9	123151996	123351996	harbor2	chr9	123204000	123204076	LINE/L2	706	+	38	123204038	52042
chr9	123151996	123351996	harbor2	chr9	123240637	123240897	LINE/L2	1535	+	130	123240767	88771
chr9	123151996	123351996	harbor2	chr9	123241200	123241221	LINE/L2	1535	+	10	123241210	89214
chr9	123151996	123351996	harbor2	chr9	123241531	123242356	LINE/L2	1535	+	412	123241943	89947
chr9	127978353	128178353	harbor2	chr9	128020664	128021076	LINE/L2	448	+	206	128020870	42517
chr9	96116739	96316739	harbor2	chr9	96168025	96168186	LINE/L2	418	+	80	96168105	51366
chr9	96116739	96316739	harbor2	chr9	96190808	96191142	LINE/L2	593	+	167	96190975	74236
chr9	96116739	96316739	harbor2	chr9	96195366	96195650	LINE/L2	679	+	142	96195508	78769
chr9	129067734	129267734	harbor2	chr9	129133647	129134228	LINE/L2	995	+	290	129133937	66203
chr9	129067734	129267734	harbor2	chr9	129151837	129151951	LINE/L2	471	+	57	129151894	84160
chr9	129067734	129267734	harbor2	chr9	129157866	129158248	LINE/L2	591	+	191	129158057	90323
chr9	129067734	129267734	harbor2	chr9	129158551	129158703	LINE/L2	591	+	76	129158627	90893
chr9	129067734	129267734	harbor2	chr9	129159010	129159261	LINE/L2	591	+	126	129159136	91402
chr9	129067734	129267734	harbor2	chr9	129167460	129167591	LINE/L2	918	+	66	129167526	99792
chr9	118902212	119102212	harbor2	chr9	118905752	118905945	LINE/L2	468	+	96	118905848	3636
chr9	118902212	119102212	harbor2	chr9	118955190	118955467	LINE/L2	641	+	138	118955328	53116
chr9	118902212	119102212	harbor2	chr9	118955795	118956150	LINE/L2	618	+	178	118955973	53761
chr9	116971445	117171445	harbor2	chr9	116992893	116993062	LINE/L2	436	+	84	116992977	21532
chr9	116971445	117171445	harbor2	chr9	116993134	116993551	LINE/L2	507	+	208	116993342	21897
chr9	116971445	117171445	harbor2	chr9	117004981	117005071	LINE/L2	1871	+	45	117005026	33581
chr9	116971445	117171445	harbor2	chr9	117006237	117006834	LINE/L2	1871	+	298	117006535	35090
chr9	116971445	117171445	harbor2	chr9	117007085	117007329	LINE/L2	1127	+	122	117007207	35762
chr9	116971445	117171445	harbor2	chr9	117007534	117007664	LINE/L2	1127	+	65	117007599	36154
chr9	116971445	117171445	harbor2	chr9	117023262	117023700	LINE/L2	692	+	219	117023481	52036
chr9	116971445	117171445	harbor2	chr9	117046760	117046842	LINE/L2	397	+	41	117046801	75356
chr9	124115967	124315967	harbor2	chr9	124126692	124126815	LINE/L2	425	+	62	124126754	10787
chr9	124115967	124315967	harbor2	chr9	124186559	124186771	LINE/L2	574	+	106	124186665	70698
chr9	124115967	124315967	harbor2	chr9	124187086	124187706	LINE/L2	534	+	310	124187396	71429
chr9	124115967	124315967	harbor2	chr9	124188010	124188187	LINE/L2	534	+	88	124188098	72131
chr9	124115967	124315967	harbor2	chr9	124208652	124209078	LINE/L2	667	+	213	124208865	92898
chr9	124115967	124315967	harbor2	chr9	124215061	124215438	LINE/L2	401	+	188	124215249	99282
chr9	75531404	75731404	harbor2	chr9	75580240	75580766	LINE/L2	939	+	263	75580503	49099
chr9	75531404	75731404	harbor2	chr9	75606950	75607131	LINE/L2	507	+	90	75607040	75636
chr9	75531404	75731404	harbor2	chr9	75607436	75608176	LINE/L2	507	+	370	75607806	76402
chr9	75531404	75731404	harbor2	chr9	75610545	75611682	LINE/L2	455	+	568	75611113	79709
chr9	75531404	75731404	harbor2	chr9	75628219	75628348	LINE/L2	429	+	64	75628283	96879
chr9	109903026	110103026	harbor2	chr9	109967931	109968064	LINE/L2	398	+	66	109967997	64971
chr9	109903026	110103026	harbor2	chr9	109971118	109971225	LINE/L2	423	+	54	109971172	68146
chr9	116899007	117099007	harbor2	chr9	116902749	116903390	LINE/L2	880	+	320	116903069	4062
chr9	116899007	117099007	harbor2	chr9	116917100	116917466	LINE/L2	492	+	183	116917283	18276
chr9	116899007	117099007	harbor2	chr9	116920615	116920745	LINE/L2	426	+	65	116920680	21673
chr9	116899007	117099007	harbor2	chr9	116992893	116993062	LINE/L2	436	+	84	116992977	93970
chr9	116899007	117099007	harbor2	chr9	116993134	116993551	LINE/L2	507	+	208	116993342	94335
chr9	82638776	82838776	harbor2	chr9	82661534	82661874	LINE/L2	460	+	170	82661704	22928
chr9	64697224	64897224	harbor2	chr9	64710270	64711253	LINE/L2	556	+	492	64710762	13538
chr9	64697224	64897224	harbor2	chr9	64777720	64778066	LINE/L2	456	+	173	64777893	80669
chr9	28172524	28372524	harbor2	chr9	28174546	28174821	LINE/L2	454	+	138	28174684	2160
chr9	28172524	28372524	harbor2	chr9	28191670	28192184	LINE/L2	1049	+	257	28191927	19403
chr9	28172524	28372524	harbor2	chr9	28205275	28205609	LINE/L2	520	+	167	28205442	32918
chr9	28172524	28372524	harbor2	chr9	28268923	28269333	LINE/L2	617	+	205	28269128	96604
chr9	28172524	28372524	harbor2	chr9	28272087	28272515	LINE/L2	610	+	214	28272301	99777
chr9	120473271	120673271	harbor2	chr9	120501092	120501525	LINE/L2	1083	+	216	120501308	28037
chr9	120473271	120673271	harbor2	chr9	120508574	120508946	LINE/L2	657	+	186	120508760	35489
chr9	120473271	120673271	harbor2	chr9	120525990	120526641	LINE/L2	450	+	326	120526316	53045
chr9	120473271	120673271	harbor2	chr9	120543134	120543401	LINE/L2	572	+	134	120543268	69997
chr9	120473271	120673271	harbor2	chr9	120558466	120559003	LINE/L2	562	+	268	120558734	85463
chr9	120473271	120673271	harbor2	chr9	120565334	120565982	LINE/L2	633	+	324	120565658	92387
chr9	68911145	69111145	harbor2	chr9	68929285	68929656	LINE/L2	909	+	186	68929471	18326
chr9	68911145	69111145	harbor2	chr9	68929970	68930755	LINE/L2	909	+	392	68930362	19217
chr9	68911145	69111145	harbor2	chr9	68992539	68992557	LINE/L2	511	+	9	68992548	81403
chr9	68911145	69111145	harbor2	chr9	68993175	68993463	LINE/L2	675	+	144	68993319	82174
chr9	89348023	89548023	harbor2	chr9	89407546	89407828	LINE/L2	401	+	141	89407687	59664
chr9	102137962	102337962	harbor2	chr9	102181328	102181439	LINE/L2	611	+	56	102181384	43422
chr9	102137962	102337962	harbor2	chr9	102181751	102182044	LINE/L2	611	+	146	102181897	43935
chr9	102137962	102337962	harbor2	chr9	102182503	102182809	LINE/L2	546	+	153	102182656	44694
chr9	102137962	102337962	harbor2	chr9	102212723	102212952	LINE/L2	605	+	114	102212837	74875
chr9	102137962	102337962	harbor2	chr9	102226646	102227093	LINE/L2	392	+	224	102226870	88908
chr9	102137962	102337962	harbor2	chr9	102228859	102229105	LINE/L2	450	+	123	102228982	91020
chr9	135999124	136199124	harbor2	chr9	136098036	136098544	LINE/L2	482	+	254	136098290	99166
chr9	120814186	121014186	harbor2	chr9	120820608	120820789	LINE/L2	430	+	90	120820698	6512
chr9	132351991	132551991	harbor2	chr9	132352691	132353090	LINE/L2	512	+	200	132352891	900
chr9	132351991	132551991	harbor2	chr9	132385892	132385974	LINE/L2	409	+	41	132385933	33942
chr9	132351991	132551991	harbor2	chr9	132404346	132404854	LINE/L2	637	+	254	132404600	52609
chr9	132351991	132551991	harbor2	chr9	132434177	132434438	LINE/L2	588	+	130	132434307	82316
chr9	131670337	131870337	harbor2	chr9	131695018	131695182	LINE/L2	719	+	82	131695100	24763
chr9	131670337	131870337	harbor2	chr9	131698995	131699239	LINE/L2	2432	+	122	131699117	28780
chr9	131670337	131870337	harbor2	chr9	131699544	131700181	LINE/L2	2432	+	318	131699862	29525
chr9	131670337	131870337	harbor2	chr9	131700244	131700580	LINE/L2	613	+	168	131700412	30075
chr9	131670337	131870337	harbor2	chr9	131694537	131694797	LINE/L2	719	+	130	131694667	24330
chr9	109179900	109379900	harbor2	chr9	109179465	109180258	LINE/L2	1172	+	396	109179861	39
chr9	123445329	123645329	harbor2	chr9	123454076	123454217	LINE/L2	419	+	70	123454146	8817
chr9	123445329	123645329	harbor2	chr9	123460854	123460974	LINE/L2	401	+	60	123460914	15585
chr9	123445329	123645329	harbor2	chr9	123472746	123473180	LINE/L2	403	+	217	123472963	27634
chr9	123445329	123645329	harbor2	chr9	123480456	123480817	LINE/L2	769	+	180	123480636	35307
chr9	123445329	123645329	harbor2	chr9	123494651	123494788	LINE/L2	479	+	68	123494719	49390
chr9	123445329	123645329	harbor2	chr9	123495092	123495135	LINE/L2	479	+	22	123495114	49785
chr9	123445329	123645329	harbor2	chr9	123495171	123495298	LINE/L2	479	+	64	123495235	49906
chr9	123445329	123645329	harbor2	chr9	123526570	123527706	LINE/L2	683	+	568	123527138	81809
chr9	123445329	123645329	harbor2	chr9	123534993	123535299	LINE/L2	1061	+	153	123535146	89817
chr9	123445329	123645329	harbor2	chr9	123535452	123535879	LINE/L2	1061	+	214	123535666	90337
chr9	123445329	123645329	harbor2	chr9	123540973	123541192	LINE/L2	551	+	110	123541083	95754
chr9	123445329	123645329	harbor2	chr9	123518676	123519094	LINE/L2	420	+	209	123518885	73556
chr9	93348438	93548438	harbor2	chr9	93370631	93371193	LINE/L2	1045	+	281	93370912	22474
chr9	98115336	98315336	harbor2	chr9	98150245	98150618	LINE/L2	398	+	186	98150431	35095
chr9	98115336	98315336	harbor2	chr9	98188026	98188482	LINE/L2	1216	+	228	98188254	72918
chr9	98115336	98315336	harbor2	chr9	98188833	98188876	LINE/L2	1216	+	22	98188855	73519
chr9	98115336	98315336	harbor2	chr9	98212106	98212504	LINE/L2	530	+	199	98212305	96969
chr9	98115336	98315336	harbor2	chr9	98212804	98212901	LINE/L2	530	+	48	98212852	97516
chr9	113409679	113609679	harbor2	chr9	113416488	113416673	LINE/L2	467	+	92	113416580	6901
chr9	113409679	113609679	harbor2	chr9	113416904	113417218	LINE/L2	668	+	157	113417061	7382
chr9	113409679	113609679	harbor2	chr9	113448158	113448747	LINE/L2	656	+	294	113448452	38773
chr9	113409679	113609679	harbor2	chr9	113455992	113456799	LINE/L2	1143	+	404	113456396	46717
chr9	113409679	113609679	harbor2	chr9	113457096	113457529	LINE/L2	1143	+	216	113457312	47633
chr9	79309932	79509932	harbor2	chr9	79327633	79327954	LINE/L2	439	+	160	79327793	17861
chr9	79309932	79509932	harbor2	chr9	79328263	79328390	LINE/L2	439	+	64	79328327	18395
chr9	79309932	79509932	harbor2	chr9	79348952	79349216	LINE/L2	601	+	132	79349084	39152
chr9	79309932	79509932	harbor2	chr9	79371558	79371822	LINE/L2	416	+	132	79371690	61758
chr9	79309932	79509932	harbor2	chr9	79346458	79348455	LINE/L2	4030	+	998	79347456	37524
chr9	79309932	79509932	harbor2	chr9	79364072	79365155	LINE/L2	511	+	542	79364614	54682
chr9	94689313	94889313	harbor2	chr9	94696300	94696430	LINE/L2	478	+	65	94696365	7052
chr9	94689313	94889313	harbor2	chr9	94725099	94725706	LINE/L2	526	+	304	94725403	36090
chr9	78644620	78844620	harbor2	chr9	78672778	78672956	LINE/L2	600	+	89	78672867	28247
chr9	78644620	78844620	harbor2	chr9	78692827	78692895	LINE/L2	436	+	34	78692861	48241
chr9	78644620	78844620	harbor2	chr9	78693341	78693646	LINE/L2	436	+	152	78693493	48873
chr9	78644620	78844620	harbor2	chr9	78722774	78722955	LINE/L2	425	+	90	78722864	78244
chr9	72680664	72880664	harbor2	chr9	72684228	72684858	LINE/L2	1621	+	315	72684543	3879
chr9	72680664	72880664	harbor2	chr9	72750624	72751214	LINE/L2	511	+	295	72750919	70255
chr9	127856450	128056450	harbor2	chr9	127861476	127861627	LINE/L2	1136	+	76	127861552	5102
chr9	127856450	128056450	harbor2	chr9	127894749	127895011	LINE/L2	491	+	131	127894880	38430
chr9	127856450	128056450	harbor2	chr9	127918968	127919389	LINE/L2	636	+	210	127919178	62728
chr9	127856450	128056450	harbor2	chr9	127920777	127920914	LINE/L2	433	+	68	127920845	64395
chr9	127856450	128056450	harbor2	chr9	127931274	127931738	LINE/L2	422	+	232	127931506	75056
chr9	127856450	128056450	harbor2	chr9	127947638	127947924	LINE/L2	443	+	143	127947781	91331
chr9	127856450	128056450	harbor2	chr9	127860370	127861171	LINE/L2	1211	+	400	127860770	4320
chr9	103762890	103962890	harbor2	chr9	103838219	103838516	LINE/L2	488	+	148	103838367	75477
chr9	103762890	103962890	harbor2	chr9	103838791	103838938	LINE/L2	488	+	74	103838865	75975
chr9	64626101	64826101	harbor2	chr9	64629845	64630273	LINE/L2	548	+	214	64630059	3958
chr9	64626101	64826101	harbor2	chr9	64632019	64632111	LINE/L2	393	+	46	64632065	5964
chr9	64626101	64826101	harbor2	chr9	64710270	64711253	LINE/L2	556	+	492	64710762	84661
chr9	104899122	105099122	harbor2	chr9	104972835	104973159	LINE/L2	431	+	162	104972997	73875
chr9	119425434	119625434	harbor2	chr9	119438726	119439278	LINE/L2	914	+	276	119439002	13568
chr9	119425434	119625434	harbor2	chr9	119500597	119501213	LINE/L2	482	+	308	119500905	75471
chr9	129855447	130055447	harbor2	chr9	129904684	129904918	LINE/L2	505	+	117	129904801	49354
chr9	105087336	105287336	harbor2	chr9	105128252	105128433	LINE/L2	472	+	90	105128342	41006
chr9	105087336	105287336	harbor2	chr9	105128718	105128844	LINE/L2	472	+	63	105128781	41445
chr9	78695848	78895848	harbor2	chr9	78722774	78722955	LINE/L2	425	+	90	78722864	27016
chr9	78695848	78895848	harbor2	chr9	78766265	78767174	LINE/L2	1228	+	454	78766719	70871
chr9	137867594	138067594	harbor2	chr9	137873870	137874394	LINE/L2	698	+	262	137874132	6538
chr9	74197115	74397115	harbor2	chr9	74286712	74287437	LINE/L2	978	+	362	74287074	89959
chr9	91505643	91705643	harbor2	chr9	91542906	91543422	LINE/L2	616	+	258	91543164	37521
chr9	88186376	88386376	harbor2	chr9	88277478	88277867	LINE/L2	428	+	194	88277672	91296
chr9	36438385	36638385	harbor2	chr9	36462283	36462492	LINE/L2	626	+	104	36462387	24002
chr9	36438385	36638385	harbor2	chr9	36463070	36463292	LINE/L2	517	+	111	36463181	24796
chr9	36438385	36638385	harbor2	chr9	36514618	36514871	LINE/L2	429	+	126	36514744	76359
chr9	105749179	105949179	harbor2	chr9	105835219	105835627	LINE/L2	461	+	204	105835423	86244
chr9	112453345	112653345	harbor2	chr9	112455354	112455910	LINE/L2	878	+	278	112455632	2287
chr9	112453345	112653345	harbor2	chr9	112456066	112456647	LINE/L2	878	+	290	112456356	3011
chr9	112453345	112653345	harbor2	chr9	112493238	112493516	LINE/L2	585	+	139	112493377	40032
chr9	112453345	112653345	harbor2	chr9	112544351	112544517	LINE/L2	469	+	83	112544434	91089
chr9	99166838	99366838	harbor2	chr9	99223765	99224037	LINE/L2	424	+	136	99223901	57063
chr9	84683411	84883411	harbor2	chr9	84685592	84685964	LINE/L2	552	+	186	84685778	2367
chr9	84683411	84883411	harbor2	chr9	84746411	84746764	LINE/L2	540	+	176	84746587	63176
chr9	84683411	84883411	harbor2	chr9	84746807	84747015	LINE/L2	394	+	104	84746911	63500
chr9	84683411	84883411	harbor2	chr9	84771619	84771757	LINE/L2	476	+	69	84771688	88277
chr9	82962441	83162441	harbor2	chr9	82977380	82977521	LINE/L2	459	+	70	82977450	15009
chr9	82962441	83162441	harbor2	chr9	82991882	82992015	LINE/L2	452	+	66	82991948	29507
chr9	82962441	83162441	harbor2	chr9	82994372	82994668	LINE/L2	734	+	148	82994520	32079
chr9	82962441	83162441	harbor2	chr9	82997744	82997864	LINE/L2	413	+	60	82997804	35363
chr9	82962441	83162441	harbor2	chr9	82999403	82999548	LINE/L2	410	+	72	82999475	37034
chr9	79354958	79554958	harbor2	chr9	79371558	79371822	LINE/L2	416	+	132	79371690	16732
chr9	79354958	79554958	harbor2	chr9	79364072	79365155	LINE/L2	511	+	542	79364614	9656
chr9	105556173	105756173	harbor2	chr9	105655166	105655286	LINE/L2	648	+	60	105655226	99053
chr9	130234003	130434003	harbor2	chr9	130326112	130326507	LINE/L2	639	+	198	130326310	92307
chr9	130453428	130653428	harbor2	chr9	130512286	130512539	LINE/L2	608	+	126	130512412	58984
chr9	130920616	131120616	harbor2	chr9	130932483	130932689	LINE/L2	441	+	103	130932586	11970
chr9	130920616	131120616	harbor2	chr9	130994139	130994541	LINE/L2	778	+	201	130994340	73724
chr9	132666176	132866176	harbor2	chr9	132683996	132684330	LINE/L2	818	+	167	132684163	17987
chr9	132666176	132866176	harbor2	chr9	132684332	132685006	LINE/L2	1016	+	337	132684669	18493
chr9	132666176	132866176	harbor2	chr9	132752621	132753047	LINE/L2	452	+	213	132752834	86658
chr9	132563497	132763497	harbor2	chr9	132574250	132574464	LINE/L2	500	+	107	132574357	10860
chr9	132563497	132763497	harbor2	chr9	132616951	132617074	LINE/L2	457	+	62	132617013	53516
chr9	132563497	132763497	harbor2	chr9	132617142	132617513	LINE/L2	769	+	186	132617328	53831
chr9	126922145	127122145	harbor2	chr9	126922936	126923092	LINE/L2	510	+	78	126923014	869
chr9	126922145	127122145	harbor2	chr9	126935012	126935298	LINE/L2	395	+	143	126935155	13010
chr9	126922145	127122145	harbor2	chr9	126941494	126941717	LINE/L2	739	+	112	126941606	19461
chr9	126922145	127122145	harbor2	chr9	126954242	126954505	LINE/L2	898	+	132	126954374	32229
chr9	126922145	127122145	harbor2	chr9	126954820	126955285	LINE/L2	898	+	232	126955052	32907
chr9	126922145	127122145	harbor2	chr9	126967204	126967543	LINE/L2	654	+	170	126967374	45229
chr9	126922145	127122145	harbor2	chr9	126967838	126967995	LINE/L2	654	+	78	126967916	45771
chr9	119545959	119745959	harbor2	chr9	119558187	119558341	LINE/L2	566	+	77	119558264	12305
chr9	119545959	119745959	harbor2	chr9	119558658	119559227	LINE/L2	556	+	284	119558942	12983
chr9	119545959	119745959	harbor2	chr9	119627597	119627848	LINE/L2	535	+	126	119627723	81764
chr9	119545959	119745959	harbor2	chr9	119627856	119628348	LINE/L2	948	+	246	119628102	82143
chr9	119545959	119745959	harbor2	chr9	119628891	119628970	LINE/L2	948	+	40	119628931	82972
chr9	119545959	119745959	harbor2	chr9	119630227	119630340	LINE/L2	431	+	56	119630283	84324
chr9	110955803	111155803	harbor2	chr9	110968484	110968793	LINE/L2	551	+	154	110968638	12835
chr9	110955803	111155803	harbor2	chr9	111004261	111004835	LINE/L2	660	+	287	111004548	48745
chr9	110955803	111155803	harbor2	chr9	111023340	111023663	LINE/L2	392	+	162	111023502	67699
chr9	75901308	76101308	harbor2	chr9	75944415	75944829	LINE/L2	930	+	207	75944622	43314
chr9	75901308	76101308	harbor2	chr9	75945140	75946124	LINE/L2	930	+	492	75945632	44324
chr9	75901308	76101308	harbor2	chr9	75979643	75979979	LINE/L2	495	+	168	75979811	78503
chr9	75901308	76101308	harbor2	chr9	75993482	75993583	LINE/L2	866	+	50	75993532	92224
chr9	75901308	76101308	harbor2	chr9	75994125	75994375	LINE/L2	866	+	125	75994250	92942
chr9	75901308	76101308	harbor2	chr9	75994722	75995369	LINE/L2	866	+	324	75995046	93738
chr9	127458378	127658378	harbor2	chr9	127474162	127474265	LINE/L2	602	+	52	127474214	15836
chr9	127458378	127658378	harbor2	chr9	127474432	127474665	LINE/L2	602	+	116	127474548	16170
chr9	127458378	127658378	harbor2	chr9	127522530	127523072	LINE/L2	508	+	271	127522801	64423
chr9	73837527	74037527	harbor2	chr9	73880575	73881019	LINE/L2	687	+	222	73880797	43270
chr9	93309160	93509160	harbor2	chr9	93370631	93371193	LINE/L2	1045	+	281	93370912	61752
chr9	104902077	105102077	harbor2	chr9	104972835	104973159	LINE/L2	431	+	162	104972997	70920
chr9	123158330	123358330	harbor2	chr9	123193482	123193974	LINE/L2	807	+	246	123193728	35398
chr9	123158330	123358330	harbor2	chr9	123194085	123194499	LINE/L2	807	+	207	123194292	35962
chr9	123158330	123358330	harbor2	chr9	123194513	123194977	LINE/L2	420	+	232	123194745	36415
chr9	123158330	123358330	harbor2	chr9	123194986	123195334	LINE/L2	1062	+	174	123195160	36830
chr9	123158330	123358330	harbor2	chr9	123202889	123203073	LINE/L2	1117	+	92	123202981	44651
chr9	123158330	123358330	harbor2	chr9	123203369	123203689	LINE/L2	1117	+	160	123203529	45199
chr9	123158330	123358330	harbor2	chr9	123204000	123204076	LINE/L2	706	+	38	123204038	45708
chr9	123158330	123358330	harbor2	chr9	123240637	123240897	LINE/L2	1535	+	130	123240767	82437
chr9	123158330	123358330	harbor2	chr9	123241200	123241221	LINE/L2	1535	+	10	123241210	82880
chr9	123158330	123358330	harbor2	chr9	123241531	123242356	LINE/L2	1535	+	412	123241943	83613
chr9	128155396	128355396	harbor2	chr9	128186324	128186880	LINE/L2	533	+	278	128186602	31206
chr9	128155396	128355396	harbor2	chr9	128201905	128202168	LINE/L2	696	+	132	128202037	46641
chr9	128155396	128355396	harbor2	chr9	128202518	128202905	LINE/L2	1057	+	194	128202712	47316
chr9	128155396	128355396	harbor2	chr9	128216012	128216230	LINE/L2	541	+	109	128216121	60725
chr9	128155396	128355396	harbor2	chr9	128240399	128240694	LINE/L2	448	+	148	128240547	85151
chr9	130366842	130566842	harbor2	chr9	130390106	130390442	LINE/L2	436	+	168	130390274	23432
chr9	130366842	130566842	harbor2	chr9	130399857	130400201	LINE/L2	491	+	172	130400029	33187
chr9	69328208	69528208	harbor2	chr9	69411172	69411779	LINE/L2	797	+	304	69411476	83268
chr9	69328208	69528208	harbor2	chr9	69422555	69422771	LINE/L2	421	+	108	69422663	94455
chr9	128366718	128566718	harbor2	chr9	128366657	128366749	LINE/L2	497	+	46	128366703	15
chr9	128366718	128566718	harbor2	chr9	128369595	128369622	LINE/L2	457	+	14	128369609	2891
chr9	128366718	128566718	harbor2	chr9	128369913	128369938	LINE/L2	457	+	12	128369925	3207
chr9	128366718	128566718	harbor2	chr9	128370234	128370589	LINE/L2	457	+	178	128370412	3694
chr9	128366718	128566718	harbor2	chr9	128370643	128370866	LINE/L2	454	+	112	128370755	4037
chr9	128366718	128566718	harbor2	chr9	128413902	128414165	LINE/L2	923	+	132	128414034	47316
chr9	128366718	128566718	harbor2	chr9	128414477	128414698	LINE/L2	923	+	110	128414587	47869
chr9	88777907	88977907	harbor2	chr9	88787417	88788801	LINE/L2	2147	+	692	88788109	10202
chr9	104410202	104610202	harbor2	chr9	104435045	104435168	LINE/L2	461	+	62	104435107	24905
chr9	129053454	129253454	harbor2	chr9	129133647	129134228	LINE/L2	995	+	290	129133937	80483
chr9	129053454	129253454	harbor2	chr9	129151837	129151951	LINE/L2	471	+	57	129151894	98440
chr9	127788209	127988209	harbor2	chr9	127861476	127861627	LINE/L2	1136	+	76	127861552	73343
chr9	127788209	127988209	harbor2	chr9	127860370	127861171	LINE/L2	1211	+	400	127860770	72561
chr9	33362837	33562837	harbor2	chr9	33380802	33381183	LINE/L2	1002	+	190	33380992	18155
chr9	33362837	33562837	harbor2	chr9	33383339	33383591	LINE/L2	396	+	126	33383465	20628
chr9	33362837	33562837	harbor2	chr9	33383813	33384041	LINE/L2	432	+	114	33383927	21090
chr9	33362837	33562837	harbor2	chr9	33394252	33394415	LINE/L2	397	+	82	33394334	31497
chr9	33362837	33562837	harbor2	chr9	33395847	33395944	LINE/L2	414	+	48	33395895	33058
chr9	33362837	33562837	harbor2	chr9	33431111	33431316	LINE/L2	394	+	102	33431213	68376
chr9	131056292	131256292	harbor2	chr9	131149317	131150216	LINE/L2	567	+	450	131149767	93475
chr9	135606015	135806015	harbor2	chr9	135638524	135638714	LINE/L2	576	+	95	135638619	32604
chr9	85133926	85333926	harbor2	chr9	85216671	85217696	LINE/L2	2459	+	512	85217183	83257
chr9	112043701	112243701	harbor2	chr9	112096242	112096363	LINE/L2	448	+	60	112096302	52601
chr9	110306872	110506872	harbor2	chr9	110371462	110371977	LINE/L2	699	+	258	110371720	64848
chr9	134789919	134989919	harbor2	chr9	134862324	134862485	LINE/L2	510	+	80	134862404	72485
chr9	120061184	120261184	harbor2	chr9	120063381	120063511	LINE/L2	841	+	65	120063446	2262
chr9	120061184	120261184	harbor2	chr9	120063810	120064013	LINE/L2	841	+	102	120063912	2728
chr9	120061184	120261184	harbor2	chr9	120082308	120082677	LINE/L2	489	+	184	120082492	21308
chr9	120061184	120261184	harbor2	chr9	120084464	120084944	LINE/L2	474	+	240	120084704	23520
chr9	120061184	120261184	harbor2	chr9	120085955	120086128	LINE/L2	472	+	86	120086041	24857
chr9	120061184	120261184	harbor2	chr9	120091487	120091732	LINE/L2	525	+	122	120091609	30425
chr9	120061184	120261184	harbor2	chr9	120092161	120092338	LINE/L2	525	+	88	120092249	31065
chr9	120061184	120261184	harbor2	chr9	120114405	120114749	LINE/L2	420	+	172	120114577	53393
chr9	120061184	120261184	harbor2	chr9	120144204	120145007	LINE/L2	668	+	402	120144606	83422
chr9	120061184	120261184	harbor2	chr9	120147753	120147927	LINE/L2	442	+	87	120147840	86656
chr9	120061184	120261184	harbor2	chr9	120153941	120154268	LINE/L2	477	+	164	120154105	92921
chr9	120061184	120261184	harbor2	chr9	120143793	120143988	LINE/L2	629	+	98	120143891	82707
chr9	108080712	108280712	harbor2	chr9	108111383	108111652	LINE/L2	467	+	134	108111517	30805
chr10	131819487	132019487	harbor2	chr10	131898561	131899878	LINE/L2	1209	+	658	131899219	79732
chr10	127750951	127950951	harbor2	chr10	127805442	127805861	LINE/L2	721	+	210	127805652	54701
chr10	93820572	94020572	harbor2	chr10	93830552	93830885	LINE/L2	792	+	166	93830718	10146
chr10	93820572	94020572	harbor2	chr10	93837286	93837815	LINE/L2	1215	+	264	93837550	16978
chr10	93820572	94020572	harbor2	chr10	93904038	93904327	LINE/L2	412	+	144	93904182	83610
chr10	120812399	121012399	harbor2	chr10	120867487	120867803	LINE/L2	491	+	158	120867645	55246
chr10	74107930	74307930	harbor2	chr10	74168052	74168237	LINE/L2	435	+	92	74168144	60214
chr10	125848272	126048272	harbor2	chr10	125884879	125885254	LINE/L2	2077	+	188	125885067	36795
chr10	125848272	126048272	harbor2	chr10	125885745	125886441	LINE/L2	2077	+	348	125886093	37821
chr10	125848272	126048272	harbor2	chr10	125891791	125892506	LINE/L2	458	+	358	125892149	43877
chr10	125848272	126048272	harbor2	chr10	125901181	125901839	LINE/L2	721	+	329	125901510	53238
chr10	125848272	126048272	harbor2	chr10	125902272	125902398	LINE/L2	721	+	63	125902335	54063
chr10	125848272	126048272	harbor2	chr10	125935234	125935382	LINE/L2	443	+	74	125935308	87036
chr10	117681690	117881690	harbor2	chr10	117682323	117682620	LINE/L2	650	+	148	117682471	781
chr10	117681690	117881690	harbor2	chr10	117735877	117736267	LINE/L2	527	+	195	117736072	54382
chr10	117681690	117881690	harbor2	chr10	117755938	117756377	LINE/L2	482	+	220	117756158	74468
chr10	75529164	75729164	harbor2	chr10	75574430	75574839	LINE/L2	549	+	204	75574634	45470
chr10	75529164	75729164	harbor2	chr10	75584165	75584532	LINE/L2	541	+	184	75584349	55185
chr10	132261625	132461625	harbor2	chr10	132272417	132273145	LINE/L2	1130	+	364	132272781	11156
chr10	129943807	130143807	harbor2	chr10	130005515	130005731	LINE/L2	689	+	108	130005623	61816
chr10	120238616	120438616	harbor2	chr10	120253506	120253912	LINE/L2	439	+	203	120253709	15093
chr10	120238616	120438616	harbor2	chr10	120315253	120316003	LINE/L2	595	+	375	120315628	77012
chr10	120238616	120438616	harbor2	chr10	120333939	120334099	LINE/L2	519	+	80	120334019	95403
chr10	127606390	127806390	harbor2	chr10	127626737	127627283	LINE/L2	658	+	273	127627010	20620
chr10	90021500	90221500	harbor2	chr10	90037778	90038108	LINE/L2	466	+	165	90037943	16443
chr10	90021500	90221500	harbor2	chr10	90060202	90060402	LINE/L2	436	+	100	90060302	38802
chr10	123737951	123937951	harbor2	chr10	123750265	123750720	LINE/L2	491	+	228	123750493	12542
chr10	124948233	125148233	harbor2	chr10	124948448	124948871	LINE/L2	951	+	212	124948660	427
chr10	129752154	129952154	harbor2	chr10	129820573	129820689	LINE/L2	541	+	58	129820631	68477
chr10	129752154	129952154	harbor2	chr10	129839144	129839234	LINE/L2	515	+	45	129839189	87035
chr10	123560554	123760554	harbor2	chr10	123562347	123562786	LINE/L2	837	+	220	123562567	2013
chr10	126338370	126538370	harbor2	chr10	126340612	126340720	LINE/L2	588	+	54	126340666	2296
chr10	126338370	126538370	harbor2	chr10	126341015	126341345	LINE/L2	588	+	165	126341180	2810
chr10	106835864	107035864	harbor2	chr10	106837775	106838059	LINE/L2	559	+	142	106837917	2053
chr10	106323121	106523121	harbor2	chr10	106322731	106323194	LINE/L2	1113	+	232	106322963	158
chr10	106323121	106523121	harbor2	chr10	106380894	106381286	LINE/L2	643	+	196	106381090	57969
chr10	100098948	100298948	harbor2	chr10	100101237	100101537	LINE/L2	463	+	150	100101387	2439
chr10	100098948	100298948	harbor2	chr10	100118931	100119297	LINE/L2	423	+	183	100119114	20166
chr10	67762583	67962583	harbor2	chr10	67769716	67770255	LINE/L2	658	+	270	67769986	7403
chr10	67762583	67962583	harbor2	chr10	67783769	67784181	LINE/L2	884	+	206	67783975	21392
chr10	61248730	61448730	harbor2	chr10	61283780	61284065	LINE/L2	485	+	142	61283922	35192
chr10	61248730	61448730	harbor2	chr10	61342361	61342779	LINE/L2	1604	+	209	61342570	93840
chr10	61248730	61448730	harbor2	chr10	61343291	61343637	LINE/L2	1604	+	173	61343464	94734
chr10	61248730	61448730	harbor2	chr10	61344135	61344373	LINE/L2	1604	+	119	61344254	95524
chr10	108454057	108654057	harbor2	chr10	108503587	108504160	LINE/L2	463	+	286	108503873	49816
chr10	124882393	125082393	harbor2	chr10	124947542	124948024	LINE/L2	951	+	241	124947783	65390
chr10	124882393	125082393	harbor2	chr10	124948448	124948871	LINE/L2	951	+	212	124948660	66267
chr10	115998279	116198279	harbor2	chr10	116018677	116019126	LINE/L2	709	+	224	116018901	20622
chr10	65892389	66092389	harbor2	chr10	65897103	65898104	LINE/L2	1881	+	500	65897603	5214
chr10	65892389	66092389	harbor2	chr10	65907305	65907749	LINE/L2	426	+	222	65907527	15138
chr10	65892389	66092389	harbor2	chr10	65915046	65915153	LINE/L2	479	+	54	65915100	22711
chr10	102901191	103101191	harbor2	chr10	102941482	102941915	LINE/L2	959	+	216	102941698	40507
chr10	102901191	103101191	harbor2	chr10	102978228	102978634	LINE/L2	1000	+	203	102978431	77240
chr10	102901191	103101191	harbor2	chr10	102979224	102979697	LINE/L2	572	+	236	102979460	78269
chr10	123228199	123428199	harbor2	chr10	123234611	123234832	LINE/L2	446	+	110	123234721	6522
chr10	115793897	115993897	harbor2	chr10	115855288	115855569	LINE/L2	454	+	140	115855428	61531
chr10	115793897	115993897	harbor2	chr10	115887758	115888079	LINE/L2	616	+	160	115887918	94021
chr10	87748728	87948728	harbor2	chr10	87769262	87769659	LINE/L2	445	+	198	87769460	20732
chr10	43774270	43974270	harbor2	chr10	43777228	43777560	LINE/L2	412	+	166	43777394	3124
chr10	113681281	113881281	harbor2	chr10	113744332	113744590	LINE/L2	428	+	129	113744461	63180
chr10	113681281	113881281	harbor2	chr10	113745996	113746514	LINE/L2	601	+	259	113746255	64974
chr10	121683166	121883166	harbor2	chr10	121746052	121746358	LINE/L2	614	+	153	121746205	63039
chr10	121683166	121883166	harbor2	chr10	121761811	121762371	LINE/L2	565	+	280	121762091	78925
chr10	121683166	121883166	harbor2	chr10	121778941	121780991	LINE/L2	808	+	1025	121779966	96800
chr10	111547818	111747818	harbor2	chr10	111548462	111548755	LINE/L2	1411	+	146	111548608	790
chr10	111547818	111747818	harbor2	chr10	111549058	111549550	LINE/L2	1411	+	246	111549304	1486
chr10	111547818	111747818	harbor2	chr10	111597489	111598066	LINE/L2	722	+	288	111597777	49959
chr10	111547818	111747818	harbor2	chr10	111628994	111629189	LINE/L2	414	+	98	111629092	81274
chr10	117001516	117201516	harbor2	chr10	117049473	117049611	LINE/L2	419	+	69	117049542	48026
chr10	126236799	126436799	harbor2	chr10	126326754	126326897	LINE/L2	425	+	72	126326826	90027
chr10	42677636	42877636	harbor2	chr10	42680231	42680665	LINE/L2	921	+	217	42680448	2812
chr10	125566545	125766545	harbor2	chr10	125595420	125595972	LINE/L2	787	+	276	125595696	29151
chr10	125566545	125766545	harbor2	chr10	125607662	125607791	LINE/L2	444	+	64	125607726	41181
chr10	90827380	91027380	harbor2	chr10	90837761	90839043	LINE/L2	1911	+	641	90838402	11022
chr10	90827380	91027380	harbor2	chr10	90873833	90874078	LINE/L2	415	+	122	90873955	46575
chr10	93011111	93211111	harbor2	chr10	93042011	93042484	LINE/L2	536	+	236	93042247	31136
chr10	93011111	93211111	harbor2	chr10	93054173	93054311	LINE/L2	520	+	69	93054242	43131
chr10	93011111	93211111	harbor2	chr10	93093866	93094086	LINE/L2	716	+	110	93093976	82865
chr10	99598013	99798013	harbor2	chr10	99608933	99609220	LINE/L2	598	+	144	99609077	11064
chr10	99598013	99798013	harbor2	chr10	99609250	99609640	LINE/L2	822	+	195	99609445	11432
chr10	113009159	113209159	harbor2	chr10	113049145	113049682	LINE/L2	869	+	268	113049413	40254
chr10	87275270	87475270	harbor2	chr10	87306011	87306516	LINE/L2	1203	+	252	87306263	30993
chr10	87275270	87475270	harbor2	chr10	87314965	87315420	LINE/L2	1194	+	228	87315193	39923
chr10	118251980	118451980	harbor2	chr10	118334201	118334986	LINE/L2	967	+	392	118334593	82613
chr10	63999781	64199781	harbor2	chr10	64009204	64010659	LINE/L2	2936	+	728	64009932	10151
chr10	63999781	64199781	harbor2	chr10	64073952	64074303	LINE/L2	770	+	176	64074128	74347
chr10	63999781	64199781	harbor2	chr10	64075625	64075901	LINE/L2	414	+	138	64075763	75982
chr10	63999781	64199781	harbor2	chr10	64086826	64087040	LINE/L2	480	+	107	64086933	87152
chr10	116754167	116954167	harbor2	chr10	116784365	116784557	LINE/L2	600	+	96	116784461	30294
chr10	116754167	116954167	harbor2	chr10	116789923	116790092	LINE/L2	970	+	84	116790007	35840
chr10	116754167	116954167	harbor2	chr10	116790403	116790691	LINE/L2	970	+	144	116790547	36380
chr10	116754167	116954167	harbor2	chr10	116790991	116791189	LINE/L2	970	+	99	116791090	36923
chr10	116754167	116954167	harbor2	chr10	116820490	116821685	LINE/L2	1507	+	598	116821088	66921
chr10	116754167	116954167	harbor2	chr10	116826071	116826405	LINE/L2	445	+	167	116826238	72071
chr10	116754167	116954167	harbor2	chr10	116846020	116846135	LINE/L2	500	+	58	116846078	91911
chr10	94319252	94519252	harbor2	chr10	94365765	94366276	LINE/L2	420	+	256	94366021	46769
chr10	92302907	92502907	harbor2	chr10	92373521	92373832	LINE/L2	670	+	156	92373677	70770
chr10	92302907	92502907	harbor2	chr10	92373883	92374001	LINE/L2	670	+	59	92373942	71035
chr10	114601271	114801271	harbor2	chr10	114673392	114673775	LINE/L2	478	+	192	114673584	72313
chr10	114601271	114801271	harbor2	chr10	114677041	114677273	LINE/L2	507	+	116	114677157	75886
chr10	95795212	95995212	harbor2	chr10	95817515	95817944	LINE/L2	862	+	214	95817729	22517
chr10	95795212	95995212	harbor2	chr10	95820521	95820902	LINE/L2	595	+	190	95820711	25499
chr10	95795212	95995212	harbor2	chr10	95889541	95889576	LINE/L2	410	+	18	95889559	94347
chr10	95795212	95995212	harbor2	chr10	95890157	95890243	LINE/L2	410	+	43	95890200	94988
chr10	104457848	104657848	harbor2	chr10	104472241	104473074	LINE/L2	997	+	416	104472657	14809
chr10	104457848	104657848	harbor2	chr10	104485020	104485574	LINE/L2	730	+	277	104485297	27449
chr10	28714667	28914667	harbor2	chr10	28717722	28717989	LINE/L2	546	+	134	28717856	3189
chr10	125265626	125465626	harbor2	chr10	125325972	125326321	LINE/L2	433	+	174	125326146	60520
chr10	125265626	125465626	harbor2	chr10	125321177	125321646	LINE/L2	1112	+	234	125321411	55785
chr10	37479582	37679582	harbor2	chr10	37513315	37513869	LINE/L2	1024	+	277	37513592	34010
chr10	37479582	37679582	harbor2	chr10	37518371	37518713	LINE/L2	497	+	171	37518542	38960
chr10	37479582	37679582	harbor2	chr10	37560462	37560762	LINE/L2	849	+	150	37560612	81030
chr10	37479582	37679582	harbor2	chr10	37561935	37562373	LINE/L2	1000	+	219	37562154	82572
chr10	37479582	37679582	harbor2	chr10	37562588	37562612	LINE/L2	1000	+	12	37562600	83018
chr10	77013521	77213521	harbor2	chr10	77014821	77015128	LINE/L2	428	+	154	77014975	1454
chr10	77013521	77213521	harbor2	chr10	77015529	77016474	LINE/L2	1207	+	472	77016001	2480
chr10	111723424	111923424	harbor2	chr10	111757195	111757660	LINE/L2	1287	+	232	111757427	34003
chr10	111723424	111923424	harbor2	chr10	111757705	111758166	LINE/L2	894	+	230	111757935	34511
chr10	111723424	111923424	harbor2	chr10	111778389	111779824	LINE/L2	1783	+	718	111779107	55683
chr10	111723424	111923424	harbor2	chr10	111798744	111799057	LINE/L2	561	+	156	111798900	75476
chr10	111723424	111923424	harbor2	chr10	111799418	111799466	LINE/L2	561	+	24	111799442	76018
chr10	123436531	123636531	harbor2	chr10	123464271	123464944	LINE/L2	612	+	336	123464607	28076
chr10	123436531	123636531	harbor2	chr10	123515768	123516153	LINE/L2	583	+	192	123515960	79429
chr10	25617061	25817061	harbor2	chr10	25694607	25695467	LINE/L2	929	+	430	25695037	77976
chr10	119497380	119697380	harbor2	chr10	119510255	119510648	LINE/L2	442	+	196	119510451	13071
chr10	119497380	119697380	harbor2	chr10	119587312	119587618	LINE/L2	448	+	153	119587465	90085
chr10	119497380	119697380	harbor2	chr10	119585671	119586843	LINE/L2	1625	+	586	119586257	88877
chr10	117002919	117202919	harbor2	chr10	117049473	117049611	LINE/L2	419	+	69	117049542	46623
chr10	69806733	70006733	harbor2	chr10	69819835	69820242	LINE/L2	833	+	204	69820039	13306
chr10	69806733	70006733	harbor2	chr10	69812004	69812249	LINE/L2	509	+	122	69812126	5393
chr10	104749229	104949229	harbor2	chr10	104829693	104829864	LINE/L2	453	+	86	104829779	80550
chr10	104749229	104949229	harbor2	chr10	104833627	104834825	LINE/L2	2591	+	599	104834226	84997
chr10	104749229	104949229	harbor2	chr10	104840261	104840604	LINE/L2	603	+	172	104840433	91204
chr10	104749229	104949229	harbor2	chr10	104845005	104845410	LINE/L2	981	+	202	104845207	95978
chr10	74840912	75040912	harbor2	chr10	74915283	74915668	LINE/L2	418	+	192	74915475	74563
chr10	124003783	124203783	harbor2	chr10	124080286	124080600	LINE/L2	490	+	157	124080443	76660
chr10	93736984	93936984	harbor2	chr10	93817348	93817683	LINE/L2	687	+	168	93817516	80532
chr10	93736984	93936984	harbor2	chr10	93830552	93830885	LINE/L2	792	+	166	93830718	93734
chr10	28366450	28566450	harbor2	chr10	28429603	28429628	LINE/L2	1103	+	12	28429615	63165
chr10	28366450	28566450	harbor2	chr10	28430345	28431053	LINE/L2	1103	+	354	28430699	64249
chr10	122797993	122997993	harbor2	chr10	122861818	122862385	LINE/L2	672	+	284	122862102	64109
chr10	122797993	122997993	harbor2	chr10	122885775	122886292	LINE/L2	580	+	258	122886033	88040
chr10	122295715	122495715	harbor2	chr10	122373796	122374117	LINE/L2	525	+	160	122373956	78241
chr10	122295715	122495715	harbor2	chr10	122355439	122355770	LINE/L2	415	+	166	122355605	59890
chr10	91935025	92135025	harbor2	chr10	91966896	91967014	LINE/L2	428	+	59	91966955	31930
chr10	29036168	29236168	harbor2	chr10	29087986	29088313	LINE/L2	1129	+	164	29088150	51982
chr10	29036168	29236168	harbor2	chr10	29088616	29088706	LINE/L2	1129	+	45	29088661	52493
chr10	29036168	29236168	harbor2	chr10	29089486	29090107	LINE/L2	1618	+	310	29089796	53628
chr10	29036168	29236168	harbor2	chr10	29105450	29105606	LINE/L2	433	+	78	29105528	69360
chr10	83828067	84028067	harbor2	chr10	83837505	83837661	LINE/L2	437	+	78	83837583	9516
chr10	83828067	84028067	harbor2	chr10	83840873	83841136	LINE/L2	418	+	132	83841005	12938
chr10	83828067	84028067	harbor2	chr10	83868551	83868903	LINE/L2	465	+	176	83868727	40660
chr10	102961335	103161335	harbor2	chr10	102978228	102978634	LINE/L2	1000	+	203	102978431	17096
chr10	102961335	103161335	harbor2	chr10	102979224	102979697	LINE/L2	572	+	236	102979460	18125
chr10	102961335	103161335	harbor2	chr10	103041678	103042344	LINE/L2	1119	+	333	103042011	80676
chr10	105237426	105437426	harbor2	chr10	105304075	105304725	LINE/L2	653	+	325	105304400	66974
chr10	105237426	105437426	harbor2	chr10	105304735	105305475	LINE/L2	1012	+	370	105305105	67679
chr10	105237426	105437426	harbor2	chr10	105305766	105306406	LINE/L2	474	+	320	105306086	68660
chr10	105237426	105437426	harbor2	chr10	105306724	105306845	LINE/L2	432	+	60	105306784	69358
chr10	108276561	108476561	harbor2	chr10	108341714	108342216	LINE/L2	591	+	251	108341965	65404
chr10	132523710	132723710	harbor2	chr10	132532401	132532540	LINE/L2	417	+	70	132532471	8761
chr10	131877011	132077011	harbor2	chr10	131898561	131899878	LINE/L2	1209	+	658	131899219	22208
chr10	124709102	124909102	harbor2	chr10	124722891	124723262	LINE/L2	478	+	186	124723077	13975
chr10	124709102	124909102	harbor2	chr10	124733963	124734079	LINE/L2	435	+	58	124734021	24919
chr10	120208288	120408288	harbor2	chr10	120253506	120253912	LINE/L2	439	+	203	120253709	45421
chr10	116804822	117004822	harbor2	chr10	116820490	116821685	LINE/L2	1507	+	598	116821088	16266
chr10	116804822	117004822	harbor2	chr10	116826071	116826405	LINE/L2	445	+	167	116826238	21416
chr10	116804822	117004822	harbor2	chr10	116846020	116846135	LINE/L2	500	+	58	116846078	41256
chr10	107208296	107408296	harbor2	chr10	107300467	107300980	LINE/L2	1038	+	256	107300723	92427
chr10	107208296	107408296	harbor2	chr10	107302183	107302414	LINE/L2	425	+	116	107302299	94003
chr10	107208296	107408296	harbor2	chr10	107305879	107306469	LINE/L2	645	+	295	107306174	97878
chr10	127618429	127818429	harbor2	chr10	127626737	127627283	LINE/L2	658	+	273	127627010	8581
chr10	108318135	108518135	harbor2	chr10	108341714	108342216	LINE/L2	591	+	251	108341965	23830
chr10	88574918	88774918	harbor2	chr10	88575748	88576299	LINE/L2	772	+	276	88576024	1106
chr10	88574918	88774918	harbor2	chr10	88578831	88578950	LINE/L2	415	+	60	88578891	3973
chr10	88574918	88774918	harbor2	chr10	88586426	88586744	LINE/L2	488	+	159	88586585	11667
chr10	88574918	88774918	harbor2	chr10	88642283	88643079	LINE/L2	1200	+	398	88642681	67763
chr10	88574918	88774918	harbor2	chr10	88644248	88645007	LINE/L2	477	+	380	88644628	69710
chr10	88574918	88774918	harbor2	chr10	88660094	88660317	LINE/L2	459	+	112	88660206	85288
chr10	88574918	88774918	harbor2	chr10	88660494	88661571	LINE/L2	1415	+	538	88661032	86114
chr10	75516797	75716797	harbor2	chr10	75574430	75574839	LINE/L2	549	+	204	75574634	57837
chr10	75516797	75716797	harbor2	chr10	75584165	75584532	LINE/L2	541	+	184	75584349	67552
chr10	108846617	109046617	harbor2	chr10	108905179	108905333	LINE/L2	462	+	77	108905256	58639
chr10	108846617	109046617	harbor2	chr10	108916978	108917297	LINE/L2	604	+	160	108917138	70521
chr10	129727898	129927898	harbor2	chr10	129820573	129820689	LINE/L2	541	+	58	129820631	92733
chr10	100593749	100793749	harbor2	chr10	100599656	100599710	LINE/L2	875	+	27	100599683	5934
chr10	100593749	100793749	harbor2	chr10	100600013	100600295	LINE/L2	875	+	141	100600154	6405
chr10	100593749	100793749	harbor2	chr10	100619247	100619924	LINE/L2	495	+	338	100619585	25836
chr10	100593749	100793749	harbor2	chr10	100641991	100642108	LINE/L2	449	+	58	100642049	48300
chr10	99882955	100082955	harbor2	chr10	99940348	99940891	LINE/L2	1591	+	272	99940620	57665
chr10	99882955	100082955	harbor2	chr10	99941184	99941470	LINE/L2	1591	+	143	99941327	58372
chr10	99882955	100082955	harbor2	chr10	99941768	99942043	LINE/L2	1591	+	138	99941906	58951
chr10	99882955	100082955	harbor2	chr10	99944549	99944675	LINE/L2	442	+	63	99944612	61657
chr10	99882955	100082955	harbor2	chr10	99969750	99970243	LINE/L2	517	+	246	99969996	87041
chr10	102489603	102689603	harbor2	chr10	102523789	102524183	LINE/L2	823	+	197	102523986	34383
chr10	102489603	102689603	harbor2	chr10	102524621	102524850	LINE/L2	823	+	114	102524735	35132
chr10	68914592	69114592	harbor2	chr10	68930568	68930674	LINE/L2	562	+	53	68930621	16029
chr10	68914592	69114592	harbor2	chr10	68930946	68931275	LINE/L2	562	+	164	68931110	16518
chr10	68914592	69114592	harbor2	chr10	68939431	68940006	LINE/L2	1121	+	288	68939719	25127
chr10	90288138	90488138	harbor2	chr10	90346325	90347193	LINE/L2	557	+	434	90346759	58621
chr10	90288138	90488138	harbor2	chr10	90352489	90353035	LINE/L2	817	+	273	90352762	64624
chr11	88809305	89009305	harbor2	chr11	88839648	88839685	LINE/L2	773	+	18	88839666	30361
chr11	88809305	89009305	harbor2	chr11	88842354	88842990	LINE/L2	773	+	318	88842672	33367
chr11	88809305	89009305	harbor2	chr11	88861226	88861475	LINE/L2	508	+	124	88861350	52045
chr11	88809305	89009305	harbor2	chr11	88861783	88861981	LINE/L2	508	+	99	88861882	52577
chr11	94745263	94945263	harbor2	chr11	94838086	94838319	LINE/L2	450	+	116	94838202	92939
chr11	114935676	115135676	harbor2	chr11	114973277	114973826	LINE/L2	883	+	274	114973551	37875
chr11	114935676	115135676	harbor2	chr11	114973857	114974261	LINE/L2	509	+	202	114974059	38383
chr11	114935676	115135676	harbor2	chr11	114978790	114979163	LINE/L2	378	+	186	114978976	43300
chr11	114935676	115135676	harbor2	chr11	114993322	114994143	LINE/L2	1114	+	410	114993732	58056
chr11	114935676	115135676	harbor2	chr11	114994930	114995379	LINE/L2	937	+	224	114995154	59478
chr11	114935676	115135676	harbor2	chr11	114995584	114996607	LINE/L2	1250	+	512	114996096	60420
chr11	114935676	115135676	harbor2	chr11	114996965	114997094	LINE/L2	1250	+	64	114997029	61353
chr11	114935676	115135676	harbor2	chr11	115007877	115008153	LINE/L2	748	+	138	115008015	72339
chr11	20697519	20897519	harbor2	chr11	20743619	20744394	LINE/L2	1100	+	388	20744007	46488
chr11	20697519	20897519	harbor2	chr11	20744846	20745228	LINE/L2	692	+	191	20745037	47518
chr11	132076026	132276026	harbor2	chr11	132092039	132093312	LINE/L2	523	+	636	132092675	16649
chr11	132076026	132276026	harbor2	chr11	132109920	132110268	LINE/L2	412	+	174	132110094	34068
chr11	132076026	132276026	harbor2	chr11	132156296	132156633	LINE/L2	485	+	168	132156464	80438
chr11	132076026	132276026	harbor2	chr11	132157677	132158640	LINE/L2	923	+	482	132158159	82133
chr11	133599692	133799692	harbor2	chr11	133622373	133623077	LINE/L2	418	+	352	133622725	23033
chr11	133599692	133799692	harbor2	chr11	133657272	133657440	LINE/L2	501	+	84	133657356	57664
chr11	133599692	133799692	harbor2	chr11	133674755	133675217	LINE/L2	905	+	231	133674986	75294
chr11	133599692	133799692	harbor2	chr11	133699140	133699576	LINE/L2	721	+	218	133699358	99666
chr11	80406593	80606593	harbor2	chr11	80417343	80417710	LINE/L2	451	+	184	80417527	10934
chr11	80406593	80606593	harbor2	chr11	80430797	80431368	LINE/L2	1095	+	286	80431083	24490
chr11	80406593	80606593	harbor2	chr11	80431834	80432633	LINE/L2	2711	+	400	80432234	25641
chr11	80406593	80606593	harbor2	chr11	80432947	80433734	LINE/L2	2711	+	394	80433341	26748
chr11	80406593	80606593	harbor2	chr11	80434396	80434929	LINE/L2	2711	+	266	80434662	28069
chr11	80406593	80606593	harbor2	chr11	80434981	80435075	LINE/L2	947	+	47	80435028	28435
chr11	80406593	80606593	harbor2	chr11	80438339	80438609	LINE/L2	577	+	135	80438474	31881
chr11	33799228	33999228	harbor2	chr11	33833525	33833603	LINE/L2	427	+	39	33833564	34336
chr11	33799228	33999228	harbor2	chr11	33848067	33848106	LINE/L2	793	+	20	33848087	48859
chr11	33799228	33999228	harbor2	chr11	33848516	33849209	LINE/L2	926	+	346	33848862	49634
chr11	33799228	33999228	harbor2	chr11	33875908	33876428	LINE/L2	1187	+	260	33876168	76940
chr11	33799228	33999228	harbor2	chr11	33888310	33888877	LINE/L2	1152	+	284	33888594	89366
chr11	33799228	33999228	harbor2	chr11	33898854	33899256	LINE/L2	421	+	201	33899055	99827
chr11	56767441	56967441	harbor2	chr11	56852258	56853391	LINE/L2	2151	+	566	56852824	85383
chr11	67823502	68023502	harbor2	chr11	67891540	67891745	LINE/L2	805	+	102	67891642	68140
chr11	67823502	68023502	harbor2	chr11	67892070	67892747	LINE/L2	805	+	338	67892408	68906
chr11	67823502	68023502	harbor2	chr11	67893845	67893994	LINE/L2	442	+	74	67893919	70417
chr11	67823502	68023502	harbor2	chr11	67902926	67903186	LINE/L2	413	+	130	67903056	79554
chr11	67823502	68023502	harbor2	chr11	67903697	67903795	LINE/L2	392	+	49	67903746	80244
chr11	67823502	68023502	harbor2	chr11	67904087	67904231	LINE/L2	392	+	72	67904159	80657
chr11	113602741	113802741	harbor2	chr11	113652885	113653734	LINE/L2	842	+	424	113653309	50568
chr11	132269289	132469289	harbor2	chr11	132358566	132358930	LINE/L2	496	+	182	132358748	89459
chr11	132269289	132469289	harbor2	chr11	132367346	132367577	LINE/L2	458	+	116	132367462	98173
chr11	105509477	105709477	harbor2	chr11	105536607	105537102	LINE/L2	991	+	248	105536855	27378
chr11	105509477	105709477	harbor2	chr11	105541519	105541930	LINE/L2	426	+	206	105541725	32248
chr11	105509477	105709477	harbor2	chr11	105598812	105599435	LINE/L2	538	+	312	105599124	89647
chr11	64288974	64488974	harbor2	chr11	64339505	64339669	LINE/L2	386	+	82	64339587	50613
chr11	64288974	64488974	harbor2	chr11	64366506	64366878	LINE/L2	390	+	186	64366692	77718
chr11	64288974	64488974	harbor2	chr11	64382616	64383112	LINE/L2	765	+	248	64382864	93890
chr11	64288974	64488974	harbor2	chr11	64383413	64383566	LINE/L2	765	+	76	64383489	94515
chr11	106411230	106611230	harbor2	chr11	106464322	106464494	LINE/L2	407	+	86	106464408	53178
chr11	106411230	106611230	harbor2	chr11	106508887	106509432	LINE/L2	480	+	272	106509159	97929
chr11	122761608	122961608	harbor2	chr11	122771114	122771232	LINE/L2	514	+	59	122771173	9565
chr11	122761608	122961608	harbor2	chr11	122771541	122771586	LINE/L2	514	+	22	122771563	9955
chr11	122761608	122961608	harbor2	chr11	122772182	122772361	LINE/L2	514	+	90	122772272	10664
chr11	122761608	122961608	harbor2	chr11	122774891	122775180	LINE/L2	652	+	144	122775035	13427
chr11	87536864	87736864	harbor2	chr11	87556354	87556732	LINE/L2	404	+	189	87556543	19679
chr11	87536864	87736864	harbor2	chr11	87613865	87614099	LINE/L2	459	+	117	87613982	77118
chr11	89426752	89626752	harbor2	chr11	89497635	89497809	LINE/L2	462	+	87	89497722	70970
chr11	89426752	89626752	harbor2	chr11	89517756	89517901	LINE/L2	381	+	72	89517828	91076
chr11	50026457	50226457	harbor2	chr11	50083186	50083825	LINE/L2	1302	+	320	50083506	57049
chr11	50026457	50226457	harbor2	chr11	50095189	50095785	LINE/L2	1489	+	298	50095487	69030
chr11	50026457	50226457	harbor2	chr11	50108064	50108438	LINE/L2	480	+	187	50108251	81794
chr11	50026457	50226457	harbor2	chr11	50109173	50109708	LINE/L2	721	+	268	50109441	82984
chr11	133320641	133520641	harbor2	chr11	133340846	133341192	LINE/L2	492	+	173	133341019	20378
chr11	133320641	133520641	harbor2	chr11	133351232	133352385	LINE/L2	1149	+	576	133351808	31167
chr11	130939077	131139077	harbor2	chr11	130945087	130945293	LINE/L2	410	+	103	130945190	6113
chr11	130939077	131139077	harbor2	chr11	130978428	130978781	LINE/L2	629	+	176	130978604	39527
chr11	130939077	131139077	harbor2	chr11	131007001	131007634	LINE/L2	1261	+	316	131007317	68240
chr11	130939077	131139077	harbor2	chr11	131007928	131008488	LINE/L2	1261	+	280	131008208	69131
chr11	130939077	131139077	harbor2	chr11	131024314	131024497	LINE/L2	375	+	92	131024406	85329
chr11	96932710	97132710	harbor2	chr11	97012522	97012662	LINE/L2	399	+	70	97012592	79882
chr11	96932710	97132710	harbor2	chr11	97031062	97031416	LINE/L2	680	+	177	97031239	98529
chr11	85107485	85307485	harbor2	chr11	85127222	85127629	LINE/L2	399	+	204	85127426	19941
chr11	85107485	85307485	harbor2	chr11	85138520	85138542	LINE/L2	909	+	11	85138531	31046
chr11	85107485	85307485	harbor2	chr11	85138894	85139309	LINE/L2	909	+	208	85139102	31617
chr11	129224657	129424657	harbor2	chr11	129282722	129283426	LINE/L2	712	+	352	129283074	58417
chr11	129224657	129424657	harbor2	chr11	129283466	129283599	LINE/L2	375	+	66	129283532	58875
chr11	128042982	128242982	harbor2	chr11	128059336	128059701	LINE/L2	412	+	182	128059518	16536
chr11	128042982	128242982	harbor2	chr11	128130372	128130508	LINE/L2	407	+	68	128130440	87458
chr11	115763104	115963104	harbor2	chr11	115764958	115766103	LINE/L2	1308	+	572	115765530	2426
chr11	115763104	115963104	harbor2	chr11	115767760	115768179	LINE/L2	475	+	210	115767970	4866
chr11	115763104	115963104	harbor2	chr11	115812995	115813486	LINE/L2	1140	+	246	115813241	50137
chr11	115763104	115963104	harbor2	chr11	115813846	115813876	LINE/L2	1140	+	15	115813861	50757
chr11	104219399	104419399	harbor2	chr11	104303942	104304250	LINE/L2	405	+	154	104304096	84697
chr11	133691837	133891837	harbor2	chr11	133699140	133699576	LINE/L2	721	+	218	133699358	7521
chr11	133691837	133891837	harbor2	chr11	133730443	133730792	LINE/L2	671	+	174	133730617	38780
chr11	133691837	133891837	harbor2	chr11	133708495	133711394	LINE/L2	4231	+	1450	133709945	18108
chr11	128358885	128558885	harbor2	chr11	128395374	128395770	LINE/L2	558	+	198	128395572	36687
chr11	128358885	128558885	harbor2	chr11	128417080	128417513	LINE/L2	423	+	216	128417296	58411
chr11	128358885	128558885	harbor2	chr11	128418486	128418757	LINE/L2	443	+	136	128418622	59737
chr11	128358885	128558885	harbor2	chr11	128421806	128422105	LINE/L2	414	+	150	128421956	63071
chr11	128358885	128558885	harbor2	chr11	128453529	128453898	LINE/L2	387	+	184	128453713	94828
chr11	72791212	72991212	harbor2	chr11	72840012	72840246	LINE/L2	420	+	117	72840129	48917
chr11	72791212	72991212	harbor2	chr11	72845861	72846000	LINE/L2	643	+	70	72845931	54719
chr11	72791212	72991212	harbor2	chr11	72848184	72848645	LINE/L2	458	+	230	72848414	57202
chr11	100220962	100420962	harbor2	chr11	100242034	100242443	LINE/L2	419	+	204	100242238	21276
chr11	130078647	130278647	harbor2	chr11	130112886	130113209	LINE/L2	431	+	162	130113048	34401
chr11	114097142	114297142	harbor2	chr11	114181948	114182042	LINE/L2	528	+	47	114181995	84853
chr11	114097142	114297142	harbor2	chr11	114182350	114182532	LINE/L2	528	+	91	114182441	85299
chr11	95485116	95685116	harbor2	chr11	95499731	95499882	LINE/L2	437	+	76	95499807	14691
chr11	95485116	95685116	harbor2	chr11	95502832	95503171	LINE/L2	1647	+	170	95503002	17886
chr11	95485116	95685116	harbor2	chr11	95503218	95503457	LINE/L2	1647	+	120	95503338	18222
chr11	95485116	95685116	harbor2	chr11	95520042	95520412	LINE/L2	706	+	185	95520227	35111
chr11	95485116	95685116	harbor2	chr11	95549691	95550267	LINE/L2	893	+	288	95549979	64863
chr11	95485116	95685116	harbor2	chr11	95550312	95550512	LINE/L2	461	+	100	95550412	65296
chr11	95485116	95685116	harbor2	chr11	95555266	95555515	LINE/L2	548	+	124	95555390	70274
chr11	95485116	95685116	harbor2	chr11	95563226	95563712	LINE/L2	393	+	243	95563469	78353
chr11	95485116	95685116	harbor2	chr11	95582267	95582764	LINE/L2	601	+	248	95582515	97399
chr11	95485116	95685116	harbor2	chr11	95582906	95583014	LINE/L2	428	+	54	95582960	97844
chr11	94562424	94762424	harbor2	chr11	94621601	94622288	LINE/L2	2426	+	344	94621945	59521
chr11	94562424	94762424	harbor2	chr11	94661054	94661822	LINE/L2	2152	+	384	94661438	99014
chr11	126756558	126956558	harbor2	chr11	126789245	126790127	LINE/L2	1031	+	441	126789686	33128
chr11	25046314	25246314	harbor2	chr11	25072212	25072402	LINE/L2	459	+	95	25072307	25993
chr11	25046314	25246314	harbor2	chr11	25088576	25089093	LINE/L2	996	+	258	25088834	42520
chr11	101525974	101725974	harbor2	chr11	101599816	101600215	LINE/L2	767	+	200	101600016	74042
chr11	126600636	126800636	harbor2	chr11	126625682	126626052	LINE/L2	591	+	185	126625867	25231
chr11	126600636	126800636	harbor2	chr11	126640836	126641324	LINE/L2	1688	+	244	126641080	40444
chr11	126600636	126800636	harbor2	chr11	126647574	126647942	LINE/L2	1695	+	184	126647758	47122
chr11	126600636	126800636	harbor2	chr11	126669647	126670223	LINE/L2	1769	+	288	126669935	69299
chr11	126600636	126800636	harbor2	chr11	126648307	126648709	LINE/L2	1695	+	201	126648508	47872
chr11	130471575	130671575	harbor2	chr11	130560823	130561010	LINE/L2	533	+	94	130560917	89342
chr11	130471575	130671575	harbor2	chr11	130563542	130563728	LINE/L2	375	+	93	130563635	92060
chr11	130489213	130689213	harbor2	chr11	130560823	130561010	LINE/L2	533	+	94	130560917	71704
chr11	130489213	130689213	harbor2	chr11	130563542	130563728	LINE/L2	375	+	93	130563635	74422
chr11	67664312	67864312	harbor2	chr11	67743066	67743534	LINE/L2	453	+	234	67743300	78988
chr11	116169971	116369971	harbor2	chr11	116223646	116223783	LINE/L2	406	+	68	116223714	53743
chr11	116169971	116369971	harbor2	chr11	116232897	116233373	LINE/L2	433	+	238	116233135	63164
chr11	116169971	116369971	harbor2	chr11	116241654	116242085	LINE/L2	1463	+	216	116241870	71899
chr11	116169971	116369971	harbor2	chr11	116247530	116247849	LINE/L2	379	+	160	116247690	77719
chr11	116169971	116369971	harbor2	chr11	116258611	116258923	LINE/L2	622	+	156	116258767	88796
chr11	116169971	116369971	harbor2	chr11	116264551	116265127	LINE/L2	1355	+	288	116264839	94868
chr11	75456332	75656332	harbor2	chr11	75477851	75478152	LINE/L2	1094	+	150	75478001	21669
chr11	75456332	75656332	harbor2	chr11	75478446	75478721	LINE/L2	1094	+	138	75478584	22252
chr11	75456332	75656332	harbor2	chr11	75500851	75501130	LINE/L2	378	+	140	75500991	44659
chr11	75456332	75656332	harbor2	chr11	75528049	75528138	LINE/L2	535	+	44	75528093	71761
chr11	75456332	75656332	harbor2	chr11	75549160	75549277	LINE/L2	729	+	58	75549218	92886
chr11	75456332	75656332	harbor2	chr11	75549755	75550001	LINE/L2	729	+	123	75549878	93546
chr11	111194744	111394744	harbor2	chr11	111205634	111205745	LINE/L2	374	+	56	111205690	10946
chr11	111194744	111394744	harbor2	chr11	111253482	111254140	LINE/L2	384	+	329	111253811	59067
chr11	125925704	126125704	harbor2	chr11	125973100	125973251	LINE/L2	382	+	76	125973176	47472
chr11	125925704	126125704	harbor2	chr11	125973555	125973897	LINE/L2	382	+	171	125973726	48022
chr11	125925704	126125704	harbor2	chr11	125982448	125982662	LINE/L2	383	+	107	125982555	56851
chr11	125925704	126125704	harbor2	chr11	126002730	126003263	LINE/L2	999	+	266	126002996	77292
chr11	23274216	23474216	harbor2	chr11	23306214	23306773	LINE/L2	664	+	280	23306494	32278
chr11	23274216	23474216	harbor2	chr11	23337853	23337932	LINE/L2	395	+	40	23337893	63677
chr11	23274216	23474216	harbor2	chr11	23361453	23361818	LINE/L2	385	+	182	23361635	87419
chr11	113508218	113708218	harbor2	chr11	113529176	113529536	LINE/L2	468	+	180	113529356	21138
chr11	113508218	113708218	harbor2	chr11	113542436	113542915	LINE/L2	1045	+	240	113542676	34458
chr11	113508218	113708218	harbor2	chr11	113550686	113550721	LINE/L2	503	+	18	113550704	42486
chr11	113508218	113708218	harbor2	chr11	113551039	113551602	LINE/L2	1001	+	282	113551321	43103
chr11	113508218	113708218	harbor2	chr11	113566129	113566288	LINE/L2	470	+	80	113566209	57991
chr11	102412967	102612967	harbor2	chr11	102437864	102438048	LINE/L2	786	+	92	102437956	24989
chr11	102412967	102612967	harbor2	chr11	102438350	102438543	LINE/L2	786	+	96	102438446	25479
chr11	102412967	102612967	harbor2	chr11	102449948	102450206	LINE/L2	660	+	129	102450077	37110
chr11	102412967	102612967	harbor2	chr11	102455573	102455994	LINE/L2	684	+	210	102455783	42816
chr11	116627019	116827019	harbor2	chr11	116631198	116631673	LINE/L2	1207	+	238	116631436	4417
chr11	116627019	116827019	harbor2	chr11	116638119	116638460	LINE/L2	550	+	170	116638289	11270
chr11	116627019	116827019	harbor2	chr11	116642499	116642667	LINE/L2	553	+	84	116642583	15564
chr11	116627019	116827019	harbor2	chr11	116654484	116654684	LINE/L2	442	+	100	116654584	27565
chr11	116627019	116827019	harbor2	chr11	116655242	116655517	LINE/L2	497	+	138	116655380	28361
chr11	116627019	116827019	harbor2	chr11	116661220	116661393	LINE/L2	504	+	86	116661306	34287
chr11	116627019	116827019	harbor2	chr11	116662796	116663084	LINE/L2	984	+	144	116662940	35921
chr11	116627019	116827019	harbor2	chr11	116685608	116685940	LINE/L2	680	+	166	116685774	58755
chr11	116627019	116827019	harbor2	chr11	116698958	116699078	LINE/L2	607	+	60	116699018	71999
chr11	116627019	116827019	harbor2	chr11	116722984	116723389	LINE/L2	602	+	202	116723186	96167
chr11	116627019	116827019	harbor2	chr11	116719449	116719623	LINE/L2	407	+	87	116719536	92517
chr11	133417051	133617051	harbor2	chr11	133485412	133485663	LINE/L2	1748	+	126	133485538	68487
chr11	133417051	133617051	harbor2	chr11	133486260	133487729	LINE/L2	1748	+	734	133486994	69943
chr11	133417051	133617051	harbor2	chr11	133490794	133491066	LINE/L2	675	+	136	133490930	73879
chr11	133417051	133617051	harbor2	chr11	133510751	133510881	LINE/L2	1971	+	65	133510816	93765
chr11	133417051	133617051	harbor2	chr11	133510923	133511924	LINE/L2	1971	+	500	133511423	94372
chr11	133417051	133617051	harbor2	chr11	133513456	133513751	LINE/L2	448	+	148	133513604	96553
chr11	36611572	36811572	harbor2	chr11	36628286	36628629	LINE/L2	490	+	172	36628458	16886
chr11	36611572	36811572	harbor2	chr11	36655135	36655555	LINE/L2	640	+	210	36655345	43773
chr11	36611572	36811572	harbor2	chr11	36664380	36664847	LINE/L2	786	+	234	36664614	53042
chr11	36611572	36811572	harbor2	chr11	36682603	36682893	LINE/L2	415	+	145	36682748	71176
chr11	130280572	130480572	harbor2	chr11	130318796	130319116	LINE/L2	376	+	160	130318956	38384
chr11	130280572	130480572	harbor2	chr11	130324542	130324679	LINE/L2	382	+	68	130324610	44038
chr11	130280572	130480572	harbor2	chr11	130326474	130326974	LINE/L2	2483	+	250	130326724	46152
chr11	130280572	130480572	harbor2	chr11	130327935	130328529	LINE/L2	2483	+	297	130328232	47660
chr11	130280572	130480572	harbor2	chr11	130328651	130328860	LINE/L2	2483	+	104	130328755	48183
chr11	130280572	130480572	harbor2	chr11	130341067	130341388	LINE/L2	970	+	160	130341227	60655
chr11	130280572	130480572	harbor2	chr11	130341701	130341904	LINE/L2	970	+	102	130341803	61231
chr11	130280572	130480572	harbor2	chr11	130350714	130351053	LINE/L2	399	+	170	130350884	70312
chr11	76323871	76523871	harbor2	chr11	76371056	76371261	LINE/L2	380	+	102	76371158	47287
chr11	76323871	76523871	harbor2	chr11	76376987	76377236	LINE/L2	618	+	124	76377111	53240
chr11	76323871	76523871	harbor2	chr11	76379139	76379878	LINE/L2	1136	+	370	76379509	55638
chr11	100205624	100405624	harbor2	chr11	100242034	100242443	LINE/L2	419	+	204	100242238	36614
chr11	122637951	122837951	harbor2	chr11	122685211	122685377	LINE/L2	531	+	83	122685294	47343
chr11	122637951	122837951	harbor2	chr11	122719993	122720954	LINE/L2	1896	+	480	122720473	82522
chr11	134931997	135131997	harbor2	chr11	134953762	134954242	LINE/L2	481	+	240	134954002	22005
chr11	69199813	69399813	harbor2	chr11	69285239	69285629	LINE/L2	408	+	195	69285434	85621
chr11	125946090	126146090	harbor2	chr11	125973100	125973251	LINE/L2	382	+	76	125973176	27086
chr11	125946090	126146090	harbor2	chr11	125973555	125973897	LINE/L2	382	+	171	125973726	27636
chr11	125946090	126146090	harbor2	chr11	125982448	125982662	LINE/L2	383	+	107	125982555	36465
chr11	125946090	126146090	harbor2	chr11	126002730	126003263	LINE/L2	999	+	266	126002996	56906
chr11	125946090	126146090	harbor2	chr11	126040279	126040401	LINE/L2	410	+	61	126040340	94250
chr11	115500745	115700745	harbor2	chr11	115534207	115534744	LINE/L2	492	+	268	115534475	33730
chr11	115500745	115700745	harbor2	chr11	115556362	115556498	LINE/L2	405	+	68	115556430	55685
chr11	115500745	115700745	harbor2	chr11	115590799	115590916	LINE/L2	537	+	58	115590857	90112
chr11	82367958	82567958	harbor2	chr11	82371198	82371402	LINE/L2	408	+	102	82371300	3342
chr11	82367958	82567958	harbor2	chr11	82371527	82371883	LINE/L2	408	+	178	82371705	3747
chr11	82367958	82567958	harbor2	chr11	82463845	82464159	LINE/L2	518	+	157	82464002	96044
chr11	122268206	122468206	harbor2	chr11	122273260	122273556	LINE/L2	623	+	148	122273408	5202
chr11	122268206	122468206	harbor2	chr11	122299916	122300212	LINE/L2	405	+	148	122300064	31858
chr11	122268206	122468206	harbor2	chr11	122300453	122300691	LINE/L2	410	+	119	122300572	32366
chr11	122268206	122468206	harbor2	chr11	122340431	122340802	LINE/L2	455	+	186	122340617	72411
chr11	122268206	122468206	harbor2	chr11	122322143	122322989	LINE/L2	510	+	423	122322566	54360
chr11	90302240	90502240	harbor2	chr11	90320529	90320674	LINE/L2	593	+	72	90320601	18361
chr11	90302240	90502240	harbor2	chr11	90321396	90321621	LINE/L2	593	+	112	90321508	19268
chr11	90302240	90502240	harbor2	chr11	90329562	90329782	LINE/L2	377	+	110	90329672	27432
chr11	90302240	90502240	harbor2	chr11	90362442	90362799	LINE/L2	626	+	178	90362620	60380
chr11	90302240	90502240	harbor2	chr11	90394191	90394499	LINE/L2	411	+	154	90394345	92105
chr11	97093032	97293032	harbor2	chr11	97190680	97191625	LINE/L2	1575	+	472	97191152	98120
chr11	130437790	130637790	harbor2	chr11	130464399	130464685	LINE/L2	2029	+	143	130464542	26752
chr11	130437790	130637790	harbor2	chr11	130466173	130467053	LINE/L2	2029	+	440	130466613	28823
chr11	130437790	130637790	harbor2	chr11	130464997	130465859	LINE/L2	2029	+	431	130465428	27638
chr11	39943085	40143085	harbor2	chr11	39954379	39954521	LINE/L2	382	+	71	39954450	11365
chr11	39943085	40143085	harbor2	chr11	40004418	40004538	LINE/L2	390	+	60	40004478	61393
chr11	115379566	115579566	harbor2	chr11	115392043	115392325	LINE/L2	907	+	141	115392184	12618
chr11	115379566	115579566	harbor2	chr11	115431268	115431901	LINE/L2	499	+	316	115431584	52018
chr11	115379566	115579566	harbor2	chr11	115440264	115440449	LINE/L2	413	+	92	115440356	60790
chr11	133309979	133509979	harbor2	chr11	133313068	133313259	LINE/L2	503	+	96	133313164	3185
chr11	133309979	133509979	harbor2	chr11	133340846	133341192	LINE/L2	492	+	173	133341019	31040
chr11	133309979	133509979	harbor2	chr11	133351232	133352385	LINE/L2	1149	+	576	133351808	41829
chr11	117695936	117895936	harbor2	chr11	117731382	117731830	LINE/L2	543	+	224	117731606	35670
chr11	117695936	117895936	harbor2	chr11	117734428	117734777	LINE/L2	430	+	174	117734602	38666
chr11	117695936	117895936	harbor2	chr11	117746684	117746879	LINE/L2	524	+	98	117746782	50846
chr11	117695936	117895936	harbor2	chr11	117702360	117702660	LINE/L2	561	+	150	117702510	6574
chr11	126733061	126933061	harbor2	chr11	126744717	126744883	LINE/L2	398	+	83	126744800	11739
chr11	126733061	126933061	harbor2	chr11	126789245	126790127	LINE/L2	1031	+	441	126789686	56625
chr11	110259290	110459290	harbor2	chr11	110260643	110260654	LINE/L2	775	+	6	110260649	1359
chr11	110259290	110459290	harbor2	chr11	110261004	110261310	LINE/L2	775	+	153	110261157	1867
chr11	110259290	110459290	harbor2	chr11	110265627	110266003	LINE/L2	393	+	188	110265815	6525
chr11	103890630	104090630	harbor2	chr11	103894617	103895245	LINE/L2	2048	+	314	103894931	4301
chr11	103890630	104090630	harbor2	chr11	103896086	103896573	LINE/L2	1010	+	244	103896330	5700
chr11	103890630	104090630	harbor2	chr11	103898024	103898696	LINE/L2	1101	+	336	103898360	7730
chr11	103890630	104090630	harbor2	chr11	103899228	103899442	LINE/L2	430	+	107	103899335	8705
chr11	103890630	104090630	harbor2	chr11	103903154	103903572	LINE/L2	822	+	209	103903363	12733
chr11	103890630	104090630	harbor2	chr11	103951322	103951978	LINE/L2	872	+	328	103951650	61020
chr11	103890630	104090630	harbor2	chr11	103961040	103961204	LINE/L2	405	+	82	103961122	70492
chr11	103890630	104090630	harbor2	chr11	103967807	103969126	LINE/L2	676	+	660	103968467	77837
chr11	103890630	104090630	harbor2	chr11	103990261	103990623	LINE/L2	520	+	181	103990442	99812
chr11	128712559	128912559	harbor2	chr11	128760849	128761386	LINE/L2	644	+	268	128761117	48558
chr11	128712559	128912559	harbor2	chr11	128797465	128797711	LINE/L2	617	+	123	128797588	85029
chr11	128712559	128912559	harbor2	chr11	128806756	128807062	LINE/L2	593	+	153	128806909	94350
chr11	132348085	132548085	harbor2	chr11	132358566	132358930	LINE/L2	496	+	182	132358748	10663
chr11	132348085	132548085	harbor2	chr11	132367346	132367577	LINE/L2	458	+	116	132367462	19377
chr11	132348085	132548085	harbor2	chr11	132396570	132396926	LINE/L2	1315	+	178	132396748	48663
chr11	132348085	132548085	harbor2	chr11	132397230	132397929	LINE/L2	1315	+	350	132397580	49495
chr11	132348085	132548085	harbor2	chr11	132398078	132398290	LINE/L2	579	+	106	132398184	50099
chr11	132348085	132548085	harbor2	chr11	132432816	132432935	LINE/L2	397	+	60	132432876	84791
chr11	131570265	131770265	harbor2	chr11	131602575	131603292	LINE/L2	1220	+	358	131602933	32668
chr11	131570265	131770265	harbor2	chr11	131620264	131620943	LINE/L2	1311	+	340	131620604	50339
chr11	128241785	128441785	harbor2	chr11	128286564	128286690	LINE/L2	397	+	63	128286627	44842
chr11	128241785	128441785	harbor2	chr11	128309552	128309667	LINE/L2	436	+	58	128309610	67825
chr11	128241785	128441785	harbor2	chr11	128312701	128312988	LINE/L2	719	+	144	128312845	71060
chr11	131144361	131344361	harbor2	chr11	131148697	131148971	LINE/L2	403	+	137	131148834	4473
chr11	131144361	131344361	harbor2	chr11	131172092	131172503	LINE/L2	485	+	206	131172298	27937
chr11	131144361	131344361	harbor2	chr11	131206908	131207329	LINE/L2	509	+	210	131207118	62757
chr11	131144361	131344361	harbor2	chr11	131215265	131215611	LINE/L2	596	+	173	131215438	71077
chr11	106184289	106384289	harbor2	chr11	106221630	106221852	LINE/L2	440	+	111	106221741	37452
chr11	106184289	106384289	harbor2	chr11	106255205	106255331	LINE/L2	444	+	63	106255268	70979
chr11	106184289	106384289	harbor2	chr11	106255396	106255591	LINE/L2	444	+	98	106255494	71205
chr11	106184289	106384289	harbor2	chr11	106258841	106260460	LINE/L2	1777	+	810	106259651	75362
chr11	106184289	106384289	harbor2	chr11	106282879	106282951	LINE/L2	543	+	36	106282915	98626
chr11	106184289	106384289	harbor2	chr11	106283307	106284113	LINE/L2	621	+	403	106283710	99421
chr11	89796103	89996103	harbor2	chr11	89802360	89802566	LINE/L2	596	+	103	89802463	6360
chr11	89796103	89996103	harbor2	chr11	89802642	89803014	LINE/L2	596	+	186	89802828	6725
chr11	129357157	129557157	harbor2	chr11	129360462	129360848	LINE/L2	889	+	193	129360655	3498
chr11	129357157	129557157	harbor2	chr11	129362395	129363014	LINE/L2	835	+	310	129362705	5548
chr11	129357157	129557157	harbor2	chr11	129432856	129433992	LINE/L2	1465	+	568	129433424	76267
chr11	95334600	95534600	harbor2	chr11	95340752	95341092	LINE/L2	699	+	170	95340922	6322
chr11	95334600	95534600	harbor2	chr11	95361413	95361563	LINE/L2	404	+	75	95361488	26888
chr11	95334600	95534600	harbor2	chr11	95426970	95427366	LINE/L2	499	+	198	95427168	92568
chr11	103314444	103514444	harbor2	chr11	103315399	103315896	LINE/L2	411	+	248	103315647	1203
chr11	103314444	103514444	harbor2	chr11	103344342	103344699	LINE/L2	703	+	178	103344520	30076
chr11	103314444	103514444	harbor2	chr11	103317182	103318023	LINE/L2	647	+	420	103317602	3158
chr11	96855014	97055014	harbor2	chr11	96917951	96918384	LINE/L2	1179	+	216	96918167	63153
chr11	128412072	128612072	harbor2	chr11	128417080	128417513	LINE/L2	423	+	216	128417296	5224
chr11	128412072	128612072	harbor2	chr11	128418486	128418757	LINE/L2	443	+	136	128418622	6550
chr11	128412072	128612072	harbor2	chr11	128421806	128422105	LINE/L2	414	+	150	128421956	9884
chr11	128412072	128612072	harbor2	chr11	128453529	128453898	LINE/L2	387	+	184	128453713	41641
chr11	110857651	111057651	harbor2	chr11	110871322	110871519	LINE/L2	424	+	98	110871420	13769
chr11	110857651	111057651	harbor2	chr11	110895747	110895845	LINE/L2	390	+	49	110895796	38145
chr11	110857651	111057651	harbor2	chr11	110896227	110896853	LINE/L2	390	+	313	110896540	38889
chr11	110857651	111057651	harbor2	chr11	110897168	110897325	LINE/L2	391	+	78	110897246	39595
chr11	110857651	111057651	harbor2	chr11	110897323	110897666	LINE/L2	419	+	172	110897495	39844
chr11	110857651	111057651	harbor2	chr11	110944783	110945205	LINE/L2	760	+	211	110944994	87343
chr11	110857651	111057651	harbor2	chr11	110948464	110948655	LINE/L2	376	+	96	110948560	90909
chr11	101883569	102083569	harbor2	chr11	101910553	101911062	LINE/L2	1498	+	254	101910807	27238
chr11	101883569	102083569	harbor2	chr11	101911801	101912200	LINE/L2	1498	+	200	101912001	28432
chr11	101883569	102083569	harbor2	chr11	101932580	101932907	LINE/L2	401	+	164	101932744	49175
chr11	101883569	102083569	harbor2	chr11	101934048	101934576	LINE/L2	1392	+	264	101934312	50743
chr11	35095635	35295635	harbor2	chr11	35131279	35131496	LINE/L2	700	+	108	35131387	35752
chr11	79010269	79210269	harbor2	chr11	79013788	79014136	LINE/L2	415	+	174	79013962	3693
chr11	79010269	79210269	harbor2	chr11	79057068	79057745	LINE/L2	1644	+	338	79057406	47137
chr11	79010269	79210269	harbor2	chr11	79065105	79065489	LINE/L2	597	+	192	79065297	55028
chr11	79010269	79210269	harbor2	chr11	79070539	79070711	LINE/L2	681	+	86	79070625	60356
chr11	79010269	79210269	harbor2	chr11	79100544	79100659	LINE/L2	452	+	58	79100602	90333
chr11	79010269	79210269	harbor2	chr11	79103974	79104265	LINE/L2	483	+	146	79104120	93851
chr11	72470280	72670280	harbor2	chr11	72552706	72553157	LINE/L2	388	+	226	72552932	82652
chr11	111436508	111636508	harbor2	chr11	111471836	111472347	LINE/L2	1443	+	256	111472092	35584
chr11	111436508	111636508	harbor2	chr11	111472565	111472855	LINE/L2	736	+	145	111472710	36202
chr11	111436508	111636508	harbor2	chr11	111518734	111519020	LINE/L2	408	+	143	111518877	82369
chr11	111436508	111636508	harbor2	chr11	111521071	111521207	LINE/L2	387	+	68	111521139	84631
chr11	111436508	111636508	harbor2	chr11	111523587	111524084	LINE/L2	620	+	248	111523835	87327
chr11	111436508	111636508	harbor2	chr11	111531950	111532280	LINE/L2	408	+	165	111532115	95607
chr11	128939709	129139709	harbor2	chr11	129027149	129027932	LINE/L2	1233	+	392	129027541	87832
chr11	109407424	109607424	harbor2	chr11	109417170	109417286	LINE/L2	377	+	58	109417228	9804
chr11	78135329	78335329	harbor2	chr11	78138793	78139208	LINE/L2	438	+	208	78139001	3672
chr11	78135329	78335329	harbor2	chr11	78143941	78144337	LINE/L2	632	+	198	78144139	8810
chr11	78135329	78335329	harbor2	chr11	78200918	78201316	LINE/L2	403	+	199	78201117	65788
chr11	99332114	99532114	harbor2	chr11	99354561	99355354	LINE/L2	940	+	396	99354957	22843
chr11	18510745	18710745	harbor2	chr11	18515126	18515321	LINE/L2	399	+	98	18515224	4479
chr11	18510745	18710745	harbor2	chr11	18521333	18521359	LINE/L2	874	+	13	18521346	10601
chr11	18510745	18710745	harbor2	chr11	18521977	18522256	LINE/L2	874	+	140	18522117	11372
chr11	18510745	18710745	harbor2	chr11	18522443	18522895	LINE/L2	1472	+	226	18522669	11924
chr11	18510745	18710745	harbor2	chr11	18523182	18523479	LINE/L2	1154	+	148	18523330	12585
chr11	102129226	102329226	harbor2	chr11	102151318	102151695	LINE/L2	517	+	188	102151506	22280
chr11	114495176	114695176	harbor2	chr11	114516771	114517107	LINE/L2	565	+	168	114516939	21763
chr11	114495176	114695176	harbor2	chr11	114568537	114568993	LINE/L2	489	+	228	114568765	73589
chr11	115384270	115584270	harbor2	chr11	115392043	115392325	LINE/L2	907	+	141	115392184	7914
chr11	115384270	115584270	harbor2	chr11	115431268	115431901	LINE/L2	499	+	316	115431584	47314
chr11	115384270	115584270	harbor2	chr11	115440264	115440449	LINE/L2	413	+	92	115440356	56086
chr11	115384270	115584270	harbor2	chr11	115481986	115482428	LINE/L2	807	+	221	115482207	97937
chr11	86975314	87175314	harbor2	chr11	87036793	87036990	LINE/L2	558	+	98	87036891	61577
chr11	86975314	87175314	harbor2	chr11	87046997	87047175	LINE/L2	501	+	89	87047086	71772
chr11	129868908	130068908	harbor2	chr11	129870739	129870995	LINE/L2	584	+	128	129870867	1959
chr11	129868908	130068908	harbor2	chr11	129871486	129872301	LINE/L2	1008	+	408	129871894	2986
chr11	129868908	130068908	harbor2	chr11	129879456	129879905	LINE/L2	436	+	224	129879680	10772
chr11	129868908	130068908	harbor2	chr11	129880215	129880398	LINE/L2	436	+	92	129880307	11399
chr11	129868908	130068908	harbor2	chr11	129880489	129880823	LINE/L2	386	+	167	129880656	11748
chr11	129868908	130068908	harbor2	chr11	129933796	129934374	LINE/L2	1339	+	289	129934085	65177
chr11	129868908	130068908	harbor2	chr11	129934404	129934706	LINE/L2	475	+	151	129934555	65647
chr11	129868908	130068908	harbor2	chr11	129938060	129938634	LINE/L2	936	+	287	129938347	69439
chr11	129868908	130068908	harbor2	chr11	129938737	129938958	LINE/L2	936	+	110	129938847	69939
chr11	102151937	102351937	harbor2	chr11	102251477	102251890	LINE/L2	652	+	206	102251683	99746
chr11	61752158	61952158	harbor2	chr11	61758714	61758890	LINE/L2	702	+	88	61758802	6644
chr11	61752158	61952158	harbor2	chr11	61808746	61809250	LINE/L2	538	+	252	61808998	56840
chr11	123884856	124084856	harbor2	chr11	123941446	123941979	LINE/L2	651	+	266	123941712	56856
chr11	123884856	124084856	harbor2	chr11	123942149	123942186	LINE/L2	651	+	18	123942167	57311
chr11	127181085	127381085	harbor2	chr11	127258470	127258805	LINE/L2	557	+	168	127258638	77553
chr11	122968086	123168086	harbor2	chr11	123003844	123003962	LINE/L2	531	+	59	123003903	35817
chr11	122968086	123168086	harbor2	chr11	123046614	123046930	LINE/L2	752	+	158	123046772	78686
chr11	127824252	128024252	harbor2	chr11	127878922	127879583	LINE/L2	690	+	330	127879252	55000
chr11	127824252	128024252	harbor2	chr11	127881761	127882863	LINE/L2	1177	+	551	127882312	58060
chr11	120110322	120310322	harbor2	chr11	120118480	120119046	LINE/L2	497	+	283	120118763	8441
chr11	120110322	120310322	harbor2	chr11	120126565	120126911	LINE/L2	478	+	173	120126738	16416
chr11	120110322	120310322	harbor2	chr11	120205046	120205820	LINE/L2	410	+	387	120205433	95111
chr11	89215898	89415898	harbor2	chr11	89277454	89278374	LINE/L2	439	+	460	89277914	62016
chr11	89215898	89415898	harbor2	chr11	89301666	89302015	LINE/L2	376	+	174	89301840	85942
chr11	89215898	89415898	harbor2	chr11	89303462	89303628	LINE/L2	822	+	83	89303545	87647
chr11	89215898	89415898	harbor2	chr11	89303950	89304415	LINE/L2	822	+	232	89304182	88284
chr11	120315101	120515101	harbor2	chr11	120373449	120373542	LINE/L2	577	+	46	120373495	58394
chr11	120315101	120515101	harbor2	chr11	120391996	120392503	LINE/L2	736	+	254	120392250	77149
chr11	105565680	105765680	harbor2	chr11	105598812	105599435	LINE/L2	538	+	312	105599124	33444
chr11	105565680	105765680	harbor2	chr11	105620096	105620250	LINE/L2	431	+	77	105620173	54493
chr11	105565680	105765680	harbor2	chr11	105622550	105622686	LINE/L2	509	+	68	105622618	56938
chr11	105565680	105765680	harbor2	chr11	105623306	105623542	LINE/L2	509	+	118	105623424	57744
chr11	105565680	105765680	harbor2	chr11	105623561	105623949	LINE/L2	569	+	194	105623755	58075
chr11	122187515	122387515	harbor2	chr11	122192989	122193363	LINE/L2	544	+	187	122193176	5661
chr11	122187515	122387515	harbor2	chr11	122196630	122196748	LINE/L2	422	+	59	122196689	9174
chr11	122187515	122387515	harbor2	chr11	122196762	122197009	LINE/L2	389	+	124	122196886	9371
chr11	122187515	122387515	harbor2	chr11	122197488	122198011	LINE/L2	425	+	262	122197750	10235
chr11	122187515	122387515	harbor2	chr11	122214229	122214558	LINE/L2	579	+	164	122214393	26878
chr11	122187515	122387515	harbor2	chr11	122221182	122221516	LINE/L2	796	+	167	122221349	33834
chr11	122187515	122387515	harbor2	chr11	122221821	122221920	LINE/L2	796	+	50	122221871	34356
chr11	122187515	122387515	harbor2	chr11	122231052	122231386	LINE/L2	3526	+	167	122231219	43704
chr11	122187515	122387515	harbor2	chr11	122231679	122232770	LINE/L2	3526	+	546	122232225	44710
chr11	122187515	122387515	harbor2	chr11	122273260	122273556	LINE/L2	623	+	148	122273408	85893
chr11	65114277	65314277	harbor2	chr11	65118707	65118970	LINE/L2	463	+	132	65118839	4562
chr11	65114277	65314277	harbor2	chr11	65137342	65137550	LINE/L2	493	+	104	65137446	23169
chr11	65114277	65314277	harbor2	chr11	65188969	65189029	LINE/L2	906	+	30	65188999	74722
chr11	65114277	65314277	harbor2	chr11	65189321	65190427	LINE/L2	906	+	553	65189874	75597
chr11	90262225	90462225	harbor2	chr11	90262862	90263245	LINE/L2	800	+	192	90263054	829
chr11	90262225	90462225	harbor2	chr11	90263643	90263821	LINE/L2	800	+	89	90263732	1507
chr11	90262225	90462225	harbor2	chr11	90264354	90264690	LINE/L2	574	+	168	90264522	2297
chr11	90262225	90462225	harbor2	chr11	90320529	90320674	LINE/L2	593	+	72	90320601	58376
chr11	90262225	90462225	harbor2	chr11	90321396	90321621	LINE/L2	593	+	112	90321508	59283
chr11	90262225	90462225	harbor2	chr11	90329562	90329782	LINE/L2	377	+	110	90329672	67447
chr11	106637112	106837112	harbor2	chr11	106727717	106728197	LINE/L2	380	+	240	106727957	90845
chr11	120102211	120302211	harbor2	chr11	120118480	120119046	LINE/L2	497	+	283	120118763	16552
chr11	120102211	120302211	harbor2	chr11	120126565	120126911	LINE/L2	478	+	173	120126738	24527
chr11	125898453	126098453	harbor2	chr11	125973100	125973251	LINE/L2	382	+	76	125973176	74723
chr11	125898453	126098453	harbor2	chr11	125973555	125973897	LINE/L2	382	+	171	125973726	75273
chr11	125898453	126098453	harbor2	chr11	125982448	125982662	LINE/L2	383	+	107	125982555	84102
chr11	71413240	71613240	harbor2	chr11	71445133	71445663	LINE/L2	638	+	265	71445398	32158
chr11	111024899	111224899	harbor2	chr11	111071589	111072036	LINE/L2	376	+	224	111071813	46914
chr11	111024899	111224899	harbor2	chr11	111091683	111092042	LINE/L2	385	+	180	111091863	66964
chr11	111024899	111224899	harbor2	chr11	111108334	111108593	LINE/L2	489	+	130	111108464	83565
chr11	111024899	111224899	harbor2	chr11	111114591	111114730	LINE/L2	472	+	70	111114661	89762
chr11	133844693	134044693	harbor2	chr11	133891948	133892952	LINE/L2	1269	+	502	133892450	47757
chr11	133844693	134044693	harbor2	chr11	133895972	133896288	LINE/L2	636	+	158	133896130	51437
chr11	133844693	134044693	harbor2	chr11	133939059	133939527	LINE/L2	977	+	234	133939293	94600
chr11	109426753	109626753	harbor2	chr11	109513891	109515183	LINE/L2	2050	+	646	109514537	87784
chr11	109426753	109626753	harbor2	chr11	109516564	109516835	LINE/L2	1015	+	136	109516700	89947
chr11	104412726	104612726	harbor2	chr11	104438233	104439491	LINE/L2	1487	+	629	104438862	26136
chr11	34958022	35158022	harbor2	chr11	35008827	35008882	LINE/L2	377	+	28	35008855	50833
chr11	34958022	35158022	harbor2	chr11	35009177	35009404	LINE/L2	377	+	114	35009291	51269
chr11	34958022	35158022	harbor2	chr11	35033474	35034398	LINE/L2	958	+	462	35033936	75914
chr11	34958022	35158022	harbor2	chr11	35035017	35035298	LINE/L2	410	+	140	35035157	77135
chr11	34958022	35158022	harbor2	chr11	35035482	35035783	LINE/L2	489	+	150	35035632	77610
chr11	74694708	74894708	harbor2	chr11	74697995	74698058	LINE/L2	423	+	32	74698027	3319
chr11	74694708	74894708	harbor2	chr11	74698372	74698628	LINE/L2	423	+	128	74698500	3792
chr11	74694708	74894708	harbor2	chr11	74724471	74724864	LINE/L2	448	+	196	74724667	29959
chr11	74694708	74894708	harbor2	chr11	74733764	74734120	LINE/L2	446	+	178	74733942	39234
chr11	74694708	74894708	harbor2	chr11	74737048	74737081	LINE/L2	661	+	16	74737064	42356
chr11	74694708	74894708	harbor2	chr11	74737394	74737466	LINE/L2	661	+	36	74737430	42722
chr11	74694708	74894708	harbor2	chr11	74737768	74738202	LINE/L2	743	+	217	74737985	43277
chr11	74694708	74894708	harbor2	chr11	74738340	74738405	LINE/L2	743	+	32	74738372	43664
chr11	74694708	74894708	harbor2	chr11	74775631	74775935	LINE/L2	538	+	152	74775783	81075
chr11	105307027	105507027	harbor2	chr11	105309540	105309856	LINE/L2	434	+	158	105309698	2671
chr11	105307027	105507027	harbor2	chr11	105361503	105361898	LINE/L2	541	+	198	105361701	54674
chr11	134951399	135151399	harbor2	chr11	134953762	134954242	LINE/L2	481	+	240	134954002	2603
chr11	126175622	126375622	harbor2	chr11	126218261	126218617	LINE/L2	1097	+	178	126218439	42817
chr11	103404534	103604534	harbor2	chr11	103440749	103441596	LINE/L2	1791	+	424	103441173	36639
chr11	134289061	134489061	harbor2	chr11	134326360	134326603	LINE/L2	1309	+	122	134326482	37421
chr11	134289061	134489061	harbor2	chr11	134326911	134328014	LINE/L2	1309	+	552	134327463	38402
chr11	134289061	134489061	harbor2	chr11	134328265	134328473	LINE/L2	803	+	104	134328369	39308
chr11	134289061	134489061	harbor2	chr11	134359400	134360049	LINE/L2	577	+	324	134359724	70663
chr11	134289061	134489061	harbor2	chr11	134377398	134378003	LINE/L2	737	+	302	134377700	88639
chr11	134289061	134489061	harbor2	chr11	134378192	134378465	LINE/L2	554	+	136	134378328	89267
chr11	115704262	115904262	harbor2	chr11	115750439	115750662	LINE/L2	377	+	112	115750551	46289
chr11	115704262	115904262	harbor2	chr11	115764958	115766103	LINE/L2	1308	+	572	115765530	61268
chr11	115704262	115904262	harbor2	chr11	115767760	115768179	LINE/L2	475	+	210	115767970	63708
chr11	133670627	133870627	harbor2	chr11	133674755	133675217	LINE/L2	905	+	231	133674986	4359
chr11	133670627	133870627	harbor2	chr11	133699140	133699576	LINE/L2	721	+	218	133699358	28731
chr11	133670627	133870627	harbor2	chr11	133730443	133730792	LINE/L2	671	+	174	133730617	59990
chr11	133670627	133870627	harbor2	chr11	133708495	133711394	LINE/L2	4231	+	1450	133709945	39318
chr11	119745066	119945066	harbor2	chr11	119758349	119758601	LINE/L2	409	+	126	119758475	13409
chr11	119745066	119945066	harbor2	chr11	119760028	119760214	LINE/L2	377	+	93	119760121	15055
chr11	119745066	119945066	harbor2	chr11	119765068	119765290	LINE/L2	533	+	111	119765179	20113
chr11	119745066	119945066	harbor2	chr11	119765372	119765768	LINE/L2	613	+	198	119765570	20504
chr11	119745066	119945066	harbor2	chr11	119799555	119799681	LINE/L2	393	+	63	119799618	54552
chr11	119745066	119945066	harbor2	chr11	119834467	119834791	LINE/L2	724	+	162	119834629	89563
chr11	120359289	120559289	harbor2	chr11	120373449	120373542	LINE/L2	577	+	46	120373495	14206
chr11	120359289	120559289	harbor2	chr11	120391996	120392503	LINE/L2	736	+	254	120392250	32961
chr11	120359289	120559289	harbor2	chr11	120428520	120428637	LINE/L2	479	+	58	120428578	69289
chr11	120359289	120559289	harbor2	chr11	120442755	120443021	LINE/L2	1393	+	133	120442888	83599
chr11	120359289	120559289	harbor2	chr11	120443320	120443566	LINE/L2	1393	+	123	120443443	84154
chr11	120359289	120559289	harbor2	chr11	120443594	120443710	LINE/L2	628	+	58	120443652	84363
chr11	120359289	120559289	harbor2	chr11	120444028	120444162	LINE/L2	615	+	67	120444095	84806
chr11	120008815	120208815	harbor2	chr11	120021928	120022151	LINE/L2	526	+	112	120022040	13225
chr11	120008815	120208815	harbor2	chr11	120034593	120034764	LINE/L2	383	+	86	120034679	25864
chr11	120008815	120208815	harbor2	chr11	120080325	120080910	LINE/L2	1076	+	292	120080617	71802
chr11	120008815	120208815	harbor2	chr11	120090164	120090321	LINE/L2	526	+	78	120090242	81427
chr11	116798092	116998092	harbor2	chr11	116849686	116850221	LINE/L2	630	+	268	116849954	51862
chr11	116798092	116998092	harbor2	chr11	116878141	116878381	LINE/L2	787	+	120	116878261	80169
chr11	116798092	116998092	harbor2	chr11	116878680	116879134	LINE/L2	787	+	227	116878907	80815
chr11	116798092	116998092	harbor2	chr11	116894004	116894954	LINE/L2	1472	+	475	116894479	96387
chr11	116798092	116998092	harbor2	chr11	116895022	116895429	LINE/L2	1472	+	204	116895226	97134
chr11	103019204	103219204	harbor2	chr11	103055938	103056716	LINE/L2	965	+	389	103056327	37123
chr11	103019204	103219204	harbor2	chr11	103086457	103086766	LINE/L2	875	+	154	103086611	67407
chr11	123703324	123903324	harbor2	chr11	123713714	123714651	LINE/L2	1377	+	468	123714182	10858
chr11	123703324	123903324	harbor2	chr11	123734275	123734751	LINE/L2	531	+	238	123734513	31189
chr11	123703324	123903324	harbor2	chr11	123757140	123757532	LINE/L2	836	+	196	123757336	54012
chr11	123703324	123903324	harbor2	chr11	123757728	123758104	LINE/L2	836	+	188	123757916	54592
chr11	78232384	78432384	harbor2	chr11	78252528	78252923	LINE/L2	482	+	198	78252726	20342
chr11	78232384	78432384	harbor2	chr11	78282781	78284899	LINE/L2	5017	+	1059	78283840	51456
chr11	78232384	78432384	harbor2	chr11	78286168	78286584	LINE/L2	509	+	208	78286376	53992
chr11	78232384	78432384	harbor2	chr11	78329374	78329584	LINE/L2	431	+	105	78329479	97095
chr11	86282361	86482361	harbor2	chr11	86283342	86283554	LINE/L2	654	+	106	86283448	1087
chr11	86282361	86482361	harbor2	chr11	86362212	86362516	LINE/L2	830	+	152	86362364	80003
chr11	113645760	113845760	harbor2	chr11	113652885	113653734	LINE/L2	842	+	424	113653309	7549
chr11	113645760	113845760	harbor2	chr11	113721770	113722216	LINE/L2	428	+	223	113721993	76233
chr11	113645760	113845760	harbor2	chr11	113729444	113729998	LINE/L2	476	+	277	113729721	83961
chr11	92187926	92387926	harbor2	chr11	92220473	92220653	LINE/L2	374	+	90	92220563	32637
chr11	92187926	92387926	harbor2	chr11	92270030	92270396	LINE/L2	2071	+	183	92270213	82287
chr11	92187926	92387926	harbor2	chr11	92270709	92271663	LINE/L2	2071	+	477	92271186	83260
chr11	92187926	92387926	harbor2	chr11	92282864	92283110	LINE/L2	527	+	123	92282987	95061
chr11	92187926	92387926	harbor2	chr11	92192342	92192872	LINE/L2	517	+	265	92192607	4681
chr11	134310279	134510279	harbor2	chr11	134326360	134326603	LINE/L2	1309	+	122	134326482	16203
chr11	134310279	134510279	harbor2	chr11	134326911	134328014	LINE/L2	1309	+	552	134327463	17184
chr11	134310279	134510279	harbor2	chr11	134328265	134328473	LINE/L2	803	+	104	134328369	18090
chr11	134310279	134510279	harbor2	chr11	134359400	134360049	LINE/L2	577	+	324	134359724	49445
chr11	134310279	134510279	harbor2	chr11	134377398	134378003	LINE/L2	737	+	302	134377700	67421
chr11	134310279	134510279	harbor2	chr11	134378192	134378465	LINE/L2	554	+	136	134378328	68049
chr11	110415488	110615488	harbor2	chr11	110446374	110446894	LINE/L2	1152	+	260	110446634	31146
chr11	110415488	110615488	harbor2	chr11	110447469	110447950	LINE/L2	1152	+	240	110447709	32221
chr11	110415488	110615488	harbor2	chr11	110492419	110492747	LINE/L2	470	+	164	110492583	77095
chr11	110415488	110615488	harbor2	chr11	110511720	110511919	LINE/L2	426	+	100	110511820	96332
chr11	110415488	110615488	harbor2	chr11	110512424	110512896	LINE/L2	455	+	236	110512660	97172
chr11	110415488	110615488	harbor2	chr11	110477252	110477369	LINE/L2	375	+	58	110477310	61822
chr11	98898419	99098419	harbor2	chr11	98950332	98950557	LINE/L2	666	+	112	98950444	52025
chr11	98898419	99098419	harbor2	chr11	98951514	98951612	LINE/L2	657	+	49	98951563	53144
chr11	98898419	99098419	harbor2	chr11	98951639	98952221	LINE/L2	943	+	291	98951930	53511
chr11	42563328	42763328	harbor2	chr11	42613302	42614075	LINE/L2	2789	+	386	42613688	50360
chr11	42563328	42763328	harbor2	chr11	42645023	42645336	LINE/L2	403	+	156	42645179	81851
chr11	42563328	42763328	harbor2	chr11	42614377	42615014	LINE/L2	2789	+	318	42614695	51367
chr11	59552895	59752895	harbor2	chr11	59603365	59603529	LINE/L2	447	+	82	59603447	50552
chr11	59552895	59752895	harbor2	chr11	59603819	59604015	LINE/L2	447	+	98	59603917	51022
chr11	59552895	59752895	harbor2	chr11	59627511	59627991	LINE/L2	527	+	240	59627751	74856
chr11	89703046	89903046	harbor2	chr11	89802360	89802566	LINE/L2	596	+	103	89802463	99417
chr11	89703046	89903046	harbor2	chr11	89802642	89803014	LINE/L2	596	+	186	89802828	99782
chr11	123672640	123872640	harbor2	chr11	123675862	123676307	LINE/L2	510	+	222	123676084	3444
chr11	123672640	123872640	harbor2	chr11	123713714	123714651	LINE/L2	1377	+	468	123714182	41542
chr11	123672640	123872640	harbor2	chr11	123734275	123734751	LINE/L2	531	+	238	123734513	61873
chr11	123672640	123872640	harbor2	chr11	123757140	123757532	LINE/L2	836	+	196	123757336	84696
chr11	123672640	123872640	harbor2	chr11	123757728	123758104	LINE/L2	836	+	188	123757916	85276
chr11	35068434	35268434	harbor2	chr11	35080744	35081174	LINE/L2	532	+	215	35080959	12525
chr11	35068434	35268434	harbor2	chr11	35081637	35081799	LINE/L2	453	+	81	35081718	13284
chr11	35068434	35268434	harbor2	chr11	35131279	35131496	LINE/L2	700	+	108	35131387	62953
chr11	132519723	132719723	harbor2	chr11	132540233	132540388	LINE/L2	390	+	78	132540311	20588
chr11	132519723	132719723	harbor2	chr11	132603155	132603776	LINE/L2	806	+	310	132603465	83742
chr11	132519723	132719723	harbor2	chr11	132608906	132609178	LINE/L2	451	+	136	132609042	89319
chr11	132519723	132719723	harbor2	chr11	132609422	132609907	LINE/L2	429	+	242	132609664	89941
chr11	132519723	132719723	harbor2	chr11	132611292	132611634	LINE/L2	424	+	171	132611463	91740
chr11	132519723	132719723	harbor2	chr11	132619001	132619455	LINE/L2	401	+	227	132619228	99505
chr11	26724293	26924293	harbor2	chr11	26726545	26726797	LINE/L2	726	+	126	26726671	2378
chr11	26724293	26924293	harbor2	chr11	26771402	26772164	LINE/L2	511	+	381	26771783	47490
chr11	26724293	26924293	harbor2	chr11	26803456	26804436	LINE/L2	846	+	490	26803946	79653
chr11	132603948	132803948	harbor2	chr11	132608906	132609178	LINE/L2	451	+	136	132609042	5094
chr11	132603948	132803948	harbor2	chr11	132609422	132609907	LINE/L2	429	+	242	132609664	5716
chr11	132603948	132803948	harbor2	chr11	132611292	132611634	LINE/L2	424	+	171	132611463	7515
chr11	132603948	132803948	harbor2	chr11	132619001	132619455	LINE/L2	401	+	227	132619228	15280
chr11	117884533	118084533	harbor2	chr11	117888598	117888927	LINE/L2	472	+	164	117888762	4229
chr11	117884533	118084533	harbor2	chr11	117912622	117912880	LINE/L2	480	+	129	117912751	28218
chr11	117884533	118084533	harbor2	chr11	117971021	117971375	LINE/L2	475	+	177	117971198	86665
chr11	117884533	118084533	harbor2	chr11	117972223	117972422	LINE/L2	920	+	100	117972323	87790
chr11	117884533	118084533	harbor2	chr11	117972559	117972833	LINE/L2	920	+	137	117972696	88163
chr11	117884533	118084533	harbor2	chr11	117981702	117982075	LINE/L2	853	+	186	117981888	97355
chr11	121965504	122165504	harbor2	chr11	122008904	122009089	LINE/L2	421	+	92	122008996	43492
chr11	129851915	130051915	harbor2	chr11	129865290	129865501	LINE/L2	473	+	106	129865396	13481
chr11	129851915	130051915	harbor2	chr11	129870739	129870995	LINE/L2	584	+	128	129870867	18952
chr11	129851915	130051915	harbor2	chr11	129871486	129872301	LINE/L2	1008	+	408	129871894	19979
chr11	129851915	130051915	harbor2	chr11	129879456	129879905	LINE/L2	436	+	224	129879680	27765
chr11	129851915	130051915	harbor2	chr11	129880215	129880398	LINE/L2	436	+	92	129880307	28392
chr11	129851915	130051915	harbor2	chr11	129880489	129880823	LINE/L2	386	+	167	129880656	28741
chr11	129851915	130051915	harbor2	chr11	129933796	129934374	LINE/L2	1339	+	289	129934085	82170
chr11	129851915	130051915	harbor2	chr11	129934404	129934706	LINE/L2	475	+	151	129934555	82640
chr11	129851915	130051915	harbor2	chr11	129938060	129938634	LINE/L2	936	+	287	129938347	86432
chr11	129851915	130051915	harbor2	chr11	129938737	129938958	LINE/L2	936	+	110	129938847	86932
chr11	100487827	100687827	harbor2	chr11	100538383	100538525	LINE/L2	504	+	71	100538454	50627
chr11	100487827	100687827	harbor2	chr11	100540861	100541528	LINE/L2	505	+	334	100541195	53368
chr11	100487827	100687827	harbor2	chr11	100582445	100583023	LINE/L2	567	+	289	100582734	94907
chr11	100487827	100687827	harbor2	chr11	100584092	100584924	LINE/L2	581	+	416	100584508	96681
chr11	108283173	108483173	harbor2	chr11	108306954	108307129	LINE/L2	585	+	88	108307042	23869
chr11	108283173	108483173	harbor2	chr11	108307448	108307654	LINE/L2	585	+	103	108307551	24378
chr11	108283173	108483173	harbor2	chr11	108312870	108313633	LINE/L2	722	+	382	108313252	30079
chr11	108283173	108483173	harbor2	chr11	108319271	108319719	LINE/L2	730	+	224	108319495	36322
chr11	108283173	108483173	harbor2	chr11	108340460	108340698	LINE/L2	389	+	119	108340579	57406
chr11	108283173	108483173	harbor2	chr11	108341006	108341550	LINE/L2	699	+	272	108341278	58105
chr11	118166450	118366450	harbor2	chr11	118203972	118204849	LINE/L2	2269	+	438	118204410	37960
chr11	118166450	118366450	harbor2	chr11	118230537	118230938	LINE/L2	1339	+	200	118230737	64287
chr11	118166450	118366450	harbor2	chr11	118230941	118231439	LINE/L2	470	+	249	118231190	64740
chr11	118166450	118366450	harbor2	chr11	118231478	118232590	LINE/L2	2994	+	556	118232034	65584
chr11	118166450	118366450	harbor2	chr11	118243787	118244003	LINE/L2	398	+	108	118243895	77445
chr11	118166450	118366450	harbor2	chr11	118243159	118243486	LINE/L2	398	+	164	118243323	76873
chr11	120305102	120505102	harbor2	chr11	120373449	120373542	LINE/L2	577	+	46	120373495	68393
chr11	120305102	120505102	harbor2	chr11	120391996	120392503	LINE/L2	736	+	254	120392250	87148
chr11	126023267	126223267	harbor2	chr11	126040279	126040401	LINE/L2	410	+	61	126040340	17073
chr11	79507506	79707506	harbor2	chr11	79584597	79584861	LINE/L2	499	+	132	79584729	77223
chr11	79507506	79707506	harbor2	chr11	79598357	79598836	LINE/L2	469	+	240	79598597	91091
chr11	128139939	128339939	harbor2	chr11	128184974	128185070	LINE/L2	452	+	48	128185022	45083
chr11	128139939	128339939	harbor2	chr11	128185436	128185751	LINE/L2	452	+	158	128185594	45655
chr11	128139939	128339939	harbor2	chr11	128192716	128193235	LINE/L2	984	+	260	128192976	53037
chr11	115428779	115628779	harbor2	chr11	115431268	115431901	LINE/L2	499	+	316	115431584	2805
chr11	115428779	115628779	harbor2	chr11	115440264	115440449	LINE/L2	413	+	92	115440356	11577
chr11	115428779	115628779	harbor2	chr11	115481986	115482428	LINE/L2	807	+	221	115482207	53428
chr11	115428779	115628779	harbor2	chr11	115485798	115486195	LINE/L2	449	+	198	115485996	57217
chr11	130205421	130405421	harbor2	chr11	130260221	130260589	LINE/L2	399	+	184	130260405	54984
chr11	40442666	40642666	harbor2	chr11	40503306	40503386	LINE/L2	401	+	40	40503346	60680
chr11	40442666	40642666	harbor2	chr11	40536571	40537052	LINE/L2	1147	+	240	40536811	94145
chr11	130089308	130289308	harbor2	chr11	130112886	130113209	LINE/L2	431	+	162	130113048	23740
chr11	61316367	61516367	harbor2	chr11	61339506	61339974	LINE/L2	577	+	234	61339740	23373
chr11	61316367	61516367	harbor2	chr11	61340654	61341067	LINE/L2	601	+	206	61340860	24493
chr11	90324150	90524150	harbor2	chr11	90329562	90329782	LINE/L2	377	+	110	90329672	5522
chr11	90324150	90524150	harbor2	chr11	90362442	90362799	LINE/L2	626	+	178	90362620	38470
chr11	90324150	90524150	harbor2	chr11	90394191	90394499	LINE/L2	411	+	154	90394345	70195
chr11	37025451	37225451	harbor2	chr11	37029495	37029747	LINE/L2	416	+	126	37029621	4170
chr11	37025451	37225451	harbor2	chr11	37042269	37042478	LINE/L2	409	+	104	37042373	16922
chr11	37025451	37225451	harbor2	chr11	37103832	37104455	LINE/L2	1234	+	312	37104144	78693
chr11	37025451	37225451	harbor2	chr11	37124445	37124832	LINE/L2	534	+	194	37124639	99188
chr11	133340514	133540514	harbor2	chr11	133340846	133341192	LINE/L2	492	+	173	133341019	505
chr11	133340514	133540514	harbor2	chr11	133351232	133352385	LINE/L2	1149	+	576	133351808	11294
chr11	106366919	106566919	harbor2	chr11	106384719	106384875	LINE/L2	400	+	78	106384797	17878
chr11	106366919	106566919	harbor2	chr11	106408801	106408984	LINE/L2	407	+	92	106408893	41974
chr11	106366919	106566919	harbor2	chr11	106464322	106464494	LINE/L2	407	+	86	106464408	97489
chr11	102516293	102716293	harbor2	chr11	102571607	102572585	LINE/L2	1654	+	489	102572096	55803
chr11	102516293	102716293	harbor2	chr11	102582921	102583162	LINE/L2	463	+	120	102583041	66748
chr11	102516293	102716293	harbor2	chr11	102588926	102589480	LINE/L2	505	+	277	102589203	72910
chr11	102516293	102716293	harbor2	chr11	102613331	102613448	LINE/L2	396	+	58	102613389	97096
chr11	58925397	59125397	harbor2	chr11	58967171	58967593	LINE/L2	1232	+	211	58967382	41985
chr11	121460603	121660603	harbor2	chr11	121462247	121462576	LINE/L2	520	+	164	121462411	1808
chr11	121460603	121660603	harbor2	chr11	121462872	121462943	LINE/L2	520	+	36	121462908	2305
chr11	121460603	121660603	harbor2	chr11	121491458	121491901	LINE/L2	1120	+	222	121491680	31077
chr11	121460603	121660603	harbor2	chr11	121491888	121492078	LINE/L2	941	+	95	121491983	31380
chr11	121460603	121660603	harbor2	chr11	121492385	121492608	LINE/L2	941	+	112	121492497	31894
chr11	121460603	121660603	harbor2	chr11	121523218	121523332	LINE/L2	391	+	57	121523275	62672
chr11	78064651	78264651	harbor2	chr11	78095858	78095986	LINE/L2	390	+	64	78095922	31271
chr11	78064651	78264651	harbor2	chr11	78110535	78110650	LINE/L2	397	+	58	78110593	45942
chr11	78064651	78264651	harbor2	chr11	78132284	78132833	LINE/L2	498	+	274	78132558	67907
chr11	78064651	78264651	harbor2	chr11	78133135	78133325	LINE/L2	498	+	95	78133230	68579
chr11	78064651	78264651	harbor2	chr11	78138793	78139208	LINE/L2	438	+	208	78139001	74350
chr11	78064651	78264651	harbor2	chr11	78143941	78144337	LINE/L2	632	+	198	78144139	79488
chr11	95268107	95468107	harbor2	chr11	95269485	95269588	LINE/L2	494	+	52	95269537	1430
chr11	95268107	95468107	harbor2	chr11	95271361	95271711	LINE/L2	516	+	175	95271536	3429
chr11	95268107	95468107	harbor2	chr11	95275424	95275573	LINE/L2	541	+	74	95275498	7391
chr11	95268107	95468107	harbor2	chr11	95286465	95286552	LINE/L2	390	+	44	95286509	18402
chr11	95268107	95468107	harbor2	chr11	95292214	95292629	LINE/L2	461	+	208	95292422	24315
chr11	95268107	95468107	harbor2	chr11	95325726	95325891	LINE/L2	500	+	82	95325808	57701
chr11	95268107	95468107	harbor2	chr11	95340752	95341092	LINE/L2	699	+	170	95340922	72815
chr11	95268107	95468107	harbor2	chr11	95361413	95361563	LINE/L2	404	+	75	95361488	93381
chr11	95942367	96142367	harbor2	chr11	95955344	95955662	LINE/L2	870	+	159	95955503	13136
chr11	95942367	96142367	harbor2	chr11	96001717	96002251	LINE/L2	1089	+	267	96001984	59617
chr11	95942367	96142367	harbor2	chr11	96021086	96021330	LINE/L2	576	+	122	96021208	78841
chr11	95942367	96142367	harbor2	chr11	96028223	96028632	LINE/L2	673	+	204	96028427	86060
chr11	95942367	96142367	harbor2	chr11	96033476	96033595	LINE/L2	392	+	60	96033536	91169
chr11	95942367	96142367	harbor2	chr11	96038578	96038940	LINE/L2	700	+	181	96038759	96392
chr11	100080912	100280912	harbor2	chr11	100090874	100091417	LINE/L2	612	+	272	100091146	10234
chr11	100080912	100280912	harbor2	chr11	100091727	100091859	LINE/L2	612	+	66	100091793	10881
chr11	100080912	100280912	harbor2	chr11	100128016	100128367	LINE/L2	788	+	176	100128192	47280
chr11	100080912	100280912	harbor2	chr11	100177226	100177490	LINE/L2	484	+	132	100177358	96446
chr11	94883562	95083562	harbor2	chr11	94898476	94898735	LINE/L2	492	+	130	94898606	15044
chr11	94883562	95083562	harbor2	chr11	94940387	94940551	LINE/L2	395	+	82	94940469	56907
chr11	94883562	95083562	harbor2	chr11	94940557	94940899	LINE/L2	532	+	171	94940728	57166
chr11	94883562	95083562	harbor2	chr11	94964811	94964984	LINE/L2	562	+	86	94964897	81335
chr11	94883562	95083562	harbor2	chr11	94974578	94975336	LINE/L2	1144	+	379	94974957	91395
chr11	94883562	95083562	harbor2	chr11	94975635	94975773	LINE/L2	772	+	69	94975704	92142
chr11	94883562	95083562	harbor2	chr11	94976124	94976653	LINE/L2	601	+	264	94976388	92826
chr11	94883562	95083562	harbor2	chr11	94977304	94977877	LINE/L2	784	+	286	94977590	94028
chr11	133615248	133815248	harbor2	chr11	133622373	133623077	LINE/L2	418	+	352	133622725	7477
chr11	133615248	133815248	harbor2	chr11	133657272	133657440	LINE/L2	501	+	84	133657356	42108
chr11	133615248	133815248	harbor2	chr11	133674755	133675217	LINE/L2	905	+	231	133674986	59738
chr11	133615248	133815248	harbor2	chr11	133699140	133699576	LINE/L2	721	+	218	133699358	84110
chr11	133615248	133815248	harbor2	chr11	133708495	133711394	LINE/L2	4231	+	1450	133709945	94697
chr11	133967710	134167710	harbor2	chr11	133990488	133990903	LINE/L2	529	+	208	133990696	22986
chr11	133967710	134167710	harbor2	chr11	133997046	133997283	LINE/L2	724	+	118	133997164	29454
chr11	133967710	134167710	harbor2	chr11	133997321	133997485	LINE/L2	724	+	82	133997403	29693
chr11	13320805	13520805	harbor2	chr11	13323276	13323624	LINE/L2	1033	+	174	13323450	2645
chr11	13320805	13520805	harbor2	chr11	13324043	13324776	LINE/L2	1033	+	366	13324409	3604
chr11	13320805	13520805	harbor2	chr11	13339267	13339430	LINE/L2	657	+	82	13339349	18544
chr11	13320805	13520805	harbor2	chr11	13339458	13339972	LINE/L2	657	+	257	13339715	18910
chr11	13320805	13520805	harbor2	chr11	13370063	13370825	LINE/L2	713	+	381	13370444	49639
chr11	13320805	13520805	harbor2	chr11	13377133	13378098	LINE/L2	670	+	482	13377615	56810
chr11	13320805	13520805	harbor2	chr11	13391029	13391606	LINE/L2	382	+	288	13391317	70512
chr11	13320805	13520805	harbor2	chr11	13401860	13402073	LINE/L2	448	+	106	13401966	81161
chr11	13320805	13520805	harbor2	chr11	13407271	13407481	LINE/L2	594	+	105	13407376	86571
chr11	13320805	13520805	harbor2	chr11	13408460	13409486	LINE/L2	1940	+	513	13408973	88168
chr11	13320805	13520805	harbor2	chr11	13409494	13409856	LINE/L2	541	+	181	13409675	88870
chr11	54653570	54853570	harbor2	chr11	54659224	54659572	LINE/L2	521	+	174	54659398	5828
chr11	116678321	116878321	harbor2	chr11	116685608	116685940	LINE/L2	680	+	166	116685774	7453
chr11	116678321	116878321	harbor2	chr11	116698958	116699078	LINE/L2	607	+	60	116699018	20697
chr11	116678321	116878321	harbor2	chr11	116722984	116723389	LINE/L2	602	+	202	116723186	44865
chr11	116678321	116878321	harbor2	chr11	116750596	116751288	LINE/L2	584	+	346	116750942	72621
chr11	116678321	116878321	harbor2	chr11	116770294	116770491	LINE/L2	485	+	98	116770392	92071
chr11	116678321	116878321	harbor2	chr11	116771067	116771412	LINE/L2	485	+	172	116771239	92918
chr11	116678321	116878321	harbor2	chr11	116777969	116778324	LINE/L2	1020	+	178	116778147	99826
chr11	116678321	116878321	harbor2	chr11	116719449	116719623	LINE/L2	407	+	87	116719536	41215
chr11	129635173	129835173	harbor2	chr11	129637693	129637961	LINE/L2	557	+	134	129637827	2654
chr11	129635173	129835173	harbor2	chr11	129638043	129638369	LINE/L2	578	+	163	129638206	3033
chr11	129635173	129835173	harbor2	chr11	129691935	129692473	LINE/L2	389	+	269	129692204	57031
chr11	129635173	129835173	harbor2	chr11	129728154	129728286	LINE/L2	429	+	66	129728220	93047
chr11	129635173	129835173	harbor2	chr11	129732543	129732684	LINE/L2	435	+	70	129732613	97440
chr11	91599682	91799682	harbor2	chr11	91646839	91647295	LINE/L2	899	+	228	91647067	47385
chr11	91599682	91799682	harbor2	chr11	91647485	91647747	LINE/L2	899	+	131	91647616	47934
chr11	91599682	91799682	harbor2	chr11	91689264	91690059	LINE/L2	921	+	398	91689662	89980
chr11	123420345	123620345	harbor2	chr11	123455680	123455884	LINE/L2	492	+	102	123455782	35437
chr11	123420345	123620345	harbor2	chr11	123471301	123471426	LINE/L2	502	+	62	123471363	51018
chr11	123420345	123620345	harbor2	chr11	123514798	123514989	LINE/L2	631	+	96	123514894	94549
chr11	84433158	84633158	harbor2	chr11	84456488	84456871	LINE/L2	607	+	192	84456680	23522
chr11	84433158	84633158	harbor2	chr11	84495056	84495587	LINE/L2	509	+	266	84495322	62164
chr11	84433158	84633158	harbor2	chr11	84508010	84508400	LINE/L2	859	+	195	84508205	75047
chr11	84433158	84633158	harbor2	chr11	84508700	84508905	LINE/L2	859	+	102	84508802	75644
chr11	112850025	113050025	harbor2	chr11	112872675	112873136	LINE/L2	479	+	230	112872905	22880
chr11	112850025	113050025	harbor2	chr11	112892858	112893069	LINE/L2	736	+	106	112892964	42939
chr11	112850025	113050025	harbor2	chr11	112893367	112893933	LINE/L2	736	+	283	112893650	43625
chr11	112850025	113050025	harbor2	chr11	112930126	112930307	LINE/L2	453	+	90	112930216	80191
chr11	112850025	113050025	harbor2	chr11	112930609	112930705	LINE/L2	453	+	48	112930657	80632
chr11	112850025	113050025	harbor2	chr11	112931519	112931677	LINE/L2	475	+	79	112931598	81573
chr11	134301432	134501432	harbor2	chr11	134326360	134326603	LINE/L2	1309	+	122	134326482	25050
chr11	134301432	134501432	harbor2	chr11	134326911	134328014	LINE/L2	1309	+	552	134327463	26031
chr11	134301432	134501432	harbor2	chr11	134328265	134328473	LINE/L2	803	+	104	134328369	26937
chr11	134301432	134501432	harbor2	chr11	134359400	134360049	LINE/L2	577	+	324	134359724	58292
chr11	134301432	134501432	harbor2	chr11	134377398	134378003	LINE/L2	737	+	302	134377700	76268
chr11	134301432	134501432	harbor2	chr11	134378192	134378465	LINE/L2	554	+	136	134378328	76896
chr11	133986799	134186799	harbor2	chr11	133990488	133990903	LINE/L2	529	+	208	133990696	3897
chr11	133986799	134186799	harbor2	chr11	133997046	133997283	LINE/L2	724	+	118	133997164	10365
chr11	133986799	134186799	harbor2	chr11	133997321	133997485	LINE/L2	724	+	82	133997403	10604
chr11	72272748	72472748	harbor2	chr11	72298848	72299613	LINE/L2	650	+	382	72299230	26482
chr11	72272748	72472748	harbor2	chr11	72319199	72319380	LINE/L2	394	+	90	72319289	46541
chr11	72272748	72472748	harbor2	chr11	72335504	72335799	LINE/L2	482	+	148	72335652	62904
chr11	72272748	72472748	harbor2	chr11	72352385	72352825	LINE/L2	614	+	220	72352605	79857
chr11	72272748	72472748	harbor2	chr11	72362088	72362447	LINE/L2	637	+	180	72362268	89520
chr11	130087869	130287869	harbor2	chr11	130112886	130113209	LINE/L2	431	+	162	130113048	25179
chr11	118051190	118251190	harbor2	chr11	118116503	118116666	LINE/L2	604	+	82	118116585	65395
chr11	118051190	118251190	harbor2	chr11	118141867	118142690	LINE/L2	1251	+	412	118142279	91089
chr11	72463493	72663493	harbor2	chr11	72552706	72553157	LINE/L2	388	+	226	72552932	89439
chr11	66026136	66226136	harbor2	chr11	66063264	66063381	LINE/L2	508	+	58	66063322	37186
chr11	66026136	66226136	harbor2	chr11	66104807	66104949	LINE/L2	473	+	71	66104878	78742
chr11	66026136	66226136	harbor2	chr11	66107081	66107592	LINE/L2	1212	+	256	66107337	81201
chr11	66026136	66226136	harbor2	chr11	66111424	66111644	LINE/L2	1296	+	110	66111534	85398
chr11	66026136	66226136	harbor2	chr11	66111945	66112666	LINE/L2	1059	+	360	66112305	86169
chr11	106075382	106275382	harbor2	chr11	106105491	106106320	LINE/L2	1541	+	414	106105905	30523
chr11	106075382	106275382	harbor2	chr11	106107549	106108026	LINE/L2	1541	+	238	106107787	32405
chr11	106075382	106275382	harbor2	chr11	106113090	106113565	LINE/L2	1549	+	238	106113328	37946
chr11	106075382	106275382	harbor2	chr11	106114019	106114774	LINE/L2	2325	+	378	106114397	39015
chr11	106075382	106275382	harbor2	chr11	106118070	106118547	LINE/L2	1375	+	238	106118308	42926
chr11	106075382	106275382	harbor2	chr11	106120506	106120658	LINE/L2	410	+	76	106120582	45200
chr11	106075382	106275382	harbor2	chr11	106141428	106141738	LINE/L2	684	+	155	106141583	66201
chr11	106075382	106275382	harbor2	chr11	106146984	106147108	LINE/L2	412	+	62	106147046	71664
chr11	106075382	106275382	harbor2	chr11	106168827	106169153	LINE/L2	505	+	163	106168990	93608
chr11	106075382	106275382	harbor2	chr11	106169467	106169624	LINE/L2	505	+	78	106169545	94163
chr11	121108420	121308420	harbor2	chr11	121123306	121123666	LINE/L2	555	+	180	121123486	15066
chr11	121108420	121308420	harbor2	chr11	121123667	121124294	LINE/L2	1364	+	314	121123981	15561
chr11	121108420	121308420	harbor2	chr11	121124291	121124739	LINE/L2	677	+	224	121124515	16095
chr11	121108420	121308420	harbor2	chr11	121143213	121143678	LINE/L2	690	+	232	121143445	35025
chr11	113629346	113829346	harbor2	chr11	113652885	113653734	LINE/L2	842	+	424	113653309	23963
chr11	113629346	113829346	harbor2	chr11	113721770	113722216	LINE/L2	428	+	223	113721993	92647
chr11	118165776	118365776	harbor2	chr11	118203972	118204849	LINE/L2	2269	+	438	118204410	38634
chr11	118165776	118365776	harbor2	chr11	118230537	118230938	LINE/L2	1339	+	200	118230737	64961
chr11	118165776	118365776	harbor2	chr11	118230941	118231439	LINE/L2	470	+	249	118231190	65414
chr11	118165776	118365776	harbor2	chr11	118231478	118232590	LINE/L2	2994	+	556	118232034	66258
chr11	118165776	118365776	harbor2	chr11	118243787	118244003	LINE/L2	398	+	108	118243895	78119
chr11	118165776	118365776	harbor2	chr11	118243159	118243486	LINE/L2	398	+	164	118243323	77547
chr11	134159015	134359015	harbor2	chr11	134228979	134229013	LINE/L2	486	+	17	134228996	69981
chr11	134159015	134359015	harbor2	chr11	134229317	134230303	LINE/L2	665	+	493	134229810	70795
chr11	128279504	128479504	harbor2	chr11	128286564	128286690	LINE/L2	397	+	63	128286627	7123
chr11	128279504	128479504	harbor2	chr11	128309552	128309667	LINE/L2	436	+	58	128309610	30106
chr11	128279504	128479504	harbor2	chr11	128312701	128312988	LINE/L2	719	+	144	128312845	33341
chr11	94229243	94429243	harbor2	chr11	94256606	94256912	LINE/L2	635	+	153	94256759	27516
chr11	94229243	94429243	harbor2	chr11	94283403	94283733	LINE/L2	605	+	165	94283568	54325
chr11	94229243	94429243	harbor2	chr11	94316424	94316886	LINE/L2	1086	+	231	94316655	87412
chr11	117853044	118053044	harbor2	chr11	117888598	117888927	LINE/L2	472	+	164	117888762	35718
chr11	117853044	118053044	harbor2	chr11	117912622	117912880	LINE/L2	480	+	129	117912751	59707
chr11	87279615	87479615	harbor2	chr11	87291047	87291515	LINE/L2	1527	+	234	87291281	11666
chr11	87279615	87479615	harbor2	chr11	87291843	87292432	LINE/L2	1527	+	294	87292137	12522
chr11	87279615	87479615	harbor2	chr11	87307844	87308249	LINE/L2	482	+	202	87308046	28431
chr11	87279615	87479615	harbor2	chr11	87346673	87346740	LINE/L2	552	+	34	87346707	67092
chr11	87279615	87479615	harbor2	chr11	87347043	87347239	LINE/L2	552	+	98	87347141	67526
chr11	87279615	87479615	harbor2	chr11	87370320	87370438	LINE/L2	448	+	59	87370379	90764
chr11	87279615	87479615	harbor2	chr11	87370746	87370821	LINE/L2	448	+	38	87370784	91169
chr11	92857148	93057148	harbor2	chr11	92912230	92912471	LINE/L2	743	+	120	92912350	55202
chr11	92857148	93057148	harbor2	chr11	92934875	92935173	LINE/L2	451	+	149	92935024	77876
chr11	92857148	93057148	harbor2	chr11	92935192	92935312	LINE/L2	419	+	60	92935252	78104
chr11	129335746	129535746	harbor2	chr11	129360462	129360848	LINE/L2	889	+	193	129360655	24909
chr11	129335746	129535746	harbor2	chr11	129362395	129363014	LINE/L2	835	+	310	129362705	26959
chr11	129335746	129535746	harbor2	chr11	129432856	129433992	LINE/L2	1465	+	568	129433424	97678
chr11	95053867	95253867	harbor2	chr11	95093194	95093662	LINE/L2	664	+	234	95093428	39561
chr11	122825604	123025604	harbor2	chr11	122898792	122899245	LINE/L2	684	+	226	122899018	73414
chr11	122825604	123025604	harbor2	chr11	122913414	122913879	LINE/L2	384	+	232	122913646	88042
chr11	86541039	86741039	harbor2	chr11	86581609	86582254	LINE/L2	471	+	322	86581931	40892
chr11	86541039	86741039	harbor2	chr11	86589213	86589335	LINE/L2	467	+	61	86589274	48235
chr11	111201435	111401435	harbor2	chr11	111205634	111205745	LINE/L2	374	+	56	111205690	4255
chr11	111201435	111401435	harbor2	chr11	111253482	111254140	LINE/L2	384	+	329	111253811	52376
chr11	107209862	107409862	harbor2	chr11	107214957	107215124	LINE/L2	409	+	84	107215041	5179
chr11	107209862	107409862	harbor2	chr11	107238236	107238420	LINE/L2	416	+	92	107238328	28466
chr11	107209862	107409862	harbor2	chr11	107238784	107239465	LINE/L2	416	+	340	107239124	29262
chr11	40026292	40226292	harbor2	chr11	40073586	40073951	LINE/L2	785	+	182	40073768	47476
chr11	40026292	40226292	harbor2	chr11	40119368	40119600	LINE/L2	409	+	116	40119484	93192
chr11	133316121	133516121	harbor2	chr11	133340846	133341192	LINE/L2	492	+	173	133341019	24898
chr11	133316121	133516121	harbor2	chr11	133351232	133352385	LINE/L2	1149	+	576	133351808	35687
chr11	22184829	22384829	harbor2	chr11	22215389	22215675	LINE/L2	953	+	143	22215532	30703
chr11	22184829	22384829	harbor2	chr11	22221593	22221781	LINE/L2	445	+	94	22221687	36858
chr11	22184829	22384829	harbor2	chr11	22221905	22223152	LINE/L2	3571	+	624	22222529	37700
chr11	22184829	22384829	harbor2	chr11	22223705	22223889	LINE/L2	3571	+	92	22223797	38968
chr11	22184829	22384829	harbor2	chr11	22230713	22231110	LINE/L2	508	+	198	22230911	46082
chr11	22184829	22384829	harbor2	chr11	22252950	22253081	LINE/L2	386	+	66	22253016	68187
chr11	129617131	129817131	harbor2	chr11	129618537	129618658	LINE/L2	413	+	60	129618597	1466
chr11	129617131	129817131	harbor2	chr11	129637693	129637961	LINE/L2	557	+	134	129637827	20696
chr11	129617131	129817131	harbor2	chr11	129638043	129638369	LINE/L2	578	+	163	129638206	21075
chr11	129617131	129817131	harbor2	chr11	129691935	129692473	LINE/L2	389	+	269	129692204	75073
chr11	85271180	85471180	harbor2	chr11	85304847	85305055	LINE/L2	660	+	104	85304951	33771
chr11	85271180	85471180	harbor2	chr11	85322027	85322597	LINE/L2	562	+	285	85322312	51132
chr11	85271180	85471180	harbor2	chr11	85322711	85323113	LINE/L2	595	+	201	85322912	51732
chr11	85271180	85471180	harbor2	chr11	85368344	85368584	LINE/L2	687	+	120	85368464	97284
chr11	106705018	106905018	harbor2	chr11	106727717	106728197	LINE/L2	380	+	240	106727957	22939
chr11	128108103	128308103	harbor2	chr11	128130372	128130508	LINE/L2	407	+	68	128130440	22337
chr11	128108103	128308103	harbor2	chr11	128184974	128185070	LINE/L2	452	+	48	128185022	76919
chr11	128108103	128308103	harbor2	chr11	128185436	128185751	LINE/L2	452	+	158	128185594	77491
chr11	128108103	128308103	harbor2	chr11	128192716	128193235	LINE/L2	984	+	260	128192976	84873
chr11	115099626	115299626	harbor2	chr11	115153102	115153522	LINE/L2	626	+	210	115153312	53686
chr11	115099626	115299626	harbor2	chr11	115186702	115187027	LINE/L2	408	+	162	115186864	87238
chr11	133904623	134104623	harbor2	chr11	133990488	133990903	LINE/L2	529	+	208	133990696	86073
chr11	133904623	134104623	harbor2	chr11	133997046	133997283	LINE/L2	724	+	118	133997164	92541
chr11	133904623	134104623	harbor2	chr11	133997321	133997485	LINE/L2	724	+	82	133997403	92780
chr11	133904623	134104623	harbor2	chr11	133939059	133939527	LINE/L2	977	+	234	133939293	34670
chr11	114390856	114590856	harbor2	chr11	114410645	114410967	LINE/L2	600	+	161	114410806	19950
chr11	126183424	126383424	harbor2	chr11	126218261	126218617	LINE/L2	1097	+	178	126218439	35015
chr11	41412398	41612398	harbor2	chr11	41478388	41478768	LINE/L2	790	+	190	41478578	66180
chr11	41412398	41612398	harbor2	chr11	41502752	41503156	LINE/L2	402	+	202	41502954	90556
chr11	76310129	76510129	harbor2	chr11	76371056	76371261	LINE/L2	380	+	102	76371158	61029
chr11	76310129	76510129	harbor2	chr11	76376987	76377236	LINE/L2	618	+	124	76377111	66982
chr11	76310129	76510129	harbor2	chr11	76379139	76379878	LINE/L2	1136	+	370	76379509	69380
chr11	65093760	65293760	harbor2	chr11	65118707	65118970	LINE/L2	463	+	132	65118839	25079
chr11	65093760	65293760	harbor2	chr11	65137342	65137550	LINE/L2	493	+	104	65137446	43686
chr11	65093760	65293760	harbor2	chr11	65188969	65189029	LINE/L2	906	+	30	65188999	95239
chr11	65093760	65293760	harbor2	chr11	65189321	65190427	LINE/L2	906	+	553	65189874	96114
chr11	96178268	96378268	harbor2	chr11	96227053	96227252	LINE/L2	410	+	100	96227153	48885
chr11	96178268	96378268	harbor2	chr11	96247525	96247910	LINE/L2	1201	+	192	96247717	69449
chr11	96178268	96378268	harbor2	chr11	96248535	96248853	LINE/L2	992	+	159	96248694	70426
chr11	96178268	96378268	harbor2	chr11	96249049	96250174	LINE/L2	2349	+	562	96249611	71343
chr11	96178268	96378268	harbor2	chr11	96255131	96255260	LINE/L2	458	+	64	96255195	76927
chr11	96178268	96378268	harbor2	chr11	96269811	96270315	LINE/L2	1815	+	252	96270063	91795
chr11	96178268	96378268	harbor2	chr11	96270609	96270758	LINE/L2	1815	+	74	96270683	92415
chr11	96178268	96378268	harbor2	chr11	96271788	96272297	LINE/L2	1599	+	254	96272042	93774
chr11	128940531	129140531	harbor2	chr11	129027149	129027932	LINE/L2	1233	+	392	129027541	87010
chr11	126418489	126618489	harbor2	chr11	126479777	126480064	LINE/L2	452	+	144	126479921	61432
chr11	126418489	126618489	harbor2	chr11	126483858	126484132	LINE/L2	475	+	137	126483995	65506
chr11	126418489	126618489	harbor2	chr11	126495826	126496014	LINE/L2	537	+	94	126495920	77431
chr11	126418489	126618489	harbor2	chr11	126504149	126504399	LINE/L2	664	+	125	126504274	85785
chr11	126418489	126618489	harbor2	chr11	126507390	126507669	LINE/L2	686	+	140	126507530	89041
chr11	126418489	126618489	harbor2	chr11	126516358	126516617	LINE/L2	742	+	130	126516488	97999
chr11	125651284	125851284	harbor2	chr11	125656637	125656781	LINE/L2	419	+	72	125656709	5425
chr11	125651284	125851284	harbor2	chr11	125686012	125686071	LINE/L2	571	+	30	125686042	34758
chr11	125651284	125851284	harbor2	chr11	125686498	125686687	LINE/L2	571	+	94	125686592	35308
chr11	133061478	133261478	harbor2	chr11	133114233	133114606	LINE/L2	752	+	186	133114419	52941
chr11	133061478	133261478	harbor2	chr11	133155220	133155950	LINE/L2	384	+	365	133155585	94107
chr11	108187439	108387439	harbor2	chr11	108224517	108224901	LINE/L2	440	+	192	108224709	37270
chr11	108187439	108387439	harbor2	chr11	108277838	108278035	LINE/L2	631	+	98	108277936	90497
chr11	101043426	101243426	harbor2	chr11	101059083	101059376	LINE/L2	433	+	146	101059229	15803
chr11	101043426	101243426	harbor2	chr11	101066132	101067248	LINE/L2	2407	+	558	101066690	23264
chr11	101043426	101243426	harbor2	chr11	101089459	101089651	LINE/L2	683	+	96	101089555	46129
chr11	117648754	117848754	harbor2	chr11	117731382	117731830	LINE/L2	543	+	224	117731606	82852
chr11	117648754	117848754	harbor2	chr11	117734428	117734777	LINE/L2	430	+	174	117734602	85848
chr11	117648754	117848754	harbor2	chr11	117746684	117746879	LINE/L2	524	+	98	117746782	98028
chr11	117648754	117848754	harbor2	chr11	117702360	117702660	LINE/L2	561	+	150	117702510	53756
chr11	106771742	106971742	harbor2	chr11	106833452	106833693	LINE/L2	541	+	120	106833572	61830
chr11	56809705	57009705	harbor2	chr11	56874606	56874937	LINE/L2	720	+	166	56874772	65067
chr11	56809705	57009705	harbor2	chr11	56852258	56853391	LINE/L2	2151	+	566	56852824	43119
chr11	130913332	131113332	harbor2	chr11	130945087	130945293	LINE/L2	410	+	103	130945190	31858
chr11	130913332	131113332	harbor2	chr11	130978428	130978781	LINE/L2	629	+	176	130978604	65272
chr11	130913332	131113332	harbor2	chr11	131007001	131007634	LINE/L2	1261	+	316	131007317	93985
chr11	130913332	131113332	harbor2	chr11	131007928	131008488	LINE/L2	1261	+	280	131008208	94876
chr11	74524261	74724261	harbor2	chr11	74562168	74562360	LINE/L2	537	+	96	74562264	38003
chr11	74524261	74724261	harbor2	chr11	74602283	74603192	LINE/L2	1699	+	454	74602737	78476
chr11	132351591	132551591	harbor2	chr11	132358566	132358930	LINE/L2	496	+	182	132358748	7157
chr11	132351591	132551591	harbor2	chr11	132367346	132367577	LINE/L2	458	+	116	132367462	15871
chr11	132351591	132551591	harbor2	chr11	132396570	132396926	LINE/L2	1315	+	178	132396748	45157
chr11	132351591	132551591	harbor2	chr11	132397230	132397929	LINE/L2	1315	+	350	132397580	45989
chr11	132351591	132551591	harbor2	chr11	132398078	132398290	LINE/L2	579	+	106	132398184	46593
chr11	132351591	132551591	harbor2	chr11	132432816	132432935	LINE/L2	397	+	60	132432876	81285
chr11	42340154	42540154	harbor2	chr11	42391614	42391945	LINE/L2	391	+	166	42391780	51626
chr11	131413767	131613767	harbor2	chr11	131427804	131428274	LINE/L2	470	+	235	131428039	14272
chr11	131413767	131613767	harbor2	chr11	131473811	131474874	LINE/L2	632	+	532	131474343	60576
chr11	131413767	131613767	harbor2	chr11	131499404	131499756	LINE/L2	613	+	176	131499580	85813
chr11	68987581	69187581	harbor2	chr11	69032900	69033052	LINE/L2	375	+	76	69032976	45395
chr11	110143754	110343754	harbor2	chr11	110216115	110216291	LINE/L2	427	+	88	110216203	72449
chr11	110143754	110343754	harbor2	chr11	110218669	110218895	LINE/L2	433	+	113	110218782	75028
chr11	19002533	19202533	harbor2	chr11	19090685	19091385	LINE/L2	559	+	350	19091035	88502
chr11	87481462	87681462	harbor2	chr11	87514279	87514535	LINE/L2	397	+	128	87514407	32945
chr11	87481462	87681462	harbor2	chr11	87556354	87556732	LINE/L2	404	+	189	87556543	75081
chr11	92115716	92315716	harbor2	chr11	92156514	92156629	LINE/L2	380	+	58	92156572	40856
chr11	92115716	92315716	harbor2	chr11	92192342	92192872	LINE/L2	517	+	265	92192607	76891
chr11	22006693	22206693	harbor2	chr11	22080771	22081101	LINE/L2	398	+	165	22080936	74243
chr11	22006693	22206693	harbor2	chr11	22081152	22081284	LINE/L2	434	+	66	22081218	74525
chr11	133861856	134061856	harbor2	chr11	133891948	133892952	LINE/L2	1269	+	502	133892450	30594
chr11	133861856	134061856	harbor2	chr11	133895972	133896288	LINE/L2	636	+	158	133896130	34274
chr11	133861856	134061856	harbor2	chr11	133939059	133939527	LINE/L2	977	+	234	133939293	77437
chr11	11183438	11383438	harbor2	chr11	11250078	11250302	LINE/L2	1173	+	112	11250190	66752
chr11	11183438	11383438	harbor2	chr11	11250351	11250496	LINE/L2	1173	+	72	11250423	66985
chr11	11183438	11383438	harbor2	chr11	11259557	11260295	LINE/L2	662	+	369	11259926	76488
chr11	11183438	11383438	harbor2	chr11	11260543	11260732	LINE/L2	584	+	94	11260637	77199
chr11	11183438	11383438	harbor2	chr11	11272243	11272741	LINE/L2	386	+	249	11272492	89054
chr11	124816573	125016573	harbor2	chr11	124822453	124822824	LINE/L2	867	+	186	124822639	6066
chr11	124816573	125016573	harbor2	chr11	124826387	124826765	LINE/L2	1220	+	189	124826576	10003
chr11	124816573	125016573	harbor2	chr11	124827070	124827349	LINE/L2	1220	+	140	124827210	10637
chr11	124816573	125016573	harbor2	chr11	124842136	124842391	LINE/L2	400	+	128	124842264	25691
chr11	124816573	125016573	harbor2	chr11	124853631	124854511	LINE/L2	6029	+	440	124854071	37498
chr11	124816573	125016573	harbor2	chr11	124854796	124855430	LINE/L2	6029	+	317	124855113	38540
chr11	124816573	125016573	harbor2	chr11	124855791	124856936	LINE/L2	6029	+	572	124856363	39790
chr11	119842945	120042945	harbor2	chr11	119861347	119861693	LINE/L2	771	+	173	119861520	18575
chr11	119842945	120042945	harbor2	chr11	119869619	119870535	LINE/L2	1005	+	458	119870077	27132
chr11	119842945	120042945	harbor2	chr11	119872394	119872805	LINE/L2	423	+	206	119872600	29655
chr11	119842945	120042945	harbor2	chr11	119884175	119884712	LINE/L2	1050	+	268	119884443	41498
chr11	119842945	120042945	harbor2	chr11	119884729	119884897	LINE/L2	501	+	84	119884813	41868
chr11	119842945	120042945	harbor2	chr11	119885173	119885237	LINE/L2	501	+	32	119885205	42260
chr11	119842945	120042945	harbor2	chr11	119885361	119885550	LINE/L2	658	+	94	119885455	42510
chr11	119842945	120042945	harbor2	chr11	119889085	119889215	LINE/L2	395	+	65	119889150	46205
chr11	119842945	120042945	harbor2	chr11	119901964	119902306	LINE/L2	472	+	171	119902135	59190
chr11	119842945	120042945	harbor2	chr11	119921797	119923502	LINE/L2	4301	+	852	119922649	79704
chr11	119842945	120042945	harbor2	chr11	119934198	119934808	LINE/L2	553	+	305	119934503	91558
chr11	124383607	124583607	harbor2	chr11	124414268	124414458	LINE/L2	381	+	95	124414363	30756
chr11	96396643	96596643	harbor2	chr11	96448198	96448853	LINE/L2	1479	+	328	96448526	51883
chr11	96396643	96596643	harbor2	chr11	96453550	96454079	LINE/L2	738	+	264	96453814	57171
chr11	117129464	117329464	harbor2	chr11	117135102	117135276	LINE/L2	387	+	87	117135189	5725
chr11	117129464	117329464	harbor2	chr11	117213018	117213265	LINE/L2	512	+	124	117213142	83678
chr11	82010381	82210381	harbor2	chr11	82036242	82036474	LINE/L2	419	+	116	82036358	25977
chr11	82010381	82210381	harbor2	chr11	82094131	82094539	LINE/L2	397	+	204	82094335	83954
chr11	82010381	82210381	harbor2	chr11	82094706	82094786	LINE/L2	397	+	40	82094746	84365
chr11	107042222	107242222	harbor2	chr11	107047200	107047520	LINE/L2	515	+	160	107047360	5138
chr11	107042222	107242222	harbor2	chr11	107047919	107048019	LINE/L2	431	+	50	107047969	5747
chr11	107042222	107242222	harbor2	chr11	107048330	107048851	LINE/L2	561	+	260	107048590	6368
chr11	107042222	107242222	harbor2	chr11	107062853	107063343	LINE/L2	873	+	245	107063098	20876
chr11	107042222	107242222	harbor2	chr11	107064422	107064960	LINE/L2	591	+	269	107064691	22469
chr11	107042222	107242222	harbor2	chr11	107112980	107113243	LINE/L2	854	+	132	107113112	70890
chr11	107042222	107242222	harbor2	chr11	107131563	107131889	LINE/L2	570	+	163	107131726	89504
chr11	45122909	45322909	harbor2	chr11	45133031	45133462	LINE/L2	699	+	216	45133247	10338
chr11	45122909	45322909	harbor2	chr11	45142111	45142532	LINE/L2	531	+	210	45142321	19412
chr11	45122909	45322909	harbor2	chr11	45148843	45149393	LINE/L2	905	+	275	45149118	26209
chr11	45122909	45322909	harbor2	chr11	45151950	45152066	LINE/L2	1019	+	58	45152008	29099
chr11	45122909	45322909	harbor2	chr11	45152367	45152618	LINE/L2	1019	+	126	45152493	29584
chr11	126992181	127192181	harbor2	chr11	127051385	127051539	LINE/L2	525	+	77	127051462	59281
chr11	126992181	127192181	harbor2	chr11	127051831	127052055	LINE/L2	525	+	112	127051943	59762
chr11	126992181	127192181	harbor2	chr11	127058619	127059048	LINE/L2	888	+	214	127058833	66652
chr11	127994744	128194744	harbor2	chr11	128059336	128059701	LINE/L2	412	+	182	128059518	64774
chr11	46179357	46379357	harbor2	chr11	46245384	46245674	LINE/L2	522	+	145	46245529	66172
chr11	46179357	46379357	harbor2	chr11	46261358	46261530	LINE/L2	646	+	86	46261444	82087
chr11	46179357	46379357	harbor2	chr11	46261828	46262208	LINE/L2	646	+	190	46262018	82661
chr11	46179357	46379357	harbor2	chr11	46263134	46263435	LINE/L2	850	+	150	46263284	83927
chr11	46179357	46379357	harbor2	chr11	46264053	46264293	LINE/L2	850	+	120	46264173	84816
chr11	46179357	46379357	harbor2	chr11	46266228	46266426	LINE/L2	419	+	99	46266327	86970
chr11	46179357	46379357	harbor2	chr11	46274957	46275347	LINE/L2	554	+	195	46275152	95795
chr11	43704576	43904576	harbor2	chr11	43717197	43717315	LINE/L2	475	+	59	43717256	12680
chr11	88788636	88988636	harbor2	chr11	88794143	88794416	LINE/L2	452	+	136	88794279	5643
chr11	88788636	88988636	harbor2	chr11	88806945	88807204	LINE/L2	395	+	130	88807075	18439
chr11	88788636	88988636	harbor2	chr11	88839648	88839685	LINE/L2	773	+	18	88839666	51030
chr11	88788636	88988636	harbor2	chr11	88842354	88842990	LINE/L2	773	+	318	88842672	54036
chr11	88788636	88988636	harbor2	chr11	88861226	88861475	LINE/L2	508	+	124	88861350	72714
chr11	88788636	88988636	harbor2	chr11	88861783	88861981	LINE/L2	508	+	99	88861882	73246
chr11	131937136	132137136	harbor2	chr11	131948596	131948823	LINE/L2	452	+	114	131948710	11574
chr11	131937136	132137136	harbor2	chr11	131949324	131949450	LINE/L2	452	+	63	131949387	12251
chr11	131937136	132137136	harbor2	chr11	131986561	131986826	LINE/L2	689	+	132	131986693	49557
chr11	65191509	65391509	harbor2	chr11	65264493	65264948	LINE/L2	2726	+	228	65264721	73212
chr11	65191509	65391509	harbor2	chr11	65265239	65265478	LINE/L2	2726	+	120	65265359	73850
chr11	65191509	65391509	harbor2	chr11	65265776	65266012	LINE/L2	2726	+	118	65265894	74385
chr11	65191509	65391509	harbor2	chr11	65266226	65266405	LINE/L2	666	+	90	65266316	74807
chr11	65191509	65391509	harbor2	chr11	65270470	65271098	LINE/L2	1129	+	314	65270784	79275
chr11	65191509	65391509	harbor2	chr11	65271077	65271266	LINE/L2	447	+	94	65271171	79662
chr11	112605671	112805671	harbor2	chr11	112656403	112656802	LINE/L2	374	+	200	112656603	50932
chr11	112605671	112805671	harbor2	chr11	112662526	112662660	LINE/L2	396	+	67	112662593	56922
chr11	112605671	112805671	harbor2	chr11	112691953	112692196	LINE/L2	446	+	122	112692075	86404
chr11	103665059	103865059	harbor2	chr11	103706145	103706246	LINE/L2	377	+	50	103706195	41136
chr11	103665059	103865059	harbor2	chr11	103749035	103749265	LINE/L2	561	+	115	103749150	84091
chr11	103665059	103865059	harbor2	chr11	103754742	103754907	LINE/L2	429	+	82	103754824	89765
chr11	79772948	79972948	harbor2	chr11	79800745	79801568	LINE/L2	676	+	412	79801157	28209
chr11	79772948	79972948	harbor2	chr11	79826947	79827063	LINE/L2	392	+	58	79827005	54057
chr11	79772948	79972948	harbor2	chr11	79833134	79833527	LINE/L2	502	+	196	79833330	60382
chr11	79772948	79972948	harbor2	chr11	79833571	79833905	LINE/L2	474	+	167	79833738	60790
chr11	61375550	61575550	harbor2	chr11	61456414	61457227	LINE/L2	937	+	406	61456820	81270
chr11	61375550	61575550	harbor2	chr11	61459967	61460093	LINE/L2	416	+	63	61460030	84480
chr12	109963141	110163141	harbor2	chr12	110060237	110060753	LINE/L2	1385	+	258	110060495	97354
chr12	109963141	110163141	harbor2	chr12	110061004	110061017	LINE/L2	1385	+	6	110061010	97869
chr12	109963141	110163141	harbor2	chr12	110061087	110061532	LINE/L2	1385	+	222	110061309	98168
chr12	120861620	121061620	harbor2	chr12	120909021	120909177	LINE/L2	661	+	78	120909099	47479
chr12	120861620	121061620	harbor2	chr12	120909486	120909789	LINE/L2	661	+	152	120909638	48018
chr12	120861620	121061620	harbor2	chr12	120936179	120936568	LINE/L2	518	+	194	120936373	74753
chr12	110156236	110356236	harbor2	chr12	110188541	110188642	LINE/L2	2892	+	50	110188591	32355
chr12	110156236	110356236	harbor2	chr12	110188943	110189336	LINE/L2	2892	+	196	110189139	32903
chr12	110156236	110356236	harbor2	chr12	110189649	110190597	LINE/L2	2892	+	474	110190123	33887
chr12	110156236	110356236	harbor2	chr12	110202928	110202983	LINE/L2	714	+	28	110202956	46720
chr12	110156236	110356236	harbor2	chr12	110203294	110203672	LINE/L2	714	+	189	110203483	47247
chr12	110156236	110356236	harbor2	chr12	110204253	110204947	LINE/L2	879	+	347	110204600	48364
chr12	102599169	102799169	harbor2	chr12	102629501	102629827	LINE/L2	567	+	163	102629664	30495
chr12	102599169	102799169	harbor2	chr12	102677742	102678270	LINE/L2	681	+	264	102678006	78837
chr12	102599169	102799169	harbor2	chr12	102678559	102678704	LINE/L2	486	+	72	102678631	79462
chr12	102599169	102799169	harbor2	chr12	102680734	102681126	LINE/L2	709	+	196	102680930	81761
chr12	123040621	123240621	harbor2	chr12	123044966	123045478	LINE/L2	1026	+	256	123045222	4601
chr12	123040621	123240621	harbor2	chr12	123087920	123088481	LINE/L2	773	+	280	123088200	47579
chr12	123040621	123240621	harbor2	chr12	123104231	123104299	LINE/L2	815	+	34	123104265	63644
chr12	123040621	123240621	harbor2	chr12	123104800	123105374	LINE/L2	815	+	287	123105087	64466
chr12	124026480	124226480	harbor2	chr12	124047877	124048178	LINE/L2	782	+	150	124048027	21547
chr12	73285478	73485478	harbor2	chr12	73380731	73380961	LINE/L2	1865	+	115	73380846	95368
chr12	73285478	73485478	harbor2	chr12	73381281	73382181	LINE/L2	1865	+	450	73381731	96253
chr12	106591788	106791788	harbor2	chr12	106600187	106600556	LINE/L2	529	+	184	106600371	8583
chr12	106591788	106791788	harbor2	chr12	106600614	106601067	LINE/L2	494	+	226	106600840	9052
chr12	106591788	106791788	harbor2	chr12	106634579	106635025	LINE/L2	459	+	223	106634802	43014
chr12	106591788	106791788	harbor2	chr12	106657997	106658133	LINE/L2	509	+	68	106658065	66277
chr12	106591788	106791788	harbor2	chr12	106673841	106674325	LINE/L2	1263	+	242	106674083	82295
chr12	106591788	106791788	harbor2	chr12	106674630	106674856	LINE/L2	1263	+	113	106674743	82955
chr12	30264568	30464568	harbor2	chr12	30317850	30317975	LINE/L2	493	+	62	30317912	53344
chr12	122197163	122397163	harbor2	chr12	122222152	122222320	LINE/L2	723	+	84	122222236	25073
chr12	122197163	122397163	harbor2	chr12	122222592	122222607	LINE/L2	1395	+	8	122222600	25437
chr12	122197163	122397163	harbor2	chr12	122222939	122223153	LINE/L2	1395	+	107	122223046	25883
chr12	122197163	122397163	harbor2	chr12	122223452	122223799	LINE/L2	1395	+	174	122223626	26463
chr12	122197163	122397163	harbor2	chr12	122224092	122224252	LINE/L2	998	+	80	122224172	27009
chr12	79751365	79951365	harbor2	chr12	79764116	79764403	LINE/L2	2286	+	144	79764260	12895
chr12	79751365	79951365	harbor2	chr12	79764707	79765665	LINE/L2	2286	+	479	79765186	13821
chr12	79751365	79951365	harbor2	chr12	79768519	79768800	LINE/L2	1021	+	140	79768659	17294
chr12	79751365	79951365	harbor2	chr12	79769038	79769201	LINE/L2	1021	+	82	79769120	17755
chr12	79751365	79951365	harbor2	chr12	79844213	79845065	LINE/L2	2151	+	426	79844639	93274
chr12	76683788	76883788	harbor2	chr12	76698331	76698815	LINE/L2	878	+	242	76698573	14785
chr12	76683788	76883788	harbor2	chr12	76704554	76705643	LINE/L2	2410	+	544	76705098	21310
chr12	76683788	76883788	harbor2	chr12	76709941	76710350	LINE/L2	727	+	204	76710145	26357
chr12	76683788	76883788	harbor2	chr12	76780356	76780764	LINE/L2	986	+	204	76780560	96772
chr12	76683788	76883788	harbor2	chr12	76709605	76709914	LINE/L2	704	+	154	76709759	25971
chr12	23859089	24059089	harbor2	chr12	23901459	23901802	LINE/L2	624	+	172	23901631	42542
chr12	23859089	24059089	harbor2	chr12	23930867	23931127	LINE/L2	476	+	130	23930997	71908
chr12	125956424	126156424	harbor2	chr12	125961218	125961353	LINE/L2	454	+	68	125961286	4862
chr12	125956424	126156424	harbor2	chr12	126000891	126001068	LINE/L2	453	+	88	126000979	44555
chr12	116640061	116840061	harbor2	chr12	116728168	116728413	LINE/L2	594	+	122	116728290	88229
chr12	77389379	77589379	harbor2	chr12	77444000	77444449	LINE/L2	452	+	224	77444224	54845
chr12	77389379	77589379	harbor2	chr12	77466521	77466875	LINE/L2	526	+	177	77466698	77319
chr12	77389379	77589379	harbor2	chr12	77475595	77475957	LINE/L2	450	+	181	77475776	86397
chr12	122750886	122950886	harbor2	chr12	122765987	122766717	LINE/L2	529	+	365	122766352	15466
chr12	122750886	122950886	harbor2	chr12	122766972	122767356	LINE/L2	922	+	192	122767164	16278
chr12	49479926	49679926	harbor2	chr12	49519258	49519814	LINE/L2	596	+	278	49519536	39610
chr12	49479926	49679926	harbor2	chr12	49571345	49571847	LINE/L2	666	+	251	49571596	91670
chr12	49479926	49679926	harbor2	chr12	49579325	49579876	LINE/L2	1237	+	276	49579601	99675
chr12	26621911	26821911	harbor2	chr12	26636125	26636466	LINE/L2	617	+	170	26636295	14384
chr12	26621911	26821911	harbor2	chr12	26685666	26686112	LINE/L2	933	+	223	26685889	63978
chr12	61415900	61615900	harbor2	chr12	61425473	61425845	LINE/L2	623	+	186	61425659	9759
chr12	54887212	55087212	harbor2	chr12	54952816	54953414	LINE/L2	475	+	299	54953115	65903
chr12	54887212	55087212	harbor2	chr12	54976919	54977269	LINE/L2	691	+	175	54977094	89882
chr12	60771286	60971286	harbor2	chr12	60813310	60814022	LINE/L2	589	+	356	60813666	42380
chr12	60771286	60971286	harbor2	chr12	60829054	60829779	LINE/L2	1095	+	362	60829416	58130
chr12	60771286	60971286	harbor2	chr12	60831965	60833383	LINE/L2	2560	+	709	60832674	61388
chr12	92883775	93083775	harbor2	chr12	92907129	92907590	LINE/L2	567	+	230	92907359	23584
chr12	92883775	93083775	harbor2	chr12	92931379	92931602	LINE/L2	529	+	112	92931491	47716
chr12	92883775	93083775	harbor2	chr12	92931901	92931990	LINE/L2	529	+	44	92931945	48170
chr12	92883775	93083775	harbor2	chr12	92932594	92933055	LINE/L2	1778	+	230	92932824	49049
chr12	92883775	93083775	harbor2	chr12	92933351	92934284	LINE/L2	1778	+	466	92933817	50042
chr12	92883775	93083775	harbor2	chr12	92946227	92946392	LINE/L2	480	+	82	92946309	62534
chr12	63087259	63287259	harbor2	chr12	63103537	63103642	LINE/L2	452	+	52	63103589	16330
chr12	63087259	63287259	harbor2	chr12	63104273	63105389	LINE/L2	3663	+	558	63104831	17572
chr12	63087259	63287259	harbor2	chr12	63105487	63106462	LINE/L2	3663	+	488	63105975	18716
chr12	63087259	63287259	harbor2	chr12	63137781	63138058	LINE/L2	551	+	138	63137919	50660
chr12	111938858	112138858	harbor2	chr12	112015787	112016222	LINE/L2	632	+	218	112016005	77147
chr12	111938858	112138858	harbor2	chr12	112021175	112021515	LINE/L2	998	+	170	112021345	82487
chr12	111938858	112138858	harbor2	chr12	112021826	112021905	LINE/L2	998	+	40	112021866	83008
chr12	80329699	80529699	harbor2	chr12	80348538	80348897	LINE/L2	637	+	180	80348718	19019
chr12	80329699	80529699	harbor2	chr12	80414821	80415910	LINE/L2	2062	+	544	80415365	85666
chr12	99107050	99307050	harbor2	chr12	99110886	99111157	LINE/L2	504	+	136	99111022	3972
chr12	99107050	99307050	harbor2	chr12	99130442	99131243	LINE/L2	470	+	400	99130842	23792
chr12	99107050	99307050	harbor2	chr12	99140777	99141406	LINE/L2	1247	+	314	99141091	34041
chr12	99107050	99307050	harbor2	chr12	99141852	99141918	LINE/L2	1247	+	33	99141885	34835
chr12	99107050	99307050	harbor2	chr12	99180038	99180410	LINE/L2	523	+	186	99180224	73174
chr12	99107050	99307050	harbor2	chr12	99197988	99198324	LINE/L2	445	+	168	99198156	91106
chr12	130842714	131042714	harbor2	chr12	130862349	130862631	LINE/L2	1045	+	141	130862490	19776
chr12	130842714	131042714	harbor2	chr12	130863219	130863392	LINE/L2	1045	+	86	130863305	20591
chr12	75768933	75968933	harbor2	chr12	75804341	75804540	LINE/L2	563	+	100	75804441	35508
chr12	75768933	75968933	harbor2	chr12	75825299	75826587	LINE/L2	807	+	644	75825943	57010
chr12	75768933	75968933	harbor2	chr12	75862412	75862606	LINE/L2	452	+	97	75862509	93576
chr12	75768933	75968933	harbor2	chr12	75867655	75867931	LINE/L2	508	+	138	75867793	98860
chr12	107776546	107976546	harbor2	chr12	107840174	107840458	LINE/L2	518	+	142	107840316	63770
chr12	93890624	94090624	harbor2	chr12	93908613	93908728	LINE/L2	492	+	58	93908671	18047
chr12	93890624	94090624	harbor2	chr12	93965931	93966455	LINE/L2	464	+	262	93966193	75569
chr12	93890624	94090624	harbor2	chr12	93976507	93976923	LINE/L2	529	+	208	93976715	86091
chr12	108005229	108205229	harbor2	chr12	108051486	108052022	LINE/L2	534	+	268	108051754	46525
chr12	108005229	108205229	harbor2	chr12	108086885	108087163	LINE/L2	523	+	139	108087024	81795
chr12	119383067	119583067	harbor2	chr12	119466035	119466404	LINE/L2	1185	+	184	119466219	83152
chr12	119383067	119583067	harbor2	chr12	119470711	119470965	LINE/L2	457	+	127	119470838	87771
chr12	119383067	119583067	harbor2	chr12	119476538	119476922	LINE/L2	584	+	192	119476730	93663
chr12	96941451	97141451	harbor2	chr12	97005725	97006083	LINE/L2	626	+	179	97005904	64453
chr12	102960457	103160457	harbor2	chr12	102963337	102963602	LINE/L2	481	+	132	102963469	3012
chr12	102960457	103160457	harbor2	chr12	103026974	103027635	LINE/L2	1338	+	330	103027304	66847
chr12	102960457	103160457	harbor2	chr12	103048645	103048922	LINE/L2	697	+	138	103048783	88326
chr12	102960457	103160457	harbor2	chr12	103049006	103049134	LINE/L2	486	+	64	103049070	88613
chr12	102960457	103160457	harbor2	chr12	103049322	103050137	LINE/L2	1753	+	408	103049730	89273
chr12	102960457	103160457	harbor2	chr12	103038938	103039902	LINE/L2	2317	+	482	103039420	78963
chr12	132986248	133186248	harbor2	chr12	133002135	133002496	LINE/L2	497	+	180	133002315	16067
chr12	110694826	110894826	harbor2	chr12	110755962	110756072	LINE/L2	686	+	55	110756017	61191
chr12	110694826	110894826	harbor2	chr12	110756371	110756578	LINE/L2	686	+	104	110756475	61649
chr12	110694826	110894826	harbor2	chr12	110756708	110756982	LINE/L2	982	+	137	110756845	62019
chr12	110694826	110894826	harbor2	chr12	110757577	110757757	LINE/L2	982	+	90	110757667	62841
chr12	30723482	30923482	harbor2	chr12	30743769	30744413	LINE/L2	746	+	322	30744091	20609
chr12	30723482	30923482	harbor2	chr12	30744494	30744859	LINE/L2	462	+	182	30744676	21194
chr12	30723482	30923482	harbor2	chr12	30766156	30766481	LINE/L2	898	+	162	30766318	42836
chr12	30723482	30923482	harbor2	chr12	30766973	30767398	LINE/L2	898	+	212	30767185	43703
chr12	62775459	62975459	harbor2	chr12	62775749	62775847	LINE/L2	665	+	49	62775798	339
chr12	62775459	62975459	harbor2	chr12	62776216	62776544	LINE/L2	665	+	164	62776380	921
chr12	62775459	62975459	harbor2	chr12	62828227	62828694	LINE/L2	789	+	234	62828461	53002
chr12	111801752	112001752	harbor2	chr12	111840112	111840363	LINE/L2	1261	+	126	111840238	38486
chr12	111801752	112001752	harbor2	chr12	111840646	111840923	LINE/L2	1261	+	138	111840784	39032
chr12	111801752	112001752	harbor2	chr12	111841074	111841497	LINE/L2	612	+	212	111841286	39534
chr12	78716624	78916624	harbor2	chr12	78789010	78789372	LINE/L2	956	+	181	78789191	72567
chr12	103903386	104103386	harbor2	chr12	103903443	103903897	LINE/L2	981	+	227	103903670	284
chr12	103903386	104103386	harbor2	chr12	103904822	103905209	LINE/L2	952	+	194	103905016	1630
chr12	103903386	104103386	harbor2	chr12	103908339	103908411	LINE/L2	507	+	36	103908375	4989
chr12	103903386	104103386	harbor2	chr12	103908695	103909231	LINE/L2	978	+	268	103908963	5577
chr12	103903386	104103386	harbor2	chr12	103994592	103995720	LINE/L2	1997	+	564	103995156	91770
chr12	115262982	115462982	harbor2	chr12	115301711	115302187	LINE/L2	966	+	238	115301949	38967
chr12	131563802	131763802	harbor2	chr12	131662317	131662429	LINE/L2	517	+	56	131662373	98571
chr12	121765627	121965627	harbor2	chr12	121786541	121786754	LINE/L2	514	+	106	121786647	21020
chr12	121765627	121965627	harbor2	chr12	121787070	121787185	LINE/L2	514	+	58	121787128	21501
chr12	121765627	121965627	harbor2	chr12	121843169	121843616	LINE/L2	676	+	224	121843393	77766
chr12	51845020	52045020	harbor2	chr12	51870038	51870746	LINE/L2	578	+	354	51870392	25372
chr12	51845020	52045020	harbor2	chr12	51919869	51919988	LINE/L2	499	+	60	51919929	74909
chr12	51845020	52045020	harbor2	chr12	51934124	51935051	LINE/L2	882	+	464	51934588	89568
chr12	51845020	52045020	harbor2	chr12	51935363	51935613	LINE/L2	882	+	125	51935488	90468
chr12	88930080	89130080	harbor2	chr12	88981354	88981477	LINE/L2	491	+	62	88981416	51336
chr12	88930080	89130080	harbor2	chr12	89012686	89012985	LINE/L2	585	+	150	89012836	82756
chr12	88930080	89130080	harbor2	chr12	88981477	88982014	LINE/L2	823	+	268	88981745	51665
chr12	78551846	78751846	harbor2	chr12	78552496	78552849	LINE/L2	507	+	176	78552672	826
chr12	78551846	78751846	harbor2	chr12	78562516	78562901	LINE/L2	1020	+	192	78562708	10862
chr12	78551846	78751846	harbor2	chr12	78572395	78573140	LINE/L2	1334	+	372	78572767	20921
chr12	78551846	78751846	harbor2	chr12	78573142	78573659	LINE/L2	596	+	258	78573400	21554
chr12	78551846	78751846	harbor2	chr12	78592125	78593338	LINE/L2	2680	+	606	78592731	40885
chr12	86597951	86797951	harbor2	chr12	86677895	86678352	LINE/L2	899	+	228	86678123	80172
chr12	86597951	86797951	harbor2	chr12	86683605	86683998	LINE/L2	567	+	196	86683801	85850
chr12	122597528	122797528	harbor2	chr12	122638800	122638932	LINE/L2	460	+	66	122638866	41338
chr12	77381298	77581298	harbor2	chr12	77444000	77444449	LINE/L2	452	+	224	77444224	62926
chr12	77381298	77581298	harbor2	chr12	77466521	77466875	LINE/L2	526	+	177	77466698	85400
chr12	77381298	77581298	harbor2	chr12	77475595	77475957	LINE/L2	450	+	181	77475776	94478
chr12	101943227	102143227	harbor2	chr12	101951979	101952346	LINE/L2	572	+	184	101952163	8936
chr12	101943227	102143227	harbor2	chr12	101994554	101995050	LINE/L2	823	+	248	101994802	51575
chr12	101943227	102143227	harbor2	chr12	101995288	101995826	LINE/L2	721	+	269	101995557	52330
chr12	129899596	130099596	harbor2	chr12	129914562	129914904	LINE/L2	565	+	171	129914733	15137
chr12	129899596	130099596	harbor2	chr12	129915203	129915429	LINE/L2	565	+	113	129915316	15720
chr12	129899596	130099596	harbor2	chr12	129943834	129943969	LINE/L2	2003	+	68	129943902	44306
chr12	129899596	130099596	harbor2	chr12	129944286	129945417	LINE/L2	2003	+	566	129944852	45256
chr12	26512012	26712012	harbor2	chr12	26511849	26512063	LINE/L2	445	+	107	26511956	56
chr12	26512012	26712012	harbor2	chr12	26528850	26529556	LINE/L2	1481	+	353	26529203	17191
chr12	26512012	26712012	harbor2	chr12	26529811	26529997	LINE/L2	503	+	93	26529904	17892
chr12	26512012	26712012	harbor2	chr12	26558505	26559289	LINE/L2	2019	+	392	26558897	46885
chr12	26512012	26712012	harbor2	chr12	26559641	26560099	LINE/L2	2019	+	229	26559870	47858
chr12	126304453	126504453	harbor2	chr12	126318858	126319059	LINE/L2	538	+	100	126318958	14505
chr12	126304453	126504453	harbor2	chr12	126346396	126346551	LINE/L2	471	+	78	126346474	42021
chr12	108776157	108976157	harbor2	chr12	108842970	108843179	LINE/L2	891	+	104	108843074	66917
chr12	121254299	121454299	harbor2	chr12	121332501	121332654	LINE/L2	567	+	76	121332577	78278
chr12	118976237	119176237	harbor2	chr12	119023586	119023798	LINE/L2	458	+	106	119023692	47455
chr12	118976237	119176237	harbor2	chr12	119056476	119056972	LINE/L2	466	+	248	119056724	80487
chr12	22809745	23009745	harbor2	chr12	22817634	22817837	LINE/L2	457	+	102	22817736	7991
chr12	22809745	23009745	harbor2	chr12	22841089	22841577	LINE/L2	2124	+	244	22841333	31588
chr12	22809745	23009745	harbor2	chr12	22841873	22842158	LINE/L2	2124	+	142	22842015	32270
chr12	22809745	23009745	harbor2	chr12	22842508	22842933	LINE/L2	872	+	212	22842720	32975
chr12	22809745	23009745	harbor2	chr12	22866700	22868861	LINE/L2	5770	+	1080	22867780	58035
chr12	22809745	23009745	harbor2	chr12	22870125	22870238	LINE/L2	467	+	56	22870181	60436
chr12	22809745	23009745	harbor2	chr12	22871154	22871391	LINE/L2	738	+	118	22871272	61527
chr12	97457389	97657389	harbor2	chr12	97479024	97479133	LINE/L2	621	+	54	97479078	21689
chr12	97457389	97657389	harbor2	chr12	97479453	97480078	LINE/L2	621	+	312	97479765	22376
chr12	97457389	97657389	harbor2	chr12	97480365	97480986	LINE/L2	621	+	310	97480675	23286
chr13	70834930	71034930	harbor2	chr13	70927677	70928086	LINE/L2	550	+	204	70927881	92951
chr13	63117841	63317841	harbor2	chr13	63161483	63162113	LINE/L2	668	+	315	63161798	43957
chr13	63117841	63317841	harbor2	chr13	63209839	63209929	LINE/L2	2993	+	45	63209884	92043
chr13	63117841	63317841	harbor2	chr13	63209966	63211646	LINE/L2	2993	+	840	63210806	92965
chr13	83916741	84116741	harbor2	chr13	83936852	83937271	LINE/L2	498	+	210	83937062	20321
chr13	75106175	75306175	harbor2	chr13	75148834	75149041	LINE/L2	413	+	104	75148938	42763
chr13	75106175	75306175	harbor2	chr13	75149042	75149622	LINE/L2	1336	+	290	75149332	43157
chr13	75106175	75306175	harbor2	chr13	75182095	75182904	LINE/L2	1400	+	404	75182499	76324
chr13	88136313	88336313	harbor2	chr13	88155207	88155604	LINE/L2	791	+	198	88155405	19092
chr13	88136313	88336313	harbor2	chr13	88220311	88220474	LINE/L2	475	+	82	88220393	84080
chr13	84580156	84780156	harbor2	chr13	84599613	84600246	LINE/L2	721	+	316	84599929	19773
chr13	84580156	84780156	harbor2	chr13	84624049	84624262	LINE/L2	714	+	106	84624155	43999
chr13	84580156	84780156	harbor2	chr13	84663291	84664177	LINE/L2	731	+	443	84663734	83578
chr13	84580156	84780156	harbor2	chr13	84623262	84623928	LINE/L2	888	+	333	84623595	43439
chr13	80240365	80440365	harbor2	chr13	80255770	80256351	LINE/L2	1970	+	290	80256060	15695
chr13	80240365	80440365	harbor2	chr13	80256510	80256745	LINE/L2	1970	+	118	80256628	16263
chr13	80240365	80440365	harbor2	chr13	80303236	80303772	LINE/L2	1210	+	268	80303504	63139
chr13	84849949	85049949	harbor2	chr13	84933361	84933640	LINE/L2	521	+	140	84933501	83552
chr13	68497953	68697953	harbor2	chr13	68517577	68517894	LINE/L2	465	+	158	68517735	19782
chr13	103379104	103579104	harbor2	chr13	103412381	103413424	LINE/L2	4558	+	522	103412903	33799
chr13	103379104	103579104	harbor2	chr13	103413840	103414961	LINE/L2	4558	+	560	103414400	35296
chr13	68454919	68654919	harbor2	chr13	68480463	68480670	LINE/L2	442	+	104	68480567	25648
chr13	68454919	68654919	harbor2	chr13	68517577	68517894	LINE/L2	465	+	158	68517735	62816
chr13	55447620	55647620	harbor2	chr13	55461940	55462489	LINE/L2	1394	+	274	55462214	14594
chr13	99199216	99399216	harbor2	chr13	99226262	99226916	LINE/L2	1405	+	327	99226589	27373
chr13	99199216	99399216	harbor2	chr13	99227223	99227241	LINE/L2	459	+	9	99227232	28016
chr13	99199216	99399216	harbor2	chr13	99227605	99227808	LINE/L2	523	+	102	99227707	28491
chr13	67513368	67713368	harbor2	chr13	67512562	67515448	LINE/L2	4293	+	1443	67514005	637
chr13	67513368	67713368	harbor2	chr13	67515514	67516022	LINE/L2	420	+	254	67515768	2400
chr13	106326599	106526599	harbor2	chr13	106414575	106414728	LINE/L2	624	+	76	106414651	88052
chr13	106326599	106526599	harbor2	chr13	106413470	106414264	LINE/L2	1410	+	397	106413867	87268
chr13	104925468	105125468	harbor2	chr13	104963339	104963646	LINE/L2	409	+	154	104963493	38025
chr13	103262370	103462370	harbor2	chr13	103264580	103264992	LINE/L2	441	+	206	103264786	2416
chr13	103262370	103462370	harbor2	chr13	103354095	103354843	LINE/L2	1717	+	374	103354469	92099
chr13	23528885	23728885	harbor2	chr13	23544718	23544897	LINE/L2	668	+	90	23544808	15923
chr13	23528885	23728885	harbor2	chr13	23544913	23545331	LINE/L2	704	+	209	23545122	16237
chr13	78445507	78645507	harbor2	chr13	78501466	78501878	LINE/L2	528	+	206	78501672	56165
chr13	78445507	78645507	harbor2	chr13	78534021	78534809	LINE/L2	935	+	394	78534415	88908
chr13	38974059	39174059	harbor2	chr13	38991157	38991466	LINE/L2	451	+	154	38991311	17252
chr13	38974059	39174059	harbor2	chr13	39024082	39024357	LINE/L2	783	+	138	39024220	50161
chr13	38974059	39174059	harbor2	chr13	39070134	39070498	LINE/L2	1042	+	182	39070316	96257
chr13	38974059	39174059	harbor2	chr13	39070532	39070589	LINE/L2	766	+	28	39070560	96501
chr13	38974059	39174059	harbor2	chr13	39070938	39071217	LINE/L2	766	+	140	39071078	97019
chr13	53426796	53626796	harbor2	chr13	53446295	53446521	LINE/L2	401	+	113	53446408	19612
chr13	53426796	53626796	harbor2	chr13	53478180	53478791	LINE/L2	452	+	306	53478486	51690
chr13	53426796	53626796	harbor2	chr13	53510797	53511128	LINE/L2	408	+	166	53510963	84167
chr13	69458195	69658195	harbor2	chr13	69463906	69464711	LINE/L2	632	+	402	69464308	6113
chr13	80823054	81023054	harbor2	chr13	80913983	80914567	LINE/L2	988	+	292	80914275	91221
chr13	73842251	74042251	harbor2	chr13	73884831	73885505	LINE/L2	1220	+	337	73885168	42917
chr13	73842251	74042251	harbor2	chr13	73897344	73897829	LINE/L2	538	+	242	73897586	55335
chr13	73842251	74042251	harbor2	chr13	73897879	73898142	LINE/L2	447	+	132	73898011	55760
chr13	73842251	74042251	harbor2	chr13	73907756	73908120	LINE/L2	931	+	182	73907938	65687
chr13	73842251	74042251	harbor2	chr13	73908430	73908471	LINE/L2	931	+	20	73908450	66199
chr13	73842251	74042251	harbor2	chr13	73908780	73908952	LINE/L2	931	+	86	73908866	66615
chr13	73842251	74042251	harbor2	chr13	73912839	73913184	LINE/L2	399	+	172	73913011	70760
chr13	80150814	80350814	harbor2	chr13	80167183	80167821	LINE/L2	803	+	319	80167502	16688
chr14	53498927	53698927	harbor2	chr14	53521179	53521848	LINE/L2	653	+	334	53521513	22586
chr14	53498927	53698927	harbor2	chr14	53552214	53552669	LINE/L2	425	+	228	53552442	53515
chr14	96926824	97126824	harbor2	chr14	96936082	96936356	LINE/L2	480	+	137	96936219	9395
chr14	96926824	97126824	harbor2	chr14	96937502	96937857	LINE/L2	415	+	178	96937680	10856
chr14	96926824	97126824	harbor2	chr14	96997453	96997851	LINE/L2	1151	+	199	96997652	70828
chr14	99071730	99271730	harbor2	chr14	99163274	99163572	LINE/L2	583	+	149	99163423	91693
chr14	97477268	97677268	harbor2	chr14	97569012	97569938	LINE/L2	1021	+	463	97569475	92207
chr14	100190946	100390946	harbor2	chr14	100255818	100255990	LINE/L2	566	+	86	100255904	64958
chr14	100190946	100390946	harbor2	chr14	100256155	100256451	LINE/L2	566	+	148	100256303	65357
chr14	100190946	100390946	harbor2	chr14	100257222	100257354	LINE/L2	529	+	66	100257288	66342
chr14	77320508	77520508	harbor2	chr14	77349433	77349756	LINE/L2	568	+	162	77349595	29087
chr14	77320508	77520508	harbor2	chr14	77350272	77350432	LINE/L2	601	+	80	77350352	29844
chr14	32485606	32685606	harbor2	chr14	32550805	32551290	LINE/L2	1218	+	242	32551047	65441
chr14	32485606	32685606	harbor2	chr14	32551591	32551642	LINE/L2	1036	+	26	32551617	66011
chr14	32485606	32685606	harbor2	chr14	32551966	32552155	LINE/L2	1036	+	94	32552060	66454
chr14	32485606	32685606	harbor2	chr14	32565086	32566008	LINE/L2	592	+	461	32565547	79941
chr14	97118492	97318492	harbor2	chr14	97122254	97122730	LINE/L2	466	+	238	97122492	4000
chr14	97118492	97318492	harbor2	chr14	97149829	97150247	LINE/L2	596	+	209	97150038	31546
chr14	97118492	97318492	harbor2	chr14	97168122	97168451	LINE/L2	579	+	164	97168286	49794
chr14	97118492	97318492	harbor2	chr14	97203955	97204284	LINE/L2	565	+	164	97204119	85627
chr14	88698893	88898893	harbor2	chr14	88708240	88708485	LINE/L2	570	+	122	88708362	9469
chr14	88698893	88898893	harbor2	chr14	88771197	88771601	LINE/L2	609	+	202	88771399	72506
chr14	88698893	88898893	harbor2	chr14	88771820	88772475	LINE/L2	1227	+	328	88772148	73255
chr14	88698893	88898893	harbor2	chr14	88772765	88773042	LINE/L2	1227	+	138	88772903	74010
chr14	88698893	88898893	harbor2	chr14	88774743	88774946	LINE/L2	894	+	102	88774845	75952
chr14	88698893	88898893	harbor2	chr14	88785500	88786480	LINE/L2	2347	+	490	88785990	87097
chr14	50440236	50640236	harbor2	chr14	50457464	50458800	LINE/L2	1065	+	668	50458132	17896
chr14	50440236	50640236	harbor2	chr14	50459113	50459685	LINE/L2	1065	+	286	50459399	19163
chr14	50440236	50640236	harbor2	chr14	50459998	50460350	LINE/L2	1065	+	176	50460174	19938
chr14	50440236	50640236	harbor2	chr14	50501799	50501978	LINE/L2	590	+	90	50501889	61653
chr14	50440236	50640236	harbor2	chr14	50510305	50510444	LINE/L2	437	+	70	50510375	70139
chr14	50440236	50640236	harbor2	chr14	50515843	50516164	LINE/L2	565	+	160	50516003	75767
chr14	50440236	50640236	harbor2	chr14	50523494	50523845	LINE/L2	1130	+	176	50523670	83434
chr14	50440236	50640236	harbor2	chr14	50524975	50525492	LINE/L2	442	+	258	50525233	84997
chr14	50440236	50640236	harbor2	chr14	50526030	50526299	LINE/L2	490	+	134	50526164	85928
chr14	50440236	50640236	harbor2	chr14	50526596	50526715	LINE/L2	490	+	60	50526656	86420
chr14	75249928	75449928	harbor2	chr14	75286399	75286751	LINE/L2	949	+	176	75286575	36647
chr14	75249928	75449928	harbor2	chr14	75287047	75287177	LINE/L2	949	+	65	75287112	37184
chr14	75249928	75449928	harbor2	chr14	75301832	75302062	LINE/L2	634	+	115	75301947	52019
chr14	75249928	75449928	harbor2	chr14	75302367	75302634	LINE/L2	634	+	134	75302501	52573
chr14	75249928	75449928	harbor2	chr14	75308411	75308576	LINE/L2	548	+	82	75308493	58565
chr14	75249928	75449928	harbor2	chr14	75319856	75320185	LINE/L2	608	+	164	75320020	70092
chr14	75249928	75449928	harbor2	chr14	75322761	75322922	LINE/L2	426	+	80	75322841	72913
chr14	75249928	75449928	harbor2	chr14	75323304	75323782	LINE/L2	930	+	239	75323543	73615
chr14	75697845	75897845	harbor2	chr14	75722826	75723125	LINE/L2	522	+	150	75722976	25131
chr14	99644325	99844325	harbor2	chr14	99685331	99685624	LINE/L2	601	+	146	99685477	41152
chr14	99644325	99844325	harbor2	chr14	99688245	99689230	LINE/L2	1006	+	492	99688737	44412
chr14	99644325	99844325	harbor2	chr14	99689565	99690175	LINE/L2	1260	+	305	99689870	45545
chr14	99644325	99844325	harbor2	chr14	99690305	99690438	LINE/L2	756	+	66	99690371	46046
chr14	99644325	99844325	harbor2	chr14	99718213	99718518	LINE/L2	463	+	152	99718365	74040
chr14	99644325	99844325	harbor2	chr14	99726857	99727306	LINE/L2	812	+	224	99727081	82756
chr14	85715869	85915869	harbor2	chr14	85743661	85744457	LINE/L2	1012	+	398	85744059	28190
chr14	85715869	85915869	harbor2	chr14	85812541	85812792	LINE/L2	544	+	126	85812667	96798
chr14	91579399	91779399	harbor2	chr14	91622650	91622893	LINE/L2	2017	+	122	91622772	43373
chr14	91579399	91779399	harbor2	chr14	91623195	91623621	LINE/L2	2017	+	213	91623408	44009
chr14	91579399	91779399	harbor2	chr14	91623622	91623826	LINE/L2	849	+	102	91623724	44325
chr14	91579399	91779399	harbor2	chr14	91630030	91631277	LINE/L2	1820	+	624	91630654	51255
chr14	91579399	91779399	harbor2	chr14	91639892	91640240	LINE/L2	1211	+	174	91640066	60667
chr14	91579399	91779399	harbor2	chr14	91646239	91646643	LINE/L2	1496	+	202	91646441	67042
chr14	91579399	91779399	harbor2	chr14	91648950	91649170	LINE/L2	610	+	110	91649060	69661
chr14	81685860	81885860	harbor2	chr14	81704016	81704461	LINE/L2	926	+	222	81704238	18378
chr14	81685860	81885860	harbor2	chr14	81731868	81732293	LINE/L2	440	+	212	81732080	46220
chr14	81685860	81885860	harbor2	chr14	81778793	81779086	LINE/L2	558	+	146	81778939	93079
chr14	81685860	81885860	harbor2	chr14	81779300	81779589	LINE/L2	558	+	144	81779444	93584
chr14	65125635	65325635	harbor2	chr14	65220815	65221098	LINE/L2	736	+	142	65220957	95322
chr14	65125635	65325635	harbor2	chr14	65221404	65221542	LINE/L2	736	+	69	65221473	95838
chr14	65125635	65325635	harbor2	chr14	65221546	65221757	LINE/L2	732	+	106	65221652	96017
chr14	65125635	65325635	harbor2	chr14	65221767	65221923	LINE/L2	600	+	78	65221845	96210
chr14	67474324	67674324	harbor2	chr14	67484015	67484313	LINE/L2	757	+	149	67484164	9840
chr14	76704239	76904239	harbor2	chr14	76759380	76759517	LINE/L2	465	+	68	76759448	55209
chr14	93021646	93221646	harbor2	chr14	93121293	93121685	LINE/L2	491	+	196	93121489	99843
chr14	37948693	38148693	harbor2	chr14	38005837	38006156	LINE/L2	749	+	160	38005997	57304
chr14	37948693	38148693	harbor2	chr14	38037687	38038191	LINE/L2	788	+	252	38037939	89246
chr14	39445548	39645548	harbor2	chr14	39534938	39535114	LINE/L2	438	+	88	39535026	89478
chr14	28573598	28773598	harbor2	chr14	28671309	28671413	LINE/L2	510	+	52	28671361	97763
chr14	88008196	88208196	harbor2	chr14	88039903	88040693	LINE/L2	3401	+	395	88040298	32102
chr14	88008196	88208196	harbor2	chr14	88040831	88041535	LINE/L2	3401	+	352	88041183	32987
chr14	88008196	88208196	harbor2	chr14	88065163	88065364	LINE/L2	448	+	100	88065263	57067
chr14	88008196	88208196	harbor2	chr14	88081356	88081556	LINE/L2	444	+	100	88081456	73260
chr14	103938626	104138626	harbor2	chr14	103954289	103954508	LINE/L2	527	+	110	103954399	15773
chr14	95402955	95602955	harbor2	chr14	95421767	95421992	LINE/L2	493	+	112	95421879	18924
chr14	95402955	95602955	harbor2	chr14	95442798	95443014	LINE/L2	525	+	108	95442906	39951
chr14	96131970	96331970	harbor2	chr14	96162539	96162828	LINE/L2	670	+	144	96162683	30713
chr14	96131970	96331970	harbor2	chr14	96170856	96171496	LINE/L2	907	+	320	96171176	39206
chr14	89180055	89380055	harbor2	chr14	89247585	89248297	LINE/L2	762	+	356	89247941	67886
chr14	72897480	73097480	harbor2	chr14	72995832	72996079	LINE/L2	461	+	124	72995956	98476
chr14	72897480	73097480	harbor2	chr14	72996559	72996884	LINE/L2	551	+	162	72996721	99241
chr14	72897480	73097480	harbor2	chr14	72996922	72997365	LINE/L2	1934	+	222	72997144	99664
chr14	57400611	57600611	harbor2	chr14	57442076	57442259	LINE/L2	492	+	92	57442168	41557
chr14	57400611	57600611	harbor2	chr14	57466313	57466774	LINE/L2	1024	+	230	57466543	65932
chr14	57400611	57600611	harbor2	chr14	57473239	57474218	LINE/L2	1025	+	490	57473729	73118
chr14	103548913	103748913	harbor2	chr14	103626692	103626770	LINE/L2	477	+	39	103626731	77818
chr14	103548913	103748913	harbor2	chr14	103627066	103627362	LINE/L2	477	+	148	103627214	78301
chr14	103548913	103748913	harbor2	chr14	103633771	103633857	LINE/L2	561	+	43	103633814	84901
chr14	103548913	103748913	harbor2	chr14	103634169	103634323	LINE/L2	561	+	77	103634246	85333
chr14	61182987	61382987	harbor2	chr14	61190380	61190895	LINE/L2	485	+	258	61190638	7651
chr14	61182987	61382987	harbor2	chr14	61198272	61198671	LINE/L2	624	+	200	61198472	15485
chr14	42445812	42645812	harbor2	chr14	42479435	42479961	LINE/L2	452	+	263	42479698	33886
chr14	42445812	42645812	harbor2	chr14	42513934	42514328	LINE/L2	503	+	197	42514131	68319
chr14	42445812	42645812	harbor2	chr14	42541868	42542324	LINE/L2	625	+	228	42542096	96284
chr14	80194044	80394044	harbor2	chr14	80213552	80213675	LINE/L2	528	+	62	80213614	19570
chr14	94284035	94484035	harbor2	chr14	94287072	94288046	LINE/L2	2272	+	487	94287559	3524
chr14	94284035	94484035	harbor2	chr14	94356373	94356906	LINE/L2	1368	+	266	94356639	72604
chr14	104309027	104509027	harbor2	chr14	104344726	104345020	LINE/L2	624	+	147	104344873	35846
chr14	103311828	103511828	harbor2	chr14	103382749	103383038	LINE/L2	442	+	144	103382893	71065
chr14	61605186	61805186	harbor2	chr14	61626710	61626891	LINE/L2	428	+	90	61626800	21614
chr14	61605186	61805186	harbor2	chr14	61629247	61629541	LINE/L2	481	+	147	61629394	24208
chr14	61605186	61805186	harbor2	chr14	61667867	61668347	LINE/L2	421	+	240	61668107	62921
chr14	61605186	61805186	harbor2	chr14	61668475	61668826	LINE/L2	583	+	176	61668651	63465
chr14	61605186	61805186	harbor2	chr14	61652063	61653405	LINE/L2	2586	+	671	61652734	47548
chr14	29824980	30024980	harbor2	chr14	29858200	29858389	LINE/L2	619	+	94	29858294	33314
chr14	29824980	30024980	harbor2	chr14	29895370	29896109	LINE/L2	1323	+	370	29895740	70760
chr14	65548062	65748062	harbor2	chr14	65582542	65582821	LINE/L2	491	+	140	65582682	34620
chr14	65548062	65748062	harbor2	chr14	65588168	65588604	LINE/L2	449	+	218	65588386	40324
chr14	27997397	28197397	harbor2	chr14	28062573	28063525	LINE/L2	690	+	476	28063049	65652
chr14	27997397	28197397	harbor2	chr14	28090316	28091982	LINE/L2	2982	+	833	28091149	93752
chr14	89826324	90026324	harbor2	chr14	89841236	89842306	LINE/L2	816	+	535	89841771	15447
chr14	89826324	90026324	harbor2	chr14	89842647	89843119	LINE/L2	816	+	236	89842883	16559
chr14	89826324	90026324	harbor2	chr14	89847033	89847271	LINE/L2	459	+	119	89847152	20828
chr14	89826324	90026324	harbor2	chr14	89902055	89902502	LINE/L2	933	+	224	89902279	75955
chr14	99231684	99431684	harbor2	chr14	99290726	99291989	LINE/L2	2522	+	632	99291358	59674
chr14	99231684	99431684	harbor2	chr14	99296283	99296411	LINE/L2	510	+	64	99296347	64663
chr14	80117377	80317377	harbor2	chr14	80118475	80118925	LINE/L2	460	+	225	80118700	1323
chr14	80117377	80317377	harbor2	chr14	80140812	80141510	LINE/L2	807	+	349	80141161	23784
chr14	80117377	80317377	harbor2	chr14	80142455	80142903	LINE/L2	466	+	224	80142679	25302
chr14	80117377	80317377	harbor2	chr14	80168872	80169144	LINE/L2	601	+	136	80169008	51631
chr14	80117377	80317377	harbor2	chr14	80213552	80213675	LINE/L2	528	+	62	80213614	96237
chr14	93352361	93552361	harbor2	chr14	93380390	93380742	LINE/L2	642	+	176	93380566	28205
chr14	93352361	93552361	harbor2	chr14	93427507	93427757	LINE/L2	611	+	125	93427632	75271
chr14	93352361	93552361	harbor2	chr14	93452028	93452348	LINE/L2	478	+	160	93452188	99827
chr14	84529393	84729393	harbor2	chr14	84549922	84550418	LINE/L2	498	+	248	84550170	20777
chr14	84529393	84729393	harbor2	chr14	84550578	84550799	LINE/L2	498	+	110	84550688	21295
chr14	84529393	84729393	harbor2	chr14	84550898	84551092	LINE/L2	538	+	97	84550995	21602
chr14	84529393	84729393	harbor2	chr14	84607575	84609629	LINE/L2	1736	+	1027	84608602	79209
chr14	84529393	84729393	harbor2	chr14	84606491	84607270	LINE/L2	1736	+	390	84606881	77488
chr14	97225595	97425595	harbor2	chr14	97235603	97235690	LINE/L2	551	+	44	97235647	10052
chr14	97225595	97425595	harbor2	chr14	97236136	97236539	LINE/L2	551	+	202	97236338	10743
chr14	67725211	67925211	harbor2	chr14	67725629	67725768	LINE/L2	488	+	70	67725699	488
chr14	67725211	67925211	harbor2	chr14	67749018	67749172	LINE/L2	582	+	77	67749095	23884
chr14	67725211	67925211	harbor2	chr14	67756304	67757634	LINE/L2	3086	+	665	67756969	31758
chr14	67725211	67925211	harbor2	chr14	67758015	67758066	LINE/L2	584	+	26	67758041	32830
chr14	101287871	101487871	harbor2	chr14	101337220	101337595	LINE/L2	486	+	188	101337408	49537
chr14	101287871	101487871	harbor2	chr14	101352590	101352920	LINE/L2	841	+	165	101352755	64884
chr14	72141644	72341644	harbor2	chr14	72208514	72208658	LINE/L2	430	+	72	72208586	66942
chr14	74075768	74275768	harbor2	chr14	74078976	74079194	LINE/L2	651	+	109	74079085	3317
chr14	74075768	74275768	harbor2	chr14	74080059	74080353	LINE/L2	651	+	147	74080206	4438
chr14	78107797	78307797	harbor2	chr14	78123634	78124394	LINE/L2	1431	+	380	78124014	16217
chr14	78107797	78307797	harbor2	chr14	78134483	78135181	LINE/L2	847	+	349	78134832	27035
chr14	78107797	78307797	harbor2	chr14	78147950	78148134	LINE/L2	471	+	92	78148042	40245
chr14	78107797	78307797	harbor2	chr14	78159911	78160193	LINE/L2	520	+	141	78160052	52255
chr14	78107797	78307797	harbor2	chr14	78175729	78176063	LINE/L2	807	+	167	78175896	68099
chr14	78107797	78307797	harbor2	chr14	78188847	78189585	LINE/L2	1798	+	369	78189216	81419
chr14	78107797	78307797	harbor2	chr14	78189833	78190128	LINE/L2	603	+	148	78189981	82184
chr14	90418717	90618717	harbor2	chr14	90422334	90422592	LINE/L2	506	+	129	90422463	3746
chr14	90418717	90618717	harbor2	chr14	90464105	90464497	LINE/L2	436	+	196	90464301	45584
chr14	90418717	90618717	harbor2	chr14	90507490	90507986	LINE/L2	730	+	248	90507738	89021
chr14	71954555	72154555	harbor2	chr14	71960917	71961057	LINE/L2	452	+	70	71960987	6432
chr14	85416455	85616455	harbor2	chr14	85500253	85500823	LINE/L2	1487	+	285	85500538	84083
chr14	73553767	73753767	harbor2	chr14	73649611	73649773	LINE/L2	746	+	81	73649692	95925
chr14	73553767	73753767	harbor2	chr14	73650420	73650559	LINE/L2	746	+	70	73650490	96723
chr14	94861120	95061120	harbor2	chr14	94931202	94931485	LINE/L2	439	+	142	94931344	70224
chr14	94861120	95061120	harbor2	chr14	94942507	94942813	LINE/L2	604	+	153	94942660	81540
chr14	76693222	76893222	harbor2	chr14	76759380	76759517	LINE/L2	465	+	68	76759448	66226
chr14	95455982	95655982	harbor2	chr14	95526159	95526454	LINE/L2	459	+	148	95526307	70325
chr14	93035290	93235290	harbor2	chr14	93121293	93121685	LINE/L2	491	+	196	93121489	86199
chr14	94747755	94947755	harbor2	chr14	94759479	94759589	LINE/L2	567	+	55	94759534	11779
chr14	94747755	94947755	harbor2	chr14	94759891	94760030	LINE/L2	567	+	70	94759961	12206
chr14	94747755	94947755	harbor2	chr14	94829039	94829337	LINE/L2	460	+	149	94829188	81433
chr14	94747755	94947755	harbor2	chr14	94830377	94830868	LINE/L2	786	+	246	94830623	82868
chr14	93252936	93452936	harbor2	chr14	93267732	93268461	LINE/L2	566	+	364	93268096	15160
chr14	93252936	93452936	harbor2	chr14	93307570	93307871	LINE/L2	534	+	150	93307720	54784
chr14	93252936	93452936	harbor2	chr14	93316556	93316710	LINE/L2	627	+	77	93316633	63697
chr14	105388668	105588668	harbor2	chr14	105401131	105401231	LINE/L2	469	+	50	105401181	12513
chr14	74324589	74524589	harbor2	chr14	74360658	74360855	LINE/L2	795	+	98	74360756	36167
chr14	74324589	74524589	harbor2	chr14	74361434	74361965	LINE/L2	795	+	266	74361700	37111
chr14	74324589	74524589	harbor2	chr14	74368624	74368937	LINE/L2	562	+	156	74368780	44191
chr14	74324589	74524589	harbor2	chr14	74419064	74419412	LINE/L2	549	+	174	74419238	94649
chr14	90123014	90323014	harbor2	chr14	90195235	90195361	LINE/L2	424	+	63	90195298	72284
chr14	90123014	90323014	harbor2	chr14	90195985	90196006	LINE/L2	424	+	10	90195995	72981
chr14	98014989	98214989	harbor2	chr14	98054000	98054726	LINE/L2	958	+	363	98054363	39374
chr14	57356937	57556937	harbor2	chr14	57381773	57382092	LINE/L2	548	+	160	57381933	24996
chr14	57356937	57556937	harbor2	chr14	57442076	57442259	LINE/L2	492	+	92	57442168	85231
chr14	66211764	66411764	harbor2	chr14	66226176	66226275	LINE/L2	444	+	50	66226226	14462
chr14	66211764	66411764	harbor2	chr14	66251258	66252034	LINE/L2	559	+	388	66251646	39882
chr14	87842251	88042251	harbor2	chr14	87901638	87901858	LINE/L2	473	+	110	87901748	59497
chr14	87842251	88042251	harbor2	chr14	87902074	87902330	LINE/L2	727	+	128	87902202	59951
chr14	87842251	88042251	harbor2	chr14	87936055	87936330	LINE/L2	793	+	138	87936193	93942
chr14	87842251	88042251	harbor2	chr14	87936566	87936691	LINE/L2	793	+	62	87936628	94377
chr14	88986589	89186589	harbor2	chr14	88996616	88997339	LINE/L2	568	+	362	88996978	10389
chr14	88986589	89186589	harbor2	chr14	89057311	89057501	LINE/L2	518	+	95	89057406	70817
chr14	88986589	89186589	harbor2	chr14	89059360	89059779	LINE/L2	1002	+	210	89059570	72981
chr14	93723743	93923743	harbor2	chr14	93760764	93761063	LINE/L2	901	+	150	93760914	37171
chr14	93723743	93923743	harbor2	chr14	93761369	93761646	LINE/L2	901	+	138	93761507	37764
chr14	93723743	93923743	harbor2	chr14	93762539	93763211	LINE/L2	719	+	336	93762875	39132
chr14	93723743	93923743	harbor2	chr14	93769993	93770864	LINE/L2	780	+	436	93770429	46686
chr14	93723743	93923743	harbor2	chr14	93784468	93784936	LINE/L2	542	+	234	93784702	60959
chr14	93723743	93923743	harbor2	chr14	93798842	93799254	LINE/L2	1329	+	206	93799048	75305
chr14	93723743	93923743	harbor2	chr14	93800494	93800749	LINE/L2	451	+	128	93800622	76879
chr14	93723743	93923743	harbor2	chr14	93805763	93806089	LINE/L2	503	+	163	93805926	82183
chr14	93723743	93923743	harbor2	chr14	93817923	93819550	LINE/L2	1346	+	814	93818737	94994
chr14	93723743	93923743	harbor2	chr14	93819835	93819959	LINE/L2	452	+	62	93819897	96154
chr14	39829467	40029467	harbor2	chr14	39877250	39877566	LINE/L2	434	+	158	39877408	47941
chr14	102529878	102729878	harbor2	chr14	102622317	102622877	LINE/L2	1069	+	280	102622597	92719
chr14	102529878	102729878	harbor2	chr14	102625908	102626259	LINE/L2	580	+	176	102626084	96206
chr14	102529878	102729878	harbor2	chr14	102626874	102627375	LINE/L2	1152	+	250	102627124	97246
chr14	102529878	102729878	harbor2	chr14	102627672	102627868	LINE/L2	1152	+	98	102627770	97892
chr14	102529878	102729878	harbor2	chr14	102629079	102629500	LINE/L2	496	+	210	102629289	99411
chr14	50034455	50234455	harbor2	chr14	50037233	50037521	LINE/L2	682	+	144	50037377	2922
chr14	50034455	50234455	harbor2	chr14	50048112	50048414	LINE/L2	467	+	151	50048263	13808
chr14	58040784	58240784	harbor2	chr14	58052519	58053727	LINE/L2	840	+	604	58053123	12339
chr14	58040784	58240784	harbor2	chr14	58071959	58072230	LINE/L2	466	+	136	58072095	31311
chr14	76368307	76568307	harbor2	chr14	76389162	76389435	LINE/L2	459	+	136	76389298	20991
chr14	76368307	76568307	harbor2	chr14	76413264	76413725	LINE/L2	468	+	230	76413494	45187
chr14	90296087	90496087	harbor2	chr14	90322349	90322458	LINE/L2	456	+	54	90322403	26316
chr14	23704653	23904653	harbor2	chr14	23709415	23709682	LINE/L2	915	+	134	23709549	4896
chr14	23704653	23904653	harbor2	chr14	23711895	23712492	LINE/L2	658	+	298	23712193	7540
chr14	23704653	23904653	harbor2	chr14	23712657	23713245	LINE/L2	616	+	294	23712951	8298
chr15	26656230	26856230	harbor2	chr15	26729729	26730003	LINE/L2	538	+	137	26729866	73636
chr15	80116329	80316329	harbor2	chr15	80154950	80155319	LINE/L2	544	+	184	80155134	38805
chr15	101834199	102034199	harbor2	chr15	101847182	101847910	LINE/L2	1597	+	364	101847546	13347
chr15	101834199	102034199	harbor2	chr15	101865006	101865592	LINE/L2	492	+	293	101865299	31100
chr15	101834199	102034199	harbor2	chr15	101903941	101904290	LINE/L2	609	+	174	101904115	69916
chr15	101834199	102034199	harbor2	chr15	101931771	101931923	LINE/L2	441	+	76	101931847	97648
chr15	101496598	101696598	harbor2	chr15	101496749	101498048	LINE/L2	1776	+	650	101497399	801
chr15	78083912	78283912	harbor2	chr15	78091730	78092132	LINE/L2	742	+	201	78091931	8019
chr15	78083912	78283912	harbor2	chr15	78099660	78100247	LINE/L2	863	+	294	78099954	16042
chr15	78083912	78283912	harbor2	chr15	78136969	78137106	LINE/L2	477	+	68	78137037	53125
chr15	76217764	76417764	harbor2	chr15	76274908	76275285	LINE/L2	870	+	188	76275096	57332
chr15	76217764	76417764	harbor2	chr15	76278103	76279173	LINE/L2	1746	+	535	76278638	60874
chr15	76217764	76417764	harbor2	chr15	76280063	76280917	LINE/L2	3025	+	427	76280490	62726
chr15	76217764	76417764	harbor2	chr15	76299164	76299281	LINE/L2	421	+	58	76299222	81458
chr15	76217764	76417764	harbor2	chr15	76299580	76299916	LINE/L2	421	+	168	76299748	81984
chr15	76217764	76417764	harbor2	chr15	76311786	76311932	LINE/L2	406	+	73	76311859	94095
chr15	76217764	76417764	harbor2	chr15	76312239	76312334	LINE/L2	406	+	48	76312287	94523
chr15	76217764	76417764	harbor2	chr15	76312455	76313061	LINE/L2	926	+	303	76312758	94994
chr15	66058456	66258456	harbor2	chr15	66072282	66072596	LINE/L2	763	+	157	66072439	13983
chr15	66058456	66258456	harbor2	chr15	66075935	66076058	LINE/L2	424	+	62	66075997	17541
chr15	66058456	66258456	harbor2	chr15	66132860	66132978	LINE/L2	514	+	59	66132919	74463
chr15	66058456	66258456	harbor2	chr15	66155464	66155913	LINE/L2	1198	+	224	66155688	97232
chr15	61863291	62063291	harbor2	chr15	61924167	61924526	LINE/L2	449	+	180	61924347	61056
chr15	37339815	37539815	harbor2	chr15	37395364	37395841	LINE/L2	474	+	238	37395602	55787
chr15	91466573	91666573	harbor2	chr15	91470648	91470897	LINE/L2	417	+	124	91470772	4199
chr15	91466573	91666573	harbor2	chr15	91471501	91471740	LINE/L2	417	+	120	91471621	5048
chr15	43486840	43686840	harbor2	chr15	43500006	43500298	LINE/L2	1334	+	146	43500152	13312
chr15	49430110	49630110	harbor2	chr15	49453645	49453975	LINE/L2	433	+	165	49453810	23700
chr15	49430110	49630110	harbor2	chr15	49490317	49490455	LINE/L2	589	+	69	49490386	60276
chr15	49430110	49630110	harbor2	chr15	49494514	49494656	LINE/L2	499	+	71	49494585	64475
chr15	49430110	49630110	harbor2	chr15	49494652	49494801	LINE/L2	455	+	74	49494726	64616
chr15	91724690	91924690	harbor2	chr15	91744186	91744660	LINE/L2	851	+	237	91744423	19733
chr15	47112285	47312285	harbor2	chr15	47191982	47192315	LINE/L2	1036	+	166	47192148	79863
chr15	47112285	47312285	harbor2	chr15	47193687	47194057	LINE/L2	465	+	185	47193872	81587
chr15	64870675	65070675	harbor2	chr15	64897864	64898366	LINE/L2	747	+	251	64898115	27440
chr15	64870675	65070675	harbor2	chr15	64898756	64898963	LINE/L2	607	+	104	64898860	28185
chr15	65809653	66009653	harbor2	chr15	65858022	65858564	LINE/L2	1262	+	271	65858293	48640
chr15	65809653	66009653	harbor2	chr15	65858872	65858996	LINE/L2	903	+	62	65858934	49281
chr15	83186874	83386874	harbor2	chr15	83188607	83189762	LINE/L2	1579	+	578	83189185	2311
chr15	83186874	83386874	harbor2	chr15	83259974	83260022	LINE/L2	441	+	24	83259998	73124
chr15	83186874	83386874	harbor2	chr15	83260497	83260709	LINE/L2	441	+	106	83260603	73729
chr15	50873935	51073935	harbor2	chr15	50941065	50941212	LINE/L2	590	+	74	50941139	67204
chr15	86962707	87162707	harbor2	chr15	86975558	86975934	LINE/L2	527	+	188	86975746	13039
chr15	86962707	87162707	harbor2	chr15	87033781	87034416	LINE/L2	814	+	318	87034099	71392
chr15	86962707	87162707	harbor2	chr15	87050790	87050983	LINE/L2	575	+	96	87050886	88179
chr15	73165131	73365131	harbor2	chr15	73248212	73248778	LINE/L2	417	+	283	73248495	83364
chr15	46402636	46602636	harbor2	chr15	46407304	46408406	LINE/L2	477	+	551	46407855	5219
chr15	46402636	46602636	harbor2	chr15	46408424	46409281	LINE/L2	535	+	428	46408852	6216
chr15	72399976	72599976	harbor2	chr15	72420754	72421019	LINE/L2	514	+	132	72420886	20910
chr15	72399976	72599976	harbor2	chr15	72421705	72421830	LINE/L2	557	+	62	72421767	21791
chr15	72399976	72599976	harbor2	chr15	72452871	72452986	LINE/L2	419	+	58	72452929	52953
chr15	72399976	72599976	harbor2	chr15	72462466	72462623	LINE/L2	457	+	78	72462544	62568
chr15	72399976	72599976	harbor2	chr15	72462923	72463107	LINE/L2	457	+	92	72463015	63039
chr15	72399976	72599976	harbor2	chr15	72463423	72463499	LINE/L2	457	+	38	72463461	63485
chr15	72399976	72599976	harbor2	chr15	72471146	72471729	LINE/L2	1311	+	292	72471438	71462
chr15	72771118	72971118	harbor2	chr15	72812495	72813135	LINE/L2	413	+	320	72812815	41697
chr15	72771118	72971118	harbor2	chr15	72813763	72813944	LINE/L2	415	+	90	72813853	42735
chr15	72771118	72971118	harbor2	chr15	72814242	72814389	LINE/L2	415	+	74	72814316	43198
chr15	72771118	72971118	harbor2	chr15	72831353	72831648	LINE/L2	954	+	148	72831501	60383
chr15	72771118	72971118	harbor2	chr15	72838770	72839053	LINE/L2	875	+	142	72838912	67794
chr15	72771118	72971118	harbor2	chr15	72853400	72853968	LINE/L2	902	+	284	72853684	82566
chr15	72771118	72971118	harbor2	chr15	72865108	72865483	LINE/L2	592	+	188	72865296	94178
chr15	72771118	72971118	harbor2	chr15	72870890	72871103	LINE/L2	645	+	106	72870996	99878
chr15	74879453	75079453	harbor2	chr15	74889338	74889909	LINE/L2	951	+	286	74889624	10171
chr15	74879453	75079453	harbor2	chr15	74972819	74973285	LINE/L2	1471	+	233	74973052	93599
chr15	90341848	90541848	harbor2	chr15	90364449	90365240	LINE/L2	1007	+	396	90364845	22997
chr15	90341848	90541848	harbor2	chr15	90414365	90414959	LINE/L2	499	+	297	90414662	72814
chr15	79788996	79988996	harbor2	chr15	79819628	79820023	LINE/L2	1239	+	198	79819826	30830
chr15	79788996	79988996	harbor2	chr15	79820763	79821225	LINE/L2	1239	+	231	79820994	31998
chr15	79788996	79988996	harbor2	chr15	79821238	79821552	LINE/L2	620	+	157	79821395	32399
chr15	32606916	32806916	harbor2	chr15	32634198	32634283	LINE/L2	2056	+	42	32634240	27324
chr15	32606916	32806916	harbor2	chr15	32634517	32635544	LINE/L2	2056	+	514	32635031	28115
chr15	32606916	32806916	harbor2	chr15	32644005	32644148	LINE/L2	718	+	72	32644077	37161
chr15	32606916	32806916	harbor2	chr15	32647491	32648618	LINE/L2	1045	+	564	32648055	41139
chr15	32606916	32806916	harbor2	chr15	32648693	32648771	LINE/L2	599	+	39	32648732	41816
chr15	32606916	32806916	harbor2	chr15	32649056	32649230	LINE/L2	599	+	87	32649143	42227
chr15	80548489	80748489	harbor2	chr15	80557582	80558333	LINE/L2	613	+	376	80557958	9469
chr15	80548489	80748489	harbor2	chr15	80558640	80558710	LINE/L2	613	+	35	80558675	10186
chr15	80548489	80748489	harbor2	chr15	80588190	80589006	LINE/L2	678	+	408	80588598	40109
chr15	83873308	84073308	harbor2	chr15	83901989	83902272	LINE/L2	424	+	142	83902131	28823
chr15	83873308	84073308	harbor2	chr15	83902570	83902812	LINE/L2	424	+	121	83902691	29383
chr15	91016288	91216288	harbor2	chr15	91063934	91064223	LINE/L2	847	+	144	91064078	47790
chr15	91016288	91216288	harbor2	chr15	91064652	91064945	LINE/L2	425	+	146	91064798	48510
chr15	91016288	91216288	harbor2	chr15	91086891	91086907	LINE/L2	597	+	8	91086899	70611
chr15	91016288	91216288	harbor2	chr15	91087209	91087383	LINE/L2	597	+	87	91087296	71008
chr15	91016288	91216288	harbor2	chr15	91087386	91087527	LINE/L2	567	+	70	91087456	71168
chr15	91016288	91216288	harbor2	chr15	91113922	91114037	LINE/L2	419	+	58	91113980	97692
chr15	31549396	31749396	harbor2	chr15	31553093	31554065	LINE/L2	589	+	486	31553579	4183
chr15	31549396	31749396	harbor2	chr15	31586767	31587355	LINE/L2	915	+	294	31587061	37665
chr15	31549396	31749396	harbor2	chr15	31587660	31587984	LINE/L2	915	+	162	31587822	38426
chr15	31549396	31749396	harbor2	chr15	31647474	31647739	LINE/L2	662	+	132	31647606	98210
chr15	101215872	101415872	harbor2	chr15	101220199	101220386	LINE/L2	421	+	94	101220293	4421
chr15	59188238	59388238	harbor2	chr15	59211288	59212164	LINE/L2	1708	+	438	59211726	23488
chr15	53241676	53441676	harbor2	chr15	53266753	53267406	LINE/L2	1261	+	326	53267079	25403
chr15	64792502	64992502	harbor2	chr15	64837485	64837860	LINE/L2	687	+	188	64837673	45171
chr15	49478674	49678674	harbor2	chr15	49490317	49490455	LINE/L2	589	+	69	49490386	11712
chr15	49478674	49678674	harbor2	chr15	49494514	49494656	LINE/L2	499	+	71	49494585	15911
chr15	49478674	49678674	harbor2	chr15	49494652	49494801	LINE/L2	455	+	74	49494726	16052
chr15	85094668	85294668	harbor2	chr15	85122016	85122335	LINE/L2	408	+	160	85122176	27508
chr15	100617304	100817304	harbor2	chr15	100616864	100617399	LINE/L2	528	+	268	100617132	172
chr15	100617304	100817304	harbor2	chr15	100703639	100703980	LINE/L2	612	+	170	100703809	86505
chr15	56904795	57104795	harbor2	chr15	56911522	56911647	LINE/L2	472	+	62	56911584	6789
chr15	70152281	70352281	harbor2	chr15	70209497	70210041	LINE/L2	1272	+	272	70209769	57488
chr15	70152281	70352281	harbor2	chr15	70223172	70223750	LINE/L2	675	+	289	70223461	71180
chr15	70152281	70352281	harbor2	chr15	70224316	70224506	LINE/L2	468	+	95	70224411	72130
chr15	70152281	70352281	harbor2	chr15	70238007	70238257	LINE/L2	438	+	125	70238132	85851
chr15	46579099	46779099	harbor2	chr15	46592438	46592740	LINE/L2	415	+	151	46592589	13490
chr15	46579099	46779099	harbor2	chr15	46642526	46643191	LINE/L2	503	+	332	46642858	63759
chr15	94336859	94536859	harbor2	chr15	94428942	94430393	LINE/L2	2531	+	726	94429668	92809
chr15	94336859	94536859	harbor2	chr15	94430781	94431117	LINE/L2	2531	+	168	94430949	94090
chr15	96687571	96887571	harbor2	chr15	96730293	96730560	LINE/L2	908	+	134	96730427	42856
chr15	96687571	96887571	harbor2	chr15	96731055	96731758	LINE/L2	926	+	352	96731407	43836
chr15	95125754	95325754	harbor2	chr15	95144673	95145685	LINE/L2	1244	+	506	95145179	19425
chr15	53117023	53317023	harbor2	chr15	53164464	53164618	LINE/L2	422	+	77	53164541	47518
chr15	96913477	97113477	harbor2	chr15	96959845	96960113	LINE/L2	443	+	134	96959979	46502
chr15	33092032	33292032	harbor2	chr15	33106838	33107692	LINE/L2	1689	+	427	33107265	15233
chr15	33092032	33292032	harbor2	chr15	33135840	33136033	LINE/L2	512	+	96	33135936	43904
chr15	33092032	33292032	harbor2	chr15	33179404	33179747	LINE/L2	745	+	172	33179576	87544
chr15	38845904	39045904	harbor2	chr15	38866234	38866517	LINE/L2	417	+	142	38866376	20472
chr15	38845904	39045904	harbor2	chr15	38882038	38882322	LINE/L2	832	+	142	38882180	36276
chr15	38845904	39045904	harbor2	chr15	38907713	38908124	LINE/L2	489	+	206	38907919	62015
chr15	35814653	36014653	harbor2	chr15	35820020	35820768	LINE/L2	1138	+	374	35820394	5741
chr15	35814653	36014653	harbor2	chr15	35825564	35825936	LINE/L2	547	+	186	35825750	11097
chr15	35814653	36014653	harbor2	chr15	35877937	35878487	LINE/L2	909	+	275	35878212	63559
chr15	35814653	36014653	harbor2	chr15	35897827	35898356	LINE/L2	1381	+	264	35898091	83438
chr15	75063395	75263395	harbor2	chr15	75151854	75152060	LINE/L2	483	+	103	75151957	88562
chr15	100141767	100341767	harbor2	chr15	100227960	100228470	LINE/L2	566	+	255	100228215	86448
chr15	100141767	100341767	harbor2	chr15	100238194	100238482	LINE/L2	737	+	144	100238338	96571
chr15	61523963	61723963	harbor2	chr15	61529217	61529484	LINE/L2	575	+	134	61529351	5388
chr15	61523963	61723963	harbor2	chr15	61547115	61547492	LINE/L2	526	+	188	61547303	23340
chr15	61523963	61723963	harbor2	chr15	61561245	61561594	LINE/L2	807	+	174	61561419	37456
chr15	61523963	61723963	harbor2	chr15	61584806	61585159	LINE/L2	431	+	176	61584982	61019
chr15	46828330	47028330	harbor2	chr15	46869336	46869573	LINE/L2	520	+	118	46869454	41124
chr15	46828330	47028330	harbor2	chr15	46895627	46895776	LINE/L2	429	+	74	46895701	67371
chr15	70354617	70554617	harbor2	chr15	70420935	70421452	LINE/L2	924	+	258	70421193	66576
chr15	70354617	70554617	harbor2	chr15	70448659	70449056	LINE/L2	540	+	198	70448857	94240
chr15	71015917	71215917	harbor2	chr15	71091016	71091172	LINE/L2	559	+	78	71091094	75177
chr15	71015917	71215917	harbor2	chr15	71090127	71090428	LINE/L2	493	+	150	71090277	74360
chr15	91506756	91706756	harbor2	chr15	91600244	91602207	LINE/L2	3696	+	982	91601226	94470
chr15	89008472	89208472	harbor2	chr15	89039808	89039957	LINE/L2	486	+	74	89039882	31410
chr15	89008472	89208472	harbor2	chr15	89078067	89078312	LINE/L2	448	+	122	89078189	69717
chr15	78152046	78352046	harbor2	chr15	78228749	78228986	LINE/L2	731	+	118	78228867	76821
chr15	78152046	78352046	harbor2	chr15	78229073	78229265	LINE/L2	731	+	96	78229169	77123
chr15	67739019	67939019	harbor2	chr15	67807604	67807823	LINE/L2	447	+	110	67807714	68695
chr15	67739019	67939019	harbor2	chr15	67808410	67808775	LINE/L2	832	+	182	67808592	69573
chr15	67739019	67939019	harbor2	chr15	67815587	67815804	LINE/L2	509	+	108	67815695	76676
chr15	67739019	67939019	harbor2	chr15	67813271	67813708	LINE/L2	579	+	218	67813489	74470
chr15	42940846	43140846	harbor2	chr15	42964520	42965017	LINE/L2	750	+	248	42964768	23922
chr15	42940846	43140846	harbor2	chr15	42998501	42998844	LINE/L2	1131	+	172	42998673	57827
chr15	42940846	43140846	harbor2	chr15	42998860	42998937	LINE/L2	841	+	38	42998898	58052
chr15	42940846	43140846	harbor2	chr15	42999239	42999517	LINE/L2	841	+	139	42999378	58532
chr15	42940846	43140846	harbor2	chr15	43019980	43020044	LINE/L2	1118	+	32	43020012	79166
chr15	42940846	43140846	harbor2	chr15	43020341	43021072	LINE/L2	1118	+	366	43020707	79861
chr15	28783766	28983766	harbor2	chr15	28811957	28812197	LINE/L2	442	+	120	28812077	28311
chr15	93250665	93450665	harbor2	chr15	93284703	93285045	LINE/L2	445	+	171	93284874	34209
chr15	101752643	101952643	harbor2	chr15	101847182	101847910	LINE/L2	1597	+	364	101847546	94903
chr15	71615979	71815979	harbor2	chr15	71714275	71714369	LINE/L2	529	+	47	71714322	98343
chr15	60089029	60289029	harbor2	chr15	60092704	60092807	LINE/L2	452	+	52	60092756	3727
chr15	60089029	60289029	harbor2	chr15	60109508	60109810	LINE/L2	720	+	151	60109659	20630
chr15	60089029	60289029	harbor2	chr15	60110259	60110385	LINE/L2	524	+	63	60110322	21293
chr15	60089029	60289029	harbor2	chr15	60110382	60110812	LINE/L2	1300	+	215	60110597	21568
chr15	60089029	60289029	harbor2	chr15	60184687	60184941	LINE/L2	416	+	127	60184814	95785
chr15	99543281	99743281	harbor2	chr15	99557943	99558363	LINE/L2	782	+	210	99558153	14872
chr15	99543281	99743281	harbor2	chr15	99571595	99572612	LINE/L2	1218	+	508	99572103	28822
chr15	99543281	99743281	harbor2	chr15	99595298	99595564	LINE/L2	578	+	133	99595431	52150
chr15	89282749	89482749	harbor2	chr15	89342062	89342250	LINE/L2	513	+	94	89342156	59407
chr15	78036193	78236193	harbor2	chr15	78070146	78070540	LINE/L2	611	+	197	78070343	34150
chr15	78036193	78236193	harbor2	chr15	78080380	78080546	LINE/L2	421	+	83	78080463	44270
chr15	78036193	78236193	harbor2	chr15	78091730	78092132	LINE/L2	742	+	201	78091931	55738
chr15	78036193	78236193	harbor2	chr15	78099660	78100247	LINE/L2	863	+	294	78099954	63761
chr15	77651376	77851376	harbor2	chr15	77673404	77673844	LINE/L2	2032	+	220	77673624	22248
chr15	77651376	77851376	harbor2	chr15	77674005	77674964	LINE/L2	2032	+	480	77674485	23109
chr15	77651376	77851376	harbor2	chr15	77706251	77706830	LINE/L2	458	+	290	77706541	55165
chr15	77651376	77851376	harbor2	chr15	77712175	77713001	LINE/L2	857	+	413	77712588	61212
chr15	77651376	77851376	harbor2	chr15	77713783	77714545	LINE/L2	848	+	381	77714164	62788
chr15	77651376	77851376	harbor2	chr15	77721209	77721637	LINE/L2	586	+	214	77721423	70047
chr15	77651376	77851376	harbor2	chr15	77737811	77738747	LINE/L2	585	+	468	77738279	86903
chr15	94180151	94380151	harbor2	chr15	94266331	94266490	LINE/L2	543	+	80	94266411	86260
chr15	94180151	94380151	harbor2	chr15	94270442	94270948	LINE/L2	562	+	253	94270695	90544
chr15	94180151	94380151	harbor2	chr15	94272470	94273054	LINE/L2	822	+	292	94272762	92611
chr15	94180151	94380151	harbor2	chr15	94256849	94257273	LINE/L2	460	+	212	94257061	76910
chr15	54572176	54772176	harbor2	chr15	54655510	54656419	LINE/L2	906	+	454	54655964	83788
chr15	46256172	46456172	harbor2	chr15	46272686	46272876	LINE/L2	410	+	95	46272781	16609
chr15	46256172	46456172	harbor2	chr15	46295124	46295317	LINE/L2	547	+	96	46295220	39048
chr15	46256172	46456172	harbor2	chr15	46295329	46295728	LINE/L2	1000	+	200	46295529	39357
chr15	46256172	46456172	harbor2	chr15	46345429	46346138	LINE/L2	1113	+	354	46345783	89611
chr15	100133680	100333680	harbor2	chr15	100227960	100228470	LINE/L2	566	+	255	100228215	94535
chr15	89165022	89365022	harbor2	chr15	89215814	89216213	LINE/L2	1158	+	200	89216014	50992
chr15	89165022	89365022	harbor2	chr15	89256860	89256897	LINE/L2	908	+	18	89256878	91856
chr15	89165022	89365022	harbor2	chr15	89257206	89257313	LINE/L2	908	+	54	89257260	92238
chr15	89165022	89365022	harbor2	chr15	89257764	89258457	LINE/L2	908	+	346	89258110	93088
chr15	101267964	101467964	harbor2	chr15	101337649	101337813	LINE/L2	509	+	82	101337731	69767
chr15	101267964	101467964	harbor2	chr15	101359810	101360506	LINE/L2	1526	+	348	101360158	92194
chr15	101267964	101467964	harbor2	chr15	101360690	101361049	LINE/L2	1129	+	180	101360870	92906
chr15	62546554	62746554	harbor2	chr15	62644030	62644437	LINE/L2	493	+	204	62644234	97680
chr15	92559666	92759666	harbor2	chr15	92602428	92602554	LINE/L2	545	+	63	92602491	42825
chr15	92559666	92759666	harbor2	chr15	92604916	92605033	LINE/L2	491	+	58	92604974	45308
chr15	92008538	92208538	harbor2	chr15	92010836	92011276	LINE/L2	665	+	220	92011056	2518
chr15	92008538	92208538	harbor2	chr15	92093637	92093755	LINE/L2	479	+	59	92093696	85158
chr15	38775966	38975966	harbor2	chr15	38816960	38817307	LINE/L2	416	+	174	38817134	41168
chr15	38775966	38975966	harbor2	chr15	38866234	38866517	LINE/L2	417	+	142	38866376	90410
chr15	87433606	87633606	harbor2	chr15	87445922	87447351	LINE/L2	821	+	714	87446636	13030
chr15	87433606	87633606	harbor2	chr15	87495535	87496275	LINE/L2	577	+	370	87495905	62299
chr15	87433606	87633606	harbor2	chr15	87506947	87507164	LINE/L2	627	+	108	87507055	73449
chr15	87433606	87633606	harbor2	chr15	87507517	87508227	LINE/L2	868	+	355	87507872	74266
chr16	83272094	83472094	harbor2	chr16	83274900	83275160	LINE/L2	464	+	130	83275030	2936
chr16	59638626	59838626	harbor2	chr16	59691226	59691874	LINE/L2	576	+	324	59691550	52924
chr16	85305309	85505309	harbor2	chr16	85320758	85321221	LINE/L2	719	+	232	85320990	15681
chr16	85305309	85505309	harbor2	chr16	85339832	85339964	LINE/L2	442	+	66	85339898	34589
chr16	85305309	85505309	harbor2	chr16	85343774	85344059	LINE/L2	556	+	142	85343916	38607
chr16	85305309	85505309	harbor2	chr16	85345443	85345850	LINE/L2	1003	+	204	85345647	40338
chr16	85305309	85505309	harbor2	chr16	85387339	85387815	LINE/L2	988	+	238	85387577	82268
chr16	32067627	32267627	harbor2	chr16	32093921	32094274	LINE/L2	498	+	176	32094097	26470
chr16	85310590	85510590	harbor2	chr16	85320758	85321221	LINE/L2	719	+	232	85320990	10400
chr16	85310590	85510590	harbor2	chr16	85339832	85339964	LINE/L2	442	+	66	85339898	29308
chr16	85310590	85510590	harbor2	chr16	85343774	85344059	LINE/L2	556	+	142	85343916	33326
chr16	85310590	85510590	harbor2	chr16	85345443	85345850	LINE/L2	1003	+	204	85345647	35057
chr16	85310590	85510590	harbor2	chr16	85387339	85387815	LINE/L2	988	+	238	85387577	76987
chr16	87814657	88014657	harbor2	chr16	87885636	87886020	LINE/L2	507	+	192	87885828	71171
chr16	57436404	57636404	harbor2	chr16	57484599	57484990	LINE/L2	417	+	196	57484795	48391
chr16	57436404	57636404	harbor2	chr16	57517158	57517341	LINE/L2	549	+	92	57517250	80846
chr16	57436404	57636404	harbor2	chr16	57517643	57517911	LINE/L2	549	+	134	57517777	81373
chr16	57436404	57636404	harbor2	chr16	57518940	57519357	LINE/L2	598	+	208	57519148	82744
chr16	57436404	57636404	harbor2	chr16	57520173	57520511	LINE/L2	688	+	169	57520342	83938
chr16	57436404	57636404	harbor2	chr16	57524817	57525075	LINE/L2	854	+	129	57524946	88542
chr16	57436404	57636404	harbor2	chr16	57525401	57525535	LINE/L2	854	+	67	57525468	89064
chr16	57436404	57636404	harbor2	chr16	57525606	57525736	LINE/L2	577	+	65	57525671	89267
chr16	57436404	57636404	harbor2	chr16	57527858	57527947	LINE/L2	537	+	44	57527902	91498
chr16	57436404	57636404	harbor2	chr16	57528118	57528251	LINE/L2	537	+	66	57528184	91780
chr16	57436404	57636404	harbor2	chr16	57531570	57531993	LINE/L2	615	+	212	57531782	95378
chr16	69807420	70007420	harbor2	chr16	69818527	69819505	LINE/L2	1475	+	489	69819016	11596
chr16	69807420	70007420	harbor2	chr16	69820626	69820809	LINE/L2	453	+	92	69820718	13298
chr16	69807420	70007420	harbor2	chr16	69833974	69834520	LINE/L2	1022	+	273	69834247	26827
chr16	69807420	70007420	harbor2	chr16	69834828	69834985	LINE/L2	1009	+	78	69834906	27486
chr16	69807420	70007420	harbor2	chr16	69891889	69892147	LINE/L2	465	+	129	69892018	84598
chr16	19590965	19790965	harbor2	chr16	19605357	19605974	LINE/L2	1077	+	308	19605665	14700
chr16	19590965	19790965	harbor2	chr16	19687004	19687166	LINE/L2	417	+	81	19687085	96120
chr16	52206352	52406352	harbor2	chr16	52219316	52219566	LINE/L2	440	+	125	52219441	13089
chr16	52206352	52406352	harbor2	chr16	52267057	52267599	LINE/L2	517	+	271	52267328	60976
chr16	52206352	52406352	harbor2	chr16	52277250	52277416	LINE/L2	445	+	83	52277333	70981
chr16	52206352	52406352	harbor2	chr16	52280711	52281064	LINE/L2	651	+	176	52280887	74535
chr16	63195089	63395089	harbor2	chr16	63229317	63229566	LINE/L2	574	+	124	63229441	34352
chr16	68870847	69070847	harbor2	chr16	68897239	68897448	LINE/L2	621	+	104	68897343	26496
chr16	86002399	86202399	harbor2	chr16	86072343	86072795	LINE/L2	928	+	226	86072569	70170
chr16	68926297	69126297	harbor2	chr16	68988068	68988424	LINE/L2	751	+	178	68988246	61949
chr16	68926297	69126297	harbor2	chr16	69015954	69016245	LINE/L2	440	+	146	69016100	89803
chr16	68926297	69126297	harbor2	chr16	69021002	69021637	LINE/L2	1229	+	318	69021320	95023
chr16	67660371	67860371	harbor2	chr16	67711254	67712112	LINE/L2	2574	+	429	67711683	51312
chr16	74688122	74888122	harbor2	chr16	74751860	74752521	LINE/L2	1502	+	330	74752190	64068
chr16	74688122	74888122	harbor2	chr16	74772053	74772551	LINE/L2	769	+	249	74772302	84180
chr16	31168791	31368791	harbor2	chr16	31178610	31178705	LINE/L2	459	+	48	31178658	9867
chr16	31168791	31368791	harbor2	chr16	31248804	31248925	LINE/L2	439	+	60	31248864	80073
chr16	82630977	82830977	harbor2	chr16	82635073	82635234	LINE/L2	569	+	80	82635153	4176
chr16	82630977	82830977	harbor2	chr16	82676097	82676810	LINE/L2	694	+	356	82676453	45476
chr16	82630977	82830977	harbor2	chr16	82700981	82701325	LINE/L2	416	+	172	82701153	70176
chr16	67253672	67453672	harbor2	chr16	67257714	67258196	LINE/L2	469	+	241	67257955	4283
chr16	67253672	67453672	harbor2	chr16	67310183	67310329	LINE/L2	419	+	73	67310256	56584
chr16	67253672	67453672	harbor2	chr16	67312463	67312914	LINE/L2	1415	+	226	67312689	59017
chr16	67253672	67453672	harbor2	chr16	67315125	67315305	LINE/L2	525	+	90	67315215	61543
chr16	67253672	67453672	harbor2	chr16	67315914	67316035	LINE/L2	525	+	60	67315974	62302
chr16	67253672	67453672	harbor2	chr16	67316339	67316430	LINE/L2	525	+	46	67316385	62713
chr16	67253672	67453672	harbor2	chr16	67348700	67348850	LINE/L2	479	+	75	67348775	95103
chr16	79686610	79886610	harbor2	chr16	79701729	79701903	LINE/L2	480	+	87	79701816	15206
chr16	79686610	79886610	harbor2	chr16	79702554	79702619	LINE/L2	480	+	32	79702586	15976
chr16	79686610	79886610	harbor2	chr16	79702941	79703105	LINE/L2	480	+	82	79703023	16413
chr16	55365595	55565595	harbor2	chr16	55402088	55402495	LINE/L2	1052	+	204	55402292	36697
chr16	55365595	55565595	harbor2	chr16	55402833	55403189	LINE/L2	1052	+	178	55403011	37416
chr16	55365595	55565595	harbor2	chr16	55419710	55420262	LINE/L2	1277	+	276	55419986	54391
chr16	55365595	55565595	harbor2	chr16	55423882	55424401	LINE/L2	919	+	260	55424142	58547
chr16	55365595	55565595	harbor2	chr16	55425578	55425721	LINE/L2	594	+	72	55425650	60055
chr16	55365595	55565595	harbor2	chr16	55463751	55464135	LINE/L2	923	+	192	55463943	98348
chr16	85191342	85391342	harbor2	chr16	85287381	85287930	LINE/L2	1296	+	274	85287655	96313
chr16	25546714	25746714	harbor2	chr16	25615280	25615439	LINE/L2	454	+	80	25615360	68646
chr16	25546714	25746714	harbor2	chr16	25621574	25621622	LINE/L2	630	+	24	25621598	74884
chr16	25546714	25746714	harbor2	chr16	25621928	25622323	LINE/L2	630	+	198	25622126	75412
chr16	48168410	48368410	harbor2	chr16	48170310	48170713	LINE/L2	846	+	202	48170512	2102
chr16	48168410	48368410	harbor2	chr16	48173926	48174320	LINE/L2	771	+	197	48174123	5713
chr16	48168410	48368410	harbor2	chr16	48186214	48186454	LINE/L2	533	+	120	48186334	17924
chr16	48168410	48368410	harbor2	chr16	48212163	48212326	LINE/L2	612	+	82	48212245	43835
chr16	48168410	48368410	harbor2	chr16	48212548	48212751	LINE/L2	612	+	102	48212650	44240
chr16	48168410	48368410	harbor2	chr16	48229773	48230262	LINE/L2	696	+	244	48230017	61607
chr16	48168410	48368410	harbor2	chr16	48235248	48235399	LINE/L2	520	+	76	48235324	66914
chr16	48168410	48368410	harbor2	chr16	48236206	48236609	LINE/L2	840	+	202	48236408	67998
chr16	48168410	48368410	harbor2	chr16	48237316	48238122	LINE/L2	1171	+	403	48237719	69309
chr16	66219986	66419986	harbor2	chr16	66233699	66234133	LINE/L2	488	+	217	66233916	13930
chr16	66219986	66419986	harbor2	chr16	66257037	66257321	LINE/L2	587	+	142	66257179	37193
chr16	66219986	66419986	harbor2	chr16	66299096	66299517	LINE/L2	419	+	210	66299306	79320
chr16	69725319	69925319	harbor2	chr16	69765963	69766745	LINE/L2	2221	+	391	69766354	41035
chr16	69725319	69925319	harbor2	chr16	69774161	69774264	LINE/L2	476	+	52	69774213	48894
chr16	69725319	69925319	harbor2	chr16	69774557	69774677	LINE/L2	476	+	60	69774617	49298
chr16	69725319	69925319	harbor2	chr16	69776379	69776480	LINE/L2	447	+	50	69776429	51110
chr16	69725319	69925319	harbor2	chr16	69787649	69788080	LINE/L2	1175	+	216	69787865	62546
chr16	69725319	69925319	harbor2	chr16	69788335	69788863	LINE/L2	1175	+	264	69788599	63280
chr16	69725319	69925319	harbor2	chr16	69818527	69819505	LINE/L2	1475	+	489	69819016	93697
chr16	69725319	69925319	harbor2	chr16	69820626	69820809	LINE/L2	453	+	92	69820718	95399
chr16	71750767	71950767	harbor2	chr16	71753243	71753783	LINE/L2	1116	+	270	71753513	2746
chr16	64182656	64382656	harbor2	chr16	64183206	64183579	LINE/L2	413	+	186	64183392	736
chr16	64182656	64382656	harbor2	chr16	64210365	64210756	LINE/L2	421	+	196	64210561	27905
chr16	47702617	47902617	harbor2	chr16	47719053	47719769	LINE/L2	1743	+	358	47719411	16794
chr16	47702617	47902617	harbor2	chr16	47720247	47720580	LINE/L2	1743	+	166	47720413	17796
chr16	47702617	47902617	harbor2	chr16	47783117	47783593	LINE/L2	502	+	238	47783355	80738
chr16	47702617	47902617	harbor2	chr16	47786308	47786897	LINE/L2	840	+	294	47786602	83985
chr16	55133832	55333832	harbor2	chr16	55172127	55172396	LINE/L2	428	+	134	55172261	38429
chr16	55727263	55927263	harbor2	chr16	55770255	55770380	LINE/L2	425	+	62	55770317	43054
chr16	55727263	55927263	harbor2	chr16	55815556	55816333	LINE/L2	1429	+	388	55815944	88681
chr16	55727263	55927263	harbor2	chr16	55770882	55772197	LINE/L2	964	+	658	55771540	44277
chr16	88811014	89011014	harbor2	chr16	88891157	88891352	LINE/L2	487	+	98	88891255	80241
chr16	72858727	73058727	harbor2	chr16	72949800	72950017	LINE/L2	480	+	108	72949908	91181
chr16	31252007	31452007	harbor2	chr16	31275988	31276077	LINE/L2	488	+	44	31276032	24025
chr16	63181513	63381513	harbor2	chr16	63229317	63229566	LINE/L2	574	+	124	63229441	47928
chr16	56750865	56950865	harbor2	chr16	56805685	56806411	LINE/L2	2120	+	363	56806048	55183
chr16	56750865	56950865	harbor2	chr16	56806901	56807557	LINE/L2	1319	+	328	56807229	56364
chr16	84881189	85081189	harbor2	chr16	84888605	84889040	LINE/L2	880	+	218	84888823	7634
chr16	84881189	85081189	harbor2	chr16	84898254	84898777	LINE/L2	424	+	262	84898516	17327
chr16	64417972	64617972	harbor2	chr16	64450016	64450398	LINE/L2	430	+	191	64450207	32235
chr16	64417972	64617972	harbor2	chr16	64461248	64461929	LINE/L2	491	+	340	64461588	43616
chr16	77268992	77468992	harbor2	chr16	77285740	77286481	LINE/L2	806	+	370	77286110	17118
chr16	77268992	77468992	harbor2	chr16	77303307	77303607	LINE/L2	561	+	150	77303457	34465
chr16	77268992	77468992	harbor2	chr16	77323795	77323927	LINE/L2	437	+	66	77323861	54869
chr16	77268992	77468992	harbor2	chr16	77345232	77345604	LINE/L2	1739	+	186	77345418	76426
chr16	77268992	77468992	harbor2	chr16	77345799	77346393	LINE/L2	1739	+	297	77346096	77104
chr16	77268992	77468992	harbor2	chr16	77315815	77316258	LINE/L2	673	+	222	77316037	47045
chr16	71158240	71358240	harbor2	chr16	71164877	71165644	LINE/L2	792	+	384	71165261	7021
chr16	71158240	71358240	harbor2	chr16	71167858	71168035	LINE/L2	660	+	88	71167946	9706
chr16	71158240	71358240	harbor2	chr16	71168340	71168435	LINE/L2	660	+	48	71168388	10148
chr16	71158240	71358240	harbor2	chr16	71171011	71171520	LINE/L2	883	+	254	71171265	13025
chr16	71158240	71358240	harbor2	chr16	71192204	71192429	LINE/L2	458	+	112	71192316	34076
chr16	71158240	71358240	harbor2	chr16	71192562	71192861	LINE/L2	711	+	150	71192712	34472
chr16	71158240	71358240	harbor2	chr16	71192889	71193214	LINE/L2	470	+	162	71193051	34811
chr16	71158240	71358240	harbor2	chr16	71200978	71201307	LINE/L2	625	+	164	71201142	42902
chr16	71158240	71358240	harbor2	chr16	71231672	71231903	LINE/L2	418	+	116	71231788	73548
chr16	87626676	87826676	harbor2	chr16	87654070	87654394	LINE/L2	417	+	162	87654232	27556
chr16	27088730	27288730	harbor2	chr16	27114112	27114464	LINE/L2	511	+	176	27114288	25558
chr16	27088730	27288730	harbor2	chr16	27114762	27114873	LINE/L2	511	+	56	27114818	26088
chr16	27088730	27288730	harbor2	chr16	27140544	27140748	LINE/L2	569	+	102	27140646	51916
chr16	27088730	27288730	harbor2	chr16	27141038	27141231	LINE/L2	569	+	96	27141134	52404
chr16	84296737	84496737	harbor2	chr16	84315121	84315477	LINE/L2	966	+	178	84315299	18562
chr16	68557194	68757194	harbor2	chr16	68569065	68569136	LINE/L2	630	+	36	68569101	11907
chr16	68557194	68757194	harbor2	chr16	68569434	68569619	LINE/L2	630	+	92	68569526	12332
chr16	68557194	68757194	harbor2	chr16	68569824	68570274	LINE/L2	884	+	225	68570049	12855
chr16	68557194	68757194	harbor2	chr16	68592034	68592219	LINE/L2	1043	+	92	68592126	34932
chr16	68557194	68757194	harbor2	chr16	68592580	68592733	LINE/L2	1043	+	76	68592656	35462
chr16	68557194	68757194	harbor2	chr16	68593085	68593183	LINE/L2	467	+	49	68593134	35940
chr16	68557194	68757194	harbor2	chr16	68617188	68618001	LINE/L2	2090	+	406	68617594	60400
chr16	68557194	68757194	harbor2	chr16	68619993	68620283	LINE/L2	938	+	145	68620138	62944
chr16	68557194	68757194	harbor2	chr16	68620594	68620749	LINE/L2	673	+	78	68620672	63478
chr16	68557194	68757194	harbor2	chr16	68638926	68638953	LINE/L2	644	+	14	68638940	81746
chr16	68557194	68757194	harbor2	chr16	68639260	68639401	LINE/L2	644	+	70	68639330	82136
chr16	68557194	68757194	harbor2	chr16	68640838	68641258	LINE/L2	974	+	210	68641048	83854
chr16	68557194	68757194	harbor2	chr16	68642319	68642509	LINE/L2	482	+	95	68642414	85220
chr16	55829308	56029308	harbor2	chr16	55872239	55872588	LINE/L2	418	+	174	55872413	43105
chr16	55829308	56029308	harbor2	chr16	55916796	55917245	LINE/L2	692	+	224	55917020	87712
chr16	66765186	66965186	harbor2	chr16	66814684	66815203	LINE/L2	813	+	260	66814944	49758
chr16	66765186	66965186	harbor2	chr16	66835972	66836183	LINE/L2	445	+	106	66836078	70892
chr16	82255839	82455839	harbor2	chr16	82317818	82317974	LINE/L2	520	+	78	82317896	62057
chr16	82255839	82455839	harbor2	chr16	82326710	82327391	LINE/L2	777	+	340	82327050	71211
chr16	69708865	69908865	harbor2	chr16	69708689	69708921	LINE/L2	736	+	116	69708805	60
chr16	69708865	69908865	harbor2	chr16	69765963	69766745	LINE/L2	2221	+	391	69766354	57489
chr16	69708865	69908865	harbor2	chr16	69774161	69774264	LINE/L2	476	+	52	69774213	65348
chr16	69708865	69908865	harbor2	chr16	69774557	69774677	LINE/L2	476	+	60	69774617	65752
chr16	69708865	69908865	harbor2	chr16	69776379	69776480	LINE/L2	447	+	50	69776429	67564
chr16	69708865	69908865	harbor2	chr16	69787649	69788080	LINE/L2	1175	+	216	69787865	79000
chr16	69708865	69908865	harbor2	chr16	69788335	69788863	LINE/L2	1175	+	264	69788599	79734
chr16	71433858	71633858	harbor2	chr16	71463375	71463683	LINE/L2	441	+	154	71463529	29671
chr16	71433858	71633858	harbor2	chr16	71521463	71522623	LINE/L2	2054	+	580	71522043	88185
chr16	74683048	74883048	harbor2	chr16	74751860	74752521	LINE/L2	1502	+	330	74752190	69142
chr16	74683048	74883048	harbor2	chr16	74772053	74772551	LINE/L2	769	+	249	74772302	89254
chr16	78449054	78649054	harbor2	chr16	78490971	78491400	LINE/L2	426	+	214	78491185	42131
chr16	78449054	78649054	harbor2	chr16	78533666	78533952	LINE/L2	417	+	143	78533809	84755
chr16	52305392	52505392	harbor2	chr16	52320324	52320618	LINE/L2	1156	+	147	52320471	15079
chr16	52305392	52505392	harbor2	chr16	52320655	52320756	LINE/L2	1156	+	50	52320705	15313
chr16	52305392	52505392	harbor2	chr16	52333171	52333317	LINE/L2	520	+	73	52333244	27852
chr16	52305392	52505392	harbor2	chr16	52369111	52369336	LINE/L2	579	+	112	52369223	63831
chr16	52305392	52505392	harbor2	chr16	52369489	52369572	LINE/L2	579	+	42	52369531	64139
chr16	52305392	52505392	harbor2	chr16	52369883	52369989	LINE/L2	579	+	53	52369936	64544
chr16	52305392	52505392	harbor2	chr16	52398582	52398922	LINE/L2	940	+	170	52398752	93360
chr16	52869549	53069549	harbor2	chr16	52881499	52881850	LINE/L2	943	+	176	52881675	12126
chr16	52869549	53069549	harbor2	chr16	52882028	52882105	LINE/L2	943	+	38	52882066	12517
chr16	52869549	53069549	harbor2	chr16	52930568	52930697	LINE/L2	428	+	64	52930632	61083
chr16	17117083	17317083	harbor2	chr16	17118639	17119220	LINE/L2	604	+	290	17118929	1846
chr16	17117083	17317083	harbor2	chr16	17120348	17120816	LINE/L2	549	+	234	17120582	3499
chr16	17117083	17317083	harbor2	chr16	17125369	17125892	LINE/L2	940	+	262	17125631	8548
chr16	17117083	17317083	harbor2	chr16	17130653	17131165	LINE/L2	466	+	256	17130909	13826
chr16	17117083	17317083	harbor2	chr16	17148262	17148527	LINE/L2	985	+	132	17148394	31311
chr16	17117083	17317083	harbor2	chr16	17159254	17159573	LINE/L2	623	+	160	17159414	42331
chr16	17117083	17317083	harbor2	chr16	17176901	17177200	LINE/L2	551	+	150	17177051	59968
chr16	17117083	17317083	harbor2	chr16	17179483	17179697	LINE/L2	465	+	107	17179590	62507
chr16	17117083	17317083	harbor2	chr16	17197071	17197449	LINE/L2	700	+	189	17197260	80177
chr16	17117083	17317083	harbor2	chr16	17202487	17202874	LINE/L2	770	+	194	17202681	85598
chr16	47907362	48107362	harbor2	chr16	47958220	47958890	LINE/L2	745	+	335	47958555	51193
chr16	70051233	70251233	harbor2	chr16	70070036	70070259	LINE/L2	433	+	112	70070148	18915
chr16	70051233	70251233	harbor2	chr16	70070557	70070622	LINE/L2	433	+	32	70070589	19356
chr16	70051233	70251233	harbor2	chr16	70119366	70119895	LINE/L2	503	+	264	70119630	68397
chr16	12748454	12948454	harbor2	chr16	12771200	12771301	LINE/L2	439	+	50	12771250	22796
chr16	64840019	65040019	harbor2	chr16	64845233	64845688	LINE/L2	868	+	228	64845461	5442
chr16	64840019	65040019	harbor2	chr16	64867449	64867861	LINE/L2	534	+	206	64867655	27636
chr16	64840019	65040019	harbor2	chr16	64933337	64933631	LINE/L2	690	+	147	64933484	93465
chr16	73581244	73781244	harbor2	chr16	73595552	73595976	LINE/L2	431	+	212	73595764	14520
chr16	73581244	73781244	harbor2	chr16	73638644	73638805	LINE/L2	417	+	80	73638724	57480
chr16	83009664	83209664	harbor2	chr16	83091702	83091826	LINE/L2	535	+	62	83091764	82100
chr16	80197618	80397618	harbor2	chr16	80230938	80231182	LINE/L2	471	+	122	80231060	33442
chr16	51091425	51291425	harbor2	chr16	51105490	51105776	LINE/L2	499	+	143	51105633	14208
chr16	51091425	51291425	harbor2	chr16	51124805	51124946	LINE/L2	551	+	70	51124875	33450
chr16	75062971	75262971	harbor2	chr16	75140435	75140654	LINE/L2	583	+	110	75140545	77574
chr16	80687316	80887316	harbor2	chr16	80724752	80725167	LINE/L2	679	+	208	80724960	37644
chr16	80687316	80887316	harbor2	chr16	80725221	80725534	LINE/L2	679	+	156	80725377	38061
chr16	80687316	80887316	harbor2	chr16	80733772	80733975	LINE/L2	449	+	102	80733874	46558
chr16	65614012	65814012	harbor2	chr16	65646117	65646642	LINE/L2	1300	+	262	65646379	32367
chr16	65594336	65794336	harbor2	chr16	65601165	65601484	LINE/L2	422	+	160	65601325	6989
chr16	65594336	65794336	harbor2	chr16	65646117	65646642	LINE/L2	1300	+	262	65646379	52043
chr16	64645605	64845605	harbor2	chr16	64684559	64685084	LINE/L2	994	+	262	64684821	39216
chr16	64645605	64845605	harbor2	chr16	64683621	64684202	LINE/L2	994	+	290	64683911	38306
chr16	20689644	20889644	harbor2	chr16	20711909	20712100	LINE/L2	451	+	96	20712005	22361
chr16	20689644	20889644	harbor2	chr16	20727107	20727224	LINE/L2	439	+	58	20727165	37521
chr16	20689644	20889644	harbor2	chr16	20765555	20765726	LINE/L2	506	+	86	20765641	75997
chr16	71971474	72171474	harbor2	chr16	71994122	71994503	LINE/L2	949	+	190	71994312	22838
chr16	50305798	50505798	harbor2	chr16	50324170	50324787	LINE/L2	886	+	308	50324478	18680
chr16	50305798	50505798	harbor2	chr16	50380214	50380582	LINE/L2	586	+	184	50380398	74600
chr16	50305798	50505798	harbor2	chr16	50380869	50381067	LINE/L2	586	+	99	50380968	75170
chr16	78399454	78599454	harbor2	chr16	78490971	78491400	LINE/L2	426	+	214	78491185	91731
chr16	83057426	83257426	harbor2	chr16	83091702	83091826	LINE/L2	535	+	62	83091764	34338
chr16	83057426	83257426	harbor2	chr16	83142468	83142765	LINE/L2	621	+	148	83142616	85190
chr16	73133967	73333967	harbor2	chr16	73169819	73170118	LINE/L2	625	+	150	73169969	36002
chr16	27295733	27495733	harbor2	chr16	27304092	27304173	LINE/L2	431	+	40	27304132	8399
chr16	27295733	27495733	harbor2	chr16	27325854	27326246	LINE/L2	872	+	196	27326050	30317
chr16	27295733	27495733	harbor2	chr16	27357826	27357883	LINE/L2	523	+	28	27357854	62121
chr16	27295733	27495733	harbor2	chr16	27358194	27358355	LINE/L2	523	+	80	27358274	62541
chr16	27295733	27495733	harbor2	chr16	27373664	27373839	LINE/L2	580	+	88	27373752	78019
chr16	27295733	27495733	harbor2	chr16	27379944	27380081	LINE/L2	465	+	68	27380012	84279
chr16	27295733	27495733	harbor2	chr16	27311933	27312207	LINE/L2	466	+	137	27312070	16337
chr16	82613937	82813937	harbor2	chr16	82635073	82635234	LINE/L2	569	+	80	82635153	21216
chr16	82613937	82813937	harbor2	chr16	82676097	82676810	LINE/L2	694	+	356	82676453	62516
chr16	82613937	82813937	harbor2	chr16	82700981	82701325	LINE/L2	416	+	172	82701153	87216
chr16	10565624	10765624	harbor2	chr16	10566897	10567279	LINE/L2	542	+	191	10567088	1464
chr16	10565624	10765624	harbor2	chr16	10644466	10644737	LINE/L2	449	+	136	10644602	78978
chr16	10565624	10765624	harbor2	chr16	10651184	10651502	LINE/L2	965	+	159	10651343	85719
chr16	10565624	10765624	harbor2	chr16	10664088	10664266	LINE/L2	640	+	89	10664177	98553
chr16	51621469	51821469	harbor2	chr16	51678050	51678558	LINE/L2	514	+	254	51678304	56835
chr16	64909815	65109815	harbor2	chr16	64933337	64933631	LINE/L2	690	+	147	64933484	23669
chr16	64909815	65109815	harbor2	chr16	64949270	64949414	LINE/L2	458	+	72	64949342	39527
chr16	64909815	65109815	harbor2	chr16	64949726	64949937	LINE/L2	458	+	106	64949832	40017
chr16	64909815	65109815	harbor2	chr16	64952000	64952433	LINE/L2	593	+	216	64952216	42401
chr16	77612590	77812590	harbor2	chr16	77650764	77651169	LINE/L2	584	+	202	77650966	38376
chr16	77612590	77812590	harbor2	chr16	77664189	77664469	LINE/L2	451	+	140	77664329	51739
chr16	77612590	77812590	harbor2	chr16	77664780	77664887	LINE/L2	451	+	54	77664834	52244
chr16	83433773	83633773	harbor2	chr16	83435356	83435929	LINE/L2	528	+	286	83435642	1869
chr16	83433773	83633773	harbor2	chr16	83522920	83523300	LINE/L2	639	+	190	83523110	89337
chr16	79614129	79814129	harbor2	chr16	79663542	79663904	LINE/L2	469	+	181	79663723	49594
chr16	79614129	79814129	harbor2	chr16	79701729	79701903	LINE/L2	480	+	87	79701816	87687
chr16	79614129	79814129	harbor2	chr16	79702554	79702619	LINE/L2	480	+	32	79702586	88457
chr16	79614129	79814129	harbor2	chr16	79702941	79703105	LINE/L2	480	+	82	79703023	88894
chr16	68483543	68683543	harbor2	chr16	68536851	68537131	LINE/L2	464	+	140	68536991	53448
chr16	68483543	68683543	harbor2	chr16	68569065	68569136	LINE/L2	630	+	36	68569101	85558
chr16	68483543	68683543	harbor2	chr16	68569434	68569619	LINE/L2	630	+	92	68569526	85983
chr16	68483543	68683543	harbor2	chr16	68569824	68570274	LINE/L2	884	+	225	68570049	86506
chr16	67349501	67549501	harbor2	chr16	67407483	67407802	LINE/L2	425	+	160	67407643	58142
chr16	86233989	86433989	harbor2	chr16	86318321	86318569	LINE/L2	573	+	124	86318445	84456
chr16	69191513	69391513	harbor2	chr16	69237939	69238019	LINE/L2	1912	+	40	69237979	46466
chr16	69191513	69391513	harbor2	chr16	69244725	69244942	LINE/L2	423	+	108	69244833	53320
chr16	69191513	69391513	harbor2	chr16	69238489	69239317	LINE/L2	1912	+	414	69238903	47390
chr16	61692513	61892513	harbor2	chr16	61705917	61706046	LINE/L2	425	+	64	61705981	13468
chr16	89877231	90077231	harbor2	chr16	89944816	89945268	LINE/L2	495	+	226	89945042	67811
chr16	74990404	75190404	harbor2	chr16	75027510	75028287	LINE/L2	2044	+	388	75027898	37494
chr16	74990404	75190404	harbor2	chr16	75028595	75028643	LINE/L2	2044	+	24	75028619	38215
chr16	58071046	58271046	harbor2	chr16	58142111	58142186	LINE/L2	708	+	38	58142149	71103
chr16	58071046	58271046	harbor2	chr16	58142450	58142687	LINE/L2	708	+	118	58142568	71522
chr16	58071046	58271046	harbor2	chr16	58143704	58144162	LINE/L2	1811	+	229	58143933	72887
chr16	58071046	58271046	harbor2	chr16	58144526	58144636	LINE/L2	1811	+	55	58144581	73535
chr16	58071046	58271046	harbor2	chr16	58144701	58145341	LINE/L2	1811	+	320	58145021	73975
chr16	58071046	58271046	harbor2	chr16	58145820	58146404	LINE/L2	1811	+	292	58146112	75066
chr16	58071046	58271046	harbor2	chr16	58147134	58147238	LINE/L2	1811	+	52	58147186	76140
chr16	58071046	58271046	harbor2	chr16	58148418	58148693	LINE/L2	528	+	138	58148556	77510
chr16	86864969	87064969	harbor2	chr16	86867116	86867746	LINE/L2	652	+	315	86867431	2462
chr16	83964755	84164755	harbor2	chr16	83966618	83966876	LINE/L2	471	+	129	83966747	1992
chr16	83964755	84164755	harbor2	chr16	83967168	83967364	LINE/L2	471	+	98	83967266	2511
chr16	83964755	84164755	harbor2	chr16	84030343	84030710	LINE/L2	647	+	184	84030527	65772
chr16	83964755	84164755	harbor2	chr16	84030890	84031034	LINE/L2	494	+	72	84030962	66207
chr16	83964755	84164755	harbor2	chr16	84031337	84031531	LINE/L2	494	+	97	84031434	66679
chr16	83175068	83375068	harbor2	chr16	83274900	83275160	LINE/L2	464	+	130	83275030	99962
chr16	75515300	75715300	harbor2	chr16	75521204	75521461	LINE/L2	601	+	128	75521332	6032
chr16	75515300	75715300	harbor2	chr16	75563639	75564295	LINE/L2	1865	+	328	75563967	48667
chr16	75515300	75715300	harbor2	chr16	75564293	75564536	LINE/L2	493	+	122	75564415	49115
chr16	75515300	75715300	harbor2	chr16	75584539	75585304	LINE/L2	637	+	382	75584921	69621
chr16	27197045	27397045	harbor2	chr16	27197053	27197544	LINE/L2	781	+	246	27197299	254
chr16	70161004	70361004	harbor2	chr16	70225680	70225997	LINE/L2	515	+	158	70225838	64834
chr16	85607493	85807493	harbor2	chr16	85683199	85683820	LINE/L2	834	+	310	85683509	76016
chr16	56536773	56736773	harbor2	chr16	56542077	56542380	LINE/L2	420	+	152	56542229	5456
chr16	56536773	56736773	harbor2	chr16	56549954	56550325	LINE/L2	496	+	186	56550140	13367
chr16	88897369	89097369	harbor2	chr16	88912367	88912708	LINE/L2	422	+	170	88912537	15168
chr16	80249266	80449266	harbor2	chr16	80309245	80310139	LINE/L2	494	+	447	80309692	60426
chr16	77373932	77573932	harbor2	chr16	77383353	77383542	LINE/L2	553	+	94	77383447	9515
chr16	77373932	77573932	harbor2	chr16	77383841	77384148	LINE/L2	553	+	154	77383995	10063
chr16	77373932	77573932	harbor2	chr16	77392165	77392729	LINE/L2	943	+	282	77392447	18515
chr16	77373932	77573932	harbor2	chr16	77441539	77441912	LINE/L2	543	+	186	77441725	67793
chr16	56085230	56285230	harbor2	chr16	56087266	56087420	LINE/L2	475	+	77	56087343	2113
chr16	56085230	56285230	harbor2	chr16	56137342	56137759	LINE/L2	446	+	208	56137550	52320
chr16	56085230	56285230	harbor2	chr16	56138634	56139094	LINE/L2	621	+	230	56138864	53634
chr16	56085230	56285230	harbor2	chr16	56162464	56162623	LINE/L2	559	+	80	56162544	77314
chr16	82627225	82827225	harbor2	chr16	82635073	82635234	LINE/L2	569	+	80	82635153	7928
chr16	82627225	82827225	harbor2	chr16	82676097	82676810	LINE/L2	694	+	356	82676453	49228
chr16	82627225	82827225	harbor2	chr16	82700981	82701325	LINE/L2	416	+	172	82701153	73928
chr16	68049123	68249123	harbor2	chr16	68117888	68118453	LINE/L2	425	+	282	68118170	69047
chr16	68049123	68249123	harbor2	chr16	68118453	68118881	LINE/L2	1145	+	214	68118667	69544
chr16	68049123	68249123	harbor2	chr16	68119167	68119893	LINE/L2	1145	+	363	68119530	70407
chr16	20665978	20865978	harbor2	chr16	20670198	20670776	LINE/L2	746	+	289	20670487	4509
chr16	20665978	20865978	harbor2	chr16	20711909	20712100	LINE/L2	451	+	96	20712005	46027
chr16	20665978	20865978	harbor2	chr16	20727107	20727224	LINE/L2	439	+	58	20727165	61187
chr16	20665978	20865978	harbor2	chr16	20765555	20765726	LINE/L2	506	+	86	20765641	99663
chr16	24390079	24590079	harbor2	chr16	24395547	24395679	LINE/L2	545	+	66	24395613	5534
chr16	24390079	24590079	harbor2	chr16	24407421	24407702	LINE/L2	776	+	140	24407561	17482
chr16	24390079	24590079	harbor2	chr16	24408250	24408282	LINE/L2	776	+	16	24408266	18187
chr16	24390079	24590079	harbor2	chr16	24408988	24409074	LINE/L2	776	+	43	24409031	18952
chr16	81122240	81322240	harbor2	chr16	81164948	81165071	LINE/L2	564	+	62	81165010	42770
chr16	81122240	81322240	harbor2	chr16	81168845	81169008	LINE/L2	436	+	82	81168927	46687
chr16	81122240	81322240	harbor2	chr16	81189356	81189728	LINE/L2	528	+	186	81189542	67302
chr16	81122240	81322240	harbor2	chr16	81190018	81190154	LINE/L2	528	+	68	81190086	67846
chr16	88850236	89050236	harbor2	chr16	88891157	88891352	LINE/L2	487	+	98	88891255	41019
chr16	88850236	89050236	harbor2	chr16	88912367	88912708	LINE/L2	422	+	170	88912537	62301
chr16	72258615	72458615	harbor2	chr16	72290025	72290381	LINE/L2	615	+	178	72290203	31588
chr16	72258615	72458615	harbor2	chr16	72295755	72296124	LINE/L2	535	+	184	72295939	37324
chr16	72258615	72458615	harbor2	chr16	72315895	72316204	LINE/L2	453	+	154	72316049	57434
chr16	53009274	53209274	harbor2	chr16	53082721	53083083	LINE/L2	578	+	181	53082902	73628
chr16	86782651	86982651	harbor2	chr16	86867116	86867746	LINE/L2	652	+	315	86867431	84780
chr17	77138558	77338558	harbor2	chr17	77192210	77192456	LINE/L2	851	+	123	77192333	53775
chr17	8644596	8844596	harbor2	chr17	8656301	8656432	LINE/L2	636	+	66	8656367	11771
chr17	8644596	8844596	harbor2	chr17	8689342	8689563	LINE/L2	564	+	110	8689452	44856
chr17	8644596	8844596	harbor2	chr17	8704689	8704920	LINE/L2	1286	+	116	8704805	60209
chr17	8644596	8844596	harbor2	chr17	8705211	8705667	LINE/L2	1286	+	228	8705439	60843
chr17	54893005	55093005	harbor2	chr17	54947793	54948772	LINE/L2	1427	+	490	54948283	55278
chr17	54893005	55093005	harbor2	chr17	54975684	54976146	LINE/L2	654	+	231	54975915	82910
chr17	49316410	49516410	harbor2	chr17	49376746	49377151	LINE/L2	742	+	202	49376948	60538
chr17	63754062	63954062	harbor2	chr17	63845129	63845488	LINE/L2	559	+	180	63845309	91247
chr17	49317419	49517419	harbor2	chr17	49376746	49377151	LINE/L2	742	+	202	49376948	59529
chr17	46315256	46515256	harbor2	chr17	46373934	46374482	LINE/L2	716	+	274	46374208	58952
chr17	44295669	44495669	harbor2	chr17	44317695	44317852	LINE/L2	679	+	78	44317773	22104
chr17	44295669	44495669	harbor2	chr17	44368456	44368639	LINE/L2	1200	+	92	44368548	72879
chr17	44295669	44495669	harbor2	chr17	44370210	44370224	LINE/L2	1200	+	7	44370217	74548
chr17	44295669	44495669	harbor2	chr17	44370873	44370889	LINE/L2	1200	+	8	44370881	75212
chr17	44295669	44495669	harbor2	chr17	44382677	44383420	LINE/L2	706	+	372	44383049	87380
chr17	44295669	44495669	harbor2	chr17	44367778	44368090	LINE/L2	1200	+	156	44367934	72265
chr17	47312362	47512362	harbor2	chr17	47324759	47325030	LINE/L2	647	+	136	47324895	12533
chr17	47312362	47512362	harbor2	chr17	47325325	47325394	LINE/L2	647	+	34	47325359	12997
chr17	47312362	47512362	harbor2	chr17	47325395	47325905	LINE/L2	1153	+	255	47325650	13288
chr17	47312362	47512362	harbor2	chr17	47325975	47326057	LINE/L2	1153	+	41	47326016	13654
chr17	47312362	47512362	harbor2	chr17	47364596	47365267	LINE/L2	762	+	336	47364932	52570
chr17	68911608	69111608	harbor2	chr17	68993760	68993882	LINE/L2	1904	+	61	68993821	82213
chr17	68911608	69111608	harbor2	chr17	68994176	68995601	LINE/L2	1904	+	712	68994888	83280
chr17	69225434	69425434	harbor2	chr17	69241016	69241888	LINE/L2	1316	+	436	69241452	16018
chr17	69225434	69425434	harbor2	chr17	69282016	69282488	LINE/L2	1071	+	236	69282252	56818
chr17	69225434	69425434	harbor2	chr17	69282792	69282980	LINE/L2	1071	+	94	69282886	57452
chr17	69225434	69425434	harbor2	chr17	69283284	69283845	LINE/L2	1071	+	280	69283564	58130
chr17	62734858	62934858	harbor2	chr17	62799153	62799465	LINE/L2	955	+	156	62799309	64451
chr17	62734858	62934858	harbor2	chr17	62799771	62800193	LINE/L2	955	+	211	62799982	65124
chr17	68581170	68781170	harbor2	chr17	68662992	68663446	LINE/L2	721	+	227	68663219	82049
chr17	68581170	68781170	harbor2	chr17	68663845	68664086	LINE/L2	615	+	120	68663965	82795
chr17	39291348	39491348	harbor2	chr17	39380014	39380800	LINE/L2	1017	+	393	39380407	89059
chr17	76005839	76205839	harbor2	chr17	76025271	76025408	LINE/L2	503	+	68	76025339	19500
chr17	79070439	79270439	harbor2	chr17	79120785	79122303	LINE/L2	2764	+	759	79121544	51105
chr17	79070439	79270439	harbor2	chr17	79153976	79154466	LINE/L2	552	+	245	79154221	83782
chr17	22686880	22886880	harbor2	chr17	22718424	22719031	LINE/L2	936	+	304	22718728	31848
chr17	41415217	41615217	harbor2	chr17	41460344	41460563	LINE/L2	646	+	110	41460454	45237
chr17	41415217	41615217	harbor2	chr17	41460881	41461304	LINE/L2	646	+	212	41461093	45876
chr17	73010629	73210629	harbor2	chr17	73099923	73100100	LINE/L2	638	+	88	73100011	89382
chr17	73010629	73210629	harbor2	chr17	73100407	73100894	LINE/L2	843	+	244	73100651	90022
chr17	65549168	65749168	harbor2	chr17	65604586	65604711	LINE/L2	554	+	62	65604648	55480
chr17	65549168	65749168	harbor2	chr17	65605022	65605089	LINE/L2	554	+	34	65605056	55888
chr17	73930199	74130199	harbor2	chr17	73949344	73949588	LINE/L2	674	+	122	73949466	19267
chr17	37601190	37801190	harbor2	chr17	37648139	37648491	LINE/L2	569	+	176	37648315	47125
chr17	37601190	37801190	harbor2	chr17	37679109	37679344	LINE/L2	559	+	118	37679227	78037
chr17	37601190	37801190	harbor2	chr17	37681722	37682321	LINE/L2	1294	+	300	37682022	80832
chr17	37601190	37801190	harbor2	chr17	37682641	37682688	LINE/L2	1294	+	24	37682665	81475
chr17	37601190	37801190	harbor2	chr17	37682990	37683195	LINE/L2	1294	+	102	37683092	81902
chr17	9610096	9810096	harbor2	chr17	9630015	9630296	LINE/L2	614	+	140	9630155	20059
chr17	9610096	9810096	harbor2	chr17	9631105	9631415	LINE/L2	547	+	155	9631260	21164
chr17	59609167	59809167	harbor2	chr17	59671640	59672071	LINE/L2	992	+	216	59671856	62689
chr17	66777552	66977552	harbor2	chr17	66813032	66813153	LINE/L2	526	+	60	66813092	35540
chr17	80818437	81018437	harbor2	chr17	80845194	80846343	LINE/L2	554	+	574	80845768	27331
chr17	80818437	81018437	harbor2	chr17	80895235	80895569	LINE/L2	519	+	167	80895402	76965
chr17	75256287	75456287	harbor2	chr17	75287075	75287115	LINE/L2	565	+	20	75287095	30808
chr17	75256287	75456287	harbor2	chr17	75287404	75287571	LINE/L2	565	+	84	75287488	31201
chr17	75256287	75456287	harbor2	chr17	75355128	75355418	LINE/L2	784	+	145	75355273	98986
chr17	77175939	77375939	harbor2	chr17	77192210	77192456	LINE/L2	851	+	123	77192333	16394
chr17	77175939	77375939	harbor2	chr17	77247675	77247934	LINE/L2	582	+	130	77247805	71866
chr17	77175939	77375939	harbor2	chr17	77269842	77270710	LINE/L2	569	+	434	77270276	94337
chr17	21214544	21414544	harbor2	chr17	21280435	21280704	LINE/L2	1235	+	134	21280569	66025
chr17	21214544	21414544	harbor2	chr17	21280990	21281136	LINE/L2	1235	+	73	21281063	66519
chr17	21214544	21414544	harbor2	chr17	21282152	21282485	LINE/L2	577	+	166	21282318	67774
chr17	21214544	21414544	harbor2	chr17	21250012	21250571	LINE/L2	630	+	280	21250292	35748
chr17	72084347	72284347	harbor2	chr17	72089806	72090083	LINE/L2	707	+	138	72089944	5597
chr17	72084347	72284347	harbor2	chr17	72130966	72131087	LINE/L2	506	+	60	72131026	46679
chr17	72084347	72284347	harbor2	chr17	72131305	72131780	LINE/L2	516	+	238	72131543	47196
chr17	72084347	72284347	harbor2	chr17	72180882	72181478	LINE/L2	1016	+	298	72181180	96833
chr17	72084347	72284347	harbor2	chr17	72181924	72182130	LINE/L2	541	+	103	72182027	97680
chr17	54182066	54382066	harbor2	chr17	54183518	54183598	LINE/L2	511	+	40	54183558	1492
chr17	54182066	54382066	harbor2	chr17	54183797	54184015	LINE/L2	511	+	109	54183906	1840
chr17	54182066	54382066	harbor2	chr17	54226783	54226866	LINE/L2	1362	+	42	54226825	44759
chr17	54182066	54382066	harbor2	chr17	54229126	54229752	LINE/L2	1362	+	313	54229439	47373
chr17	40408717	40608717	harbor2	chr17	40440034	40440194	LINE/L2	532	+	80	40440114	31397
chr17	40408717	40608717	harbor2	chr17	40464746	40465073	LINE/L2	653	+	164	40464910	56193
chr17	40408717	40608717	harbor2	chr17	40467389	40467870	LINE/L2	606	+	240	40467629	58912
chr17	40408717	40608717	harbor2	chr17	40468470	40468533	LINE/L2	606	+	32	40468502	59785
chr17	33746554	33946554	harbor2	chr17	33782756	33783248	LINE/L2	593	+	246	33783002	36448
chr17	33746554	33946554	harbor2	chr17	33843091	33843284	LINE/L2	558	+	96	33843187	96633
chr17	71599467	71799467	harbor2	chr17	71683438	71684497	LINE/L2	1454	+	530	71683968	84501
chr17	71599467	71799467	harbor2	chr17	71685746	71686073	LINE/L2	716	+	164	71685910	86443
chr17	59396195	59596195	harbor2	chr17	59416063	59416550	LINE/L2	1231	+	244	59416307	20112
chr17	59396195	59596195	harbor2	chr17	59417063	59417239	LINE/L2	1231	+	88	59417151	20956
chr17	59396195	59596195	harbor2	chr17	59417548	59417706	LINE/L2	689	+	79	59417627	21432
chr17	59396195	59596195	harbor2	chr17	59420152	59420428	LINE/L2	710	+	138	59420290	24095
chr17	59396195	59596195	harbor2	chr17	59494507	59495121	LINE/L2	1253	+	307	59494814	98619
chr17	59396195	59596195	harbor2	chr17	59495204	59495559	LINE/L2	524	+	178	59495382	99187
chr17	68234243	68434243	harbor2	chr17	68301547	68302134	LINE/L2	665	+	294	68301841	67598
chr17	68234243	68434243	harbor2	chr17	68316045	68316490	LINE/L2	1044	+	222	68316267	82024
chr17	67679943	67879943	harbor2	chr17	67712195	67712704	LINE/L2	826	+	254	67712449	32506
chr17	74706402	74906402	harbor2	chr17	74781836	74782107	LINE/L2	566	+	136	74781972	75570
chr17	74706402	74906402	harbor2	chr17	74782368	74782517	LINE/L2	566	+	74	74782442	76040
chr17	74110403	74310403	harbor2	chr17	74121249	74121379	LINE/L2	2308	+	65	74121314	10911
chr17	74110403	74310403	harbor2	chr17	74122227	74122798	LINE/L2	2308	+	286	74122513	12110
chr17	74110403	74310403	harbor2	chr17	74123122	74123434	LINE/L2	1024	+	156	74123278	12875
chr17	74110403	74310403	harbor2	chr17	74126400	74127209	LINE/L2	729	+	404	74126804	16401
chr17	74110403	74310403	harbor2	chr17	74148717	74149058	LINE/L2	955	+	170	74148887	38484
chr17	74110403	74310403	harbor2	chr17	74159598	74159865	LINE/L2	558	+	134	74159732	49329
chr17	74110403	74310403	harbor2	chr17	74163648	74164884	LINE/L2	1600	+	618	74164266	53863
chr17	37581907	37781907	harbor2	chr17	37587370	37588255	LINE/L2	1221	+	442	37587812	5905
chr17	37581907	37781907	harbor2	chr17	37648139	37648491	LINE/L2	569	+	176	37648315	66408
chr17	37581907	37781907	harbor2	chr17	37679109	37679344	LINE/L2	559	+	118	37679227	97320
chr17	77967870	78167870	harbor2	chr17	77989798	77990389	LINE/L2	697	+	296	77990094	22224
chr17	77967870	78167870	harbor2	chr17	77971373	77971569	LINE/L2	571	+	98	77971471	3601
chr17	30928430	31128430	harbor2	chr17	30984958	30986215	LINE/L2	1554	+	628	30985586	57156
chr17	30928430	31128430	harbor2	chr17	30986494	30986599	LINE/L2	553	+	52	30986546	58116
chr17	29921009	30121009	harbor2	chr17	29980343	29981655	LINE/L2	1923	+	656	29980999	59990
chr17	50870803	51070803	harbor2	chr17	50883910	50884431	LINE/L2	578	+	260	50884170	13367
chr17	50870803	51070803	harbor2	chr17	50895293	50895659	LINE/L2	536	+	183	50895476	24673
chr17	50870803	51070803	harbor2	chr17	50927610	50927738	LINE/L2	660	+	64	50927674	56871
chr17	50870803	51070803	harbor2	chr17	50928593	50928933	LINE/L2	561	+	170	50928763	57960
chr17	50870803	51070803	harbor2	chr17	50940258	50940862	LINE/L2	707	+	302	50940560	69757
chr17	50870803	51070803	harbor2	chr17	50940898	50940908	LINE/L2	707	+	5	50940903	70100
chr17	79613980	79813980	harbor2	chr17	79644940	79645566	LINE/L2	931	+	313	79645253	31273
chr17	53363541	53563541	harbor2	chr17	53365811	53365987	LINE/L2	932	+	88	53365899	2358
chr17	53363541	53563541	harbor2	chr17	53366735	53367044	LINE/L2	932	+	154	53366889	3348
chr17	56787403	56987403	harbor2	chr17	56818878	56819482	LINE/L2	814	+	302	56819180	31777
chr17	56787403	56987403	harbor2	chr17	56880354	56880713	LINE/L2	863	+	180	56880534	93131
chr17	74527642	74727642	harbor2	chr17	74540120	74540538	LINE/L2	572	+	209	74540329	12687
chr17	74527642	74727642	harbor2	chr17	74547967	74548366	LINE/L2	614	+	200	74548167	20525
chr17	63261221	63461221	harbor2	chr17	63325259	63325692	LINE/L2	958	+	216	63325475	64254
chr17	38638117	38838117	harbor2	chr17	38675794	38676026	LINE/L2	659	+	116	38675910	37793
chr17	38638117	38838117	harbor2	chr17	38685498	38686224	LINE/L2	882	+	363	38685861	47744
chr17	55798655	55998655	harbor2	chr17	55846910	55847072	LINE/L2	507	+	81	55846991	48336
chr17	53079588	53279588	harbor2	chr17	53103424	53103645	LINE/L2	568	+	110	53103534	23946
chr17	53079588	53279588	harbor2	chr17	53149062	53149862	LINE/L2	802	+	400	53149462	69874
chr17	73674996	73874996	harbor2	chr17	73679156	73679495	LINE/L2	638	+	170	73679326	4330
chr17	35948284	36148284	harbor2	chr17	36031544	36031774	LINE/L2	605	+	115	36031659	83375
chr17	35948284	36148284	harbor2	chr17	36031811	36032181	LINE/L2	514	+	185	36031996	83712
chr17	62130759	62330759	harbor2	chr17	62140643	62140890	LINE/L2	627	+	124	62140767	10008
chr17	62130759	62330759	harbor2	chr17	62141282	62141345	LINE/L2	627	+	32	62141314	10555
chr17	62130759	62330759	harbor2	chr17	62141665	62141924	LINE/L2	627	+	130	62141795	11036
chr17	62130759	62330759	harbor2	chr17	62145905	62146331	LINE/L2	584	+	213	62146118	15359
chr17	62130759	62330759	harbor2	chr17	62191232	62191309	LINE/L2	844	+	38	62191270	60511
chr17	62130759	62330759	harbor2	chr17	62191639	62191746	LINE/L2	1239	+	54	62191693	60934
chr17	62130759	62330759	harbor2	chr17	62192061	62192537	LINE/L2	1239	+	238	62192299	61540
chr17	78543385	78743385	harbor2	chr17	78558837	78560236	LINE/L2	1903	+	700	78559537	16152
chr17	74784158	74984158	harbor2	chr17	74869392	74869848	LINE/L2	545	+	228	74869620	85462
chr17	28950331	29150331	harbor2	chr17	28969343	28969487	LINE/L2	526	+	72	28969415	19084
chr17	28950331	29150331	harbor2	chr17	28976835	28977074	LINE/L2	665	+	120	28976955	26624
chr17	66840222	67040222	harbor2	chr17	66911102	66911651	LINE/L2	1831	+	274	66911376	71154
chr17	66840222	67040222	harbor2	chr17	66911868	66911992	LINE/L2	1831	+	62	66911930	71708
chr17	66840222	67040222	harbor2	chr17	66912305	66912848	LINE/L2	1831	+	272	66912577	72355
chr17	66840222	67040222	harbor2	chr17	66913594	66913610	LINE/L2	1831	+	8	66913602	73380
chr17	66840222	67040222	harbor2	chr17	66913921	66914024	LINE/L2	1831	+	52	66913973	73751
chr17	66840222	67040222	harbor2	chr17	66914214	66914288	LINE/L2	956	+	37	66914251	74029
chr17	66840222	67040222	harbor2	chr17	66914598	66914931	LINE/L2	956	+	166	66914764	74542
chr17	60403586	60603586	harbor2	chr17	60436567	60436721	LINE/L2	634	+	77	60436644	33058
chr17	60403586	60603586	harbor2	chr17	60456553	60456853	LINE/L2	600	+	150	60456703	53117
chr17	60403586	60603586	harbor2	chr17	60457146	60457257	LINE/L2	600	+	56	60457202	53616
chr17	60403586	60603586	harbor2	chr17	60496707	60496725	LINE/L2	549	+	9	60496716	93130
chr17	60403586	60603586	harbor2	chr17	60497021	60497131	LINE/L2	549	+	55	60497076	93490
chr17	60403586	60603586	harbor2	chr17	60497659	60497720	LINE/L2	549	+	30	60497689	94103
chr17	50248967	50448967	harbor2	chr17	50282966	50284664	LINE/L2	1701	+	849	50283815	34848
chr17	42168736	42368736	harbor2	chr17	42205433	42205638	LINE/L2	813	+	102	42205535	36799
chr17	42168736	42368736	harbor2	chr17	42205927	42206062	LINE/L2	813	+	68	42205995	37259
chr17	42168736	42368736	harbor2	chr17	42206390	42206449	LINE/L2	813	+	30	42206420	37684
chr17	42168736	42368736	harbor2	chr17	42235112	42235365	LINE/L2	512	+	126	42235238	66502
chr17	72246043	72446043	harbor2	chr17	72290937	72291909	LINE/L2	989	+	486	72291423	45380
chr17	72246043	72446043	harbor2	chr17	72292209	72293611	LINE/L2	989	+	701	72292910	46867
chr17	72246043	72446043	harbor2	chr17	72307331	72307732	LINE/L2	878	+	200	72307531	61488
chr17	65706559	65906559	harbor2	chr17	65707292	65707625	LINE/L2	721	+	166	65707458	899
chr17	65706559	65906559	harbor2	chr17	65794894	65795018	LINE/L2	547	+	62	65794956	88397
chr17	49302852	49502852	harbor2	chr17	49376746	49377151	LINE/L2	742	+	202	49376948	74096
chr17	81226937	81426937	harbor2	chr17	81307886	81308229	LINE/L2	702	+	172	81308058	81121
chr17	61876160	62076160	harbor2	chr17	61932617	61932945	LINE/L2	573	+	164	61932781	56621
chr17	61876160	62076160	harbor2	chr17	61933244	61933328	LINE/L2	573	+	42	61933286	57126
chr17	79526805	79726805	harbor2	chr17	79552345	79552621	LINE/L2	673	+	138	79552483	25678
chr17	77699199	77899199	harbor2	chr17	77701094	77701361	LINE/L2	795	+	134	77701228	2029
chr17	28820980	29020980	harbor2	chr17	28823597	28823875	LINE/L2	1193	+	139	28823736	2756
chr17	28820980	29020980	harbor2	chr17	28824477	28824782	LINE/L2	1193	+	152	28824629	3649
chr17	28820980	29020980	harbor2	chr17	28825061	28825150	LINE/L2	1193	+	44	28825105	4125
chr17	28820980	29020980	harbor2	chr17	28825456	28825768	LINE/L2	1193	+	156	28825612	4632
chr17	28820980	29020980	harbor2	chr17	28826050	28826068	LINE/L2	517	+	9	28826059	5079
chr17	28820980	29020980	harbor2	chr17	28826371	28826399	LINE/L2	517	+	14	28826385	5405
chr17	28820980	29020980	harbor2	chr17	28826704	28826817	LINE/L2	517	+	56	28826760	5780
chr17	28820980	29020980	harbor2	chr17	28878239	28878765	LINE/L2	918	+	263	28878502	57522
chr17	28820980	29020980	harbor2	chr17	28899537	28899711	LINE/L2	1311	+	87	28899624	78644
chr17	28820980	29020980	harbor2	chr17	28900329	28900669	LINE/L2	1311	+	170	28900499	79519
chr17	73002059	73202059	harbor2	chr17	73099923	73100100	LINE/L2	638	+	88	73100011	97952
chr17	73002059	73202059	harbor2	chr17	73100407	73100894	LINE/L2	843	+	244	73100651	98592
chr17	61799300	61999300	harbor2	chr17	61871450	61871651	LINE/L2	543	+	100	61871550	72250
chr17	71336547	71536547	harbor2	chr17	71360399	71361083	LINE/L2	979	+	342	71360741	24194
chr17	18360677	18560677	harbor2	chr17	18451333	18451742	LINE/L2	565	+	204	18451537	90860
chr17	52382385	52582385	harbor2	chr17	52431311	52431745	LINE/L2	630	+	217	52431528	49143
chr17	52382385	52582385	harbor2	chr17	52438149	52438825	LINE/L2	1871	+	338	52438487	56102
chr17	76082968	76282968	harbor2	chr17	76157895	76158247	LINE/L2	661	+	176	76158071	75103
chr17	69622601	69822601	harbor2	chr17	69653134	69653812	LINE/L2	879	+	339	69653473	30872
chr17	65204426	65404426	harbor2	chr17	65285970	65286528	LINE/L2	724	+	279	65286249	81823
chr17	76098434	76298434	harbor2	chr17	76157895	76158247	LINE/L2	661	+	176	76158071	59637
chr17	72461838	72661838	harbor2	chr17	72461679	72461894	LINE/L2	574	+	108	72461787	51
chr17	72461838	72661838	harbor2	chr17	72534631	72535036	LINE/L2	753	+	202	72534833	72995
chr17	72461838	72661838	harbor2	chr17	72543241	72543856	LINE/L2	567	+	308	72543549	81711
chr17	80544725	80744725	harbor2	chr17	80550459	80550890	LINE/L2	951	+	216	80550675	5950
chr17	80544725	80744725	harbor2	chr17	80551188	80551207	LINE/L2	951	+	10	80551198	6473
chr17	80544725	80744725	harbor2	chr17	80552177	80552304	LINE/L2	951	+	64	80552241	7516
chr17	27943049	28143049	harbor2	chr17	27969826	27970478	LINE/L2	1043	+	326	27970152	27103
chr17	27943049	28143049	harbor2	chr17	28016595	28016743	LINE/L2	504	+	74	28016669	73620
chr17	47361660	47561660	harbor2	chr17	47364596	47365267	LINE/L2	762	+	336	47364932	3272
chr17	75826516	76026516	harbor2	chr17	75833180	75833712	LINE/L2	1273	+	266	75833446	6930
chr17	72272874	72472874	harbor2	chr17	72290937	72291909	LINE/L2	989	+	486	72291423	18549
chr17	72272874	72472874	harbor2	chr17	72292209	72293611	LINE/L2	989	+	701	72292910	20036
chr17	72272874	72472874	harbor2	chr17	72307331	72307732	LINE/L2	878	+	200	72307531	34657
chr17	45440492	45640492	harbor2	chr17	45454445	45454837	LINE/L2	913	+	196	45454641	14149
chr17	45440492	45640492	harbor2	chr17	45455295	45456381	LINE/L2	1678	+	543	45455838	15346
chr17	62446077	62646077	harbor2	chr17	62526174	62526510	LINE/L2	962	+	168	62526342	80265
chr17	62446077	62646077	harbor2	chr17	62526563	62527331	LINE/L2	1151	+	384	62526947	80870
chr17	62446077	62646077	harbor2	chr17	62539286	62539473	LINE/L2	1518	+	94	62539380	93303
chr17	62446077	62646077	harbor2	chr17	62539803	62540102	LINE/L2	1518	+	150	62539953	93876
chr17	62446077	62646077	harbor2	chr17	62540237	62540400	LINE/L2	1518	+	82	62540319	94242
chr17	62446077	62646077	harbor2	chr17	62540699	62541385	LINE/L2	1518	+	343	62541042	94965
chr17	62893041	63093041	harbor2	chr17	62914987	62915372	LINE/L2	943	+	192	62915179	22138
chr17	62893041	63093041	harbor2	chr17	62930570	62930724	LINE/L2	708	+	77	62930647	37606
chr17	62893041	63093041	harbor2	chr17	62931024	62931261	LINE/L2	708	+	118	62931142	38101
chr17	62893041	63093041	harbor2	chr17	62945158	62945575	LINE/L2	869	+	208	62945366	52325
chr17	62893041	63093041	harbor2	chr17	62972592	62973030	LINE/L2	742	+	219	62972811	79770
chr17	62893041	63093041	harbor2	chr17	62973332	62973468	LINE/L2	742	+	68	62973400	80359
chr17	62893041	63093041	harbor2	chr17	62980563	62980666	LINE/L2	1462	+	52	62980615	87574
chr17	62893041	63093041	harbor2	chr17	62980729	62981414	LINE/L2	1462	+	342	62981071	88030
chr17	62893041	63093041	harbor2	chr17	62982382	62982694	LINE/L2	1421	+	156	62982538	89497
chr17	62893041	63093041	harbor2	chr17	62980025	62980346	LINE/L2	1462	+	160	62980185	87144
chr17	62893041	63093041	harbor2	chr17	62914219	62914783	LINE/L2	943	+	282	62914501	21460
chr17	51265157	51465157	harbor2	chr17	51273805	51274301	LINE/L2	722	+	248	51274053	8896
chr17	75332910	75532910	harbor2	chr17	75355128	75355418	LINE/L2	784	+	145	75355273	22363
chr17	41748115	41948115	harbor2	chr17	41799735	41799966	LINE/L2	605	+	116	41799851	51736
chr17	59200718	59400718	harbor2	chr17	59299398	59299652	LINE/L2	936	+	127	59299525	98807
chr17	78191468	78391468	harbor2	chr17	78257893	78258353	LINE/L2	530	+	230	78258123	66655
chr17	78587297	78787297	harbor2	chr17	78648671	78648698	LINE/L2	573	+	14	78648685	61388
chr17	78587297	78787297	harbor2	chr17	78649393	78649536	LINE/L2	573	+	72	78649465	62168
chr17	79125860	79325860	harbor2	chr17	79153976	79154466	LINE/L2	552	+	245	79154221	28361
chr17	32888680	33088680	harbor2	chr17	32929763	32930030	LINE/L2	524	+	134	32929897	41217
chr17	55360263	55560263	harbor2	chr17	55367266	55367613	LINE/L2	572	+	174	55367440	7177
chr17	55360263	55560263	harbor2	chr17	55385075	55385516	LINE/L2	1172	+	220	55385295	25032
chr17	55360263	55560263	harbor2	chr17	55417398	55417508	LINE/L2	601	+	55	55417453	57190
chr17	55360263	55560263	harbor2	chr17	55417821	55418370	LINE/L2	620	+	274	55418095	57832
chr17	70296240	70496240	harbor2	chr17	70351427	70351766	LINE/L2	615	+	170	70351597	55357
chr17	70296240	70496240	harbor2	chr17	70352562	70352612	LINE/L2	615	+	25	70352587	56347
chr17	70296240	70496240	harbor2	chr17	70365182	70365951	LINE/L2	1019	+	384	70365566	69326
chr17	69152662	69352662	harbor2	chr17	69186666	69186969	LINE/L2	666	+	152	69186818	34156
chr17	69152662	69352662	harbor2	chr17	69197471	69198113	LINE/L2	763	+	321	69197792	45130
chr17	69152662	69352662	harbor2	chr17	69241016	69241888	LINE/L2	1316	+	436	69241452	88790
chr17	64742160	64942160	harbor2	chr17	64791461	64791749	LINE/L2	516	+	144	64791605	49445
chr17	64742160	64942160	harbor2	chr17	64801090	64801494	LINE/L2	2443	+	202	64801292	59132
chr17	64742160	64942160	harbor2	chr17	64801793	64803029	LINE/L2	2443	+	618	64802411	60251
chr17	33595173	33795173	harbor2	chr17	33599864	33600164	LINE/L2	642	+	150	33600014	4841
chr17	33595173	33795173	harbor2	chr17	33609092	33609710	LINE/L2	651	+	309	33609401	14228
chr17	33595173	33795173	harbor2	chr17	33620882	33621358	LINE/L2	519	+	238	33621120	25947
chr17	28546968	28746968	harbor2	chr17	28567666	28568100	LINE/L2	1367	+	217	28567883	20915
chr17	28546968	28746968	harbor2	chr17	28568402	28568511	LINE/L2	1367	+	54	28568456	21488
chr17	28546968	28746968	harbor2	chr17	28580422	28580990	LINE/L2	676	+	284	28580706	33738
chr17	13802079	14002079	harbor2	chr17	13855013	13855314	LINE/L2	653	+	150	13855163	53084
chr17	13802079	14002079	harbor2	chr17	13869855	13870205	LINE/L2	584	+	175	13870030	67951
chr17	62065951	62265951	harbor2	chr17	62140643	62140890	LINE/L2	627	+	124	62140767	74816
chr17	62065951	62265951	harbor2	chr17	62141282	62141345	LINE/L2	627	+	32	62141314	75363
chr17	62065951	62265951	harbor2	chr17	62141665	62141924	LINE/L2	627	+	130	62141795	75844
chr17	62065951	62265951	harbor2	chr17	62145905	62146331	LINE/L2	584	+	213	62146118	80167
chr17	79511783	79711783	harbor2	chr17	79552345	79552621	LINE/L2	673	+	138	79552483	40700
chr17	30338405	30538405	harbor2	chr17	30373259	30373681	LINE/L2	1803	+	211	30373470	35065
chr17	30338405	30538405	harbor2	chr17	30415091	30415363	LINE/L2	505	+	136	30415227	76822
chr17	30338405	30538405	harbor2	chr17	30416467	30416820	LINE/L2	920	+	176	30416643	78238
chr17	30338405	30538405	harbor2	chr17	30417117	30417353	LINE/L2	920	+	118	30417235	78830
chr17	33535408	33735408	harbor2	chr17	33536536	33536724	LINE/L2	1209	+	94	33536630	1222
chr17	33535408	33735408	harbor2	chr17	33537029	33537588	LINE/L2	1209	+	280	33537309	1901
chr17	33535408	33735408	harbor2	chr17	33548648	33549180	LINE/L2	1320	+	266	33548914	13506
chr17	33535408	33735408	harbor2	chr17	33586360	33587011	LINE/L2	596	+	326	33586686	51278
chr17	33535408	33735408	harbor2	chr17	33599864	33600164	LINE/L2	642	+	150	33600014	64606
chr17	33535408	33735408	harbor2	chr17	33609092	33609710	LINE/L2	651	+	309	33609401	73993
chr17	33535408	33735408	harbor2	chr17	33620882	33621358	LINE/L2	519	+	238	33621120	85712
chr17	55195700	55395700	harbor2	chr17	55221959	55222197	LINE/L2	813	+	119	55222078	26378
chr17	55195700	55395700	harbor2	chr17	55229491	55229743	LINE/L2	2000	+	126	55229617	33917
chr17	55195700	55395700	harbor2	chr17	55229964	55230670	LINE/L2	2000	+	353	55230317	34617
chr17	80082491	80282491	harbor2	chr17	80145612	80146523	LINE/L2	504	+	456	80146068	63577
chr17	42159207	42359207	harbor2	chr17	42162481	42162590	LINE/L2	533	+	54	42162535	3328
chr17	42159207	42359207	harbor2	chr17	42162892	42163175	LINE/L2	533	+	142	42163034	3827
chr17	42159207	42359207	harbor2	chr17	42205433	42205638	LINE/L2	813	+	102	42205535	46328
chr17	42159207	42359207	harbor2	chr17	42205927	42206062	LINE/L2	813	+	68	42205995	46788
chr17	42159207	42359207	harbor2	chr17	42206390	42206449	LINE/L2	813	+	30	42206420	47213
chr17	42159207	42359207	harbor2	chr17	42235112	42235365	LINE/L2	512	+	126	42235238	76031
chr17	65262835	65462835	harbor2	chr17	65285970	65286528	LINE/L2	724	+	279	65286249	23414
chr17	76095738	76295738	harbor2	chr17	76157895	76158247	LINE/L2	661	+	176	76158071	62333
chr17	63802205	64002205	harbor2	chr17	63845129	63845488	LINE/L2	559	+	180	63845309	43104
chr18	63824874	64024874	harbor2	chr18	63921258	63922185	LINE/L2	402	+	464	63921722	96848
chr18	43102168	43302168	harbor2	chr18	43151823	43152231	LINE/L2	738	+	204	43152027	49859
chr18	32203770	32403770	harbor2	chr18	32285400	32285826	LINE/L2	499	+	213	32285613	81843
chr18	32203770	32403770	harbor2	chr18	32286480	32286866	LINE/L2	1047	+	193	32286673	82903
chr18	54458323	54658323	harbor2	chr18	54461933	54462487	LINE/L2	885	+	277	54462210	3887
chr18	54458323	54658323	harbor2	chr18	54556328	54556441	LINE/L2	422	+	56	54556384	98061
chr18	33194929	33394929	harbor2	chr18	33203578	33203945	LINE/L2	671	+	184	33203762	8833
chr18	35761091	35961091	harbor2	chr18	35774144	35774815	LINE/L2	902	+	336	35774480	13389
chr18	35761091	35961091	harbor2	chr18	35785260	35785506	LINE/L2	464	+	123	35785383	24292
chr18	35761091	35961091	harbor2	chr18	35785558	35785617	LINE/L2	464	+	30	35785588	24497
chr18	31516987	31716987	harbor2	chr18	31520427	31520661	LINE/L2	439	+	117	31520544	3557
chr18	31516987	31716987	harbor2	chr18	31539239	31539356	LINE/L2	526	+	58	31539297	22310
chr18	77206532	77406532	harbor2	chr18	77246487	77247300	LINE/L2	832	+	406	77246893	40361
chr18	77206532	77406532	harbor2	chr18	77247703	77247851	LINE/L2	621	+	74	77247777	41245
chr18	74701340	74901340	harbor2	chr18	74777545	74777795	LINE/L2	680	+	125	74777670	76330
chr18	74701340	74901340	harbor2	chr18	74778294	74778643	LINE/L2	639	+	174	74778468	77128
chr18	65161972	65361972	harbor2	chr18	65195914	65196309	LINE/L2	443	+	198	65196112	34140
chr18	76564250	76764250	harbor2	chr18	76601700	76601872	LINE/L2	448	+	86	76601786	37536
chr18	22243581	22443581	harbor2	chr18	22251794	22251902	LINE/L2	387	+	54	22251848	8267
chr18	22243581	22443581	harbor2	chr18	22265067	22265530	LINE/L2	398	+	232	22265299	21718
chr18	22243581	22443581	harbor2	chr18	22295208	22295785	LINE/L2	796	+	288	22295496	51915
chr18	22243581	22443581	harbor2	chr18	22295842	22296207	LINE/L2	796	+	182	22296024	52443
chr18	22243581	22443581	harbor2	chr18	22296917	22297231	LINE/L2	429	+	157	22297074	53493
chr18	22243581	22443581	harbor2	chr18	22328286	22328732	LINE/L2	1047	+	223	22328509	84928
chr18	28673418	28873418	harbor2	chr18	28677952	28678453	LINE/L2	498	+	250	28678202	4784
chr18	28673418	28873418	harbor2	chr18	28712272	28712602	LINE/L2	577	+	165	28712437	39019
chr18	28673418	28873418	harbor2	chr18	28722984	28723538	LINE/L2	981	+	277	28723261	49843
chr18	76049777	76249777	harbor2	chr18	76064894	76065580	LINE/L2	515	+	343	76065237	15460
chr18	76049777	76249777	harbor2	chr18	76130934	76131648	LINE/L2	429	+	357	76131291	81514
chr18	40681131	40881131	harbor2	chr18	40731346	40731815	LINE/L2	543	+	234	40731580	50449
chr18	75862275	76062275	harbor2	chr18	75914696	75914765	LINE/L2	463	+	34	75914730	52455
chr18	75862275	76062275	harbor2	chr18	75915072	75915224	LINE/L2	463	+	76	75915148	52873
chr18	75862275	76062275	harbor2	chr18	75942343	75942622	LINE/L2	581	+	140	75942483	80208
chr18	28715047	28915047	harbor2	chr18	28722984	28723538	LINE/L2	981	+	277	28723261	8214
chr18	28715047	28915047	harbor2	chr18	28777639	28777836	LINE/L2	649	+	98	28777737	62690
chr18	28715047	28915047	harbor2	chr18	28778105	28778271	LINE/L2	649	+	83	28778188	63141
chr18	48914970	49114970	harbor2	chr18	49003367	49003992	LINE/L2	1340	+	312	49003679	88709
chr18	48914970	49114970	harbor2	chr18	49004186	49004382	LINE/L2	1340	+	98	49004284	89314
chr18	48914970	49114970	harbor2	chr18	49004857	49005052	LINE/L2	536	+	98	49004955	89985
chr18	32688955	32888955	harbor2	chr18	32708957	32709451	LINE/L2	992	+	247	32709204	20249
chr18	32688955	32888955	harbor2	chr18	32709690	32709818	LINE/L2	992	+	64	32709754	20799
chr18	32688955	32888955	harbor2	chr18	32711685	32712018	LINE/L2	781	+	166	32711851	22896
chr18	32688955	32888955	harbor2	chr18	32712229	32713051	LINE/L2	2653	+	411	32712640	23685
chr18	32688955	32888955	harbor2	chr18	32713255	32713424	LINE/L2	512	+	84	32713339	24384
chr18	32688955	32888955	harbor2	chr18	32735366	32735876	LINE/L2	595	+	255	32735621	46666
chr18	32688955	32888955	harbor2	chr18	32736609	32737042	LINE/L2	768	+	216	32736825	47870
chr18	32688955	32888955	harbor2	chr18	32761415	32761805	LINE/L2	472	+	195	32761610	72655
chr18	47861886	48061886	harbor2	chr18	47894886	47895593	LINE/L2	540	+	354	47895240	33354
chr18	47861886	48061886	harbor2	chr18	47933741	47934198	LINE/L2	715	+	228	47933969	72083
chr18	47861886	48061886	harbor2	chr18	47936401	47936682	LINE/L2	495	+	140	47936541	74655
chr18	47861886	48061886	harbor2	chr18	47937466	47938106	LINE/L2	915	+	320	47937786	75900
chr18	47861886	48061886	harbor2	chr18	47960036	47960277	LINE/L2	521	+	120	47960156	98270
chr18	50654411	50854411	harbor2	chr18	50697311	50697427	LINE/L2	438	+	58	50697369	42958
chr18	50654411	50854411	harbor2	chr18	50705723	50705963	LINE/L2	672	+	120	50705843	51432
chr18	50654411	50854411	harbor2	chr18	50728824	50728932	LINE/L2	495	+	54	50728878	74467
chr18	74231680	74431680	harbor2	chr18	74239991	74240407	LINE/L2	748	+	208	74240199	8519
chr18	74231680	74431680	harbor2	chr18	74269230	74269790	LINE/L2	984	+	280	74269510	37830
chr18	74231680	74431680	harbor2	chr18	74310017	74310831	LINE/L2	596	+	407	74310424	78744
chr18	74231680	74431680	harbor2	chr18	74314341	74314874	LINE/L2	1610	+	266	74314607	82927
chr18	74231680	74431680	harbor2	chr18	74314877	74315344	LINE/L2	848	+	234	74315111	83431
chr18	30375367	30575367	harbor2	chr18	30438991	30439555	LINE/L2	1203	+	282	30439273	63906
chr18	30375367	30575367	harbor2	chr18	30470560	30471048	LINE/L2	410	+	244	30470804	95437
chr18	77001364	77201364	harbor2	chr18	77090318	77090763	LINE/L2	484	+	222	77090540	89176
chr19	53911311	54111311	harbor2	chr19	53926146	53926629	LINE/L2	624	+	242	53926388	15077
chr19	53911311	54111311	harbor2	chr19	54003661	54003848	LINE/L2	971	+	94	54003755	92444
chr19	53911311	54111311	harbor2	chr19	54004518	54004868	LINE/L2	971	+	175	54004693	93382
chr19	48400520	48600520	harbor2	chr19	48485843	48486047	LINE/L2	726	+	102	48485945	85425
chr19	48400520	48600520	harbor2	chr19	48486359	48486526	LINE/L2	726	+	84	48486443	85923
chr19	48400520	48600520	harbor2	chr19	48487475	48487589	LINE/L2	726	+	57	48487532	87012
chr19	48400520	48600520	harbor2	chr19	48488334	48488738	LINE/L2	622	+	202	48488536	88016
chr19	48400520	48600520	harbor2	chr19	48489039	48489256	LINE/L2	622	+	108	48489147	88627
chr19	51587353	51787353	harbor2	chr19	51595032	51595932	LINE/L2	1008	+	450	51595482	8129
chr19	51587353	51787353	harbor2	chr19	51662592	51662986	LINE/L2	1238	+	197	51662789	75436
chr19	49941421	50141421	harbor2	chr19	49985490	49985786	LINE/L2	665	+	148	49985638	44217
chr19	49941421	50141421	harbor2	chr19	50022325	50022503	LINE/L2	1167	+	89	50022414	80993
chr19	49941421	50141421	harbor2	chr19	50022820	50023182	LINE/L2	1439	+	181	50023001	81580
chr19	49941421	50141421	harbor2	chr19	50023481	50023697	LINE/L2	1439	+	108	50023589	82168
chr19	49941421	50141421	harbor2	chr19	50034037	50034393	LINE/L2	972	+	178	50034215	92794
chr19	4653752	4853752	harbor2	chr19	4693229	4694195	LINE/L2	839	+	483	4693712	39960
chr19	4653752	4853752	harbor2	chr19	4729020	4729108	LINE/L2	1616	+	44	4729064	75312
chr19	4653752	4853752	harbor2	chr19	4729407	4729424	LINE/L2	1616	+	8	4729415	75663
chr19	4653752	4853752	harbor2	chr19	4729846	4730444	LINE/L2	1616	+	299	4730145	76393
chr19	4653752	4853752	harbor2	chr19	4730736	4731314	LINE/L2	1616	+	289	4731025	77273
chr19	4653752	4853752	harbor2	chr19	4731620	4731807	LINE/L2	655	+	94	4731714	77962
chr19	40964482	41164482	harbor2	chr19	41047968	41048406	LINE/L2	945	+	219	41048187	83705
chr19	40964482	41164482	harbor2	chr19	41048734	41048764	LINE/L2	743	+	15	41048749	84267
chr19	40964482	41164482	harbor2	chr19	41049065	41049403	LINE/L2	743	+	169	41049234	84752
chr19	34137642	34337642	harbor2	chr19	34180541	34182105	LINE/L2	3723	+	782	34181323	43681
chr19	49930130	50130130	harbor2	chr19	49985490	49985786	LINE/L2	665	+	148	49985638	55508
chr19	49930130	50130130	harbor2	chr19	50022325	50022503	LINE/L2	1167	+	89	50022414	92284
chr19	49930130	50130130	harbor2	chr19	50022820	50023182	LINE/L2	1439	+	181	50023001	92871
chr19	49930130	50130130	harbor2	chr19	50023481	50023697	LINE/L2	1439	+	108	50023589	93459
chr19	36646643	36846643	harbor2	chr19	36660035	36660148	LINE/L2	753	+	56	36660091	13448
chr19	36646643	36846643	harbor2	chr19	36660448	36660610	LINE/L2	753	+	81	36660529	13886
chr19	51819179	52019179	harbor2	chr19	51830219	51830520	LINE/L2	1542	+	150	51830369	11190
chr19	51819179	52019179	harbor2	chr19	51830574	51831105	LINE/L2	1542	+	266	51830840	11661
chr19	51819179	52019179	harbor2	chr19	51831417	51832054	LINE/L2	1542	+	318	51831735	12556
chr19	45624161	45824161	harbor2	chr19	45688700	45688736	LINE/L2	863	+	18	45688718	64557
chr19	45624161	45824161	harbor2	chr19	45689033	45689381	LINE/L2	863	+	174	45689207	65046
chr19	45624161	45824161	harbor2	chr19	45696036	45696309	LINE/L2	780	+	136	45696172	72011
chr19	52311434	52511434	harbor2	chr19	52342406	52342520	LINE/L2	678	+	57	52342463	31029
chr19	52311434	52511434	harbor2	chr19	52342825	52343172	LINE/L2	678	+	174	52342999	31565
chr19	52311434	52511434	harbor2	chr19	52400825	52401296	LINE/L2	733	+	236	52401061	89627
chr19	50341112	50541112	harbor2	chr19	50380836	50381167	LINE/L2	840	+	166	50381002	39890
chr19	41248258	41448258	harbor2	chr19	41314566	41314718	LINE/L2	1094	+	76	41314642	66384
chr19	41248258	41448258	harbor2	chr19	41316108	41316321	LINE/L2	1094	+	106	41316214	67956
chr19	41248258	41448258	harbor2	chr19	41332935	41333192	LINE/L2	644	+	128	41333063	84805
chr19	41248258	41448258	harbor2	chr19	41343924	41343978	LINE/L2	1131	+	27	41343951	95693
chr19	41248258	41448258	harbor2	chr19	41344285	41344581	LINE/L2	1131	+	148	41344433	96175
chr19	37352729	37552729	harbor2	chr19	37369420	37369778	LINE/L2	766	+	179	37369599	16870
chr19	34147386	34347386	harbor2	chr19	34180541	34182105	LINE/L2	3723	+	782	34181323	33937
chr19	55785674	55985674	harbor2	chr19	55789895	55790244	LINE/L2	722	+	174	55790069	4395
chr19	55785674	55985674	harbor2	chr19	55790458	55790589	LINE/L2	722	+	66	55790524	4850
chr19	55785674	55985674	harbor2	chr19	55805456	55805533	LINE/L2	1477	+	38	55805494	19820
chr19	55785674	55985674	harbor2	chr19	55805840	55806831	LINE/L2	1477	+	496	55806336	20662
chr19	57706616	57906616	harbor2	chr19	57707184	57707634	LINE/L2	673	+	225	57707409	793
chr19	46479918	46679918	harbor2	chr19	46525932	46526172	LINE/L2	766	+	120	46526052	46134
chr19	46479918	46679918	harbor2	chr19	46572106	46572275	LINE/L2	634	+	84	46572190	92272
chr19	57016344	57216344	harbor2	chr19	57047780	57048282	LINE/L2	765	+	251	57048031	31687
chr19	56612059	56812059	harbor2	chr19	56638553	56639021	LINE/L2	1501	+	234	56638787	26728
chr19	56612059	56812059	harbor2	chr19	56659165	56659514	LINE/L2	780	+	174	56659339	47280
chr19	56612059	56812059	harbor2	chr19	56639311	56639761	LINE/L2	1501	+	225	56639536	27477
chr19	30536518	30736518	harbor2	chr19	30536838	30537180	LINE/L2	959	+	171	30537009	491
chr19	30536518	30736518	harbor2	chr19	30623104	30623899	LINE/L2	901	+	398	30623502	86984
chr19	6095437	6295437	harbor2	chr19	6167889	6168583	LINE/L2	1143	+	347	6168236	72799
chr19	43321865	43521865	harbor2	chr19	43375422	43376004	LINE/L2	822	+	291	43375713	53848
chr19	51757602	51957602	harbor2	chr19	51783696	51784666	LINE/L2	1307	+	485	51784181	26579
chr19	51757602	51957602	harbor2	chr19	51830219	51830520	LINE/L2	1542	+	150	51830369	72767
chr19	51757602	51957602	harbor2	chr19	51830574	51831105	LINE/L2	1542	+	266	51830840	73238
chr19	51757602	51957602	harbor2	chr19	51831417	51832054	LINE/L2	1542	+	318	51831735	74133
chr19	55470764	55670764	harbor2	chr19	55568503	55569034	LINE/L2	1133	+	266	55568769	98005
chr19	50296445	50496445	harbor2	chr19	50380836	50381167	LINE/L2	840	+	166	50381002	84557
chr19	35846873	36046873	harbor2	chr19	35901482	35901573	LINE/L2	1080	+	46	35901528	54655
chr19	35846873	36046873	harbor2	chr19	35901854	35902464	LINE/L2	1080	+	305	35902159	55286
chr19	40333190	40533190	harbor2	chr19	40360036	40360387	LINE/L2	948	+	176	40360212	27022
chr19	40333190	40533190	harbor2	chr19	40361441	40361843	LINE/L2	1132	+	201	40361642	28452
chr19	40333190	40533190	harbor2	chr19	40362137	40362241	LINE/L2	1132	+	52	40362189	28999
chr19	40333190	40533190	harbor2	chr19	40385024	40385661	LINE/L2	1551	+	318	40385342	52152
chr19	40333190	40533190	harbor2	chr19	40386003	40386060	LINE/L2	1551	+	28	40386031	52841
chr19	40333190	40533190	harbor2	chr19	40386652	40386798	LINE/L2	1551	+	73	40386725	53535
chr19	40333190	40533190	harbor2	chr19	40399049	40399712	LINE/L2	1600	+	332	40399381	66191
chr19	40333190	40533190	harbor2	chr19	40400741	40401285	LINE/L2	1211	+	272	40401013	67823
chr19	40333190	40533190	harbor2	chr19	40401491	40401769	LINE/L2	1095	+	139	40401630	68440
chr19	40333190	40533190	harbor2	chr19	40402029	40402070	LINE/L2	1095	+	20	40402049	68859
chr19	40333190	40533190	harbor2	chr19	40402384	40402489	LINE/L2	1095	+	52	40402436	69246
chr19	40333190	40533190	harbor2	chr19	40402790	40402891	LINE/L2	1095	+	50	40402840	69650
chr19	40333190	40533190	harbor2	chr19	40403191	40403235	LINE/L2	1095	+	22	40403213	70023
chr19	44985726	45185726	harbor2	chr19	44996143	44996392	LINE/L2	708	+	124	44996267	10541
chr19	44985726	45185726	harbor2	chr19	44998120	44998551	LINE/L2	1172	+	216	44998336	12610
chr19	44985726	45185726	harbor2	chr19	45041562	45041987	LINE/L2	755	+	212	45041774	56048
chr19	44985726	45185726	harbor2	chr19	45046429	45046674	LINE/L2	837	+	122	45046551	60825
chr19	44985726	45185726	harbor2	chr19	45081534	45081615	LINE/L2	891	+	40	45081574	95848
chr19	44985726	45185726	harbor2	chr19	45081923	45082589	LINE/L2	891	+	333	45082256	96530
chr19	52201453	52401453	harbor2	chr19	52272032	52272457	LINE/L2	665	+	212	52272244	70791
chr19	17298841	17498841	harbor2	chr19	17353219	17353911	LINE/L2	1210	+	346	17353565	54724
chr19	14206293	14406293	harbor2	chr19	14291420	14291762	LINE/L2	826	+	171	14291591	85298
chr19	48526960	48726960	harbor2	chr19	48541891	48542099	LINE/L2	653	+	104	48541995	15035
chr19	41907367	42107367	harbor2	chr19	41955615	41955918	LINE/L2	769	+	152	41955767	48400
chr19	41907367	42107367	harbor2	chr19	41956507	41956694	LINE/L2	769	+	94	41956601	49234
chr19	52253987	52453987	harbor2	chr19	52272032	52272457	LINE/L2	665	+	212	52272244	18257
chr19	52253987	52453987	harbor2	chr19	52342406	52342520	LINE/L2	678	+	57	52342463	88476
chr19	52253987	52453987	harbor2	chr19	52342825	52343172	LINE/L2	678	+	174	52342999	89012
chr19	56939809	57139809	harbor2	chr19	57009903	57010358	LINE/L2	805	+	228	57010131	70322
chr19	56939809	57139809	harbor2	chr19	57015168	57015604	LINE/L2	706	+	218	57015386	75577
chr19	52416953	52616953	harbor2	chr19	52455085	52455193	LINE/L2	674	+	54	52455139	38186
chr19	52416953	52616953	harbor2	chr19	52455495	52455745	LINE/L2	674	+	125	52455620	38667
chr19	34171594	34371594	harbor2	chr19	34180541	34182105	LINE/L2	3723	+	782	34181323	9729
chr19	55534408	55734408	harbor2	chr19	55568503	55569034	LINE/L2	1133	+	266	55568769	34361
chr19	55534408	55734408	harbor2	chr19	55586020	55586459	LINE/L2	765	+	220	55586240	51832
chr19	55534408	55734408	harbor2	chr19	55586775	55586970	LINE/L2	765	+	98	55586873	52465
chr19	4581026	4781026	harbor2	chr19	4615690	4616067	LINE/L2	794	+	188	4615878	34852
chr19	56632307	56832307	harbor2	chr19	56638553	56639021	LINE/L2	1501	+	234	56638787	6480
chr19	56632307	56832307	harbor2	chr19	56659165	56659514	LINE/L2	780	+	174	56659339	27032
chr19	56632307	56832307	harbor2	chr19	56639311	56639761	LINE/L2	1501	+	225	56639536	7229
chr19	56696976	56896976	harbor2	chr19	56777317	56777547	LINE/L2	950	+	115	56777432	80456
chr19	56696976	56896976	harbor2	chr19	56777752	56778282	LINE/L2	1101	+	265	56778017	81041
chr19	52255013	52455013	harbor2	chr19	52272032	52272457	LINE/L2	665	+	212	52272244	17231
chr19	52255013	52455013	harbor2	chr19	52342406	52342520	LINE/L2	678	+	57	52342463	87450
chr19	52255013	52455013	harbor2	chr19	52342825	52343172	LINE/L2	678	+	174	52342999	87986
chr19	34043506	34243506	harbor2	chr19	34065998	34066378	LINE/L2	1656	+	190	34066188	22682
chr19	34043506	34243506	harbor2	chr19	34066817	34067129	LINE/L2	1656	+	156	34066973	23467
chr19	34043506	34243506	harbor2	chr19	34067459	34067540	LINE/L2	1656	+	40	34067499	23993
chr19	34043506	34243506	harbor2	chr19	34094674	34094924	LINE/L2	665	+	125	34094799	51293
chr19	52412840	52612840	harbor2	chr19	52455085	52455193	LINE/L2	674	+	54	52455139	42299
chr19	52412840	52612840	harbor2	chr19	52455495	52455745	LINE/L2	674	+	125	52455620	42780
chr19	43564582	43764582	harbor2	chr19	43570985	43571505	LINE/L2	1002	+	260	43571245	6663
chr19	43564582	43764582	harbor2	chr19	43571784	43571886	LINE/L2	888	+	51	43571835	7253
chr19	43564582	43764582	harbor2	chr19	43604533	43604869	LINE/L2	1400	+	168	43604701	40119
chr19	43564582	43764582	harbor2	chr19	43605164	43605328	LINE/L2	1400	+	82	43605246	40664
chr19	43564582	43764582	harbor2	chr19	43605649	43605866	LINE/L2	699	+	108	43605757	41175
chr19	43564582	43764582	harbor2	chr19	43606154	43606194	LINE/L2	699	+	20	43606174	41592
chr19	43564582	43764582	harbor2	chr19	43606449	43606652	LINE/L2	699	+	102	43606551	41969
chr19	43564582	43764582	harbor2	chr19	43610031	43610198	LINE/L2	636	+	84	43610115	45533
chr19	43564582	43764582	harbor2	chr19	43610499	43610665	LINE/L2	636	+	83	43610582	46000
chr19	43564582	43764582	harbor2	chr19	43632065	43632802	LINE/L2	1680	+	368	43632433	67851
chr19	43564582	43764582	harbor2	chr19	43633374	43633598	LINE/L2	914	+	112	43633486	68904
chr19	43564582	43764582	harbor2	chr19	43657242	43657810	LINE/L2	1505	+	284	43657526	92944
chr19	50391052	50591052	harbor2	chr19	50467935	50468078	LINE/L2	1153	+	72	50468007	76955
chr19	50391052	50591052	harbor2	chr19	50468389	50468603	LINE/L2	1153	+	107	50468496	77444
chr19	50391052	50591052	harbor2	chr19	50468890	50469566	LINE/L2	1153	+	338	50469228	78176
chr19	41168133	41368133	harbor2	chr19	41214138	41214484	LINE/L2	883	+	173	41214311	46178
chr19	41168133	41368133	harbor2	chr19	41215134	41215261	LINE/L2	883	+	64	41215198	47065
chr19	41168133	41368133	harbor2	chr19	41172816	41173204	LINE/L2	615	+	194	41173010	4877
chr19	39292175	39492175	harbor2	chr19	39337479	39337608	LINE/L2	969	+	64	39337543	45368
chr19	39292175	39492175	harbor2	chr19	39338309	39338552	LINE/L2	969	+	122	39338431	46256
chr19	39292175	39492175	harbor2	chr19	39339786	39340027	LINE/L2	812	+	120	39339906	47731
chr19	39292175	39492175	harbor2	chr19	39340340	39340424	LINE/L2	812	+	42	39340382	48207
chr19	39292175	39492175	harbor2	chr19	39340713	39340793	LINE/L2	812	+	40	39340753	48578
chr19	39292175	39492175	harbor2	chr19	39337924	39338011	LINE/L2	969	+	44	39337968	45793
chr19	56934939	57134939	harbor2	chr19	57009903	57010358	LINE/L2	805	+	228	57010131	75192
chr19	56934939	57134939	harbor2	chr19	57015168	57015604	LINE/L2	706	+	218	57015386	80447
chr19	50339461	50539461	harbor2	chr19	50380836	50381167	LINE/L2	840	+	166	50381002	41541
chr19	46447546	46647546	harbor2	chr19	46525932	46526172	LINE/L2	766	+	120	46526052	78506
chr19	37901641	38101641	harbor2	chr19	37933150	37933572	LINE/L2	1093	+	211	37933361	31720
chr19	37901641	38101641	harbor2	chr19	37969583	37970076	LINE/L2	705	+	246	37969829	68188
chr19	40300278	40500278	harbor2	chr19	40328862	40329225	LINE/L2	937	+	182	40329044	28766
chr19	40300278	40500278	harbor2	chr19	40329533	40329564	LINE/L2	937	+	16	40329549	29271
chr19	40300278	40500278	harbor2	chr19	40360036	40360387	LINE/L2	948	+	176	40360212	59934
chr19	40300278	40500278	harbor2	chr19	40361441	40361843	LINE/L2	1132	+	201	40361642	61364
chr19	40300278	40500278	harbor2	chr19	40362137	40362241	LINE/L2	1132	+	52	40362189	61911
chr19	40300278	40500278	harbor2	chr19	40385024	40385661	LINE/L2	1551	+	318	40385342	85064
chr19	40300278	40500278	harbor2	chr19	40386003	40386060	LINE/L2	1551	+	28	40386031	85753
chr19	40300278	40500278	harbor2	chr19	40386652	40386798	LINE/L2	1551	+	73	40386725	86447
chr19	40300278	40500278	harbor2	chr19	40399049	40399712	LINE/L2	1600	+	332	40399381	99103
chr19	49023305	49223305	harbor2	chr19	49084376	49084582	LINE/L2	913	+	103	49084479	61174
chr19	49023305	49223305	harbor2	chr19	49084893	49085054	LINE/L2	913	+	80	49084973	61668
chr19	58275503	58475503	harbor2	chr19	58324316	58324386	LINE/L2	782	+	35	58324351	48848
chr19	58275503	58475503	harbor2	chr19	58324599	58324874	LINE/L2	782	+	138	58324737	49234
chr19	58275503	58475503	harbor2	chr19	58325007	58325373	LINE/L2	782	+	183	58325190	49687
chr19	56417807	56617807	harbor2	chr19	56424285	56424703	LINE/L2	881	+	209	56424494	6687
chr19	56417807	56617807	harbor2	chr19	56483326	56484483	LINE/L2	640	+	578	56483904	66097
chr19	56417807	56617807	harbor2	chr19	56484498	56484888	LINE/L2	780	+	195	56484693	66886
chr19	50142904	50342904	harbor2	chr19	50155520	50156173	LINE/L2	739	+	326	50155846	12942
chr19	50142904	50342904	harbor2	chr19	50156389	50156503	LINE/L2	675	+	57	50156446	13542
chr19	50142904	50342904	harbor2	chr19	50160149	50160218	LINE/L2	1208	+	34	50160183	17279
chr19	50142904	50342904	harbor2	chr19	50160854	50161111	LINE/L2	1208	+	128	50160982	18078
chr19	50142904	50342904	harbor2	chr19	50161421	50161502	LINE/L2	1208	+	40	50161461	18557
chr19	50142904	50342904	harbor2	chr19	50161510	50161850	LINE/L2	813	+	170	50161680	18776
chr19	50142904	50342904	harbor2	chr19	50174258	50174660	LINE/L2	761	+	201	50174459	31555
chr19	50142904	50342904	harbor2	chr19	50207812	50208130	LINE/L2	814	+	159	50207971	65067
chr19	31858598	32058598	harbor2	chr19	31950610	31950866	LINE/L2	642	+	128	31950738	92140
chr19	55289905	55489905	harbor2	chr19	55357220	55357589	LINE/L2	696	+	184	55357404	67499
chr19	55234371	55434371	harbor2	chr19	55277138	55277361	LINE/L2	837	+	112	55277250	42879
chr19	55234371	55434371	harbor2	chr19	55282446	55282695	LINE/L2	699	+	124	55282570	48199
chr19	52206124	52406124	harbor2	chr19	52272032	52272457	LINE/L2	665	+	212	52272244	66120
chr19	55375297	55575297	harbor2	chr19	55441051	55441652	LINE/L2	873	+	300	55441351	66054
chr19	55375297	55575297	harbor2	chr19	55462351	55462659	LINE/L2	722	+	154	55462505	87208
chr19	55375297	55575297	harbor2	chr19	55462933	55463173	LINE/L2	722	+	120	55463053	87756
chr19	45526095	45726095	harbor2	chr19	45560153	45560428	LINE/L2	648	+	138	45560291	34196
chr19	45526095	45726095	harbor2	chr19	45578853	45579232	LINE/L2	935	+	190	45579043	52948
chr19	45526095	45726095	harbor2	chr19	45579521	45579664	LINE/L2	935	+	72	45579593	53498
chr19	45526095	45726095	harbor2	chr19	45581339	45581658	LINE/L2	910	+	160	45581499	55404
chr19	45526095	45726095	harbor2	chr19	45588213	45588242	LINE/L2	1066	+	14	45588227	62132
chr19	45526095	45726095	harbor2	chr19	45588555	45588688	LINE/L2	1066	+	66	45588621	62526
chr19	45526095	45726095	harbor2	chr19	45588985	45589246	LINE/L2	1066	+	130	45589115	63020
chr19	45526095	45726095	harbor2	chr19	45589544	45589909	LINE/L2	1066	+	182	45589726	63631
chr19	45526095	45726095	harbor2	chr19	45613796	45614362	LINE/L2	1191	+	283	45614079	87984
chr19	34926579	35126579	harbor2	chr19	34962755	34963409	LINE/L2	854	+	327	34963082	36503
chr19	49939182	50139182	harbor2	chr19	49985490	49985786	LINE/L2	665	+	148	49985638	46456
chr19	49939182	50139182	harbor2	chr19	50022325	50022503	LINE/L2	1167	+	89	50022414	83232
chr19	49939182	50139182	harbor2	chr19	50022820	50023182	LINE/L2	1439	+	181	50023001	83819
chr19	49939182	50139182	harbor2	chr19	50023481	50023697	LINE/L2	1439	+	108	50023589	84407
chr19	49939182	50139182	harbor2	chr19	50034037	50034393	LINE/L2	972	+	178	50034215	95033
chr19	45543568	45743568	harbor2	chr19	45560153	45560428	LINE/L2	648	+	138	45560291	16723
chr19	45543568	45743568	harbor2	chr19	45578853	45579232	LINE/L2	935	+	190	45579043	35475
chr19	45543568	45743568	harbor2	chr19	45579521	45579664	LINE/L2	935	+	72	45579593	36025
chr19	45543568	45743568	harbor2	chr19	45581339	45581658	LINE/L2	910	+	160	45581499	37931
chr19	45543568	45743568	harbor2	chr19	45588213	45588242	LINE/L2	1066	+	14	45588227	44659
chr19	45543568	45743568	harbor2	chr19	45588555	45588688	LINE/L2	1066	+	66	45588621	45053
chr19	45543568	45743568	harbor2	chr19	45588985	45589246	LINE/L2	1066	+	130	45589115	45547
chr19	45543568	45743568	harbor2	chr19	45589544	45589909	LINE/L2	1066	+	182	45589726	46158
chr19	45543568	45743568	harbor2	chr19	45613796	45614362	LINE/L2	1191	+	283	45614079	70511
chr19	36502186	36702186	harbor2	chr19	36522937	36523412	LINE/L2	1062	+	238	36523175	20989
chr19	45350712	45550712	harbor2	chr19	45373632	45373916	LINE/L2	978	+	142	45373774	23062
chr19	45350712	45550712	harbor2	chr19	45374211	45374419	LINE/L2	978	+	104	45374315	23603
chr19	45350712	45550712	harbor2	chr19	45421998	45422489	LINE/L2	1060	+	246	45422244	71532
chr19	45350712	45550712	harbor2	chr19	45422786	45422847	LINE/L2	912	+	30	45422816	72104
chr19	47407243	47607243	harbor2	chr19	47435925	47436444	LINE/L2	942	+	260	47436185	28942
chr19	47407243	47607243	harbor2	chr19	47442202	47442670	LINE/L2	1133	+	234	47442436	35193
chr19	47407243	47607243	harbor2	chr19	47442983	47443165	LINE/L2	1058	+	91	47443074	35831
chr19	47407243	47607243	harbor2	chr19	47467693	47467711	LINE/L2	682	+	9	47467702	60459
chr19	47407243	47607243	harbor2	chr19	47468032	47468294	LINE/L2	682	+	131	47468163	60920
chr19	47407243	47607243	harbor2	chr19	47468588	47468714	LINE/L2	682	+	63	47468651	61408
chr19	19634406	19834406	harbor2	chr19	19661266	19661692	LINE/L2	613	+	213	19661479	27073
chr19	44000760	44200760	harbor2	chr19	44009226	44009585	LINE/L2	728	+	180	44009406	8646
chr19	44000760	44200760	harbor2	chr19	44027524	44027891	LINE/L2	864	+	184	44027708	26948
chr19	44000760	44200760	harbor2	chr19	44060891	44061249	LINE/L2	627	+	179	44061070	60310
chr19	44000760	44200760	harbor2	chr19	44061759	44062103	LINE/L2	627	+	172	44061931	61171
chr19	49281070	49481070	harbor2	chr19	49291988	49292089	LINE/L2	979	+	50	49292038	10968
chr19	49281070	49481070	harbor2	chr19	49292388	49293086	LINE/L2	1162	+	349	49292737	11667
chr19	14412298	14612298	harbor2	chr19	14415681	14415789	LINE/L2	802	+	54	14415735	3437
chr19	14412298	14612298	harbor2	chr19	14416087	14416408	LINE/L2	802	+	160	14416247	3949
chr19	14412298	14612298	harbor2	chr19	14494394	14494668	LINE/L2	765	+	137	14494531	82233
chr19	28698788	28898788	harbor2	chr19	28746138	28747033	LINE/L2	857	+	448	28746586	47798
chr19	31118154	31318154	harbor2	chr19	31133057	31133313	LINE/L2	1103	+	128	31133185	15031
chr19	31118154	31318154	harbor2	chr19	31133615	31133944	LINE/L2	1103	+	164	31133779	15625
chr19	55712866	55912866	harbor2	chr19	55789895	55790244	LINE/L2	722	+	174	55790069	77203
chr19	55712866	55912866	harbor2	chr19	55790458	55790589	LINE/L2	722	+	66	55790524	77658
chr19	55712866	55912866	harbor2	chr19	55805456	55805533	LINE/L2	1477	+	38	55805494	92628
chr19	55712866	55912866	harbor2	chr19	55805840	55806831	LINE/L2	1477	+	496	55806336	93470
chr19	34549328	34749328	harbor2	chr19	34591034	34592008	LINE/L2	900	+	487	34591521	42193
chr19	31943487	32143487	harbor2	chr19	31950610	31950866	LINE/L2	642	+	128	31950738	7251
chr19	35214735	35414735	harbor2	chr19	35225897	35226181	LINE/L2	804	+	142	35226039	11304
chr19	35214735	35414735	harbor2	chr19	35226492	35226617	LINE/L2	804	+	62	35226554	11819
chr19	47501373	47701373	harbor2	chr19	47538953	47539260	LINE/L2	1163	+	154	47539107	37734
chr19	53997012	54197012	harbor2	chr19	54003661	54003848	LINE/L2	971	+	94	54003755	6743
chr19	53997012	54197012	harbor2	chr19	54004518	54004868	LINE/L2	971	+	175	54004693	7681
chr19	54147656	54347656	harbor2	chr19	54195748	54195956	LINE/L2	835	+	104	54195852	48196
chr19	54147656	54347656	harbor2	chr19	54196270	54196391	LINE/L2	835	+	60	54196330	48674
chr19	54147656	54347656	harbor2	chr19	54217613	54218056	LINE/L2	675	+	222	54217835	70179
chr19	58261840	58461840	harbor2	chr19	58324316	58324386	LINE/L2	782	+	35	58324351	62511
chr19	58261840	58461840	harbor2	chr19	58324599	58324874	LINE/L2	782	+	138	58324737	62897
chr19	58261840	58461840	harbor2	chr19	58325007	58325373	LINE/L2	782	+	183	58325190	63350
chr19	49993774	50193774	harbor2	chr19	50022325	50022503	LINE/L2	1167	+	89	50022414	28640
chr19	49993774	50193774	harbor2	chr19	50022820	50023182	LINE/L2	1439	+	181	50023001	29227
chr19	49993774	50193774	harbor2	chr19	50023481	50023697	LINE/L2	1439	+	108	50023589	29815
chr19	49993774	50193774	harbor2	chr19	50034037	50034393	LINE/L2	972	+	178	50034215	40441
chr19	45676490	45876490	harbor2	chr19	45688700	45688736	LINE/L2	863	+	18	45688718	12228
chr19	45676490	45876490	harbor2	chr19	45689033	45689381	LINE/L2	863	+	174	45689207	12717
chr19	45676490	45876490	harbor2	chr19	45696036	45696309	LINE/L2	780	+	136	45696172	19682
chr19	36616085	36816085	harbor2	chr19	36660035	36660148	LINE/L2	753	+	56	36660091	44006
chr19	36616085	36816085	harbor2	chr19	36660448	36660610	LINE/L2	753	+	81	36660529	44444
chr19	50427167	50627167	harbor2	chr19	50467935	50468078	LINE/L2	1153	+	72	50468007	40840
chr19	50427167	50627167	harbor2	chr19	50468389	50468603	LINE/L2	1153	+	107	50468496	41329
chr19	50427167	50627167	harbor2	chr19	50468890	50469566	LINE/L2	1153	+	338	50469228	42061
chr19	56649419	56849419	harbor2	chr19	56659165	56659514	LINE/L2	780	+	174	56659339	9920
chr19	38037250	38237250	harbor2	chr19	38122328	38123032	LINE/L2	883	+	352	38122680	85430
chr19	56466025	56666025	harbor2	chr19	56483326	56484483	LINE/L2	640	+	578	56483904	17879
chr19	56466025	56666025	harbor2	chr19	56484498	56484888	LINE/L2	780	+	195	56484693	18668
chr19	56466025	56666025	harbor2	chr19	56540839	56541722	LINE/L2	1765	+	442	56541281	75256
chr19	34803208	35003208	harbor2	chr19	34804567	34804734	LINE/L2	634	+	84	34804651	1443
chr19	34803208	35003208	harbor2	chr19	34805159	34805197	LINE/L2	634	+	19	34805178	1970
chr19	34803208	35003208	harbor2	chr19	34805495	34805728	LINE/L2	634	+	116	34805611	2403
chr19	34803208	35003208	harbor2	chr19	34846622	34847428	LINE/L2	649	+	403	34847025	43817
chr19	50314010	50514010	harbor2	chr19	50380836	50381167	LINE/L2	840	+	166	50381002	66992
chr19	52254536	52454536	harbor2	chr19	52272032	52272457	LINE/L2	665	+	212	52272244	17708
chr19	52254536	52454536	harbor2	chr19	52342406	52342520	LINE/L2	678	+	57	52342463	87927
chr19	52254536	52454536	harbor2	chr19	52342825	52343172	LINE/L2	678	+	174	52342999	88463
chr19	45393507	45593507	harbor2	chr19	45421998	45422489	LINE/L2	1060	+	246	45422244	28737
chr19	45393507	45593507	harbor2	chr19	45422786	45422847	LINE/L2	912	+	30	45422816	29309
chr19	45393507	45593507	harbor2	chr19	45452276	45452495	LINE/L2	622	+	110	45452386	58879
chr19	45393507	45593507	harbor2	chr19	45479576	45479948	LINE/L2	950	+	186	45479762	86255
chr19	45393507	45593507	harbor2	chr19	45480574	45480814	LINE/L2	950	+	120	45480694	87187
chr19	48474969	48674969	harbor2	chr19	48485843	48486047	LINE/L2	726	+	102	48485945	10976
chr19	48474969	48674969	harbor2	chr19	48486359	48486526	LINE/L2	726	+	84	48486443	11474
chr19	48474969	48674969	harbor2	chr19	48487475	48487589	LINE/L2	726	+	57	48487532	12563
chr19	48474969	48674969	harbor2	chr19	48488334	48488738	LINE/L2	622	+	202	48488536	13567
chr19	48474969	48674969	harbor2	chr19	48489039	48489256	LINE/L2	622	+	108	48489147	14178
chr19	48474969	48674969	harbor2	chr19	48516780	48517429	LINE/L2	1328	+	324	48517104	42135
chr19	48474969	48674969	harbor2	chr19	48518017	48518187	LINE/L2	647	+	85	48518102	43133
chr19	48474969	48674969	harbor2	chr19	48541891	48542099	LINE/L2	653	+	104	48541995	67026
chr19	41311424	41511424	harbor2	chr19	41314566	41314718	LINE/L2	1094	+	76	41314642	3218
chr19	41311424	41511424	harbor2	chr19	41316108	41316321	LINE/L2	1094	+	106	41316214	4790
chr19	41311424	41511424	harbor2	chr19	41332935	41333192	LINE/L2	644	+	128	41333063	21639
chr19	41311424	41511424	harbor2	chr19	41343924	41343978	LINE/L2	1131	+	27	41343951	32527
chr19	41311424	41511424	harbor2	chr19	41344285	41344581	LINE/L2	1131	+	148	41344433	33009
chr19	41311424	41511424	harbor2	chr19	41356959	41357393	LINE/L2	818	+	217	41357176	45752
chr19	41311424	41511424	harbor2	chr19	41359857	41360193	LINE/L2	894	+	168	41360025	48601
chr19	41311424	41511424	harbor2	chr19	41360473	41360492	LINE/L2	894	+	10	41360483	49059
chr19	41311424	41511424	harbor2	chr19	41360809	41360945	LINE/L2	894	+	68	41360877	49453
chr19	41311424	41511424	harbor2	chr19	41366271	41366607	LINE/L2	868	+	168	41366439	55015
chr19	41311424	41511424	harbor2	chr19	41395402	41396096	LINE/L2	1166	+	347	41395749	84325
chr19	46550734	46750734	harbor2	chr19	46572106	46572275	LINE/L2	634	+	84	46572190	21456
chr19	46550734	46750734	harbor2	chr19	46606311	46606645	LINE/L2	688	+	167	46606478	55744
chr19	46550734	46750734	harbor2	chr19	46633195	46633499	LINE/L2	1033	+	152	46633347	82613
chr19	46550734	46750734	harbor2	chr19	46640740	46640989	LINE/L2	850	+	124	46640864	90130
chr19	46550734	46750734	harbor2	chr19	46642625	46642906	LINE/L2	973	+	140	46642765	92031
chr19	46550734	46750734	harbor2	chr19	46643191	46643244	LINE/L2	973	+	26	46643217	92483
chr19	46550734	46750734	harbor2	chr19	46643538	46643638	LINE/L2	973	+	50	46643588	92854
chr19	46550734	46750734	harbor2	chr19	46649998	46650127	LINE/L2	1242	+	64	46650062	99328
chr19	47647389	47847389	harbor2	chr19	47650967	47651444	LINE/L2	669	+	238	47651205	3816
chr19	47562041	47762041	harbor2	chr19	47650967	47651444	LINE/L2	669	+	238	47651205	89164
chr19	50102044	50302044	harbor2	chr19	50155520	50156173	LINE/L2	739	+	326	50155846	53802
chr19	50102044	50302044	harbor2	chr19	50156389	50156503	LINE/L2	675	+	57	50156446	54402
chr19	50102044	50302044	harbor2	chr19	50160149	50160218	LINE/L2	1208	+	34	50160183	58139
chr19	50102044	50302044	harbor2	chr19	50160854	50161111	LINE/L2	1208	+	128	50160982	58938
chr19	50102044	50302044	harbor2	chr19	50161421	50161502	LINE/L2	1208	+	40	50161461	59417
chr19	50102044	50302044	harbor2	chr19	50161510	50161850	LINE/L2	813	+	170	50161680	59636
chr19	50102044	50302044	harbor2	chr19	50174258	50174660	LINE/L2	761	+	201	50174459	72415
chr19	18183583	18383583	harbor2	chr19	18230547	18230925	LINE/L2	770	+	189	18230736	47153
chr19	18183583	18383583	harbor2	chr19	18235475	18235940	LINE/L2	804	+	232	18235707	52124
chr19	18183583	18383583	harbor2	chr19	18236515	18236779	LINE/L2	804	+	132	18236647	53064
chr19	56507974	56707974	harbor2	chr19	56540839	56541722	LINE/L2	1765	+	442	56541281	33307
chr19	44510056	44710056	harbor2	chr19	44519474	44519735	LINE/L2	852	+	130	44519604	9548
chr19	44510056	44710056	harbor2	chr19	44520161	44520260	LINE/L2	852	+	50	44520211	10155
chr19	44510056	44710056	harbor2	chr19	44581144	44581797	LINE/L2	1567	+	326	44581470	71414
chr19	44510056	44710056	harbor2	chr19	44581927	44582020	LINE/L2	1567	+	46	44581973	71917
chr19	56646331	56846331	harbor2	chr19	56659165	56659514	LINE/L2	780	+	174	56659339	13008
chr19	42045400	42245400	harbor2	chr19	42059699	42060162	LINE/L2	971	+	232	42059931	14531
chr19	42045400	42245400	harbor2	chr19	42060605	42061036	LINE/L2	1045	+	216	42060821	15421
chr19	42045400	42245400	harbor2	chr19	42102878	42103407	LINE/L2	1016	+	264	42103142	57742
chr19	42045400	42245400	harbor2	chr19	42107764	42108289	LINE/L2	664	+	262	42108026	62626
chr19	42045400	42245400	harbor2	chr19	42111414	42111821	LINE/L2	746	+	204	42111618	66218
chr19	42045400	42245400	harbor2	chr19	42140487	42140837	LINE/L2	647	+	175	42140662	95262
chr19	29189878	29389878	harbor2	chr19	29258531	29258979	LINE/L2	621	+	224	29258755	68877
chr19	44813763	45013763	harbor2	chr19	44881311	44881419	LINE/L2	698	+	54	44881365	67602
chr19	44813763	45013763	harbor2	chr19	44881693	44882088	LINE/L2	698	+	198	44881891	68128
chr19	45504743	45704743	harbor2	chr19	45516053	45516298	LINE/L2	689	+	122	45516175	11432
chr19	45504743	45704743	harbor2	chr19	45560153	45560428	LINE/L2	648	+	138	45560291	55548
chr19	45504743	45704743	harbor2	chr19	45578853	45579232	LINE/L2	935	+	190	45579043	74300
chr19	45504743	45704743	harbor2	chr19	45579521	45579664	LINE/L2	935	+	72	45579593	74850
chr19	45504743	45704743	harbor2	chr19	45581339	45581658	LINE/L2	910	+	160	45581499	76756
chr19	45504743	45704743	harbor2	chr19	45588213	45588242	LINE/L2	1066	+	14	45588227	83484
chr19	45504743	45704743	harbor2	chr19	45588555	45588688	LINE/L2	1066	+	66	45588621	83878
chr19	45504743	45704743	harbor2	chr19	45588985	45589246	LINE/L2	1066	+	130	45589115	84372
chr19	45504743	45704743	harbor2	chr19	45589544	45589909	LINE/L2	1066	+	182	45589726	84983
chr19	55197556	55397556	harbor2	chr19	55277138	55277361	LINE/L2	837	+	112	55277250	79694
chr19	55197556	55397556	harbor2	chr19	55282446	55282695	LINE/L2	699	+	124	55282570	85014
chr19	49907971	50107971	harbor2	chr19	49985490	49985786	LINE/L2	665	+	148	49985638	77667
chr19	37967887	38167887	harbor2	chr19	37969583	37970076	LINE/L2	705	+	246	37969829	1942
chr19	37967887	38167887	harbor2	chr19	38007784	38008055	LINE/L2	831	+	136	38007920	40033
chr19	49946024	50146024	harbor2	chr19	49985490	49985786	LINE/L2	665	+	148	49985638	39614
chr19	49946024	50146024	harbor2	chr19	50022325	50022503	LINE/L2	1167	+	89	50022414	76390
chr19	49946024	50146024	harbor2	chr19	50022820	50023182	LINE/L2	1439	+	181	50023001	76977
chr19	49946024	50146024	harbor2	chr19	50023481	50023697	LINE/L2	1439	+	108	50023589	77565
chr19	49946024	50146024	harbor2	chr19	50034037	50034393	LINE/L2	972	+	178	50034215	88191
chr19	55268124	55468124	harbor2	chr19	55277138	55277361	LINE/L2	837	+	112	55277250	9126
chr19	55268124	55468124	harbor2	chr19	55282446	55282695	LINE/L2	699	+	124	55282570	14446
chr19	55268124	55468124	harbor2	chr19	55357220	55357589	LINE/L2	696	+	184	55357404	89280
chr19	51533879	51733879	harbor2	chr19	51541179	51542172	LINE/L2	809	+	496	51541675	7796
chr19	51533879	51733879	harbor2	chr19	51595032	51595932	LINE/L2	1008	+	450	51595482	61603
chr19	42110347	42310347	harbor2	chr19	42111414	42111821	LINE/L2	746	+	204	42111618	1271
chr19	42110347	42310347	harbor2	chr19	42140487	42140837	LINE/L2	647	+	175	42140662	30315
chr19	42110347	42310347	harbor2	chr19	42146926	42147611	LINE/L2	1024	+	342	42147268	36921
chr19	42110347	42310347	harbor2	chr19	42199895	42200400	LINE/L2	935	+	252	42200147	89800
chr19	37546814	37746814	harbor2	chr19	37566606	37567131	LINE/L2	1231	+	262	37566868	20054
chr19	37546814	37746814	harbor2	chr19	37582179	37583225	LINE/L2	1821	+	523	37582702	35888
chr19	39715780	39915780	harbor2	chr19	39745569	39746303	LINE/L2	2090	+	367	39745936	30156
chr19	39715780	39915780	harbor2	chr19	39749996	39750683	LINE/L2	1707	+	344	39750340	34560
chr19	39715780	39915780	harbor2	chr19	39754929	39755246	LINE/L2	945	+	158	39755087	39307
chr19	39715780	39915780	harbor2	chr19	39755479	39756060	LINE/L2	1446	+	290	39755769	39989
chr19	45834091	46034091	harbor2	chr19	45858214	45858518	LINE/L2	814	+	152	45858366	24275
chr19	45834091	46034091	harbor2	chr19	45892402	45892908	LINE/L2	1138	+	253	45892655	58564
chr19	45834091	46034091	harbor2	chr19	45895040	45895243	LINE/L2	867	+	102	45895142	61051
chr19	45834091	46034091	harbor2	chr19	45898647	45898944	LINE/L2	958	+	148	45898795	64704
chr19	45834091	46034091	harbor2	chr19	45899257	45899374	LINE/L2	958	+	58	45899315	65224
chr19	45834091	46034091	harbor2	chr19	45900121	45900639	LINE/L2	658	+	259	45900380	66289
chr19	45834091	46034091	harbor2	chr19	45858815	45858906	LINE/L2	814	+	46	45858861	24770
chr19	43501707	43701707	harbor2	chr19	43540527	43540865	LINE/L2	672	+	169	43540696	38989
chr19	43501707	43701707	harbor2	chr19	43563560	43563969	LINE/L2	1006	+	204	43563764	62057
chr19	43501707	43701707	harbor2	chr19	43570985	43571505	LINE/L2	1002	+	260	43571245	69538
chr19	43501707	43701707	harbor2	chr19	43571784	43571886	LINE/L2	888	+	51	43571835	70128
chr19	42180627	42380627	harbor2	chr19	42199895	42200400	LINE/L2	935	+	252	42200147	19520
chr19	42180627	42380627	harbor2	chr19	42262023	42262188	LINE/L2	1087	+	82	42262105	81478
chr19	42180627	42380627	harbor2	chr19	42262578	42262870	LINE/L2	1087	+	146	42262724	82097
chr19	54396937	54596937	harbor2	chr19	54434064	54434457	LINE/L2	694	+	196	54434260	37323
chr19	48260879	48460879	harbor2	chr19	48323523	48323894	LINE/L2	721	+	186	48323709	62830
chr19	48260879	48460879	harbor2	chr19	48324206	48324390	LINE/L2	721	+	92	48324298	63419
chr19	48260879	48460879	harbor2	chr19	48351326	48351849	LINE/L2	785	+	262	48351588	90709
chr19	48260879	48460879	harbor2	chr19	48358425	48358886	LINE/L2	1878	+	230	48358655	97776
chr19	48260879	48460879	harbor2	chr19	48359201	48359503	LINE/L2	1878	+	151	48359352	98473
chr19	48260879	48460879	harbor2	chr19	48359807	48360029	LINE/L2	1457	+	111	48359918	99039
chr19	54317216	54517216	harbor2	chr19	54379004	54379408	LINE/L2	967	+	202	54379206	61990
chr19	54317216	54517216	harbor2	chr19	54380916	54381484	LINE/L2	1703	+	284	54381200	63984
chr19	54317216	54517216	harbor2	chr19	54385041	54385801	LINE/L2	839	+	380	54385421	68205
chr19	37524861	37724861	harbor2	chr19	37566606	37567131	LINE/L2	1231	+	262	37566868	42007
chr19	37524861	37724861	harbor2	chr19	37582179	37583225	LINE/L2	1821	+	523	37582702	57841
chr19	30039458	30239458	harbor2	chr19	30135338	30135845	LINE/L2	971	+	254	30135592	96134
chr19	43436508	43636508	harbor2	chr19	43482900	43483095	LINE/L2	701	+	98	43482998	46490
chr19	39833667	40033667	harbor2	chr19	39842863	39843254	LINE/L2	914	+	196	39843059	9392
chr19	39833667	40033667	harbor2	chr19	39844484	39844869	LINE/L2	1018	+	192	39844676	11009
chr19	39833667	40033667	harbor2	chr19	39848738	39849713	LINE/L2	2192	+	488	39849226	15559
chr19	39833667	40033667	harbor2	chr19	39916263	39916601	LINE/L2	817	+	169	39916432	82765
chr19	39833667	40033667	harbor2	chr19	39918962	39918986	LINE/L2	723	+	12	39918974	85307
chr19	39833667	40033667	harbor2	chr19	39919264	39919484	LINE/L2	723	+	110	39919374	85707
chr19	34972912	35172912	harbor2	chr19	35047191	35047683	LINE/L2	740	+	246	35047437	74525
chr19	34972912	35172912	harbor2	chr19	35055948	35056437	LINE/L2	973	+	244	35056192	83280
chr19	52433554	52633554	harbor2	chr19	52455085	52455193	LINE/L2	674	+	54	52455139	21585
chr19	52433554	52633554	harbor2	chr19	52455495	52455745	LINE/L2	674	+	125	52455620	22066
chr19	36406224	36606224	harbor2	chr19	36470024	36470628	LINE/L2	1144	+	302	36470326	64102
chr19	36406224	36606224	harbor2	chr19	36471233	36471743	LINE/L2	1144	+	255	36471488	65264
chr19	36406224	36606224	harbor2	chr19	36472040	36472135	LINE/L2	733	+	48	36472088	65864
chr19	40230630	40430630	harbor2	chr19	40263770	40264167	LINE/L2	778	+	198	40263968	33338
chr19	40230630	40430630	harbor2	chr19	40264390	40264918	LINE/L2	707	+	264	40264654	34024
chr19	40230630	40430630	harbor2	chr19	40269868	40270394	LINE/L2	816	+	263	40270131	39501
chr19	40230630	40430630	harbor2	chr19	40328862	40329225	LINE/L2	937	+	182	40329044	98414
chr19	40230630	40430630	harbor2	chr19	40329533	40329564	LINE/L2	937	+	16	40329549	98919
chr19	37999378	38199378	harbor2	chr19	38007784	38008055	LINE/L2	831	+	136	38007920	8542
chr19	56501095	56701095	harbor2	chr19	56540839	56541722	LINE/L2	1765	+	442	56541281	40186
chr19	33931450	34131450	harbor2	chr19	33960070	33960316	LINE/L2	1356	+	123	33960193	28743
chr19	33931450	34131450	harbor2	chr19	33960629	33960861	LINE/L2	1356	+	116	33960745	29295
chr19	33931450	34131450	harbor2	chr19	33989616	33989939	LINE/L2	1141	+	162	33989778	58328
chr19	47113754	47313754	harbor2	chr19	47142558	47143028	LINE/L2	1155	+	235	47142793	29039
chr19	45898559	46098559	harbor2	chr19	45898647	45898944	LINE/L2	958	+	148	45898795	236
chr19	45898559	46098559	harbor2	chr19	45899257	45899374	LINE/L2	958	+	58	45899315	756
chr19	45898559	46098559	harbor2	chr19	45900121	45900639	LINE/L2	658	+	259	45900380	1821
chr19	45898559	46098559	harbor2	chr19	45947045	45947275	LINE/L2	926	+	115	45947160	48601
chr19	45898559	46098559	harbor2	chr19	45958774	45959122	LINE/L2	686	+	174	45958948	60389
chr19	45898559	46098559	harbor2	chr19	45981600	45981924	LINE/L2	655	+	162	45981762	83203
chr19	45898559	46098559	harbor2	chr19	45982216	45982269	LINE/L2	655	+	26	45982242	83683
chr19	45898559	46098559	harbor2	chr19	45987365	45987675	LINE/L2	1597	+	155	45987520	88961
chr19	45898559	46098559	harbor2	chr19	45988000	45988243	LINE/L2	1597	+	122	45988122	89563
chr19	45898559	46098559	harbor2	chr19	45988717	45988786	LINE/L2	1597	+	34	45988751	90192
chr19	45898559	46098559	harbor2	chr19	45989099	45989215	LINE/L2	1597	+	58	45989157	90598
chr19	45898559	46098559	harbor2	chr19	45990202	45990353	LINE/L2	1597	+	76	45990278	91719
chr19	45898559	46098559	harbor2	chr19	45991377	45991429	LINE/L2	892	+	26	45991403	92844
chr19	45898559	46098559	harbor2	chr19	45991731	45992002	LINE/L2	892	+	136	45991867	93308
chr19	45898559	46098559	harbor2	chr19	45992316	45992333	LINE/L2	889	+	8	45992324	93765
chr19	45898559	46098559	harbor2	chr19	45992639	45992783	LINE/L2	889	+	72	45992711	94152
chr19	45898559	46098559	harbor2	chr19	45993096	45993242	LINE/L2	889	+	73	45993169	94610
chr19	45898559	46098559	harbor2	chr19	45996097	45996427	LINE/L2	1565	+	165	45996262	97703
chr19	45898559	46098559	harbor2	chr19	45996699	45997389	LINE/L2	1565	+	345	45997044	98485
chr19	45898559	46098559	harbor2	chr19	45997987	45998068	LINE/L2	686	+	40	45998027	99468
chr19	45898559	46098559	harbor2	chr19	45989430	45989946	LINE/L2	1597	+	258	45989688	91129
chr19	31888380	32088380	harbor2	chr19	31950610	31950866	LINE/L2	642	+	128	31950738	62358
chr19	45917382	46117382	harbor2	chr19	45947045	45947275	LINE/L2	926	+	115	45947160	29778
chr19	45917382	46117382	harbor2	chr19	45958774	45959122	LINE/L2	686	+	174	45958948	41566
chr19	45917382	46117382	harbor2	chr19	45981600	45981924	LINE/L2	655	+	162	45981762	64380
chr19	45917382	46117382	harbor2	chr19	45982216	45982269	LINE/L2	655	+	26	45982242	64860
chr19	45917382	46117382	harbor2	chr19	45987365	45987675	LINE/L2	1597	+	155	45987520	70138
chr19	45917382	46117382	harbor2	chr19	45988000	45988243	LINE/L2	1597	+	122	45988122	70740
chr19	45917382	46117382	harbor2	chr19	45988717	45988786	LINE/L2	1597	+	34	45988751	71369
chr19	45917382	46117382	harbor2	chr19	45989099	45989215	LINE/L2	1597	+	58	45989157	71775
chr19	45917382	46117382	harbor2	chr19	45990202	45990353	LINE/L2	1597	+	76	45990278	72896
chr19	45917382	46117382	harbor2	chr19	45991377	45991429	LINE/L2	892	+	26	45991403	74021
chr19	45917382	46117382	harbor2	chr19	45991731	45992002	LINE/L2	892	+	136	45991867	74485
chr19	45917382	46117382	harbor2	chr19	45992316	45992333	LINE/L2	889	+	8	45992324	74942
chr19	45917382	46117382	harbor2	chr19	45992639	45992783	LINE/L2	889	+	72	45992711	75329
chr19	45917382	46117382	harbor2	chr19	45993096	45993242	LINE/L2	889	+	73	45993169	75787
chr19	45917382	46117382	harbor2	chr19	45996097	45996427	LINE/L2	1565	+	165	45996262	78880
chr19	45917382	46117382	harbor2	chr19	45996699	45997389	LINE/L2	1565	+	345	45997044	79662
chr19	45917382	46117382	harbor2	chr19	45997987	45998068	LINE/L2	686	+	40	45998027	80645
chr19	45917382	46117382	harbor2	chr19	45989430	45989946	LINE/L2	1597	+	258	45989688	72306
chr19	55784381	55984381	harbor2	chr19	55789895	55790244	LINE/L2	722	+	174	55790069	5688
chr19	55784381	55984381	harbor2	chr19	55790458	55790589	LINE/L2	722	+	66	55790524	6143
chr19	55784381	55984381	harbor2	chr19	55805456	55805533	LINE/L2	1477	+	38	55805494	21113
chr19	55784381	55984381	harbor2	chr19	55805840	55806831	LINE/L2	1477	+	496	55806336	21955
chr19	41342200	41542200	harbor2	chr19	41343924	41343978	LINE/L2	1131	+	27	41343951	1751
chr19	41342200	41542200	harbor2	chr19	41344285	41344581	LINE/L2	1131	+	148	41344433	2233
chr19	41342200	41542200	harbor2	chr19	41356959	41357393	LINE/L2	818	+	217	41357176	14976
chr19	41342200	41542200	harbor2	chr19	41359857	41360193	LINE/L2	894	+	168	41360025	17825
chr19	41342200	41542200	harbor2	chr19	41360473	41360492	LINE/L2	894	+	10	41360483	18283
chr19	41342200	41542200	harbor2	chr19	41360809	41360945	LINE/L2	894	+	68	41360877	18677
chr19	41342200	41542200	harbor2	chr19	41366271	41366607	LINE/L2	868	+	168	41366439	24239
chr19	41342200	41542200	harbor2	chr19	41395402	41396096	LINE/L2	1166	+	347	41395749	53549
chr19	45585986	45785986	harbor2	chr19	45588213	45588242	LINE/L2	1066	+	14	45588227	2241
chr19	45585986	45785986	harbor2	chr19	45588555	45588688	LINE/L2	1066	+	66	45588621	2635
chr19	45585986	45785986	harbor2	chr19	45588985	45589246	LINE/L2	1066	+	130	45589115	3129
chr19	45585986	45785986	harbor2	chr19	45589544	45589909	LINE/L2	1066	+	182	45589726	3740
chr19	45585986	45785986	harbor2	chr19	45613796	45614362	LINE/L2	1191	+	283	45614079	28093
chr19	14103290	14303290	harbor2	chr19	14139925	14140329	LINE/L2	1114	+	202	14140127	36837
chr19	14103290	14303290	harbor2	chr19	14140635	14140710	LINE/L2	1114	+	38	14140673	37383
chr19	14103290	14303290	harbor2	chr19	14141029	14141205	LINE/L2	1114	+	88	14141117	37827
chr19	33584439	33784439	harbor2	chr19	33671319	33671901	LINE/L2	663	+	291	33671610	87171
chr19	36030897	36230897	harbor2	chr19	36030514	36030982	LINE/L2	727	+	234	36030748	149
chr19	36030897	36230897	harbor2	chr19	36031317	36031516	LINE/L2	727	+	100	36031417	520
chr19	36030897	36230897	harbor2	chr19	36033924	36034328	LINE/L2	676	+	202	36034126	3229
chr19	36030897	36230897	harbor2	chr19	36034630	36034790	LINE/L2	676	+	80	36034710	3813
chr19	36030897	36230897	harbor2	chr19	36116921	36117341	LINE/L2	685	+	210	36117131	86234
chr19	36030897	36230897	harbor2	chr19	36117652	36117677	LINE/L2	685	+	12	36117664	86767
chr19	55207015	55407015	harbor2	chr19	55277138	55277361	LINE/L2	837	+	112	55277250	70235
chr19	55207015	55407015	harbor2	chr19	55282446	55282695	LINE/L2	699	+	124	55282570	75555
chr19	56748409	56948409	harbor2	chr19	56777317	56777547	LINE/L2	950	+	115	56777432	29023
chr19	56748409	56948409	harbor2	chr19	56777752	56778282	LINE/L2	1101	+	265	56778017	29608
chr19	42226662	42426662	harbor2	chr19	42262023	42262188	LINE/L2	1087	+	82	42262105	35443
chr19	42226662	42426662	harbor2	chr19	42262578	42262870	LINE/L2	1087	+	146	42262724	36062
chr19	54993165	55193165	harbor2	chr19	55069537	55070155	LINE/L2	694	+	309	55069846	76681
chr19	54993165	55193165	harbor2	chr19	55089366	55089994	LINE/L2	688	+	314	55089680	96515
chr19	30259666	30459666	harbor2	chr19	30278710	30279373	LINE/L2	726	+	332	30279042	19376
chr19	30259666	30459666	harbor2	chr19	30314926	30315200	LINE/L2	674	+	137	30315063	55397
chr19	30259666	30459666	harbor2	chr19	30331575	30332313	LINE/L2	732	+	369	30331944	72278
chr19	10253166	10453166	harbor2	chr19	10268399	10268757	LINE/L2	691	+	179	10268578	15412
chr19	10253166	10453166	harbor2	chr19	10269056	10269174	LINE/L2	691	+	59	10269115	15949
chr19	46686890	46886890	harbor2	chr19	46692405	46693016	LINE/L2	856	+	306	46692711	5821
chr19	46686890	46886890	harbor2	chr19	46693026	46693336	LINE/L2	899	+	155	46693181	6291
chr19	46686890	46886890	harbor2	chr19	46699054	46699458	LINE/L2	1055	+	202	46699256	12366
chr19	46686890	46886890	harbor2	chr19	46731644	46732623	LINE/L2	1069	+	490	46732134	45244
chr19	53943380	54143380	harbor2	chr19	54003661	54003848	LINE/L2	971	+	94	54003755	60375
chr19	53943380	54143380	harbor2	chr19	54004518	54004868	LINE/L2	971	+	175	54004693	61313
chr19	58227627	58427627	harbor2	chr19	58324316	58324386	LINE/L2	782	+	35	58324351	96724
chr19	58227627	58427627	harbor2	chr19	58324599	58324874	LINE/L2	782	+	138	58324737	97110
chr19	58227627	58427627	harbor2	chr19	58325007	58325373	LINE/L2	782	+	183	58325190	97563
chr19	50693387	50893387	harbor2	chr19	50706502	50706760	LINE/L2	937	+	129	50706631	13244
chr19	50693387	50893387	harbor2	chr19	50707078	50707107	LINE/L2	937	+	14	50707092	13705
chr19	50693387	50893387	harbor2	chr19	50755447	50755499	LINE/L2	1934	+	26	50755473	62086
chr19	50693387	50893387	harbor2	chr19	50755800	50756568	LINE/L2	1934	+	384	50756184	62797
chr19	50693387	50893387	harbor2	chr19	50756869	50756976	LINE/L2	944	+	54	50756923	63536
chr19	50693387	50893387	harbor2	chr19	50766375	50766440	LINE/L2	2097	+	32	50766407	73020
chr19	50693387	50893387	harbor2	chr19	50766554	50766612	LINE/L2	2097	+	29	50766583	73196
chr19	50693387	50893387	harbor2	chr19	50766904	50767649	LINE/L2	2097	+	372	50767276	73889
chr19	50693387	50893387	harbor2	chr19	50767943	50768050	LINE/L2	883	+	54	50767997	74610
chr19	50693387	50893387	harbor2	chr19	50768359	50768380	LINE/L2	883	+	10	50768369	74982
chr19	45002855	45202855	harbor2	chr19	45041562	45041987	LINE/L2	755	+	212	45041774	38919
chr19	45002855	45202855	harbor2	chr19	45046429	45046674	LINE/L2	837	+	122	45046551	43696
chr19	45002855	45202855	harbor2	chr19	45081534	45081615	LINE/L2	891	+	40	45081574	78719
chr19	45002855	45202855	harbor2	chr19	45081923	45082589	LINE/L2	891	+	333	45082256	79401
chr19	50572064	50772064	harbor2	chr19	50577720	50578300	LINE/L2	1891	+	290	50578010	5946
chr19	50572064	50772064	harbor2	chr19	50578613	50579018	LINE/L2	1891	+	202	50578815	6751
chr19	50572064	50772064	harbor2	chr19	50579332	50579416	LINE/L2	1891	+	42	50579374	7310
chr19	50572064	50772064	harbor2	chr19	50580042	50580480	LINE/L2	1891	+	219	50580261	8197
chr19	50572064	50772064	harbor2	chr19	50669943	50670787	LINE/L2	2386	+	422	50670365	98301
chr19	50572064	50772064	harbor2	chr19	50671092	50671168	LINE/L2	1263	+	38	50671130	99066
chr19	50572064	50772064	harbor2	chr19	50671483	50671701	LINE/L2	1263	+	109	50671592	99528
chr19	55540936	55740936	harbor2	chr19	55568503	55569034	LINE/L2	1133	+	266	55568769	27833
chr19	55540936	55740936	harbor2	chr19	55586020	55586459	LINE/L2	765	+	220	55586240	45304
chr19	55540936	55740936	harbor2	chr19	55586775	55586970	LINE/L2	765	+	98	55586873	45937
chr19	54199078	54399078	harbor2	chr19	54217613	54218056	LINE/L2	675	+	222	54217835	18757
chr19	54199078	54399078	harbor2	chr19	54275202	54275648	LINE/L2	613	+	223	54275425	76347
chr19	56380649	56580649	harbor2	chr19	56403620	56403825	LINE/L2	633	+	102	56403722	23073
chr19	56380649	56580649	harbor2	chr19	56408754	56409282	LINE/L2	920	+	264	56409018	28369
chr19	56380649	56580649	harbor2	chr19	56424285	56424703	LINE/L2	881	+	209	56424494	43845
chr19	44577527	44777527	harbor2	chr19	44581144	44581797	LINE/L2	1567	+	326	44581470	3943
chr19	44577527	44777527	harbor2	chr19	44581927	44582020	LINE/L2	1567	+	46	44581973	4446
chr19	44577527	44777527	harbor2	chr19	44622540	44623122	LINE/L2	1082	+	291	44622831	45304
chr19	44577527	44777527	harbor2	chr19	44642600	44642817	LINE/L2	711	+	108	44642708	65181
chr19	44577527	44777527	harbor2	chr19	44659983	44660244	LINE/L2	848	+	130	44660113	82586
chr19	44577527	44777527	harbor2	chr19	44669526	44670015	LINE/L2	723	+	244	44669770	92243
chr19	47444397	47644397	harbor2	chr19	47467693	47467711	LINE/L2	682	+	9	47467702	23305
chr19	47444397	47644397	harbor2	chr19	47468032	47468294	LINE/L2	682	+	131	47468163	23766
chr19	47444397	47644397	harbor2	chr19	47468588	47468714	LINE/L2	682	+	63	47468651	24254
chr19	47444397	47644397	harbor2	chr19	47538953	47539260	LINE/L2	1163	+	154	47539107	94710
chr19	51741438	51941438	harbor2	chr19	51783696	51784666	LINE/L2	1307	+	485	51784181	42743
chr19	51741438	51941438	harbor2	chr19	51830219	51830520	LINE/L2	1542	+	150	51830369	88931
chr19	51741438	51941438	harbor2	chr19	51830574	51831105	LINE/L2	1542	+	266	51830840	89402
chr19	51741438	51941438	harbor2	chr19	51831417	51832054	LINE/L2	1542	+	318	51831735	90297
chr19	58312607	58512607	harbor2	chr19	58324316	58324386	LINE/L2	782	+	35	58324351	11744
chr19	58312607	58512607	harbor2	chr19	58324599	58324874	LINE/L2	782	+	138	58324737	12130
chr19	58312607	58512607	harbor2	chr19	58325007	58325373	LINE/L2	782	+	183	58325190	12583
chr19	31427485	31627485	harbor2	chr19	31450021	31450626	LINE/L2	946	+	302	31450323	22838
chr19	45662493	45862493	harbor2	chr19	45688700	45688736	LINE/L2	863	+	18	45688718	26225
chr19	45662493	45862493	harbor2	chr19	45689033	45689381	LINE/L2	863	+	174	45689207	26714
chr19	45662493	45862493	harbor2	chr19	45696036	45696309	LINE/L2	780	+	136	45696172	33679
chr19	45104451	45304451	harbor2	chr19	45157286	45157424	LINE/L2	720	+	69	45157355	52904
chr19	45104451	45304451	harbor2	chr19	45158025	45158190	LINE/L2	720	+	82	45158107	53656
chr19	45104451	45304451	harbor2	chr19	45154241	45154450	LINE/L2	676	+	104	45154345	49894
chr19	48489764	48689764	harbor2	chr19	48516780	48517429	LINE/L2	1328	+	324	48517104	27340
chr19	48489764	48689764	harbor2	chr19	48518017	48518187	LINE/L2	647	+	85	48518102	28338
chr19	48489764	48689764	harbor2	chr19	48541891	48542099	LINE/L2	653	+	104	48541995	52231
chr19	28521046	28721046	harbor2	chr19	28590899	28590940	LINE/L2	822	+	20	28590919	69873
chr19	28521046	28721046	harbor2	chr19	28591720	28592607	LINE/L2	822	+	444	28592164	71118
chr19	28521046	28721046	harbor2	chr19	28594731	28595219	LINE/L2	917	+	244	28594975	73929
chr19	45867809	46067809	harbor2	chr19	45892402	45892908	LINE/L2	1138	+	253	45892655	24846
chr19	45867809	46067809	harbor2	chr19	45895040	45895243	LINE/L2	867	+	102	45895142	27333
chr19	45867809	46067809	harbor2	chr19	45898647	45898944	LINE/L2	958	+	148	45898795	30986
chr19	45867809	46067809	harbor2	chr19	45899257	45899374	LINE/L2	958	+	58	45899315	31506
chr19	45867809	46067809	harbor2	chr19	45900121	45900639	LINE/L2	658	+	259	45900380	32571
chr19	45867809	46067809	harbor2	chr19	45947045	45947275	LINE/L2	926	+	115	45947160	79351
chr19	45867809	46067809	harbor2	chr19	45958774	45959122	LINE/L2	686	+	174	45958948	91139
chr19	30524302	30724302	harbor2	chr19	30536838	30537180	LINE/L2	959	+	171	30537009	12707
chr19	30524302	30724302	harbor2	chr19	30623104	30623899	LINE/L2	901	+	398	30623502	99200
chr19	31445680	31645680	harbor2	chr19	31450021	31450626	LINE/L2	946	+	302	31450323	4643
chr19	54124536	54324536	harbor2	chr19	54195748	54195956	LINE/L2	835	+	104	54195852	71316
chr19	54124536	54324536	harbor2	chr19	54196270	54196391	LINE/L2	835	+	60	54196330	71794
chr19	54124536	54324536	harbor2	chr19	54217613	54218056	LINE/L2	675	+	222	54217835	93299
chr19	35713852	35913852	harbor2	chr19	35735335	35735897	LINE/L2	926	+	281	35735616	21764
chr19	35713852	35913852	harbor2	chr19	35768898	35769303	LINE/L2	1460	+	202	35769100	55248
chr19	35713852	35913852	harbor2	chr19	35769606	35769727	LINE/L2	1460	+	60	35769666	55814
chr19	35713852	35913852	harbor2	chr19	35770338	35770435	LINE/L2	1460	+	48	35770386	56534
chr19	46541734	46741734	harbor2	chr19	46572106	46572275	LINE/L2	634	+	84	46572190	30456
chr19	46541734	46741734	harbor2	chr19	46606311	46606645	LINE/L2	688	+	167	46606478	64744
chr19	46541734	46741734	harbor2	chr19	46633195	46633499	LINE/L2	1033	+	152	46633347	91613
chr19	46541734	46741734	harbor2	chr19	46640740	46640989	LINE/L2	850	+	124	46640864	99130
chr19	56509919	56709919	harbor2	chr19	56540839	56541722	LINE/L2	1765	+	442	56541281	31362
chr19	51633721	51833721	harbor2	chr19	51662592	51662986	LINE/L2	1238	+	197	51662789	29068
chr19	51633721	51833721	harbor2	chr19	51705352	51705688	LINE/L2	785	+	168	51705520	71799
chr19	51633721	51833721	harbor2	chr19	51705996	51706315	LINE/L2	785	+	160	51706156	72435
chr19	51633721	51833721	harbor2	chr19	51715124	51715633	LINE/L2	712	+	254	51715378	81657
chr19	45565682	45765682	harbor2	chr19	45578853	45579232	LINE/L2	935	+	190	45579043	13361
chr19	45565682	45765682	harbor2	chr19	45579521	45579664	LINE/L2	935	+	72	45579593	13911
chr19	45565682	45765682	harbor2	chr19	45581339	45581658	LINE/L2	910	+	160	45581499	15817
chr19	45565682	45765682	harbor2	chr19	45588213	45588242	LINE/L2	1066	+	14	45588227	22545
chr19	45565682	45765682	harbor2	chr19	45588555	45588688	LINE/L2	1066	+	66	45588621	22939
chr19	45565682	45765682	harbor2	chr19	45588985	45589246	LINE/L2	1066	+	130	45589115	23433
chr19	45565682	45765682	harbor2	chr19	45589544	45589909	LINE/L2	1066	+	182	45589726	24044
chr19	45565682	45765682	harbor2	chr19	45613796	45614362	LINE/L2	1191	+	283	45614079	48397
chr19	56975687	57175687	harbor2	chr19	57009903	57010358	LINE/L2	805	+	228	57010131	34444
chr19	56975687	57175687	harbor2	chr19	57015168	57015604	LINE/L2	706	+	218	57015386	39699
chr19	56975687	57175687	harbor2	chr19	57047780	57048282	LINE/L2	765	+	251	57048031	72344
chr19	57627747	57827747	harbor2	chr19	57707184	57707634	LINE/L2	673	+	225	57707409	79662
chr19	37840523	38040523	harbor2	chr19	37856499	37856896	LINE/L2	3490	+	198	37856697	16174
chr19	37840523	38040523	harbor2	chr19	37857195	37857807	LINE/L2	3490	+	306	37857501	16978
chr19	37840523	38040523	harbor2	chr19	37858102	37858832	LINE/L2	3490	+	365	37858467	17944
chr19	37840523	38040523	harbor2	chr19	37933150	37933572	LINE/L2	1093	+	211	37933361	92838
chr19	4527523	4727523	harbor2	chr19	4547576	4547919	LINE/L2	1032	+	172	4547748	20225
chr19	4527523	4727523	harbor2	chr19	4557686	4558016	LINE/L2	817	+	165	4557851	30328
chr19	4527523	4727523	harbor2	chr19	4567487	4568123	LINE/L2	1021	+	318	4567805	40282
chr19	4527523	4727523	harbor2	chr19	4576003	4576774	LINE/L2	1287	+	386	4576389	48866
chr19	4527523	4727523	harbor2	chr19	4615690	4616067	LINE/L2	794	+	188	4615878	88355
chr19	50061353	50261353	harbor2	chr19	50155520	50156173	LINE/L2	739	+	326	50155846	94493
chr19	50061353	50261353	harbor2	chr19	50156389	50156503	LINE/L2	675	+	57	50156446	95093
chr19	50061353	50261353	harbor2	chr19	50160149	50160218	LINE/L2	1208	+	34	50160183	98830
chr19	50061353	50261353	harbor2	chr19	50160854	50161111	LINE/L2	1208	+	128	50160982	99629
chr19	51061002	51261002	harbor2	chr19	51061339	51061925	LINE/L2	1069	+	293	51061632	630
chr19	51061002	51261002	harbor2	chr19	51062251	51062569	LINE/L2	696	+	159	51062410	1408
chr19	51061002	51261002	harbor2	chr19	51069691	51070254	LINE/L2	1340	+	282	51069973	8971
chr19	51061002	51261002	harbor2	chr19	51070844	51071083	LINE/L2	804	+	120	51070964	9962
chr19	51061002	51261002	harbor2	chr19	51091945	51092875	LINE/L2	919	+	465	51092410	31408
chr19	51061002	51261002	harbor2	chr19	51093917	51094293	LINE/L2	760	+	188	51094105	33103
chr19	51061002	51261002	harbor2	chr19	51096659	51097271	LINE/L2	1193	+	306	51096965	35963
chr19	51061002	51261002	harbor2	chr19	51105661	51106281	LINE/L2	696	+	310	51105971	44969
chr19	51061002	51261002	harbor2	chr19	51068821	51069173	LINE/L2	922	+	176	51068997	7995
chr19	56694722	56894722	harbor2	chr19	56777317	56777547	LINE/L2	950	+	115	56777432	82710
chr19	56694722	56894722	harbor2	chr19	56777752	56778282	LINE/L2	1101	+	265	56778017	83295
chr19	44254115	44454115	harbor2	chr19	44267012	44267351	LINE/L2	1128	+	170	44267182	13067
chr19	44254115	44454115	harbor2	chr19	44267681	44267812	LINE/L2	1128	+	66	44267747	13632
chr19	47815798	48015798	harbor2	chr19	47871723	47871912	LINE/L2	1094	+	94	47871817	56019
chr19	47815798	48015798	harbor2	chr19	47872218	47872724	LINE/L2	1094	+	253	47872471	56673
chr19	55186979	55386979	harbor2	chr19	55277138	55277361	LINE/L2	837	+	112	55277250	90271
chr19	55186979	55386979	harbor2	chr19	55282446	55282695	LINE/L2	699	+	124	55282570	95591
chr19	50307906	50507906	harbor2	chr19	50380836	50381167	LINE/L2	840	+	166	50381002	73096
chr20	42203949	42403949	harbor2	chr20	42231950	42232183	LINE/L2	623	+	116	42232066	28117
chr20	42203949	42403949	harbor2	chr20	42270104	42270189	LINE/L2	387	+	42	42270146	66197
chr20	42203949	42403949	harbor2	chr20	42270743	42271064	LINE/L2	477	+	160	42270903	66954
chr20	42203949	42403949	harbor2	chr20	42271145	42271609	LINE/L2	675	+	232	42271377	67428
chr20	42203949	42403949	harbor2	chr20	42293195	42293887	LINE/L2	977	+	346	42293541	89592
chr20	42203949	42403949	harbor2	chr20	42302412	42302742	LINE/L2	578	+	165	42302577	98628
chr20	64246677	64446677	harbor2	chr20	64296465	64296574	LINE/L2	384	+	54	64296519	49842
chr20	60310247	60510247	harbor2	chr20	60312154	60312419	LINE/L2	511	+	132	60312286	2039
chr20	60310247	60510247	harbor2	chr20	60348146	60348588	LINE/L2	724	+	221	60348367	38120
chr20	56996882	57196882	harbor2	chr20	57003635	57003986	LINE/L2	1026	+	176	57003811	6929
chr20	56996882	57196882	harbor2	chr20	57004286	57004514	LINE/L2	1026	+	114	57004400	7518
chr20	56996882	57196882	harbor2	chr20	57005876	57006054	LINE/L2	459	+	89	57005965	9083
chr20	56996882	57196882	harbor2	chr20	57006355	57006441	LINE/L2	459	+	43	57006398	9516
chr20	56996882	57196882	harbor2	chr20	57017839	57018012	LINE/L2	456	+	86	57017925	21043
chr20	56996882	57196882	harbor2	chr20	57018349	57018473	LINE/L2	456	+	62	57018411	21529
chr20	56996882	57196882	harbor2	chr20	57035792	57036610	LINE/L2	695	+	409	57036201	39319
chr20	56996882	57196882	harbor2	chr20	57080390	57080607	LINE/L2	623	+	108	57080498	83616
chr20	56996882	57196882	harbor2	chr20	57095525	57095770	LINE/L2	518	+	122	57095647	98765
chr20	32744295	32944295	harbor2	chr20	32823943	32824267	LINE/L2	533	+	162	32824105	79810
chr20	45732769	45932769	harbor2	chr20	45782142	45782361	LINE/L2	745	+	110	45782252	49483
chr20	45732769	45932769	harbor2	chr20	45782676	45782988	LINE/L2	745	+	156	45782832	50063
chr20	45732769	45932769	harbor2	chr20	45785882	45786118	LINE/L2	1014	+	118	45786000	53231
chr20	45732769	45932769	harbor2	chr20	45786414	45786655	LINE/L2	1014	+	120	45786534	53765
chr20	45732769	45932769	harbor2	chr20	45796643	45797096	LINE/L2	1079	+	226	45796869	64100
chr20	45732769	45932769	harbor2	chr20	45797099	45797253	LINE/L2	492	+	77	45797176	64407
chr20	45732769	45932769	harbor2	chr20	45798496	45798738	LINE/L2	423	+	121	45798617	65848
chr20	45732769	45932769	harbor2	chr20	45799408	45799804	LINE/L2	595	+	198	45799606	66837
chr20	45732769	45932769	harbor2	chr20	45803934	45805017	LINE/L2	1036	+	542	45804476	71707
chr20	46208767	46408767	harbor2	chr20	46214391	46214944	LINE/L2	726	+	276	46214667	5900
chr20	46208767	46408767	harbor2	chr20	46222326	46222474	LINE/L2	429	+	74	46222400	13633
chr20	46208767	46408767	harbor2	chr20	46224152	46224377	LINE/L2	643	+	112	46224264	15497
chr20	46208767	46408767	harbor2	chr20	46235837	46236129	LINE/L2	997	+	146	46235983	27216
chr20	46208767	46408767	harbor2	chr20	46236309	46236488	LINE/L2	963	+	90	46236399	27632
chr20	46208767	46408767	harbor2	chr20	46238403	46239252	LINE/L2	1620	+	424	46238827	30060
chr20	46208767	46408767	harbor2	chr20	46271348	46272177	LINE/L2	1349	+	414	46271762	62995
chr20	46208767	46408767	harbor2	chr20	46275119	46275662	LINE/L2	1343	+	272	46275391	66624
chr20	46208767	46408767	harbor2	chr20	46288332	46289496	LINE/L2	2653	+	582	46288914	80147
chr20	46208767	46408767	harbor2	chr20	46289510	46289658	LINE/L2	416	+	74	46289584	80817
chr20	46208767	46408767	harbor2	chr20	46292628	46292916	LINE/L2	520	+	144	46292772	84005
chr20	46208767	46408767	harbor2	chr20	46292960	46293088	LINE/L2	520	+	64	46293024	84257
chr20	41219780	41419780	harbor2	chr20	41231387	41231707	LINE/L2	484	+	160	41231547	11767
chr20	41219780	41419780	harbor2	chr20	41256222	41256341	LINE/L2	474	+	60	41256282	36502
chr20	41219780	41419780	harbor2	chr20	41261709	41262394	LINE/L2	636	+	342	41262051	42271
chr20	41219780	41419780	harbor2	chr20	41286574	41286718	LINE/L2	483	+	72	41286646	66866
chr20	41219780	41419780	harbor2	chr20	41287085	41287368	LINE/L2	639	+	142	41287227	67447
chr20	41219780	41419780	harbor2	chr20	41301255	41301567	LINE/L2	632	+	156	41301411	81631
chr20	41219780	41419780	harbor2	chr20	41318821	41319143	LINE/L2	923	+	161	41318982	99202
chr20	41219780	41419780	harbor2	chr20	41319362	41319798	LINE/L2	665	+	218	41319580	99800
chr20	19587459	19787459	harbor2	chr20	19612642	19613355	LINE/L2	722	+	356	19612998	25539
chr20	39034649	39234649	harbor2	chr20	39054712	39054947	LINE/L2	572	+	118	39054830	20181
chr20	39034649	39234649	harbor2	chr20	39077960	39078157	LINE/L2	637	+	98	39078058	43409
chr20	39034649	39234649	harbor2	chr20	39078466	39078683	LINE/L2	637	+	108	39078574	43925
chr20	39034649	39234649	harbor2	chr20	39079060	39079106	LINE/L2	637	+	23	39079083	44434
chr20	39034649	39234649	harbor2	chr20	39079413	39079558	LINE/L2	637	+	72	39079485	44836
chr20	39034649	39234649	harbor2	chr20	39084312	39084577	LINE/L2	926	+	132	39084444	49795
chr20	39034649	39234649	harbor2	chr20	39084868	39085202	LINE/L2	926	+	167	39085035	50386
chr20	39034649	39234649	harbor2	chr20	39131567	39132069	LINE/L2	565	+	251	39131818	97169
chr20	36011486	36211486	harbor2	chr20	36026359	36026994	LINE/L2	702	+	318	36026677	15191
chr20	36011486	36211486	harbor2	chr20	36054206	36054351	LINE/L2	1397	+	72	36054278	42792
chr20	36011486	36211486	harbor2	chr20	36054703	36054809	LINE/L2	1397	+	53	36054756	43270
chr20	36011486	36211486	harbor2	chr20	36055021	36055298	LINE/L2	1397	+	138	36055159	43673
chr20	36011486	36211486	harbor2	chr20	36055622	36056016	LINE/L2	1397	+	197	36055819	44333
chr20	36011486	36211486	harbor2	chr20	36056315	36056346	LINE/L2	569	+	16	36056331	44845
chr20	36011486	36211486	harbor2	chr20	36056650	36056758	LINE/L2	481	+	54	36056704	45218
chr20	36011486	36211486	harbor2	chr20	36096468	36096846	LINE/L2	748	+	189	36096657	85171
chr20	60471377	60671377	harbor2	chr20	60485390	60485806	LINE/L2	463	+	208	60485598	14221
chr20	60471377	60671377	harbor2	chr20	60519575	60519891	LINE/L2	642	+	158	60519733	48356
chr20	60471377	60671377	harbor2	chr20	60523636	60524380	LINE/L2	604	+	372	60524008	52631
chr20	60214204	60414204	harbor2	chr20	60239437	60239523	LINE/L2	401	+	43	60239480	25276
chr20	60214204	60414204	harbor2	chr20	60266976	60267298	LINE/L2	452	+	161	60267137	52933
chr20	60214204	60414204	harbor2	chr20	60302212	60302531	LINE/L2	2465	+	160	60302372	88168
chr20	60214204	60414204	harbor2	chr20	60302673	60302997	LINE/L2	2465	+	162	60302835	88631
chr20	60214204	60414204	harbor2	chr20	60303072	60304374	LINE/L2	2465	+	651	60303723	89519
chr20	60214204	60414204	harbor2	chr20	60304664	60304722	LINE/L2	2465	+	29	60304693	90489
chr20	60214204	60414204	harbor2	chr20	60312154	60312419	LINE/L2	511	+	132	60312286	98082
chr20	47852225	48052225	harbor2	chr20	47861956	47862199	LINE/L2	601	+	122	47862078	9853
chr20	47852225	48052225	harbor2	chr20	47862508	47862636	LINE/L2	601	+	64	47862572	10347
chr20	47852225	48052225	harbor2	chr20	47863203	47863234	LINE/L2	601	+	16	47863219	10994
chr20	47852225	48052225	harbor2	chr20	47878346	47878642	LINE/L2	654	+	148	47878494	26269
chr20	47852225	48052225	harbor2	chr20	47924009	47924127	LINE/L2	430	+	59	47924068	71843
chr20	47852225	48052225	harbor2	chr20	47924381	47924527	LINE/L2	544	+	73	47924454	72229
chr20	47852225	48052225	harbor2	chr20	47938319	47938491	LINE/L2	584	+	86	47938405	86180
chr20	47852225	48052225	harbor2	chr20	47947778	47947904	LINE/L2	586	+	63	47947841	95616
chr20	47852225	48052225	harbor2	chr20	47948639	47948683	LINE/L2	586	+	22	47948661	96436
chr20	50172323	50372323	harbor2	chr20	50185594	50185778	LINE/L2	601	+	92	50185686	13363
chr20	50172323	50372323	harbor2	chr20	50186032	50186249	LINE/L2	628	+	108	50186140	13817
chr20	50172323	50372323	harbor2	chr20	50218377	50218520	LINE/L2	523	+	72	50218449	46126
chr20	50172323	50372323	harbor2	chr20	50218825	50219121	LINE/L2	706	+	148	50218973	46650
chr20	50172323	50372323	harbor2	chr20	50219543	50219770	LINE/L2	706	+	114	50219657	47334
chr20	50172323	50372323	harbor2	chr20	50221876	50222734	LINE/L2	1503	+	429	50222305	49982
chr20	50172323	50372323	harbor2	chr20	50225730	50225931	LINE/L2	594	+	100	50225830	53507
chr20	50172323	50372323	harbor2	chr20	50229207	50229425	LINE/L2	411	+	109	50229316	56993
chr20	50172323	50372323	harbor2	chr20	50232643	50233168	LINE/L2	604	+	262	50232905	60582
chr20	50172323	50372323	harbor2	chr20	50258819	50259207	LINE/L2	535	+	194	50259013	86690
chr20	50172323	50372323	harbor2	chr20	50260424	50260707	LINE/L2	719	+	142	50260566	88243
chr20	50172323	50372323	harbor2	chr20	50261080	50261506	LINE/L2	688	+	213	50261293	88970
chr20	50172323	50372323	harbor2	chr20	50269594	50270000	LINE/L2	663	+	203	50269797	97474
chr20	50172323	50372323	harbor2	chr20	50216929	50217477	LINE/L2	508	+	274	50217203	44880
chr20	10756220	10956220	harbor2	chr20	10803355	10803872	LINE/L2	944	+	258	10803613	47393
chr20	57096752	57296752	harbor2	chr20	57104336	57104548	LINE/L2	396	+	106	57104442	7690
chr20	57096752	57296752	harbor2	chr20	57105424	57105547	LINE/L2	394	+	62	57105486	8734
chr20	57096752	57296752	harbor2	chr20	57116874	57117005	LINE/L2	420	+	66	57116940	20188
chr20	57096752	57296752	harbor2	chr20	57175873	57176001	LINE/L2	398	+	64	57175937	79185
chr20	34052845	34252845	harbor2	chr20	34056106	34056582	LINE/L2	388	+	238	34056344	3499
chr20	34052845	34252845	harbor2	chr20	34085705	34085977	LINE/L2	416	+	136	34085841	32996
chr20	34052845	34252845	harbor2	chr20	34117328	34117745	LINE/L2	632	+	208	34117536	64691
chr20	34052845	34252845	harbor2	chr20	34119269	34119640	LINE/L2	436	+	186	34119455	66610
chr20	44607412	44807412	harbor2	chr20	44621509	44621863	LINE/L2	480	+	177	44621686	14274
chr20	44607412	44807412	harbor2	chr20	44626753	44627062	LINE/L2	520	+	154	44626907	19495
chr20	44607412	44807412	harbor2	chr20	44627081	44627178	LINE/L2	523	+	48	44627129	19717
chr20	44607412	44807412	harbor2	chr20	44627481	44627706	LINE/L2	523	+	112	44627593	20181
chr20	44607412	44807412	harbor2	chr20	44705056	44705480	LINE/L2	737	+	212	44705268	97856
chr20	44607412	44807412	harbor2	chr20	44613396	44614279	LINE/L2	696	+	442	44613838	6426
chr20	20728993	20928993	harbor2	chr20	20753480	20754441	LINE/L2	1949	+	480	20753960	24967
chr20	20728993	20928993	harbor2	chr20	20755338	20755833	LINE/L2	1246	+	248	20755586	26593
chr20	20728993	20928993	harbor2	chr20	20768043	20768265	LINE/L2	684	+	111	20768154	39161
chr20	20728993	20928993	harbor2	chr20	20770048	20770227	LINE/L2	684	+	90	20770138	41145
chr20	46337360	46537360	harbor2	chr20	46358915	46359404	LINE/L2	440	+	244	46359159	21799
chr20	46337360	46537360	harbor2	chr20	46360988	46361517	LINE/L2	1203	+	264	46361252	23892
chr20	46337360	46537360	harbor2	chr20	46362622	46362770	LINE/L2	1343	+	74	46362696	25336
chr20	46337360	46537360	harbor2	chr20	46363066	46363778	LINE/L2	1343	+	356	46363422	26062
chr20	46337360	46537360	harbor2	chr20	46392274	46392863	LINE/L2	625	+	294	46392568	55208
chr20	46337360	46537360	harbor2	chr20	46409249	46409737	LINE/L2	963	+	244	46409493	72133
chr20	60277524	60477524	harbor2	chr20	60302212	60302531	LINE/L2	2465	+	160	60302372	24848
chr20	60277524	60477524	harbor2	chr20	60302673	60302997	LINE/L2	2465	+	162	60302835	25311
chr20	60277524	60477524	harbor2	chr20	60303072	60304374	LINE/L2	2465	+	651	60303723	26199
chr20	60277524	60477524	harbor2	chr20	60304664	60304722	LINE/L2	2465	+	29	60304693	27169
chr20	60277524	60477524	harbor2	chr20	60312154	60312419	LINE/L2	511	+	132	60312286	34762
chr20	60277524	60477524	harbor2	chr20	60348146	60348588	LINE/L2	724	+	221	60348367	70843
chr20	48409098	48609098	harbor2	chr20	48409802	48410554	LINE/L2	1182	+	376	48410178	1080
chr20	48409098	48609098	harbor2	chr20	48415205	48415634	LINE/L2	560	+	214	48415419	6321
chr20	48409098	48609098	harbor2	chr20	48424373	48424863	LINE/L2	717	+	245	48424618	15520
chr20	48409098	48609098	harbor2	chr20	48425275	48425565	LINE/L2	391	+	145	48425420	16322
chr20	48409098	48609098	harbor2	chr20	48447419	48447442	LINE/L2	380	+	12	48447431	38333
chr20	48409098	48609098	harbor2	chr20	48447860	48448038	LINE/L2	380	+	89	48447949	38851
chr20	48409098	48609098	harbor2	chr20	48453290	48453619	LINE/L2	390	+	164	48453454	44356
chr20	48409098	48609098	harbor2	chr20	48462718	48463335	LINE/L2	587	+	308	48463026	53928
chr20	48409098	48609098	harbor2	chr20	48484891	48485361	LINE/L2	816	+	235	48485126	76028
chr20	48409098	48609098	harbor2	chr20	48485987	48486457	LINE/L2	1008	+	235	48486222	77124
chr20	48409098	48609098	harbor2	chr20	48487483	48487673	LINE/L2	604	+	95	48487578	78480
chr20	48409098	48609098	harbor2	chr20	48494344	48494671	LINE/L2	387	+	164	48494508	85410
chr20	23203992	23403992	harbor2	chr20	23294291	23295112	LINE/L2	579	+	410	23294701	90709
chr20	50052804	50252804	harbor2	chr20	50067351	50068108	LINE/L2	1769	+	378	50067729	14925
chr20	50052804	50252804	harbor2	chr20	50102695	50103230	LINE/L2	779	+	268	50102963	50159
chr20	50052804	50252804	harbor2	chr20	50110582	50111144	LINE/L2	619	+	281	50110863	58059
chr20	50052804	50252804	harbor2	chr20	50123148	50123262	LINE/L2	950	+	57	50123205	70401
chr20	50052804	50252804	harbor2	chr20	50123566	50123917	LINE/L2	950	+	176	50123742	70938
chr20	50052804	50252804	harbor2	chr20	50125467	50125544	LINE/L2	495	+	38	50125505	72701
chr20	50052804	50252804	harbor2	chr20	50125890	50125900	LINE/L2	495	+	5	50125895	73091
chr20	50052804	50252804	harbor2	chr20	50126025	50126224	LINE/L2	495	+	100	50126125	73321
chr20	50052804	50252804	harbor2	chr20	50126958	50127340	LINE/L2	1155	+	191	50127149	74345
chr20	50052804	50252804	harbor2	chr20	50127645	50127719	LINE/L2	1155	+	37	50127682	74878
chr20	50052804	50252804	harbor2	chr20	50127735	50127841	LINE/L2	451	+	53	50127788	74984
chr20	50052804	50252804	harbor2	chr20	50132377	50132765	LINE/L2	812	+	194	50132571	79767
chr20	50052804	50252804	harbor2	chr20	50139327	50139677	LINE/L2	1374	+	175	50139502	86698
chr20	50052804	50252804	harbor2	chr20	50139926	50140692	LINE/L2	1374	+	383	50140309	87505
chr20	50052804	50252804	harbor2	chr20	50150288	50150687	LINE/L2	1070	+	200	50150488	97684
chr20	50052804	50252804	harbor2	chr20	50150996	50151072	LINE/L2	1070	+	38	50151034	98230
chr20	50052804	50252804	harbor2	chr20	50069268	50069601	LINE/L2	628	+	166	50069434	16630
chr20	53374684	53574684	harbor2	chr20	53454609	53454703	LINE/L2	497	+	47	53454656	79972
chr20	53374684	53574684	harbor2	chr20	53455196	53455409	LINE/L2	497	+	106	53455302	80618
chr20	62982277	63182277	harbor2	chr20	63014429	63014743	LINE/L2	443	+	157	63014586	32309
chr20	54289413	54489413	harbor2	chr20	54295999	54296186	LINE/L2	685	+	94	54296093	6680
chr20	54289413	54489413	harbor2	chr20	54324025	54324178	LINE/L2	387	+	76	54324101	34688
chr20	54289413	54489413	harbor2	chr20	54326985	54327132	LINE/L2	403	+	74	54327059	37646
chr20	54289413	54489413	harbor2	chr20	54362307	54362582	LINE/L2	592	+	138	54362445	73032
chr20	54289413	54489413	harbor2	chr20	54362747	54362946	LINE/L2	713	+	100	54362847	73434
chr20	54289413	54489413	harbor2	chr20	54380902	54381061	LINE/L2	522	+	80	54380982	91569
chr20	54289413	54489413	harbor2	chr20	54381583	54382109	LINE/L2	942	+	263	54381846	92433
chr20	54289413	54489413	harbor2	chr20	54383629	54383992	LINE/L2	443	+	182	54383811	94398
chr20	54289413	54489413	harbor2	chr20	54296564	54296894	LINE/L2	685	+	165	54296729	7316
chr20	35952805	36152805	harbor2	chr20	36026359	36026994	LINE/L2	702	+	318	36026677	73872
chr20	50274377	50474377	harbor2	chr20	50276785	50277598	LINE/L2	823	+	406	50277191	2814
chr20	50274377	50474377	harbor2	chr20	50278143	50278653	LINE/L2	603	+	255	50278398	4021
chr20	50274377	50474377	harbor2	chr20	50278696	50278802	LINE/L2	486	+	53	50278749	4372
chr20	50274377	50474377	harbor2	chr20	50279964	50280217	LINE/L2	503	+	126	50280090	5713
chr20	50274377	50474377	harbor2	chr20	50282642	50283500	LINE/L2	1178	+	429	50283071	8694
chr20	50274377	50474377	harbor2	chr20	50284302	50284645	LINE/L2	551	+	172	50284474	10097
chr20	50274377	50474377	harbor2	chr20	50298493	50298639	LINE/L2	555	+	73	50298566	24189
chr20	50274377	50474377	harbor2	chr20	50312091	50312450	LINE/L2	978	+	180	50312271	37894
chr20	50274377	50474377	harbor2	chr20	50316307	50316546	LINE/L2	629	+	120	50316427	42050
chr20	50274377	50474377	harbor2	chr20	50316869	50317094	LINE/L2	629	+	112	50316981	42604
chr20	50274377	50474377	harbor2	chr20	50320634	50321121	LINE/L2	940	+	244	50320878	46501
chr20	50274377	50474377	harbor2	chr20	50329630	50330025	LINE/L2	619	+	198	50329828	55451
chr20	50274377	50474377	harbor2	chr20	50332712	50332802	LINE/L2	385	+	45	50332757	58380
chr20	50274377	50474377	harbor2	chr20	50339775	50339916	LINE/L2	911	+	70	50339845	65468
chr20	50274377	50474377	harbor2	chr20	50340226	50340661	LINE/L2	911	+	218	50340444	66067
chr20	50274377	50474377	harbor2	chr20	50345003	50345186	LINE/L2	480	+	92	50345095	70718
chr20	50274377	50474377	harbor2	chr20	50358810	50359169	LINE/L2	404	+	180	50358990	84613
chr20	50274377	50474377	harbor2	chr20	50363178	50363322	LINE/L2	487	+	72	50363250	88873
chr20	50274377	50474377	harbor2	chr20	50368222	50368523	LINE/L2	459	+	150	50368372	93995
chr20	34143738	34343738	harbor2	chr20	34190395	34190667	LINE/L2	463	+	136	34190531	46793
chr20	60277847	60477847	harbor2	chr20	60302212	60302531	LINE/L2	2465	+	160	60302372	24525
chr20	60277847	60477847	harbor2	chr20	60302673	60302997	LINE/L2	2465	+	162	60302835	24988
chr20	60277847	60477847	harbor2	chr20	60303072	60304374	LINE/L2	2465	+	651	60303723	25876
chr20	60277847	60477847	harbor2	chr20	60304664	60304722	LINE/L2	2465	+	29	60304693	26846
chr20	60277847	60477847	harbor2	chr20	60312154	60312419	LINE/L2	511	+	132	60312286	34439
chr20	60277847	60477847	harbor2	chr20	60348146	60348588	LINE/L2	724	+	221	60348367	70520
chr20	36065730	36265730	harbor2	chr20	36096468	36096846	LINE/L2	748	+	189	36096657	30927
chr20	36065730	36265730	harbor2	chr20	36111940	36112160	LINE/L2	547	+	110	36112050	46320
chr20	36065730	36265730	harbor2	chr20	36123917	36123966	LINE/L2	462	+	24	36123941	58211
chr20	36065730	36265730	harbor2	chr20	36124284	36124609	LINE/L2	462	+	162	36124446	58716
chr20	59913467	60113467	harbor2	chr20	59974774	59975051	LINE/L2	396	+	138	59974912	61445
chr20	46261424	46461424	harbor2	chr20	46271348	46272177	LINE/L2	1349	+	414	46271762	10338
chr20	46261424	46461424	harbor2	chr20	46275119	46275662	LINE/L2	1343	+	272	46275391	13967
chr20	46261424	46461424	harbor2	chr20	46288332	46289496	LINE/L2	2653	+	582	46288914	27490
chr20	46261424	46461424	harbor2	chr20	46289510	46289658	LINE/L2	416	+	74	46289584	28160
chr20	46261424	46461424	harbor2	chr20	46292628	46292916	LINE/L2	520	+	144	46292772	31348
chr20	46261424	46461424	harbor2	chr20	46292960	46293088	LINE/L2	520	+	64	46293024	31600
chr20	46261424	46461424	harbor2	chr20	46315628	46315964	LINE/L2	717	+	168	46315796	54372
chr20	46261424	46461424	harbor2	chr20	46358915	46359404	LINE/L2	440	+	244	46359159	97735
chr20	46261424	46461424	harbor2	chr20	46360988	46361517	LINE/L2	1203	+	264	46361252	99828
chr20	33119712	33319712	harbor2	chr20	33129383	33129849	LINE/L2	1188	+	233	33129616	9904
chr20	33119712	33319712	harbor2	chr20	33176641	33177055	LINE/L2	387	+	207	33176848	57136
chr20	33119712	33319712	harbor2	chr20	33198532	33198688	LINE/L2	558	+	78	33198610	78898
chr20	33119712	33319712	harbor2	chr20	33199968	33200599	LINE/L2	1654	+	316	33200284	80572
chr20	33119712	33319712	harbor2	chr20	33200975	33201201	LINE/L2	1654	+	113	33201088	81376
chr20	33119712	33319712	harbor2	chr20	33208453	33208652	LINE/L2	429	+	100	33208553	88841
chr20	33119712	33319712	harbor2	chr20	33213592	33214002	LINE/L2	760	+	205	33213797	94085
chr20	3440073	3640073	harbor2	chr20	3491159	3491617	LINE/L2	524	+	229	3491388	51315
chr20	3440073	3640073	harbor2	chr20	3538527	3538821	LINE/L2	411	+	147	3538674	98601
chr20	55998621	56198621	harbor2	chr20	56019450	56020148	LINE/L2	485	+	349	56019799	21178
chr20	55998621	56198621	harbor2	chr20	56024437	56024627	LINE/L2	382	+	95	56024532	25911
chr20	55998621	56198621	harbor2	chr20	56040290	56040485	LINE/L2	429	+	98	56040388	41767
chr20	55998621	56198621	harbor2	chr20	56075288	56075511	LINE/L2	881	+	112	56075400	76779
chr20	55998621	56198621	harbor2	chr20	56075927	56076215	LINE/L2	881	+	144	56076071	77450
chr20	55998621	56198621	harbor2	chr20	56089638	56089941	LINE/L2	449	+	152	56089790	91169
chr20	52708696	52908696	harbor2	chr20	52713693	52713972	LINE/L2	442	+	140	52713833	5137
chr20	52708696	52908696	harbor2	chr20	52720473	52720652	LINE/L2	399	+	90	52720563	11867
chr20	52708696	52908696	harbor2	chr20	52743694	52744274	LINE/L2	565	+	290	52743984	35288
chr20	48444901	48644901	harbor2	chr20	48447419	48447442	LINE/L2	380	+	12	48447431	2530
chr20	48444901	48644901	harbor2	chr20	48447860	48448038	LINE/L2	380	+	89	48447949	3048
chr20	48444901	48644901	harbor2	chr20	48453290	48453619	LINE/L2	390	+	164	48453454	8553
chr20	48444901	48644901	harbor2	chr20	48462718	48463335	LINE/L2	587	+	308	48463026	18125
chr20	48444901	48644901	harbor2	chr20	48484891	48485361	LINE/L2	816	+	235	48485126	40225
chr20	48444901	48644901	harbor2	chr20	48485987	48486457	LINE/L2	1008	+	235	48486222	41321
chr20	48444901	48644901	harbor2	chr20	48487483	48487673	LINE/L2	604	+	95	48487578	42677
chr20	48444901	48644901	harbor2	chr20	48494344	48494671	LINE/L2	387	+	164	48494508	49607
chr20	48444901	48644901	harbor2	chr20	48517142	48517573	LINE/L2	420	+	216	48517358	72457
chr20	48444901	48644901	harbor2	chr20	48518714	48518743	LINE/L2	569	+	14	48518728	73827
chr20	48444901	48644901	harbor2	chr20	48519068	48519275	LINE/L2	569	+	104	48519172	74271
chr20	48444901	48644901	harbor2	chr20	48521650	48521993	LINE/L2	476	+	172	48521822	76921
chr20	48444901	48644901	harbor2	chr20	48533237	48533320	LINE/L2	583	+	42	48533279	88378
chr20	48444901	48644901	harbor2	chr20	48533490	48533633	LINE/L2	583	+	72	48533562	88661
chr21	32461913	32661913	harbor2	chr21	32474311	32474707	LINE/L2	461	+	198	32474509	12596
chr21	32461913	32661913	harbor2	chr21	32547396	32547799	LINE/L2	526	+	202	32547598	85685
chr21	40964138	41164138	harbor2	chr21	41059698	41060390	LINE/L2	1705	+	346	41060044	95906
chr21	40964138	41164138	harbor2	chr21	41060742	41061106	LINE/L2	1705	+	182	41060924	96786
chr21	40964138	41164138	harbor2	chr21	41061622	41062243	LINE/L2	1705	+	310	41061932	97794
chr21	40332699	40532699	harbor2	chr21	40334141	40334629	LINE/L2	1308	+	244	40334385	1686
chr21	40332699	40532699	harbor2	chr21	40334819	40335227	LINE/L2	560	+	204	40335023	2324
chr21	40332699	40532699	harbor2	chr21	40336738	40336897	LINE/L2	539	+	80	40336818	4119
chr21	26958869	27158869	harbor2	chr21	26986569	26987164	LINE/L2	550	+	298	26986867	27998
chr21	26958869	27158869	harbor2	chr21	27017504	27018423	LINE/L2	2299	+	460	27017964	59095
chr21	26958869	27158869	harbor2	chr21	27018504	27018609	LINE/L2	2299	+	52	27018556	59687
chr21	26958869	27158869	harbor2	chr21	27019035	27019416	LINE/L2	2299	+	190	27019225	60356
chr21	26958869	27158869	harbor2	chr21	27019484	27020033	LINE/L2	856	+	274	27019758	60889
chr21	38043287	38243287	harbor2	chr21	38069119	38069318	LINE/L2	554	+	100	38069219	25932
chr21	39335565	39535565	harbor2	chr21	39407658	39407781	LINE/L2	519	+	62	39407720	72155
chr21	32591316	32791316	harbor2	chr21	32646919	32648903	LINE/L2	506	+	992	32647911	56595
chr21	32591316	32791316	harbor2	chr21	32648948	32649283	LINE/L2	541	+	168	32649116	57800
chr21	32591316	32791316	harbor2	chr21	32667715	32667979	LINE/L2	619	+	132	32667847	76531
chr21	32591316	32791316	harbor2	chr21	32674078	32674590	LINE/L2	1643	+	256	32674334	83018
chr21	16838296	17038296	harbor2	chr21	16877744	16878104	LINE/L2	928	+	180	16877924	39628
chr21	45694072	45894072	harbor2	chr21	45714133	45714428	LINE/L2	788	+	148	45714281	20209
chr21	45082424	45282424	harbor2	chr21	45143474	45144082	LINE/L2	673	+	304	45143778	61354
chr21	24793042	24993042	harbor2	chr21	24845353	24845693	LINE/L2	759	+	170	24845523	52481
chr21	45650344	45850344	harbor2	chr21	45714133	45714428	LINE/L2	788	+	148	45714281	63937
chr21	35539288	35739288	harbor2	chr21	35623513	35624300	LINE/L2	682	+	394	35623907	84619
chr21	38926642	39126642	harbor2	chr21	38962288	38962729	LINE/L2	461	+	220	38962508	35866
chr21	20865091	21065091	harbor2	chr21	20869327	20869599	LINE/L2	645	+	136	20869463	4372
chr21	20865091	21065091	harbor2	chr21	20869710	20869784	LINE/L2	645	+	37	20869747	4656
chr21	20865091	21065091	harbor2	chr21	20869960	20870139	LINE/L2	460	+	90	20870050	4959
chr21	32560557	32760557	harbor2	chr21	32646919	32648903	LINE/L2	506	+	992	32647911	87354
chr21	32560557	32760557	harbor2	chr21	32648948	32649283	LINE/L2	541	+	168	32649116	88559
chr22	21124289	21324289	harbor2	chr22	21218944	21219835	LINE/L2	563	+	446	21219390	95101
chr22	16939699	17139699	harbor2	chr22	16972912	16973345	LINE/L2	576	+	216	16973128	33429
chr22	16939699	17139699	harbor2	chr22	16993415	16994307	LINE/L2	1898	+	446	16993861	54162
chr22	16939699	17139699	harbor2	chr22	17014169	17014457	LINE/L2	812	+	144	17014313	74614
chr22	24054852	24254852	harbor2	chr22	24058661	24059019	LINE/L2	494	+	179	24058840	3988
chr22	24054852	24254852	harbor2	chr22	24077124	24077385	LINE/L2	757	+	130	24077254	22402
chr22	39677995	39877995	harbor2	chr22	39726658	39726805	LINE/L2	833	+	74	39726732	48737
chr22	39677995	39877995	harbor2	chr22	39727101	39727344	LINE/L2	833	+	122	39727223	49228
chr22	39677995	39877995	harbor2	chr22	39735777	39736366	LINE/L2	507	+	294	39736071	58076
chr22	39677995	39877995	harbor2	chr22	39738013	39738415	LINE/L2	814	+	201	39738214	60219
chr22	39677995	39877995	harbor2	chr22	39741176	39741806	LINE/L2	1808	+	315	39741491	63496
chr22	39677995	39877995	harbor2	chr22	39742139	39742225	LINE/L2	1808	+	43	39742182	64187
chr22	39677995	39877995	harbor2	chr22	39742527	39742698	LINE/L2	1808	+	86	39742613	64618
chr22	39677995	39877995	harbor2	chr22	39774541	39774878	LINE/L2	506	+	168	39774709	96714
chr22	43470625	43670625	harbor2	chr22	43538075	43538377	LINE/L2	883	+	151	43538226	67601
chr22	43470625	43670625	harbor2	chr22	43538686	43538799	LINE/L2	883	+	56	43538742	68117
chr22	45710349	45910349	harbor2	chr22	45709532	45710612	LINE/L2	1279	+	540	45710072	277
chr22	42278960	42478960	harbor2	chr22	42285771	42285953	LINE/L2	446	+	91	42285862	6902
chr22	42278960	42478960	harbor2	chr22	42320102	42320258	LINE/L2	467	+	78	42320180	41220
chr22	42278960	42478960	harbor2	chr22	42336559	42337082	LINE/L2	561	+	262	42336821	57861
chr22	42278960	42478960	harbor2	chr22	42337373	42337620	LINE/L2	472	+	124	42337497	58537
chr22	42278960	42478960	harbor2	chr22	42346886	42347105	LINE/L2	573	+	110	42346996	68036
chr22	42278960	42478960	harbor2	chr22	42354037	42354719	LINE/L2	1560	+	341	42354378	75418
chr22	49782793	49982793	harbor2	chr22	49836565	49836828	LINE/L2	578	+	132	49836697	53904
chr22	47083476	47283476	harbor2	chr22	47109514	47110197	LINE/L2	839	+	342	47109856	26380
chr22	47083476	47283476	harbor2	chr22	47110503	47110680	LINE/L2	485	+	88	47110591	27115
chr22	29739598	29939598	harbor2	chr22	29749054	29749083	LINE/L2	1028	+	14	29749068	9470
chr22	29739598	29939598	harbor2	chr22	29749368	29749642	LINE/L2	1028	+	137	29749505	9907
chr22	29739598	29939598	harbor2	chr22	29750018	29750180	LINE/L2	1028	+	81	29750099	10501
chr22	29739598	29939598	harbor2	chr22	29764935	29765137	LINE/L2	788	+	101	29765036	25438
chr22	29739598	29939598	harbor2	chr22	29765445	29765587	LINE/L2	788	+	71	29765516	25918
chr22	29739598	29939598	harbor2	chr22	29765878	29766045	LINE/L2	788	+	84	29765962	26364
chr22	29739598	29939598	harbor2	chr22	29766165	29766544	LINE/L2	788	+	190	29766355	26757
chr22	29739598	29939598	harbor2	chr22	29800109	29800501	LINE/L2	577	+	196	29800305	60707
chr22	29739598	29939598	harbor2	chr22	29813248	29813368	LINE/L2	483	+	60	29813308	73710
chr22	29739598	29939598	harbor2	chr22	29814202	29814352	LINE/L2	449	+	75	29814277	74679
chr22	29739598	29939598	harbor2	chr22	29837679	29837911	LINE/L2	802	+	116	29837795	98197
chr22	27639704	27839704	harbor2	chr22	27644390	27644615	LINE/L2	654	+	112	27644502	4798
chr22	27639704	27839704	harbor2	chr22	27647640	27647830	LINE/L2	499	+	95	27647735	8031
chr22	27639704	27839704	harbor2	chr22	27679930	27680316	LINE/L2	988	+	193	27680123	40419
chr22	27639704	27839704	harbor2	chr22	27691304	27691565	LINE/L2	465	+	130	27691434	51730
chr22	27639704	27839704	harbor2	chr22	27691814	27691964	LINE/L2	465	+	75	27691889	52185
chr22	27639704	27839704	harbor2	chr22	27710760	27711170	LINE/L2	580	+	205	27710965	71261
chr22	27639704	27839704	harbor2	chr22	27727415	27727583	LINE/L2	468	+	84	27727499	87795
chr22	50613553	50813553	harbor2	chr22	50702427	50702839	LINE/L2	838	+	206	50702633	89080
chr22	42313571	42513571	harbor2	chr22	42320102	42320258	LINE/L2	467	+	78	42320180	6609
chr22	42313571	42513571	harbor2	chr22	42336559	42337082	LINE/L2	561	+	262	42336821	23250
chr22	42313571	42513571	harbor2	chr22	42337373	42337620	LINE/L2	472	+	124	42337497	23926
chr22	42313571	42513571	harbor2	chr22	42346886	42347105	LINE/L2	573	+	110	42346996	33425
chr22	42313571	42513571	harbor2	chr22	42354037	42354719	LINE/L2	1560	+	341	42354378	40807
chr22	42313571	42513571	harbor2	chr22	42406215	42406761	LINE/L2	474	+	273	42406488	92917
chr22	28734601	28934601	harbor2	chr22	28748197	28748502	LINE/L2	663	+	152	28748349	13748
chr22	28734601	28934601	harbor2	chr22	28748817	28748857	LINE/L2	663	+	20	28748837	14236
chr22	28734601	28934601	harbor2	chr22	28749159	28749634	LINE/L2	663	+	238	28749397	14796
chr22	46484342	46684342	harbor2	chr22	46572121	46572437	LINE/L2	479	+	158	46572279	87937
chr22	50642824	50842824	harbor2	chr22	50702427	50702839	LINE/L2	838	+	206	50702633	59809
chr22	34816010	35016010	harbor2	chr22	34858944	34859093	LINE/L2	751	+	74	34859018	43008
chr22	34816010	35016010	harbor2	chr22	34859592	34860212	LINE/L2	751	+	310	34859902	43892
chr22	34816010	35016010	harbor2	chr22	34868196	34869006	LINE/L2	1403	+	405	34868601	52591
chr22	34816010	35016010	harbor2	chr22	34888128	34888364	LINE/L2	467	+	118	34888246	72236
chr22	34816010	35016010	harbor2	chr22	34894772	34895596	LINE/L2	610	+	412	34895184	79174
chr22	26071598	26271598	harbor2	chr22	26119932	26120350	LINE/L2	613	+	209	26120141	48543
chr22	26071598	26271598	harbor2	chr22	26131044	26131182	LINE/L2	467	+	69	26131113	59515
chr22	26071598	26271598	harbor2	chr22	26164971	26165288	LINE/L2	668	+	158	26165129	93531
chr22	23060864	23260864	harbor2	chr22	23090180	23090953	LINE/L2	557	+	386	23090566	29702
chr22	23060864	23260864	harbor2	chr22	23150638	23151001	LINE/L2	450	+	182	23150820	89956
chr22	46127582	46327582	harbor2	chr22	46164555	46164700	LINE/L2	540	+	72	46164627	37045
chr22	46127582	46327582	harbor2	chr22	46196433	46196627	LINE/L2	591	+	97	46196530	68948
chr22	49212447	49412447	harbor2	chr22	49228985	49229746	LINE/L2	1204	+	380	49229365	16918
chr22	34077678	34277678	harbor2	chr22	34105563	34106032	LINE/L2	890	+	234	34105797	28119
chr22	46122650	46322650	harbor2	chr22	46164555	46164700	LINE/L2	540	+	72	46164627	41977
chr22	46122650	46322650	harbor2	chr22	46196433	46196627	LINE/L2	591	+	97	46196530	73880
chr22	47804723	48004723	harbor2	chr22	47837108	47837583	LINE/L2	560	+	238	47837346	32623
chr22	47804723	48004723	harbor2	chr22	47853820	47854931	LINE/L2	1728	+	556	47854376	49653
chr22	36576813	36776813	harbor2	chr22	36578979	36579122	LINE/L2	608	+	72	36579051	2238
chr22	36576813	36776813	harbor2	chr22	36579431	36579958	LINE/L2	608	+	264	36579695	2882
chr22	36576813	36776813	harbor2	chr22	36581611	36582393	LINE/L2	1891	+	391	36582002	5189
chr22	36576813	36776813	harbor2	chr22	36583806	36584169	LINE/L2	569	+	182	36583988	7175
chr22	36576813	36776813	harbor2	chr22	36584432	36584642	LINE/L2	569	+	105	36584537	7724
chr22	36576813	36776813	harbor2	chr22	36590288	36590921	LINE/L2	797	+	316	36590604	13791
chr22	36576813	36776813	harbor2	chr22	36613436	36614163	LINE/L2	700	+	364	36613800	36987
chr22	36576813	36776813	harbor2	chr22	36615334	36615773	LINE/L2	776	+	220	36615554	38741
chr22	36576813	36776813	harbor2	chr22	36632844	36633321	LINE/L2	818	+	238	36633082	56269
chr22	36576813	36776813	harbor2	chr22	36635592	36636414	LINE/L2	824	+	411	36636003	59190
chr22	36576813	36776813	harbor2	chr22	36638137	36638833	LINE/L2	582	+	348	36638485	61672
chr22	36576813	36776813	harbor2	chr22	36640659	36641361	LINE/L2	1198	+	351	36641010	64197
chr22	36576813	36776813	harbor2	chr22	36647145	36647311	LINE/L2	434	+	83	36647228	70415
chr22	36576813	36776813	harbor2	chr22	36647636	36648020	LINE/L2	443	+	192	36647828	71015
chr22	36576813	36776813	harbor2	chr22	36649101	36649295	LINE/L2	1422	+	97	36649198	72385
chr22	36576813	36776813	harbor2	chr22	36649586	36649606	LINE/L2	1422	+	10	36649596	72783
chr22	36576813	36776813	harbor2	chr22	36649971	36650370	LINE/L2	1422	+	200	36650171	73358
chr22	36576813	36776813	harbor2	chr22	36651605	36651777	LINE/L2	1533	+	86	36651691	74878
chr22	36576813	36776813	harbor2	chr22	36655333	36655620	LINE/L2	511	+	144	36655477	78664
chr22	36576813	36776813	harbor2	chr22	36656345	36657077	LINE/L2	1201	+	366	36656711	79898
chr22	36576813	36776813	harbor2	chr22	36660067	36660263	LINE/L2	483	+	98	36660165	83352
chr22	36576813	36776813	harbor2	chr22	36662412	36662662	LINE/L2	479	+	125	36662537	85724
chr22	36576813	36776813	harbor2	chr22	36650820	36651102	LINE/L2	1533	+	141	36650961	74148
chr22	31936344	32136344	harbor2	chr22	32017681	32018030	LINE/L2	479	+	174	32017855	81511
chr22	31936344	32136344	harbor2	chr22	32018907	32019098	LINE/L2	543	+	96	32019003	82659
chr22	47353644	47553644	harbor2	chr22	47420484	47421060	LINE/L2	1183	+	288	47420772	67128
chr22	47353644	47553644	harbor2	chr22	47430148	47430321	LINE/L2	529	+	86	47430234	76590
chr22	33912921	34112921	harbor2	chr22	33957075	33957445	LINE/L2	592	+	185	33957260	44339
chr22	33912921	34112921	harbor2	chr22	33957911	33959080	LINE/L2	2658	+	584	33958495	45574
chr22	33912921	34112921	harbor2	chr22	33959363	33959894	LINE/L2	2658	+	266	33959629	46708
chr22	33912921	34112921	harbor2	chr22	33959898	33960070	LINE/L2	480	+	86	33959984	47063
chr22	33912921	34112921	harbor2	chr22	33961711	33961873	LINE/L2	721	+	81	33961792	48871
chr22	33912921	34112921	harbor2	chr22	33975553	33975798	LINE/L2	506	+	122	33975675	62754
chr22	33912921	34112921	harbor2	chr22	34010531	34010861	LINE/L2	481	+	165	34010696	97775
chr22	33912921	34112921	harbor2	chr22	34011170	34011341	LINE/L2	481	+	86	34011256	98335
chr22	33912921	34112921	harbor2	chr22	34011810	34012175	LINE/L2	729	+	182	34011992	99071
chr22	38527245	38727245	harbor2	chr22	38611769	38612518	LINE/L2	1198	+	374	38612143	84898
chr22	29478240	29678240	harbor2	chr22	29559093	29559258	LINE/L2	1195	+	82	29559175	80935
chr22	29478240	29678240	harbor2	chr22	29559554	29560241	LINE/L2	1195	+	344	29559898	81658
chr22	29478240	29678240	harbor2	chr22	29560544	29560652	LINE/L2	574	+	54	29560598	82358
chr22	29478240	29678240	harbor2	chr22	29576397	29576569	LINE/L2	447	+	86	29576483	98243
chr22	31627822	31827822	harbor2	chr22	31653903	31654155	LINE/L2	639	+	126	31654029	26207
chr22	31627822	31827822	harbor2	chr22	31656719	31656976	LINE/L2	443	+	128	31656847	29025
chr22	31627822	31827822	harbor2	chr22	31657983	31658127	LINE/L2	443	+	72	31658055	30233
chr22	37044680	37244680	harbor2	chr22	37067865	37068239	LINE/L2	460	+	187	37068052	23372
chr22	37044680	37244680	harbor2	chr22	37092945	37093112	LINE/L2	487	+	84	37093029	48349
chr22	37044680	37244680	harbor2	chr22	37133635	37134062	LINE/L2	677	+	214	37133849	89169
chr22	37044680	37244680	harbor2	chr22	37134725	37134919	LINE/L2	677	+	97	37134822	90142
chr22	37044680	37244680	harbor2	chr22	37136766	37137193	LINE/L2	442	+	214	37136980	92300
chr22	37044680	37244680	harbor2	chr22	37137760	37138139	LINE/L2	908	+	190	37137950	93270
chr22	37044680	37244680	harbor2	chr22	37144310	37144463	LINE/L2	793	+	76	37144386	99706
chr22	48402875	48602875	harbor2	chr22	48487260	48487475	LINE/L2	547	+	108	48487368	84493
chr22	50424052	50624052	harbor2	chr22	50508925	50509770	LINE/L2	1175	+	422	50509347	85295
chr22	50424052	50624052	harbor2	chr22	50510729	50510850	LINE/L2	439	+	60	50510789	86737
chr22	50424052	50624052	harbor2	chr22	50512086	50512238	LINE/L2	439	+	76	50512162	88110
chr22	35393936	35593936	harbor2	chr22	35407278	35407921	LINE/L2	895	+	322	35407600	13664
chr22	35393936	35593936	harbor2	chr22	35411677	35412247	LINE/L2	1460	+	285	35411962	18026
chr22	35393936	35593936	harbor2	chr22	35486231	35486604	LINE/L2	450	+	186	35486417	92481
chr22	36981680	37181680	harbor2	chr22	36988083	36988481	LINE/L2	588	+	199	36988282	6602
chr22	36981680	37181680	harbor2	chr22	36997313	36997823	LINE/L2	958	+	255	36997568	15888
chr22	36981680	37181680	harbor2	chr22	37009453	37009988	LINE/L2	1008	+	268	37009721	28041
chr22	36981680	37181680	harbor2	chr22	37067865	37068239	LINE/L2	460	+	187	37068052	86372
chr22	49178482	49378482	harbor2	chr22	49228985	49229746	LINE/L2	1204	+	380	49229365	50883
chr22	24207152	24407152	harbor2	chr22	24235918	24236481	LINE/L2	1346	+	282	24236200	29048
chr22	24207152	24407152	harbor2	chr22	24236779	24236798	LINE/L2	1346	+	10	24236789	29637
chrX	111769321	111969321	harbor2	chrX	111777498	111778043	LINE/L2	812	+	272	111777770	8449
chrX	111769321	111969321	harbor2	chrX	111818209	111818529	LINE/L2	719	+	160	111818369	49048
chrX	111769321	111969321	harbor2	chrX	111827135	111827978	LINE/L2	3370	+	422	111827557	58236
chrX	111769321	111969321	harbor2	chrX	111836456	111836783	LINE/L2	796	+	164	111836620	67299
chrX	130532246	130732246	harbor2	chrX	130587743	130590333	LINE/L2	1661	+	1295	130589038	56792
chrX	130532246	130732246	harbor2	chrX	130608120	130608741	LINE/L2	3475	+	310	130608430	76184
chrX	130532246	130732246	harbor2	chrX	130609059	130609416	LINE/L2	3475	+	178	130609237	76991
chrX	130532246	130732246	harbor2	chrX	130610468	130610619	LINE/L2	534	+	76	130610544	78298
chrX	130532246	130732246	harbor2	chrX	130613781	130614675	LINE/L2	4385	+	447	130614228	81982
chrX	130532246	130732246	harbor2	chrX	130614988	130615574	LINE/L2	4385	+	293	130615281	83035
chrX	130532246	130732246	harbor2	chrX	130615976	130616103	LINE/L2	550	+	64	130616040	83794
chrX	121434567	121634567	harbor2	chrX	121447219	121448543	LINE/L2	3120	+	662	121447881	13314
chrX	70224219	70424219	harbor2	chrX	70223837	70224264	LINE/L2	1158	+	214	70224051	168
chrX	70224219	70424219	harbor2	chrX	70321427	70322303	LINE/L2	616	+	438	70321865	97646
chrX	70224219	70424219	harbor2	chrX	70322610	70323443	LINE/L2	616	+	416	70323026	98807
chrX	142711940	142911940	harbor2	chrX	142760240	142761234	LINE/L2	2768	+	497	142760737	48797
chrX	142711940	142911940	harbor2	chrX	142761239	142761605	LINE/L2	1402	+	183	142761422	49482
chrX	142711940	142911940	harbor2	chrX	142762222	142762452	LINE/L2	1402	+	115	142762337	50397
chrX	130681148	130881148	harbor2	chrX	130697133	130697488	LINE/L2	609	+	178	130697311	16163
chrX	130681148	130881148	harbor2	chrX	130767225	130767378	LINE/L2	765	+	76	130767301	86153
chrX	54200417	54400417	harbor2	chrX	54274170	54274623	LINE/L2	1548	+	226	54274396	73979
chrX	54200417	54400417	harbor2	chrX	54287309	54287650	LINE/L2	1068	+	170	54287479	87062
chrX	101625919	101825919	harbor2	chrX	101662727	101663365	LINE/L2	1341	+	319	101663046	37127
chrX	101625919	101825919	harbor2	chrX	101674279	101675141	LINE/L2	1910	+	431	101674710	48791
chrX	149082167	149282167	harbor2	chrX	149106012	149106541	LINE/L2	514	+	264	149106276	24109
chrX	128363396	128563396	harbor2	chrX	128425594	128426579	LINE/L2	1084	+	492	128426086	62690
chrX	136968343	137168343	harbor2	chrX	136989460	136989652	LINE/L2	549	+	96	136989556	21213
chrX	136769059	136969059	harbor2	chrX	136793708	136794524	LINE/L2	2407	+	408	136794116	25057
chrX	136769059	136969059	harbor2	chrX	136796030	136796321	LINE/L2	775	+	146	136796176	27117
chrX	136769059	136969059	harbor2	chrX	136852912	136853176	LINE/L2	801	+	132	136853044	83985
chrX	136769059	136969059	harbor2	chrX	136853458	136853718	LINE/L2	801	+	130	136853588	84529
chrX	136769059	136969059	harbor2	chrX	136854398	136854633	LINE/L2	580	+	118	136854516	85457
chrX	136769059	136969059	harbor2	chrX	136857198	136857455	LINE/L2	2006	+	128	136857326	88267
chrX	136769059	136969059	harbor2	chrX	136857742	136858579	LINE/L2	2006	+	418	136858160	89101
chrX	136769059	136969059	harbor2	chrX	136861132	136861384	LINE/L2	623	+	126	136861258	92199
