H_chr	H_start	H_end	Harbor	TE_chr	TE_start	TE_end	TE	score	TE_strand	TE_half	TE_middle_pos	TE_dis
chr1	179174585	179374585	harbor2	chr1	179233508	179233558	LINE/CR1	502	-	25	179233533	58948
chr1	179174585	179374585	harbor2	chr1	179233849	179234013	LINE/CR1	502	-	82	179233931	59346
chr1	209361823	209561823	harbor2	chr1	209408365	209409297	LINE/CR1	1054	-	466	209408831	47008
chr1	57565137	57765137	harbor2	chr1	57580291	57580525	LINE/CR1	547	-	117	57580408	15271
chr1	174449313	174649313	harbor2	chr1	174462053	174462502	LINE/CR1	792	-	224	174462277	12964
chr1	174449313	174649313	harbor2	chr1	174464926	174465180	LINE/CR1	422	-	127	174465053	15740
chr1	239853196	240053196	harbor2	chr1	239919708	239919895	LINE/CR1	453	-	94	239919802	66606
chr1	239353691	239553691	harbor2	chr1	239384282	239384964	LINE/CR1	541	-	341	239384623	30932
chr1	231655327	231855327	harbor2	chr1	231666013	231666225	LINE/CR1	640	-	106	231666119	10792
chr1	231655327	231855327	harbor2	chr1	231672077	231672714	LINE/CR1	1090	-	318	231672395	17068
chr1	231655327	231855327	harbor2	chr1	231676275	231676511	LINE/CR1	406	-	118	231676393	21066
chr1	243362159	243562159	harbor2	chr1	243362656	243363177	LINE/CR1	481	-	260	243362916	757
chr1	232152947	232352947	harbor2	chr1	232175147	232175361	LINE/CR1	641	-	107	232175254	22307
chr1	76260370	76460370	harbor2	chr1	76292853	76293026	LINE/CR1	513	-	86	76292939	32569
chr1	239828801	240028801	harbor2	chr1	239919708	239919895	LINE/CR1	453	-	94	239919802	91001
chr1	212945932	213145932	harbor2	chr1	212952786	212953029	LINE/CR1	604	-	122	212952908	6976
chr1	212945932	213145932	harbor2	chr1	212953859	212953901	LINE/CR1	465	-	21	212953880	7948
chr1	212945932	213145932	harbor2	chr1	212954213	212954429	LINE/CR1	465	-	108	212954321	8389
chr1	212945932	213145932	harbor2	chr1	212954717	212954890	LINE/CR1	465	-	86	212954803	8871
chr1	146585524	146785524	harbor2	chr1	146594011	146594193	LINE/CR1	430	-	91	146594102	8578
chr1	245832758	246032758	harbor2	chr1	245843849	245844280	LINE/CR1	686	-	216	245844065	11307
chr1	245832758	246032758	harbor2	chr1	245861982	245863063	LINE/CR1	505	-	540	245862522	29764
chr1	158483257	158683257	harbor2	chr1	158493069	158493491	LINE/CR1	558	-	211	158493280	10023
chr1	147956958	148156958	harbor2	chr1	148000852	148001234	LINE/CR1	496	-	191	148001043	44085
chr1	186195385	186395385	harbor2	chr1	186210023	186210357	LINE/CR1	664	-	167	186210190	14805
chr1	36439499	36639499	harbor2	chr1	36478958	36479259	LINE/CR1	429	-	150	36479108	39609
chr1	172655810	172855810	harbor2	chr1	172672976	172673231	LINE/CR1	557	-	128	172673104	17294
chr1	181809342	182009342	harbor2	chr1	181813900	181814154	LINE/CR1	517	-	127	181814027	4685
chr1	245851156	246051156	harbor2	chr1	245861982	245863063	LINE/CR1	505	-	540	245862522	11366
chr1	244095961	244295961	harbor2	chr1	244115110	244115292	LINE/CR1	478	-	91	244115201	19240
chr1	145599117	145799117	harbor2	chr1	145677982	145678364	LINE/CR1	636	-	191	145678173	79056
chr1	198328657	198528657	harbor2	chr1	198388498	198388880	LINE/CR1	871	-	191	198388689	60032
chr1	198328657	198528657	harbor2	chr1	198388924	198389353	LINE/CR1	871	-	214	198389138	60481
chr1	237384465	237584465	harbor2	chr1	237438984	237439213	LINE/CR1	522	-	114	237439098	54633
chr1	239570054	239770054	harbor2	chr1	239579136	239579567	LINE/CR1	538	-	216	239579352	9298
chr1	181805898	182005898	harbor2	chr1	181813900	181814154	LINE/CR1	517	-	127	181814027	8129
chr1	200611413	200811413	harbor2	chr1	200695122	200695246	LINE/CR1	427	-	62	200695184	83771
chr1	200611413	200811413	harbor2	chr1	200695475	200695517	LINE/CR1	427	-	21	200695496	84083
chr1	242606595	242806595	harbor2	chr1	242655035	242655547	LINE/CR1	499	-	256	242655291	48696
chr1	225024407	225224407	harbor2	chr1	225123047	225123266	LINE/CR1	418	-	110	225123157	98750
chr1	66653305	66853305	harbor2	chr1	66716156	66716429	LINE/CR1	586	-	136	66716292	62987
chr1	164842370	165042370	harbor2	chr1	164918605	164918780	LINE/CR1	448	-	88	164918693	76323
chr1	183793100	183993100	harbor2	chr1	183823287	183823788	LINE/CR1	2154	-	250	183823537	30437
chr1	183793100	183993100	harbor2	chr1	183824087	183824724	LINE/CR1	2154	-	318	183824405	31305
chr1	185988450	186188450	harbor2	chr1	185997581	185997934	LINE/CR1	414	-	176	185997757	9307
chr1	237003724	237203724	harbor2	chr1	237027274	237027437	LINE/CR1	419	-	82	237027356	23632
chr1	205885743	206085743	harbor2	chr1	205911288	205911441	LINE/CR1	411	-	76	205911364	25621
chr1	230339685	230539685	harbor2	chr1	230351421	230351722	LINE/CR1	553	-	150	230351571	11886
chr1	212636205	212836205	harbor2	chr1	212688078	212688769	LINE/CR1	893	-	346	212688424	52219
chr1	212636205	212836205	harbor2	chr1	212721219	212721533	LINE/CR1	490	-	157	212721376	85171
chr1	168291066	168491066	harbor2	chr1	168341477	168342065	LINE/CR1	849	-	294	168341771	50705
chr1	118109234	118309234	harbor2	chr1	118144767	118144972	LINE/CR1	557	-	102	118144869	35635
chr1	118109234	118309234	harbor2	chr1	118185498	118185738	LINE/CR1	407	-	120	118185618	76384
chr1	226120827	226320827	harbor2	chr1	226178723	226179102	LINE/CR1	686	-	190	226178913	58086
chr1	165052531	165252531	harbor2	chr1	165135291	165135590	LINE/CR1	538	-	150	165135441	82910
chr1	165052531	165252531	harbor2	chr1	165134250	165134447	LINE/CR1	486	-	98	165134348	81817
chr1	152136836	152336836	harbor2	chr1	152180638	152181008	LINE/CR1	476	-	185	152180823	43987
chr1	220330149	220530149	harbor2	chr1	220368223	220368721	LINE/CR1	896	-	249	220368472	38323
chr1	56836709	57036709	harbor2	chr1	56894331	56894443	LINE/CR1	522	-	56	56894387	57678
chr1	56836709	57036709	harbor2	chr1	56902038	56902494	LINE/CR1	1073	-	228	56902266	65557
chr1	56836709	57036709	harbor2	chr1	56902882	56903146	LINE/CR1	1073	-	132	56903014	66305
chr1	56836709	57036709	harbor2	chr1	56903519	56903710	LINE/CR1	1073	-	96	56903615	66906
chr1	197571289	197771289	harbor2	chr1	197662830	197663358	LINE/CR1	450	-	264	197663094	91805
chr1	161097778	161297778	harbor2	chr1	161195074	161195276	LINE/CR1	436	-	101	161195175	97397
chr1	149979090	150179090	harbor2	chr1	149981230	149981516	LINE/CR1	574	-	143	149981373	2283
chr1	240276024	240476024	harbor2	chr1	240352899	240353184	LINE/CR1	451	-	142	240353041	77017
chr1	235779671	235979671	harbor2	chr1	235838204	235838896	LINE/CR1	1109	-	346	235838550	58879
chr1	235779671	235979671	harbor2	chr1	235842605	235842871	LINE/CR1	659	-	133	235842738	63067
chr1	235779671	235979671	harbor2	chr1	235859928	235860171	LINE/CR1	523	-	122	235860050	80379
chr1	185353866	185553866	harbor2	chr1	185372908	185373027	LINE/CR1	406	-	60	185372968	19102
chr1	218443782	218643782	harbor2	chr1	218478222	218478577	LINE/CR1	790	-	178	218478400	34618
chr1	218443782	218643782	harbor2	chr1	218530994	218531462	LINE/CR1	999	-	234	218531228	87446
chr1	154807861	155007861	harbor2	chr1	154831606	154831774	LINE/CR1	460	-	84	154831690	23829
chr1	217358436	217558436	harbor2	chr1	217411389	217411556	LINE/CR1	515	-	84	217411473	53037
chr1	181779497	181979497	harbor2	chr1	181813900	181814154	LINE/CR1	517	-	127	181814027	34530
chr1	209242541	209442541	harbor2	chr1	209266762	209267280	LINE/CR1	958	-	259	209267021	24480
chr1	209242541	209442541	harbor2	chr1	209267304	209267583	LINE/CR1	512	-	140	209267444	24903
chr1	152389453	152589453	harbor2	chr1	152391080	152391302	LINE/CR1	409	-	111	152391191	1738
chr1	29030525	29230525	harbor2	chr1	29075838	29076137	LINE/CR1	569	-	150	29075988	45463
chr1	162654864	162854864	harbor2	chr1	162701719	162701939	LINE/CR1	489	-	110	162701829	46965
chr1	162654864	162854864	harbor2	chr1	162701947	162702336	LINE/CR1	412	-	194	162702141	47277
chr1	117258018	117458018	harbor2	chr1	117290905	117291026	LINE/CR1	412	-	60	117290965	32947
chr1	241857430	242057430	harbor2	chr1	241870155	241871443	LINE/CR1	1207	-	644	241870799	13369
chr1	205669662	205869662	harbor2	chr1	205736484	205736543	LINE/CR1	423	-	30	205736514	66852
chr1	205669662	205869662	harbor2	chr1	205736848	205737306	LINE/CR1	423	-	229	205737077	67415
chr1	205669662	205869662	harbor2	chr1	205737314	205737681	LINE/CR1	786	-	184	205737498	67836
chr1	239494288	239694288	harbor2	chr1	239579136	239579567	LINE/CR1	538	-	216	239579352	85064
chr1	179563681	179763681	harbor2	chr1	179613853	179614078	LINE/CR1	507	-	112	179613965	50284
chr1	157563162	157763162	harbor2	chr1	157623864	157624091	LINE/CR1	575	-	114	157623978	60816
chr1	60647439	60847439	harbor2	chr1	60725947	60726230	LINE/CR1	573	-	142	60726089	78650
chr1	210578299	210778299	harbor2	chr1	210655915	210656187	LINE/CR1	521	-	136	210656051	77752
chr1	223277474	223477474	harbor2	chr1	223365945	223366519	LINE/CR1	1085	-	287	223366232	88758
chr1	233891345	234091345	harbor2	chr1	233960427	233960613	LINE/CR1	421	-	93	233960520	69175
chr1	93624306	93824306	harbor2	chr1	93662141	93663301	LINE/CR1	997	-	580	93662721	38415
chr1	174343199	174543199	harbor2	chr1	174359074	174359537	LINE/CR1	572	-	232	174359306	16107
chr1	187655702	187855702	harbor2	chr1	187660158	187660526	LINE/CR1	578	-	184	187660342	4640
chr1	43831152	44031152	harbor2	chr1	43869146	43869374	LINE/CR1	713	-	114	43869260	38108
chr1	43831152	44031152	harbor2	chr1	43909260	43909532	LINE/CR1	580	-	136	43909396	78244
chr2	177555837	177755837	harbor2	chr2	177634979	177635216	LINE/CR1	632	-	118	177635097	79260
chr2	217805971	218005971	harbor2	chr2	217861088	217861560	LINE/CR1	499	-	236	217861324	55353
chr2	217805971	218005971	harbor2	chr2	217903614	217903790	LINE/CR1	488	-	88	217903702	97731
chr2	147463212	147663212	harbor2	chr2	147521907	147522796	LINE/CR1	1990	-	444	147522351	59139
chr2	147463212	147663212	harbor2	chr2	147523108	147523810	LINE/CR1	1990	-	351	147523459	60247
chr2	147463212	147663212	harbor2	chr2	147549519	147549791	LINE/CR1	582	-	136	147549655	86443
chr2	217892866	218092866	harbor2	chr2	217903614	217903790	LINE/CR1	488	-	88	217903702	10836
chr2	81089887	81289887	harbor2	chr2	81117120	81117872	LINE/CR1	583	-	376	81117496	27609
chr2	120693471	120893471	harbor2	chr2	120722050	120722400	LINE/CR1	635	-	175	120722225	28754
chr2	120693471	120893471	harbor2	chr2	120722448	120722871	LINE/CR1	472	-	212	120722660	29189
chr2	236432858	236632858	harbor2	chr2	236512456	236512913	LINE/CR1	797	-	228	236512684	79826
chr2	236432858	236632858	harbor2	chr2	236513522	236513733	LINE/CR1	457	-	106	236513628	80770
chr2	236432858	236632858	harbor2	chr2	236515432	236515690	LINE/CR1	470	-	129	236515561	82703
chr2	138171787	138371787	harbor2	chr2	138194286	138194554	LINE/CR1	931	-	134	138194420	22633
chr2	138171787	138371787	harbor2	chr2	138215819	138216140	LINE/CR1	419	-	160	138215979	44192
chr2	141996710	142196710	harbor2	chr2	142037947	142038287	LINE/CR1	431	-	170	142038117	41407
chr2	141996710	142196710	harbor2	chr2	142039738	142040536	LINE/CR1	1022	-	399	142040137	43427
chr2	214472167	214672167	harbor2	chr2	214528188	214528676	LINE/CR1	663	-	244	214528432	56265
chr2	147424710	147624710	harbor2	chr2	147424683	147424975	LINE/CR1	661	-	146	147424829	119
chr2	147424710	147624710	harbor2	chr2	147521907	147522796	LINE/CR1	1990	-	444	147522351	97641
chr2	147424710	147624710	harbor2	chr2	147523108	147523810	LINE/CR1	1990	-	351	147523459	98749
chr2	84614207	84814207	harbor2	chr2	84689872	84690371	LINE/CR1	699	-	250	84690122	75915
chr2	223784150	223984150	harbor2	chr2	223794529	223794697	LINE/CR1	463	-	84	223794613	10463
chr2	165142667	165342667	harbor2	chr2	165234868	165235447	LINE/CR1	898	-	290	165235158	92491
chr2	105815027	106015027	harbor2	chr2	105857343	105857559	LINE/CR1	455	-	108	105857451	42424
chr2	44174058	44374058	harbor2	chr2	44246093	44246668	LINE/CR1	546	-	288	44246381	72323
chr2	203944036	204144036	harbor2	chr2	203974291	203974577	LINE/CR1	677	-	143	203974434	30398
chr2	190193282	190393282	harbor2	chr2	190246734	190247272	LINE/CR1	767	-	269	190247003	53721
chr2	206576457	206776457	harbor2	chr2	206669134	206669477	LINE/CR1	515	-	172	206669306	92849
chr2	235327843	235527843	harbor2	chr2	235330830	235331394	LINE/CR1	754	-	282	235331112	3269
chr2	139749468	139949468	harbor2	chr2	139813601	139813758	LINE/CR1	449	-	78	139813679	64211
chr2	215062130	215262130	harbor2	chr2	215077463	215077734	LINE/CR1	524	-	136	215077599	15469
chr2	215062130	215262130	harbor2	chr2	215120670	215121014	LINE/CR1	626	-	172	215120842	58712
chr2	234544632	234744632	harbor2	chr2	234584396	234584565	LINE/CR1	516	-	84	234584480	39848
chr2	206379093	206579093	harbor2	chr2	206433232	206433380	LINE/CR1	417	-	74	206433306	54213
chr2	206379093	206579093	harbor2	chr2	206433734	206434072	LINE/CR1	650	-	169	206433903	54810
chr2	180930014	181130014	harbor2	chr2	180934251	180935112	LINE/CR1	1240	-	430	180934681	4667
chr2	180930014	181130014	harbor2	chr2	180935551	180936463	LINE/CR1	774	-	456	180936007	5993
chr2	142012740	142212740	harbor2	chr2	142037947	142038287	LINE/CR1	431	-	170	142038117	25377
chr2	142012740	142212740	harbor2	chr2	142039738	142040536	LINE/CR1	1022	-	399	142040137	27397
chr2	227299710	227499710	harbor2	chr2	227299725	227300588	LINE/CR1	798	-	432	227300157	447
chr2	227299710	227499710	harbor2	chr2	227301419	227301658	LINE/CR1	538	-	120	227301539	1829
chr2	169791976	169991976	harbor2	chr2	169886253	169886531	LINE/CR1	752	-	139	169886392	94416
chr2	206423268	206623268	harbor2	chr2	206433232	206433380	LINE/CR1	417	-	74	206433306	10038
chr2	206423268	206623268	harbor2	chr2	206433734	206434072	LINE/CR1	650	-	169	206433903	10635
chr2	225368080	225568080	harbor2	chr2	225452390	225452663	LINE/CR1	454	-	136	225452526	84446
chr3	180017578	180217578	harbor2	chr3	180030430	180030615	LINE/CR1	610	-	92	180030522	12944
chr3	194522490	194722490	harbor2	chr3	194562320	194562459	LINE/CR1	424	-	70	194562390	39900
chr3	194522490	194722490	harbor2	chr3	194562732	194562791	LINE/CR1	424	-	30	194562762	40272
chr3	184292703	184492703	harbor2	chr3	184373669	184373888	LINE/CR1	466	-	110	184373779	81076
chr3	184292703	184492703	harbor2	chr3	184374370	184374790	LINE/CR1	524	-	210	184374580	81877
chr3	184292703	184492703	harbor2	chr3	184375083	184375301	LINE/CR1	524	-	109	184375192	82489
chr3	186415162	186615162	harbor2	chr3	186457350	186457635	LINE/CR1	559	-	142	186457492	42330
chr3	188837705	189037705	harbor2	chr3	188917070	188917368	LINE/CR1	565	-	149	188917219	79514
chr3	186166894	186366894	harbor2	chr3	186189783	186189948	LINE/CR1	466	-	82	186189865	22971
chr3	186166894	186366894	harbor2	chr3	186190531	186190968	LINE/CR1	530	-	218	186190749	23855
chr3	186166894	186366894	harbor2	chr3	186191289	186191615	LINE/CR1	687	-	163	186191452	24558
chr3	186166894	186366894	harbor2	chr3	186192678	186192785	LINE/CR1	451	-	54	186192732	25838
chr3	186166894	186366894	harbor2	chr3	186223358	186224500	LINE/CR1	1957	-	571	186223929	57035
chr3	186166894	186366894	harbor2	chr3	186224898	186225092	LINE/CR1	527	-	97	186224995	58101
chr3	186166894	186366894	harbor2	chr3	186225266	186225416	LINE/CR1	527	-	75	186225341	58447
chr3	186166894	186366894	harbor2	chr3	186230900	186231299	LINE/CR1	557	-	200	186231100	64206
chr3	186166894	186366894	harbor2	chr3	186233999	186234338	LINE/CR1	546	-	170	186234169	67275
chr3	114679858	114879858	harbor2	chr3	114731021	114731275	LINE/CR1	495	-	127	114731148	51290
chr3	189932515	190132515	harbor2	chr3	189962923	189963170	LINE/CR1	520	-	124	189963047	30532
chr3	189932515	190132515	harbor2	chr3	190016695	190016959	LINE/CR1	423	-	132	190016827	84312
chr3	124312167	124512167	harbor2	chr3	124404749	124405337	LINE/CR1	495	-	294	124405043	92876
chr3	188719330	188919330	harbor2	chr3	188798453	188798629	LINE/CR1	415	-	88	188798541	79211
chr3	184718575	184918575	harbor2	chr3	184743626	184743831	LINE/CR1	1478	-	102	184743728	25153
chr3	184718575	184918575	harbor2	chr3	184744115	184744317	LINE/CR1	1478	-	101	184744216	25641
chr3	184718575	184918575	harbor2	chr3	184744612	184744798	LINE/CR1	1478	-	93	184744705	26130
chr3	184718575	184918575	harbor2	chr3	184745096	184745530	LINE/CR1	1478	-	217	184745313	26738
chr3	99641127	99841127	harbor2	chr3	99716728	99716890	LINE/CR1	468	-	81	99716809	75682
chr3	187821813	188021813	harbor2	chr3	187854975	187855095	LINE/CR1	395	-	60	187855035	33222
chr3	78376820	78576820	harbor2	chr3	78426220	78426533	LINE/CR1	399	-	156	78426376	49556
chr3	105980377	106180377	harbor2	chr3	106060573	106060872	LINE/CR1	437	-	150	106060723	80346
chr3	105980377	106180377	harbor2	chr3	106066541	106067035	LINE/CR1	454	-	247	106066788	86411
chr3	196556187	196756187	harbor2	chr3	196624334	196624878	LINE/CR1	521	-	272	196624606	68419
chr3	194974835	195174835	harbor2	chr3	195019635	195019793	LINE/CR1	467	-	79	195019714	44879
chr3	196530737	196730737	harbor2	chr3	196624334	196624878	LINE/CR1	521	-	272	196624606	93869
chr3	160693021	160893021	harbor2	chr3	160768236	160768443	LINE/CR1	480	-	104	160768340	75319
chr3	174196473	174396473	harbor2	chr3	174288335	174289127	LINE/CR1	723	-	396	174288731	92258
chr3	193740598	193940598	harbor2	chr3	193826102	193826350	LINE/CR1	418	-	124	193826226	85628
chr3	183141577	183341577	harbor2	chr3	183154855	183154917	LINE/CR1	506	-	31	183154886	13309
chr3	183141577	183341577	harbor2	chr3	183155206	183155333	LINE/CR1	506	-	64	183155270	13693
chr3	194784824	194984824	harbor2	chr3	194875182	194875532	LINE/CR1	423	-	175	194875357	90533
chr3	183736683	183936683	harbor2	chr3	183746368	183746745	LINE/CR1	522	-	188	183746556	9873
chr3	173957326	174157326	harbor2	chr3	174004045	174004505	LINE/CR1	594	-	230	174004275	46949
chr3	141044228	141244228	harbor2	chr3	141096310	141096654	LINE/CR1	543	-	172	141096482	52254
chr3	122991355	123191355	harbor2	chr3	123018710	123018863	LINE/CR1	403	-	76	123018786	27431
chr3	158946320	159146320	harbor2	chr3	159042227	159042464	LINE/CR1	521	-	118	159042345	96025
chr3	145058469	145258469	harbor2	chr3	145128602	145129193	LINE/CR1	536	-	296	145128898	70429
chr3	149425678	149625678	harbor2	chr3	149430400	149430745	LINE/CR1	686	-	172	149430572	4894
chr3	197108554	197308554	harbor2	chr3	197187337	197187802	LINE/CR1	463	-	232	197187569	79015
chr4	121875958	122075958	harbor2	chr4	121886399	121886680	LINE/CR1	484	-	140	121886539	10581
chr4	161905581	162105581	harbor2	chr4	161968596	161968911	LINE/CR1	423	-	158	161968754	63173
chr4	109287094	109487094	harbor2	chr4	109379135	109379710	LINE/CR1	781	-	288	109379423	92329
chr4	134530249	134730249	harbor2	chr4	134602645	134602963	LINE/CR1	714	-	159	134602804	72555
chr4	58027995	58227995	harbor2	chr4	58037322	58037559	LINE/CR1	438	-	118	58037440	9445
chr4	168612068	168812068	harbor2	chr4	168622808	168622974	LINE/CR1	524	-	83	168622891	10823
chr4	189886700	190086700	harbor2	chr4	189971186	189971330	LINE/CR1	470	-	72	189971258	84558
chr4	109647825	109847825	harbor2	chr4	109723079	109723438	LINE/CR1	450	-	180	109723259	75434
chr4	189291574	189491574	harbor2	chr4	189303789	189303975	LINE/CR1	475	-	93	189303882	12308
chr4	189291574	189491574	harbor2	chr4	189386158	189386399	LINE/CR1	468	-	120	189386278	94704
chr4	88944871	89144871	harbor2	chr4	88949098	88949455	LINE/CR1	683	-	178	88949276	4405
chr4	95534468	95734468	harbor2	chr4	95625118	95625663	LINE/CR1	427	-	272	95625390	90922
chr5	31458572	31658572	harbor2	chr5	31459443	31459886	LINE/CR1	555	-	222	31459665	1093
chr5	159756297	159956297	harbor2	chr5	159840507	159840850	LINE/CR1	602	-	172	159840679	84382
chr5	159756297	159956297	harbor2	chr5	159841532	159842185	LINE/CR1	568	-	326	159841858	85561
chr5	150220775	150420775	harbor2	chr5	150282844	150283241	LINE/CR1	482	-	198	150283042	62267
chr5	102909710	103109710	harbor2	chr5	102994118	102994903	LINE/CR1	1264	-	392	102994510	84800
chr5	102909710	103109710	harbor2	chr5	102994910	102995225	LINE/CR1	403	-	158	102995068	85358
chr5	171824318	172024318	harbor2	chr5	171901523	171902282	LINE/CR1	797	-	380	171901903	77585
chr5	122360405	122560405	harbor2	chr5	122376909	122377311	LINE/CR1	401	-	201	122377110	16705
chr5	122360405	122560405	harbor2	chr5	122407812	122408207	LINE/CR1	704	-	198	122408010	47605
chr5	156503327	156703327	harbor2	chr5	156566963	156567188	LINE/CR1	433	-	112	156567075	63748
chr5	164357347	164557347	harbor2	chr5	164357699	164358078	LINE/CR1	557	-	190	164357889	542
chr5	160658958	160858958	harbor2	chr5	160671911	160671969	LINE/CR1	574	-	29	160671940	12982
chr5	160658958	160858958	harbor2	chr5	160672276	160672616	LINE/CR1	574	-	170	160672446	13488
chr5	160658958	160858958	harbor2	chr5	160740372	160740616	LINE/CR1	597	-	122	160740494	81536
chr5	153729797	153929797	harbor2	chr5	153762737	153763032	LINE/CR1	625	-	148	153762885	33088
chr5	153729797	153929797	harbor2	chr5	153785719	153785973	LINE/CR1	405	-	127	153785846	56049
chr5	153729797	153929797	harbor2	chr5	153788830	153789313	LINE/CR1	783	-	242	153789072	59275
chr5	153729797	153929797	harbor2	chr5	153798033	153798230	LINE/CR1	427	-	98	153798131	68334
chr5	152085270	152285270	harbor2	chr5	152151403	152151787	LINE/CR1	416	-	192	152151595	66325
chr5	151857548	152057548	harbor2	chr5	151888788	151888919	LINE/CR1	522	-	66	151888854	31306
chr5	151857548	152057548	harbor2	chr5	151918731	151918961	LINE/CR1	585	-	115	151918846	61298
chr5	77920231	78120231	harbor2	chr5	77938721	77938947	LINE/CR1	436	-	113	77938834	18603
chr5	148006738	148206738	harbor2	chr5	148025972	148026421	LINE/CR1	473	-	224	148026196	19458
chr5	151143263	151343263	harbor2	chr5	151199413	151199610	LINE/CR1	503	-	98	151199511	56248
chr5	151143263	151343263	harbor2	chr5	151204370	151204653	LINE/CR1	531	-	142	151204512	61249
chr5	151143263	151343263	harbor2	chr5	151219846	151220065	LINE/CR1	564	-	110	151219956	76693
chr5	83878015	84078015	harbor2	chr5	83947560	83948203	LINE/CR1	626	-	322	83947882	69867
chr5	144690452	144890452	harbor2	chr5	144740796	144740976	LINE/CR1	401	-	90	144740886	50434
chr5	147461876	147661876	harbor2	chr5	147472698	147472993	LINE/CR1	537	-	148	147472846	10970
chr5	109027941	109227941	harbor2	chr5	109083286	109083561	LINE/CR1	774	-	138	109083424	55483
chr5	161360024	161560024	harbor2	chr5	161404894	161405342	LINE/CR1	605	-	224	161405118	45094
chr5	112815799	113015799	harbor2	chr5	112825943	112826246	LINE/CR1	396	-	152	112826095	10296
chr5	113969908	114169908	harbor2	chr5	114014188	114014419	LINE/CR1	403	-	116	114014304	44396
chr6	157449195	157649195	harbor2	chr6	157528007	157528161	LINE/CR1	468	-	77	157528084	78889
chr6	167018813	167218813	harbor2	chr6	167097153	167097478	LINE/CR1	522	-	162	167097315	78502
chr6	167018813	167218813	harbor2	chr6	167097790	167097839	LINE/CR1	522	-	24	167097814	79001
chr6	147994489	148194489	harbor2	chr6	148042622	148042808	LINE/CR1	430	-	93	148042715	48226
chr6	126662571	126862571	harbor2	chr6	126714209	126714578	LINE/CR1	760	-	184	126714393	51822
chr6	126662571	126862571	harbor2	chr6	126714984	126715392	LINE/CR1	473	-	204	126715188	52617
chr6	156251792	156451792	harbor2	chr6	156284934	156285267	LINE/CR1	743	-	166	156285100	33308
chr6	92717677	92917677	harbor2	chr6	92758656	92759239	LINE/CR1	685	-	292	92758948	41271
chr6	164838514	165038514	harbor2	chr6	164842527	164842784	LINE/CR1	588	-	128	164842655	4141
chr6	138742411	138942411	harbor2	chr6	138804013	138804251	LINE/CR1	532	-	119	138804132	61721
chr6	52232936	52432936	harbor2	chr6	52310895	52311326	LINE/CR1	839	-	216	52311111	78175
chr6	52232936	52432936	harbor2	chr6	52312601	52313023	LINE/CR1	410	-	211	52312812	79876
chr6	167637920	167837920	harbor2	chr6	167674257	167674528	LINE/CR1	442	-	136	167674393	36473
chr6	140734169	140934169	harbor2	chr6	140825464	140825679	LINE/CR1	465	-	108	140825572	91403
chr6	100687550	100887550	harbor2	chr6	100707732	100708447	LINE/CR1	852	-	358	100708090	20540
chr6	40958407	41158407	harbor2	chr6	41003486	41003896	LINE/CR1	1074	-	205	41003691	45284
chr6	152706295	152906295	harbor2	chr6	152767210	152767754	LINE/CR1	908	-	272	152767482	61187
chr6	152706295	152906295	harbor2	chr6	152799825	152800191	LINE/CR1	496	-	183	152800008	93713
chr6	134063581	134263581	harbor2	chr6	134148636	134149426	LINE/CR1	580	-	395	134149031	85450
chr6	78471644	78671644	harbor2	chr6	78533167	78533346	LINE/CR1	429	-	90	78533257	61613
chr6	78471644	78671644	harbor2	chr6	78533350	78533617	LINE/CR1	504	-	134	78533484	61840
chr6	140810647	141010647	harbor2	chr6	140825464	140825679	LINE/CR1	465	-	108	140825572	14925
chr6	154264818	154464818	harbor2	chr6	154264685	154265123	LINE/CR1	537	-	219	154264904	86
chr6	141204771	141404771	harbor2	chr6	141214454	141214930	LINE/CR1	709	-	238	141214692	9921
chr6	151078002	151278002	harbor2	chr6	151148099	151148112	LINE/CR1	1223	-	6	151148105	70103
chr6	151078002	151278002	harbor2	chr6	151148547	151148888	LINE/CR1	1223	-	170	151148717	70715
chr6	151078002	151278002	harbor2	chr6	151149202	151149719	LINE/CR1	1223	-	258	151149460	71458
chr6	40351030	40551030	harbor2	chr6	40426660	40427398	LINE/CR1	988	-	369	40427029	75999
chr6	40351030	40551030	harbor2	chr6	40427596	40427897	LINE/CR1	555	-	150	40427746	76716
chr6	112807492	113007492	harbor2	chr6	112821641	112821891	LINE/CR1	452	-	125	112821766	14274
chr6	112807492	113007492	harbor2	chr6	112841778	112842418	LINE/CR1	654	-	320	112842098	34606
chr6	167436237	167636237	harbor2	chr6	167527780	167528512	LINE/CR1	1348	-	366	167528146	91909
chr6	75257980	75457980	harbor2	chr6	75326831	75327075	LINE/CR1	440	-	122	75326953	68973
chr6	46453536	46653536	harbor2	chr6	46492766	46493031	LINE/CR1	525	-	132	46492898	39362
chr6	46453536	46653536	harbor2	chr6	46496887	46497351	LINE/CR1	709	-	232	46497119	43583
chr6	167655624	167855624	harbor2	chr6	167674257	167674528	LINE/CR1	442	-	136	167674393	18769
chr6	125733260	125933260	harbor2	chr6	125807034	125807810	LINE/CR1	707	-	388	125807422	74162
chr6	125733260	125933260	harbor2	chr6	125808526	125809111	LINE/CR1	611	-	292	125808818	75558
chr6	125733260	125933260	harbor2	chr6	125829932	125830374	LINE/CR1	525	-	221	125830153	96893
chr6	125733260	125933260	harbor2	chr6	125830897	125832019	LINE/CR1	1158	-	561	125831458	98198
chr6	75266533	75466533	harbor2	chr6	75326831	75327075	LINE/CR1	440	-	122	75326953	60420
chr6	98349827	98549827	harbor2	chr6	98353250	98353597	LINE/CR1	537	-	174	98353424	3597
chr6	50335995	50535995	harbor2	chr6	50428964	50429617	LINE/CR1	916	-	326	50429290	93295
chr7	130462702	130662702	harbor2	chr7	130488154	130488483	LINE/CR1	496	-	164	130488318	25616
chr7	153623871	153823871	harbor2	chr7	153653799	153654187	LINE/CR1	578	-	194	153653993	30122
chr7	150351971	150551971	harbor2	chr7	150373778	150374006	LINE/CR1	728	-	114	150373892	21921
chr7	154433924	154633924	harbor2	chr7	154507654	154507943	LINE/CR1	518	-	144	154507798	73874
chr7	81767718	81967718	harbor2	chr7	81782716	81782922	LINE/CR1	445	-	103	81782819	15101
chr7	153604371	153804371	harbor2	chr7	153653799	153654187	LINE/CR1	578	-	194	153653993	49622
chr7	39285867	39485867	harbor2	chr7	39301256	39301660	LINE/CR1	493	-	202	39301458	15591
chr7	79360313	79560313	harbor2	chr7	79450742	79451310	LINE/CR1	911	-	284	79451026	90713
chr7	74886891	75086891	harbor2	chr7	74915051	74915387	LINE/CR1	439	-	168	74915219	28328
chr7	74886891	75086891	harbor2	chr7	74915693	74915752	LINE/CR1	439	-	30	74915723	28832
chr7	134860919	135060919	harbor2	chr7	134949210	134949347	LINE/CR1	527	-	68	134949278	88359
chr7	129165780	129365780	harbor2	chr7	129260371	129260794	LINE/CR1	1612	-	212	129260583	94803
chr7	129165780	129365780	harbor2	chr7	129261090	129261995	LINE/CR1	1612	-	452	129261542	95762
chr7	106542437	106742437	harbor2	chr7	106572739	106572961	LINE/CR1	450	-	111	106572850	30413
chr7	106548645	106748645	harbor2	chr7	106572739	106572961	LINE/CR1	450	-	111	106572850	24205
chr7	132637756	132837756	harbor2	chr7	132680164	132680318	LINE/CR1	476	-	77	132680241	42485
chr7	131757430	131957430	harbor2	chr7	131809887	131810451	LINE/CR1	1047	-	282	131810169	52739
chr7	140197844	140397844	harbor2	chr7	140260345	140260594	LINE/CR1	511	-	124	140260469	62625
chr7	41910497	42110497	harbor2	chr7	42008071	42008396	LINE/CR1	504	-	162	42008233	97736
chr7	118192898	118392898	harbor2	chr7	118195583	118196356	LINE/CR1	705	-	386	118195969	3071
chr7	141565929	141765929	harbor2	chr7	141662194	141662355	LINE/CR1	443	-	80	141662274	96345
chr7	93289258	93489258	harbor2	chr7	93312318	93312613	LINE/CR1	587	-	148	93312466	23208
chr7	79231160	79431160	harbor2	chr7	79240594	79240877	LINE/CR1	442	-	142	79240736	9576
chr7	111278166	111478166	harbor2	chr7	111292165	111292313	LINE/CR1	539	-	74	111292239	14073
chr7	111278166	111478166	harbor2	chr7	111345690	111346079	LINE/CR1	605	-	194	111345884	67718
chr8	108165434	108365434	harbor2	chr8	108188823	108189074	LINE/CR1	618	-	126	108188949	23515
chr8	59244790	59444790	harbor2	chr8	59299152	59299692	LINE/CR1	1242	-	270	59299422	54632
chr8	59244790	59444790	harbor2	chr8	59300384	59300514	LINE/CR1	1242	-	65	59300449	55659
chr8	131612658	131812658	harbor2	chr8	131626678	131627080	LINE/CR1	624	-	201	131626879	14221
chr8	101635464	101835464	harbor2	chr8	101637719	101638204	LINE/CR1	644	-	242	101637961	2497
chr8	125999393	126199393	harbor2	chr8	126076926	126077030	LINE/CR1	591	-	52	126076978	77585
chr8	125999393	126199393	harbor2	chr8	126077330	126077683	LINE/CR1	591	-	176	126077506	78113
chr8	139336514	139536514	harbor2	chr8	139433216	139433523	LINE/CR1	433	-	154	139433370	96856
chr8	134602053	134802053	harbor2	chr8	134616334	134616714	LINE/CR1	421	-	190	134616524	14471
chr8	104256930	104456930	harbor2	chr8	104257755	104258056	LINE/CR1	485	-	150	104257905	975
chr8	104256930	104456930	harbor2	chr8	104258531	104258944	LINE/CR1	678	-	206	104258737	1807
chr8	104199899	104399899	harbor2	chr8	104257755	104258056	LINE/CR1	485	-	150	104257905	58006
chr8	104199899	104399899	harbor2	chr8	104258531	104258944	LINE/CR1	678	-	206	104258737	58838
chr8	135665959	135865959	harbor2	chr8	135678257	135678394	LINE/CR1	441	-	68	135678325	12366
chr8	135665959	135865959	harbor2	chr8	135678801	135679006	LINE/CR1	438	-	102	135678903	12944
chr8	131591598	131791598	harbor2	chr8	131626678	131627080	LINE/CR1	624	-	201	131626879	35281
chr8	107925272	108125272	harbor2	chr8	108013032	108013173	LINE/CR1	551	-	70	108013102	87830
chr8	86639356	86839356	harbor2	chr8	86660840	86661036	LINE/CR1	550	-	98	86660938	21582
chr8	86639356	86839356	harbor2	chr8	86688226	86688519	LINE/CR1	575	-	146	86688372	49016
chr8	131166543	131366543	harbor2	chr8	131242519	131242720	LINE/CR1	467	-	100	131242619	76076
chr8	128928583	129128583	harbor2	chr8	128933918	128934095	LINE/CR1	634	-	88	128934006	5423
chr8	131606213	131806213	harbor2	chr8	131626678	131627080	LINE/CR1	624	-	201	131626879	20666
chr8	112812475	113012475	harbor2	chr8	112908276	112908662	LINE/CR1	370	-	193	112908469	95994
chr8	131538625	131738625	harbor2	chr8	131538584	131539085	LINE/CR1	567	-	250	131538834	209
chr8	131538625	131738625	harbor2	chr8	131626678	131627080	LINE/CR1	624	-	201	131626879	88254
chr8	76504478	76704478	harbor2	chr8	76543167	76543701	LINE/CR1	1059	-	267	76543434	38956
chr8	76504478	76704478	harbor2	chr8	76602596	76602770	LINE/CR1	420	-	87	76602683	98205
chr8	76504478	76704478	harbor2	chr8	76603890	76604235	LINE/CR1	572	-	172	76604062	99584
chr8	71526168	71726168	harbor2	chr8	71544294	71544740	LINE/CR1	371	-	223	71544517	18349
chr8	71526168	71726168	harbor2	chr8	71544848	71545055	LINE/CR1	654	-	104	71544952	18784
chr8	105143614	105343614	harbor2	chr8	105152622	105152800	LINE/CR1	441	-	89	105152711	9097
chr8	105143614	105343614	harbor2	chr8	105154003	105154533	LINE/CR1	719	-	265	105154268	10654
chr8	128154020	128354020	harbor2	chr8	128248635	128248928	LINE/CR1	598	-	146	128248781	94761
chr8	103088136	103288136	harbor2	chr8	103144371	103144500	LINE/CR1	369	-	64	103144435	56299
chr8	103088136	103288136	harbor2	chr8	103145264	103145689	LINE/CR1	537	-	212	103145476	57340
chr8	123887206	124087206	harbor2	chr8	123954231	123954440	LINE/CR1	457	-	104	123954335	67129
chr8	123887206	124087206	harbor2	chr8	123972431	123972978	LINE/CR1	686	-	274	123972705	85499
chr8	57062066	57262066	harbor2	chr8	57062168	57062450	LINE/CR1	646	-	141	57062309	243
chr8	57062066	57262066	harbor2	chr8	57077227	57077615	LINE/CR1	696	-	194	57077421	15355
chr8	58758424	58958424	harbor2	chr8	58820021	58820245	LINE/CR1	381	-	112	58820133	61709
chr8	135624091	135824091	harbor2	chr8	135678257	135678394	LINE/CR1	441	-	68	135678325	54234
chr8	135624091	135824091	harbor2	chr8	135678801	135679006	LINE/CR1	438	-	102	135678903	54812
chr8	120068491	120268491	harbor2	chr8	120138937	120139286	LINE/CR1	533	-	174	120139111	70620
chr8	126045451	126245451	harbor2	chr8	126076926	126077030	LINE/CR1	591	-	52	126076978	31527
chr8	126045451	126245451	harbor2	chr8	126077330	126077683	LINE/CR1	591	-	176	126077506	32055
chr8	138679488	138879488	harbor2	chr8	138685894	138686179	LINE/CR1	579	-	142	138686036	6548
chr8	99874130	100074130	harbor2	chr8	99907561	99907698	LINE/CR1	370	-	68	99907629	33499
chr8	80972715	81172715	harbor2	chr8	81035968	81036351	LINE/CR1	542	-	192	81036160	63445
chr9	6839634	7039634	harbor2	chr9	6929292	6929392	LINE/CR1	468	-	50	6929342	89708
chr9	125505580	125705580	harbor2	chr9	125599217	125599463	LINE/CR1	458	-	123	125599340	93760
chr9	105638242	105838242	harbor2	chr9	105661446	105661723	LINE/CR1	548	-	138	105661584	23342
chr9	117913215	118113215	harbor2	chr9	117952141	117952695	LINE/CR1	470	-	277	117952418	39203
chr9	91365178	91565178	harbor2	chr9	91407532	91407770	LINE/CR1	551	-	119	91407651	42473
chr9	109367266	109567266	harbor2	chr9	109451456	109451648	LINE/CR1	434	-	96	109451552	84286
chr9	98767974	98967974	harbor2	chr9	98777742	98777910	LINE/CR1	443	-	84	98777826	9852
chr9	98767974	98967974	harbor2	chr9	98862939	98863273	LINE/CR1	622	-	167	98863106	95132
chr9	132609057	132809057	harbor2	chr9	132648766	132649045	LINE/CR1	461	-	140	132648906	39849
chr9	132609057	132809057	harbor2	chr9	132664000	132664383	LINE/CR1	567	-	192	132664192	55135
chr9	132609057	132809057	harbor2	chr9	132675829	132675895	LINE/CR1	765	-	33	132675862	66805
chr9	132609057	132809057	harbor2	chr9	132676199	132676322	LINE/CR1	765	-	62	132676261	67204
chr9	132609057	132809057	harbor2	chr9	132676621	132677113	LINE/CR1	765	-	246	132676867	67810
chr9	93239757	93439757	harbor2	chr9	93246911	93247134	LINE/CR1	411	-	112	93247023	7266
chr9	109700567	109900567	harbor2	chr9	109712694	109712964	LINE/CR1	492	-	135	109712829	12262
chr9	117891421	118091421	harbor2	chr9	117952141	117952695	LINE/CR1	470	-	277	117952418	60997
chr9	109676786	109876786	harbor2	chr9	109691375	109691715	LINE/CR1	402	-	170	109691545	14759
chr9	109676786	109876786	harbor2	chr9	109712694	109712964	LINE/CR1	492	-	135	109712829	36043
chr9	92476254	92676254	harbor2	chr9	92479520	92479728	LINE/CR1	437	-	104	92479624	3370
chr9	109871215	110071215	harbor2	chr9	109934111	109934646	LINE/CR1	744	-	268	109934379	63164
chr9	109871215	110071215	harbor2	chr9	109935188	109935997	LINE/CR1	1032	-	404	109935592	64377
chr9	119355842	119555842	harbor2	chr9	119410742	119410920	LINE/CR1	501	-	89	119410831	54989
chr9	119355842	119555842	harbor2	chr9	119411227	119411334	LINE/CR1	501	-	54	119411281	55439
chr9	71813459	72013459	harbor2	chr9	71863517	71863969	LINE/CR1	841	-	226	71863743	50284
chr9	108970538	109170538	harbor2	chr9	109043200	109043592	LINE/CR1	575	-	196	109043396	72858
chr9	118973349	119173349	harbor2	chr9	119008061	119008426	LINE/CR1	393	-	182	119008243	34894
chr9	85284733	85484733	harbor2	chr9	85382699	85383135	LINE/CR1	823	-	218	85382917	98184
chr9	72414895	72614895	harbor2	chr9	72422833	72423145	LINE/CR1	724	-	156	72422989	8094
chr9	100451892	100651892	harbor2	chr9	100477004	100477620	LINE/CR1	1181	-	308	100477312	25420
chr9	100451892	100651892	harbor2	chr9	100477927	100478307	LINE/CR1	1181	-	190	100478117	26225
chr9	108547897	108747897	harbor2	chr9	108582741	108582934	LINE/CR1	391	-	96	108582837	34940
chr9	125652003	125852003	harbor2	chr9	125717144	125717341	LINE/CR1	553	-	98	125717242	65239
chr9	121279757	121479757	harbor2	chr9	121326943	121327158	LINE/CR1	512	-	108	121327051	47294
chr9	109883190	110083190	harbor2	chr9	109934111	109934646	LINE/CR1	744	-	268	109934379	51189
chr9	109883190	110083190	harbor2	chr9	109935188	109935997	LINE/CR1	1032	-	404	109935592	52402
chr9	105919668	106119668	harbor2	chr9	105987338	105987906	LINE/CR1	830	-	284	105987622	67954
chr9	38175548	38375548	harbor2	chr9	38237579	38237963	LINE/CR1	650	-	192	38237771	62223
chr9	99499498	99699498	harbor2	chr9	99534837	99535141	LINE/CR1	536	-	152	99534989	35491
chr9	99499498	99699498	harbor2	chr9	99535467	99536187	LINE/CR1	989	-	360	99535827	36329
chr9	99499498	99699498	harbor2	chr9	99536810	99537159	LINE/CR1	672	-	174	99536984	37486
chr9	97573307	97773307	harbor2	chr9	97577180	97577342	LINE/CR1	422	-	81	97577261	3954
chr9	81221419	81421419	harbor2	chr9	81253535	81254047	LINE/CR1	1060	-	256	81253791	32372
chr9	24092785	24292785	harbor2	chr9	24097403	24097770	LINE/CR1	451	-	184	24097587	4802
chr9	98713448	98913448	harbor2	chr9	98714902	98716045	LINE/CR1	1243	-	572	98715474	2026
chr9	98713448	98913448	harbor2	chr9	98777742	98777910	LINE/CR1	443	-	84	98777826	64378
chr9	98441531	98641531	harbor2	chr9	98458884	98459209	LINE/CR1	534	-	162	98459046	17515
chr9	98441531	98641531	harbor2	chr9	98479593	98480201	LINE/CR1	398	-	304	98479897	38366
chr9	128197107	128397107	harbor2	chr9	128241931	128242061	LINE/CR1	398	-	65	128241996	44889
chr9	75773390	75973390	harbor2	chr9	75840443	75840815	LINE/CR1	395	-	186	75840629	67239
chr9	121870900	122070900	harbor2	chr9	121949663	121949965	LINE/CR1	570	-	151	121949814	78914
chr9	121870900	122070900	harbor2	chr9	121958193	121958548	LINE/CR1	567	-	178	121958371	87471
chr9	75844880	76044880	harbor2	chr9	75940010	75940304	LINE/CR1	500	-	147	75940157	95277
chr9	99904739	100104739	harbor2	chr9	99921231	99921434	LINE/CR1	565	-	102	99921333	16594
chr9	99904739	100104739	harbor2	chr9	99921579	99922017	LINE/CR1	1164	-	219	99921798	17059
chr9	99904739	100104739	harbor2	chr9	99939750	99940134	LINE/CR1	1217	-	192	99939942	35203
chr9	99904739	100104739	harbor2	chr9	99940417	99940464	LINE/CR1	1217	-	24	99940441	35702
chr9	99904739	100104739	harbor2	chr9	99940781	99941198	LINE/CR1	1217	-	208	99940989	36250
chr9	99904739	100104739	harbor2	chr9	99961744	99962214	LINE/CR1	643	-	235	99961979	57240
chr9	132809308	133009308	harbor2	chr9	132893034	132893453	LINE/CR1	491	-	210	132893244	83936
chr9	77869414	78069414	harbor2	chr9	77915096	77915300	LINE/CR1	476	-	102	77915198	45784
chr9	103387173	103587173	harbor2	chr9	103432795	103433460	LINE/CR1	438	-	332	103433127	45954
chr9	129067734	129267734	harbor2	chr9	129121329	129121547	LINE/CR1	477	-	109	129121438	53704
chr9	109903026	110103026	harbor2	chr9	109934111	109934646	LINE/CR1	744	-	268	109934379	31353
chr9	109903026	110103026	harbor2	chr9	109935188	109935997	LINE/CR1	1032	-	404	109935592	32566
chr9	82638776	82838776	harbor2	chr9	82727552	82727877	LINE/CR1	489	-	162	82727714	88938
chr9	28172524	28372524	harbor2	chr9	28228197	28228414	LINE/CR1	435	-	108	28228305	55781
chr9	28172524	28372524	harbor2	chr9	28264460	28264595	LINE/CR1	480	-	68	28264528	92004
chr9	68911145	69111145	harbor2	chr9	69006535	69006798	LINE/CR1	622	-	132	69006667	95522
chr9	102137962	102337962	harbor2	chr9	102158387	102159596	LINE/CR1	626	-	604	102158991	21029
chr9	102137962	102337962	harbor2	chr9	102162574	102163179	LINE/CR1	655	-	302	102162876	24914
chr9	109179900	109379900	harbor2	chr9	109228232	109228681	LINE/CR1	942	-	224	109228456	48556
chr9	109179900	109379900	harbor2	chr9	109229160	109229383	LINE/CR1	514	-	112	109229272	49372
chr9	98115336	98315336	harbor2	chr9	98145137	98145458	LINE/CR1	549	-	160	98145297	29961
chr9	104899122	105099122	harbor2	chr9	104977591	104977914	LINE/CR1	834	-	162	104977753	78631
chr9	119425434	119625434	harbor2	chr9	119458321	119459019	LINE/CR1	967	-	349	119458670	33236
chr9	119425434	119625434	harbor2	chr9	119482077	119482687	LINE/CR1	697	-	305	119482382	56948
chr9	99166838	99366838	harbor2	chr9	99182818	99183006	LINE/CR1	511	-	94	99182912	16074
chr9	99166838	99366838	harbor2	chr9	99256230	99256494	LINE/CR1	408	-	132	99256362	89524
chr9	99166838	99366838	harbor2	chr9	99265441	99265713	LINE/CR1	481	-	136	99265577	98739
chr9	79354958	79554958	harbor2	chr9	79427867	79428046	LINE/CR1	622	-	90	79427957	72999
chr9	79354958	79554958	harbor2	chr9	79429376	79429584	LINE/CR1	456	-	104	79429480	74522
chr9	105556173	105756173	harbor2	chr9	105622881	105623218	LINE/CR1	391	-	168	105623049	66876
chr9	130234003	130434003	harbor2	chr9	130305076	130305269	LINE/CR1	405	-	96	130305172	71169
chr9	132666176	132866176	harbor2	chr9	132675829	132675895	LINE/CR1	765	-	33	132675862	9686
chr9	132666176	132866176	harbor2	chr9	132676199	132676322	LINE/CR1	765	-	62	132676261	10085
chr9	132666176	132866176	harbor2	chr9	132676621	132677113	LINE/CR1	765	-	246	132676867	10691
chr9	132563497	132763497	harbor2	chr9	132648766	132649045	LINE/CR1	461	-	140	132648906	85409
chr9	119545959	119745959	harbor2	chr9	119565143	119565662	LINE/CR1	584	-	260	119565403	19444
chr9	119545959	119745959	harbor2	chr9	119566017	119566186	LINE/CR1	518	-	84	119566101	20142
chr9	119545959	119745959	harbor2	chr9	119566488	119566618	LINE/CR1	518	-	65	119566553	20594
chr9	110955803	111155803	harbor2	chr9	111011256	111011741	LINE/CR1	587	-	242	111011498	55695
chr9	75901308	76101308	harbor2	chr9	75940010	75940304	LINE/CR1	500	-	147	75940157	38849
chr9	104902077	105102077	harbor2	chr9	104977591	104977914	LINE/CR1	834	-	162	104977753	75676
chr9	128155396	128355396	harbor2	chr9	128241931	128242061	LINE/CR1	398	-	65	128241996	86600
chr9	129053454	129253454	harbor2	chr9	129121329	129121547	LINE/CR1	477	-	109	129121438	67984
chr9	134789919	134989919	harbor2	chr9	134837963	134838122	LINE/CR1	431	-	80	134838043	48124
chr10	93820572	94020572	harbor2	chr10	93866777	93867197	LINE/CR1	703	-	210	93866987	46415
chr10	93820572	94020572	harbor2	chr10	93870140	93870331	LINE/CR1	413	-	96	93870236	49664
chr10	123737951	123937951	harbor2	chr10	123784674	123784838	LINE/CR1	595	-	82	123784756	46805
chr10	123737951	123937951	harbor2	chr10	123785236	123785389	LINE/CR1	595	-	76	123785312	47361
chr10	126338370	126538370	harbor2	chr10	126394902	126395180	LINE/CR1	664	-	139	126395041	56671
chr10	61248730	61448730	harbor2	chr10	61337314	61337590	LINE/CR1	562	-	138	61337452	88722
chr10	61248730	61448730	harbor2	chr10	61337929	61337991	LINE/CR1	562	-	31	61337960	89230
chr10	123228199	123428199	harbor2	chr10	123228040	123228252	LINE/CR1	654	-	106	123228146	53
chr10	123228199	123428199	harbor2	chr10	123228599	123228689	LINE/CR1	654	-	45	123228644	445
chr10	87748728	87948728	harbor2	chr10	87831228	87831413	LINE/CR1	441	-	92	87831320	82592
chr10	126236799	126436799	harbor2	chr10	126274570	126274920	LINE/CR1	471	-	175	126274745	37946
chr10	90827380	91027380	harbor2	chr10	90856349	90856474	LINE/CR1	452	-	62	90856411	29031
chr10	90827380	91027380	harbor2	chr10	90914273	90914655	LINE/CR1	600	-	191	90914464	87084
chr10	113009159	113209159	harbor2	chr10	113046372	113046603	LINE/CR1	418	-	116	113046488	37329
chr10	116754167	116954167	harbor2	chr10	116758920	116759167	LINE/CR1	425	-	124	116759044	4877
chr10	94319252	94519252	harbor2	chr10	94343406	94343589	LINE/CR1	413	-	92	94343498	24246
chr10	126496146	126696146	harbor2	chr10	126534225	126534799	LINE/CR1	545	-	287	126534512	38366
chr10	123436531	123636531	harbor2	chr10	123482200	123482343	LINE/CR1	409	-	72	123482272	45741
chr10	131290672	131490672	harbor2	chr10	131320188	131320339	LINE/CR1	473	-	76	131320264	29592
chr10	131267561	131467561	harbor2	chr10	131320188	131320339	LINE/CR1	473	-	76	131320264	52703
chr10	74840912	75040912	harbor2	chr10	74910311	74910779	LINE/CR1	657	-	234	74910545	69633
chr10	131056253	131256253	harbor2	chr10	131121451	131121616	LINE/CR1	597	-	82	131121533	65280
chr10	131256720	131456720	harbor2	chr10	131320188	131320339	LINE/CR1	473	-	76	131320264	63544
chr10	100593749	100793749	harbor2	chr10	100664280	100664521	LINE/CR1	486	-	120	100664400	70651
chr11	88809305	89009305	harbor2	chr11	88879586	88879833	LINE/CR1	437	-	124	88879710	70405
chr11	94745263	94945263	harbor2	chr11	94755407	94755590	LINE/CR1	400	-	92	94755499	10236
chr11	94745263	94945263	harbor2	chr11	94756634	94756901	LINE/CR1	399	-	134	94756768	11505
chr11	94745263	94945263	harbor2	chr11	94825833	94826002	LINE/CR1	483	-	84	94825917	80654
chr11	94745263	94945263	harbor2	chr11	94826309	94826367	LINE/CR1	483	-	29	94826338	81075
chr11	94745263	94945263	harbor2	chr11	94826802	94826838	LINE/CR1	483	-	18	94826820	81557
chr11	114935676	115135676	harbor2	chr11	115011847	115011915	LINE/CR1	1072	-	34	115011881	76205
chr11	114935676	115135676	harbor2	chr11	115012160	115012634	LINE/CR1	1072	-	237	115012397	76721
chr11	134721797	134921797	harbor2	chr11	134763659	134763860	LINE/CR1	378	-	100	134763759	41962
chr11	20697519	20897519	harbor2	chr11	20717905	20718080	LINE/CR1	379	-	88	20717993	20474
chr11	105509477	105709477	harbor2	chr11	105531460	105531679	LINE/CR1	458	-	110	105531570	22093
chr11	121785436	121985436	harbor2	chr11	121881633	121882372	LINE/CR1	895	-	370	121882003	96567
chr11	89426752	89626752	harbor2	chr11	89468034	89468609	LINE/CR1	636	-	288	89468322	41570
chr11	89426752	89626752	harbor2	chr11	89504706	89504968	LINE/CR1	664	-	131	89504837	78085
chr11	104576591	104776591	harbor2	chr11	104655339	104655529	LINE/CR1	450	-	95	104655434	78843
chr11	104576591	104776591	harbor2	chr11	104670402	104670911	LINE/CR1	492	-	254	104670656	94065
chr11	134687844	134887844	harbor2	chr11	134763659	134763860	LINE/CR1	378	-	100	134763759	75915
chr11	133320641	133520641	harbor2	chr11	133377915	133378620	LINE/CR1	566	-	352	133378267	57626
chr11	128358885	128558885	harbor2	chr11	128401529	128401713	LINE/CR1	396	-	92	128401621	42736
chr11	128358885	128558885	harbor2	chr11	128401849	128402288	LINE/CR1	529	-	220	128402069	43184
chr11	72791212	72991212	harbor2	chr11	72886071	72886414	LINE/CR1	632	-	172	72886243	95031
chr11	25046314	25246314	harbor2	chr11	25139772	25140239	LINE/CR1	475	-	234	25140006	93692
chr11	126600636	126800636	harbor2	chr11	126620151	126620406	LINE/CR1	411	-	128	126620279	19643
chr11	116169971	116369971	harbor2	chr11	116172719	116172791	LINE/CR1	645	-	36	116172755	2784
chr11	116169971	116369971	harbor2	chr11	116173270	116173459	LINE/CR1	645	-	94	116173364	3393
chr11	116169971	116369971	harbor2	chr11	116182191	116182402	LINE/CR1	522	-	106	116182297	12326
chr11	111194744	111394744	harbor2	chr11	111254939	111255149	LINE/CR1	374	-	105	111255044	60300
chr11	125925704	126125704	harbor2	chr11	125971645	125971864	LINE/CR1	457	-	110	125971755	46051
chr11	125925704	126125704	harbor2	chr11	125992880	125993185	LINE/CR1	616	-	152	125993032	67328
chr11	125946090	126146090	harbor2	chr11	125971645	125971864	LINE/CR1	457	-	110	125971755	25665
chr11	125946090	126146090	harbor2	chr11	125992880	125993185	LINE/CR1	616	-	152	125993032	46942
chr11	115500745	115700745	harbor2	chr11	115541352	115541797	LINE/CR1	1177	-	222	115541574	40829
chr11	115500745	115700745	harbor2	chr11	115542145	115542334	LINE/CR1	1177	-	94	115542239	41494
chr11	115500745	115700745	harbor2	chr11	115542811	115542909	LINE/CR1	1401	-	49	115542860	42115
chr11	115500745	115700745	harbor2	chr11	115543342	115543768	LINE/CR1	1401	-	213	115543555	42810
chr11	82367958	82567958	harbor2	chr11	82406840	82407142	LINE/CR1	452	-	151	82406991	39033
chr11	59501102	59701102	harbor2	chr11	59590295	59590363	LINE/CR1	477	-	34	59590329	89227
chr11	59501102	59701102	harbor2	chr11	59590612	59590912	LINE/CR1	477	-	150	59590762	89660
chr11	133309979	133509979	harbor2	chr11	133377915	133378620	LINE/CR1	566	-	352	133378267	68288
chr11	117695936	117895936	harbor2	chr11	117722747	117722951	LINE/CR1	383	-	102	117722849	26913
chr11	117695936	117895936	harbor2	chr11	117723194	117723346	LINE/CR1	412	-	76	117723270	27334
chr11	117695936	117895936	harbor2	chr11	117723621	117724174	LINE/CR1	953	-	276	117723897	27961
chr11	117695936	117895936	harbor2	chr11	117748235	117748506	LINE/CR1	682	-	136	117748371	52435
chr11	126733061	126933061	harbor2	chr11	126751232	126751504	LINE/CR1	406	-	136	126751368	18307
chr11	129947930	130147930	harbor2	chr11	129948795	129949109	LINE/CR1	726	-	157	129948952	1022
chr11	110857651	111057651	harbor2	chr11	110879723	110880069	LINE/CR1	688	-	173	110879896	22245
chr11	110857651	111057651	harbor2	chr11	110880193	110880543	LINE/CR1	901	-	175	110880368	22717
chr11	79010269	79210269	harbor2	chr11	79079867	79080174	LINE/CR1	398	-	154	79080021	69752
chr11	79010269	79210269	harbor2	chr11	79083452	79083725	LINE/CR1	509	-	136	79083588	73319
chr11	111436508	111636508	harbor2	chr11	111500312	111500793	LINE/CR1	844	-	240	111500552	64044
chr11	109407424	109607424	harbor2	chr11	109417917	109418248	LINE/CR1	436	-	166	109418083	10659
chr11	86975314	87175314	harbor2	chr11	86980098	86980334	LINE/CR1	383	-	118	86980216	4902
chr11	129868908	130068908	harbor2	chr11	129948795	129949109	LINE/CR1	726	-	157	129948952	80044
chr11	122968086	123168086	harbor2	chr11	122973535	122974025	LINE/CR1	622	-	245	122973780	5694
chr11	127824252	128024252	harbor2	chr11	127837114	127837373	LINE/CR1	575	-	130	127837244	12992
chr11	120110322	120310322	harbor2	chr11	120142367	120142589	LINE/CR1	452	-	111	120142478	32156
chr11	105565680	105765680	harbor2	chr11	105625375	105626151	LINE/CR1	395	-	388	105625763	60083
chr11	120102211	120302211	harbor2	chr11	120142367	120142589	LINE/CR1	452	-	111	120142478	40267
chr11	125898453	126098453	harbor2	chr11	125971645	125971864	LINE/CR1	457	-	110	125971755	73302
chr11	125898453	126098453	harbor2	chr11	125992880	125993185	LINE/CR1	616	-	152	125993032	94579
chr11	74694708	74894708	harbor2	chr11	74700934	74701135	LINE/CR1	404	-	100	74701034	6326
chr11	74694708	74894708	harbor2	chr11	74734666	74734883	LINE/CR1	648	-	108	74734774	40066
chr11	115704262	115904262	harbor2	chr11	115749156	115749648	LINE/CR1	825	-	246	115749402	45140
chr11	119745066	119945066	harbor2	chr11	119776644	119776966	LINE/CR1	405	-	161	119776805	31739
chr11	120008815	120208815	harbor2	chr11	120014781	120015056	LINE/CR1	533	-	138	120014919	6104
chr11	120008815	120208815	harbor2	chr11	120021806	120021910	LINE/CR1	379	-	52	120021858	13043
chr11	120008815	120208815	harbor2	chr11	120101978	120102134	LINE/CR1	483	-	78	120102056	93241
chr11	116798092	116998092	harbor2	chr11	116856267	116856580	LINE/CR1	648	-	156	116856423	58331
chr11	86282361	86482361	harbor2	chr11	86300146	86300406	LINE/CR1	451	-	130	86300276	17915
chr11	42563328	42763328	harbor2	chr11	42593688	42594029	LINE/CR1	479	-	170	42593858	30530
chr11	59552895	59752895	harbor2	chr11	59590295	59590363	LINE/CR1	477	-	34	59590329	37434
chr11	59552895	59752895	harbor2	chr11	59590612	59590912	LINE/CR1	477	-	150	59590762	37867
chr11	26724293	26924293	harbor2	chr11	26760232	26760557	LINE/CR1	665	-	162	26760394	36101
chr11	132603948	132803948	harbor2	chr11	132674749	132674971	LINE/CR1	421	-	111	132674860	70912
chr11	134699327	134899327	harbor2	chr11	134763659	134763860	LINE/CR1	378	-	100	134763759	64432
chr11	129851915	130051915	harbor2	chr11	129948795	129949109	LINE/CR1	726	-	157	129948952	97037
chr11	118166450	118366450	harbor2	chr11	118241731	118241864	LINE/CR1	389	-	66	118241797	75347
chr11	126023267	126223267	harbor2	chr11	126056055	126056268	LINE/CR1	491	-	106	126056161	32894
chr11	128139939	128339939	harbor2	chr11	128213189	128213510	LINE/CR1	481	-	160	128213349	73410
chr11	37025451	37225451	harbor2	chr11	37054697	37055060	LINE/CR1	462	-	182	37054879	29428
chr11	133340514	133540514	harbor2	chr11	133377915	133378620	LINE/CR1	566	-	352	133378267	37753
chr11	121460603	121660603	harbor2	chr11	121537594	121537857	LINE/CR1	393	-	132	121537726	77123
chr11	121460603	121660603	harbor2	chr11	121537971	121538185	LINE/CR1	399	-	107	121538078	77475
chr11	121460603	121660603	harbor2	chr11	121538575	121538681	LINE/CR1	617	-	53	121538628	78025
chr11	121460603	121660603	harbor2	chr11	121538977	121539625	LINE/CR1	617	-	324	121539301	78698
chr11	127507687	127707687	harbor2	chr11	127528373	127528639	LINE/CR1	408	-	133	127528506	20819
chr11	100080912	100280912	harbor2	chr11	100104687	100104900	LINE/CR1	384	-	106	100104793	23881
chr11	13320805	13520805	harbor2	chr11	13333564	13333974	LINE/CR1	379	-	205	13333769	12964
chr11	13320805	13520805	harbor2	chr11	13364111	13364406	LINE/CR1	549	-	148	13364259	43454
chr11	13320805	13520805	harbor2	chr11	13418843	13419227	LINE/CR1	520	-	192	13419035	98230
chr11	116678321	116878321	harbor2	chr11	116765927	116766199	LINE/CR1	543	-	136	116766063	87742
chr11	116678321	116878321	harbor2	chr11	116768616	116768721	LINE/CR1	381	-	52	116768668	90347
chr11	116678321	116878321	harbor2	chr11	116769037	116769205	LINE/CR1	381	-	84	116769121	90800
chr11	123420345	123620345	harbor2	chr11	123445861	123446022	LINE/CR1	376	-	80	123445941	25596
chr11	84433158	84633158	harbor2	chr11	84520033	84520556	LINE/CR1	901	-	262	84520295	87137
chr11	112850025	113050025	harbor2	chr11	112941801	112942091	LINE/CR1	421	-	145	112941946	91921
chr11	72272748	72472748	harbor2	chr11	72327126	72327492	LINE/CR1	411	-	183	72327309	54561
chr11	118051190	118251190	harbor2	chr11	118113701	118113911	LINE/CR1	512	-	105	118113806	62616
chr11	118051190	118251190	harbor2	chr11	118138155	118138595	LINE/CR1	472	-	220	118138375	87185
chr11	118051190	118251190	harbor2	chr11	118140322	118140891	LINE/CR1	588	-	284	118140606	89416
chr11	66026136	66226136	harbor2	chr11	66047570	66047915	LINE/CR1	735	-	172	66047742	21606
chr11	121108420	121308420	harbor2	chr11	121138555	121139095	LINE/CR1	543	-	270	121138825	30405
chr11	121108420	121308420	harbor2	chr11	121139763	121140428	LINE/CR1	833	-	332	121140095	31675
chr11	118165776	118365776	harbor2	chr11	118241731	118241864	LINE/CR1	389	-	66	118241797	76021
chr11	134159015	134359015	harbor2	chr11	134182200	134182770	LINE/CR1	957	-	285	134182485	23470
chr11	94229243	94429243	harbor2	chr11	94230844	94231146	LINE/CR1	515	-	151	94230995	1752
chr11	86541039	86741039	harbor2	chr11	86607565	86607882	LINE/CR1	464	-	158	86607723	66684
chr11	111201435	111401435	harbor2	chr11	111254939	111255149	LINE/CR1	374	-	105	111255044	53609
chr11	133316121	133516121	harbor2	chr11	133377915	133378620	LINE/CR1	566	-	352	133378267	62146
chr11	85271180	85471180	harbor2	chr11	85311531	85311930	LINE/CR1	489	-	200	85311731	40551
chr11	114390856	114590856	harbor2	chr11	114397988	114398160	LINE/CR1	427	-	86	114398074	7218
chr11	114390856	114590856	harbor2	chr11	114398678	114398808	LINE/CR1	382	-	65	114398743	7887
chr11	114853136	115053136	harbor2	chr11	114854802	114855033	LINE/CR1	708	-	116	114854918	1782
chr11	96178268	96378268	harbor2	chr11	96198180	96198509	LINE/CR1	477	-	164	96198344	20076
chr11	131806099	132006099	harbor2	chr11	131864633	131864890	LINE/CR1	484	-	128	131864761	58662
chr11	131806099	132006099	harbor2	chr11	131891673	131891982	LINE/CR1	643	-	154	131891827	85728
chr11	131806099	132006099	harbor2	chr11	131901383	131901778	LINE/CR1	715	-	198	131901581	95482
chr11	126418489	126618489	harbor2	chr11	126429671	126429854	LINE/CR1	427	-	92	126429763	11274
chr11	126418489	126618489	harbor2	chr11	126454794	126455041	LINE/CR1	445	-	124	126454918	36429
chr11	108187439	108387439	harbor2	chr11	108230082	108230133	LINE/CR1	389	-	26	108230108	42669
chr11	108187439	108387439	harbor2	chr11	108230424	108230707	LINE/CR1	389	-	142	108230566	43127
chr11	108187439	108387439	harbor2	chr11	108231002	108231273	LINE/CR1	389	-	136	108231138	43699
chr11	117648754	117848754	harbor2	chr11	117692634	117692920	LINE/CR1	422	-	143	117692777	44023
chr11	117648754	117848754	harbor2	chr11	117692949	117693570	LINE/CR1	413	-	310	117693259	44505
chr11	117648754	117848754	harbor2	chr11	117693801	117693986	LINE/CR1	468	-	92	117693893	45139
chr11	117648754	117848754	harbor2	chr11	117722747	117722951	LINE/CR1	383	-	102	117722849	74095
chr11	117648754	117848754	harbor2	chr11	117723194	117723346	LINE/CR1	412	-	76	117723270	74516
chr11	117648754	117848754	harbor2	chr11	117723621	117724174	LINE/CR1	953	-	276	117723897	75143
chr11	117648754	117848754	harbor2	chr11	117748235	117748506	LINE/CR1	682	-	136	117748371	99617
chr11	45122909	45322909	harbor2	chr11	45199191	45199500	LINE/CR1	475	-	154	45199345	76436
chr11	46179357	46379357	harbor2	chr11	46198841	46198945	LINE/CR1	423	-	52	46198893	19536
chr11	88788636	88988636	harbor2	chr11	88879586	88879833	LINE/CR1	437	-	124	88879710	91074
chr11	103665059	103865059	harbor2	chr11	103700803	103700965	LINE/CR1	409	-	81	103700884	35825
chr12	79751365	79951365	harbor2	chr12	79801382	79801956	LINE/CR1	685	-	287	79801669	50304
chr12	77389379	77589379	harbor2	chr12	77440788	77440935	LINE/CR1	463	-	74	77440862	51483
chr12	99107050	99307050	harbor2	chr12	99155703	99156003	LINE/CR1	658	-	150	99155853	48803
chr12	93890624	94090624	harbor2	chr12	93957773	93958075	LINE/CR1	803	-	151	93957924	67300
chr12	93890624	94090624	harbor2	chr12	93978840	93979145	LINE/CR1	486	-	152	93978992	88368
chr12	93890624	94090624	harbor2	chr12	93979200	93979656	LINE/CR1	921	-	228	93979428	88804
chr12	78551846	78751846	harbor2	chr12	78568387	78568544	LINE/CR1	504	-	78	78568465	16619
chr12	77381298	77581298	harbor2	chr12	77440788	77440935	LINE/CR1	463	-	74	77440862	59564
chr12	26512012	26712012	harbor2	chr12	26554621	26554792	LINE/CR1	1243	-	86	26554707	42695
chr12	26512012	26712012	harbor2	chr12	26554900	26555563	LINE/CR1	1243	-	332	26555232	43220
chr12	26512012	26712012	harbor2	chr12	26574109	26574501	LINE/CR1	510	-	196	26574305	62293
chr12	108776157	108976157	harbor2	chr12	108806665	108807038	LINE/CR1	557	-	186	108806851	30694
chr12	121254299	121454299	harbor2	chr12	121333559	121333998	LINE/CR1	662	-	220	121333779	79480
chr12	121254299	121454299	harbor2	chr12	121334298	121334417	LINE/CR1	662	-	60	121334358	80059
chr13	95067801	95267801	harbor2	chr13	95118689	95119184	LINE/CR1	955	-	248	95118937	51136
chr13	58102484	58302484	harbor2	chr13	58170142	58170422	LINE/CR1	545	-	140	58170282	67798
chr13	106326599	106526599	harbor2	chr13	106412527	106413000	LINE/CR1	535	-	236	106412763	86164
chr13	53426796	53626796	harbor2	chr13	53489829	53490092	LINE/CR1	488	-	132	53489961	63165
chr13	73842251	74042251	harbor2	chr13	73909136	73909555	LINE/CR1	703	-	210	73909346	67095
chr14	98937710	99137710	harbor2	chr14	98937245	98937883	LINE/CR1	512	-	319	98937564	146
chr14	53498927	53698927	harbor2	chr14	53521965	53522329	LINE/CR1	554	-	182	53522147	23220
chr14	51413534	51613534	harbor2	chr14	51459216	51459552	LINE/CR1	672	-	168	51459384	45850
chr14	96926824	97126824	harbor2	chr14	96966576	96966795	LINE/CR1	487	-	110	96966686	39862
chr14	96926824	97126824	harbor2	chr14	96985400	96985773	LINE/CR1	817	-	186	96985586	58762
chr14	97477268	97677268	harbor2	chr14	97542080	97542510	LINE/CR1	781	-	215	97542295	65027
chr14	75697845	75897845	harbor2	chr14	75739951	75740571	LINE/CR1	865	-	310	75740261	42416
chr14	65125635	65325635	harbor2	chr14	65220583	65220774	LINE/CR1	444	-	96	65220679	95044
chr14	39445548	39645548	harbor2	chr14	39506143	39506409	LINE/CR1	588	-	133	39506276	60728
chr14	88008196	88208196	harbor2	chr14	88080991	88081364	LINE/CR1	824	-	186	88081177	72981
chr14	96131970	96331970	harbor2	chr14	96207936	96208050	LINE/CR1	451	-	57	96207993	76023
chr14	89180055	89380055	harbor2	chr14	89208035	89208189	LINE/CR1	460	-	77	89208112	28057
chr14	104309027	104509027	harbor2	chr14	104378650	104378850	LINE/CR1	491	-	100	104378750	69723
chr14	61605186	61805186	harbor2	chr14	61644314	61644506	LINE/CR1	435	-	96	61644410	39224
chr14	27997397	28197397	harbor2	chr14	28052306	28052477	LINE/CR1	433	-	86	28052392	54995
chr14	93352361	93552361	harbor2	chr14	93437495	93437539	LINE/CR1	667	-	22	93437517	85156
chr14	93352361	93552361	harbor2	chr14	93437993	93438305	LINE/CR1	667	-	156	93438149	85788
chr14	84529393	84729393	harbor2	chr14	84571854	84572114	LINE/CR1	632	-	130	84571984	42591
chr14	74075768	74275768	harbor2	chr14	74160677	74161006	LINE/CR1	452	-	164	74160841	85073
chr14	94861120	95061120	harbor2	chr14	94872018	94872439	LINE/CR1	627	-	210	94872228	11108
chr14	94861120	95061120	harbor2	chr14	94872742	94872987	LINE/CR1	627	-	122	94872864	11744
chr14	66211764	66411764	harbor2	chr14	66264289	66264555	LINE/CR1	476	-	133	66264422	52658
chr14	87842251	88042251	harbor2	chr14	87848782	87849367	LINE/CR1	935	-	292	87849074	6823
chr14	58040784	58240784	harbor2	chr14	58077820	58078371	LINE/CR1	544	-	276	58078096	37312
chr14	76368307	76568307	harbor2	chr14	76374744	76375006	LINE/CR1	471	-	131	76374875	6568
chr14	33233205	33433205	harbor2	chr14	33240859	33240990	LINE/CR1	445	-	66	33240925	7720
chr15	53028079	53228079	harbor2	chr15	53100912	53101559	LINE/CR1	681	-	324	53101236	73157
chr15	53028079	53228079	harbor2	chr15	53124655	53124940	LINE/CR1	720	-	142	53124797	96718
chr15	99311315	99511315	harbor2	chr15	99314105	99314162	LINE/CR1	498	-	28	99314133	2818
chr15	99311315	99511315	harbor2	chr15	99314473	99314755	LINE/CR1	498	-	141	99314614	3299
chr15	100417101	100617101	harbor2	chr15	100429402	100429746	LINE/CR1	456	-	172	100429574	12473
chr15	91466573	91666573	harbor2	chr15	91549939	91550291	LINE/CR1	446	-	176	91550115	83542
chr15	43486840	43686840	harbor2	chr15	43510183	43510408	LINE/CR1	458	-	112	43510295	23455
chr15	49430110	49630110	harbor2	chr15	49448783	49448957	LINE/CR1	549	-	87	49448870	18760
chr15	49430110	49630110	harbor2	chr15	49449341	49449791	LINE/CR1	1007	-	225	49449566	19456
chr15	91724690	91924690	harbor2	chr15	91774734	91774868	LINE/CR1	524	-	67	91774801	50111
chr15	91724690	91924690	harbor2	chr15	91775325	91775536	LINE/CR1	524	-	106	91775431	50741
chr15	46402636	46602636	harbor2	chr15	46438098	46438402	LINE/CR1	523	-	152	46438250	35614
chr15	90341848	90541848	harbor2	chr15	90354111	90354344	LINE/CR1	423	-	116	90354227	12379
chr15	79788996	79988996	harbor2	chr15	79884793	79885152	LINE/CR1	470	-	180	79884973	95977
chr15	83873308	84073308	harbor2	chr15	83900649	83901010	LINE/CR1	691	-	180	83900829	27521
chr15	89623825	89823825	harbor2	chr15	89674545	89674877	LINE/CR1	638	-	166	89674711	50886
chr15	89623825	89823825	harbor2	chr15	89675137	89675238	LINE/CR1	638	-	50	89675187	51362
chr15	74000853	74200853	harbor2	chr15	74025556	74025798	LINE/CR1	620	-	121	74025677	24824
chr15	99993813	100193813	harbor2	chr15	100028091	100028515	LINE/CR1	445	-	212	100028303	34490
chr15	34302930	34502930	harbor2	chr15	34399798	34400157	LINE/CR1	752	-	180	34399978	97048
chr15	53117023	53317023	harbor2	chr15	53124655	53124940	LINE/CR1	720	-	142	53124797	7774
chr15	96913477	97113477	harbor2	chr15	96955593	96956056	LINE/CR1	478	-	232	96955825	42348
chr15	33092032	33292032	harbor2	chr15	33142025	33142459	LINE/CR1	577	-	217	33142242	50210
chr15	33092032	33292032	harbor2	chr15	33185981	33186468	LINE/CR1	716	-	244	33186225	94193
chr15	33092032	33292032	harbor2	chr15	33186572	33186678	LINE/CR1	406	-	53	33186625	94593
chr15	33092032	33292032	harbor2	chr15	33187903	33188052	LINE/CR1	438	-	74	33187977	95945
chr15	33092032	33292032	harbor2	chr15	33188349	33188608	LINE/CR1	438	-	130	33188479	96447
chr15	100141767	100341767	harbor2	chr15	100185441	100185964	LINE/CR1	565	-	262	100185703	43936
chr15	100141767	100341767	harbor2	chr15	100186489	100187120	LINE/CR1	902	-	316	100186805	45038
chr15	46828330	47028330	harbor2	chr15	46905279	46905591	LINE/CR1	426	-	156	46905435	77105
chr15	44130173	44330173	harbor2	chr15	44141620	44142444	LINE/CR1	1061	-	412	44142032	11859
chr15	71015917	71215917	harbor2	chr15	71038570	71038841	LINE/CR1	563	-	136	71038706	22789
chr15	91506756	91706756	harbor2	chr15	91549939	91550291	LINE/CR1	446	-	176	91550115	43359
chr15	91847856	92047856	harbor2	chr15	91920632	91920852	LINE/CR1	416	-	110	91920742	72886
chr15	89282749	89482749	harbor2	chr15	89310400	89310842	LINE/CR1	682	-	221	89310621	27872
chr15	89282749	89482749	harbor2	chr15	89311426	89312080	LINE/CR1	682	-	327	89311753	29004
chr15	89282749	89482749	harbor2	chr15	89308989	89309343	LINE/CR1	821	-	177	89309166	26417
chr15	100133680	100333680	harbor2	chr15	100185441	100185964	LINE/CR1	565	-	262	100185703	52023
chr15	100133680	100333680	harbor2	chr15	100186489	100187120	LINE/CR1	902	-	316	100186805	53125
chr15	89165022	89365022	harbor2	chr15	89181512	89181762	LINE/CR1	537	-	125	89181637	16615
chr15	89165022	89365022	harbor2	chr15	89182131	89182503	LINE/CR1	430	-	186	89182317	17295
chr15	89165022	89365022	harbor2	chr15	89182816	89182897	LINE/CR1	430	-	40	89182856	17834
chr15	89165022	89365022	harbor2	chr15	89191289	89191619	LINE/CR1	1139	-	165	89191454	26432
chr15	89165022	89365022	harbor2	chr15	89191926	89192320	LINE/CR1	1139	-	197	89192123	27101
chr15	92008538	92208538	harbor2	chr15	92052439	92052681	LINE/CR1	660	-	121	92052560	44022
chr15	92008538	92208538	harbor2	chr15	92052990	92053083	LINE/CR1	660	-	46	92053036	44498
chr15	92008538	92208538	harbor2	chr15	92055743	92056409	LINE/CR1	785	-	333	92056076	47538
chr15	92008538	92208538	harbor2	chr15	92074983	92076101	LINE/CR1	730	-	559	92075542	67004
chr15	87433606	87633606	harbor2	chr15	87440989	87441239	LINE/CR1	587	-	125	87441114	7508
chr16	67253672	67453672	harbor2	chr16	67260814	67261338	LINE/CR1	532	-	262	67261076	7404
chr16	55133832	55333832	harbor2	chr16	55148301	55148482	LINE/CR1	449	-	90	55148391	14559
chr16	55829308	56029308	harbor2	chr16	55829809	55830149	LINE/CR1	547	-	170	55829979	671
chr16	55829308	56029308	harbor2	chr16	55833549	55833714	LINE/CR1	471	-	82	55833631	4323
chr16	55829308	56029308	harbor2	chr16	55860867	55861265	LINE/CR1	735	-	199	55861066	31758
chr16	52305392	52505392	harbor2	chr16	52399730	52399941	LINE/CR1	492	-	106	52399836	94444
chr16	52869549	53069549	harbor2	chr16	52871305	52871646	LINE/CR1	700	-	170	52871475	1926
chr16	65614012	65814012	harbor2	chr16	65669900	65670024	LINE/CR1	433	-	62	65669962	55950
chr16	65614012	65814012	harbor2	chr16	65670463	65670627	LINE/CR1	433	-	82	65670545	56533
chr16	65594336	65794336	harbor2	chr16	65669900	65670024	LINE/CR1	433	-	62	65669962	75626
chr16	65594336	65794336	harbor2	chr16	65670463	65670627	LINE/CR1	433	-	82	65670545	76209
chr16	82125554	82325554	harbor2	chr16	82190878	82191564	LINE/CR1	661	-	343	82191221	65667
chr16	82125554	82325554	harbor2	chr16	82192883	82193450	LINE/CR1	1675	-	284	82193167	67613
chr16	64645605	64845605	harbor2	chr16	64698106	64698407	LINE/CR1	425	-	150	64698256	52651
chr16	73133967	73333967	harbor2	chr16	73178018	73178151	LINE/CR1	525	-	66	73178084	44117
chr16	73133967	73333967	harbor2	chr16	73178439	73178647	LINE/CR1	525	-	104	73178543	44576
chr16	73133967	73333967	harbor2	chr16	73179010	73179317	LINE/CR1	469	-	154	73179164	45197
chr16	82951413	83151413	harbor2	chr16	82972789	82973406	LINE/CR1	587	-	308	82973097	21684
chr16	10565624	10765624	harbor2	chr16	10609680	10609766	LINE/CR1	511	-	43	10609723	44099
chr16	10565624	10765624	harbor2	chr16	10610386	10610516	LINE/CR1	511	-	65	10610451	44827
chr16	10565624	10765624	harbor2	chr16	10610833	10610945	LINE/CR1	511	-	56	10610889	45265
chr16	77373932	77573932	harbor2	chr16	77459993	77460239	LINE/CR1	461	-	123	77460116	86184
chr16	81021343	81221343	harbor2	chr16	81074233	81074383	LINE/CR1	1095	-	75	81074308	52965
chr16	81021343	81221343	harbor2	chr16	81074683	81075176	LINE/CR1	1095	-	246	81074929	53586
chr16	72258615	72458615	harbor2	chr16	72275239	72275625	LINE/CR1	1024	-	193	72275432	16817
chr16	53009274	53209274	harbor2	chr16	53064149	53064314	LINE/CR1	414	-	82	53064231	54957
chr16	86782651	86982651	harbor2	chr16	86815625	86815872	LINE/CR1	425	-	124	86815749	33098
chr17	8644596	8844596	harbor2	chr17	8728931	8729076	LINE/CR1	595	-	72	8729003	84407
chr17	46315256	46515256	harbor2	chr17	46376707	46377036	LINE/CR1	648	-	164	46376871	61615
chr17	68059653	68259653	harbor2	chr17	68089375	68089589	LINE/CR1	520	-	107	68089482	29829
chr17	68059653	68259653	harbor2	chr17	68089884	68090289	LINE/CR1	550	-	202	68090086	30433
chr17	77555298	77755298	harbor2	chr17	77618642	77619451	LINE/CR1	736	-	404	77619046	63748
chr17	77555298	77755298	harbor2	chr17	77619839	77620312	LINE/CR1	538	-	236	77620075	64777
chr17	73010629	73210629	harbor2	chr17	73032520	73032744	LINE/CR1	664	-	112	73032632	22003
chr17	72084347	72284347	harbor2	chr17	72130006	72130612	LINE/CR1	736	-	303	72130309	45962
chr17	72084347	72284347	harbor2	chr17	72148069	72148525	LINE/CR1	727	-	228	72148297	63950
chr17	57612072	57812072	harbor2	chr17	57699340	57699690	LINE/CR1	752	-	175	57699515	87443
chr17	71599467	71799467	harbor2	chr17	71660877	71661406	LINE/CR1	807	-	264	71661141	61674
chr17	29921009	30121009	harbor2	chr17	29928369	29928602	LINE/CR1	738	-	116	29928485	7476
chr17	43031693	43231693	harbor2	chr17	43065735	43066213	LINE/CR1	656	-	239	43065974	34281
chr17	79157998	79357998	harbor2	chr17	79224135	79225089	LINE/CR1	833	-	477	79224612	66614
chr17	63502090	63702090	harbor2	chr17	63515405	63515603	LINE/CR1	607	-	99	63515504	13414
chr17	72349274	72549274	harbor2	chr17	72366074	72366653	LINE/CR1	1458	-	290	72366364	17090
chr17	79526805	79726805	harbor2	chr17	79565897	79566241	LINE/CR1	742	-	172	79566069	39264
chr17	73002059	73202059	harbor2	chr17	73032520	73032744	LINE/CR1	664	-	112	73032632	30573
chr17	72272874	72472874	harbor2	chr17	72366074	72366653	LINE/CR1	1458	-	290	72366364	93490
chr17	79125860	79325860	harbor2	chr17	79224135	79225089	LINE/CR1	833	-	477	79224612	98752
chr17	79511783	79711783	harbor2	chr17	79565897	79566241	LINE/CR1	742	-	172	79566069	54286
chr18	43102168	43302168	harbor2	chr18	43129080	43129431	LINE/CR1	462	-	176	43129256	27088
chr18	42176356	42376356	harbor2	chr18	42201103	42201425	LINE/CR1	548	-	161	42201264	24908
chr18	77142677	77342677	harbor2	chr18	77193098	77193803	LINE/CR1	734	-	352	77193450	50773
chr18	22243581	22443581	harbor2	chr18	22293436	22293778	LINE/CR1	1105	-	171	22293607	50026
chr18	60743468	60943468	harbor2	chr18	60765843	60766281	LINE/CR1	496	-	219	60766062	22594
chr18	48914970	49114970	harbor2	chr18	48967709	48967847	LINE/CR1	592	-	69	48967778	52808
chr18	48914970	49114970	harbor2	chr18	48968136	48968372	LINE/CR1	592	-	118	48968254	53284
chr18	75337098	75537098	harbor2	chr18	75368841	75369090	LINE/CR1	528	-	124	75368965	31867
chr18	75337098	75537098	harbor2	chr18	75384049	75384201	LINE/CR1	440	-	76	75384125	47027
chr18	75337098	75537098	harbor2	chr18	75418557	75418852	LINE/CR1	482	-	148	75418705	81607
chr18	50654411	50854411	harbor2	chr18	50675225	50675316	LINE/CR1	1386	-	46	50675271	20860
chr18	50654411	50854411	harbor2	chr18	50675910	50676511	LINE/CR1	1386	-	300	50676210	21799
chr18	50654411	50854411	harbor2	chr18	50708990	50709188	LINE/CR1	418	-	99	50709089	54678
chr19	39292175	39492175	harbor2	chr19	39352953	39353130	LINE/CR1	653	-	88	39353041	60866
chr19	32013552	32213552	harbor2	chr19	32081103	32081626	LINE/CR1	675	-	262	32081365	67813
chr20	42203949	42403949	harbor2	chr20	42283843	42284767	LINE/CR1	490	-	462	42284305	80356
chr20	42203949	42403949	harbor2	chr20	42289722	42290344	LINE/CR1	637	-	311	42290033	86084
chr20	46208767	46408767	harbor2	chr20	46298097	46298316	LINE/CR1	382	-	110	46298207	89440
chr20	41219780	41419780	harbor2	chr20	41221033	41221216	LINE/CR1	495	-	92	41221125	1345
chr20	36011486	36211486	harbor2	chr20	36088026	36088161	LINE/CR1	556	-	68	36088094	76608
chr20	36011486	36211486	harbor2	chr20	36088972	36089207	LINE/CR1	846	-	118	36089090	77604
chr20	36011486	36211486	harbor2	chr20	36089827	36090099	LINE/CR1	846	-	136	36089963	78477
chr20	36011486	36211486	harbor2	chr20	36090301	36090560	LINE/CR1	846	-	130	36090431	78945
chr20	44607412	44807412	harbor2	chr20	44666066	44666449	LINE/CR1	481	-	192	44666258	58846
chr20	36065730	36265730	harbor2	chr20	36088026	36088161	LINE/CR1	556	-	68	36088094	22364
chr20	36065730	36265730	harbor2	chr20	36088972	36089207	LINE/CR1	846	-	118	36089090	23360
chr20	36065730	36265730	harbor2	chr20	36089827	36090099	LINE/CR1	846	-	136	36089963	24233
chr20	36065730	36265730	harbor2	chr20	36090301	36090560	LINE/CR1	846	-	130	36090431	24701
chr20	36065730	36265730	harbor2	chr20	36115309	36115448	LINE/CR1	396	-	70	36115379	49649
chr20	46261424	46461424	harbor2	chr20	46298097	46298316	LINE/CR1	382	-	110	46298207	36783
chr21	32591316	32791316	harbor2	chr21	32655005	32655368	LINE/CR1	905	-	182	32655187	63871
chr21	38926642	39126642	harbor2	chr21	38927004	38927148	LINE/CR1	571	-	72	38927076	434
chr21	38926642	39126642	harbor2	chr21	38927639	38927987	LINE/CR1	571	-	174	38927813	1171
chr21	20865091	21065091	harbor2	chr21	20873937	20874103	LINE/CR1	459	-	83	20874020	8929
chr21	32560557	32760557	harbor2	chr21	32655005	32655368	LINE/CR1	905	-	182	32655187	94630
chr22	34816010	35016010	harbor2	chr22	34866653	34866990	LINE/CR1	751	-	168	34866821	50811
chr22	35393936	35593936	harbor2	chr22	35410949	35411100	LINE/CR1	517	-	76	35411025	17089
chr22	35393936	35593936	harbor2	chr22	35471373	35471606	LINE/CR1	515	-	116	35471489	77553
chrX	130532246	130732246	harbor2	chrX	130617602	130617796	LINE/CR1	721	-	97	130617699	85453
chrX	70224219	70424219	harbor2	chrX	70291652	70291959	LINE/CR1	680	-	154	70291806	67587
chrX	70224219	70424219	harbor2	chrX	70303037	70303675	LINE/CR1	1358	-	319	70303356	79137
chrX	142711940	142911940	harbor2	chrX	142800830	142801011	LINE/CR1	644	-	90	142800920	88980
chrX	136968343	137168343	harbor2	chrX	137043843	137044199	LINE/CR1	1151	-	178	137044021	75678
chrX	136968343	137168343	harbor2	chrX	137044685	137045139	LINE/CR1	581	-	227	137044912	76569
