H_chr	H_start	H_end	Harbor	TE_chr	TE_start	TE_end	TE	score	TE_strand	TE_half	TE_middle_pos	TE_dis
chr1	193326713	193526713	harbor1	chr1	193395298	193395546	LTR/ERV1	1789	+	124	193395422	68709
chr1	193326713	193526713	harbor1	chr1	193396276	193396570	LTR/ERV1	1789	+	147	193396423	69710
chr1	2751372	2951372	harbor1	chr1	2813099	2814487	LTR/ERV1	8424	+	694	2813793	62421
chr1	61689580	61889580	harbor1	chr1	61735814	61736021	LTR/ERV1	3112	+	104	61735918	46338
chr1	61689580	61889580	harbor1	chr1	61736323	61736602	LTR/ERV1	3112	+	140	61736463	46883
chr1	61689580	61889580	harbor1	chr1	61736949	61736978	LTR/ERV1	3112	+	14	61736963	47383
chr1	61689580	61889580	harbor1	chr1	61737266	61737328	LTR/ERV1	461	+	31	61737297	47717
chr1	102982162	103182162	harbor1	chr1	102987772	102988505	LTR/ERV1	3033	+	366	102988138	5976
chr1	236259460	236459460	harbor1	chr1	236287391	236287766	LTR/ERV1	2200	+	188	236287579	28119
chr1	236259460	236459460	harbor1	chr1	236287936	236288537	LTR/ERV1	3588	+	300	236288236	28776
chr1	236259460	236459460	harbor1	chr1	236301050	236301882	LTR/ERV1	5002	+	416	236301466	42006
chr1	236259460	236459460	harbor1	chr1	236314210	236314760	LTR/ERV1	4408	+	275	236314485	55025
chr1	236259460	236459460	harbor1	chr1	236315613	236316352	LTR/ERV1	3904	+	370	236315983	56523
chr1	236259460	236459460	harbor1	chr1	236332396	236332490	LTR/ERV1	532	+	47	236332443	72983
chr1	236259460	236459460	harbor1	chr1	236332813	236332895	LTR/ERV1	532	+	41	236332854	73394
chr1	236259460	236459460	harbor1	chr1	236350707	236350997	LTR/ERV1	1695	+	145	236350852	91392
chr1	236259460	236459460	harbor1	chr1	236351152	236351297	LTR/ERV1	806	+	72	236351224	91764
chr1	236259460	236459460	harbor1	chr1	236354441	236355103	LTR/ERV1	3733	+	331	236354772	95312
chr1	236259460	236459460	harbor1	chr1	236357413	236357457	LTR/ERV1	1405	+	22	236357435	97975
chr1	236259460	236459460	harbor1	chr1	236357844	236357864	LTR/ERV1	1405	+	10	236357854	98394
chr1	236259460	236459460	harbor1	chr1	236358171	236358380	LTR/ERV1	1405	+	104	236358275	98815
chr1	247505213	247705213	harbor1	chr1	247533250	247533882	LTR/ERV1	3835	+	316	247533566	28353
chr1	247505213	247705213	harbor1	chr1	247574664	247575328	LTR/ERV1	2238	+	332	247574996	69783
chr1	145761999	145961999	harbor1	chr1	145796890	145797382	LTR/ERV1	3414	+	246	145797136	35137
chr1	206125916	206325916	harbor1	chr1	206140830	206141551	LTR/ERV1	4007	+	360	206141190	15274
chr1	74353744	74553744	harbor1	chr1	74375214	74375912	LTR/ERV1	2991	+	349	74375563	21819
chr1	74353744	74553744	harbor1	chr1	74394411	74394762	LTR/ERV1	4264	+	176	74394587	40843
chr1	74353744	74553744	harbor1	chr1	74395065	74395315	LTR/ERV1	4264	+	125	74395190	41446
chr1	74353744	74553744	harbor1	chr1	74395318	74396999	LTR/ERV1	7231	+	840	74396158	42414
chr1	74353744	74553744	harbor1	chr1	74397383	74398876	LTR/ERV1	17977	+	746	74398129	44385
chr1	74353744	74553744	harbor1	chr1	74399180	74400944	LTR/ERV1	17977	+	882	74400062	46318
chr1	240850481	241050481	harbor1	chr1	240892533	240892901	LTR/ERV1	2119	+	184	240892717	42236
chr1	240850481	241050481	harbor1	chr1	240936794	240937368	LTR/ERV1	3726	+	287	240937081	86600
chr1	240850481	241050481	harbor1	chr1	240939566	240939788	LTR/ERV1	3095	+	111	240939677	89196
chr1	240850481	241050481	harbor1	chr1	240940086	240940436	LTR/ERV1	3095	+	175	240940261	89780
chr1	230369077	230569077	harbor1	chr1	230453600	230453955	LTR/ERV1	2744	+	178	230453778	84701
chr1	230369077	230569077	harbor1	chr1	230454258	230454619	LTR/ERV1	2744	+	180	230454438	85361
chr1	230369077	230569077	harbor1	chr1	230456165	230456604	LTR/ERV1	2080	+	220	230456385	87308
chr1	230369077	230569077	harbor1	chr1	230458619	230459094	LTR/ERV1	1553	+	238	230458857	89780
chr1	201026708	201226708	harbor1	chr1	201104051	201104160	LTR/ERV1	1308	+	54	201104105	77397
chr1	201026708	201226708	harbor1	chr1	201104380	201104698	LTR/ERV1	1308	+	159	201104539	77831
chr1	4794226	4994226	harbor1	chr1	4820138	4820702	LTR/ERV1	1468	+	282	4820420	26194
chr1	4794226	4994226	harbor1	chr1	4821767	4822482	LTR/ERV1	4280	+	358	4822125	27899
chr1	4794226	4994226	harbor1	chr1	4822687	4823119	LTR/ERV1	2466	+	216	4822903	28677
chr1	4794226	4994226	harbor1	chr1	4825399	4825932	LTR/ERV1	2552	+	266	4825665	31439
chr1	4794226	4994226	harbor1	chr1	4826762	4827349	LTR/ERV1	4684	+	294	4827056	32830
chr1	4794226	4994226	harbor1	chr1	4816393	4817073	LTR/ERV1	5360	+	340	4816733	22507
chr1	21703949	21903949	harbor1	chr1	21789463	21789492	LTR/ERV1	3134	+	14	21789477	85528
chr1	21703949	21903949	harbor1	chr1	21789793	21790371	LTR/ERV1	3134	+	289	21790082	86133
chr1	220592982	220792982	harbor1	chr1	220686728	220687075	LTR/ERV1	534	+	174	220686902	93920
chr1	67038643	67238643	harbor1	chr1	67086023	67086362	LTR/ERV1	729	+	170	67086193	47550
chr1	67038643	67238643	harbor1	chr1	67087139	67087923	LTR/ERV1	5364	+	392	67087531	48888
chr1	67038643	67238643	harbor1	chr1	67118349	67118581	LTR/ERV1	513	+	116	67118465	79822
chr1	67038643	67238643	harbor1	chr1	67129579	67130010	LTR/ERV1	1862	+	216	67129795	91152
chr1	152106119	152306119	harbor1	chr1	152182078	152182143	LTR/ERV1	411	+	32	152182110	75991
chr1	152106119	152306119	harbor1	chr1	152187701	152188100	LTR/ERV1	2392	+	200	152187901	81782
chr1	179157233	179357233	harbor1	chr1	179209041	179209558	LTR/ERV1	1426	+	258	179209299	52066
chr1	72566007	72766007	harbor1	chr1	72607018	72607940	LTR/ERV1	4835	+	461	72607479	41472
chr1	72566007	72766007	harbor1	chr1	72634744	72635202	LTR/ERV1	1893	+	229	72634973	68966
chr1	72566007	72766007	harbor1	chr1	72648228	72649868	LTR/ERV1	7238	+	820	72649048	83041
chr1	233496035	233696035	harbor1	chr1	233514888	233515207	LTR/ERV1	884	+	160	233515048	19013
chr1	233496035	233696035	harbor1	chr1	233515600	233517097	LTR/ERV1	6880	+	748	233516348	20313
chr1	233496035	233696035	harbor1	chr1	233530294	233530828	LTR/ERV1	2270	+	267	233530561	34526
chr1	233496035	233696035	harbor1	chr1	233542917	233543521	LTR/ERV1	3667	+	302	233543219	47184
chr1	233496035	233696035	harbor1	chr1	233546754	233547215	LTR/ERV1	2396	+	230	233546984	50949
chr1	233496035	233696035	harbor1	chr1	233550074	233550662	LTR/ERV1	4246	+	294	233550368	54333
chr1	233496035	233696035	harbor1	chr1	233583830	233584639	LTR/ERV1	4197	+	404	233584234	88199
chr1	103645883	103845883	harbor1	chr1	103683642	103683808	LTR/ERV1	1025	+	83	103683725	37842
chr1	103645883	103845883	harbor1	chr1	103683814	103684878	LTR/ERV1	3540	+	532	103684346	38463
chr1	103645883	103845883	harbor1	chr1	103684931	103685557	LTR/ERV1	3140	+	313	103685244	39361
chr1	103645883	103845883	harbor1	chr1	103685561	103687337	LTR/ERV1	5679	+	888	103686449	40566
chr1	103645883	103845883	harbor1	chr1	103696445	103696893	LTR/ERV1	3024	+	224	103696669	50786
chr1	103645883	103845883	harbor1	chr1	103696894	103697243	LTR/ERV1	2034	+	174	103697068	51185
chr1	103645883	103845883	harbor1	chr1	103697240	103699917	LTR/ERV1	12200	+	1338	103698578	52695
chr1	103645883	103845883	harbor1	chr1	103699928	103703454	LTR/ERV1	18865	+	1763	103701691	55808
chr1	103645883	103845883	harbor1	chr1	103703437	103703816	LTR/ERV1	1979	+	190	103703627	57744
chr1	103645883	103845883	harbor1	chr1	103703817	103704285	LTR/ERV1	3220	+	234	103704051	58168
chr1	29790768	29990768	harbor1	chr1	29840950	29841669	LTR/ERV1	4365	+	360	29841310	50542
chr1	29790768	29990768	harbor1	chr1	29862542	29862834	LTR/ERV1	946	+	146	29862688	71920
chr1	29790768	29990768	harbor1	chr1	29868642	29869196	LTR/ERV1	3324	+	277	29868919	78151
chr1	29790768	29990768	harbor1	chr1	29875536	29876081	LTR/ERV1	3205	+	272	29875808	85040
chr1	29790768	29990768	harbor1	chr1	29876498	29877261	LTR/ERV1	2474	+	382	29876880	86112
chr1	29790768	29990768	harbor1	chr1	29880535	29880635	LTR/ERV1	644	+	50	29880585	89817
chr1	29790768	29990768	harbor1	chr1	29880633	29880898	LTR/ERV1	1427	+	132	29880765	89997
chr1	29790768	29990768	harbor1	chr1	29881208	29881391	LTR/ERV1	1427	+	92	29881300	90532
chr1	29790768	29990768	harbor1	chr1	29883499	29883971	LTR/ERV1	2712	+	236	29883735	92967
chr1	29790768	29990768	harbor1	chr1	29885048	29885247	LTR/ERV1	698	+	100	29885148	94380
chr1	29790768	29990768	harbor1	chr1	29885341	29886710	LTR/ERV1	7335	+	684	29886025	95257
chr1	29790768	29990768	harbor1	chr1	29886708	29886940	LTR/ERV1	1683	+	116	29886824	96056
chr1	29790768	29990768	harbor1	chr1	29886940	29887180	LTR/ERV1	1205	+	120	29887060	96292
chr1	29790768	29990768	harbor1	chr1	29887232	29887477	LTR/ERV1	8722	+	122	29887354	96586
chr1	29790768	29990768	harbor1	chr1	29888053	29888843	LTR/ERV1	12237	+	395	29888448	97680
chr1	29790768	29990768	harbor1	chr1	29888891	29889857	LTR/ERV1	12237	+	483	29889374	98606
chr1	29790768	29990768	harbor1	chr1	29889871	29890340	LTR/ERV1	2403	+	234	29890105	99337
chr1	29790768	29990768	harbor1	chr1	29883986	29884910	LTR/ERV1	3121	+	462	29884448	93680
chr1	82675227	82875227	harbor1	chr1	82716134	82716724	LTR/ERV1	2042	+	295	82716429	41202
chr1	82675227	82875227	harbor1	chr1	82740382	82740922	LTR/ERV1	2053	+	270	82740652	65425
chr1	5150589	5350589	harbor1	chr1	5232913	5233331	LTR/ERV1	2096	+	209	5233122	82533
chr1	5150589	5350589	harbor1	chr1	5233686	5233892	LTR/ERV1	2096	+	103	5233789	83200
chr1	25316005	25516005	harbor1	chr1	25368182	25368744	LTR/ERV1	4522	+	281	25368463	52458
chr1	17254467	17454467	harbor1	chr1	17309089	17309584	LTR/ERV1	2874	+	248	17309337	54870
chr1	181849301	182049301	harbor1	chr1	181899225	181899758	LTR/ERV1	2508	+	266	181899491	50190
chr1	181849301	182049301	harbor1	chr1	181899759	181900348	LTR/ERV1	3820	+	294	181900053	50752
chr1	181849301	182049301	harbor1	chr1	181900349	181900386	LTR/ERV1	2508	+	18	181900367	51066
chr1	181849301	182049301	harbor1	chr1	181902006	181902302	LTR/ERV1	1477	+	148	181902154	52853
chr1	181849301	182049301	harbor1	chr1	181902583	181902834	LTR/ERV1	506	+	126	181902709	53408
chr1	181849301	182049301	harbor1	chr1	181926694	181927413	LTR/ERV1	1849	+	360	181927054	77753
chr1	233174045	233374045	harbor1	chr1	233179726	233180180	LTR/ERV1	2049	+	227	233179953	5908
chr1	233174045	233374045	harbor1	chr1	233254975	233255526	LTR/ERV1	2668	+	276	233255251	81206
chr1	233174045	233374045	harbor1	chr1	233177044	233177630	LTR/ERV1	4851	+	293	233177337	3292
chr1	177311812	177511812	harbor1	chr1	177319379	177320088	LTR/ERV1	5345	+	354	177319733	7921
chr1	177311812	177511812	harbor1	chr1	177324898	177325446	LTR/ERV1	26603	+	274	177325172	13360
chr1	177311812	177511812	harbor1	chr1	177325453	177326257	LTR/ERV1	5886	+	402	177325855	14043
chr1	177311812	177511812	harbor1	chr1	177320093	177324741	LTR/ERV1	26603	+	2324	177322417	10605
chr1	116667850	116867850	harbor1	chr1	116743492	116743805	LTR/ERV1	1643	+	156	116743648	75798
chr1	116667850	116867850	harbor1	chr1	116743806	116746255	LTR/ERV1	11445	+	1224	116745030	77180
chr1	116667850	116867850	harbor1	chr1	116746249	116748149	LTR/ERV1	5562	+	950	116747199	79349
chr1	116667850	116867850	harbor1	chr1	116748310	116748594	LTR/ERV1	1741	+	142	116748452	80602
chr1	116667850	116867850	harbor1	chr1	116749155	116749180	LTR/ERV1	1536	+	12	116749167	81317
chr1	116667850	116867850	harbor1	chr1	116749649	116750200	LTR/ERV1	1536	+	276	116749925	82075
chr1	116667850	116867850	harbor1	chr1	116751531	116751979	LTR/ERV1	2785	+	224	116751755	83905
chr1	106457917	106657917	harbor1	chr1	106526256	106527125	LTR/ERV1	2814	+	434	106526690	68773
chr1	72008290	72208290	harbor1	chr1	72012248	72012547	LTR/ERV1	1443	+	150	72012398	4108
chr1	72008290	72208290	harbor1	chr1	72012526	72012760	LTR/ERV1	638	+	117	72012643	4353
chr1	72008290	72208290	harbor1	chr1	72034756	72035382	LTR/ERV1	3903	+	313	72035069	26779
chr1	72008290	72208290	harbor1	chr1	72068119	72068505	LTR/ERV1	2071	+	193	72068312	60022
chr1	72008290	72208290	harbor1	chr1	72097483	72098210	LTR/ERV1	1393	+	364	72097847	89557
chr1	72008290	72208290	harbor1	chr1	72098339	72098763	LTR/ERV1	1340	+	212	72098551	90261
chr1	175248650	175448650	harbor1	chr1	175269253	175269782	LTR/ERV1	2660	+	264	175269517	20867
chr1	175248650	175448650	harbor1	chr1	175269784	175270246	LTR/ERV1	2700	+	231	175270015	21365
chr1	175248650	175448650	harbor1	chr1	175270246	175275346	LTR/ERV1	52949	+	2550	175272796	24146
chr1	175248650	175448650	harbor1	chr1	175277284	175277820	LTR/ERV1	2512	+	268	175277552	28902
chr1	175248650	175448650	harbor1	chr1	175287406	175287788	LTR/ERV1	2018	+	191	175287597	38947
chr1	175248650	175448650	harbor1	chr1	175288743	175289089	LTR/ERV1	1784	+	173	175288916	40266
chr1	175248650	175448650	harbor1	chr1	175289147	175290049	LTR/ERV1	2025	+	451	175289598	40948
chr1	175248650	175448650	harbor1	chr1	175290042	175290176	LTR/ERV1	701	+	67	175290109	41459
chr1	175248650	175448650	harbor1	chr1	175293411	175293719	LTR/ERV1	1027	+	154	175293565	44915
chr1	175248650	175448650	harbor1	chr1	175294025	175294736	LTR/ERV1	2335	+	356	175294381	45731
chr1	175248650	175448650	harbor1	chr1	175294863	175295811	LTR/ERV1	5649	+	474	175295337	46687
chr1	175248650	175448650	harbor1	chr1	175296106	175296477	LTR/ERV1	5649	+	186	175296292	47642
chr1	175248650	175448650	harbor1	chr1	175296777	175297047	LTR/ERV1	2922	+	135	175296912	48262
chr1	175248650	175448650	harbor1	chr1	175297343	175297572	LTR/ERV1	1417	+	114	175297457	48807
chr1	175248650	175448650	harbor1	chr1	175297673	175298094	LTR/ERV1	1930	+	210	175297883	49233
chr1	175248650	175448650	harbor1	chr1	175298090	175298561	LTR/ERV1	2193	+	236	175298326	49676
chr1	175248650	175448650	harbor1	chr1	175298562	175299036	LTR/ERV1	2440	+	237	175298799	50149
chr1	175248650	175448650	harbor1	chr1	175334160	175334911	LTR/ERV1	5027	+	376	175334536	85886
chr1	175248650	175448650	harbor1	chr1	175275380	175277279	LTR/ERV1	52949	+	950	175276330	27680
chr1	207860445	208060445	harbor1	chr1	207935101	207935552	LTR/ERV1	2409	+	226	207935327	74882
chr1	65360987	65560987	harbor1	chr1	65442219	65442611	LTR/ERV1	2115	+	196	65442415	81428
chr1	65360987	65560987	harbor1	chr1	65443705	65443956	LTR/ERV1	1362	+	126	65443831	82844
chr1	65360987	65560987	harbor1	chr1	65444210	65444580	LTR/ERV1	1362	+	185	65444395	83408
chr1	220494210	220694210	harbor1	chr1	220545825	220546273	LTR/ERV1	1640	+	224	220546049	51839
chr1	229486705	229686705	harbor1	chr1	229513873	229514337	LTR/ERV1	1308	+	232	229514105	27400
chr1	60407136	60607136	harbor1	chr1	60430494	60431375	LTR/ERV1	4487	+	440	60430934	23798
chr1	60407136	60607136	harbor1	chr1	60436717	60437049	LTR/ERV1	1988	+	166	60436883	29747
chr1	60407136	60607136	harbor1	chr1	60440693	60440968	LTR/ERV1	2387	+	138	60440831	33695
chr1	60407136	60607136	harbor1	chr1	60441269	60441401	LTR/ERV1	2387	+	66	60441335	34199
chr1	55874565	56074565	harbor1	chr1	55912296	55913896	LTR/ERV1	8053	+	800	55913096	38531
chr1	55874565	56074565	harbor1	chr1	55926557	55927479	LTR/ERV1	3669	+	461	55927018	52453
chr1	192476602	192676602	harbor1	chr1	192479980	192480748	LTR/ERV1	4337	+	384	192480364	3762
chr1	192476602	192676602	harbor1	chr1	192543546	192543931	LTR/ERV1	1289	+	192	192543738	67136
chr1	239145859	239345859	harbor1	chr1	239177148	239177428	LTR/ERV1	3507	+	140	239177288	31429
chr1	239145859	239345859	harbor1	chr1	239177740	239178136	LTR/ERV1	3507	+	198	239177938	32079
chr1	239145859	239345859	harbor1	chr1	239188137	239188199	LTR/ERV1	727	+	31	239188168	42309
chr1	239145859	239345859	harbor1	chr1	239188523	239188748	LTR/ERV1	727	+	112	239188635	42776
chr1	239145859	239345859	harbor1	chr1	239199892	239200331	LTR/ERV1	3125	+	220	239200112	54253
chr1	239145859	239345859	harbor1	chr1	239222920	239223610	LTR/ERV1	2922	+	345	239223265	77406
chr1	239145859	239345859	harbor1	chr1	239232905	239233506	LTR/ERV1	4005	+	300	239233205	87346
chr1	239145859	239345859	harbor1	chr1	239238047	239238389	LTR/ERV1	1753	+	171	239238218	92359
chr1	235130086	235330086	harbor1	chr1	235130366	235130504	LTR/ERV1	2258	+	69	235130435	349
chr1	235130086	235330086	harbor1	chr1	235130802	235130929	LTR/ERV1	2258	+	64	235130866	780
chr1	235130086	235330086	harbor1	chr1	235140104	235141979	LTR/ERV1	10555	+	938	235141042	10956
chr1	35024738	35224738	harbor1	chr1	35053706	35053930	LTR/ERV1	1282	+	112	35053818	29080
chr1	35024738	35224738	harbor1	chr1	35053919	35054051	LTR/ERV1	713	+	66	35053985	29247
chr1	35024738	35224738	harbor1	chr1	35054054	35054128	LTR/ERV1	535	+	37	35054091	29353
chr1	35024738	35224738	harbor1	chr1	35058419	35058830	LTR/ERV1	2691	+	206	35058625	33887
chr1	35024738	35224738	harbor1	chr1	35058833	35059027	LTR/ERV1	1300	+	97	35058930	34192
chr1	35024738	35224738	harbor1	chr1	35075455	35076339	LTR/ERV1	7037	+	442	35075897	51159
chr1	35024738	35224738	harbor1	chr1	35077245	35077935	LTR/ERV1	4828	+	345	35077590	52852
chr1	235520757	235720757	harbor1	chr1	235567882	235568238	LTR/ERV1	2009	+	178	235568060	47303
chr1	235520757	235720757	harbor1	chr1	235591864	235592223	LTR/ERV1	4694	+	180	235592044	71287
chr1	235520757	235720757	harbor1	chr1	235592526	235592947	LTR/ERV1	4694	+	210	235592736	71979
chr1	228028121	228228121	harbor1	chr1	228110461	228110821	LTR/ERV1	1117	+	180	228110641	82520
chr1	228028121	228228121	harbor1	chr1	228123654	228123838	LTR/ERV1	491	+	92	228123746	95625
chr1	228028121	228228121	harbor1	chr1	228124092	228124767	LTR/ERV1	3906	+	338	228124430	96309
chr1	118267868	118467868	harbor1	chr1	118321527	118321783	LTR/ERV1	780	+	128	118321655	53787
chr1	66900725	67100725	harbor1	chr1	66911760	66911843	LTR/ERV1	2546	+	42	66911802	11077
chr1	66900725	67100725	harbor1	chr1	66912139	66912200	LTR/ERV1	2546	+	30	66912169	11444
chr1	66900725	67100725	harbor1	chr1	66912485	66912767	LTR/ERV1	2546	+	141	66912626	11901
chr1	66900725	67100725	harbor1	chr1	66912771	66913292	LTR/ERV1	2884	+	260	66913031	12306
chr1	66900725	67100725	harbor1	chr1	66913303	66913700	LTR/ERV1	3740	+	198	66913501	12776
chr1	66900725	67100725	harbor1	chr1	66914003	66914244	LTR/ERV1	3740	+	120	66914123	13398
chr1	66900725	67100725	harbor1	chr1	66914271	66914476	LTR/ERV1	1259	+	102	66914373	13648
chr1	66900725	67100725	harbor1	chr1	66914496	66915200	LTR/ERV1	4265	+	352	66914848	14123
chr1	66900725	67100725	harbor1	chr1	66915444	66915840	LTR/ERV1	2425	+	198	66915642	14917
chr1	66900725	67100725	harbor1	chr1	66916103	66918817	LTR/ERV1	15335	+	1357	66917460	16735
chr1	66900725	67100725	harbor1	chr1	66918819	66919266	LTR/ERV1	3059	+	224	66919043	18318
chr1	66900725	67100725	harbor1	chr1	66919943	66920726	LTR/ERV1	4419	+	392	66920335	19610
chr1	108672567	108872567	harbor1	chr1	108676721	108676812	LTR/ERV1	854	+	46	108676767	4200
chr1	108672567	108872567	harbor1	chr1	108681697	108682183	LTR/ERV1	3740	+	243	108681940	9373
chr1	234606365	234806365	harbor1	chr1	234659951	234660648	LTR/ERV1	4033	+	348	234660299	53934
chr1	75516586	75716586	harbor1	chr1	75533429	75533820	LTR/ERV1	1771	+	196	75533625	17039
chr1	70731232	70931232	harbor1	chr1	70755025	70755468	LTR/ERV1	2922	+	222	70755247	24015
chr1	70731232	70931232	harbor1	chr1	70765433	70765659	LTR/ERV1	1372	+	113	70765546	34314
chr1	70731232	70931232	harbor1	chr1	70765656	70767711	LTR/ERV1	4164	+	1028	70766684	35452
chr1	70731232	70931232	harbor1	chr1	70775269	70775421	LTR/ERV1	894	+	76	70775345	44113
chr1	70731232	70931232	harbor1	chr1	70775423	70775530	LTR/ERV1	494	+	54	70775477	44245
chr1	70731232	70931232	harbor1	chr1	70775627	70775668	LTR/ERV1	1191	+	20	70775647	44415
chr1	70731232	70931232	harbor1	chr1	70775966	70776149	LTR/ERV1	1191	+	92	70776058	44826
chr1	70731232	70931232	harbor1	chr1	70776228	70776581	LTR/ERV1	2183	+	176	70776404	45172
chr1	70731232	70931232	harbor1	chr1	70776585	70776774	LTR/ERV1	3472	+	94	70776679	45447
chr1	70731232	70931232	harbor1	chr1	70777105	70777457	LTR/ERV1	3472	+	176	70777281	46049
chr1	59863231	60063231	harbor1	chr1	59885765	59886160	LTR/ERV1	1145	+	198	59885963	22732
chr1	30835619	31035619	harbor1	chr1	30845425	30845980	LTR/ERV1	4109	+	278	30845703	10084
chr1	74122454	74322454	harbor1	chr1	74158628	74159280	LTR/ERV1	2497	+	326	74158954	36500
chr1	74122454	74322454	harbor1	chr1	74214323	74214677	LTR/ERV1	2466	+	177	74214500	92046
chr1	165814343	166014343	harbor1	chr1	165883727	165883800	LTR/ERV1	621	+	36	165883763	69420
chr1	5164389	5364389	harbor1	chr1	5232913	5233331	LTR/ERV1	2096	+	209	5233122	68733
chr1	5164389	5364389	harbor1	chr1	5233686	5233892	LTR/ERV1	2096	+	103	5233789	69400
chr1	48815287	49015287	harbor1	chr1	48861869	48862337	LTR/ERV1	2628	+	234	48862103	46816
chr1	48815287	49015287	harbor1	chr1	48862619	48862706	LTR/ERV1	2628	+	44	48862663	47376
chr1	179246732	179446732	harbor1	chr1	179263224	179263659	LTR/ERV1	1723	+	218	179263442	16710
chr1	71214482	71414482	harbor1	chr1	71251149	71251716	LTR/ERV1	2777	+	284	71251433	36951
chr1	187759418	187959418	harbor1	chr1	187839692	187840365	LTR/ERV1	2599	+	336	187840028	80610
chr1	187759418	187959418	harbor1	chr1	187840597	187840913	LTR/ERV1	1511	+	158	187840755	81337
chr1	187759418	187959418	harbor1	chr1	187850025	187851465	LTR/ERV1	9542	+	720	187850745	91327
chr1	225021401	225221401	harbor1	chr1	225053976	225054389	LTR/ERV1	801	+	206	225054182	32781
chr1	225021401	225221401	harbor1	chr1	225119851	225119972	LTR/ERV1	475	+	60	225119911	98510
chr1	225021401	225221401	harbor1	chr1	225120700	225120732	LTR/ERV1	475	+	16	225120716	99315
chr1	94639859	94839859	harbor1	chr1	94659428	94659892	LTR/ERV1	2668	+	232	94659660	19801
chr1	94639859	94839859	harbor1	chr1	94660244	94660299	LTR/ERV1	2668	+	28	94660272	20413
chr1	94639859	94839859	harbor1	chr1	94667658	94668351	LTR/ERV1	4061	+	346	94668004	28145
chr1	94639859	94839859	harbor1	chr1	94734096	94734890	LTR/ERV1	5271	+	397	94734493	94634
chr1	49940313	50140313	harbor1	chr1	49951266	49951728	LTR/ERV1	2220	+	231	49951497	11184
chr1	49940313	50140313	harbor1	chr1	49982187	49983652	LTR/ERV1	6820	+	732	49982919	42606
chr1	49940313	50140313	harbor1	chr1	49983835	49984725	LTR/ERV1	5479	+	445	49984280	43967
chr1	80182806	80382806	harbor1	chr1	80276238	80276979	LTR/ERV1	4115	+	370	80276608	93802
chr1	246695878	246895878	harbor1	chr1	246710588	246711444	LTR/ERV1	5343	+	428	246711016	15138
chr1	246695878	246895878	harbor1	chr1	246712260	246713113	LTR/ERV1	5781	+	426	246712686	16808
chr1	246450637	246650637	harbor1	chr1	246491738	246491926	LTR/ERV1	1097	+	94	246491832	41195
chr1	246450637	246650637	harbor1	chr1	246529011	246529801	LTR/ERV1	39998	+	395	246529406	78769
chr1	246450637	246650637	harbor1	chr1	246530404	246532861	LTR/ERV1	39998	+	1228	246531632	80995
chr1	246450637	246650637	harbor1	chr1	246532916	246534697	LTR/ERV1	39998	+	890	246533806	83169
chr1	246450637	246650637	harbor1	chr1	246534785	246535521	LTR/ERV1	39998	+	368	246535153	84516
chr1	246450637	246650637	harbor1	chr1	246535825	246535990	LTR/ERV1	39998	+	82	246535907	85270
chr1	246450637	246650637	harbor1	chr1	246536298	246536907	LTR/ERV1	39998	+	304	246536602	85965
chr1	246450637	246650637	harbor1	chr1	246537219	246537664	LTR/ERV1	3484	+	222	246537441	86804
chr1	246450637	246650637	harbor1	chr1	246537669	246538336	LTR/ERV1	4230	+	334	246538003	87366
chr1	86700808	86900808	harbor1	chr1	86795252	86795690	LTR/ERV1	917	+	219	86795471	94663
chr1	107018212	107218212	harbor1	chr1	107028053	107028550	LTR/ERV1	3300	+	248	107028301	10089
chr1	107018212	107218212	harbor1	chr1	107044572	107046171	LTR/ERV1	11271	+	800	107045372	27160
chr1	15225770	15425770	harbor1	chr1	15279440	15279552	LTR/ERV1	682	+	56	15279496	53726
chr1	80147950	80347950	harbor1	chr1	80155268	80155877	LTR/ERV1	3550	+	304	80155572	7622
chr1	80147950	80347950	harbor1	chr1	80157768	80158342	LTR/ERV1	1754	+	287	80158055	10105
chr1	80147950	80347950	harbor1	chr1	80162705	80163053	LTR/ERV1	1159	+	174	80162879	14929
chr1	240463778	240663778	harbor1	chr1	240486197	240486821	LTR/ERV1	3606	+	312	240486509	22731
chr1	240463778	240663778	harbor1	chr1	240489577	240489641	LTR/ERV1	503	+	32	240489609	25831
chr1	119735737	119935737	harbor1	chr1	119771819	119772181	LTR/ERV1	1841	+	181	119772000	36263
chr1	150609374	150809374	harbor1	chr1	150640169	150640581	LTR/ERV1	3052	+	206	150640375	31001
chr1	150609374	150809374	harbor1	chr1	150641376	150641787	LTR/ERV1	2834	+	206	150641582	32208
chr1	190045914	190245914	harbor1	chr1	190083768	190084158	LTR/ERV1	4691	+	195	190083963	38049
chr1	190045914	190245914	harbor1	chr1	190084445	190084806	LTR/ERV1	4691	+	180	190084625	38711
chr1	190045914	190245914	harbor1	chr1	190084808	190085109	LTR/ERV1	1313	+	150	190084958	39044
chr1	193664295	193864295	harbor1	chr1	193696974	193697074	LTR/ERV1	429	+	50	193697024	32729
chr1	193664295	193864295	harbor1	chr1	193697655	193697920	LTR/ERV1	1074	+	132	193697787	33492
chr1	31066958	31266958	harbor1	chr1	31084368	31084573	LTR/ERV1	971	+	102	31084470	17512
chr1	31066958	31266958	harbor1	chr1	31084718	31084804	LTR/ERV1	3408	+	43	31084761	17803
chr1	31066958	31266958	harbor1	chr1	31085116	31085515	LTR/ERV1	3408	+	200	31085316	18358
chr1	31066958	31266958	harbor1	chr1	31085812	31086009	LTR/ERV1	3408	+	98	31085910	18952
chr1	31066958	31266958	harbor1	chr1	31136064	31136589	LTR/ERV1	4599	+	262	31136326	69368
chr1	31066958	31266958	harbor1	chr1	31136891	31137167	LTR/ERV1	4599	+	138	31137029	70071
chr1	31066958	31266958	harbor1	chr1	31155805	31156129	LTR/ERV1	1000	+	162	31155967	89009
chr1	31066958	31266958	harbor1	chr1	31157796	31157976	LTR/ERV1	937	+	90	31157886	90928
chr1	230981999	231181999	harbor1	chr1	231044536	231044906	LTR/ERV1	2662	+	185	231044721	62722
chr1	230981999	231181999	harbor1	chr1	231065895	231066437	LTR/ERV1	3005	+	271	231066166	84167
chr1	230981999	231181999	harbor1	chr1	231073303	231074210	LTR/ERV1	5188	+	454	231073757	91758
chr1	15129416	15329416	harbor1	chr1	15217246	15217397	LTR/ERV1	980	+	76	15217322	87906
chr1	15129416	15329416	harbor1	chr1	15218556	15219080	LTR/ERV1	3193	+	262	15218818	89402
chr1	40991371	41191371	harbor1	chr1	41059166	41059908	LTR/ERV1	4970	+	371	41059537	68166
chr1	40991371	41191371	harbor1	chr1	41061011	41061283	LTR/ERV1	2058	+	136	41061147	69776
chr1	90017094	90217094	harbor1	chr1	90047814	90048365	LTR/ERV1	1526	+	276	90048090	30996
chr1	90017094	90217094	harbor1	chr1	90048440	90048999	LTR/ERV1	1453	+	280	90048720	31626
chr1	198107560	198307560	harbor1	chr1	198129377	198129683	LTR/ERV1	1282	+	153	198129530	21970
chr1	198107560	198307560	harbor1	chr1	198130678	198130775	LTR/ERV1	600	+	48	198130726	23166
chr1	222097721	222297721	harbor1	chr1	222157484	222157888	LTR/ERV1	1211	+	202	222157686	59965
chr1	222097721	222297721	harbor1	chr1	222160638	222161528	LTR/ERV1	4912	+	445	222161083	63362
chr1	202385848	202585848	harbor1	chr1	202483356	202483472	LTR/ERV1	430	+	58	202483414	97566
chr1	55993739	56193739	harbor1	chr1	56031873	56032469	LTR/ERV1	1536	+	298	56032171	38432
chr1	227762708	227962708	harbor1	chr1	227798792	227799379	LTR/ERV1	3301	+	294	227799086	36378
chr1	227762708	227962708	harbor1	chr1	227856848	227857038	LTR/ERV1	2794	+	95	227856943	94235
chr1	227762708	227962708	harbor1	chr1	227857373	227857658	LTR/ERV1	2794	+	142	227857515	94807
chr1	177992402	178192402	harbor1	chr1	178040241	178040673	LTR/ERV1	3643	+	216	178040457	48055
chr1	177992402	178192402	harbor1	chr1	178040674	178041186	LTR/ERV1	1836	+	256	178040930	48528
chr1	177992402	178192402	harbor1	chr1	178041157	178043398	LTR/ERV1	13281	+	1120	178042277	49875
chr1	177992402	178192402	harbor1	chr1	178043378	178043824	LTR/ERV1	2896	+	223	178043601	51199
chr1	177992402	178192402	harbor1	chr1	178045047	178045465	LTR/ERV1	2784	+	209	178045256	52854
chr1	177992402	178192402	harbor1	chr1	178045466	178045930	LTR/ERV1	3985	+	232	178045698	53296
chr1	177992402	178192402	harbor1	chr1	178043819	178045066	LTR/ERV1	6948	+	624	178044443	52041
chr1	232605632	232805632	harbor1	chr1	232693895	232694736	LTR/ERV1	4838	+	420	232694315	88683
chr1	232046476	232246476	harbor1	chr1	232118115	232118565	LTR/ERV1	3595	+	225	232118340	71864
chr1	232046476	232246476	harbor1	chr1	232118568	232121599	LTR/ERV1	19510	+	1516	232120084	73608
chr1	232046476	232246476	harbor1	chr1	232121579	232121728	LTR/ERV1	938	+	74	232121653	75177
chr1	232046476	232246476	harbor1	chr1	232121719	232122222	LTR/ERV1	3167	+	252	232121971	75495
chr1	232046476	232246476	harbor1	chr1	232122225	232122886	LTR/ERV1	4086	+	330	232122555	76079
chr1	232046476	232246476	harbor1	chr1	232122888	232123116	LTR/ERV1	1248	+	114	232123002	76526
chr1	232046476	232246476	harbor1	chr1	232123117	232123494	LTR/ERV1	2445	+	188	232123305	76829
chr1	232046476	232246476	harbor1	chr1	232123495	232123945	LTR/ERV1	3542	+	225	232123720	77244
chr1	232046476	232246476	harbor1	chr1	232130893	232131345	LTR/ERV1	2718	+	226	232131119	84643
chr1	232046476	232246476	harbor1	chr1	232134372	232134801	LTR/ERV1	1887	+	214	232134586	88110
chr1	101969950	102169950	harbor1	chr1	102045800	102046068	LTR/ERV1	1093	+	134	102045934	75984
chr1	101969950	102169950	harbor1	chr1	102046168	102047205	LTR/ERV1	5024	+	518	102046686	76736
chr1	101969950	102169950	harbor1	chr1	102047206	102047666	LTR/ERV1	3027	+	230	102047436	77486
chr1	101969950	102169950	harbor1	chr1	102047989	102048156	LTR/ERV1	3027	+	84	102048073	78123
chr1	220727059	220927059	harbor1	chr1	220778651	220779144	LTR/ERV1	2710	+	246	220778897	51838
chr1	220727059	220927059	harbor1	chr1	220785616	220786074	LTR/ERV1	1630	+	229	220785845	58786
chr1	241728723	241928723	harbor1	chr1	241733975	241734421	LTR/ERV1	2885	+	223	241734198	5475
chr1	241728723	241928723	harbor1	chr1	241742266	241742813	LTR/ERV1	4145	+	274	241742540	13817
chr1	178975873	179175873	harbor1	chr1	178975540	178976346	LTR/ERV1	6027	+	403	178975943	70
chr1	114328488	114528488	harbor1	chr1	114358451	114359144	LTR/ERV1	3768	+	346	114358797	30309
chr1	114328488	114528488	harbor1	chr1	114359517	114359744	LTR/ERV1	3768	+	114	114359631	31143
chr1	114328488	114528488	harbor1	chr1	114359736	114359830	LTR/ERV1	641	+	47	114359783	31295
chr1	114328488	114528488	harbor1	chr1	114359820	114360102	LTR/ERV1	1775	+	141	114359961	31473
chr1	114328488	114528488	harbor1	chr1	114360884	114361336	LTR/ERV1	3184	+	226	114361110	32622
chr1	114328488	114528488	harbor1	chr1	114361342	114361426	LTR/ERV1	3340	+	42	114361384	32896
chr1	114328488	114528488	harbor1	chr1	114361733	114362172	LTR/ERV1	3340	+	220	114361953	33465
chr1	114328488	114528488	harbor1	chr1	114362475	114362960	LTR/ERV1	3340	+	242	114362717	34229
chr1	114328488	114528488	harbor1	chr1	114369593	114370997	LTR/ERV1	11983	+	702	114370295	41807
chr1	114328488	114528488	harbor1	chr1	114371295	114371373	LTR/ERV1	11983	+	39	114371334	42846
chr1	114328488	114528488	harbor1	chr1	114371614	114371823	LTR/ERV1	11983	+	104	114371718	43230
chr1	114328488	114528488	harbor1	chr1	114372116	114373929	LTR/ERV1	17330	+	906	114373022	44534
chr1	114328488	114528488	harbor1	chr1	114374218	114374768	LTR/ERV1	17330	+	275	114374493	46005
chr1	114328488	114528488	harbor1	chr1	114375058	114375071	LTR/ERV1	17330	+	6	114375064	46576
chr1	114328488	114528488	harbor1	chr1	114375359	114376008	LTR/ERV1	17330	+	324	114375683	47195
chr1	114328488	114528488	harbor1	chr1	114376024	114376478	LTR/ERV1	3237	+	227	114376251	47763
chr1	114328488	114528488	harbor1	chr1	114378736	114379196	LTR/ERV1	475	+	230	114378966	50478
chr1	114328488	114528488	harbor1	chr1	114379215	114379342	LTR/ERV1	1186	+	64	114379279	50791
chr1	114328488	114528488	harbor1	chr1	114379984	114380421	LTR/ERV1	1186	+	218	114380202	51714
chr1	114328488	114528488	harbor1	chr1	114418356	114418938	LTR/ERV1	3521	+	291	114418647	90159
chr1	114328488	114528488	harbor1	chr1	114419230	114419418	LTR/ERV1	3521	+	94	114419324	90836
chr1	114328488	114528488	harbor1	chr1	114360099	114360697	LTR/ERV1	3753	+	299	114360398	31910
chr1	114328488	114528488	harbor1	chr1	114376592	114378631	LTR/ERV1	9301	+	1020	114377612	49124
chr1	73697291	73897291	harbor1	chr1	73708172	73708860	LTR/ERV1	4157	+	344	73708516	11225
chr1	73697291	73897291	harbor1	chr1	73709098	73709653	LTR/ERV1	1867	+	278	73709376	12085
chr1	73697291	73897291	harbor1	chr1	73770358	73771842	LTR/ERV1	6759	+	742	73771100	73809
chr1	38736685	38936685	harbor1	chr1	38761714	38761836	LTR/ERV1	725	+	61	38761775	25090
chr1	38736685	38936685	harbor1	chr1	38800778	38802592	LTR/ERV1	8060	+	907	38801685	65000
chr1	38736685	38936685	harbor1	chr1	38811219	38811981	LTR/ERV1	4788	+	381	38811600	74915
chr1	38736685	38936685	harbor1	chr1	38812172	38812351	LTR/ERV1	1303	+	90	38812262	75577
chr1	38736685	38936685	harbor1	chr1	38829778	38829976	LTR/ERV1	3230	+	99	38829877	93192
chr1	38736685	38936685	harbor1	chr1	38830231	38830650	LTR/ERV1	3230	+	210	38830441	93756
chr1	38736685	38936685	harbor1	chr1	38830959	38831020	LTR/ERV1	3230	+	30	38830989	94304
chr1	71055478	71255478	harbor1	chr1	71081718	71082102	LTR/ERV1	1968	+	192	71081910	26432
chr1	71055478	71255478	harbor1	chr1	71153664	71154383	LTR/ERV1	4555	+	360	71154024	98546
chr1	196591551	196791551	harbor1	chr1	196629003	196629111	LTR/ERV1	651	+	54	196629057	37506
chr1	196591551	196791551	harbor1	chr1	196649892	196650693	LTR/ERV1	4325	+	400	196650292	58741
chr1	44654421	44854421	harbor1	chr1	44726392	44726991	LTR/ERV1	3550	+	300	44726692	72271
chr1	44654421	44854421	harbor1	chr1	44732044	44732168	LTR/ERV1	436	+	62	44732106	77685
chr1	44654421	44854421	harbor1	chr1	44732195	44732310	LTR/ERV1	518	+	58	44732253	77832
chr1	28272919	28472919	harbor1	chr1	28347529	28347589	LTR/ERV1	1327	+	30	28347559	74640
chr1	28272919	28472919	harbor1	chr1	28347892	28348021	LTR/ERV1	1327	+	64	28347956	75037
chr1	28272919	28472919	harbor1	chr1	28348329	28348651	LTR/ERV1	1327	+	161	28348490	75571
chr1	28272919	28472919	harbor1	chr1	28364965	28365488	LTR/ERV1	2081	+	262	28365227	92308
chr1	38930014	39130014	harbor1	chr1	38947280	38947925	LTR/ERV1	3354	+	322	38947602	17588
chr1	38930014	39130014	harbor1	chr1	38953090	38953772	LTR/ERV1	5339	+	341	38953431	23417
chr1	38930014	39130014	harbor1	chr1	38973209	38973412	LTR/ERV1	5169	+	102	38973311	43297
chr1	38930014	39130014	harbor1	chr1	38973705	38974317	LTR/ERV1	5169	+	306	38974011	43997
chr1	38930014	39130014	harbor1	chr1	38981705	38981790	LTR/ERV1	2400	+	42	38981747	51733
chr1	38930014	39130014	harbor1	chr1	38982105	38982475	LTR/ERV1	2400	+	185	38982290	52276
chr1	234599957	234799957	harbor1	chr1	234659951	234660648	LTR/ERV1	4033	+	348	234660299	60342
chr1	215993077	216193077	harbor1	chr1	216008143	216008553	LTR/ERV1	2673	+	205	216008348	15271
chr1	215993077	216193077	harbor1	chr1	216008556	216011399	LTR/ERV1	16650	+	1422	216009978	16901
chr1	215993077	216193077	harbor1	chr1	216011372	216011541	LTR/ERV1	871	+	84	216011456	18379
chr1	215993077	216193077	harbor1	chr1	216011532	216011970	LTR/ERV1	2923	+	219	216011751	18674
chr1	215993077	216193077	harbor1	chr1	216012139	216012204	LTR/ERV1	519	+	32	216012171	19094
chr1	215993077	216193077	harbor1	chr1	216012208	216012864	LTR/ERV1	4334	+	328	216012536	19459
chr1	215993077	216193077	harbor1	chr1	216012866	216013082	LTR/ERV1	1352	+	108	216012974	19897
chr1	215993077	216193077	harbor1	chr1	216013081	216013458	LTR/ERV1	2397	+	188	216013269	20192
chr1	215993077	216193077	harbor1	chr1	216013459	216013869	LTR/ERV1	2764	+	205	216013664	20587
chr1	39659410	39859410	harbor1	chr1	39730039	39730479	LTR/ERV1	2261	+	220	39730259	70849
chr1	39659410	39859410	harbor1	chr1	39737551	39737966	LTR/ERV1	3431	+	208	39737759	78349
chr1	39659410	39859410	harbor1	chr1	39737994	39738030	LTR/ERV1	3431	+	18	39738012	78602
chr1	39659410	39859410	harbor1	chr1	39714420	39714915	LTR/ERV1	2306	+	248	39714668	55258
chr1	17385748	17585748	harbor1	chr1	17453072	17453227	LTR/ERV1	1100	+	78	17453150	67402
chr1	17385748	17585748	harbor1	chr1	17453521	17453577	LTR/ERV1	1100	+	28	17453549	67801
chr1	17385748	17585748	harbor1	chr1	17455408	17455560	LTR/ERV1	925	+	76	17455484	69736
chr1	17385748	17585748	harbor1	chr1	17472880	17473340	LTR/ERV1	3107	+	230	17473110	87362
chr1	17385748	17585748	harbor1	chr1	17479000	17479145	LTR/ERV1	538	+	72	17479072	93324
chr1	222042006	222242006	harbor1	chr1	222047452	222047703	LTR/ERV1	670	+	126	222047578	5572
chr1	222042006	222242006	harbor1	chr1	222049565	222050989	LTR/ERV1	11012	+	712	222050277	8271
chr1	222042006	222242006	harbor1	chr1	222055169	222055620	LTR/ERV1	3076	+	226	222055395	13389
chr1	222042006	222242006	harbor1	chr1	222064954	222065262	LTR/ERV1	2137	+	154	222065108	23102
chr1	222042006	222242006	harbor1	chr1	222065363	222065523	LTR/ERV1	1174	+	80	222065443	23437
chr1	222042006	222242006	harbor1	chr1	222077110	222077228	LTR/ERV1	769	+	59	222077169	35163
chr1	222042006	222242006	harbor1	chr1	222081623	222081826	LTR/ERV1	888	+	102	222081725	39719
chr1	222042006	222242006	harbor1	chr1	222082241	222082497	LTR/ERV1	795	+	128	222082369	40363
chr1	39546151	39746151	harbor1	chr1	39587791	39587827	LTR/ERV1	2570	+	18	39587809	41658
chr1	39546151	39746151	harbor1	chr1	39588134	39588538	LTR/ERV1	2570	+	202	39588336	42185
chr1	39546151	39746151	harbor1	chr1	39603744	39604218	LTR/ERV1	3000	+	237	39603981	57830
chr1	207841180	208041180	harbor1	chr1	207935101	207935552	LTR/ERV1	2409	+	226	207935327	94147
chr1	113153566	113353566	harbor1	chr1	113201773	113202077	LTR/ERV1	2010	+	152	113201925	48359
chr1	113153566	113353566	harbor1	chr1	113202324	113202828	LTR/ERV1	3706	+	252	113202576	49010
chr1	113153566	113353566	harbor1	chr1	113217759	113218338	LTR/ERV1	2036	+	290	113218049	64483
chr1	113153566	113353566	harbor1	chr1	113218902	113219355	LTR/ERV1	3463	+	226	113219128	65562
chr1	224477029	224677029	harbor1	chr1	224520285	224520491	LTR/ERV1	1369	+	103	224520388	43359
chr1	224477029	224677029	harbor1	chr1	224536988	224537711	LTR/ERV1	4359	+	362	224537350	60321
chr1	16331144	16531144	harbor1	chr1	16353271	16353551	LTR/ERV1	2628	+	140	16353411	22267
chr1	16331144	16531144	harbor1	chr1	16353848	16353960	LTR/ERV1	2628	+	56	16353904	22760
chr1	16331144	16531144	harbor1	chr1	16354604	16354771	LTR/ERV1	2628	+	84	16354688	23544
chr1	63671700	63871700	harbor1	chr1	63725110	63725342	LTR/ERV1	2744	+	116	63725226	53526
chr1	63671700	63871700	harbor1	chr1	63725769	63726006	LTR/ERV1	2744	+	118	63725887	54187
chr1	116219508	116419508	harbor1	chr1	116241861	116242307	LTR/ERV1	1969	+	223	116242084	22576
chr1	116219508	116419508	harbor1	chr1	116254074	116254948	LTR/ERV1	5072	+	437	116254511	35003
chr1	8854775	9054775	harbor1	chr1	8890363	8890566	LTR/ERV1	1513	+	102	8890465	35690
chr1	8854775	9054775	harbor1	chr1	8891763	8891915	LTR/ERV1	447	+	76	8891839	37064
chr1	8854775	9054775	harbor1	chr1	8892220	8892746	LTR/ERV1	3543	+	263	8892483	37708
chr1	8854775	9054775	harbor1	chr1	8893354	8893407	LTR/ERV1	3543	+	26	8893380	38605
chr1	8854775	9054775	harbor1	chr1	8895020	8895109	LTR/ERV1	606	+	44	8895064	40289
chr1	8854775	9054775	harbor1	chr1	8898308	8899114	LTR/ERV1	6195	+	403	8898711	43936
chr1	8854775	9054775	harbor1	chr1	8921052	8921231	LTR/ERV1	613	+	90	8921142	66367
chr1	8854775	9054775	harbor1	chr1	8921232	8924068	LTR/ERV1	17789	+	1418	8922650	67875
chr1	8854775	9054775	harbor1	chr1	8924338	8925978	LTR/ERV1	17789	+	820	8925158	70383
chr1	8854775	9054775	harbor1	chr1	8926497	8927320	LTR/ERV1	2443	+	412	8926909	72134
chr1	8854775	9054775	harbor1	chr1	8927489	8927668	LTR/ERV1	671	+	90	8927579	72804
chr1	8854775	9054775	harbor1	chr1	8938289	8938749	LTR/ERV1	3536	+	230	8938519	83744
chr1	8854775	9054775	harbor1	chr1	8939345	8939497	LTR/ERV1	3536	+	76	8939421	84646
chr1	8854775	9054775	harbor1	chr1	8939983	8940137	LTR/ERV1	924	+	77	8940060	85285
chr1	8854775	9054775	harbor1	chr1	8953731	8954173	LTR/ERV1	4094	+	221	8953952	99177
chr1	8854775	9054775	harbor1	chr1	8954465	8954588	LTR/ERV1	4094	+	62	8954527	99752
chr1	8854775	9054775	harbor1	chr1	8895877	8898307	LTR/ERV1	19583	+	1215	8897092	42317
chr1	168316166	168516166	harbor1	chr1	168317096	168317575	LTR/ERV1	1042	+	240	168317336	1170
chr1	168316166	168516166	harbor1	chr1	168331495	168331611	LTR/ERV1	489	+	58	168331553	15387
chr1	168316166	168516166	harbor1	chr1	168332006	168332170	LTR/ERV1	754	+	82	168332088	15922
chr1	168316166	168516166	harbor1	chr1	168333953	168334085	LTR/ERV1	500	+	66	168334019	17853
chr1	168316166	168516166	harbor1	chr1	168334088	168334405	LTR/ERV1	975	+	158	168334246	18080
chr1	168316166	168516166	harbor1	chr1	168334406	168336059	LTR/ERV1	3186	+	826	168335232	19066
chr1	168316166	168516166	harbor1	chr1	168336081	168336203	LTR/ERV1	476	+	61	168336142	19976
chr1	168316166	168516166	harbor1	chr1	168336577	168336708	LTR/ERV1	771	+	66	168336643	20477
chr1	168316166	168516166	harbor1	chr1	168338999	168339308	LTR/ERV1	901	+	154	168339153	22987
chr1	168316166	168516166	harbor1	chr1	168339527	168340453	LTR/ERV1	4126	+	463	168339990	23824
chr1	168316166	168516166	harbor1	chr1	168340455	168341082	LTR/ERV1	785	+	314	168340769	24603
chr1	168316166	168516166	harbor1	chr1	168341132	168341472	LTR/ERV1	883	+	170	168341302	25136
chr1	168316166	168516166	harbor1	chr1	168362390	168363097	LTR/ERV1	4108	+	354	168362744	46578
chr1	165883642	166083642	harbor1	chr1	165883727	165883800	LTR/ERV1	621	+	36	165883763	121
chr1	189566158	189766158	harbor1	chr1	189656757	189657340	LTR/ERV1	1793	+	292	189657049	90891
chr1	189566158	189766158	harbor1	chr1	189662202	189662672	LTR/ERV1	3135	+	235	189662437	96279
chr1	50699189	50899189	harbor1	chr1	50716439	50717166	LTR/ERV1	4787	+	364	50716803	17614
chr1	50699189	50899189	harbor1	chr1	50720516	50721119	LTR/ERV1	1817	+	302	50720818	21629
chr1	176908923	177108923	harbor1	chr1	176940149	176940694	LTR/ERV1	2766	+	272	176940421	31498
chr1	176908923	177108923	harbor1	chr1	176942523	176942820	LTR/ERV1	3556	+	148	176942671	33748
chr1	176908923	177108923	harbor1	chr1	176942867	176943038	LTR/ERV1	3556	+	86	176942953	34030
chr1	80893542	81093542	harbor1	chr1	80913898	80914465	LTR/ERV1	3240	+	284	80914182	20640
chr1	80893542	81093542	harbor1	chr1	80976237	80976632	LTR/ERV1	1343	+	198	80976435	82893
chr1	107028936	107228936	harbor1	chr1	107044572	107046171	LTR/ERV1	11271	+	800	107045372	16436
chr1	246147804	246347804	harbor1	chr1	246147462	246148598	LTR/ERV1	5759	+	568	246148030	226
chr1	246147804	246347804	harbor1	chr1	246219081	246220045	LTR/ERV1	5712	+	482	246219563	71759
chr1	246147804	246347804	harbor1	chr1	246220241	246221940	LTR/ERV1	3975	+	850	246221091	73287
chr1	17023977	17223977	harbor1	chr1	17045765	17046050	LTR/ERV1	1039	+	142	17045907	21930
chr1	2780000	2980000	harbor1	chr1	2813099	2814487	LTR/ERV1	8424	+	694	2813793	33793
chr1	163652398	163852398	harbor1	chr1	163680214	163680289	LTR/ERV1	479	+	38	163680252	27854
chr1	163652398	163852398	harbor1	chr1	163681632	163682175	LTR/ERV1	3229	+	272	163681904	29506
chr1	209267998	209467998	harbor1	chr1	209329032	209329179	LTR/ERV1	1486	+	74	209329106	61108
chr1	209267998	209467998	harbor1	chr1	209329465	209329750	LTR/ERV1	1486	+	142	209329607	61609
chr1	173924652	174124652	harbor1	chr1	173948058	173948408	LTR/ERV1	842	+	175	173948233	23581
chr1	173924652	174124652	harbor1	chr1	173996420	173996933	LTR/ERV1	3197	+	256	173996676	72024
chr1	144908369	145108369	harbor1	chr1	144990466	144992335	LTR/ERV1	10453	+	934	144991400	83031
chr1	226483174	226683174	harbor1	chr1	226485417	226485608	LTR/ERV1	964	+	96	226485513	2339
chr1	154306693	154506693	harbor1	chr1	154307872	154308323	LTR/ERV1	3173	+	226	154308098	1405
chr1	154306693	154506693	harbor1	chr1	154314212	154314613	LTR/ERV1	2877	+	200	154314412	7719
chr1	154306693	154506693	harbor1	chr1	154314962	154315313	LTR/ERV1	2140	+	176	154315138	8445
chr1	154306693	154506693	harbor1	chr1	154315620	154315718	LTR/ERV1	2140	+	49	154315669	8976
chr1	154306693	154506693	harbor1	chr1	154316068	154316245	LTR/ERV1	11595	+	88	154316156	9463
chr1	154306693	154506693	harbor1	chr1	154316543	154317978	LTR/ERV1	11595	+	718	154317261	10568
chr1	154306693	154506693	harbor1	chr1	154318275	154318445	LTR/ERV1	11595	+	85	154318360	11667
chr1	154306693	154506693	harbor1	chr1	154318446	154318591	LTR/ERV1	1011	+	72	154318518	11825
chr1	154306693	154506693	harbor1	chr1	154318612	154318840	LTR/ERV1	2265	+	114	154318726	12033
chr1	154306693	154506693	harbor1	chr1	154319139	154319208	LTR/ERV1	2265	+	34	154319173	12480
chr1	154306693	154506693	harbor1	chr1	154358894	154359365	LTR/ERV1	4191	+	236	154359130	52437
chr1	154306693	154506693	harbor1	chr1	154359732	154359779	LTR/ERV1	4191	+	24	154359756	53063
chr1	154306693	154506693	harbor1	chr1	154360093	154360216	LTR/ERV1	4191	+	62	154360155	53462
chr1	154306693	154506693	harbor1	chr1	154361930	154362553	LTR/ERV1	4889	+	312	154362242	55549
chr1	154306693	154506693	harbor1	chr1	154362859	154362914	LTR/ERV1	4889	+	28	154362887	56194
chr1	154306693	154506693	harbor1	chr1	154371485	154371947	LTR/ERV1	3334	+	231	154371716	65023
chr1	8064362	8264362	harbor1	chr1	8076139	8076463	LTR/ERV1	3466	+	162	8076301	11939
chr1	8064362	8264362	harbor1	chr1	8076763	8076940	LTR/ERV1	3466	+	88	8076851	12489
chr1	8064362	8264362	harbor1	chr1	8119866	8119997	LTR/ERV1	455	+	66	8119932	55570
chr1	64527976	64727976	harbor1	chr1	64564005	64564610	LTR/ERV1	1653	+	302	64564307	36331
chr1	81515461	81715461	harbor1	chr1	81615103	81615653	LTR/ERV1	3840	+	275	81615378	99917
chr1	240926295	241126295	harbor1	chr1	240936794	240937368	LTR/ERV1	3726	+	287	240937081	10786
chr1	240926295	241126295	harbor1	chr1	240939566	240939788	LTR/ERV1	3095	+	111	240939677	13382
chr1	240926295	241126295	harbor1	chr1	240940086	240940436	LTR/ERV1	3095	+	175	240940261	13966
chr1	240926295	241126295	harbor1	chr1	240988833	240989157	LTR/ERV1	2547	+	162	240988995	62700
chr1	240926295	241126295	harbor1	chr1	240989447	240989692	LTR/ERV1	2547	+	122	240989569	63274
chr1	240926295	241126295	harbor1	chr1	241008563	241008630	LTR/ERV1	3210	+	34	241008597	82302
chr1	240926295	241126295	harbor1	chr1	241008941	241009453	LTR/ERV1	3210	+	256	241009197	82902
chr1	240926295	241126295	harbor1	chr1	241011535	241012083	LTR/ERV1	3318	+	274	241011809	85514
chr1	240926295	241126295	harbor1	chr1	241012591	241013053	LTR/ERV1	1490	+	231	241012822	86527
chr1	240926295	241126295	harbor1	chr1	241013363	241013533	LTR/ERV1	518	+	85	241013448	87153
chr1	240926295	241126295	harbor1	chr1	241022178	241022849	LTR/ERV1	2829	+	336	241022514	96219
chr1	240926295	241126295	harbor1	chr1	241023193	241023562	LTR/ERV1	1167	+	184	241023377	97082
chr1	152998752	153198752	harbor1	chr1	153020541	153020708	LTR/ERV1	1032	+	84	153020625	21873
chr1	152998752	153198752	harbor1	chr1	153020710	153021273	LTR/ERV1	3427	+	282	153020992	22240
chr1	152998752	153198752	harbor1	chr1	153021281	153021693	LTR/ERV1	2929	+	206	153021487	22735
chr1	152998752	153198752	harbor1	chr1	153021957	153022481	LTR/ERV1	3905	+	262	153022219	23467
chr1	216128166	216328166	harbor1	chr1	216145601	216146051	LTR/ERV1	3458	+	225	216145826	17660
chr1	216128166	216328166	harbor1	chr1	216146054	216148964	LTR/ERV1	16648	+	1455	216147509	19343
chr1	216128166	216328166	harbor1	chr1	216148944	216149090	LTR/ERV1	834	+	73	216149017	20851
chr1	216128166	216328166	harbor1	chr1	216149081	216152206	LTR/ERV1	23345	+	1562	216150643	22477
chr1	216128166	216328166	harbor1	chr1	216152207	216152688	LTR/ERV1	3280	+	240	216152447	24281
chr1	216128166	216328166	harbor1	chr1	216152721	216153483	LTR/ERV1	4602	+	381	216153102	24936
chr1	216128166	216328166	harbor1	chr1	216155041	216155779	LTR/ERV1	3804	+	369	216155410	27244
chr1	216128166	216328166	harbor1	chr1	216167185	216167881	LTR/ERV1	4003	+	348	216167533	39367
chr1	216128166	216328166	harbor1	chr1	216168381	216169112	LTR/ERV1	3442	+	366	216168747	40581
chr1	73345949	73545949	harbor1	chr1	73359106	73359569	LTR/ERV1	3312	+	232	73359338	13389
chr1	73345949	73545949	harbor1	chr1	73370861	73371032	LTR/ERV1	2780	+	86	73370947	24998
chr1	73345949	73545949	harbor1	chr1	73371342	73371696	LTR/ERV1	2780	+	177	73371519	25570
chr1	73345949	73545949	harbor1	chr1	73387632	73388247	LTR/ERV1	4035	+	308	73387940	41991
chr1	73345949	73545949	harbor1	chr1	73406102	73406593	LTR/ERV1	2714	+	246	73406348	60399
chr1	117182262	117382262	harbor1	chr1	117185445	117186060	LTR/ERV1	4213	+	308	117185753	3491
chr1	117182262	117382262	harbor1	chr1	117187712	117187811	LTR/ERV1	576	+	50	117187762	5500
chr1	117182262	117382262	harbor1	chr1	117197389	117197792	LTR/ERV1	2452	+	202	117197591	15329
chr1	117182262	117382262	harbor1	chr1	117248952	117249384	LTR/ERV1	2963	+	216	117249168	66906
chr1	117182262	117382262	harbor1	chr1	117260380	117260945	LTR/ERV1	1899	+	282	117260662	78400
chr1	117182262	117382262	harbor1	chr1	117262921	117263581	LTR/ERV1	3954	+	330	117263251	80989
chr1	117182262	117382262	harbor1	chr1	117272510	117272782	LTR/ERV1	2632	+	136	117272646	90384
chr1	117182262	117382262	harbor1	chr1	117272783	117273341	LTR/ERV1	2577	+	279	117273062	90800
chr1	117182262	117382262	harbor1	chr1	117273342	117273558	LTR/ERV1	2632	+	108	117273450	91188
chr1	117182262	117382262	harbor1	chr1	117274269	117274448	LTR/ERV1	2632	+	90	117274359	92097
chr1	72806385	73006385	harbor1	chr1	72875650	72876245	LTR/ERV1	3608	+	298	72875948	69563
chr1	147316360	147516360	harbor1	chr1	147409658	147410401	LTR/ERV1	3379	+	372	147410030	93670
chr1	178927347	179127347	harbor1	chr1	178930201	178930757	LTR/ERV1	4210	+	278	178930479	3132
chr1	178927347	179127347	harbor1	chr1	178975540	178976346	LTR/ERV1	6027	+	403	178975943	48596
chr1	209716267	209916267	harbor1	chr1	209736740	209737112	LTR/ERV1	1435	+	186	209736926	20659
chr1	205897915	206097915	harbor1	chr1	205990052	205990777	LTR/ERV1	1379	+	362	205990414	92499
chr1	205897915	206097915	harbor1	chr1	205991071	205991403	LTR/ERV1	1379	+	166	205991237	93322
chr1	89111345	89311345	harbor1	chr1	89152793	89153190	LTR/ERV1	1728	+	198	89152991	41646
chr1	89111345	89311345	harbor1	chr1	89167821	89168047	LTR/ERV1	642	+	113	89167934	56589
chr1	89111345	89311345	harbor1	chr1	89168323	89168652	LTR/ERV1	1168	+	164	89168487	57142
chr1	89111345	89311345	harbor1	chr1	89169000	89169324	LTR/ERV1	1168	+	162	89169162	57817
chr1	89111345	89311345	harbor1	chr1	89169330	89170059	LTR/ERV1	2455	+	364	89169694	58349
chr1	89111345	89311345	harbor1	chr1	89170235	89170654	LTR/ERV1	1256	+	210	89170445	59100
chr1	89111345	89311345	harbor1	chr1	89170656	89170809	LTR/ERV1	560	+	76	89170732	59387
chr1	89111345	89311345	harbor1	chr1	89177261	89177294	LTR/ERV1	499	+	16	89177277	65932
chr1	89111345	89311345	harbor1	chr1	89177589	89177878	LTR/ERV1	908	+	144	89177733	66388
chr1	89111345	89311345	harbor1	chr1	89178360	89179158	LTR/ERV1	4584	+	399	89178759	67414
chr1	89111345	89311345	harbor1	chr1	89179228	89179558	LTR/ERV1	2418	+	165	89179393	68048
chr1	89111345	89311345	harbor1	chr1	89179559	89179875	LTR/ERV1	2202	+	158	89179717	68372
chr1	89111345	89311345	harbor1	chr1	89209360	89209434	LTR/ERV1	500	+	37	89209397	98052
chr1	89111345	89311345	harbor1	chr1	89209435	89211593	LTR/ERV1	25876	+	1079	89210514	99169
chr1	69341619	69541619	harbor1	chr1	69359045	69359154	LTR/ERV1	762	+	54	69359099	17480
chr1	69341619	69541619	harbor1	chr1	69409119	69410146	LTR/ERV1	3962	+	514	69409633	68014
chr1	69341619	69541619	harbor1	chr1	69438378	69438721	LTR/ERV1	1616	+	172	69438550	96931
chr1	11670734	11870734	harbor1	chr1	11688684	11689013	LTR/ERV1	4003	+	164	11688848	18114
chr1	11670734	11870734	harbor1	chr1	11689610	11689849	LTR/ERV1	4003	+	120	11689730	18996
chr1	11670734	11870734	harbor1	chr1	11732645	11732829	LTR/ERV1	2679	+	92	11732737	62003
chr1	11670734	11870734	harbor1	chr1	11733124	11733550	LTR/ERV1	2679	+	213	11733337	62603
chr1	11670734	11870734	harbor1	chr1	11735362	11735702	LTR/ERV1	894	+	170	11735532	64798
chr1	242162182	242362182	harbor1	chr1	242202943	242203418	LTR/ERV1	1950	+	238	242203181	40999
chr1	242162182	242362182	harbor1	chr1	242203823	242203869	LTR/ERV1	1950	+	23	242203846	41664
chr1	242162182	242362182	harbor1	chr1	242210318	242210868	LTR/ERV1	3064	+	275	242210593	48411
chr1	242162182	242362182	harbor1	chr1	242248161	242248380	LTR/ERV1	1212	+	110	242248271	86089
chr1	242162182	242362182	harbor1	chr1	242248483	242248725	LTR/ERV1	847	+	121	242248604	86422
chr1	44843895	45043895	harbor1	chr1	44882298	44882434	LTR/ERV1	845	+	68	44882366	38471
chr1	44843895	45043895	harbor1	chr1	44883238	44883805	LTR/ERV1	2329	+	284	44883522	39627
chr1	44843895	45043895	harbor1	chr1	44886501	44886932	LTR/ERV1	2911	+	216	44886717	42822
chr1	44843895	45043895	harbor1	chr1	44886933	44887656	LTR/ERV1	5802	+	362	44887295	43400
chr1	44843895	45043895	harbor1	chr1	44887912	44888122	LTR/ERV1	5802	+	105	44888017	44122
chr1	44843895	45043895	harbor1	chr1	44888116	44888473	LTR/ERV1	6236	+	178	44888294	44399
chr1	44843895	45043895	harbor1	chr1	44888503	44889253	LTR/ERV1	6236	+	375	44888878	44983
chr1	44843895	45043895	harbor1	chr1	44889860	44889988	LTR/ERV1	940	+	64	44889924	46029
chr1	44843895	45043895	harbor1	chr1	44889989	44890622	LTR/ERV1	4359	+	316	44890305	46410
chr1	179014859	179214859	harbor1	chr1	179097478	179098104	LTR/ERV1	2098	+	313	179097791	82932
chr1	5725143	5925143	harbor1	chr1	5742494	5742729	LTR/ERV1	1433	+	118	5742612	17469
chr1	5725143	5925143	harbor1	chr1	5781862	5782457	LTR/ERV1	4573	+	298	5782160	57017
chr1	5725143	5925143	harbor1	chr1	5815582	5815819	LTR/ERV1	660	+	118	5815700	90557
chr1	5725143	5925143	harbor1	chr1	5818199	5818448	LTR/ERV1	4165	+	124	5818323	93180
chr1	5725143	5925143	harbor1	chr1	5818824	5819290	LTR/ERV1	4165	+	233	5819057	93914
chr1	5725143	5925143	harbor1	chr1	5823250	5823272	LTR/ERV1	2670	+	11	5823261	98118
chr1	5725143	5925143	harbor1	chr1	5823580	5823821	LTR/ERV1	2670	+	120	5823700	98557
chr1	5725143	5925143	harbor1	chr1	5824122	5824340	LTR/ERV1	2670	+	109	5824231	99088
chr1	44151458	44351458	harbor1	chr1	44179973	44180070	LTR/ERV1	716	+	48	44180021	28563
chr1	44151458	44351458	harbor1	chr1	44195724	44196131	LTR/ERV1	2564	+	204	44195928	44470
chr1	40991263	41191263	harbor1	chr1	41059166	41059908	LTR/ERV1	4970	+	371	41059537	68274
chr1	40991263	41191263	harbor1	chr1	41061011	41061283	LTR/ERV1	2058	+	136	41061147	69884
chr1	246719106	246919106	harbor1	chr1	246813214	246813608	LTR/ERV1	2671	+	197	246813411	94305
chr1	46107497	46307497	harbor1	chr1	46148862	46149139	LTR/ERV1	3233	+	138	46149000	41503
chr1	46107497	46307497	harbor1	chr1	46149444	46149527	LTR/ERV1	3233	+	42	46149486	41989
chr1	46107497	46307497	harbor1	chr1	46149831	46150121	LTR/ERV1	3233	+	145	46149976	42479
chr1	25890385	26090385	harbor1	chr1	25920461	25920548	LTR/ERV1	1133	+	44	25920505	30120
chr1	25890385	26090385	harbor1	chr1	25920842	25921083	LTR/ERV1	1133	+	120	25920962	30577
chr1	25890385	26090385	harbor1	chr1	25942981	25943434	LTR/ERV1	3125	+	226	25943207	52822
chr1	25890385	26090385	harbor1	chr1	25943429	25943549	LTR/ERV1	688	+	60	25943489	53104
chr1	25890385	26090385	harbor1	chr1	25943550	25944050	LTR/ERV1	2680	+	250	25943800	53415
chr1	199209208	199409208	harbor1	chr1	199269959	199270584	LTR/ERV1	2952	+	312	199270271	61063
chr1	199209208	199409208	harbor1	chr1	199297219	199297599	LTR/ERV1	561	+	190	199297409	88201
chr1	38673487	38873487	harbor1	chr1	38725272	38725865	LTR/ERV1	4854	+	296	38725568	52081
chr1	38673487	38873487	harbor1	chr1	38761714	38761836	LTR/ERV1	725	+	61	38761775	88288
chr1	216396949	216596949	harbor1	chr1	216480766	216480973	LTR/ERV1	1133	+	104	216480870	83921
chr1	216396949	216596949	harbor1	chr1	216483902	216484418	LTR/ERV1	1494	+	258	216484160	87211
chr1	216396949	216596949	harbor1	chr1	216484421	216484870	LTR/ERV1	3019	+	224	216484645	87696
chr1	216396949	216596949	harbor1	chr1	216481088	216483697	LTR/ERV1	1731	+	1304	216482392	85443
chr1	19764369	19964369	harbor1	chr1	19816706	19817158	LTR/ERV1	3379	+	226	19816932	52563
chr1	185302696	185502696	harbor1	chr1	185339498	185339948	LTR/ERV1	1616	+	225	185339723	37027
chr1	108874438	109074438	harbor1	chr1	108965740	108965824	LTR/ERV1	590	+	42	108965782	91344
chr1	108874438	109074438	harbor1	chr1	108966184	108966417	LTR/ERV1	1573	+	116	108966300	91862
chr1	108874438	109074438	harbor1	chr1	108968777	108968930	LTR/ERV1	4066	+	76	108968853	94415
chr1	108874438	109074438	harbor1	chr1	108969223	108969773	LTR/ERV1	4066	+	275	108969498	95060
chr1	115023293	115223293	harbor1	chr1	115028189	115028547	LTR/ERV1	1613	+	179	115028368	5075
chr1	115023293	115223293	harbor1	chr1	115117405	115117989	LTR/ERV1	3177	+	292	115117697	94404
chr1	3030817	3230817	harbor1	chr1	3036644	3036789	LTR/ERV1	550	+	72	3036716	5899
chr1	33130703	33330703	harbor1	chr1	33143818	33144132	LTR/ERV1	2937	+	157	33143975	13272
chr1	33130703	33330703	harbor1	chr1	33144436	33144660	LTR/ERV1	2937	+	112	33144548	13845
chr1	247863749	248063749	harbor1	chr1	247908787	247909009	LTR/ERV1	1006	+	111	247908898	45149
chr1	247863749	248063749	harbor1	chr1	247942219	247942399	LTR/ERV1	426	+	90	247942309	78560
chr1	247863749	248063749	harbor1	chr1	247953570	247954169	LTR/ERV1	2339	+	300	247953870	90121
chr1	89888525	90088525	harbor1	chr1	89912336	89912639	LTR/ERV1	1244	+	152	89912488	23963
chr1	89888525	90088525	harbor1	chr1	89952738	89953657	LTR/ERV1	3799	+	460	89953198	64673
chr1	89888525	90088525	harbor1	chr1	89955198	89955825	LTR/ERV1	2987	+	314	89955512	66987
chr1	89888525	90088525	harbor1	chr1	89965868	89966129	LTR/ERV1	2144	+	130	89965998	77473
chr1	89888525	90088525	harbor1	chr1	89966458	89966814	LTR/ERV1	2144	+	178	89966636	78111
chr1	165988721	166188721	harbor1	chr1	166035957	166036099	LTR/ERV1	647	+	71	166036028	47307
chr1	75177820	75377820	harbor1	chr1	75187725	75188130	LTR/ERV1	960	+	202	75187927	10107
chr1	75177820	75377820	harbor1	chr1	75252531	75253502	LTR/ERV1	1912	+	486	75253017	75197
chr1	99027199	99227199	harbor1	chr1	99122166	99122578	LTR/ERV1	2220	+	206	99122372	95173
chr1	7395	207395	harbor1	chr1	91678	92110	LTR/ERV1	883	+	216	91894	84499
chr1	234961020	235161020	harbor1	chr1	234985850	234985933	LTR/ERV1	2289	+	42	234985892	24872
chr1	234961020	235161020	harbor1	chr1	234986547	234987003	LTR/ERV1	2289	+	228	234986775	25755
chr1	234961020	235161020	harbor1	chr1	235047414	235047659	LTR/ERV1	474	+	122	235047536	86516
chr1	234961020	235161020	harbor1	chr1	235047919	235047974	LTR/ERV1	563	+	28	235047947	86927
chr1	234961020	235161020	harbor1	chr1	235048012	235048188	LTR/ERV1	563	+	88	235048100	87080
chr1	30654731	30854731	harbor1	chr1	30679222	30680836	LTR/ERV1	8566	+	807	30680029	25298
chr1	30654731	30854731	harbor1	chr1	30705667	30706161	LTR/ERV1	3063	+	247	30705914	51183
chr1	231241357	231441357	harbor1	chr1	231285145	231285294	LTR/ERV1	1084	+	74	231285219	43862
chr1	231241357	231441357	harbor1	chr1	231285994	231286262	LTR/ERV1	1084	+	134	231286128	44771
chr1	231241357	231441357	harbor1	chr1	231317286	231318194	LTR/ERV1	5358	+	454	231317740	76383
chr1	231241357	231441357	harbor1	chr1	231323115	231323706	LTR/ERV1	3436	+	296	231323411	82054
chr1	54878262	55078262	harbor1	chr1	54906017	54906465	LTR/ERV1	3234	+	224	54906241	27979
chr1	54878262	55078262	harbor1	chr1	54940337	54940708	LTR/ERV1	916	+	186	54940523	62261
chr1	54878262	55078262	harbor1	chr1	54952015	54952567	LTR/ERV1	4404	+	276	54952291	74029
chr1	54878262	55078262	harbor1	chr1	54955558	54955915	LTR/ERV1	2593	+	178	54955736	77474
chr1	54878262	55078262	harbor1	chr1	54955916	54957173	LTR/ERV1	7070	+	628	54956544	78282
chr1	54878262	55078262	harbor1	chr1	54957466	54957862	LTR/ERV1	1287	+	198	54957664	79402
chr1	54878262	55078262	harbor1	chr1	54957972	54958038	LTR/ERV1	418	+	33	54958005	79743
chr1	54878262	55078262	harbor1	chr1	54958039	54958447	LTR/ERV1	2362	+	204	54958243	79981
chr1	54878262	55078262	harbor1	chr1	54958448	54958741	LTR/ERV1	1679	+	146	54958594	80332
chr1	54878262	55078262	harbor1	chr1	54958744	54959694	LTR/ERV1	8158	+	475	54959219	80957
chr1	54878262	55078262	harbor1	chr1	54960003	54960522	LTR/ERV1	8158	+	260	54960263	82001
chr1	54878262	55078262	harbor1	chr1	54960505	54961005	LTR/ERV1	2468	+	250	54960755	82493
chr1	54878262	55078262	harbor1	chr1	54960985	54963581	LTR/ERV1	7415	+	1298	54962283	84021
chr1	54878262	55078262	harbor1	chr1	54963583	54963921	LTR/ERV1	2430	+	169	54963752	85490
chr1	213119578	213319578	harbor1	chr1	213207136	213207669	LTR/ERV1	1438	+	266	213207402	87824
chr1	213119578	213319578	harbor1	chr1	213207973	213208067	LTR/ERV1	1438	+	47	213208020	88442
chr1	189641690	189841690	harbor1	chr1	189656757	189657340	LTR/ERV1	1793	+	292	189657049	15359
chr1	189641690	189841690	harbor1	chr1	189662202	189662672	LTR/ERV1	3135	+	235	189662437	20747
chr1	189641690	189841690	harbor1	chr1	189676863	189677452	LTR/ERV1	1380	+	294	189677157	35467
chr1	189641690	189841690	harbor1	chr1	189721920	189722258	LTR/ERV1	2513	+	169	189722089	80399
chr1	189641690	189841690	harbor1	chr1	189722385	189722802	LTR/ERV1	3179	+	208	189722593	80903
chr1	89763762	89963762	harbor1	chr1	89768952	89769961	LTR/ERV1	1320	+	504	89769456	5694
chr1	89763762	89963762	harbor1	chr1	89799391	89799683	LTR/ERV1	557	+	146	89799537	35775
chr1	108896613	109096613	harbor1	chr1	108965740	108965824	LTR/ERV1	590	+	42	108965782	69169
chr1	108896613	109096613	harbor1	chr1	108966184	108966417	LTR/ERV1	1573	+	116	108966300	69687
chr1	108896613	109096613	harbor1	chr1	108968777	108968930	LTR/ERV1	4066	+	76	108968853	72240
chr1	108896613	109096613	harbor1	chr1	108969223	108969773	LTR/ERV1	4066	+	275	108969498	72885
chr1	100186916	100386916	harbor1	chr1	100256282	100256293	LTR/ERV1	1166	+	6	100256288	69372
chr1	100186916	100386916	harbor1	chr1	100256593	100256870	LTR/ERV1	1166	+	138	100256731	69815
chr1	88961134	89161134	harbor1	chr1	88974601	88975285	LTR/ERV1	4337	+	342	88974943	13809
chr1	88961134	89161134	harbor1	chr1	88984668	88985046	LTR/ERV1	996	+	189	88984857	23723
chr1	88961134	89161134	harbor1	chr1	89004767	89005234	LTR/ERV1	3806	+	234	89005001	43867
chr1	88961134	89161134	harbor1	chr1	89048082	89048835	LTR/ERV1	5595	+	376	89048458	87324
chr1	88961134	89161134	harbor1	chr1	89049147	89049432	LTR/ERV1	5595	+	142	89049289	88155
chr1	88961134	89161134	harbor1	chr1	89049433	89049754	LTR/ERV1	1438	+	160	89049593	88459
chr1	88961134	89161134	harbor1	chr1	89049989	89050423	LTR/ERV1	1066	+	217	89050206	89072
chr1	186223348	186423348	harbor1	chr1	186223611	186224240	LTR/ERV1	3723	+	314	186223925	577
chr1	186223348	186423348	harbor1	chr1	186224285	186227756	LTR/ERV1	11455	+	1736	186226021	2673
chr1	186223348	186423348	harbor1	chr1	186227757	186228279	LTR/ERV1	3879	+	261	186228018	4670
chr1	186223348	186423348	harbor1	chr1	186245243	186245836	LTR/ERV1	3946	+	296	186245539	22191
chr1	186223348	186423348	harbor1	chr1	186247525	186247983	LTR/ERV1	3592	+	229	186247754	24406
chr1	186223348	186423348	harbor1	chr1	186253773	186254121	LTR/ERV1	1384	+	174	186253947	30599
chr1	186223348	186423348	harbor1	chr1	186274355	186274934	LTR/ERV1	2339	+	290	186274645	51297
chr1	56585265	56785265	harbor1	chr1	56638141	56638613	LTR/ERV1	1954	+	236	56638377	53112
chr1	67190858	67390858	harbor1	chr1	67214743	67215224	LTR/ERV1	4032	+	240	67214983	24125
chr1	153703110	153903110	harbor1	chr1	153705544	153705809	LTR/ERV1	2497	+	132	153705676	2566
chr1	153703110	153903110	harbor1	chr1	153706113	153706136	LTR/ERV1	2497	+	12	153706125	3015
chr1	153703110	153903110	harbor1	chr1	153706445	153706649	LTR/ERV1	2497	+	102	153706547	3437
chr1	153703110	153903110	harbor1	chr1	153724123	153724251	LTR/ERV1	1347	+	64	153724187	21077
chr1	153703110	153903110	harbor1	chr1	153724559	153724768	LTR/ERV1	1347	+	104	153724663	21553
chr1	153703110	153903110	harbor1	chr1	153725060	153725078	LTR/ERV1	445	+	9	153725069	21959
chr1	153703110	153903110	harbor1	chr1	153785216	153785721	LTR/ERV1	2899	+	252	153785468	82358
chr1	153703110	153903110	harbor1	chr1	153785822	153785905	LTR/ERV1	2899	+	42	153785864	82754
chr1	101379637	101579637	harbor1	chr1	101445100	101445637	LTR/ERV1	3276	+	268	101445368	65731
chr1	101379637	101579637	harbor1	chr1	101445926	101445969	LTR/ERV1	3276	+	22	101445948	66311
chr1	101379637	101579637	harbor1	chr1	101447102	101447234	LTR/ERV1	762	+	66	101447168	67531
chr1	101379637	101579637	harbor1	chr1	101452500	101453194	LTR/ERV1	4124	+	347	101452847	73210
chr1	101379637	101579637	harbor1	chr1	101474942	101476188	LTR/ERV1	2432	+	623	101475565	95928
chr1	55790704	55990704	harbor1	chr1	55793728	55795000	LTR/ERV1	7078	+	636	55794364	3660
chr1	55790704	55990704	harbor1	chr1	55821555	55821919	LTR/ERV1	2346	+	182	55821737	31033
chr1	112505649	112705649	harbor1	chr1	112600374	112600435	LTR/ERV1	449	+	30	112600404	94755
chr1	210248530	210448530	harbor1	chr1	210278527	210279028	LTR/ERV1	3755	+	250	210278777	30247
chr1	210248530	210448530	harbor1	chr1	210280364	210280930	LTR/ERV1	3935	+	283	210280647	32117
chr1	210248530	210448530	harbor1	chr1	210297688	210298236	LTR/ERV1	4393	+	274	210297962	49432
chr1	210248530	210448530	harbor1	chr1	210344739	210345140	LTR/ERV1	780	+	200	210344939	96409
chr1	202931084	203131084	harbor1	chr1	203006140	203006595	LTR/ERV1	2724	+	228	203006368	75284
chr1	75750929	75950929	harbor1	chr1	75758507	75759210	LTR/ERV1	4482	+	352	75758859	7930
chr1	75750929	75950929	harbor1	chr1	75784944	75785027	LTR/ERV1	2138	+	42	75784986	34057
chr1	75750929	75950929	harbor1	chr1	75785301	75785895	LTR/ERV1	2138	+	297	75785598	34669
chr1	42260145	42460145	harbor1	chr1	42355933	42356012	LTR/ERV1	2446	+	40	42355973	95828
chr1	42260145	42460145	harbor1	chr1	42356311	42356345	LTR/ERV1	2446	+	17	42356328	96183
chr1	42260145	42460145	harbor1	chr1	42356636	42357250	LTR/ERV1	2446	+	307	42356943	96798
chr1	65160720	65360720	harbor1	chr1	65243241	65243468	LTR/ERV1	1456	+	114	65243355	82635
chr1	65160720	65360720	harbor1	chr1	65243469	65243626	LTR/ERV1	930	+	78	65243547	82827
chr1	55236310	55436310	harbor1	chr1	55326874	55326963	LTR/ERV1	505	+	44	55326918	90608
chr1	55236310	55436310	harbor1	chr1	55327078	55327626	LTR/ERV1	1374	+	274	55327352	91042
chr1	211863063	212063063	harbor1	chr1	211889365	211890718	LTR/ERV1	9291	+	676	211890041	26978
chr1	211863063	212063063	harbor1	chr1	211901228	211902959	LTR/ERV1	7601	+	866	211902094	39031
chr1	26872073	27072073	harbor1	chr1	26902004	26902564	LTR/ERV1	2420	+	280	26902284	30211
chr2	42685366	42885366	harbor1	chr2	42773497	42773583	LTR/ERV1	3339	+	43	42773540	88174
chr2	42685366	42885366	harbor1	chr2	42773889	42774281	LTR/ERV1	3339	+	196	42774085	88719
chr2	42685366	42885366	harbor1	chr2	42774283	42774966	LTR/ERV1	3331	+	342	42774625	89259
chr2	42685366	42885366	harbor1	chr2	42775270	42775945	LTR/ERV1	3331	+	338	42775608	90242
chr2	42685366	42885366	harbor1	chr2	42775981	42776231	LTR/ERV1	3331	+	125	42776106	90740
chr2	42685366	42885366	harbor1	chr2	42776538	42776625	LTR/ERV1	3331	+	44	42776582	91216
chr2	42685366	42885366	harbor1	chr2	42776931	42777019	LTR/ERV1	3331	+	44	42776975	91609
chr2	42685366	42885366	harbor1	chr2	42777334	42777484	LTR/ERV1	3331	+	75	42777409	92043
chr2	42685366	42885366	harbor1	chr2	42777615	42778335	LTR/ERV1	15506	+	360	42777975	92609
chr2	42685366	42885366	harbor1	chr2	42778628	42778839	LTR/ERV1	15506	+	106	42778734	93368
chr2	42685366	42885366	harbor1	chr2	42779129	42779330	LTR/ERV1	15506	+	100	42779229	93863
chr2	42685366	42885366	harbor1	chr2	42779619	42780197	LTR/ERV1	15506	+	289	42779908	94542
chr2	42685366	42885366	harbor1	chr2	42780505	42780785	LTR/ERV1	15506	+	140	42780645	95279
chr2	42685366	42885366	harbor1	chr2	42781086	42781590	LTR/ERV1	15506	+	252	42781338	95972
chr2	42685366	42885366	harbor1	chr2	42781888	42782558	LTR/ERV1	15506	+	335	42782223	96857
chr2	42685366	42885366	harbor1	chr2	42782566	42783034	LTR/ERV1	3570	+	234	42782800	97434
chr2	195754584	195954584	harbor1	chr2	195787466	195787789	LTR/ERV1	624	+	162	195787628	33044
chr2	195754584	195954584	harbor1	chr2	195787857	195788593	LTR/ERV1	1110	+	368	195788225	33641
chr2	195754584	195954584	harbor1	chr2	195811804	195811939	LTR/ERV1	908	+	68	195811872	57288
chr2	195754584	195954584	harbor1	chr2	195811937	195812391	LTR/ERV1	2138	+	227	195812164	57580
chr2	195754584	195954584	harbor1	chr2	195813221	195813847	LTR/ERV1	2908	+	313	195813534	58950
chr2	134657306	134857306	harbor1	chr2	134674306	134674340	LTR/ERV1	2699	+	17	134674323	17017
chr2	134657306	134857306	harbor1	chr2	134674658	134675084	LTR/ERV1	2699	+	213	134674871	17565
chr2	134657306	134857306	harbor1	chr2	134709622	134710256	LTR/ERV1	4002	+	317	134709939	52633
chr2	134657306	134857306	harbor1	chr2	134719934	134720560	LTR/ERV1	3526	+	313	134720247	62941
chr2	130910460	131110460	harbor1	chr2	130991265	130992700	LTR/ERV1	10155	+	718	130991983	81523
chr2	74265851	74465851	harbor1	chr2	74306089	74306553	LTR/ERV1	3185	+	232	74306321	40470
chr2	74265851	74465851	harbor1	chr2	74316353	74317269	LTR/ERV1	5882	+	458	74316811	50960
chr2	74265851	74465851	harbor1	chr2	74340703	74341022	LTR/ERV1	769	+	160	74340863	75012
chr2	74265851	74465851	harbor1	chr2	74341331	74341409	LTR/ERV1	769	+	39	74341370	75519
chr2	123280433	123480433	harbor1	chr2	123289798	123290369	LTR/ERV1	1602	+	286	123290084	9651
chr2	202190276	202390276	harbor1	chr2	202252204	202252727	LTR/ERV1	3459	+	262	202252466	62190
chr2	202190276	202390276	harbor1	chr2	202253034	202253180	LTR/ERV1	3459	+	73	202253107	62831
chr2	179468474	179668474	harbor1	chr2	179469110	179469189	LTR/ERV1	996	+	40	179469150	676
chr2	179468474	179668474	harbor1	chr2	179469413	179469498	LTR/ERV1	996	+	42	179469455	981
chr2	179468474	179668474	harbor1	chr2	179551303	179551894	LTR/ERV1	3909	+	296	179551599	83125
chr2	179468474	179668474	harbor1	chr2	179469499	179471049	LTR/ERV1	9940	+	775	179470274	1800
chr2	5327766	5527766	harbor1	chr2	5413213	5413378	LTR/ERV1	513	+	82	5413295	85529
chr2	5327766	5527766	harbor1	chr2	5413360	5413514	LTR/ERV1	453	+	77	5413437	85671
chr2	76301164	76501164	harbor1	chr2	76352891	76353288	LTR/ERV1	2445	+	198	76353089	51925
chr2	76301164	76501164	harbor1	chr2	76394551	76394971	LTR/ERV1	2027	+	210	76394761	93597
chr2	76301164	76501164	harbor1	chr2	76397173	76397958	LTR/ERV1	4494	+	392	76397565	96401
chr2	76301164	76501164	harbor1	chr2	76398209	76399121	LTR/ERV1	5397	+	456	76398665	97501
chr2	96046374	96246374	harbor1	chr2	96057548	96057944	LTR/ERV1	1639	+	198	96057746	11372
chr2	34728845	34928845	harbor1	chr2	34736773	34737161	LTR/ERV1	2749	+	194	34736967	8122
chr2	34728845	34928845	harbor1	chr2	34737814	34738257	LTR/ERV1	1756	+	222	34738036	9191
chr2	34728845	34928845	harbor1	chr2	34754718	34755329	LTR/ERV1	1699	+	306	34755024	26179
chr2	34728845	34928845	harbor1	chr2	34789819	34790227	LTR/ERV1	2464	+	204	34790023	61178
chr2	34728845	34928845	harbor1	chr2	34790230	34793109	LTR/ERV1	15127	+	1440	34791670	62825
chr2	34728845	34928845	harbor1	chr2	34793104	34793251	LTR/ERV1	911	+	74	34793178	64333
chr2	34728845	34928845	harbor1	chr2	34793244	34793739	LTR/ERV1	3184	+	248	34793492	64647
chr2	34728845	34928845	harbor1	chr2	34793742	34793927	LTR/ERV1	1182	+	92	34793834	64989
chr2	34728845	34928845	harbor1	chr2	34793914	34794525	LTR/ERV1	4258	+	306	34794220	65375
chr2	34728845	34928845	harbor1	chr2	34794499	34795638	LTR/ERV1	7579	+	570	34795069	66224
chr2	34728845	34928845	harbor1	chr2	34795645	34796056	LTR/ERV1	2752	+	206	34795851	67006
chr2	34728845	34928845	harbor1	chr2	34821921	34822540	LTR/ERV1	2911	+	310	34822231	93386
chr2	42870195	43070195	harbor1	chr2	42890305	42891005	LTR/ERV1	4880	+	350	42890655	20460
chr2	42870195	43070195	harbor1	chr2	42914612	42915249	LTR/ERV1	1762	+	318	42914930	44735
chr2	47026092	47226092	harbor1	chr2	47099550	47100979	LTR/ERV1	11001	+	714	47100264	74172
chr2	47026092	47226092	harbor1	chr2	47107098	47108582	LTR/ERV1	10706	+	742	47107840	81748
chr2	47026092	47226092	harbor1	chr2	47100980	47107096	LTR/ERV1	50763	+	3058	47104038	77946
chr2	193084609	193284609	harbor1	chr2	193109615	193110013	LTR/ERV1	915	+	199	193109814	25205
chr2	193084609	193284609	harbor1	chr2	193181750	193182213	LTR/ERV1	2314	+	232	193181982	97373
chr2	182216821	182416821	harbor1	chr2	182275514	182275948	LTR/ERV1	753	+	217	182275731	58910
chr2	7172265	7372265	harbor1	chr2	7227445	7227908	LTR/ERV1	1477	+	232	7227677	55412
chr2	7172265	7372265	harbor1	chr2	7228312	7228889	LTR/ERV1	2319	+	288	7228600	56335
chr2	7172265	7372265	harbor1	chr2	7229167	7229349	LTR/ERV1	1984	+	91	7229258	56993
chr2	7172265	7372265	harbor1	chr2	7229735	7229984	LTR/ERV1	1984	+	124	7229859	57594
chr2	213233812	213433812	harbor1	chr2	213262430	213262589	LTR/ERV1	583	+	80	213262510	28698
chr2	213233812	213433812	harbor1	chr2	213262890	213262954	LTR/ERV1	583	+	32	213262922	29110
chr2	213233812	213433812	harbor1	chr2	213265011	213265137	LTR/ERV1	2677	+	63	213265074	31262
chr2	213233812	213433812	harbor1	chr2	213265450	213265827	LTR/ERV1	2677	+	188	213265638	31826
chr2	31894075	32094075	harbor1	chr2	31945470	31946130	LTR/ERV1	3184	+	330	31945800	51725
chr2	223285718	223485718	harbor1	chr2	223357219	223357555	LTR/ERV1	1333	+	168	223357387	71669
chr2	223285718	223485718	harbor1	chr2	223380067	223380369	LTR/ERV1	759	+	151	223380218	94500
chr2	223285718	223485718	harbor1	chr2	223380483	223380506	LTR/ERV1	3232	+	12	223380495	94777
chr2	223285718	223485718	harbor1	chr2	223380608	223381859	LTR/ERV1	3232	+	626	223381234	95516
chr2	223285718	223485718	harbor1	chr2	223382139	223382185	LTR/ERV1	1646	+	23	223382162	96444
chr2	223285718	223485718	harbor1	chr2	223382204	223382504	LTR/ERV1	868	+	150	223382354	96636
chr2	67017761	67217761	harbor1	chr2	67104079	67104773	LTR/ERV1	3173	+	347	67104426	86665
chr2	67017761	67217761	harbor1	chr2	67106086	67106705	LTR/ERV1	3212	+	310	67106396	88635
chr2	9046979	9246979	harbor1	chr2	9075647	9076246	LTR/ERV1	3087	+	300	9075947	28968
chr2	9046979	9246979	harbor1	chr2	9076322	9076730	LTR/ERV1	2162	+	204	9076526	29547
chr2	9046979	9246979	harbor1	chr2	9077035	9077081	LTR/ERV1	2162	+	23	9077058	30079
chr2	119632942	119832942	harbor1	chr2	119710982	119711359	LTR/ERV1	645	+	188	119711170	78228
chr2	240602160	240802160	harbor1	chr2	240670154	240670797	LTR/ERV1	3723	+	322	240670476	68316
chr2	240602160	240802160	harbor1	chr2	240675220	240675538	LTR/ERV1	1191	+	159	240675379	73219
chr2	240602160	240802160	harbor1	chr2	240675579	240675754	LTR/ERV1	722	+	88	240675667	73507
chr2	240602160	240802160	harbor1	chr2	240688964	240689149	LTR/ERV1	879	+	92	240689056	86896
chr2	210185676	210385676	harbor1	chr2	210200949	210201339	LTR/ERV1	2720	+	195	210201144	15468
chr2	172205691	172405691	harbor1	chr2	172249320	172249706	LTR/ERV1	1851	+	193	172249513	43822
chr2	175396127	175596127	harbor1	chr2	175450926	175451372	LTR/ERV1	2596	+	223	175451149	55022
chr2	186224083	186424083	harbor1	chr2	186241175	186241517	LTR/ERV1	1600	+	171	186241346	17263
chr2	186224083	186424083	harbor1	chr2	186241834	186241992	LTR/ERV1	1600	+	79	186241913	17830
chr2	186224083	186424083	harbor1	chr2	186247746	186248152	LTR/ERV1	1209	+	203	186247949	23866
chr2	186224083	186424083	harbor1	chr2	186304549	186305006	LTR/ERV1	1016	+	228	186304777	80694
chr2	186224083	186424083	harbor1	chr2	186306445	186307324	LTR/ERV1	5263	+	440	186306885	82802
chr2	42217672	42417672	harbor1	chr2	42312240	42312557	LTR/ERV1	2615	+	158	42312398	94726
chr2	42217672	42417672	harbor1	chr2	42312853	42312946	LTR/ERV1	2615	+	46	42312899	95227
chr2	42217672	42417672	harbor1	chr2	42313255	42313440	LTR/ERV1	2615	+	92	42313347	95675
chr2	180612621	180812621	harbor1	chr2	180691205	180692425	LTR/ERV1	7781	+	610	180691815	79194
chr2	77766252	77966252	harbor1	chr2	77767238	77768256	LTR/ERV1	5217	+	509	77767747	1495
chr2	77766252	77966252	harbor1	chr2	77768557	77769399	LTR/ERV1	5217	+	421	77768978	2726
chr2	77766252	77966252	harbor1	chr2	77771133	77772021	LTR/ERV1	933	+	444	77771577	5325
chr2	77766252	77966252	harbor1	chr2	77805337	77805553	LTR/ERV1	1112	+	108	77805445	39193
chr2	77766252	77966252	harbor1	chr2	77806352	77806585	LTR/ERV1	1426	+	116	77806468	40216
chr2	77766252	77966252	harbor1	chr2	77807026	77807602	LTR/ERV1	5158	+	288	77807314	41062
chr2	77766252	77966252	harbor1	chr2	77808186	77808360	LTR/ERV1	5158	+	87	77808273	42021
chr2	77766252	77966252	harbor1	chr2	77829734	77830854	LTR/ERV1	2511	+	560	77830294	64042
chr2	77766252	77966252	harbor1	chr2	77830855	77831567	LTR/ERV1	4277	+	356	77831211	64959
chr2	77766252	77966252	harbor1	chr2	77831568	77833429	LTR/ERV1	11044	+	930	77832498	66246
chr2	77766252	77966252	harbor1	chr2	77833426	77834757	LTR/ERV1	5515	+	666	77834092	67840
chr2	77766252	77966252	harbor1	chr2	77834754	77835771	LTR/ERV1	6605	+	508	77835262	69010
chr2	77766252	77966252	harbor1	chr2	77835772	77836422	LTR/ERV1	2958	+	325	77836097	69845
chr2	77766252	77966252	harbor1	chr2	77837223	77839028	LTR/ERV1	6709	+	902	77838125	71873
chr2	77766252	77966252	harbor1	chr2	77839133	77839434	LTR/ERV1	1938	+	150	77839283	73031
chr2	77766252	77966252	harbor1	chr2	77839927	77840171	LTR/ERV1	1362	+	122	77840049	73797
chr2	77766252	77966252	harbor1	chr2	77857803	77858128	LTR/ERV1	1690	+	162	77857965	91713
chr2	77766252	77966252	harbor1	chr2	77859560	77859896	LTR/ERV1	1116	+	168	77859728	93476
chr2	77766252	77966252	harbor1	chr2	77860424	77860628	LTR/ERV1	810	+	102	77860526	94274
chr2	77766252	77966252	harbor1	chr2	77862860	77862995	LTR/ERV1	1385	+	68	77862928	96676
chr2	77766252	77966252	harbor1	chr2	77863260	77863570	LTR/ERV1	1385	+	155	77863415	97163
chr2	77766252	77966252	harbor1	chr2	77863979	77864503	LTR/ERV1	1075	+	262	77864241	97989
chr2	54616800	54816800	harbor1	chr2	54708540	54710604	LTR/ERV1	7884	+	1032	54709572	92772
chr2	126189980	126389980	harbor1	chr2	126221580	126222125	LTR/ERV1	2590	+	272	126221852	31872
chr2	126189980	126389980	harbor1	chr2	126255747	126255898	LTR/ERV1	2952	+	76	126255823	65843
chr2	126189980	126389980	harbor1	chr2	126256203	126256705	LTR/ERV1	2952	+	251	126256454	66474
chr2	57474039	57674039	harbor1	chr2	57524346	57524672	LTR/ERV1	1694	+	163	57524509	50470
chr2	57474039	57674039	harbor1	chr2	57534024	57534565	LTR/ERV1	1796	+	270	57534294	60255
chr2	57474039	57674039	harbor1	chr2	57550816	57551557	LTR/ERV1	4046	+	370	57551186	77147
chr2	113499345	113699345	harbor1	chr2	113508186	113508307	LTR/ERV1	503	+	60	113508246	8901
chr2	113499345	113699345	harbor1	chr2	113523289	113523687	LTR/ERV1	2438	+	199	113523488	24143
chr2	38135666	38335666	harbor1	chr2	38149801	38150040	LTR/ERV1	1036	+	120	38149921	14255
chr2	38135666	38335666	harbor1	chr2	38157482	38158095	LTR/ERV1	3372	+	306	38157788	22122
chr2	133408711	133608711	harbor1	chr2	133494500	133495336	LTR/ERV1	5078	+	418	133494918	86207
chr2	240571283	240771283	harbor1	chr2	240670154	240670797	LTR/ERV1	3723	+	322	240670476	99193
chr2	135188054	135388054	harbor1	chr2	135255101	135255257	LTR/ERV1	1490	+	78	135255179	67125
chr2	135188054	135388054	harbor1	chr2	135255295	135255566	LTR/ERV1	1490	+	136	135255431	67377
chr2	135188054	135388054	harbor1	chr2	135256668	135257308	LTR/ERV1	3985	+	320	135256988	68934
chr2	135188054	135388054	harbor1	chr2	135258294	135258598	LTR/ERV1	1360	+	152	135258446	70392
chr2	135188054	135388054	harbor1	chr2	135265839	135265928	LTR/ERV1	613	+	44	135265883	77829
chr2	135188054	135388054	harbor1	chr2	135266781	135267121	LTR/ERV1	2584	+	170	135266951	78897
chr2	135188054	135388054	harbor1	chr2	135280791	135281231	LTR/ERV1	1946	+	220	135281011	92957
chr2	135188054	135388054	harbor1	chr2	135266211	135266484	LTR/ERV1	2584	+	136	135266347	78293
chr2	129053548	129253548	harbor1	chr2	129074966	129075092	LTR/ERV1	723	+	63	129075029	21481
chr2	129053548	129253548	harbor1	chr2	129081867	129082393	LTR/ERV1	3166	+	263	129082130	28582
chr2	129053548	129253548	harbor1	chr2	129085765	129086667	LTR/ERV1	5122	+	451	129086216	32668
chr2	129053548	129253548	harbor1	chr2	129091950	129092024	LTR/ERV1	456	+	37	129091987	38439
chr2	129053548	129253548	harbor1	chr2	129093073	129093440	LTR/ERV1	1608	+	184	129093257	39709
chr2	129053548	129253548	harbor1	chr2	129128127	129128600	LTR/ERV1	2951	+	236	129128363	74815
chr2	129053548	129253548	harbor1	chr2	129128601	129134153	LTR/ERV1	19995	+	2776	129131377	77829
chr2	129053548	129253548	harbor1	chr2	129134153	129134243	LTR/ERV1	558	+	45	129134198	80650
chr2	129053548	129253548	harbor1	chr2	129134244	129134739	LTR/ERV1	3153	+	248	129134492	80944
chr2	129053548	129253548	harbor1	chr2	129071999	129074963	LTR/ERV1	12390	+	1482	129073481	19933
chr2	197030827	197230827	harbor1	chr2	197040743	197040993	LTR/ERV1	884	+	125	197040868	10041
chr2	197030827	197230827	harbor1	chr2	197085355	197085907	LTR/ERV1	4313	+	276	197085631	54804
chr2	197030827	197230827	harbor1	chr2	197090563	197091411	LTR/ERV1	4619	+	424	197090987	60160
chr2	85148037	85348037	harbor1	chr2	85155146	85155518	LTR/ERV1	2649	+	186	85155332	7295
chr2	134175196	134375196	harbor1	chr2	134179726	134180337	LTR/ERV1	3921	+	306	134180032	4836
chr2	134175196	134375196	harbor1	chr2	134229209	134229543	LTR/ERV1	1055	+	167	134229376	54180
chr2	51238493	51438493	harbor1	chr2	51324930	51325616	LTR/ERV1	3745	+	343	51325273	86780
chr2	51238493	51438493	harbor1	chr2	51327154	51327654	LTR/ERV1	2088	+	250	51327404	88911
chr2	32320790	32520790	harbor1	chr2	32353519	32353819	LTR/ERV1	2029	+	150	32353669	32879
chr2	32320790	32520790	harbor1	chr2	32354569	32354705	LTR/ERV1	529	+	68	32354637	33847
chr2	32320790	32520790	harbor1	chr2	32355092	32355330	LTR/ERV1	1541	+	119	32355211	34421
chr2	32320790	32520790	harbor1	chr2	32355653	32355800	LTR/ERV1	1541	+	74	32355727	34937
chr2	156906539	157106539	harbor1	chr2	156934007	156934551	LTR/ERV1	3743	+	272	156934279	27740
chr2	156906539	157106539	harbor1	chr2	156984336	156984384	LTR/ERV1	1187	+	24	156984360	77821
chr2	156906539	157106539	harbor1	chr2	156985000	156985178	LTR/ERV1	1187	+	89	156985089	78550
chr2	141960446	142160446	harbor1	chr2	141997126	141997415	LTR/ERV1	3522	+	144	141997270	36824
chr2	141960446	142160446	harbor1	chr2	141997471	141997481	LTR/ERV1	3522	+	5	141997476	37030
chr2	141960446	142160446	harbor1	chr2	141997647	141998303	LTR/ERV1	3522	+	328	141997975	37529
chr2	141960446	142160446	harbor1	chr2	142013779	142014289	LTR/ERV1	3773	+	255	142014034	53588
chr2	215896575	216096575	harbor1	chr2	215908884	215909170	LTR/ERV1	1452	+	143	215909027	12452
chr2	215896575	216096575	harbor1	chr2	215909171	215909860	LTR/ERV1	2987	+	344	215909515	12940
chr2	215896575	216096575	harbor1	chr2	215909861	215910115	LTR/ERV1	1452	+	127	215909988	13413
chr2	215896575	216096575	harbor1	chr2	215915787	215916179	LTR/ERV1	1499	+	196	215915983	19408
chr2	215896575	216096575	harbor1	chr2	215916343	215917031	LTR/ERV1	3117	+	344	215916687	20112
chr2	215896575	216096575	harbor1	chr2	215922303	215922755	LTR/ERV1	3468	+	226	215922529	25954
chr2	215896575	216096575	harbor1	chr2	215925774	215925923	LTR/ERV1	992	+	74	215925848	29273
chr2	215896575	216096575	harbor1	chr2	215925914	215926418	LTR/ERV1	3508	+	252	215926166	29591
chr2	215896575	216096575	harbor1	chr2	215926421	215927082	LTR/ERV1	4501	+	330	215926751	30176
chr2	215896575	216096575	harbor1	chr2	215927084	215927295	LTR/ERV1	1222	+	106	215927190	30615
chr2	215896575	216096575	harbor1	chr2	215927298	215927673	LTR/ERV1	2518	+	188	215927486	30911
chr2	215896575	216096575	harbor1	chr2	215927674	215928126	LTR/ERV1	3554	+	226	215927900	31325
chr2	215896575	216096575	harbor1	chr2	215922758	215925794	LTR/ERV1	20938	+	1518	215924276	27701
chr2	153839918	154039918	harbor1	chr2	153871945	153872268	LTR/ERV1	2067	+	162	153872107	32189
chr2	153839918	154039918	harbor1	chr2	153872338	153872429	LTR/ERV1	478	+	46	153872384	32466
chr2	238638661	238838661	harbor1	chr2	238668921	238669331	LTR/ERV1	2751	+	205	238669126	30465
chr2	106178080	106378080	harbor1	chr2	106203492	106203617	LTR/ERV1	650	+	62	106203554	25474
chr2	106178080	106378080	harbor1	chr2	106209214	106209713	LTR/ERV1	3615	+	250	106209464	31384
chr2	106178080	106378080	harbor1	chr2	106209714	106211221	LTR/ERV1	9582	+	754	106210468	32388
chr2	106178080	106378080	harbor1	chr2	106211193	106214401	LTR/ERV1	29979	+	1604	106212797	34717
chr2	106178080	106378080	harbor1	chr2	106214708	106215025	LTR/ERV1	29979	+	158	106214866	36786
chr2	106178080	106378080	harbor1	chr2	106215049	106215331	LTR/ERV1	2308	+	141	106215190	37110
chr2	106178080	106378080	harbor1	chr2	106215334	106215676	LTR/ERV1	2486	+	171	106215505	37425
chr2	106178080	106378080	harbor1	chr2	106272367	106272745	LTR/ERV1	1258	+	189	106272556	94476
chr2	143531667	143731667	harbor1	chr2	143612576	143612659	LTR/ERV1	420	+	42	143612618	80951
chr2	75734051	75934051	harbor1	chr2	75768424	75768748	LTR/ERV1	842	+	162	75768586	34535
chr2	75734051	75934051	harbor1	chr2	75769838	75770289	LTR/ERV1	927	+	226	75770064	36013
chr2	75734051	75934051	harbor1	chr2	75772458	75772864	LTR/ERV1	1521	+	203	75772661	38610
chr2	16677378	16877378	harbor1	chr2	16763343	16763649	LTR/ERV1	446	+	153	16763496	86118
chr2	132259605	132459605	harbor1	chr2	132338200	132338353	LTR/ERV1	786	+	76	132338276	78671
chr2	132259605	132459605	harbor1	chr2	132338487	132338693	LTR/ERV1	786	+	103	132338590	78985
chr2	132259605	132459605	harbor1	chr2	132356059	132356269	LTR/ERV1	744	+	105	132356164	96559
chr2	51998752	52198752	harbor1	chr2	52006430	52006616	LTR/ERV1	5074	+	93	52006523	7771
chr2	51998752	52198752	harbor1	chr2	52006617	52008014	LTR/ERV1	9360	+	698	52007315	8563
chr2	51998752	52198752	harbor1	chr2	52008015	52008589	LTR/ERV1	5074	+	287	52008302	9550
chr2	51998752	52198752	harbor1	chr2	52034628	52035223	LTR/ERV1	1078	+	298	52034926	36174
chr2	51998752	52198752	harbor1	chr2	52036903	52037183	LTR/ERV1	2284	+	140	52037043	38291
chr2	51998752	52198752	harbor1	chr2	52037309	52037652	LTR/ERV1	2284	+	172	52037481	38729
chr2	51998752	52198752	harbor1	chr2	52038044	52038490	LTR/ERV1	3047	+	223	52038267	39515
chr2	51998752	52198752	harbor1	chr2	52075646	52076077	LTR/ERV1	2365	+	216	52075862	77110
chr2	136701314	136901314	harbor1	chr2	136758283	136759679	LTR/ERV1	10124	+	698	136758981	57667
chr2	100058832	100258832	harbor1	chr2	100061603	100061968	LTR/ERV1	492	+	182	100061785	2953
chr2	100058832	100258832	harbor1	chr2	100121057	100121376	LTR/ERV1	2147	+	160	100121217	62385
chr2	100058832	100258832	harbor1	chr2	100127795	100128348	LTR/ERV1	4480	+	276	100128071	69239
chr2	175304281	175504281	harbor1	chr2	175325433	175326199	LTR/ERV1	5884	+	383	175325816	21535
chr2	175304281	175504281	harbor1	chr2	175326204	175326529	LTR/ERV1	2607	+	162	175326366	22085
chr2	175304281	175504281	harbor1	chr2	175325143	175325441	LTR/ERV1	2280	+	149	175325292	21011
chr2	122667344	122867344	harbor1	chr2	122706466	122707254	LTR/ERV1	3044	+	394	122706860	39516
chr2	122667344	122867344	harbor1	chr2	122725301	122726108	LTR/ERV1	3827	+	404	122725705	58361
chr2	122667344	122867344	harbor1	chr2	122736061	122736718	LTR/ERV1	3493	+	328	122736389	69045
chr2	122667344	122867344	harbor1	chr2	122736753	122737531	LTR/ERV1	5007	+	389	122737142	69798
chr2	193116264	193316264	harbor1	chr2	193181750	193182213	LTR/ERV1	2314	+	232	193181982	65718
chr2	193116264	193316264	harbor1	chr2	193199698	193200140	LTR/ERV1	1303	+	221	193199919	83655
chr2	35496028	35696028	harbor1	chr2	35555226	35555655	LTR/ERV1	3233	+	214	35555440	59412
chr2	35496028	35696028	harbor1	chr2	35556031	35556277	LTR/ERV1	3233	+	123	35556154	60126
chr2	48791628	48991628	harbor1	chr2	48814769	48815233	LTR/ERV1	761	+	232	48815001	23373
chr2	48791628	48991628	harbor1	chr2	48847819	48847989	LTR/ERV1	599	+	85	48847904	56276
chr2	119697662	119897662	harbor1	chr2	119710982	119711359	LTR/ERV1	645	+	188	119711170	13508
chr2	101511528	101711528	harbor1	chr2	101516136	101516212	LTR/ERV1	3096	+	38	101516174	4646
chr2	101511528	101711528	harbor1	chr2	101516510	101516977	LTR/ERV1	3096	+	234	101516744	5216
chr2	101511528	101711528	harbor1	chr2	101544857	101545313	LTR/ERV1	1349	+	228	101545085	33557
chr2	101511528	101711528	harbor1	chr2	101599827	101600284	LTR/ERV1	2615	+	228	101600055	88527
chr2	229075680	229275680	harbor1	chr2	229080735	229081190	LTR/ERV1	2404	+	228	229080963	5283
chr2	97556787	97756787	harbor1	chr2	97613637	97614033	LTR/ERV1	1606	+	198	97613835	57048
chr2	68201057	68401057	harbor1	chr2	68240147	68240432	LTR/ERV1	903	+	142	68240289	39232
chr2	151242934	151442934	harbor1	chr2	151243575	151244008	LTR/ERV1	2596	+	216	151243791	857
chr2	151242934	151442934	harbor1	chr2	151246539	151246643	LTR/ERV1	726	+	52	151246591	3657
chr2	151242934	151442934	harbor1	chr2	151286443	151286997	LTR/ERV1	1868	+	277	151286720	43786
chr2	151242934	151442934	harbor1	chr2	151295825	151297378	LTR/ERV1	12073	+	776	151296601	53667
chr2	151242934	151442934	harbor1	chr2	151309068	151309482	LTR/ERV1	3144	+	207	151309275	66341
chr2	151242934	151442934	harbor1	chr2	151309483	151309948	LTR/ERV1	2808	+	232	151309715	66781
chr2	151242934	151442934	harbor1	chr2	151310007	151312257	LTR/ERV1	13516	+	1125	151311132	68198
chr2	151242934	151442934	harbor1	chr2	151312237	151313972	LTR/ERV1	5566	+	868	151313105	70171
chr2	151242934	151442934	harbor1	chr2	151314001	151314269	LTR/ERV1	1553	+	134	151314135	71201
chr2	151242934	151442934	harbor1	chr2	151314263	151314798	LTR/ERV1	2853	+	268	151314531	71597
chr2	151242934	151442934	harbor1	chr2	151314799	151315223	LTR/ERV1	3389	+	212	151315011	72077
chr2	29297023	29497023	harbor1	chr2	29299600	29300266	LTR/ERV1	2830	+	333	29299933	2910
chr2	29297023	29497023	harbor1	chr2	29300575	29301085	LTR/ERV1	2830	+	255	29300830	3807
chr2	29297023	29497023	harbor1	chr2	29352807	29353248	LTR/ERV1	2553	+	220	29353027	56004
chr2	29297023	29497023	harbor1	chr2	29375858	29376325	LTR/ERV1	3026	+	234	29376092	79069
chr2	29297023	29497023	harbor1	chr2	29393172	29393769	LTR/ERV1	1858	+	298	29393470	96447
chr2	29297023	29497023	harbor1	chr2	29395471	29396093	LTR/ERV1	2969	+	311	29395782	98759
chr2	29209915	29409915	harbor1	chr2	29299600	29300266	LTR/ERV1	2830	+	333	29299933	90018
chr2	29209915	29409915	harbor1	chr2	29300575	29301085	LTR/ERV1	2830	+	255	29300830	90915
chr2	196352248	196552248	harbor1	chr2	196353559	196354521	LTR/ERV1	3256	+	481	196354040	1792
chr2	139121758	139321758	harbor1	chr2	139128283	139128510	LTR/ERV1	1588	+	114	139128397	6639
chr2	171794890	171994890	harbor1	chr2	171827382	171827789	LTR/ERV1	1351	+	204	171827586	32696
chr2	171794890	171994890	harbor1	chr2	171827790	171827877	LTR/ERV1	436	+	44	171827834	32944
chr2	171794890	171994890	harbor1	chr2	171827949	171828389	LTR/ERV1	2788	+	220	171828169	33279
chr2	171794890	171994890	harbor1	chr2	171828706	171830109	LTR/ERV1	7039	+	702	171829408	34518
chr2	171794890	171994890	harbor1	chr2	171831120	171831391	LTR/ERV1	1570	+	136	171831256	36366
chr2	171794890	171994890	harbor1	chr2	171831399	171831614	LTR/ERV1	1048	+	108	171831507	36617
chr2	171794890	171994890	harbor1	chr2	171832261	171833335	LTR/ERV1	1678	+	537	171832798	37908
chr2	171794890	171994890	harbor1	chr2	171874836	171875423	LTR/ERV1	3074	+	294	171875130	80240
chr2	239906963	240106963	harbor1	chr2	239917169	239917860	LTR/ERV1	4362	+	346	239917515	10552
chr2	96196591	96396591	harbor1	chr2	96209232	96209895	LTR/ERV1	4272	+	332	96209564	12973
chr2	96196591	96396591	harbor1	chr2	96209896	96210670	LTR/ERV1	4553	+	387	96210283	13692
chr2	96196591	96396591	harbor1	chr2	96211062	96211338	LTR/ERV1	5717	+	138	96211200	14609
chr2	96196591	96396591	harbor1	chr2	96211635	96212218	LTR/ERV1	5717	+	292	96211927	15336
chr2	96196591	96396591	harbor1	chr2	96212219	96212733	LTR/ERV1	4302	+	257	96212476	15885
chr2	96196591	96396591	harbor1	chr2	96213032	96213050	LTR/ERV1	4302	+	9	96213041	16450
chr2	96196591	96396591	harbor1	chr2	96213351	96213514	LTR/ERV1	4302	+	82	96213433	16842
chr2	116604199	116804199	harbor1	chr2	116612550	116612629	LTR/ERV1	549	+	40	116612590	8391
chr2	116604199	116804199	harbor1	chr2	116612633	116612774	LTR/ERV1	2242	+	70	116612703	8504
chr2	116604199	116804199	harbor1	chr2	116612977	116613339	LTR/ERV1	2242	+	181	116613158	8959
chr2	133978193	134178193	harbor1	chr2	134006629	134007066	LTR/ERV1	2771	+	218	134006847	28654
chr2	131471511	131671511	harbor1	chr2	131473879	131474102	LTR/ERV1	1064	+	112	131473991	2480
chr2	131471511	131671511	harbor1	chr2	131474827	131474968	LTR/ERV1	690	+	70	131474897	3386
chr2	131471511	131671511	harbor1	chr2	131475281	131475318	LTR/ERV1	690	+	18	131475299	3788
chr2	131471511	131671511	harbor1	chr2	131523645	131524202	LTR/ERV1	3196	+	278	131523923	52412
chr2	131471511	131671511	harbor1	chr2	131548084	131548354	LTR/ERV1	1427	+	135	131548219	76708
chr2	131471511	131671511	harbor1	chr2	131548347	131548590	LTR/ERV1	798	+	122	131548469	76958
chr2	131471511	131671511	harbor1	chr2	131548611	131549045	LTR/ERV1	2086	+	217	131548828	77317
chr2	131471511	131671511	harbor1	chr2	131558160	131558366	LTR/ERV1	1089	+	103	131558263	86752
chr2	131471511	131671511	harbor1	chr2	131558345	131558689	LTR/ERV1	998	+	172	131558517	87006
chr2	131471511	131671511	harbor1	chr2	131558716	131558922	LTR/ERV1	3659	+	103	131558819	87308
chr2	131471511	131671511	harbor1	chr2	131559620	131560099	LTR/ERV1	3659	+	240	131559860	88349
chr2	131471511	131671511	harbor1	chr2	131560304	131560848	LTR/ERV1	2204	+	272	131560576	89065
chr2	131471511	131671511	harbor1	chr2	131560852	131561401	LTR/ERV1	3013	+	274	131561126	89615
chr2	131471511	131671511	harbor1	chr2	131563807	131564240	LTR/ERV1	2849	+	216	131564023	92512
chr2	131471511	131671511	harbor1	chr2	131561851	131563804	LTR/ERV1	10109	+	976	131562827	91316
chr2	123099682	123299682	harbor1	chr2	123162453	123162623	LTR/ERV1	461	+	85	123162538	62856
chr2	189580564	189780564	harbor1	chr2	189650676	189651199	LTR/ERV1	3453	+	262	189650938	70374
chr2	189580564	189780564	harbor1	chr2	189657396	189657625	LTR/ERV1	1260	+	114	189657510	76946
chr2	23166736	23366736	harbor1	chr2	23199657	23200189	LTR/ERV1	2852	+	266	23199923	33187
chr2	78965850	79165850	harbor1	chr2	79051400	79051798	LTR/ERV1	2574	+	199	79051599	85749
chr2	78965850	79165850	harbor1	chr2	79054773	79054920	LTR/ERV1	776	+	74	79054847	88997
chr2	78965850	79165850	harbor1	chr2	79054911	79055413	LTR/ERV1	3201	+	251	79055162	89312
chr2	78965850	79165850	harbor1	chr2	79055416	79056078	LTR/ERV1	4199	+	331	79055747	89897
chr2	78965850	79165850	harbor1	chr2	79056080	79056296	LTR/ERV1	1318	+	108	79056188	90338
chr2	78965850	79165850	harbor1	chr2	79056297	79056673	LTR/ERV1	2241	+	188	79056485	90635
chr2	78965850	79165850	harbor1	chr2	79056674	79057072	LTR/ERV1	2381	+	199	79056873	91023
chr2	78965850	79165850	harbor1	chr2	79051801	79054778	LTR/ERV1	19165	+	1488	79053289	87439
chr2	180210023	180410023	harbor1	chr2	180231677	180232443	LTR/ERV1	4970	+	383	180232060	22037
chr2	180210023	180410023	harbor1	chr2	180232468	180232763	LTR/ERV1	2091	+	148	180232616	22593
chr2	180210023	180410023	harbor1	chr2	180232759	180233124	LTR/ERV1	2980	+	182	180232941	22918
chr2	180210023	180410023	harbor1	chr2	180234679	180235457	LTR/ERV1	6188	+	389	180235068	25045
chr2	180210023	180410023	harbor1	chr2	180235443	180236851	LTR/ERV1	17372	+	704	180236147	26124
chr2	180210023	180410023	harbor1	chr2	180237438	180238191	LTR/ERV1	17372	+	376	180237814	27791
chr2	180210023	180410023	harbor1	chr2	180238180	180238247	LTR/ERV1	515	+	34	180238214	28191
chr2	180210023	180410023	harbor1	chr2	180238241	180238533	LTR/ERV1	2290	+	146	180238387	28364
chr2	180210023	180410023	harbor1	chr2	180238534	180239319	LTR/ERV1	5090	+	392	180238926	28903
chr2	97660687	97860687	harbor1	chr2	97667732	97667876	LTR/ERV1	527	+	72	97667804	7117
chr2	97660687	97860687	harbor1	chr2	97753054	97753581	LTR/ERV1	2170	+	264	97753318	92631
chr2	1932616	2132616	harbor1	chr2	1992581	1993256	LTR/ERV1	5128	+	338	1992919	60303
chr2	1932616	2132616	harbor1	chr2	2007724	2008400	LTR/ERV1	3099	+	338	2008062	75446
chr2	1932616	2132616	harbor1	chr2	2022555	2022706	LTR/ERV1	939	+	76	2022631	90015
chr2	186156725	186356725	harbor1	chr2	186190716	186190875	LTR/ERV1	998	+	80	186190796	34071
chr2	186156725	186356725	harbor1	chr2	186191718	186192015	LTR/ERV1	1143	+	148	186191866	35141
chr2	186156725	186356725	harbor1	chr2	186241175	186241517	LTR/ERV1	1600	+	171	186241346	84621
chr2	186156725	186356725	harbor1	chr2	186241834	186241992	LTR/ERV1	1600	+	79	186241913	85188
chr2	186156725	186356725	harbor1	chr2	186247746	186248152	LTR/ERV1	1209	+	203	186247949	91224
chr2	51308644	51508644	harbor1	chr2	51324930	51325616	LTR/ERV1	3745	+	343	51325273	16629
chr2	51308644	51508644	harbor1	chr2	51327154	51327654	LTR/ERV1	2088	+	250	51327404	18760
chr2	230923629	231123629	harbor1	chr2	230937444	230937633	LTR/ERV1	927	+	94	230937538	13909
chr2	230923629	231123629	harbor1	chr2	230969245	230969781	LTR/ERV1	3525	+	268	230969513	45884
chr2	230923629	231123629	harbor1	chr2	230976884	230977470	LTR/ERV1	2241	+	293	230977177	53548
chr2	230923629	231123629	harbor1	chr2	231017671	231017924	LTR/ERV1	906	+	126	231017797	94168
chr2	230923629	231123629	harbor1	chr2	231018308	231018630	LTR/ERV1	687	+	161	231018469	94840
chr2	230923629	231123629	harbor1	chr2	231019817	231020456	LTR/ERV1	2344	+	320	231020137	96508
chr2	230923629	231123629	harbor1	chr2	231013990	231014532	LTR/ERV1	851	+	271	231014261	90632
chr2	161896896	162096896	harbor1	chr2	161914860	161915824	LTR/ERV1	3692	+	482	161915342	18446
chr2	161896896	162096896	harbor1	chr2	161918715	161920288	LTR/ERV1	7706	+	786	161919501	22605
chr2	161896896	162096896	harbor1	chr2	161987002	161987178	LTR/ERV1	833	+	88	161987090	90194
chr2	179500518	179700518	harbor1	chr2	179551303	179551894	LTR/ERV1	3909	+	296	179551599	51081
chr2	229902204	230102204	harbor1	chr2	229992955	229993351	LTR/ERV1	3076	+	198	229993153	90949
chr2	232974640	233174640	harbor1	chr2	232981152	232981880	LTR/ERV1	3374	+	364	232981516	6876
chr2	232974640	233174640	harbor1	chr2	233028276	233028471	LTR/ERV1	4826	+	98	233028374	53734
chr2	232974640	233174640	harbor1	chr2	233028752	233029099	LTR/ERV1	4826	+	174	233028926	54286
chr2	232974640	233174640	harbor1	chr2	233029389	233029782	LTR/ERV1	4826	+	196	233029585	54945
chr2	117164905	117364905	harbor1	chr2	117213537	117214106	LTR/ERV1	3352	+	284	117213821	48916
chr2	3334893	3534893	harbor1	chr2	3356784	3357328	LTR/ERV1	3253	+	272	3357056	22163
chr2	3334893	3534893	harbor1	chr2	3357386	3357814	LTR/ERV1	3350	+	214	3357600	22707
chr2	125467540	125667540	harbor1	chr2	125497452	125497569	LTR/ERV1	538	+	58	125497510	29970
chr2	125467540	125667540	harbor1	chr2	125554629	125554870	LTR/ERV1	989	+	120	125554749	87209
chr2	18668350	18868350	harbor1	chr2	18715448	18715885	LTR/ERV1	1497	+	218	18715666	47316
chr2	18668350	18868350	harbor1	chr2	18716554	18716892	LTR/ERV1	1040	+	169	18716723	48373
chr2	148754121	148954121	harbor1	chr2	148814479	148815177	LTR/ERV1	1624	+	349	148814828	60707
chr2	115845966	116045966	harbor1	chr2	115848054	115848762	LTR/ERV1	3471	+	354	115848408	2442
chr2	96692602	96892602	harbor1	chr2	96750722	96750898	LTR/ERV1	643	+	88	96750810	58208
chr2	96692602	96892602	harbor1	chr2	96752227	96752402	LTR/ERV1	477	+	88	96752315	59713
chr2	204903500	205103500	harbor1	chr2	204914026	204914359	LTR/ERV1	1686	+	166	204914192	10692
chr2	204903500	205103500	harbor1	chr2	204983570	204984100	LTR/ERV1	1095	+	265	204983835	80335
chr2	116428871	116628871	harbor1	chr2	116467176	116467292	LTR/ERV1	433	+	58	116467234	38363
chr2	116428871	116628871	harbor1	chr2	116467844	116467929	LTR/ERV1	496	+	42	116467886	39015
chr2	116428871	116628871	harbor1	chr2	116471559	116472115	LTR/ERV1	760	+	278	116471837	42966
chr2	116428871	116628871	harbor1	chr2	116472665	116473211	LTR/ERV1	556	+	273	116472938	44067
chr2	116428871	116628871	harbor1	chr2	116474385	116474808	LTR/ERV1	495	+	212	116474597	45726
chr2	116428871	116628871	harbor1	chr2	116497326	116497882	LTR/ERV1	3854	+	278	116497604	68733
chr2	116428871	116628871	harbor1	chr2	116520794	116521170	LTR/ERV1	1858	+	188	116520982	92111
chr2	29361405	29561405	harbor1	chr2	29375858	29376325	LTR/ERV1	3026	+	234	29376092	14687
chr2	29361405	29561405	harbor1	chr2	29393172	29393769	LTR/ERV1	1858	+	298	29393470	32065
chr2	29361405	29561405	harbor1	chr2	29395471	29396093	LTR/ERV1	2969	+	311	29395782	34377
chr2	29361405	29561405	harbor1	chr2	29410158	29410561	LTR/ERV1	2773	+	202	29410360	48955
chr2	29361405	29561405	harbor1	chr2	29437332	29437864	LTR/ERV1	1995	+	266	29437598	76193
chr2	40631039	40831039	harbor1	chr2	40671993	40672552	LTR/ERV1	3953	+	280	40672273	41234
chr2	40631039	40831039	harbor1	chr2	40672553	40677063	LTR/ERV1	25534	+	2255	40674808	43769
chr2	40631039	40831039	harbor1	chr2	40677061	40677825	LTR/ERV1	6050	+	382	40677443	46404
chr2	40631039	40831039	harbor1	chr2	40677826	40678381	LTR/ERV1	3901	+	278	40678104	47065
chr2	40631039	40831039	harbor1	chr2	40718464	40718999	LTR/ERV1	1481	+	268	40718732	87693
chr2	40631039	40831039	harbor1	chr2	40725382	40726127	LTR/ERV1	830	+	372	40725754	94715
chr2	205975460	206175460	harbor1	chr2	205977058	205978429	LTR/ERV1	9711	+	686	205977744	2284
chr2	21302947	21502947	harbor1	chr2	21317606	21318633	LTR/ERV1	604	+	514	21318120	15173
chr2	21302947	21502947	harbor1	chr2	21331076	21331511	LTR/ERV1	1886	+	218	21331294	28347
chr2	21302947	21502947	harbor1	chr2	21354246	21354624	LTR/ERV1	2514	+	189	21354435	51488
chr2	191746117	191946117	harbor1	chr2	191799447	191799817	LTR/ERV1	1126	+	185	191799632	53515
chr2	19672922	19872922	harbor1	chr2	19725325	19725827	LTR/ERV1	2400	+	251	19725576	52654
chr2	238622783	238822783	harbor1	chr2	238668921	238669331	LTR/ERV1	2751	+	205	238669126	46343
chr2	76389566	76589566	harbor1	chr2	76394551	76394971	LTR/ERV1	2027	+	210	76394761	5195
chr2	76389566	76589566	harbor1	chr2	76397173	76397958	LTR/ERV1	4494	+	392	76397565	7999
chr2	76389566	76589566	harbor1	chr2	76402692	76403108	LTR/ERV1	2351	+	208	76402900	13334
chr2	76389566	76589566	harbor1	chr2	76403109	76403473	LTR/ERV1	1940	+	182	76403291	13725
chr2	76389566	76589566	harbor1	chr2	76403473	76403558	LTR/ERV1	3418	+	42	76403515	13949
chr2	76389566	76589566	harbor1	chr2	76403843	76404437	LTR/ERV1	3418	+	297	76404140	14574
chr2	76389566	76589566	harbor1	chr2	76404420	76405671	LTR/ERV1	11851	+	626	76405046	15480
chr2	76389566	76589566	harbor1	chr2	76405672	76406898	LTR/ERV1	5520	+	613	76406285	16719
chr2	76389566	76589566	harbor1	chr2	76406899	76407669	LTR/ERV1	11851	+	385	76407284	17718
chr2	76389566	76589566	harbor1	chr2	76410654	76411672	LTR/ERV1	4810	+	509	76411163	21597
chr2	76389566	76589566	harbor1	chr2	76411672	76411763	LTR/ERV1	619	+	46	76411718	22152
chr2	76389566	76589566	harbor1	chr2	76411764	76412210	LTR/ERV1	2351	+	223	76411987	22421
chr2	76389566	76589566	harbor1	chr2	76413450	76413901	LTR/ERV1	1228	+	226	76413676	24110
chr2	76389566	76589566	harbor1	chr2	76414993	76415380	LTR/ERV1	1799	+	194	76415187	25621
chr2	76389566	76589566	harbor1	chr2	76415487	76415769	LTR/ERV1	1650	+	141	76415628	26062
chr2	76389566	76589566	harbor1	chr2	76430484	76431002	LTR/ERV1	1776	+	259	76430743	41177
chr2	76389566	76589566	harbor1	chr2	76444773	76445172	LTR/ERV1	2364	+	200	76444973	55407
chr2	76389566	76589566	harbor1	chr2	76445392	76445484	LTR/ERV1	490	+	46	76445438	55872
chr2	76389566	76589566	harbor1	chr2	76453889	76454580	LTR/ERV1	3792	+	346	76454235	64669
chr2	76389566	76589566	harbor1	chr2	76471868	76472292	LTR/ERV1	2856	+	212	76472080	82514
chr2	76389566	76589566	harbor1	chr2	76472293	76472970	LTR/ERV1	4068	+	338	76472631	83065
chr2	76389566	76589566	harbor1	chr2	76472968	76473701	LTR/ERV1	3481	+	366	76473334	83768
chr2	76389566	76589566	harbor1	chr2	76473692	76474742	LTR/ERV1	5884	+	525	76474217	84651
chr2	76389566	76589566	harbor1	chr2	76475041	76475281	LTR/ERV1	5884	+	120	76475161	85595
chr2	76389566	76589566	harbor1	chr2	76475591	76476542	LTR/ERV1	5884	+	476	76476067	86501
chr2	76389566	76589566	harbor1	chr2	76476534	76477058	LTR/ERV1	3726	+	262	76476796	87230
chr2	76389566	76589566	harbor1	chr2	76398209	76399121	LTR/ERV1	5397	+	456	76398665	9099
chr2	29616251	29816251	harbor1	chr2	29616492	29617175	LTR/ERV1	3554	+	342	29616834	583
chr2	29616251	29816251	harbor1	chr2	29617558	29617823	LTR/ERV1	729	+	132	29617690	1439
chr2	29616251	29816251	harbor1	chr2	29696551	29696923	LTR/ERV1	1717	+	186	29696737	80486
chr2	204850530	205050530	harbor1	chr2	204914026	204914359	LTR/ERV1	1686	+	166	204914192	63662
chr3	27090827	27290827	harbor1	chr3	27147734	27147968	LTR/ERV1	506	+	117	27147851	57024
chr3	13369420	13569420	harbor1	chr3	13386998	13387252	LTR/ERV1	599	+	127	13387125	17705
chr3	13369420	13569420	harbor1	chr3	13430007	13430249	LTR/ERV1	1111	+	121	13430128	60708
chr3	13369420	13569420	harbor1	chr3	13431986	13432641	LTR/ERV1	8261	+	328	13432314	62894
chr3	13369420	13569420	harbor1	chr3	13432964	13433412	LTR/ERV1	8261	+	224	13433188	63768
chr3	13369420	13569420	harbor1	chr3	13433413	13434085	LTR/ERV1	4965	+	336	13433749	64329
chr3	13369420	13569420	harbor1	chr3	13434237	13434570	LTR/ERV1	1133	+	166	13434403	64983
chr3	13369420	13569420	harbor1	chr3	13451754	13452164	LTR/ERV1	1393	+	205	13451959	82539
chr3	13369420	13569420	harbor1	chr3	13453597	13453763	LTR/ERV1	651	+	83	13453680	84260
chr3	73186653	73386653	harbor1	chr3	73197341	73197797	LTR/ERV1	2098	+	228	73197569	10916
chr3	73186653	73386653	harbor1	chr3	73198101	73198153	LTR/ERV1	2098	+	26	73198127	11474
chr3	73186653	73386653	harbor1	chr3	73269010	73270292	LTR/ERV1	8392	+	641	73269651	82998
chr3	170830118	171030118	harbor1	chr3	170839632	170840180	LTR/ERV1	3804	+	274	170839906	9788
chr3	170830118	171030118	harbor1	chr3	170869418	170869664	LTR/ERV1	652	+	123	170869541	39423
chr3	170830118	171030118	harbor1	chr3	170878343	170878551	LTR/ERV1	869	+	104	170878447	48329
chr3	2801402	3001402	harbor1	chr3	2888175	2888648	LTR/ERV1	2386	+	236	2888411	87009
chr3	2801402	3001402	harbor1	chr3	2888773	2889001	LTR/ERV1	1326	+	114	2888887	87485
chr3	180215742	180415742	harbor1	chr3	180216429	180216691	LTR/ERV1	642	+	131	180216560	818
chr3	180215742	180415742	harbor1	chr3	180227547	180227988	LTR/ERV1	2701	+	220	180227767	12025
chr3	180215742	180415742	harbor1	chr3	180228301	180228973	LTR/ERV1	2620	+	336	180228637	12895
chr3	180215742	180415742	harbor1	chr3	180228974	180231217	LTR/ERV1	10125	+	1122	180230096	14354
chr3	180215742	180415742	harbor1	chr3	180231212	180231452	LTR/ERV1	11224	+	120	180231332	15590
chr3	180215742	180415742	harbor1	chr3	180231748	180232819	LTR/ERV1	11224	+	536	180232284	16542
chr3	180215742	180415742	harbor1	chr3	180235082	180235509	LTR/ERV1	11224	+	214	180235296	19554
chr3	180215742	180415742	harbor1	chr3	180235510	180235941	LTR/ERV1	2686	+	216	180235726	19984
chr3	167140906	167340906	harbor1	chr3	167172177	167172758	LTR/ERV1	3223	+	290	167172467	31561
chr3	167140906	167340906	harbor1	chr3	167184190	167184285	LTR/ERV1	394	+	48	167184238	43332
chr3	148235898	148435898	harbor1	chr3	148252338	148252560	LTR/ERV1	660	+	111	148252449	16551
chr3	148235898	148435898	harbor1	chr3	148274008	148274486	LTR/ERV1	2096	+	239	148274247	38349
chr3	148235898	148435898	harbor1	chr3	148276607	148276857	LTR/ERV1	455	+	125	148276732	40834
chr3	148235898	148435898	harbor1	chr3	148285990	148286496	LTR/ERV1	2300	+	253	148286243	50345
chr3	148235898	148435898	harbor1	chr3	148286820	148286915	LTR/ERV1	2300	+	48	148286868	50970
chr3	148235898	148435898	harbor1	chr3	148313776	148314285	LTR/ERV1	1378	+	254	148314030	78132
chr3	148235898	148435898	harbor1	chr3	148315637	148315754	LTR/ERV1	537	+	58	148315695	79797
chr3	148235898	148435898	harbor1	chr3	148316292	148316472	LTR/ERV1	1550	+	90	148316382	80484
chr3	148235898	148435898	harbor1	chr3	148316808	148317101	LTR/ERV1	1550	+	146	148316954	81056
chr3	148235898	148435898	harbor1	chr3	148317708	148318343	LTR/ERV1	2284	+	318	148318026	82128
chr3	85960814	86160814	harbor1	chr3	85990880	85991399	LTR/ERV1	1184	+	260	85991140	30326
chr3	62843731	63043731	harbor1	chr3	62902453	62903073	LTR/ERV1	3897	+	310	62902763	59032
chr3	62843731	63043731	harbor1	chr3	62932076	62932512	LTR/ERV1	2381	+	218	62932294	88563
chr3	62843731	63043731	harbor1	chr3	62939465	62940170	LTR/ERV1	3786	+	352	62939817	96086
chr3	78175664	78375664	harbor1	chr3	78203589	78203874	LTR/ERV1	487	+	142	78203731	28067
chr3	78175664	78375664	harbor1	chr3	78204121	78204199	LTR/ERV1	487	+	39	78204160	28496
chr3	78175664	78375664	harbor1	chr3	78221983	78222362	LTR/ERV1	2348	+	190	78222173	46509
chr3	78175664	78375664	harbor1	chr3	78235616	78236139	LTR/ERV1	1987	+	262	78235878	60214
chr3	78175664	78375664	harbor1	chr3	78238724	78239341	LTR/ERV1	3542	+	308	78239032	63368
chr3	78175664	78375664	harbor1	chr3	78240655	78241205	LTR/ERV1	1992	+	275	78240930	65266
chr3	78175664	78375664	harbor1	chr3	78241743	78242298	LTR/ERV1	2833	+	278	78242021	66357
chr3	78175664	78375664	harbor1	chr3	78242902	78243443	LTR/ERV1	3274	+	270	78243172	67508
chr3	78175664	78375664	harbor1	chr3	78244067	78244663	LTR/ERV1	3817	+	298	78244365	68701
chr3	78175664	78375664	harbor1	chr3	78246303	78246645	LTR/ERV1	2111	+	171	78246474	70810
chr3	78175664	78375664	harbor1	chr3	78246647	78247212	LTR/ERV1	2550	+	282	78246929	71265
chr3	78175664	78375664	harbor1	chr3	78247193	78248685	LTR/ERV1	9833	+	746	78247939	72275
chr3	78175664	78375664	harbor1	chr3	78248682	78248757	LTR/ERV1	472	+	38	78248720	73056
chr3	78175664	78375664	harbor1	chr3	78248749	78249426	LTR/ERV1	2447	+	338	78249087	73423
chr3	78175664	78375664	harbor1	chr3	78249428	78249765	LTR/ERV1	2106	+	168	78249596	73932
chr3	78175664	78375664	harbor1	chr3	78259465	78259924	LTR/ERV1	2405	+	230	78259695	84031
chr3	78175664	78375664	harbor1	chr3	78266569	78267049	LTR/ERV1	3894	+	240	78266809	91145
chr3	78241197	78441197	harbor1	chr3	78240655	78241205	LTR/ERV1	1992	+	275	78240930	267
chr3	78241197	78441197	harbor1	chr3	78241743	78242298	LTR/ERV1	2833	+	278	78242021	824
chr3	78241197	78441197	harbor1	chr3	78242902	78243443	LTR/ERV1	3274	+	270	78243172	1975
chr3	78241197	78441197	harbor1	chr3	78244067	78244663	LTR/ERV1	3817	+	298	78244365	3168
chr3	78241197	78441197	harbor1	chr3	78246303	78246645	LTR/ERV1	2111	+	171	78246474	5277
chr3	78241197	78441197	harbor1	chr3	78246647	78247212	LTR/ERV1	2550	+	282	78246929	5732
chr3	78241197	78441197	harbor1	chr3	78247193	78248685	LTR/ERV1	9833	+	746	78247939	6742
chr3	78241197	78441197	harbor1	chr3	78248682	78248757	LTR/ERV1	472	+	38	78248720	7523
chr3	78241197	78441197	harbor1	chr3	78248749	78249426	LTR/ERV1	2447	+	338	78249087	7890
chr3	78241197	78441197	harbor1	chr3	78249428	78249765	LTR/ERV1	2106	+	168	78249596	8399
chr3	78241197	78441197	harbor1	chr3	78259465	78259924	LTR/ERV1	2405	+	230	78259695	18498
chr3	78241197	78441197	harbor1	chr3	78266569	78267049	LTR/ERV1	3894	+	240	78266809	25612
chr3	78241197	78441197	harbor1	chr3	78294804	78295551	LTR/ERV1	3038	+	374	78295178	53981
chr3	78241197	78441197	harbor1	chr3	78320502	78321035	LTR/ERV1	1787	+	266	78320768	79571
chr3	78241197	78441197	harbor1	chr3	78323654	78324104	LTR/ERV1	3490	+	225	78323879	82682
chr3	78241197	78441197	harbor1	chr3	78324107	78327347	LTR/ERV1	18424	+	1620	78325727	84530
chr3	78241197	78441197	harbor1	chr3	78327347	78327784	LTR/ERV1	2806	+	218	78327565	86368
chr3	98572522	98772522	harbor1	chr3	98635826	98636288	LTR/ERV1	2253	+	231	98636057	63535
chr3	73785099	73985099	harbor1	chr3	73866617	73867340	LTR/ERV1	3182	+	362	73866979	81880
chr3	166218706	166418706	harbor1	chr3	166220657	166221199	LTR/ERV1	2325	+	271	166220928	2222
chr3	61604058	61804058	harbor1	chr3	61697087	61697245	LTR/ERV1	1452	+	79	61697166	93108
chr3	61604058	61804058	harbor1	chr3	61697246	61697925	LTR/ERV1	2740	+	340	61697586	93528
chr3	61604058	61804058	harbor1	chr3	61697926	61698230	LTR/ERV1	1452	+	152	61698078	94020
chr3	143042067	143242067	harbor1	chr3	143095161	143096764	LTR/ERV1	8646	+	802	143095963	53896
chr3	143042067	143242067	harbor1	chr3	143103534	143103960	LTR/ERV1	3039	+	213	143103747	61680
chr3	143042067	143242067	harbor1	chr3	143104239	143104431	LTR/ERV1	3039	+	96	143104335	62268
chr3	143042067	143242067	harbor1	chr3	143104432	143104669	LTR/ERV1	526	+	118	143104550	62483
chr3	143042067	143242067	harbor1	chr3	143104670	143105075	LTR/ERV1	2054	+	202	143104872	62805
chr3	143042067	143242067	harbor1	chr3	143105080	143105917	LTR/ERV1	4215	+	418	143105498	63431
chr3	143042067	143242067	harbor1	chr3	143105927	143106055	LTR/ERV1	680	+	64	143105991	63924
chr3	143042067	143242067	harbor1	chr3	143106056	143108916	LTR/ERV1	17026	+	1430	143107486	65419
chr3	143042067	143242067	harbor1	chr3	143109212	143109316	LTR/ERV1	17026	+	52	143109264	67197
chr3	143042067	143242067	harbor1	chr3	143109616	143109993	LTR/ERV1	17026	+	188	143109804	67737
chr3	143042067	143242067	harbor1	chr3	143109994	143110152	LTR/ERV1	524	+	79	143110073	68006
chr3	168329466	168529466	harbor1	chr3	168389018	168389667	LTR/ERV1	3523	+	324	168389342	59876
chr3	178024200	178224200	harbor1	chr3	178050183	178053655	LTR/ERV1	6664	+	1736	178051919	27719
chr3	125839499	126039499	harbor1	chr3	125863750	125864094	LTR/ERV1	1905	+	172	125863922	24423
chr3	125839499	126039499	harbor1	chr3	125864097	125866993	LTR/ERV1	19369	+	1448	125865545	26046
chr3	125839499	126039499	harbor1	chr3	125866990	125867845	LTR/ERV1	6104	+	428	125867418	27919
chr3	125839499	126039499	harbor1	chr3	125867848	125868506	LTR/ERV1	4485	+	329	125868177	28678
chr3	125839499	126039499	harbor1	chr3	125868504	125868718	LTR/ERV1	1267	+	107	125868611	29112
chr3	125839499	126039499	harbor1	chr3	125868719	125869094	LTR/ERV1	2276	+	188	125868907	29408
chr3	125839499	126039499	harbor1	chr3	125869096	125869497	LTR/ERV1	2665	+	200	125869296	29797
chr3	125839499	126039499	harbor1	chr3	125879972	125880463	LTR/ERV1	5194	+	246	125880218	40719
chr3	125839499	126039499	harbor1	chr3	125880694	125880990	LTR/ERV1	5194	+	148	125880842	41343
chr3	125839499	126039499	harbor1	chr3	125903322	125903757	LTR/ERV1	2413	+	218	125903540	64041
chr3	125839499	126039499	harbor1	chr3	125903758	125905024	LTR/ERV1	8700	+	633	125904391	64892
chr3	125839499	126039499	harbor1	chr3	125905025	125905060	LTR/ERV1	2413	+	18	125905043	65544
chr3	41775781	41975781	harbor1	chr3	41853417	41854149	LTR/ERV1	3659	+	366	41853783	78002
chr3	53184757	53384757	harbor1	chr3	53201152	53201529	LTR/ERV1	2488	+	188	53201340	16583
chr3	53184757	53384757	harbor1	chr3	53201828	53201929	LTR/ERV1	2488	+	50	53201878	17121
chr3	53184757	53384757	harbor1	chr3	53215304	53215369	LTR/ERV1	402	+	32	53215336	30579
chr3	53184757	53384757	harbor1	chr3	53215674	53215706	LTR/ERV1	402	+	16	53215690	30933
chr3	53184757	53384757	harbor1	chr3	53258272	53258393	LTR/ERV1	663	+	60	53258332	73575
chr3	53184757	53384757	harbor1	chr3	53258551	53258669	LTR/ERV1	689	+	59	53258610	73853
chr3	163065342	163265342	harbor1	chr3	163073066	163074359	LTR/ERV1	3640	+	646	163073712	8370
chr3	163065342	163265342	harbor1	chr3	163131450	163132536	LTR/ERV1	3868	+	543	163131993	66651
chr3	163065342	163265342	harbor1	chr3	163156783	163157240	LTR/ERV1	2700	+	228	163157011	91669
chr3	76534770	76734770	harbor1	chr3	76550424	76552080	LTR/ERV1	7905	+	828	76551252	16482
chr3	76534770	76734770	harbor1	chr3	76573331	76573716	LTR/ERV1	657	+	192	76573523	38753
chr3	172006451	172206451	harbor1	chr3	172018276	172018397	LTR/ERV1	550	+	60	172018336	11885
chr3	146369564	146569564	harbor1	chr3	146384194	146385519	LTR/ERV1	2546	+	662	146384856	15292
chr3	146369564	146569564	harbor1	chr3	146385493	146385954	LTR/ERV1	1873	+	230	146385723	16159
chr3	146369564	146569564	harbor1	chr3	146385955	146386388	LTR/ERV1	2294	+	216	146386171	16607
chr3	146369564	146569564	harbor1	chr3	146403822	146404288	LTR/ERV1	3420	+	233	146404055	34491
chr3	146369564	146569564	harbor1	chr3	146464916	146465345	LTR/ERV1	1343	+	214	146465130	95566
chr3	30117745	30317745	harbor1	chr3	30145040	30145763	LTR/ERV1	4266	+	362	30145402	27657
chr3	115167125	115367125	harbor1	chr3	115183974	115184183	LTR/ERV1	3182	+	104	115184078	16953
chr3	115167125	115367125	harbor1	chr3	115185448	115185712	LTR/ERV1	3182	+	132	115185580	18455
chr3	115167125	115367125	harbor1	chr3	115185715	115186286	LTR/ERV1	2424	+	286	115186001	18876
chr3	115167125	115367125	harbor1	chr3	115186447	115186809	LTR/ERV1	1498	+	181	115186628	19503
chr3	115167125	115367125	harbor1	chr3	115186826	115187654	LTR/ERV1	6693	+	414	115187240	20115
chr3	115167125	115367125	harbor1	chr3	115188385	115189286	LTR/ERV1	3904	+	450	115188835	21710
chr3	115167125	115367125	harbor1	chr3	115189285	115192097	LTR/ERV1	15029	+	1406	115190691	23566
chr3	115167125	115367125	harbor1	chr3	115192109	115192571	LTR/ERV1	2904	+	231	115192340	25215
chr3	115167125	115367125	harbor1	chr3	115228237	115228278	LTR/ERV1	1491	+	20	115228257	61132
chr3	115167125	115367125	harbor1	chr3	115229152	115229471	LTR/ERV1	1491	+	160	115229312	62187
chr3	115167125	115367125	harbor1	chr3	115234225	115234428	LTR/ERV1	883	+	102	115234327	67202
chr3	115167125	115367125	harbor1	chr3	115228666	115228775	LTR/ERV1	1491	+	54	115228720	61595
chr3	44662630	44862630	harbor1	chr3	44685193	44685380	LTR/ERV1	1195	+	94	44685287	22657
chr3	44662630	44862630	harbor1	chr3	44686054	44686511	LTR/ERV1	2202	+	228	44686282	23652
chr3	44662630	44862630	harbor1	chr3	44689870	44690058	LTR/ERV1	1192	+	94	44689964	27334
chr3	44662630	44862630	harbor1	chr3	44750216	44751234	LTR/ERV1	4778	+	509	44750725	88095
chr3	44662630	44862630	harbor1	chr3	44751309	44751991	LTR/ERV1	2064	+	341	44751650	89020
chr3	44662630	44862630	harbor1	chr3	44751992	44752434	LTR/ERV1	2512	+	221	44752213	89583
chr3	17160529	17360529	harbor1	chr3	17182823	17183444	LTR/ERV1	2698	+	310	17183133	22604
chr3	173952404	174152404	harbor1	chr3	173972158	173972375	LTR/ERV1	602	+	108	173972266	19862
chr3	18858148	19058148	harbor1	chr3	18949375	18949788	LTR/ERV1	1723	+	206	18949581	91433
chr3	47212979	47412979	harbor1	chr3	47215648	47215786	LTR/ERV1	2168	+	69	47215717	2738
chr3	47212979	47412979	harbor1	chr3	47216097	47216159	LTR/ERV1	2168	+	31	47216128	3149
chr3	47212979	47412979	harbor1	chr3	47216426	47216708	LTR/ERV1	2168	+	141	47216567	3588
chr3	169792947	169992947	harbor1	chr3	169813493	169813844	LTR/ERV1	2390	+	176	169813669	20722
chr3	169792947	169992947	harbor1	chr3	169875407	169875813	LTR/ERV1	2021	+	203	169875610	82663
chr3	169792947	169992947	harbor1	chr3	169879775	169880781	LTR/ERV1	5314	+	503	169880278	87331
chr3	106333449	106533449	harbor1	chr3	106386047	106386530	LTR/ERV1	2682	+	242	106386289	52840
chr3	120420998	120620998	harbor1	chr3	120469608	120470245	LTR/ERV1	3714	+	318	120469926	48928
chr3	120420998	120620998	harbor1	chr3	120481158	120481493	LTR/ERV1	437	+	168	120481326	60328
chr3	120420998	120620998	harbor1	chr3	120481533	120481702	LTR/ERV1	437	+	84	120481617	60619
chr3	120420998	120620998	harbor1	chr3	120489598	120489855	LTR/ERV1	1418	+	128	120489726	68728
chr3	120420998	120620998	harbor1	chr3	120489857	120492081	LTR/ERV1	14476	+	1112	120490969	69971
chr3	120420998	120620998	harbor1	chr3	120492069	120495825	LTR/ERV1	29818	+	1878	120493947	72949
chr3	120420998	120620998	harbor1	chr3	120495883	120496162	LTR/ERV1	1276	+	140	120496023	75025
chr3	120420998	120620998	harbor1	chr3	120505446	120506204	LTR/ERV1	4548	+	379	120505825	84827
chr3	120420998	120620998	harbor1	chr3	120506247	120508014	LTR/ERV1	9728	+	884	120507131	86133
chr3	120420998	120620998	harbor1	chr3	120508011	120508220	LTR/ERV1	1162	+	104	120508115	87117
chr3	120420998	120620998	harbor1	chr3	120508216	120509488	LTR/ERV1	6096	+	636	120508852	87854
chr3	120420998	120620998	harbor1	chr3	120509479	120511327	LTR/ERV1	9960	+	924	120510403	89405
chr3	120420998	120620998	harbor1	chr3	120511328	120511907	LTR/ERV1	4513	+	290	120511618	90620
chr3	120420998	120620998	harbor1	chr3	120512217	120512384	LTR/ERV1	4513	+	84	120512301	91303
chr3	62270200	62470200	harbor1	chr3	62314256	62314365	LTR/ERV1	524	+	54	62314310	44110
chr3	62270200	62470200	harbor1	chr3	62314513	62314944	LTR/ERV1	1079	+	216	62314729	44529
chr3	62270200	62470200	harbor1	chr3	62315298	62315389	LTR/ERV1	1079	+	46	62315344	45144
chr3	127118619	127318619	harbor1	chr3	127180202	127180869	LTR/ERV1	4008	+	334	127180536	61917
chr3	166890196	167090196	harbor1	chr3	166975652	166976739	LTR/ERV1	5043	+	544	166976196	86000
chr3	166890196	167090196	harbor1	chr3	166987722	166987939	LTR/ERV1	1586	+	108	166987830	97634
chr3	115434438	115634438	harbor1	chr3	115461094	115461719	LTR/ERV1	4199	+	312	115461406	26968
chr3	115434438	115634438	harbor1	chr3	115490578	115490766	LTR/ERV1	418	+	94	115490672	56234
chr3	115434438	115634438	harbor1	chr3	115520718	115521216	LTR/ERV1	2028	+	249	115520967	86529
chr3	144120876	144320876	harbor1	chr3	144181698	144182456	LTR/ERV1	5518	+	379	144182077	61201
chr3	144120876	144320876	harbor1	chr3	144184972	144185540	LTR/ERV1	3431	+	284	144185256	64380
chr3	108503691	108703691	harbor1	chr3	108555258	108556040	LTR/ERV1	3683	+	391	108555649	51958
chr3	108503691	108703691	harbor1	chr3	108564451	108564868	LTR/ERV1	1489	+	208	108564659	60968
chr3	108503691	108703691	harbor1	chr3	108601685	108602092	LTR/ERV1	1874	+	204	108601889	98198
chr3	9547620	9747620	harbor1	chr3	9571114	9571209	LTR/ERV1	606	+	48	9571162	23542
chr3	9547620	9747620	harbor1	chr3	9571522	9571989	LTR/ERV1	1914	+	234	9571756	24136
chr3	9547620	9747620	harbor1	chr3	9572115	9572339	LTR/ERV1	820	+	112	9572227	24607
chr3	9547620	9747620	harbor1	chr3	9572627	9572946	LTR/ERV1	3818	+	160	9572787	25167
chr3	9547620	9747620	harbor1	chr3	9573235	9573690	LTR/ERV1	3818	+	228	9573463	25843
chr3	9547620	9747620	harbor1	chr3	9574309	9574323	LTR/ERV1	3818	+	7	9574316	26696
chr3	9547620	9747620	harbor1	chr3	9588101	9588212	LTR/ERV1	750	+	56	9588157	40537
chr3	9547620	9747620	harbor1	chr3	9590154	9590652	LTR/ERV1	2642	+	249	9590403	42783
chr3	9547620	9747620	harbor1	chr3	9591009	9591277	LTR/ERV1	1666	+	134	9591143	43523
chr3	9547620	9747620	harbor1	chr3	9592640	9592960	LTR/ERV1	2731	+	160	9592800	45180
chr3	9547620	9747620	harbor1	chr3	9593264	9593457	LTR/ERV1	2731	+	96	9593360	45740
chr3	9547620	9747620	harbor1	chr3	9595956	9596289	LTR/ERV1	2178	+	166	9596122	48502
chr3	9547620	9747620	harbor1	chr3	9619046	9620150	LTR/ERV1	3968	+	552	9619598	71978
chr3	75503631	75703631	harbor1	chr3	75587615	75589015	LTR/ERV1	10280	+	700	75588315	84684
chr3	19646513	19846513	harbor1	chr3	19702400	19703772	LTR/ERV1	8982	+	686	19703086	56573
chr3	19646513	19846513	harbor1	chr3	19722478	19722899	LTR/ERV1	2939	+	210	19722688	76175
chr3	19646513	19846513	harbor1	chr3	19722912	19723568	LTR/ERV1	3761	+	328	19723240	76727
chr3	19646513	19846513	harbor1	chr3	19728685	19729115	LTR/ERV1	2446	+	215	19728900	82387
chr3	19646513	19846513	harbor1	chr3	19740794	19741436	LTR/ERV1	4430	+	321	19741115	94602
chr3	19646513	19846513	harbor1	chr3	19723563	19728676	LTR/ERV1	17908	+	2556	19726119	79606
chr3	194322481	194522481	harbor1	chr3	194335552	194335746	LTR/ERV1	1289	+	97	194335649	13168
chr3	43067022	43267022	harbor1	chr3	43139529	43139999	LTR/ERV1	487	+	235	43139764	72742
chr3	38667832	38867832	harbor1	chr3	38678905	38679662	LTR/ERV1	831	+	378	38679283	11451
chr3	38667832	38867832	harbor1	chr3	38731403	38731498	LTR/ERV1	413	+	48	38731451	63619
chr3	38667832	38867832	harbor1	chr3	38731499	38732034	LTR/ERV1	3109	+	268	38731767	63935
chr3	106161167	106361167	harbor1	chr3	106187507	106188044	LTR/ERV1	2032	+	268	106187775	26608
chr3	106161167	106361167	harbor1	chr3	106214583	106214913	LTR/ERV1	1542	+	165	106214748	53581
chr3	106161167	106361167	harbor1	chr3	106236561	106236917	LTR/ERV1	1451	+	178	106236739	75572
chr3	106161167	106361167	harbor1	chr3	106255987	106256329	LTR/ERV1	1544	+	171	106256158	94991
chr3	106161167	106361167	harbor1	chr3	106256347	106256829	LTR/ERV1	1740	+	241	106256588	95421
chr3	106161167	106361167	harbor1	chr3	106257192	106257616	LTR/ERV1	21290	+	212	106257404	96237
chr3	106161167	106361167	harbor1	chr3	106257657	106258843	LTR/ERV1	21290	+	593	106258250	97083
chr3	106161167	106361167	harbor1	chr3	106259546	106261144	LTR/ERV1	21290	+	799	106260345	99178
chr3	110428521	110628521	harbor1	chr3	110494568	110494690	LTR/ERV1	423	+	61	110494629	66108
chr3	85683345	85883345	harbor1	chr3	85686642	85687088	LTR/ERV1	3115	+	223	85686865	3520
chr3	132010545	132210545	harbor1	chr3	132069904	132070503	LTR/ERV1	2772	+	300	132070204	59659
chr3	44992868	45192868	harbor1	chr3	45049288	45049827	LTR/ERV1	2037	+	270	45049558	56690
chr3	44992868	45192868	harbor1	chr3	45061285	45061704	LTR/ERV1	3845	+	210	45061495	68627
chr3	44992868	45192868	harbor1	chr3	45061979	45062118	LTR/ERV1	3845	+	70	45062049	69181
chr3	44992868	45192868	harbor1	chr3	45062119	45062347	LTR/ERV1	2291	+	114	45062233	69365
chr3	44992868	45192868	harbor1	chr3	45062646	45062764	LTR/ERV1	2291	+	59	45062705	69837
chr3	44992868	45192868	harbor1	chr3	45062765	45063169	LTR/ERV1	2642	+	202	45062967	70099
chr3	118648676	118848676	harbor1	chr3	118665000	118665401	LTR/ERV1	1586	+	200	118665200	16524
chr3	131740056	131940056	harbor1	chr3	131765219	131765664	LTR/ERV1	1683	+	222	131765441	25385
chr3	131740056	131940056	harbor1	chr3	131795308	131796024	LTR/ERV1	4463	+	358	131795666	55610
chr3	87105672	87305672	harbor1	chr3	87141103	87141428	LTR/ERV1	1854	+	162	87141265	35593
chr3	87105672	87305672	harbor1	chr3	87141429	87141900	LTR/ERV1	1976	+	236	87141665	35993
chr3	87105672	87305672	harbor1	chr3	87142116	87145807	LTR/ERV1	23603	+	1846	87143962	38290
chr3	87105672	87305672	harbor1	chr3	87145809	87146130	LTR/ERV1	1701	+	160	87145969	40297
chr3	87105672	87305672	harbor1	chr3	87147447	87147781	LTR/ERV1	2753	+	167	87147614	41942
chr3	87105672	87305672	harbor1	chr3	87148069	87148541	LTR/ERV1	2753	+	236	87148305	42633
chr3	111229580	111429580	harbor1	chr3	111306041	111306689	LTR/ERV1	1310	+	324	111306365	76785
chr3	111229580	111429580	harbor1	chr3	111306690	111307608	LTR/ERV1	5339	+	459	111307149	77569
chr3	111229580	111429580	harbor1	chr3	111307609	111307667	LTR/ERV1	1310	+	29	111307638	78058
chr3	67013546	67213546	harbor1	chr3	67083091	67083349	LTR/ERV1	686	+	129	67083220	69674
chr3	151032723	151232723	harbor1	chr3	151082227	151082479	LTR/ERV1	412	+	126	151082353	49630
chr3	155283974	155483974	harbor1	chr3	155302823	155303284	LTR/ERV1	1091	+	230	155303053	19079
chr3	155283974	155483974	harbor1	chr3	155324174	155325538	LTR/ERV1	9475	+	682	155324856	40882
chr3	155283974	155483974	harbor1	chr3	155325541	155325889	LTR/ERV1	1694	+	174	155325715	41741
chr3	155283974	155483974	harbor1	chr3	155327724	155328668	LTR/ERV1	5512	+	472	155328196	44222
chr3	155283974	155483974	harbor1	chr3	155353511	155353942	LTR/ERV1	832	+	216	155353727	69753
chr3	155283974	155483974	harbor1	chr3	155360477	155361006	LTR/ERV1	2000	+	264	155360741	76767
chr3	155283974	155483974	harbor1	chr3	155361037	155361310	LTR/ERV1	3562	+	136	155361173	77199
chr3	155283974	155483974	harbor1	chr3	155362127	155362233	LTR/ERV1	3562	+	53	155362180	78206
chr3	155283974	155483974	harbor1	chr3	155362529	155363102	LTR/ERV1	3562	+	286	155362815	78841
chr3	155283974	155483974	harbor1	chr3	155363168	155363222	LTR/ERV1	3562	+	27	155363195	79221
chr3	155283974	155483974	harbor1	chr3	155363223	155363721	LTR/ERV1	3038	+	249	155363472	79498
chr3	155283974	155483974	harbor1	chr3	155363722	155364442	LTR/ERV1	3562	+	360	155364082	80108
chr3	155283974	155483974	harbor1	chr3	155364759	155365010	LTR/ERV1	599	+	126	155364885	80911
chr3	155283974	155483974	harbor1	chr3	155365025	155365225	LTR/ERV1	1111	+	100	155365125	81151
chr3	155283974	155483974	harbor1	chr3	155365388	155365443	LTR/ERV1	1111	+	28	155365416	81442
chr3	155283974	155483974	harbor1	chr3	155365496	155368224	LTR/ERV1	7931	+	1364	155366860	82886
chr3	155283974	155483974	harbor1	chr3	155368505	155369178	LTR/ERV1	3018	+	336	155368841	84867
chr3	155283974	155483974	harbor1	chr3	155369179	155369714	LTR/ERV1	1556	+	268	155369447	85473
chr3	134055029	134255029	harbor1	chr3	134108696	134108793	LTR/ERV1	394	+	48	134108744	53715
chr3	134055029	134255029	harbor1	chr3	134129581	134130112	LTR/ERV1	2884	+	266	134129847	74818
chr3	157799820	157999820	harbor1	chr3	157834977	157835442	LTR/ERV1	2066	+	232	157835209	35389
chr3	56851451	57051451	harbor1	chr3	56870806	56870910	LTR/ERV1	607	+	52	56870858	19407
chr3	56851451	57051451	harbor1	chr3	56934284	56935831	LTR/ERV1	10924	+	774	56935058	83607
chr3	65939161	66139161	harbor1	chr3	65948272	65948429	LTR/ERV1	699	+	78	65948350	9189
chr3	65939161	66139161	harbor1	chr3	65945438	65945863	LTR/ERV1	2858	+	212	65945650	6489
chr3	148140118	148340118	harbor1	chr3	148151529	148151957	LTR/ERV1	3290	+	214	148151743	11625
chr3	148140118	148340118	harbor1	chr3	148151960	148155053	LTR/ERV1	16273	+	1546	148153506	13388
chr3	148140118	148340118	harbor1	chr3	148155048	148155195	LTR/ERV1	822	+	74	148155122	15004
chr3	148140118	148340118	harbor1	chr3	148155186	148155688	LTR/ERV1	3578	+	251	148155437	15319
chr3	148140118	148340118	harbor1	chr3	148155691	148156352	LTR/ERV1	4116	+	330	148156021	15903
chr3	148140118	148340118	harbor1	chr3	148156350	148156556	LTR/ERV1	1172	+	103	148156453	16335
chr3	148140118	148340118	harbor1	chr3	148156554	148156931	LTR/ERV1	2445	+	188	148156742	16624
chr3	148140118	148340118	harbor1	chr3	148156932	148157361	LTR/ERV1	3298	+	214	148157146	17028
chr3	148140118	148340118	harbor1	chr3	148212455	148212676	LTR/ERV1	516	+	110	148212565	72447
chr3	148140118	148340118	harbor1	chr3	148213179	148216263	LTR/ERV1	5416	+	1542	148214721	74603
chr3	148140118	148340118	harbor1	chr3	148216710	148216962	LTR/ERV1	2742	+	126	148216836	76718
chr3	148140118	148340118	harbor1	chr3	148216966	148217044	LTR/ERV1	392	+	39	148217005	76887
chr3	148140118	148340118	harbor1	chr3	148217047	148217238	LTR/ERV1	618	+	96	148217143	77025
chr3	148140118	148340118	harbor1	chr3	148230619	148230904	LTR/ERV1	2071	+	142	148230761	90643
chr3	148140118	148340118	harbor1	chr3	148231043	148231244	LTR/ERV1	2071	+	100	148231143	91025
chr3	148140118	148340118	harbor1	chr3	148231317	148231624	LTR/ERV1	2751	+	154	148231471	91353
chr3	148140118	148340118	harbor1	chr3	148232392	148232509	LTR/ERV1	2751	+	58	148232450	92332
chr3	59089818	59289818	harbor1	chr3	59096085	59096236	LTR/ERV1	1072	+	76	59096161	6343
chr3	59089818	59289818	harbor1	chr3	59096312	59096501	LTR/ERV1	1217	+	94	59096406	6588
chr3	59089818	59289818	harbor1	chr3	59100977	59101612	LTR/ERV1	4012	+	318	59101295	11477
chr3	59089818	59289818	harbor1	chr3	59101606	59103952	LTR/ERV1	13797	+	1173	59102779	12961
chr3	59089818	59289818	harbor1	chr3	59104272	59104824	LTR/ERV1	13797	+	276	59104548	14730
chr3	59089818	59289818	harbor1	chr3	59104824	59104962	LTR/ERV1	1150	+	69	59104893	15075
chr3	59089818	59289818	harbor1	chr3	59104957	59105618	LTR/ERV1	4947	+	330	59105287	15469
chr3	59089818	59289818	harbor1	chr3	59105619	59106080	LTR/ERV1	3697	+	230	59105849	16031
chr3	118501713	118701713	harbor1	chr3	118513104	118513148	LTR/ERV1	809	+	22	118513126	11413
chr3	118501713	118701713	harbor1	chr3	118513283	118513503	LTR/ERV1	809	+	110	118513393	11680
chr3	118501713	118701713	harbor1	chr3	118515293	118515910	LTR/ERV1	2346	+	308	118515601	13888
chr3	118501713	118701713	harbor1	chr3	118589641	118590192	LTR/ERV1	4043	+	276	118589917	88204
chr3	118501713	118701713	harbor1	chr3	118590279	118590893	LTR/ERV1	3516	+	307	118590586	88873
chr3	118501713	118701713	harbor1	chr3	118590882	118592461	LTR/ERV1	11814	+	790	118591672	89959
chr3	118501713	118701713	harbor1	chr3	118592757	118594417	LTR/ERV1	11814	+	830	118593587	91874
chr3	118501713	118701713	harbor1	chr3	118594418	118594970	LTR/ERV1	4201	+	276	118594694	92981
chr3	106788919	106988919	harbor1	chr3	106820789	106822663	LTR/ERV1	4684	+	937	106821726	32807
chr3	106788919	106988919	harbor1	chr3	106824165	106824953	LTR/ERV1	4501	+	394	106824559	35640
chr3	106788919	106988919	harbor1	chr3	106853355	106853480	LTR/ERV1	451	+	62	106853417	64498
chr3	191800883	192000883	harbor1	chr3	191805937	191806681	LTR/ERV1	5441	+	372	191806309	5426
chr3	164200804	164400804	harbor1	chr3	164229853	164230062	LTR/ERV1	925	+	104	164229957	29153
chr3	164200804	164400804	harbor1	chr3	164254131	164255034	LTR/ERV1	4279	+	452	164254583	53779
chr3	32837966	33037966	harbor1	chr3	32902612	32904375	LTR/ERV1	9780	+	882	32903494	65528
chr3	61193592	61393592	harbor1	chr3	61228101	61228654	LTR/ERV1	3057	+	276	61228377	34785
chr3	61193592	61393592	harbor1	chr3	61242192	61242523	LTR/ERV1	1628	+	166	61242358	48766
chr3	61193592	61393592	harbor1	chr3	61244474	61245011	LTR/ERV1	1006	+	268	61244742	51150
chr3	61193592	61393592	harbor1	chr3	61245827	61246380	LTR/ERV1	4200	+	276	61246103	52511
chr3	61193592	61393592	harbor1	chr3	61280493	61281110	LTR/ERV1	2352	+	308	61280801	87209
chr3	61193592	61393592	harbor1	chr3	61243197	61243409	LTR/ERV1	1628	+	106	61243303	49711
chr3	153769427	153969427	harbor1	chr3	153820044	153820860	LTR/ERV1	2201	+	408	153820452	51025
chr3	153769427	153969427	harbor1	chr3	153821534	153822233	LTR/ERV1	3664	+	350	153821884	52457
chr3	175930496	176130496	harbor1	chr3	175937193	175938678	LTR/ERV1	9845	+	742	175937935	7439
chr3	184393792	184593792	harbor1	chr3	184393722	184393897	LTR/ERV1	2873	+	88	184393810	18
chr3	184393792	184593792	harbor1	chr3	184427480	184427699	LTR/ERV1	439	+	110	184427590	33798
chr3	184393792	184593792	harbor1	chr3	184428219	184428545	LTR/ERV1	551	+	163	184428382	34590
chr3	184393792	184593792	harbor1	chr3	184428715	184428974	LTR/ERV1	461	+	130	184428845	35053
chr3	184393792	184593792	harbor1	chr3	184476438	184476633	LTR/ERV1	822	+	98	184476536	82744
chr3	184393792	184593792	harbor1	chr3	184489584	184490112	LTR/ERV1	2897	+	264	184489848	96056
chr3	180562876	180762876	harbor1	chr3	180653090	180653533	LTR/ERV1	1958	+	222	180653312	90436
chr3	180562876	180762876	harbor1	chr3	180656540	180657127	LTR/ERV1	3630	+	294	180656834	93958
chr3	180562876	180762876	harbor1	chr3	180657473	180657890	LTR/ERV1	1978	+	208	180657681	94805
chr3	104833518	105033518	harbor1	chr3	104906054	104907409	LTR/ERV1	7540	+	678	104906732	73214
chr3	175637784	175837784	harbor1	chr3	175729357	175729777	LTR/ERV1	2852	+	210	175729567	91783
chr3	194789738	194989738	harbor1	chr3	194840444	194841113	LTR/ERV1	4115	+	334	194840778	51040
chr3	140425080	140625080	harbor1	chr3	140464133	140464488	LTR/ERV1	442	+	178	140464311	39231
chr3	167770839	167970839	harbor1	chr3	167776857	167777310	LTR/ERV1	2068	+	226	167777083	6244
chr3	167770839	167970839	harbor1	chr3	167820205	167821751	LTR/ERV1	8151	+	773	167820978	50139
chr3	41915219	42115219	harbor1	chr3	41940030	41940446	LTR/ERV1	2215	+	208	41940238	25019
chr3	41915219	42115219	harbor1	chr3	41955956	41956533	LTR/ERV1	1449	+	288	41956244	41025
chr3	41915219	42115219	harbor1	chr3	41962834	41963122	LTR/ERV1	1619	+	144	41962978	47759
chr3	41915219	42115219	harbor1	chr3	41963489	41963801	LTR/ERV1	2214	+	156	41963645	48426
chr3	41915219	42115219	harbor1	chr3	41964436	41964583	LTR/ERV1	1424	+	74	41964510	49291
chr3	41915219	42115219	harbor1	chr3	41964584	41965016	LTR/ERV1	3425	+	216	41964800	49581
chr3	41915219	42115219	harbor1	chr3	41965017	41965130	LTR/ERV1	1424	+	56	41965073	49854
chr3	41915219	42115219	harbor1	chr3	41966105	41966549	LTR/ERV1	4466	+	222	41966327	51108
chr3	41915219	42115219	harbor1	chr3	41966850	41967056	LTR/ERV1	4466	+	103	41966953	51734
chr3	1956276	2156276	harbor1	chr3	1963360	1963483	LTR/ERV1	491	+	62	1963422	7146
chr3	1956276	2156276	harbor1	chr3	2036138	2036626	LTR/ERV1	3008	+	244	2036382	80106
chr3	56633660	56833660	harbor1	chr3	56691697	56693023	LTR/ERV1	9275	+	663	56692360	58700
chr3	56633660	56833660	harbor1	chr3	56717801	56718144	LTR/ERV1	1731	+	172	56717973	84313
chr3	56633660	56833660	harbor1	chr3	56718141	56718750	LTR/ERV1	5418	+	304	56718445	84785
chr3	56633660	56833660	harbor1	chr3	56718752	56720218	LTR/ERV1	10020	+	733	56719485	85825
chr3	39331501	39531501	harbor1	chr3	39346920	39347210	LTR/ERV1	2231	+	145	39347065	15564
chr3	39331501	39531501	harbor1	chr3	39347199	39347826	LTR/ERV1	2725	+	314	39347513	16012
chr3	39331501	39531501	harbor1	chr3	39348688	39352664	LTR/ERV1	25259	+	1988	39350676	19175
chr3	39331501	39531501	harbor1	chr3	39352665	39352778	LTR/ERV1	579	+	56	39352721	21220
chr3	39331501	39531501	harbor1	chr3	39353585	39353968	LTR/ERV1	2755	+	192	39353777	22276
chr3	39331501	39531501	harbor1	chr3	39354272	39354320	LTR/ERV1	2755	+	24	39354296	22795
chr3	39331501	39531501	harbor1	chr3	39372838	39373361	LTR/ERV1	2943	+	262	39373100	41599
chr3	39331501	39531501	harbor1	chr3	39403782	39404447	LTR/ERV1	3357	+	332	39404114	72613
chr3	39331501	39531501	harbor1	chr3	39404741	39404818	LTR/ERV1	3357	+	38	39404779	73278
chr3	39331501	39531501	harbor1	chr3	39429568	39429953	LTR/ERV1	1923	+	192	39429760	98259
chr3	39331501	39531501	harbor1	chr3	39430051	39430097	LTR/ERV1	1923	+	23	39430074	98573
chr3	120079912	120279912	harbor1	chr3	120140075	120141692	LTR/ERV1	9460	+	808	120140883	60971
chr3	148245382	148445382	harbor1	chr3	148252338	148252560	LTR/ERV1	660	+	111	148252449	7067
chr3	148245382	148445382	harbor1	chr3	148274008	148274486	LTR/ERV1	2096	+	239	148274247	28865
chr3	148245382	148445382	harbor1	chr3	148276607	148276857	LTR/ERV1	455	+	125	148276732	31350
chr3	148245382	148445382	harbor1	chr3	148285990	148286496	LTR/ERV1	2300	+	253	148286243	40861
chr3	148245382	148445382	harbor1	chr3	148286820	148286915	LTR/ERV1	2300	+	48	148286868	41486
chr3	148245382	148445382	harbor1	chr3	148313776	148314285	LTR/ERV1	1378	+	254	148314030	68648
chr3	148245382	148445382	harbor1	chr3	148315637	148315754	LTR/ERV1	537	+	58	148315695	70313
chr3	148245382	148445382	harbor1	chr3	148316292	148316472	LTR/ERV1	1550	+	90	148316382	71000
chr3	148245382	148445382	harbor1	chr3	148316808	148317101	LTR/ERV1	1550	+	146	148316954	71572
chr3	148245382	148445382	harbor1	chr3	148317708	148318343	LTR/ERV1	2284	+	318	148318026	72644
chr3	125456918	125656918	harbor1	chr3	125552005	125552113	LTR/ERV1	679	+	54	125552059	95141
chr3	56417541	56617541	harbor1	chr3	56438050	56438539	LTR/ERV1	3354	+	244	56438294	20753
chr3	31198167	31398167	harbor1	chr3	31250231	31250833	LTR/ERV1	911	+	301	31250532	52365
chr3	31198167	31398167	harbor1	chr3	31296134	31296228	LTR/ERV1	467	+	47	31296181	98014
chr3	31198167	31398167	harbor1	chr3	31296598	31296970	LTR/ERV1	1017	+	186	31296784	98617
chr3	36289477	36489477	harbor1	chr3	36310030	36310454	LTR/ERV1	2414	+	212	36310242	20765
chr3	36289477	36489477	harbor1	chr3	36310831	36310952	LTR/ERV1	2414	+	60	36310891	21414
chr3	36289477	36489477	harbor1	chr3	36362755	36365280	LTR/ERV1	10489	+	1262	36364017	74540
chr3	36289477	36489477	harbor1	chr3	36365575	36366134	LTR/ERV1	10489	+	280	36365855	76378
chr3	36289477	36489477	harbor1	chr3	36366744	36367525	LTR/ERV1	10489	+	390	36367134	77657
chr3	36289477	36489477	harbor1	chr3	36367526	36367624	LTR/ERV1	2305	+	49	36367575	78098
chr3	36289477	36489477	harbor1	chr3	36367939	36368536	LTR/ERV1	2305	+	298	36368237	78760
chr3	36289477	36489477	harbor1	chr3	36368556	36369039	LTR/ERV1	944	+	242	36368798	79321
chr3	81830726	82030726	harbor1	chr3	81837895	81838028	LTR/ERV1	970	+	66	81837961	7235
chr3	81830726	82030726	harbor1	chr3	81846269	81846606	LTR/ERV1	707	+	168	81846437	15711
chr3	81830726	82030726	harbor1	chr3	81893959	81894378	LTR/ERV1	678	+	210	81894169	63443
chr3	81830726	82030726	harbor1	chr3	81894428	81894984	LTR/ERV1	519	+	278	81894706	63980
chr3	26127294	26327294	harbor1	chr3	26207982	26208355	LTR/ERV1	1064	+	186	26208168	80874
chr3	26127294	26327294	harbor1	chr3	26208358	26208937	LTR/ERV1	2841	+	290	26208648	81354
chr3	26127294	26327294	harbor1	chr3	26215524	26215917	LTR/ERV1	1314	+	196	26215720	88426
chr3	26127294	26327294	harbor1	chr3	26215958	26216077	LTR/ERV1	467	+	60	26216018	88724
chr3	26127294	26327294	harbor1	chr3	26218147	26218972	LTR/ERV1	2587	+	412	26218559	91265
chr3	26127294	26327294	harbor1	chr3	26218965	26219168	LTR/ERV1	680	+	102	26219067	91773
chr3	26127294	26327294	harbor1	chr3	26219331	26219950	LTR/ERV1	1878	+	310	26219641	92347
chr3	26127294	26327294	harbor1	chr3	26222258	26224153	LTR/ERV1	5803	+	948	26223206	95912
chr3	26127294	26327294	harbor1	chr3	26224151	26224247	LTR/ERV1	527	+	48	26224199	96905
chr3	26127294	26327294	harbor1	chr3	26224250	26224336	LTR/ERV1	423	+	43	26224293	96999
chr3	26127294	26327294	harbor1	chr3	26224348	26224975	LTR/ERV1	2151	+	314	26224662	97368
chr3	195890869	196090869	harbor1	chr3	195933158	195933328	LTR/ERV1	419	+	85	195933243	42374
chr3	195890869	196090869	harbor1	chr3	195933329	195933514	LTR/ERV1	1326	+	92	195933421	42552
chr3	129959240	130159240	harbor1	chr3	130010457	130011854	LTR/ERV1	10274	+	698	130011155	51915
chr3	129959240	130159240	harbor1	chr3	130056124	130056913	LTR/ERV1	5465	+	394	130056518	97278
chr3	142238269	142438269	harbor1	chr3	142242267	142242335	LTR/ERV1	525	+	34	142242301	4032
chr3	142238269	142438269	harbor1	chr3	142242347	142242818	LTR/ERV1	1646	+	236	142242583	4314
chr3	142238269	142438269	harbor1	chr3	142242821	142243361	LTR/ERV1	683	+	270	142243091	4822
chr3	142238269	142438269	harbor1	chr3	142243764	142243868	LTR/ERV1	394	+	52	142243816	5547
chr3	142238269	142438269	harbor1	chr3	142243928	142244189	LTR/ERV1	818	+	130	142244058	5789
chr3	142238269	142438269	harbor1	chr3	142244622	142244861	LTR/ERV1	818	+	120	142244742	6473
chr3	142238269	142438269	harbor1	chr3	142254570	142254948	LTR/ERV1	2218	+	189	142254759	16490
chr3	142238269	142438269	harbor1	chr3	142256227	142256671	LTR/ERV1	2195	+	222	142256449	18180
chr3	142238269	142438269	harbor1	chr3	142258215	142258363	LTR/ERV1	1103	+	74	142258289	20020
chr3	142238269	142438269	harbor1	chr3	142278954	142279547	LTR/ERV1	2795	+	296	142279250	40981
chr3	142238269	142438269	harbor1	chr3	142279740	142280580	LTR/ERV1	14487	+	420	142280160	41891
chr3	142238269	142438269	harbor1	chr3	142281199	142282698	LTR/ERV1	14487	+	750	142281949	43680
chr3	142238269	142438269	harbor1	chr3	142283127	142284585	LTR/ERV1	14487	+	729	142283856	45587
chr3	142238269	142438269	harbor1	chr3	142284586	142284603	LTR/ERV1	3738	+	8	142284594	46325
chr3	142238269	142438269	harbor1	chr3	142285032	142285638	LTR/ERV1	3738	+	303	142285335	47066
chr3	142238269	142438269	harbor1	chr3	142285641	142288065	LTR/ERV1	14455	+	1212	142286853	48584
chr3	142238269	142438269	harbor1	chr3	142288073	142288244	LTR/ERV1	991	+	86	142288159	49890
chr3	142238269	142438269	harbor1	chr3	142288401	142288598	LTR/ERV1	1211	+	98	142288499	50230
chr3	142238269	142438269	harbor1	chr3	142288599	142289224	LTR/ERV1	3070	+	312	142288911	50642
chr3	177802793	178002793	harbor1	chr3	177898282	177898848	LTR/ERV1	1101	+	283	177898565	95772
chr3	177802793	178002793	harbor1	chr3	177898852	177900125	LTR/ERV1	8353	+	636	177899488	96695
chr3	56183057	56383057	harbor1	chr3	56225256	56225779	LTR/ERV1	1642	+	262	56225518	42461
chr3	126091217	126291217	harbor1	chr3	126148775	126149178	LTR/ERV1	2069	+	202	126148977	57760
chr3	126091217	126291217	harbor1	chr3	126166134	126166603	LTR/ERV1	2853	+	234	126166368	75151
chr3	126091217	126291217	harbor1	chr3	126167924	126170497	LTR/ERV1	10352	+	1286	126169210	77993
chr3	126091217	126291217	harbor1	chr3	126170493	126170707	LTR/ERV1	1489	+	107	126170600	79383
chr3	126091217	126291217	harbor1	chr3	126170709	126171016	LTR/ERV1	3919	+	154	126170863	79646
chr3	126091217	126291217	harbor1	chr3	126171313	126171586	LTR/ERV1	3919	+	136	126171449	80232
chr3	112534884	112734884	harbor1	chr3	112554200	112554626	LTR/ERV1	3310	+	213	112554413	19529
chr3	112534884	112734884	harbor1	chr3	112615537	112616090	LTR/ERV1	4322	+	276	112615813	80929
chr3	197033481	197233481	harbor1	chr3	197101080	197101174	LTR/ERV1	438	+	47	197101127	67646
chr3	2880676	3080676	harbor1	chr3	2888175	2888648	LTR/ERV1	2386	+	236	2888411	7735
chr3	2880676	3080676	harbor1	chr3	2888773	2889001	LTR/ERV1	1326	+	114	2888887	8211
chr3	89994876	90194876	harbor1	chr3	90071193	90071542	LTR/ERV1	2001	+	174	90071367	76491
chr3	89994876	90194876	harbor1	chr3	90072974	90073080	LTR/ERV1	831	+	53	90073027	78151
chr3	89994876	90194876	harbor1	chr3	90082984	90083400	LTR/ERV1	2775	+	208	90083192	88316
chr3	89994876	90194876	harbor1	chr3	90083420	90084466	LTR/ERV1	7065	+	523	90083943	89067
chr3	89994876	90194876	harbor1	chr3	90084461	90084607	LTR/ERV1	841	+	73	90084534	89658
chr3	89994876	90194876	harbor1	chr3	90084598	90085102	LTR/ERV1	3340	+	252	90084850	89974
chr3	89994876	90194876	harbor1	chr3	90085105	90085768	LTR/ERV1	4169	+	332	90085437	90561
chr3	89994876	90194876	harbor1	chr3	90085752	90086365	LTR/ERV1	2219	+	306	90086058	91182
chr3	89994876	90194876	harbor1	chr3	90086366	90086728	LTR/ERV1	2011	+	181	90086547	91671
chr3	59736139	59936139	harbor1	chr3	59802349	59802741	LTR/ERV1	2510	+	196	59802545	66406
chr3	59736139	59936139	harbor1	chr3	59805316	59805594	LTR/ERV1	577	+	139	59805455	69316
chr3	26450645	26650645	harbor1	chr3	26452847	26452946	LTR/ERV1	424	+	50	26452897	2252
chr3	26450645	26650645	harbor1	chr3	26452983	26453342	LTR/ERV1	766	+	180	26453163	2518
chr3	26450645	26650645	harbor1	chr3	26545705	26545925	LTR/ERV1	1917	+	110	26545815	95170
chr3	26450645	26650645	harbor1	chr3	26546327	26546493	LTR/ERV1	1917	+	83	26546410	95765
chr4	167327796	167527796	harbor1	chr4	167334607	167335318	LTR/ERV1	3517	+	356	167334963	7167
chr4	167327796	167527796	harbor1	chr4	167389444	167389905	LTR/ERV1	1380	+	230	167389674	61878
chr4	167327796	167527796	harbor1	chr4	167402735	167403072	LTR/ERV1	1918	+	168	167402903	75107
chr4	167327796	167527796	harbor1	chr4	167403070	167403354	LTR/ERV1	1535	+	142	167403212	75416
chr4	167327796	167527796	harbor1	chr4	167408626	167409065	LTR/ERV1	1029	+	220	167408846	81050
chr4	167327796	167527796	harbor1	chr4	167416414	167416884	LTR/ERV1	2782	+	235	167416649	88853
chr4	167327796	167527796	harbor1	chr4	167416885	167423786	LTR/ERV1	30915	+	3450	167420335	92539
chr4	167327796	167527796	harbor1	chr4	167423790	167424407	LTR/ERV1	3467	+	308	167424098	96302
chr4	87152883	87352883	harbor1	chr4	87184050	87184148	LTR/ERV1	507	+	49	87184099	31216
chr4	87152883	87352883	harbor1	chr4	87189596	87189675	LTR/ERV1	557	+	40	87189636	36753
chr4	87152883	87352883	harbor1	chr4	87221945	87222540	LTR/ERV1	2602	+	298	87222243	69360
chr4	87152883	87352883	harbor1	chr4	87247696	87248247	LTR/ERV1	3706	+	276	87247972	95089
chr4	87152883	87352883	harbor1	chr4	87249799	87249955	LTR/ERV1	553	+	78	87249877	96994
chr4	87152883	87352883	harbor1	chr4	87250120	87250406	LTR/ERV1	1537	+	143	87250263	97380
chr4	67892792	68092792	harbor1	chr4	67926469	67927713	LTR/ERV1	4578	+	622	67927091	34299
chr4	67892792	68092792	harbor1	chr4	67940660	67941001	LTR/ERV1	1992	+	170	67940830	48038
chr4	117755301	117955301	harbor1	chr4	117760697	117762167	LTR/ERV1	2184	+	735	117761432	6131
chr4	117755301	117955301	harbor1	chr4	117762206	117763355	LTR/ERV1	4320	+	574	117762780	7479
chr4	117755301	117955301	harbor1	chr4	117764809	117764948	LTR/ERV1	443	+	70	117764879	9578
chr4	117755301	117955301	harbor1	chr4	117765418	117766243	LTR/ERV1	1508	+	412	117765830	10529
chr4	117755301	117955301	harbor1	chr4	117766262	117766667	LTR/ERV1	2580	+	202	117766464	11163
chr4	117755301	117955301	harbor1	chr4	117770108	117771053	LTR/ERV1	5824	+	472	117770580	15279
chr4	117755301	117955301	harbor1	chr4	117807591	117808160	LTR/ERV1	3178	+	284	117807875	52574
chr4	117755301	117955301	harbor1	chr4	117808161	117808931	LTR/ERV1	9779	+	385	117808546	53245
chr4	117755301	117955301	harbor1	chr4	117809244	117810651	LTR/ERV1	9779	+	704	117809948	54647
chr4	117755301	117955301	harbor1	chr4	117810738	117811354	LTR/ERV1	3074	+	308	117811046	55745
chr4	117755301	117955301	harbor1	chr4	117821003	117821601	LTR/ERV1	3118	+	299	117821302	66001
chr4	117755301	117955301	harbor1	chr4	117823898	117824824	LTR/ERV1	3962	+	463	117824361	69060
chr4	84576701	84776701	harbor1	chr4	84664536	84666115	LTR/ERV1	11227	+	790	84665326	88625
chr4	64762341	64962341	harbor1	chr4	64762691	64763359	LTR/ERV1	2584	+	334	64763025	684
chr4	64762341	64962341	harbor1	chr4	64849240	64849702	LTR/ERV1	1927	+	231	64849471	87130
chr4	81360392	81560392	harbor1	chr4	81417631	81418194	LTR/ERV1	1811	+	282	81417913	57521
chr4	81360392	81560392	harbor1	chr4	81420796	81421243	LTR/ERV1	3820	+	224	81421020	60628
chr4	81360392	81560392	harbor1	chr4	81429399	81430034	LTR/ERV1	4785	+	318	81429717	69325
chr4	81360392	81560392	harbor1	chr4	81430322	81430678	LTR/ERV1	4785	+	178	81430500	70108
chr4	186071309	186271309	harbor1	chr4	186089635	186090147	LTR/ERV1	1994	+	256	186089891	18582
chr4	186071309	186271309	harbor1	chr4	186090454	186090613	LTR/ERV1	1994	+	80	186090534	19225
chr4	186071309	186271309	harbor1	chr4	186094782	186095032	LTR/ERV1	2414	+	125	186094907	23598
chr4	186071309	186271309	harbor1	chr4	186095338	186095449	LTR/ERV1	2414	+	56	186095394	24085
chr4	171701926	171901926	harbor1	chr4	171714803	171716465	LTR/ERV1	6192	+	831	171715634	13708
chr4	171701926	171901926	harbor1	chr4	171764988	171765559	LTR/ERV1	1464	+	286	171765274	63348
chr4	171701926	171901926	harbor1	chr4	171793428	171793846	LTR/ERV1	2300	+	209	171793637	91711
chr4	103346054	103546054	harbor1	chr4	103374639	103375391	LTR/ERV1	5519	+	376	103375015	28961
chr4	103346054	103546054	harbor1	chr4	103421364	103421557	LTR/ERV1	1176	+	96	103421460	75406
chr4	127025380	127225380	harbor1	chr4	127061146	127061649	LTR/ERV1	3082	+	252	127061398	36018
chr4	122433307	122633307	harbor1	chr4	122481691	122481900	LTR/ERV1	1443	+	104	122481795	48488
chr4	122433307	122633307	harbor1	chr4	122482403	122483009	LTR/ERV1	1443	+	303	122482706	49399
chr4	66816175	67016175	harbor1	chr4	66859987	66861313	LTR/ERV1	8970	+	663	66860650	44475
chr4	74189706	74389706	harbor1	chr4	74194602	74195001	LTR/ERV1	2396	+	200	74194802	5096
chr4	65005615	65205615	harbor1	chr4	65052039	65052166	LTR/ERV1	815	+	64	65052103	46488
chr4	65005615	65205615	harbor1	chr4	65058200	65058840	LTR/ERV1	2420	+	320	65058520	52905
chr4	65005615	65205615	harbor1	chr4	65068903	65069603	LTR/ERV1	3376	+	350	65069253	63638
chr4	65005615	65205615	harbor1	chr4	65071820	65072518	LTR/ERV1	4235	+	349	65072169	66554
chr4	65005615	65205615	harbor1	chr4	65073164	65073631	LTR/ERV1	2518	+	234	65073398	67783
chr4	65005615	65205615	harbor1	chr4	65075968	65076292	LTR/ERV1	1766	+	162	65076130	70515
chr4	65005615	65205615	harbor1	chr4	65076293	65076781	LTR/ERV1	2238	+	244	65076537	70922
chr4	65005615	65205615	harbor1	chr4	65076791	65076970	LTR/ERV1	922	+	90	65076881	71266
chr4	65005615	65205615	harbor1	chr4	65079998	65080045	LTR/ERV1	18470	+	24	65080022	74407
chr4	65005615	65205615	harbor1	chr4	65080047	65080363	LTR/ERV1	1858	+	158	65080205	74590
chr4	65005615	65205615	harbor1	chr4	65096290	65096851	LTR/ERV1	4073	+	280	65096570	90955
chr4	65005615	65205615	harbor1	chr4	65076975	65079674	LTR/ERV1	18470	+	1350	65078325	72710
chr4	33702504	33902504	harbor1	chr4	33724874	33725478	LTR/ERV1	4147	+	302	33725176	22672
chr4	33702504	33902504	harbor1	chr4	33737600	33738175	LTR/ERV1	2936	+	288	33737888	35384
chr4	33702504	33902504	harbor1	chr4	33740061	33740436	LTR/ERV1	2816	+	188	33740249	37745
chr4	33702504	33902504	harbor1	chr4	33740684	33741375	LTR/ERV1	4897	+	346	33741030	38526
chr4	33702504	33902504	harbor1	chr4	33741539	33742247	LTR/ERV1	5791	+	354	33741893	39389
chr4	33702504	33902504	harbor1	chr4	33742270	33742559	LTR/ERV1	2334	+	144	33742414	39910
chr4	33702504	33902504	harbor1	chr4	33742561	33743350	LTR/ERV1	6033	+	394	33742955	40451
chr4	33702504	33902504	harbor1	chr4	33770356	33770721	LTR/ERV1	1070	+	182	33770538	68034
chr4	33702504	33902504	harbor1	chr4	33780259	33780655	LTR/ERV1	2286	+	198	33780457	77953
chr4	86810336	87010336	harbor1	chr4	86882351	86883009	LTR/ERV1	4146	+	329	86882680	72344
chr4	148201865	148401865	harbor1	chr4	148229118	148229469	LTR/ERV1	2081	+	176	148229294	27429
chr4	148201865	148401865	harbor1	chr4	148298890	148299234	LTR/ERV1	2142	+	172	148299062	97197
chr4	148201865	148401865	harbor1	chr4	148299252	148299467	LTR/ERV1	711	+	108	148299360	97495
chr4	148201865	148401865	harbor1	chr4	148299487	148299800	LTR/ERV1	1163	+	156	148299643	97778
chr4	148201865	148401865	harbor1	chr4	148299819	148300588	LTR/ERV1	3304	+	384	148300203	98338
chr4	148201865	148401865	harbor1	chr4	148300872	148301395	LTR/ERV1	3304	+	262	148301134	99269
chr4	172651186	172851186	harbor1	chr4	172666337	172666789	LTR/ERV1	2504	+	226	172666563	15377
chr4	89605590	89805590	harbor1	chr4	89626046	89626565	LTR/ERV1	4061	+	260	89626306	20716
chr4	89605590	89805590	harbor1	chr4	89627662	89628289	LTR/ERV1	1483	+	314	89627976	22386
chr4	89605590	89805590	harbor1	chr4	89630217	89630745	LTR/ERV1	2001	+	264	89630481	24891
chr4	89605590	89805590	harbor1	chr4	89640644	89641493	LTR/ERV1	5390	+	424	89641068	35478
chr4	89605590	89805590	harbor1	chr4	89681261	89681677	LTR/ERV1	2837	+	208	89681469	75879
chr4	22340424	22540424	harbor1	chr4	22369650	22370486	LTR/ERV1	4599	+	418	22370068	29644
chr4	22340424	22540424	harbor1	chr4	22373540	22374089	LTR/ERV1	4116	+	274	22373814	33390
chr4	22340424	22540424	harbor1	chr4	22374179	22375401	LTR/ERV1	9226	+	611	22374790	34366
chr4	22340424	22540424	harbor1	chr4	22375713	22377314	LTR/ERV1	9226	+	800	22376513	36089
chr4	22340424	22540424	harbor1	chr4	22382187	22382732	LTR/ERV1	4132	+	272	22382459	42035
chr4	22340424	22540424	harbor1	chr4	22379770	22382186	LTR/ERV1	11815	+	1208	22380978	40554
chr4	114921141	115121141	harbor1	chr4	114921992	114922703	LTR/ERV1	3891	+	356	114922348	1207
chr4	88909884	89109884	harbor1	chr4	88941085	88941578	LTR/ERV1	2352	+	246	88941331	31447
chr4	88909884	89109884	harbor1	chr4	88941608	88941945	LTR/ERV1	1091	+	168	88941776	31892
chr4	88909884	89109884	harbor1	chr4	88941997	88942234	LTR/ERV1	667	+	118	88942115	32231
chr4	88909884	89109884	harbor1	chr4	88942810	88944082	LTR/ERV1	3999	+	636	88943446	33562
chr4	88909884	89109884	harbor1	chr4	88944370	88944619	LTR/ERV1	3999	+	124	88944494	34610
chr4	88909884	89109884	harbor1	chr4	88944919	88945242	LTR/ERV1	3266	+	162	88945081	35197
chr4	88909884	89109884	harbor1	chr4	88945251	88945558	LTR/ERV1	1240	+	154	88945405	35521
chr4	88909884	89109884	harbor1	chr4	88946048	88946411	LTR/ERV1	1300	+	182	88946230	36346
chr4	88909884	89109884	harbor1	chr4	88946505	88947034	LTR/ERV1	2028	+	264	88946769	36885
chr4	88909884	89109884	harbor1	chr4	88947035	88947128	LTR/ERV1	1749	+	46	88947081	37197
chr4	88909884	89109884	harbor1	chr4	88947427	88947824	LTR/ERV1	1749	+	198	88947625	37741
chr4	88909884	89109884	harbor1	chr4	88991770	88992258	LTR/ERV1	2032	+	244	88992014	82130
chr4	88909884	89109884	harbor1	chr4	88992535	88992555	LTR/ERV1	2032	+	10	88992545	82661
chr4	88909884	89109884	harbor1	chr4	89009159	89009447	LTR/ERV1	2515	+	144	89009303	99419
chr4	122482770	122682770	harbor1	chr4	122482403	122483009	LTR/ERV1	1443	+	303	122482706	64
chr4	122482770	122682770	harbor1	chr4	122541450	122542327	LTR/ERV1	4747	+	438	122541888	59118
chr4	136325228	136525228	harbor1	chr4	136335793	136336057	LTR/ERV1	790	+	132	136335925	10697
chr4	136325228	136525228	harbor1	chr4	136395167	136396652	LTR/ERV1	9919	+	742	136395909	70681
chr4	171028070	171228070	harbor1	chr4	171042983	171044435	LTR/ERV1	8324	+	726	171043709	15639
chr4	171028070	171228070	harbor1	chr4	171052973	171053088	LTR/ERV1	555	+	58	171053031	24961
chr4	171028070	171228070	harbor1	chr4	171053426	171053563	LTR/ERV1	2770	+	68	171053494	25424
chr4	171028070	171228070	harbor1	chr4	171053941	171056189	LTR/ERV1	3618	+	1124	171055065	26995
chr4	171028070	171228070	harbor1	chr4	171056343	171057480	LTR/ERV1	5942	+	568	171056911	28841
chr4	171028070	171228070	harbor1	chr4	171058646	171058737	LTR/ERV1	2738	+	46	171058692	30622
chr4	171028070	171228070	harbor1	chr4	171058778	171059224	LTR/ERV1	2738	+	223	171059001	30931
chr4	171028070	171228070	harbor1	chr4	171067692	171068033	LTR/ERV1	2893	+	170	171067862	39792
chr4	171028070	171228070	harbor1	chr4	171068463	171068868	LTR/ERV1	2893	+	202	171068665	40595
chr4	171028070	171228070	harbor1	chr4	171071900	171072525	LTR/ERV1	3905	+	312	171072212	44142
chr4	171028070	171228070	harbor1	chr4	171077360	171077640	LTR/ERV1	750	+	140	171077500	49430
chr4	52664284	52864284	harbor1	chr4	52684362	52684804	LTR/ERV1	2273	+	221	52684583	20299
chr4	52664284	52864284	harbor1	chr4	52684805	52685381	LTR/ERV1	8051	+	288	52685093	20809
chr4	52664284	52864284	harbor1	chr4	52685787	52686956	LTR/ERV1	8051	+	584	52686371	22087
chr4	52664284	52864284	harbor1	chr4	52687093	52687211	LTR/ERV1	643	+	59	52687152	22868
chr4	52664284	52864284	harbor1	chr4	52687200	52687400	LTR/ERV1	1170	+	100	52687300	23016
chr4	52664284	52864284	harbor1	chr4	52687704	52688113	LTR/ERV1	2371	+	204	52687908	23624
chr4	52664284	52864284	harbor1	chr4	52688414	52688647	LTR/ERV1	2371	+	116	52688530	24246
chr4	52664284	52864284	harbor1	chr4	52688648	52688791	LTR/ERV1	598	+	72	52688720	24436
chr4	52664284	52864284	harbor1	chr4	52688796	52689403	LTR/ERV1	3099	+	304	52689100	24816
chr4	52664284	52864284	harbor1	chr4	52689701	52689934	LTR/ERV1	3099	+	116	52689817	25533
chr4	52664284	52864284	harbor1	chr4	52689945	52690025	LTR/ERV1	467	+	40	52689985	25701
chr4	52664284	52864284	harbor1	chr4	52690454	52690613	LTR/ERV1	2662	+	80	52690534	26250
chr4	52664284	52864284	harbor1	chr4	52691282	52691492	LTR/ERV1	787	+	105	52691387	27103
chr4	52664284	52864284	harbor1	chr4	52699483	52700323	LTR/ERV1	9952	+	420	52699903	35619
chr4	52664284	52864284	harbor1	chr4	52700612	52701614	LTR/ERV1	9952	+	501	52701113	36829
chr4	52664284	52864284	harbor1	chr4	52701912	52701940	LTR/ERV1	9952	+	14	52701926	37642
chr4	52664284	52864284	harbor1	chr4	52702242	52702994	LTR/ERV1	9952	+	376	52702618	38334
chr4	52664284	52864284	harbor1	chr4	52702996	52703171	LTR/ERV1	983	+	88	52703084	38800
chr4	52664284	52864284	harbor1	chr4	52703616	52703755	LTR/ERV1	783	+	70	52703686	39402
chr4	52664284	52864284	harbor1	chr4	52704091	52704230	LTR/ERV1	708	+	70	52704161	39877
chr4	52664284	52864284	harbor1	chr4	52713763	52714175	LTR/ERV1	1072	+	206	52713969	49685
chr4	52664284	52864284	harbor1	chr4	52748431	52748850	LTR/ERV1	3953	+	210	52748641	84357
chr4	52664284	52864284	harbor1	chr4	52749166	52749519	LTR/ERV1	3953	+	176	52749342	85058
chr4	52664284	52864284	harbor1	chr4	52749793	52750014	LTR/ERV1	3953	+	110	52749903	85619
chr4	52664284	52864284	harbor1	chr4	52750295	52750651	LTR/ERV1	3953	+	178	52750473	86189
chr4	52664284	52864284	harbor1	chr4	52690924	52691281	LTR/ERV1	2662	+	178	52691102	26818
chr4	164239654	164439654	harbor1	chr4	164240615	164241372	LTR/ERV1	3481	+	378	164240993	1339
chr4	164239654	164439654	harbor1	chr4	164269100	164269237	LTR/ERV1	446	+	68	164269168	29514
chr4	164239654	164439654	harbor1	chr4	164269313	164269593	LTR/ERV1	811	+	140	164269453	29799
chr4	164239654	164439654	harbor1	chr4	164293135	164293577	LTR/ERV1	2402	+	221	164293356	53702
chr4	111728081	111928081	harbor1	chr4	111816297	111817021	LTR/ERV1	3696	+	362	111816659	88578
chr4	145326562	145526562	harbor1	chr4	145336408	145337196	LTR/ERV1	4177	+	394	145336802	10240
chr4	145326562	145526562	harbor1	chr4	145340420	145340735	LTR/ERV1	1556	+	158	145340578	14016
chr4	145326562	145526562	harbor1	chr4	145396387	145397141	LTR/ERV1	2888	+	377	145396764	70202
chr4	145326562	145526562	harbor1	chr4	145421421	145421646	LTR/ERV1	650	+	112	145421533	94971
chr4	145326562	145526562	harbor1	chr4	145421640	145421907	LTR/ERV1	651	+	134	145421774	95212
chr4	630657	830657	harbor1	chr4	691625	691727	LTR/ERV1	695	+	51	691676	61019
chr4	630657	830657	harbor1	chr4	693657	694115	LTR/ERV1	1713	+	229	693886	63229
chr4	630657	830657	harbor1	chr4	694300	694889	LTR/ERV1	4882	+	294	694594	63937
chr4	62636841	62836841	harbor1	chr4	62654702	62655148	LTR/ERV1	1554	+	223	62654925	18084
chr4	62636841	62836841	harbor1	chr4	62712754	62713188	LTR/ERV1	1228	+	217	62712971	76130
chr4	9586484	9786484	harbor1	chr4	9591554	9591681	LTR/ERV1	991	+	64	9591618	5134
chr4	9586484	9786484	harbor1	chr4	9599829	9600386	LTR/ERV1	4316	+	278	9600107	13623
chr4	9586484	9786484	harbor1	chr4	9603584	9606392	LTR/ERV1	13921	+	1404	9604988	18504
chr4	9586484	9786484	harbor1	chr4	9606382	9606694	LTR/ERV1	2199	+	156	9606538	20054
chr4	9586484	9786484	harbor1	chr4	9606695	9607243	LTR/ERV1	4358	+	274	9606969	20485
chr4	9586484	9786484	harbor1	chr4	9638973	9639319	LTR/ERV1	1871	+	173	9639146	52662
chr4	9586484	9786484	harbor1	chr4	9639325	9642266	LTR/ERV1	19752	+	1470	9640795	54311
chr4	9586484	9786484	harbor1	chr4	9642252	9643103	LTR/ERV1	6050	+	426	9642678	56194
chr4	9586484	9786484	harbor1	chr4	9643106	9643768	LTR/ERV1	4290	+	331	9643437	56953
chr4	9586484	9786484	harbor1	chr4	9643770	9643980	LTR/ERV1	1279	+	105	9643875	57391
chr4	9586484	9786484	harbor1	chr4	9643981	9644357	LTR/ERV1	2417	+	188	9644169	57685
chr4	9586484	9786484	harbor1	chr4	9644359	9644753	LTR/ERV1	2415	+	197	9644556	58072
chr4	9586484	9786484	harbor1	chr4	9655190	9655683	LTR/ERV1	4771	+	246	9655436	68952
chr4	9586484	9786484	harbor1	chr4	9655914	9656150	LTR/ERV1	4771	+	118	9656032	69548
chr4	9586484	9786484	harbor1	chr4	9679249	9679686	LTR/ERV1	2480	+	218	9679467	92983
chr4	9586484	9786484	harbor1	chr4	9679687	9680972	LTR/ERV1	7912	+	642	9680329	93845
chr4	9586484	9786484	harbor1	chr4	9680973	9681008	LTR/ERV1	2480	+	18	9680991	94507
chr4	9586484	9786484	harbor1	chr4	9600389	9603574	LTR/ERV1	21898	+	1592	9601981	15497
chr4	24602274	24802274	harbor1	chr4	24601757	24603128	LTR/ERV1	7416	+	686	24602443	169
chr4	24602274	24802274	harbor1	chr4	24603122	24603827	LTR/ERV1	4305	+	352	24603474	1200
chr4	24602274	24802274	harbor1	chr4	24604184	24604404	LTR/ERV1	4305	+	110	24604294	2020
chr4	24602274	24802274	harbor1	chr4	24604428	24604833	LTR/ERV1	1775	+	202	24604630	2356
chr4	135566888	135766888	harbor1	chr4	135594953	135595563	LTR/ERV1	3612	+	305	135595258	28370
chr4	135566888	135766888	harbor1	chr4	135595581	135598203	LTR/ERV1	32838	+	1311	135596892	30004
chr4	135566888	135766888	harbor1	chr4	135598626	135603416	LTR/ERV1	32838	+	2395	135601021	34133
chr4	135566888	135766888	harbor1	chr4	135603730	135604000	LTR/ERV1	9566	+	135	135603865	36977
chr4	135566888	135766888	harbor1	chr4	135603997	135604151	LTR/ERV1	951	+	77	135604074	37186
chr4	135566888	135766888	harbor1	chr4	135604152	135604761	LTR/ERV1	3885	+	304	135604456	37568
chr4	16404468	16604468	harbor1	chr4	16464721	16465261	LTR/ERV1	3142	+	270	16464991	60523
chr4	44527873	44727873	harbor1	chr4	44609445	44610137	LTR/ERV1	2874	+	346	44609791	81918
chr4	32934290	33134290	harbor1	chr4	32971597	32971868	LTR/ERV1	1434	+	136	32971733	37443
chr4	32934290	33134290	harbor1	chr4	33006238	33006605	LTR/ERV1	2033	+	184	33006422	72132
chr4	32934290	33134290	harbor1	chr4	33007126	33007308	LTR/ERV1	415	+	91	33007217	72927
chr4	12388433	12588433	harbor1	chr4	12420801	12420931	LTR/ERV1	2216	+	65	12420866	32433
chr4	12388433	12588433	harbor1	chr4	12420996	12421365	LTR/ERV1	2216	+	184	12421180	32747
chr4	12388433	12588433	harbor1	chr4	12421366	12421903	LTR/ERV1	2872	+	268	12421634	33201
chr4	12388433	12588433	harbor1	chr4	12421930	12421995	LTR/ERV1	492	+	32	12421962	33529
chr4	12388433	12588433	harbor1	chr4	12421999	12422198	LTR/ERV1	600	+	100	12422099	33666
chr4	12388433	12588433	harbor1	chr4	12422213	12423866	LTR/ERV1	6059	+	826	12423039	34606
chr4	12388433	12588433	harbor1	chr4	12423864	12424553	LTR/ERV1	8070	+	344	12424208	35775
chr4	12388433	12588433	harbor1	chr4	12424601	12425702	LTR/ERV1	8070	+	550	12425151	36718
chr4	12388433	12588433	harbor1	chr4	12431653	12431888	LTR/ERV1	1245	+	118	12431771	43338
chr4	12388433	12588433	harbor1	chr4	12431895	12432324	LTR/ERV1	2093	+	214	12432109	43676
chr4	12388433	12588433	harbor1	chr4	12432325	12433047	LTR/ERV1	4916	+	361	12432686	44253
chr4	12388433	12588433	harbor1	chr4	12433048	12433226	LTR/ERV1	2093	+	89	12433137	44704
chr4	12388433	12588433	harbor1	chr4	12459185	12459961	LTR/ERV1	5666	+	388	12459573	71140
chr4	12388433	12588433	harbor1	chr4	12460595	12460720	LTR/ERV1	836	+	62	12460657	72224
chr4	12388433	12588433	harbor1	chr4	12460825	12460880	LTR/ERV1	405	+	28	12460853	72420
chr4	37503265	37703265	harbor1	chr4	37546189	37546669	LTR/ERV1	3878	+	240	37546429	43164
chr4	37503265	37703265	harbor1	chr4	37546670	37547059	LTR/ERV1	2566	+	194	37546864	43599
chr4	37503265	37703265	harbor1	chr4	37547040	37547175	LTR/ERV1	767	+	68	37547108	43843
chr4	37503265	37703265	harbor1	chr4	37547156	37547779	LTR/ERV1	4803	+	312	37547468	44203
chr4	37503265	37703265	harbor1	chr4	37547765	37548768	LTR/ERV1	7191	+	502	37548267	45002
chr4	37503265	37703265	harbor1	chr4	37548759	37549353	LTR/ERV1	4691	+	297	37549056	45791
chr4	37503265	37703265	harbor1	chr4	37549339	37550447	LTR/ERV1	16604	+	554	37549893	46628
chr4	37503265	37703265	harbor1	chr4	37550517	37551985	LTR/ERV1	16604	+	734	37551251	47986
chr4	37503265	37703265	harbor1	chr4	37551986	37552466	LTR/ERV1	4003	+	240	37552226	48961
chr4	134887308	135087308	harbor1	chr4	134891671	134892143	LTR/ERV1	971	+	236	134891907	4599
chr4	134887308	135087308	harbor1	chr4	134911990	134912478	LTR/ERV1	2030	+	244	134912234	24926
chr4	134887308	135087308	harbor1	chr4	134914245	134914710	LTR/ERV1	2760	+	232	134914477	27169
chr4	134887308	135087308	harbor1	chr4	134916673	134917018	LTR/ERV1	2165	+	172	134916845	29537
chr4	134887308	135087308	harbor1	chr4	134917019	134917419	LTR/ERV1	2119	+	200	134917219	29911
chr5	114406406	114606406	harbor1	chr5	114432500	114433929	LTR/ERV1	10231	+	714	114433214	26808
chr5	44727948	44927948	harbor1	chr5	44784808	44785131	LTR/ERV1	2155	+	162	44784970	57022
chr5	44727948	44927948	harbor1	chr5	44794624	44794749	LTR/ERV1	901	+	62	44794686	66738
chr5	44727948	44927948	harbor1	chr5	44797821	44798332	LTR/ERV1	2083	+	256	44798077	70129
chr5	148364371	148564371	harbor1	chr5	148372603	148373124	LTR/ERV1	2267	+	260	148372863	8492
chr5	95433082	95633082	harbor1	chr5	95510191	95510881	LTR/ERV1	4283	+	345	95510536	77454
chr5	50410718	50610718	harbor1	chr5	50412536	50412777	LTR/ERV1	403	+	120	50412656	1938
chr5	50410718	50610718	harbor1	chr5	50416712	50417151	LTR/ERV1	2029	+	220	50416932	6214
chr5	50410718	50610718	harbor1	chr5	50426822	50427289	LTR/ERV1	1725	+	234	50427056	16338
chr5	50410718	50610718	harbor1	chr5	50464833	50466380	LTR/ERV1	10724	+	774	50465607	54889
chr5	112039980	112239980	harbor1	chr5	112059008	112059501	LTR/ERV1	554	+	246	112059254	19274
chr5	112039980	112239980	harbor1	chr5	112064266	112064526	LTR/ERV1	862	+	130	112064396	24416
chr5	70055089	70255089	harbor1	chr5	70056318	70057079	LTR/ERV1	2098	+	380	70056698	1609
chr5	70055089	70255089	harbor1	chr5	70057436	70058044	LTR/ERV1	4231	+	304	70057740	2651
chr5	114862092	115062092	harbor1	chr5	114924831	114925262	LTR/ERV1	2380	+	216	114925047	62955
chr5	114862092	115062092	harbor1	chr5	114928667	114930268	LTR/ERV1	9845	+	800	114929467	67375
chr5	180658311	180858311	harbor1	chr5	180674298	180674808	LTR/ERV1	1680	+	255	180674553	16242
chr5	180658311	180858311	harbor1	chr5	180679523	180680087	LTR/ERV1	3759	+	282	180679805	21494
chr5	180658311	180858311	harbor1	chr5	180712597	180713202	LTR/ERV1	5725	+	302	180712899	54588
chr5	180658311	180858311	harbor1	chr5	180713602	180713892	LTR/ERV1	5725	+	145	180713747	55436
chr5	113279058	113479058	harbor1	chr5	113329971	113330336	LTR/ERV1	1626	+	182	113330153	51095
chr5	113279058	113479058	harbor1	chr5	113357412	113358121	LTR/ERV1	3957	+	354	113357766	78708
chr5	171431517	171631517	harbor1	chr5	171456064	171456517	LTR/ERV1	2746	+	226	171456290	24773
chr5	96180165	96380165	harbor1	chr5	96278505	96278736	LTR/ERV1	612	+	116	96278621	98456
chr5	104760047	104960047	harbor1	chr5	104793629	104794019	LTR/ERV1	1754	+	195	104793824	33777
chr5	104760047	104960047	harbor1	chr5	104794522	104794989	LTR/ERV1	3840	+	234	104794756	34709
chr5	104760047	104960047	harbor1	chr5	104835056	104835269	LTR/ERV1	915	+	106	104835162	75115
chr5	104760047	104960047	harbor1	chr5	104843299	104843515	LTR/ERV1	1644	+	108	104843407	83360
chr5	104760047	104960047	harbor1	chr5	104843804	104844056	LTR/ERV1	1644	+	126	104843930	83883
chr5	104760047	104960047	harbor1	chr5	104844104	104844473	LTR/ERV1	2050	+	184	104844288	84241
chr5	22138530	22338530	harbor1	chr5	22165590	22166147	LTR/ERV1	3897	+	278	22165868	27338
chr5	92843353	93043353	harbor1	chr5	92934995	92935220	LTR/ERV1	1292	+	112	92935107	91754
chr5	15139137	15339137	harbor1	chr5	15166398	15166890	LTR/ERV1	2931	+	246	15166644	27507
chr5	15139137	15339137	harbor1	chr5	15179237	15179693	LTR/ERV1	2884	+	228	15179465	40328
chr5	22925057	23125057	harbor1	chr5	22928858	22929367	LTR/ERV1	2510	+	254	22929112	4055
chr5	22925057	23125057	harbor1	chr5	22929548	22929973	LTR/ERV1	1753	+	212	22929760	4703
chr5	22925057	23125057	harbor1	chr5	22929974	22934868	LTR/ERV1	23785	+	2447	22932421	7364
chr5	22925057	23125057	harbor1	chr5	22934869	22935380	LTR/ERV1	3512	+	256	22935125	10068
chr5	22925057	23125057	harbor1	chr5	22947537	22948029	LTR/ERV1	2330	+	246	22947783	22726
chr5	22925057	23125057	harbor1	chr5	22974591	22974910	LTR/ERV1	1810	+	160	22974751	49694
chr5	22925057	23125057	harbor1	chr5	22974911	22975304	LTR/ERV1	1814	+	196	22975107	50050
chr5	22925057	23125057	harbor1	chr5	22987421	22987876	LTR/ERV1	1487	+	228	22987649	62592
chr5	99621094	99821094	harbor1	chr5	99652562	99653091	LTR/ERV1	3064	+	264	99652826	31732
chr5	99621094	99821094	harbor1	chr5	99662578	99662854	LTR/ERV1	685	+	138	99662716	41622
chr5	99621094	99821094	harbor1	chr5	99697348	99697806	LTR/ERV1	2236	+	229	99697577	76483
chr5	99621094	99821094	harbor1	chr5	99705593	99706557	LTR/ERV1	4775	+	482	99706075	84981
chr5	75317080	75517080	harbor1	chr5	75407686	75407884	LTR/ERV1	4196	+	99	75407785	90705
chr5	75317080	75517080	harbor1	chr5	75408062	75408509	LTR/ERV1	4196	+	224	75408286	91206
chr5	75317080	75517080	harbor1	chr5	75333501	75335010	LTR/ERV1	10466	+	754	75334255	17175
chr5	112373528	112573528	harbor1	chr5	112389295	112389802	LTR/ERV1	2610	+	254	112389549	16021
chr5	112373528	112573528	harbor1	chr5	112443692	112444458	LTR/ERV1	6051	+	383	112444075	70547
chr5	112373528	112573528	harbor1	chr5	112444459	112450410	LTR/ERV1	46401	+	2976	112447435	73907
chr5	112373528	112573528	harbor1	chr5	112450435	112450726	LTR/ERV1	2352	+	146	112450581	77053
chr5	112373528	112573528	harbor1	chr5	112450727	112451498	LTR/ERV1	5986	+	386	112451113	77585
chr5	157245832	157445832	harbor1	chr5	157278760	157278857	LTR/ERV1	693	+	48	157278808	32976
chr5	157245832	157445832	harbor1	chr5	157278864	157279121	LTR/ERV1	974	+	128	157278992	33160
chr5	33444330	33644330	harbor1	chr5	33473046	33473890	LTR/ERV1	5109	+	422	33473468	29138
chr5	33444330	33644330	harbor1	chr5	33476703	33477479	LTR/ERV1	4687	+	388	33477091	32761
chr5	33444330	33644330	harbor1	chr5	33486853	33487283	LTR/ERV1	1307	+	215	33487068	42738
chr5	33444330	33644330	harbor1	chr5	33487284	33487640	LTR/ERV1	1912	+	178	33487462	43132
chr5	33444330	33644330	harbor1	chr5	33489902	33490072	LTR/ERV1	708	+	85	33489987	45657
chr5	33444330	33644330	harbor1	chr5	33490666	33490979	LTR/ERV1	1358	+	156	33490822	46492
chr5	33444330	33644330	harbor1	chr5	33491264	33491438	LTR/ERV1	1358	+	87	33491351	47021
chr5	33444330	33644330	harbor1	chr5	33492635	33492647	LTR/ERV1	2200	+	6	33492641	48311
chr5	33444330	33644330	harbor1	chr5	33492648	33493026	LTR/ERV1	2950	+	189	33492837	48507
chr5	33444330	33644330	harbor1	chr5	33493329	33493482	LTR/ERV1	2950	+	76	33493405	49075
chr5	33444330	33644330	harbor1	chr5	33493483	33493930	LTR/ERV1	2200	+	224	33493707	49377
chr5	33444330	33644330	harbor1	chr5	33507224	33507321	LTR/ERV1	5051	+	48	33507272	62942
chr5	33444330	33644330	harbor1	chr5	33507624	33508586	LTR/ERV1	5051	+	481	33508105	63775
chr5	33444330	33644330	harbor1	chr5	33508746	33509195	LTR/ERV1	1864	+	224	33508970	64640
chr5	33444330	33644330	harbor1	chr5	33511326	33511480	LTR/ERV1	2819	+	77	33511403	67073
chr5	33444330	33644330	harbor1	chr5	33511774	33512159	LTR/ERV1	2819	+	192	33511966	67636
chr5	33444330	33644330	harbor1	chr5	33516443	33517160	LTR/ERV1	4495	+	358	33516801	72471
chr5	60655448	60855448	harbor1	chr5	60658495	60659284	LTR/ERV1	5369	+	394	60658889	3441
chr5	60655448	60855448	harbor1	chr5	60659301	60659968	LTR/ERV1	4939	+	334	60659635	4187
chr5	60655448	60855448	harbor1	chr5	60660180	60661518	LTR/ERV1	9075	+	669	60660849	5401
chr5	60655448	60855448	harbor1	chr5	60661504	60662106	LTR/ERV1	27971	+	301	60661805	6357
chr5	60655448	60855448	harbor1	chr5	60662400	60665384	LTR/ERV1	27971	+	1492	60663892	8444
chr5	60655448	60855448	harbor1	chr5	60665407	60665700	LTR/ERV1	2268	+	146	60665553	10105
chr5	60655448	60855448	harbor1	chr5	60665702	60666453	LTR/ERV1	4940	+	376	60666078	10630
chr5	60655448	60855448	harbor1	chr5	60700948	60701269	LTR/ERV1	1665	+	160	60701108	45660
chr5	60655448	60855448	harbor1	chr5	60701918	60702178	LTR/ERV1	1502	+	130	60702048	46600
chr5	43783044	43983044	harbor1	chr5	43786495	43786860	LTR/ERV1	1945	+	182	43786677	3633
chr5	43783044	43983044	harbor1	chr5	43786861	43789513	LTR/ERV1	13276	+	1326	43788187	5143
chr5	43783044	43983044	harbor1	chr5	43789500	43789699	LTR/ERV1	1183	+	100	43789600	6556
chr5	43783044	43983044	harbor1	chr5	43789701	43790700	LTR/ERV1	5484	+	500	43790201	7157
chr5	43783044	43983044	harbor1	chr5	43790700	43791419	LTR/ERV1	4600	+	360	43791060	8016
chr5	43783044	43983044	harbor1	chr5	43791420	43791592	LTR/ERV1	1044	+	86	43791506	8462
chr5	43783044	43983044	harbor1	chr5	43797818	43798213	LTR/ERV1	1852	+	198	43798016	14972
chr5	111051662	111251662	harbor1	chr5	111130828	111131383	LTR/ERV1	1340	+	278	111131106	79444
chr5	111051662	111251662	harbor1	chr5	111131394	111131809	LTR/ERV1	1156	+	208	111131602	79940
chr5	119385142	119585142	harbor1	chr5	119434382	119434776	LTR/ERV1	2323	+	197	119434579	49437
chr5	119385142	119585142	harbor1	chr5	119435608	119435884	LTR/ERV1	1644	+	138	119435746	50604
chr5	119385142	119585142	harbor1	chr5	119435958	119436117	LTR/ERV1	515	+	80	119436038	50896
chr5	119385142	119585142	harbor1	chr5	119437486	119439169	LTR/ERV1	7985	+	842	119438328	53186
chr5	119385142	119585142	harbor1	chr5	119446130	119447266	LTR/ERV1	8216	+	568	119446698	61556
chr5	119385142	119585142	harbor1	chr5	119447316	119448828	LTR/ERV1	9651	+	756	119448072	62930
chr5	119385142	119585142	harbor1	chr5	119448831	119449308	LTR/ERV1	3176	+	238	119449069	63927
chr5	2800473	3000473	harbor1	chr5	2885415	2885905	LTR/ERV1	2082	+	245	2885660	85187
chr5	42579741	42779741	harbor1	chr5	42581660	42583145	LTR/ERV1	3444	+	742	42582402	2661
chr5	41759133	41959133	harbor1	chr5	41785908	41786769	LTR/ERV1	879	+	430	41786338	27205
chr5	41759133	41959133	harbor1	chr5	41816553	41816978	LTR/ERV1	2182	+	212	41816765	57632
chr5	98711181	98911181	harbor1	chr5	98758623	98758806	LTR/ERV1	577	+	92	98758715	47534
chr5	98711181	98911181	harbor1	chr5	98770684	98770804	LTR/ERV1	537	+	60	98770744	59563
chr5	99495896	99695896	harbor1	chr5	99579341	99579849	LTR/ERV1	1606	+	254	99579595	83699
chr5	99495896	99695896	harbor1	chr5	99581122	99581213	LTR/ERV1	800	+	46	99581168	85272
chr5	99495896	99695896	harbor1	chr5	99581355	99581555	LTR/ERV1	800	+	100	99581455	85559
chr5	99495896	99695896	harbor1	chr5	99565549	99565657	LTR/ERV1	729	+	54	99565603	69707
chr5	101394276	101594276	harbor1	chr5	101394038	101394686	LTR/ERV1	3988	+	324	101394362	86
chr5	101394276	101594276	harbor1	chr5	101394708	101397196	LTR/ERV1	6382	+	1244	101395952	1676
chr5	101394276	101594276	harbor1	chr5	101397202	101397345	LTR/ERV1	989	+	72	101397274	2998
chr5	101394276	101594276	harbor1	chr5	101457586	101457856	LTR/ERV1	483	+	135	101457721	63445
chr5	27914713	28114713	harbor1	chr5	28011639	28012278	LTR/ERV1	3875	+	320	28011959	97246
chr5	27914713	28114713	harbor1	chr5	28012374	28012667	LTR/ERV1	1301	+	146	28012520	97807
chr5	27914713	28114713	harbor1	chr5	28012686	28013516	LTR/ERV1	5861	+	415	28013101	98388
chr5	27914713	28114713	harbor1	chr5	28013557	28014607	LTR/ERV1	5861	+	525	28014082	99369
chr5	27914713	28114713	harbor1	chr5	28014606	28014803	LTR/ERV1	671	+	98	28014704	99991
chr5	42277158	42477158	harbor1	chr5	42287179	42287614	LTR/ERV1	2270	+	218	42287397	10239
chr5	42277158	42477158	harbor1	chr5	42295245	42295814	LTR/ERV1	1714	+	284	42295529	18371
chr5	42277158	42477158	harbor1	chr5	42315942	42316392	LTR/ERV1	3134	+	225	42316167	39009
chr5	143816291	144016291	harbor1	chr5	143870906	143870993	LTR/ERV1	1394	+	44	143870950	54659
chr5	143816291	144016291	harbor1	chr5	143870994	143871718	LTR/ERV1	3638	+	362	143871356	55065
chr5	143816291	144016291	harbor1	chr5	143871719	143872092	LTR/ERV1	1394	+	186	143871905	55614
chr5	143816291	144016291	harbor1	chr5	143878034	143878748	LTR/ERV1	4200	+	357	143878391	62100
chr5	143816291	144016291	harbor1	chr5	143880607	143880756	LTR/ERV1	420	+	74	143880681	64390
chr5	143816291	144016291	harbor1	chr5	143911763	143911954	LTR/ERV1	1725	+	96	143911859	95568
chr5	143816291	144016291	harbor1	chr5	143912237	143912525	LTR/ERV1	1725	+	144	143912381	96090
chr5	34881711	35081711	harbor1	chr5	34967364	34967924	LTR/ERV1	3951	+	280	34967644	85933
chr5	34881711	35081711	harbor1	chr5	34968238	34968428	LTR/ERV1	3951	+	95	34968333	86622
chr5	34881711	35081711	harbor1	chr5	34980224	34980762	LTR/ERV1	3582	+	269	34980493	98782
chr5	121653930	121853930	harbor1	chr5	121678465	121678575	LTR/ERV1	424	+	55	121678520	24590
chr5	121653930	121853930	harbor1	chr5	121681299	121681741	LTR/ERV1	1364	+	221	121681520	27590
chr5	121653930	121853930	harbor1	chr5	121686409	121687048	LTR/ERV1	3727	+	320	121686729	32799
chr5	121653930	121853930	harbor1	chr5	121719487	121720064	LTR/ERV1	3622	+	288	121719775	65845
chr5	121653930	121853930	harbor1	chr5	121728096	121728792	LTR/ERV1	4031	+	348	121728444	74514
chr5	121653930	121853930	harbor1	chr5	121728794	121729126	LTR/ERV1	1531	+	166	121728960	75030
chr5	121653930	121853930	harbor1	chr5	121730518	121730678	LTR/ERV1	869	+	80	121730598	76668
chr5	121653930	121853930	harbor1	chr5	121745492	121746022	LTR/ERV1	2502	+	265	121745757	91827
chr5	115531756	115731756	harbor1	chr5	115563195	115563737	LTR/ERV1	1760	+	271	115563466	31710
chr5	115531756	115731756	harbor1	chr5	115596491	115596637	LTR/ERV1	2316	+	73	115596564	64808
chr5	115531756	115731756	harbor1	chr5	115596946	115597253	LTR/ERV1	2316	+	154	115597100	65344
chr5	65171456	65371456	harbor1	chr5	65174180	65174289	LTR/ERV1	874	+	54	65174234	2778
chr5	65171456	65371456	harbor1	chr5	65249050	65249719	LTR/ERV1	3869	+	334	65249384	77928
chr5	65171456	65371456	harbor1	chr5	65174290	65179688	LTR/ERV1	43001	+	2699	65176989	5533
chr5	118381448	118581448	harbor1	chr5	118471977	118472509	LTR/ERV1	688	+	266	118472243	90795
chr5	43944190	44144190	harbor1	chr5	43959041	43959455	LTR/ERV1	1818	+	207	43959248	15058
chr5	43944190	44144190	harbor1	chr5	43985591	43986211	LTR/ERV1	3383	+	310	43985901	41711
chr5	63242813	63442813	harbor1	chr5	63247129	63247839	LTR/ERV1	2811	+	355	63247484	4671
chr5	63242813	63442813	harbor1	chr5	63254515	63255230	LTR/ERV1	2757	+	358	63254873	12060
chr5	63242813	63442813	harbor1	chr5	63255323	63255969	LTR/ERV1	4116	+	323	63255646	12833
chr5	63242813	63442813	harbor1	chr5	63324421	63324870	LTR/ERV1	3529	+	224	63324645	81832
chr5	63242813	63442813	harbor1	chr5	63325180	63325414	LTR/ERV1	3529	+	117	63325297	82484
chr5	63242813	63442813	harbor1	chr5	63323837	63324269	LTR/ERV1	2435	+	216	63324053	81240
chr5	13694257	13894257	harbor1	chr5	13706858	13707663	LTR/ERV1	5049	+	402	13707260	13003
chr5	112236126	112436126	harbor1	chr5	112323354	112323756	LTR/ERV1	900	+	201	112323555	87429
chr5	112236126	112436126	harbor1	chr5	112333925	112334860	LTR/ERV1	4560	+	468	112334393	98267
chr5	112236126	112436126	harbor1	chr5	112246438	112247020	LTR/ERV1	4306	+	291	112246729	10603
chr5	130990269	131190269	harbor1	chr5	130994066	130994251	LTR/ERV1	405	+	92	130994158	3889
chr5	107909962	108109962	harbor1	chr5	107978142	107978920	LTR/ERV1	4333	+	389	107978531	68569
chr5	131721269	131921269	harbor1	chr5	131740670	131741218	LTR/ERV1	3865	+	274	131740944	19675
chr5	116224122	116424122	harbor1	chr5	116263225	116263990	LTR/ERV1	5578	+	382	116263607	39485
chr5	149875079	150075079	harbor1	chr5	149887557	149888026	LTR/ERV1	3487	+	234	149887791	12712
chr5	149875079	150075079	harbor1	chr5	149888194	149888801	LTR/ERV1	1406	+	304	149888498	13419
chr5	149875079	150075079	harbor1	chr5	149889099	149889418	LTR/ERV1	1406	+	160	149889259	14180
chr5	149875079	150075079	harbor1	chr5	149889936	149889957	LTR/ERV1	3795	+	10	149889946	14867
chr5	149875079	150075079	harbor1	chr5	149890257	149891187	LTR/ERV1	3795	+	465	149890722	15643
chr5	149875079	150075079	harbor1	chr5	149891482	149891519	LTR/ERV1	3795	+	18	149891500	16421
chr5	149875079	150075079	harbor1	chr5	149891824	149892030	LTR/ERV1	3795	+	103	149891927	16848
chr5	149875079	150075079	harbor1	chr5	149892385	149892471	LTR/ERV1	417	+	43	149892428	17349
chr5	149875079	150075079	harbor1	chr5	149892807	149893427	LTR/ERV1	2757	+	310	149893117	18038
chr5	149875079	150075079	harbor1	chr5	149910682	149910867	LTR/ERV1	1967	+	92	149910774	35695
chr5	149875079	150075079	harbor1	chr5	149911180	149911504	LTR/ERV1	1967	+	162	149911342	36263
chr5	149875079	150075079	harbor1	chr5	149914413	149914930	LTR/ERV1	1976	+	258	149914671	39592
chr5	149875079	150075079	harbor1	chr5	149915669	149915972	LTR/ERV1	1673	+	152	149915821	40742
chr5	149875079	150075079	harbor1	chr5	149916139	149916295	LTR/ERV1	885	+	78	149916217	41138
chr5	149875079	150075079	harbor1	chr5	149917185	149917269	LTR/ERV1	434	+	42	149917227	42148
chr5	149875079	150075079	harbor1	chr5	149922831	149923206	LTR/ERV1	1675	+	188	149923019	47940
chr5	24059798	24259798	harbor1	chr5	24068972	24069790	LTR/ERV1	5028	+	409	24069381	9583
chr5	24059798	24259798	harbor1	chr5	24106362	24107205	LTR/ERV1	5067	+	422	24106784	46986
chr5	24059798	24259798	harbor1	chr5	24108387	24108537	LTR/ERV1	1078	+	75	24108462	48664
chr5	24059798	24259798	harbor1	chr5	24141044	24141370	LTR/ERV1	1781	+	163	24141207	81409
chr5	33107989	33307989	harbor1	chr5	33182564	33183041	LTR/ERV1	1830	+	238	33182802	74813
chr5	33107989	33307989	harbor1	chr5	33183423	33183544	LTR/ERV1	488	+	60	33183483	75494
chr5	22312254	22512254	harbor1	chr5	22385339	22385674	LTR/ERV1	1511	+	168	22385507	73253
chr5	22312254	22512254	harbor1	chr5	22386361	22386552	LTR/ERV1	1511	+	96	22386457	74203
chr5	22312254	22512254	harbor1	chr5	22387473	22387572	LTR/ERV1	464	+	50	22387523	75269
chr5	22312254	22512254	harbor1	chr5	22387798	22388083	LTR/ERV1	539	+	142	22387940	75686
chr5	22312254	22512254	harbor1	chr5	22410099	22410721	LTR/ERV1	4112	+	311	22410410	98156
chr5	127092167	127292167	harbor1	chr5	127182605	127183349	LTR/ERV1	5309	+	372	127182977	90810
chr5	32301632	32501632	harbor1	chr5	32315145	32315408	LTR/ERV1	3150	+	132	32315277	13645
chr5	32301632	32501632	harbor1	chr5	32315452	32315579	LTR/ERV1	3150	+	64	32315516	13884
chr5	32301632	32501632	harbor1	chr5	32315864	32316045	LTR/ERV1	3150	+	90	32315954	14322
chr5	32301632	32501632	harbor1	chr5	32322962	32323136	LTR/ERV1	4884	+	87	32323049	21417
chr5	32301632	32501632	harbor1	chr5	32323444	32324050	LTR/ERV1	4884	+	303	32323747	22115
chr5	32301632	32501632	harbor1	chr5	32342987	32343309	LTR/ERV1	1636	+	161	32343148	41516
chr5	32301632	32501632	harbor1	chr5	32343309	32343496	LTR/ERV1	1218	+	94	32343403	41771
chr5	32301632	32501632	harbor1	chr5	32343495	32343624	LTR/ERV1	772	+	64	32343559	41927
chr5	32301632	32501632	harbor1	chr5	32343634	32344051	LTR/ERV1	4573	+	208	32343842	42210
chr5	32301632	32501632	harbor1	chr5	32344319	32344531	LTR/ERV1	4573	+	106	32344425	42793
chr5	32301632	32501632	harbor1	chr5	32345432	32345639	LTR/ERV1	4573	+	104	32345536	43904
chr5	32301632	32501632	harbor1	chr5	32345628	32345683	LTR/ERV1	616	+	28	32345656	44024
chr5	32301632	32501632	harbor1	chr5	32346080	32346180	LTR/ERV1	616	+	50	32346130	44498
chr5	32301632	32501632	harbor1	chr5	32346518	32347214	LTR/ERV1	4309	+	348	32346866	45234
chr5	32301632	32501632	harbor1	chr5	32347224	32347921	LTR/ERV1	4544	+	348	32347572	45940
chr5	32301632	32501632	harbor1	chr5	32347922	32348538	LTR/ERV1	4297	+	308	32348230	46598
chr5	50283460	50483460	harbor1	chr5	50292674	50293550	LTR/ERV1	4809	+	438	50293112	9652
chr5	50283460	50483460	harbor1	chr5	50328453	50328751	LTR/ERV1	790	+	149	50328602	45142
chr5	50283460	50483460	harbor1	chr5	50369255	50370754	LTR/ERV1	11146	+	750	50370005	86545
chr5	50283460	50483460	harbor1	chr5	50370755	50376044	LTR/ERV1	42864	+	2644	50373399	89939
chr5	50283460	50483460	harbor1	chr5	50376041	50376649	LTR/ERV1	4990	+	304	50376345	92885
chr5	50283460	50483460	harbor1	chr5	50376651	50377983	LTR/ERV1	9221	+	666	50377317	93857
chr5	50283460	50483460	harbor1	chr5	50298637	50299077	LTR/ERV1	2346	+	220	50298857	15397
chr5	162383375	162583375	harbor1	chr5	162402599	162402780	LTR/ERV1	418	+	90	162402689	19314
chr5	162383375	162583375	harbor1	chr5	162402812	162403149	LTR/ERV1	1336	+	168	162402980	19605
chr5	162383375	162583375	harbor1	chr5	162421770	162422285	LTR/ERV1	1573	+	258	162422028	38653
chr5	162383375	162583375	harbor1	chr5	162444380	162445140	LTR/ERV1	4525	+	380	162444760	61385
chr5	162383375	162583375	harbor1	chr5	162447382	162447682	LTR/ERV1	1933	+	150	162447532	64157
chr5	162383375	162583375	harbor1	chr5	162448374	162448691	LTR/ERV1	1933	+	158	162448532	65157
chr5	162383375	162583375	harbor1	chr5	162449012	162449052	LTR/ERV1	1933	+	20	162449032	65657
chr5	162383375	162583375	harbor1	chr5	162449070	162449488	LTR/ERV1	3228	+	209	162449279	65904
chr5	162383375	162583375	harbor1	chr5	162450173	162450412	LTR/ERV1	3228	+	120	162450293	66918
chr5	162383375	162583375	harbor1	chr5	162450703	162451601	LTR/ERV1	3228	+	449	162451152	67777
chr5	162383375	162583375	harbor1	chr5	162451798	162452490	LTR/ERV1	2465	+	346	162452144	68769
chr5	162383375	162583375	harbor1	chr5	162452552	162452687	LTR/ERV1	414	+	68	162452620	69245
chr5	162383375	162583375	harbor1	chr5	162472477	162473156	LTR/ERV1	4676	+	340	162472817	89442
chr5	25446584	25646584	harbor1	chr5	25514484	25514598	LTR/ERV1	435	+	57	25514541	67957
chr5	25446584	25646584	harbor1	chr5	25518528	25519126	LTR/ERV1	2249	+	299	25518827	72243
chr5	75524268	75724268	harbor1	chr5	75619091	75619517	LTR/ERV1	2853	+	213	75619304	95036
chr5	43382296	43582296	harbor1	chr5	43467734	43467969	LTR/ERV1	2561	+	118	43467852	85556
chr5	43382296	43582296	harbor1	chr5	43468534	43468702	LTR/ERV1	2561	+	84	43468618	86322
chr5	43382296	43582296	harbor1	chr5	43469658	43470137	LTR/ERV1	4570	+	240	43469898	87602
chr5	43382296	43582296	harbor1	chr5	43470442	43470632	LTR/ERV1	4570	+	95	43470537	88241
chr5	27068287	27268287	harbor1	chr5	27091603	27092321	LTR/ERV1	3118	+	359	27091962	23675
chr5	27068287	27268287	harbor1	chr5	27119716	27121105	LTR/ERV1	8908	+	694	27120410	52123
chr5	27068287	27268287	harbor1	chr5	27142318	27142617	LTR/ERV1	857	+	150	27142468	74181
chr5	27068287	27268287	harbor1	chr5	27150510	27150617	LTR/ERV1	435	+	54	27150564	82277
chr5	27068287	27268287	harbor1	chr5	27151325	27153676	LTR/ERV1	6421	+	1176	27152501	84214
chr5	27068287	27268287	harbor1	chr5	27153791	27154510	LTR/ERV1	1387	+	360	27154151	85864
chr5	27068287	27268287	harbor1	chr5	27161943	27162324	LTR/ERV1	2192	+	190	27162133	93846
chr5	94389696	94589696	harbor1	chr5	94422092	94422602	LTR/ERV1	1622	+	255	94422347	32651
chr5	94389696	94589696	harbor1	chr5	94424058	94424230	LTR/ERV1	736	+	86	94424144	34448
chr5	44656601	44856601	harbor1	chr5	44664184	44665683	LTR/ERV1	5580	+	750	44664934	8333
chr5	44656601	44856601	harbor1	chr5	44693793	44694587	LTR/ERV1	5131	+	397	44694190	37589
chr5	44656601	44856601	harbor1	chr5	44696959	44697479	LTR/ERV1	2611	+	260	44697219	40618
chr5	44656601	44856601	harbor1	chr5	44714840	44715503	LTR/ERV1	2316	+	332	44715172	58571
chr5	163626041	163826041	harbor1	chr5	163645069	163645695	LTR/ERV1	2755	+	313	163645382	19341
chr5	163626041	163826041	harbor1	chr5	163661352	163661809	LTR/ERV1	2478	+	228	163661580	35539
chr6	89407233	89607233	harbor1	chr6	89449429	89449849	LTR/ERV1	2763	+	210	89449639	42406
chr6	89407233	89607233	harbor1	chr6	89491811	89492154	LTR/ERV1	1317	+	172	89491983	84750
chr6	8867257	9067257	harbor1	chr6	8886986	8888269	LTR/ERV1	8405	+	642	8887628	20371
chr6	8867257	9067257	harbor1	chr6	8950934	8951414	LTR/ERV1	1834	+	240	8951174	83917
chr6	73491115	73691115	harbor1	chr6	73564658	73565059	LTR/ERV1	3782	+	200	73564858	73743
chr6	73491115	73691115	harbor1	chr6	73565365	73565542	LTR/ERV1	3782	+	88	73565453	74338
chr6	27159620	27359620	harbor1	chr6	27164969	27165092	LTR/ERV1	737	+	62	27165031	5411
chr6	27159620	27359620	harbor1	chr6	27165360	27165648	LTR/ERV1	3007	+	144	27165504	5884
chr6	27159620	27359620	harbor1	chr6	27165945	27166250	LTR/ERV1	3007	+	152	27166097	6477
chr6	27159620	27359620	harbor1	chr6	27167063	27167200	LTR/ERV1	3999	+	68	27167131	7511
chr6	27159620	27359620	harbor1	chr6	27167753	27168504	LTR/ERV1	3999	+	376	27168129	8509
chr6	27159620	27359620	harbor1	chr6	27168511	27168680	LTR/ERV1	988	+	84	27168595	8975
chr6	27159620	27359620	harbor1	chr6	27169121	27169296	LTR/ERV1	988	+	88	27169209	9589
chr6	27159620	27359620	harbor1	chr6	27178168	27178461	LTR/ERV1	1354	+	146	27178314	18694
chr6	27159620	27359620	harbor1	chr6	27178469	27178647	LTR/ERV1	1523	+	89	27178558	18938
chr6	27159620	27359620	harbor1	chr6	27183989	27186157	LTR/ERV1	16844	+	1084	27185073	25453
chr6	27159620	27359620	harbor1	chr6	27186237	27186538	LTR/ERV1	1354	+	150	27186387	26767
chr6	27159620	27359620	harbor1	chr6	27205026	27205489	LTR/ERV1	3024	+	232	27205258	45638
chr6	27159620	27359620	harbor1	chr6	27178874	27183984	LTR/ERV1	40491	+	2555	27181429	21809
chr6	15243281	15443281	harbor1	chr6	15337166	15339538	LTR/ERV1	13409	+	1186	15338352	95071
chr6	15243281	15443281	harbor1	chr6	15339835	15339964	LTR/ERV1	939	+	64	15339899	96618
chr6	29529982	29729982	harbor1	chr6	29556588	29556674	LTR/ERV1	5248	+	43	29556631	26649
chr6	29529982	29729982	harbor1	chr6	29556977	29557801	LTR/ERV1	5248	+	412	29557389	27407
chr6	29529982	29729982	harbor1	chr6	29558214	29558989	LTR/ERV1	6267	+	388	29558602	28620
chr6	29529982	29729982	harbor1	chr6	29561984	29562613	LTR/ERV1	4603	+	314	29562298	32316
chr6	29529982	29729982	harbor1	chr6	29591885	29592343	LTR/ERV1	3323	+	229	29592114	62132
chr6	29529982	29729982	harbor1	chr6	29592602	29592682	LTR/ERV1	3323	+	40	29592642	62660
chr6	29529982	29729982	harbor1	chr6	29592974	29593042	LTR/ERV1	3323	+	34	29593008	63026
chr6	29529982	29729982	harbor1	chr6	29593346	29593367	LTR/ERV1	3323	+	10	29593356	63374
chr6	29529982	29729982	harbor1	chr6	29593377	29594044	LTR/ERV1	4107	+	334	29593711	63729
chr6	29529982	29729982	harbor1	chr6	29594068	29594247	LTR/ERV1	851	+	90	29594158	64176
chr6	29529982	29729982	harbor1	chr6	29594921	29595296	LTR/ERV1	697	+	188	29595109	65127
chr6	29529982	29729982	harbor1	chr6	29596036	29596851	LTR/ERV1	4882	+	408	29596444	66462
chr6	29529982	29729982	harbor1	chr6	29598287	29598485	LTR/ERV1	986	+	99	29598386	68404
chr6	153930576	154130576	harbor1	chr6	153957346	153957804	LTR/ERV1	2066	+	229	153957575	26999
chr6	153930576	154130576	harbor1	chr6	153995937	153996467	LTR/ERV1	1786	+	265	153996202	65626
chr6	153930576	154130576	harbor1	chr6	153959927	153960463	LTR/ERV1	3674	+	268	153960195	29619
chr6	150209265	150409265	harbor1	chr6	150297024	150297722	LTR/ERV1	2509	+	349	150297373	88108
chr6	163018289	163218289	harbor1	chr6	163083146	163083605	LTR/ERV1	3235	+	230	163083376	65087
chr6	153428299	153628299	harbor1	chr6	153446588	153446807	LTR/ERV1	1218	+	110	153446698	18399
chr6	153428299	153628299	harbor1	chr6	153450566	153451027	LTR/ERV1	3599	+	230	153450796	22497
chr6	153428299	153628299	harbor1	chr6	153482847	153483558	LTR/ERV1	4327	+	356	153483203	54904
chr6	153428299	153628299	harbor1	chr6	153483972	153484354	LTR/ERV1	2152	+	191	153484163	55864
chr6	153428299	153628299	harbor1	chr6	153484774	153484950	LTR/ERV1	2152	+	88	153484862	56563
chr6	160738745	160938745	harbor1	chr6	160769189	160769420	LTR/ERV1	1216	+	116	160769305	30560
chr6	160738745	160938745	harbor1	chr6	160769419	160769700	LTR/ERV1	1890	+	140	160769559	30814
chr6	160738745	160938745	harbor1	chr6	160777230	160778291	LTR/ERV1	6325	+	530	160777760	39015
chr6	160738745	160938745	harbor1	chr6	160778278	160779127	LTR/ERV1	5943	+	424	160778702	39957
chr6	160738745	160938745	harbor1	chr6	160779185	160780240	LTR/ERV1	6454	+	528	160779713	40968
chr6	160738745	160938745	harbor1	chr6	160780245	160780677	LTR/ERV1	2860	+	216	160780461	41716
chr6	160738745	160938745	harbor1	chr6	160780678	160780906	LTR/ERV1	968	+	114	160780792	42047
chr6	160738745	160938745	harbor1	chr6	160781430	160781776	LTR/ERV1	3940	+	173	160781603	42858
chr6	160738745	160938745	harbor1	chr6	160782139	160782536	LTR/ERV1	3940	+	198	160782337	43592
chr6	160738745	160938745	harbor1	chr6	160786833	160787238	LTR/ERV1	2489	+	202	160787035	48290
chr6	160738745	160938745	harbor1	chr6	160787239	160787324	LTR/ERV1	561	+	42	160787281	48536
chr6	160738745	160938745	harbor1	chr6	160787327	160787777	LTR/ERV1	2958	+	225	160787552	48807
chr6	160738745	160938745	harbor1	chr6	160788074	160788113	LTR/ERV1	2958	+	20	160788094	49349
chr6	160738745	160938745	harbor1	chr6	160788118	160788698	LTR/ERV1	4720	+	290	160788408	49663
chr6	160738745	160938745	harbor1	chr6	160788723	160789648	LTR/ERV1	2885	+	462	160789185	50440
chr6	160738745	160938745	harbor1	chr6	160789680	160789929	LTR/ERV1	1059	+	124	160789804	51059
chr6	160738745	160938745	harbor1	chr6	160789930	160790416	LTR/ERV1	2421	+	243	160790173	51428
chr6	160738745	160938745	harbor1	chr6	160794094	160795820	LTR/ERV1	10929	+	863	160794957	56212
chr6	160738745	160938745	harbor1	chr6	160795826	160796126	LTR/ERV1	2162	+	150	160795976	57231
chr6	160738745	160938745	harbor1	chr6	160796255	160796837	LTR/ERV1	3776	+	291	160796546	57801
chr6	160738745	160938745	harbor1	chr6	160796887	160797781	LTR/ERV1	4938	+	447	160797334	58589
chr6	160738745	160938745	harbor1	chr6	160797833	160799280	LTR/ERV1	4938	+	724	160798557	59812
chr6	160738745	160938745	harbor1	chr6	160799276	160799800	LTR/ERV1	4881	+	262	160799538	60793
chr6	160738745	160938745	harbor1	chr6	160799983	160800532	LTR/ERV1	3970	+	274	160800257	61512
chr6	160738745	160938745	harbor1	chr6	160800554	160801126	LTR/ERV1	2080	+	286	160800840	62095
chr6	160738745	160938745	harbor1	chr6	160801135	160801505	LTR/ERV1	2246	+	185	160801320	62575
chr6	160738745	160938745	harbor1	chr6	160801503	160801615	LTR/ERV1	753	+	56	160801559	62814
chr6	160738745	160938745	harbor1	chr6	160801621	160801956	LTR/ERV1	14389	+	168	160801789	63044
chr6	160738745	160938745	harbor1	chr6	160801957	160802061	LTR/ERV1	2602	+	52	160802009	63264
chr6	160738745	160938745	harbor1	chr6	160802092	160802505	LTR/ERV1	2602	+	206	160802298	63553
chr6	160738745	160938745	harbor1	chr6	160802506	160804386	LTR/ERV1	14389	+	940	160803446	64701
chr6	160738745	160938745	harbor1	chr6	160806755	160807466	LTR/ERV1	3123	+	356	160807111	68366
chr6	160738745	160938745	harbor1	chr6	160807598	160808220	LTR/ERV1	3014	+	311	160807909	69164
chr6	160738745	160938745	harbor1	chr6	160790836	160793520	LTR/ERV1	9900	+	1342	160792178	53433
chr6	74419851	74619851	harbor1	chr6	74451660	74452392	LTR/ERV1	3783	+	366	74452026	32175
chr6	74419851	74619851	harbor1	chr6	74468144	74468622	LTR/ERV1	3934	+	239	74468383	48532
chr6	74419851	74619851	harbor1	chr6	74468623	74469000	LTR/ERV1	2631	+	188	74468811	48960
chr6	74419851	74619851	harbor1	chr6	74468996	74469641	LTR/ERV1	4528	+	322	74469318	49467
chr6	74419851	74619851	harbor1	chr6	74469627	74470616	LTR/ERV1	6550	+	494	74470121	50270
chr6	74419851	74619851	harbor1	chr6	74470616	74474132	LTR/ERV1	23826	+	1758	74472374	52523
chr6	74419851	74619851	harbor1	chr6	74474133	74474614	LTR/ERV1	3914	+	240	74474373	54522
chr6	131788799	131988799	harbor1	chr6	131880847	131881156	LTR/ERV1	484	+	154	131881001	92202
chr6	7224375	7424375	harbor1	chr6	7315039	7316321	LTR/ERV1	7128	+	641	7315680	91305
chr6	110637617	110837617	harbor1	chr6	110678691	110679027	LTR/ERV1	1563	+	168	110678859	41242
chr6	110637617	110837617	harbor1	chr6	110679644	110679727	LTR/ERV1	1563	+	42	110679686	42069
chr6	62461566	62661566	harbor1	chr6	62478126	62478444	LTR/ERV1	1556	+	159	62478285	16719
chr6	9477553	9677553	harbor1	chr6	9479194	9479624	LTR/ERV1	2117	+	215	9479409	1856
chr6	9477553	9677553	harbor1	chr6	9501222	9501624	LTR/ERV1	1245	+	201	9501423	23870
chr6	9477553	9677553	harbor1	chr6	9504682	9505236	LTR/ERV1	4088	+	277	9504959	27406
chr6	132745761	132945761	harbor1	chr6	132793443	132793893	LTR/ERV1	2121	+	225	132793668	47907
chr6	117895445	118095445	harbor1	chr6	117928866	117929362	LTR/ERV1	3515	+	248	117929114	33669
chr6	117895445	118095445	harbor1	chr6	117965736	117966652	LTR/ERV1	5142	+	458	117966194	70749
chr6	113165636	113365636	harbor1	chr6	113188426	113188853	LTR/ERV1	1232	+	214	113188640	23004
chr6	6379237	6579237	harbor1	chr6	6462718	6463102	LTR/ERV1	3000	+	192	6462910	83673
chr6	6379237	6579237	harbor1	chr6	6477682	6478452	LTR/ERV1	6083	+	385	6478067	98830
chr6	163648038	163848038	harbor1	chr6	163693974	163694349	LTR/ERV1	556	+	188	163694162	46124
chr6	163648038	163848038	harbor1	chr6	163694388	163694692	LTR/ERV1	699	+	152	163694540	46502
chr6	79859249	80059249	harbor1	chr6	79858768	79859313	LTR/ERV1	2194	+	272	79859040	209
chr6	73413880	73613880	harbor1	chr6	73418960	73419129	LTR/ERV1	753	+	84	73419044	5164
chr6	73413880	73613880	harbor1	chr6	73419426	73419469	LTR/ERV1	753	+	22	73419448	5568
chr6	31571137	31771137	harbor1	chr6	31606033	31606190	LTR/ERV1	795	+	78	31606111	34974
chr6	71573459	71773459	harbor1	chr6	71660549	71660944	LTR/ERV1	2276	+	198	71660747	87288
chr6	88558850	88758850	harbor1	chr6	88603026	88603789	LTR/ERV1	5799	+	382	88603408	44558
chr6	88558850	88758850	harbor1	chr6	88621666	88622181	LTR/ERV1	2626	+	258	88621924	63074
chr6	57448002	57648002	harbor1	chr6	57499363	57499784	LTR/ERV1	1304	+	210	57499573	51571
chr6	57448002	57648002	harbor1	chr6	57502120	57502797	LTR/ERV1	4151	+	338	57502458	54456
chr6	117523503	117723503	harbor1	chr6	117582312	117583315	LTR/ERV1	3869	+	502	117582814	59311
chr6	117523503	117723503	harbor1	chr6	117611860	117612307	LTR/ERV1	3347	+	224	117612084	88581
chr6	117523503	117723503	harbor1	chr6	117612311	117612584	LTR/ERV1	6833	+	136	117612447	88944
chr6	117523503	117723503	harbor1	chr6	117613092	117615272	LTR/ERV1	6833	+	1090	117614182	90679
chr6	117523503	117723503	harbor1	chr6	117615274	117615864	LTR/ERV1	4852	+	295	117615569	92066
chr6	117523503	117723503	harbor1	chr6	117615892	117618640	LTR/ERV1	9576	+	1374	117617266	93763
chr6	117523503	117723503	harbor1	chr6	117621416	117622007	LTR/ERV1	4692	+	296	117621712	98209
chr6	117523503	117723503	harbor1	chr6	117622081	117622506	LTR/ERV1	2778	+	212	117622293	98790
chr6	117523503	117723503	harbor1	chr6	117622507	117623168	LTR/ERV1	3997	+	330	117622837	99334
chr6	117523503	117723503	harbor1	chr6	117623163	117623699	LTR/ERV1	3383	+	268	117623431	99928
chr6	117523503	117723503	harbor1	chr6	117618956	117621393	LTR/ERV1	9576	+	1218	117620174	96671
chr6	100740193	100940193	harbor1	chr6	100765220	100765766	LTR/ERV1	3401	+	273	100765493	25300
chr6	152454466	152654466	harbor1	chr6	152490339	152490744	LTR/ERV1	1858	+	202	152490541	36075
chr6	152454466	152654466	harbor1	chr6	152490745	152491147	LTR/ERV1	1603	+	201	152490946	36480
chr6	152454466	152654466	harbor1	chr6	152491151	152491325	LTR/ERV1	439	+	87	152491238	36772
chr6	152454466	152654466	harbor1	chr6	152491384	152495382	LTR/ERV1	21904	+	1999	152493383	38917
chr6	152454466	152654466	harbor1	chr6	152495358	152495439	LTR/ERV1	1830	+	40	152495398	40932
chr6	152454466	152654466	harbor1	chr6	152495440	152495968	LTR/ERV1	3632	+	264	152495704	41238
chr6	152454466	152654466	harbor1	chr6	152495969	152496185	LTR/ERV1	1830	+	108	152496077	41611
chr6	152454466	152654466	harbor1	chr6	152496236	152496751	LTR/ERV1	3331	+	258	152496494	42028
chr6	152454466	152654466	harbor1	chr6	152496752	152497169	LTR/ERV1	1909	+	208	152496960	42494
chr6	50922904	51122904	harbor1	chr6	50963406	50963753	LTR/ERV1	3325	+	174	50963580	40676
chr6	50922904	51122904	harbor1	chr6	50964052	50964279	LTR/ERV1	3325	+	114	50964166	41262
chr6	141986311	142186311	harbor1	chr6	142014659	142015366	LTR/ERV1	5070	+	354	142015013	28702
chr6	141986311	142186311	harbor1	chr6	142015666	142016117	LTR/ERV1	3427	+	226	142015892	29581
chr6	141986311	142186311	harbor1	chr6	142020061	142020725	LTR/ERV1	4238	+	332	142020393	34082
chr6	141986311	142186311	harbor1	chr6	142020723	142020953	LTR/ERV1	1346	+	115	142020838	34527
chr6	141986311	142186311	harbor1	chr6	142020952	142021331	LTR/ERV1	2397	+	190	142021142	34831
chr6	141986311	142186311	harbor1	chr6	142021332	142021782	LTR/ERV1	3465	+	225	142021557	35246
chr6	141986311	142186311	harbor1	chr6	142016120	142020058	LTR/ERV1	25093	+	1969	142018089	31778
chr6	60875370	61075370	harbor1	chr6	60883458	60883538	LTR/ERV1	424	+	40	60883498	8128
chr6	60875370	61075370	harbor1	chr6	60887274	60887641	LTR/ERV1	1220	+	184	60887458	12088
chr6	60875370	61075370	harbor1	chr6	60969159	60969688	LTR/ERV1	812	+	264	60969423	94053
chr6	60875370	61075370	harbor1	chr6	60975153	60975541	LTR/ERV1	1553	+	194	60975347	99977
chr6	109462889	109662889	harbor1	chr6	109477938	109478514	LTR/ERV1	3038	+	288	109478226	15337
chr6	109462889	109662889	harbor1	chr6	109507725	109508135	LTR/ERV1	2906	+	205	109507930	45041
chr6	109462889	109662889	harbor1	chr6	109511983	109512527	LTR/ERV1	4150	+	272	109512255	49366
chr6	109462889	109662889	harbor1	chr6	109513625	109514173	LTR/ERV1	2636	+	274	109513899	51010
chr6	109462889	109662889	harbor1	chr6	109509519	109510815	LTR/ERV1	5413	+	648	109510167	47278
chr6	155632587	155832587	harbor1	chr6	155684864	155685264	LTR/ERV1	1677	+	200	155685064	52477
chr6	155632587	155832587	harbor1	chr6	155709396	155709888	LTR/ERV1	916	+	246	155709642	77055
chr6	140403	340403	harbor1	chr6	150464	151023	LTR/ERV1	2703	+	280	150744	10341
chr6	140403	340403	harbor1	chr6	151430	151527	LTR/ERV1	583	+	48	151478	11075
chr6	140403	340403	harbor1	chr6	177774	178138	LTR/ERV1	2623	+	182	177956	37553
chr6	140403	340403	harbor1	chr6	187173	187799	LTR/ERV1	4436	+	313	187486	47083
chr6	140403	340403	harbor1	chr6	213695	214454	LTR/ERV1	4228	+	380	214075	73672
chr6	140403	340403	harbor1	chr6	179400	180718	LTR/ERV1	6868	+	659	180059	39656
chr6	167063438	167263438	harbor1	chr6	167102621	167102875	LTR/ERV1	1194	+	127	167102748	39310
chr6	54694823	54894823	harbor1	chr6	54778117	54778361	LTR/ERV1	2850	+	122	54778239	83416
chr6	54694823	54894823	harbor1	chr6	54778731	54778988	LTR/ERV1	2850	+	128	54778859	84036
chr6	102529509	102729509	harbor1	chr6	102547148	102547329	LTR/ERV1	415	+	90	102547238	17729
chr6	102529509	102729509	harbor1	chr6	102581411	102582974	LTR/ERV1	6648	+	782	102582193	52684
chr6	102529509	102729509	harbor1	chr6	102603562	102604289	LTR/ERV1	3794	+	364	102603926	74417
chr6	102529509	102729509	harbor1	chr6	102613573	102614074	LTR/ERV1	1831	+	250	102613823	84314
chr6	102529509	102729509	harbor1	chr6	102614075	102614294	LTR/ERV1	1532	+	110	102614185	84676
chr6	102529509	102729509	harbor1	chr6	102614292	102614963	LTR/ERV1	3310	+	336	102614628	85119
chr6	102529509	102729509	harbor1	chr6	102614974	102615373	LTR/ERV1	802	+	200	102615174	85665
chr6	102529509	102729509	harbor1	chr6	102615369	102615535	LTR/ERV1	800	+	83	102615452	85943
chr6	102529509	102729509	harbor1	chr6	102615536	102616077	LTR/ERV1	3504	+	270	102615806	86297
chr6	102529509	102729509	harbor1	chr6	102616532	102617597	LTR/ERV1	1946	+	532	102617064	87555
chr6	102529509	102729509	harbor1	chr6	102617598	102618161	LTR/ERV1	2893	+	282	102617880	88371
chr6	123235712	123435712	harbor1	chr6	123289785	123290874	LTR/ERV1	8173	+	544	123290329	54617
chr6	123235712	123435712	harbor1	chr6	123291163	123291282	LTR/ERV1	8173	+	60	123291223	55511
chr6	123235712	123435712	harbor1	chr6	123291577	123292106	LTR/ERV1	8173	+	264	123291841	56129
chr6	123235712	123435712	harbor1	chr6	123292488	123294406	LTR/ERV1	13055	+	959	123293447	57735
chr6	123235712	123435712	harbor1	chr6	123294753	123295018	LTR/ERV1	13055	+	132	123294885	59173
chr6	123235712	123435712	harbor1	chr6	123295026	123295500	LTR/ERV1	2053	+	237	123295263	59551
chr6	123235712	123435712	harbor1	chr6	123304696	123305721	LTR/ERV1	2512	+	512	123305208	69496
chr6	123235712	123435712	harbor1	chr6	123305702	123305846	LTR/ERV1	567	+	72	123305774	70062
chr6	123235712	123435712	harbor1	chr6	123306420	123306854	LTR/ERV1	1884	+	217	123306637	70925
chr6	123235712	123435712	harbor1	chr6	123289442	123289780	LTR/ERV1	1667	+	169	123289611	53899
chr6	45111403	45311403	harbor1	chr6	45154424	45154919	LTR/ERV1	1648	+	248	45154672	43269
chr6	45111403	45311403	harbor1	chr6	45168429	45168588	LTR/ERV1	1191	+	80	45168509	57106
chr6	45111403	45311403	harbor1	chr6	45185413	45185804	LTR/ERV1	1029	+	196	45185609	74206
chr6	45111403	45311403	harbor1	chr6	45186695	45186976	LTR/ERV1	576	+	140	45186835	75432
chr6	45111403	45311403	harbor1	chr6	45210123	45210741	LTR/ERV1	3512	+	309	45210432	99029
chr6	5624982	5824982	harbor1	chr6	5640522	5640969	LTR/ERV1	1586	+	224	5640746	15764
chr6	44780389	44980389	harbor1	chr6	44845457	44846181	LTR/ERV1	4328	+	362	44845819	65430
chr6	82976216	83176216	harbor1	chr6	82990187	82990275	LTR/ERV1	3107	+	44	82990231	14015
chr6	82976216	83176216	harbor1	chr6	82990578	82990961	LTR/ERV1	3107	+	192	82990770	14554
chr6	30123827	30323827	harbor1	chr6	30216600	30217155	LTR/ERV1	1316	+	278	30216878	93051
chr6	3943555	4143555	harbor1	chr6	3950627	3951053	LTR/ERV1	2433	+	213	3950840	7285
chr6	3943555	4143555	harbor1	chr6	3957728	3958289	LTR/ERV1	2742	+	280	3958008	14453
chr6	3943555	4143555	harbor1	chr6	3965141	3965450	LTR/ERV1	1952	+	154	3965295	21740
chr6	3943555	4143555	harbor1	chr6	3965578	3965954	LTR/ERV1	2565	+	188	3965766	22211
chr6	3943555	4143555	harbor1	chr6	3966907	3967007	LTR/ERV1	643	+	50	3966957	23402
chr6	3943555	4143555	harbor1	chr6	3967322	3968455	LTR/ERV1	7338	+	566	3967888	24333
chr6	3943555	4143555	harbor1	chr6	3968456	3968891	LTR/ERV1	2884	+	218	3968674	25119
chr6	3943555	4143555	harbor1	chr6	3968930	3969075	LTR/ERV1	1033	+	72	3969002	25447
chr6	3943555	4143555	harbor1	chr6	3973018	3973295	LTR/ERV1	5434	+	138	3973156	29601
chr6	3943555	4143555	harbor1	chr6	3973605	3974046	LTR/ERV1	5434	+	220	3973825	30270
chr6	3943555	4143555	harbor1	chr6	3991325	3991909	LTR/ERV1	3373	+	292	3991617	48062
chr6	3943555	4143555	harbor1	chr6	3997946	3998074	LTR/ERV1	789	+	64	3998010	54455
chr6	24247705	24447705	harbor1	chr6	24258610	24259043	LTR/ERV1	2752	+	216	24258826	11121
chr6	24247705	24447705	harbor1	chr6	24311884	24312317	LTR/ERV1	2331	+	216	24312100	64395
chr6	24247705	24447705	harbor1	chr6	24321473	24322156	LTR/ERV1	3335	+	342	24321815	74110
chr6	24247705	24447705	harbor1	chr6	24322215	24322976	LTR/ERV1	5701	+	380	24322595	74890
chr6	138798632	138998632	harbor1	chr6	138798721	138799151	LTR/ERV1	3306	+	215	138798936	304
chr6	138798632	138998632	harbor1	chr6	138890958	138891830	LTR/ERV1	5667	+	436	138891394	92762
chr6	138798632	138998632	harbor1	chr6	138894526	138894901	LTR/ERV1	1962	+	188	138894714	96082
chr6	54697121	54897121	harbor1	chr6	54778117	54778361	LTR/ERV1	2850	+	122	54778239	81118
chr6	54697121	54897121	harbor1	chr6	54778731	54778988	LTR/ERV1	2850	+	128	54778859	81738
chr6	71028237	71228237	harbor1	chr6	71041446	71041828	LTR/ERV1	4044	+	191	71041637	13400
chr6	71028237	71228237	harbor1	chr6	71042273	71042561	LTR/ERV1	4044	+	144	71042417	14180
chr6	71028237	71228237	harbor1	chr6	71052236	71052664	LTR/ERV1	2239	+	214	71052450	24213
chr6	71028237	71228237	harbor1	chr6	71086435	71086547	LTR/ERV1	864	+	56	71086491	58254
chr6	71028237	71228237	harbor1	chr6	71086550	71086885	LTR/ERV1	2305	+	168	71086718	58481
chr6	7229988	7429988	harbor1	chr6	7315039	7316321	LTR/ERV1	7128	+	641	7315680	85692
chr6	125933489	126133489	harbor1	chr6	125938980	125939730	LTR/ERV1	5571	+	375	125939355	5866
chr6	125933489	126133489	harbor1	chr6	125950424	125950769	LTR/ERV1	3033	+	172	125950596	17107
chr6	125933489	126133489	harbor1	chr6	125951124	125951404	LTR/ERV1	3033	+	140	125951264	17775
chr6	125933489	126133489	harbor1	chr6	125952741	125953897	LTR/ERV1	5509	+	578	125953319	19830
chr6	3113258	3313258	harbor1	chr6	3166113	3166761	LTR/ERV1	2820	+	324	3166437	53179
chr6	3113258	3313258	harbor1	chr6	3167036	3167304	LTR/ERV1	1665	+	134	3167170	53912
chr6	3113258	3313258	harbor1	chr6	3167305	3170584	LTR/ERV1	16372	+	1640	3168945	55687
chr6	3113258	3313258	harbor1	chr6	3170585	3171949	LTR/ERV1	9113	+	682	3171267	58009
chr6	3113258	3313258	harbor1	chr6	3171950	3172859	LTR/ERV1	8358	+	454	3172404	59146
chr6	3113258	3313258	harbor1	chr6	3172861	3173080	LTR/ERV1	1409	+	110	3172971	59713
chr6	3113258	3313258	harbor1	chr6	3173079	3173445	LTR/ERV1	2271	+	183	3173262	60004
chr6	3113258	3313258	harbor1	chr6	3173446	3173856	LTR/ERV1	2785	+	205	3173651	60393
chr6	3113258	3313258	harbor1	chr6	3187274	3187944	LTR/ERV1	2727	+	335	3187609	74351
chr6	3113258	3313258	harbor1	chr6	3188241	3188330	LTR/ERV1	2727	+	44	3188285	75027
chr6	83311936	83511936	harbor1	chr6	83341681	83342343	LTR/ERV1	2685	+	331	83342012	30076
chr6	85001241	85201241	harbor1	chr6	85092945	85095905	LTR/ERV1	22531	+	1480	85094425	93184
chr6	85001241	85201241	harbor1	chr6	85095906	85096349	LTR/ERV1	2689	+	222	85096128	94887
chr6	70568469	70768469	harbor1	chr6	70585885	70586031	LTR/ERV1	846	+	73	70585958	17489
chr6	134023350	134223350	harbor1	chr6	134035051	134035729	LTR/ERV1	2690	+	339	134035390	12040
chr6	134023350	134223350	harbor1	chr6	134079392	134080034	LTR/ERV1	3422	+	321	134079713	56363
chr6	134023350	134223350	harbor1	chr6	134080150	134080823	LTR/ERV1	2982	+	336	134080486	57136
chr6	134023350	134223350	harbor1	chr6	134084022	134084375	LTR/ERV1	899	+	176	134084198	60848
chr6	134023350	134223350	harbor1	chr6	134092408	134092792	LTR/ERV1	2112	+	192	134092600	69250
chr6	134023350	134223350	harbor1	chr6	134093241	134093480	LTR/ERV1	2112	+	120	134093361	70011
chr6	134023350	134223350	harbor1	chr6	134107656	134108056	LTR/ERV1	2207	+	200	134107856	84506
chr6	132818469	133018469	harbor1	chr6	132854714	132854960	LTR/ERV1	1100	+	123	132854837	36368
chr6	132818469	133018469	harbor1	chr6	132855443	132855622	LTR/ERV1	607	+	90	132855533	37064
chr6	132818469	133018469	harbor1	chr6	132876668	132876820	LTR/ERV1	444	+	76	132876744	58275
chr6	132818469	133018469	harbor1	chr6	132877036	132877326	LTR/ERV1	1024	+	145	132877181	58712
chr6	5304745	5504745	harbor1	chr6	5319064	5319765	LTR/ERV1	4387	+	350	5319414	14669
chr6	5304745	5504745	harbor1	chr6	5323746	5324215	LTR/ERV1	3057	+	234	5323980	19235
chr6	126254536	126454536	harbor1	chr6	126313067	126313661	LTR/ERV1	1480	+	297	126313364	58828
chr6	126254536	126454536	harbor1	chr6	126313662	126314464	LTR/ERV1	4851	+	401	126314063	59527
chr6	126254536	126454536	harbor1	chr6	126314465	126314724	LTR/ERV1	1480	+	130	126314595	60059
chr6	126254536	126454536	harbor1	chr6	126322510	126322939	LTR/ERV1	2400	+	214	126322724	68188
chr6	126254536	126454536	harbor1	chr6	126323025	126323827	LTR/ERV1	3866	+	401	126323426	68890
chr6	126254536	126454536	harbor1	chr6	126324143	126324595	LTR/ERV1	3866	+	226	126324369	69833
chr6	126254536	126454536	harbor1	chr6	126324610	126324821	LTR/ERV1	727	+	106	126324716	70180
chr6	126254536	126454536	harbor1	chr6	126324818	126325224	LTR/ERV1	1724	+	203	126325021	70485
chr6	126254536	126454536	harbor1	chr6	126325352	126326598	LTR/ERV1	4861	+	623	126325975	71439
chr6	126254536	126454536	harbor1	chr6	126332790	126333743	LTR/ERV1	3134	+	476	126333266	78730
chr6	126254536	126454536	harbor1	chr6	126333739	126334216	LTR/ERV1	1846	+	238	126333977	79441
chr6	126254536	126454536	harbor1	chr6	126334217	126334275	LTR/ERV1	1780	+	29	126334246	79710
chr6	126254536	126454536	harbor1	chr6	126334589	126334850	LTR/ERV1	1780	+	130	126334719	80183
chr6	126254536	126454536	harbor1	chr6	126335141	126335296	LTR/ERV1	1780	+	78	126335219	80683
chr6	117765525	117965525	harbor1	chr6	117858018	117858260	LTR/ERV1	1441	+	121	117858139	92614
chr6	69845984	70045984	harbor1	chr6	69889432	69890176	LTR/ERV1	4509	+	372	69889804	43820
chr6	69845984	70045984	harbor1	chr6	69893452	69894197	LTR/ERV1	5418	+	372	69893824	47840
chr6	69558022	69758022	harbor1	chr6	69616648	69617430	LTR/ERV1	5209	+	391	69617039	59017
chr6	69558022	69758022	harbor1	chr6	69622823	69623369	LTR/ERV1	3298	+	273	69623096	65074
chr6	69558022	69758022	harbor1	chr6	69651767	69652274	LTR/ERV1	2436	+	254	69652021	93999
chr6	624018	824018	harbor1	chr6	627648	627819	LTR/ERV1	687	+	86	627734	3716
chr6	624018	824018	harbor1	chr6	694446	695766	LTR/ERV1	8777	+	660	695106	71088
chr6	38756841	38956841	harbor1	chr6	38759563	38760014	LTR/ERV1	2830	+	226	38759789	2948
chr6	38756841	38956841	harbor1	chr6	38796434	38796892	LTR/ERV1	3386	+	229	38796663	39822
chr6	38756841	38956841	harbor1	chr6	38833297	38833359	LTR/ERV1	426	+	31	38833328	76487
chr6	38756841	38956841	harbor1	chr6	38833424	38833832	LTR/ERV1	1959	+	204	38833628	76787
chr6	38756841	38956841	harbor1	chr6	38797285	38797960	LTR/ERV1	4362	+	338	38797623	40782
chr6	87126938	87326938	harbor1	chr6	87133219	87133678	LTR/ERV1	2624	+	230	87133449	6511
chr6	102727206	102927206	harbor1	chr6	102750331	102750879	LTR/ERV1	1674	+	274	102750605	23399
chr6	102727206	102927206	harbor1	chr6	102798680	102799412	LTR/ERV1	1955	+	366	102799046	71840
chr6	79479490	79679490	harbor1	chr6	79525295	79525774	LTR/ERV1	3698	+	240	79525535	46045
chr6	79479490	79679490	harbor1	chr6	79525912	79526261	LTR/ERV1	23281	+	174	79526086	46596
chr6	79479490	79679490	harbor1	chr6	79529323	79529614	LTR/ERV1	1709	+	146	79529469	49979
chr6	79479490	79679490	harbor1	chr6	79546317	79546694	LTR/ERV1	421	+	188	79546505	67015
chr6	79479490	79679490	harbor1	chr6	79547563	79547840	LTR/ERV1	701	+	138	79547701	68211
chr6	79479490	79679490	harbor1	chr6	79526572	79529321	LTR/ERV1	23281	+	1374	79527946	48456
chr6	160506981	160706981	harbor1	chr6	160509543	160510059	LTR/ERV1	2056	+	258	160509801	2820
chr6	3909859	4109859	harbor1	chr6	3950627	3951053	LTR/ERV1	2433	+	213	3950840	40981
chr6	3909859	4109859	harbor1	chr6	3957728	3958289	LTR/ERV1	2742	+	280	3958008	48149
chr6	3909859	4109859	harbor1	chr6	3965141	3965450	LTR/ERV1	1952	+	154	3965295	55436
chr6	3909859	4109859	harbor1	chr6	3965578	3965954	LTR/ERV1	2565	+	188	3965766	55907
chr6	3909859	4109859	harbor1	chr6	3966907	3967007	LTR/ERV1	643	+	50	3966957	57098
chr6	3909859	4109859	harbor1	chr6	3967322	3968455	LTR/ERV1	7338	+	566	3967888	58029
chr6	3909859	4109859	harbor1	chr6	3968456	3968891	LTR/ERV1	2884	+	218	3968674	58815
chr6	3909859	4109859	harbor1	chr6	3968930	3969075	LTR/ERV1	1033	+	72	3969002	59143
chr6	3909859	4109859	harbor1	chr6	3973018	3973295	LTR/ERV1	5434	+	138	3973156	63297
chr6	3909859	4109859	harbor1	chr6	3973605	3974046	LTR/ERV1	5434	+	220	3973825	63966
chr6	3909859	4109859	harbor1	chr6	3991325	3991909	LTR/ERV1	3373	+	292	3991617	81758
chr6	3909859	4109859	harbor1	chr6	3997946	3998074	LTR/ERV1	789	+	64	3998010	88151
chr6	154531721	154731721	harbor1	chr6	154540948	154541110	LTR/ERV1	481	+	81	154541029	9308
chr6	15113525	15313525	harbor1	chr6	15114887	15114949	LTR/ERV1	2899	+	31	15114918	1393
chr6	15113525	15313525	harbor1	chr6	15115247	15115709	LTR/ERV1	2899	+	231	15115478	1953
chr6	15113525	15313525	harbor1	chr6	15128472	15128720	LTR/ERV1	3673	+	124	15128596	15071
chr6	15113525	15313525	harbor1	chr6	15129033	15129279	LTR/ERV1	3673	+	123	15129156	15631
chr6	15113525	15313525	harbor1	chr6	15129583	15129751	LTR/ERV1	3673	+	84	15129667	16142
chr6	15113525	15313525	harbor1	chr6	15207114	15207441	LTR/ERV1	3637	+	164	15207278	93753
chr6	15113525	15313525	harbor1	chr6	15207760	15207954	LTR/ERV1	3637	+	97	15207857	94332
chr6	15113525	15313525	harbor1	chr6	15210317	15210489	LTR/ERV1	2220	+	86	15210403	96878
chr6	15113525	15313525	harbor1	chr6	15210794	15211108	LTR/ERV1	2220	+	157	15210951	97426
chr6	36222729	36422729	harbor1	chr6	36235777	36236562	LTR/ERV1	5228	+	392	36236169	13440
chr6	157849752	158049752	harbor1	chr6	157895752	157896190	LTR/ERV1	1696	+	219	157895971	46219
chr6	87992008	88192008	harbor1	chr6	88082743	88083078	LTR/ERV1	904	+	168	88082911	90903
chr6	87992008	88192008	harbor1	chr6	88089720	88090405	LTR/ERV1	4197	+	342	88090062	98054
chr6	87992008	88192008	harbor1	chr6	88031106	88031815	LTR/ERV1	4008	+	354	88031460	39452
chr6	19937851	20137851	harbor1	chr6	20023441	20024345	LTR/ERV1	3772	+	452	20023893	86042
chr6	19937851	20137851	harbor1	chr6	20032174	20033467	LTR/ERV1	7308	+	646	20032820	94969
chr6	60935073	61135073	harbor1	chr6	60969159	60969688	LTR/ERV1	812	+	264	60969423	34350
chr6	60935073	61135073	harbor1	chr6	60975153	60975541	LTR/ERV1	1553	+	194	60975347	40274
chr6	51677616	51877616	harbor1	chr6	51727157	51727257	LTR/ERV1	3146	+	50	51727207	49591
chr6	51677616	51877616	harbor1	chr6	51727959	51728550	LTR/ERV1	3146	+	296	51728255	50639
chr6	51677616	51877616	harbor1	chr6	51723809	51724543	LTR/ERV1	2747	+	367	51724176	46560
chr6	3555333	3755333	harbor1	chr6	3649577	3649911	LTR/ERV1	2355	+	167	3649744	94411
chr6	81385411	81585411	harbor1	chr6	81441780	81442439	LTR/ERV1	5046	+	330	81442110	56699
chr6	19972286	20172286	harbor1	chr6	20023441	20024345	LTR/ERV1	3772	+	452	20023893	51607
chr6	19972286	20172286	harbor1	chr6	20032174	20033467	LTR/ERV1	7308	+	646	20032820	60534
chr6	146806804	147006804	harbor1	chr6	146823314	146823509	LTR/ERV1	584	+	98	146823412	16608
chr6	146806804	147006804	harbor1	chr6	146828135	146828928	LTR/ERV1	4113	+	396	146828531	21727
chr6	146806804	147006804	harbor1	chr6	146829859	146830716	LTR/ERV1	5082	+	428	146830287	23483
chr6	146806804	147006804	harbor1	chr6	146879944	146880550	LTR/ERV1	3916	+	303	146880247	73443
chr6	146806804	147006804	harbor1	chr6	146883926	146884252	LTR/ERV1	1894	+	163	146884089	77285
chr6	134979173	135179173	harbor1	chr6	135062319	135062346	LTR/ERV1	3375	+	14	135062333	83160
chr6	134979173	135179173	harbor1	chr6	135062638	135063194	LTR/ERV1	3375	+	278	135062916	83743
chr6	134979173	135179173	harbor1	chr6	135063896	135064468	LTR/ERV1	3543	+	286	135064182	85009
chr6	69858095	70058095	harbor1	chr6	69889432	69890176	LTR/ERV1	4509	+	372	69889804	31709
chr6	69858095	70058095	harbor1	chr6	69893452	69894197	LTR/ERV1	5418	+	372	69893824	35729
chr6	133830762	134030762	harbor1	chr6	133867754	133868072	LTR/ERV1	2295	+	159	133867913	37151
chr6	133830762	134030762	harbor1	chr6	133918518	133918981	LTR/ERV1	772	+	232	133918750	87988
chr6	24462613	24662613	harbor1	chr6	24467776	24467893	LTR/ERV1	1313	+	58	24467834	5221
chr6	24462613	24662613	harbor1	chr6	24468206	24468544	LTR/ERV1	1313	+	169	24468375	5762
chr6	24462613	24662613	harbor1	chr6	24468798	24468987	LTR/ERV1	1214	+	94	24468892	6279
chr6	24462613	24662613	harbor1	chr6	24478948	24479399	LTR/ERV1	3119	+	226	24479174	16561
chr6	24462613	24662613	harbor1	chr6	24542359	24542447	LTR/ERV1	2619	+	44	24542403	79790
chr6	24462613	24662613	harbor1	chr6	24542729	24543143	LTR/ERV1	2619	+	207	24542936	80323
chr6	17775647	17975647	harbor1	chr6	17840806	17841073	LTR/ERV1	893	+	134	17840940	65293
chr6	17775647	17975647	harbor1	chr6	17841365	17841533	LTR/ERV1	893	+	84	17841449	65802
chr6	44752213	44952213	harbor1	chr6	44772652	44773288	LTR/ERV1	1865	+	318	44772970	20757
chr6	44752213	44952213	harbor1	chr6	44775000	44775170	LTR/ERV1	436	+	85	44775085	22872
chr6	44752213	44952213	harbor1	chr6	44845457	44846181	LTR/ERV1	4328	+	362	44845819	93606
chr6	143240959	143440959	harbor1	chr6	143291094	143291620	LTR/ERV1	987	+	263	143291357	50398
chr6	90455076	90655076	harbor1	chr6	90486502	90487079	LTR/ERV1	2364	+	288	90486790	31714
chr6	90455076	90655076	harbor1	chr6	90487923	90488348	LTR/ERV1	1115	+	212	90488135	33059
chr6	108006476	108206476	harbor1	chr6	108006651	108006767	LTR/ERV1	3193	+	58	108006709	233
chr6	108006476	108206476	harbor1	chr6	108007044	108007070	LTR/ERV1	3193	+	13	108007057	581
chr6	108006476	108206476	harbor1	chr6	108007115	108007317	LTR/ERV1	3193	+	101	108007216	740
chr6	108006476	108206476	harbor1	chr6	108052691	108053152	LTR/ERV1	1929	+	230	108052921	46445
chr6	108006476	108206476	harbor1	chr6	108081254	108081340	LTR/ERV1	515	+	43	108081297	74821
chr6	97763843	97963843	harbor1	chr6	97778357	97779245	LTR/ERV1	5133	+	444	97778801	14958
chr6	97763843	97963843	harbor1	chr6	97779950	97782999	LTR/ERV1	20668	+	1524	97781474	17631
chr6	97763843	97963843	harbor1	chr6	97782979	97783125	LTR/ERV1	924	+	73	97783052	19209
chr6	97763843	97963843	harbor1	chr6	97783116	97783620	LTR/ERV1	3281	+	252	97783368	19525
chr6	97763843	97963843	harbor1	chr6	97783623	97784278	LTR/ERV1	4251	+	328	97783951	20108
chr6	97763843	97963843	harbor1	chr6	97784280	97784494	LTR/ERV1	1385	+	107	97784387	20544
chr6	97763843	97963843	harbor1	chr6	97784493	97784871	LTR/ERV1	2451	+	189	97784682	20839
chr6	97763843	97963843	harbor1	chr6	97784872	97785325	LTR/ERV1	3477	+	226	97785098	21255
chr6	97763843	97963843	harbor1	chr6	97779488	97779947	LTR/ERV1	3363	+	230	97779718	15875
chr6	153623845	153823845	harbor1	chr6	153663877	153664347	LTR/ERV1	3423	+	235	153664112	40267
chr6	153623845	153823845	harbor1	chr6	153673127	153673212	LTR/ERV1	526	+	42	153673169	49324
chr6	153623845	153823845	harbor1	chr6	153673205	153673592	LTR/ERV1	1268	+	194	153673399	49554
chr6	153623845	153823845	harbor1	chr6	153690215	153690554	LTR/ERV1	1069	+	170	153690385	66540
chr6	78275810	78475810	harbor1	chr6	78278961	78279679	LTR/ERV1	2923	+	359	78279320	3510
chr6	78275810	78475810	harbor1	chr6	78364436	78365331	LTR/ERV1	4812	+	448	78364884	89074
chr6	62778669	62978669	harbor1	chr6	62791671	62792025	LTR/ERV1	2040	+	177	62791848	13179
chr6	62778669	62978669	harbor1	chr6	62792028	62794923	LTR/ERV1	14707	+	1448	62793476	14807
chr6	62778669	62978669	harbor1	chr6	62794903	62795052	LTR/ERV1	869	+	74	62794977	16308
chr6	62778669	62978669	harbor1	chr6	62795043	62795284	LTR/ERV1	1546	+	120	62795163	16494
chr6	62778669	62978669	harbor1	chr6	62795280	62796449	LTR/ERV1	7680	+	584	62795864	17195
chr6	62778669	62978669	harbor1	chr6	62796451	62796666	LTR/ERV1	1400	+	108	62796559	17890
chr6	62778669	62978669	harbor1	chr6	62796665	62797041	LTR/ERV1	2118	+	188	62796853	18184
chr6	62778669	62978669	harbor1	chr6	62797042	62797450	LTR/ERV1	2726	+	204	62797246	18577
chr6	62778669	62978669	harbor1	chr6	62823877	62824552	LTR/ERV1	4029	+	338	62824215	45546
chr6	62778669	62978669	harbor1	chr6	62825018	62825499	LTR/ERV1	2160	+	240	62825258	46589
chr6	55954141	56154141	harbor1	chr6	55963265	55963714	LTR/ERV1	2286	+	224	55963489	9348
chr6	55954141	56154141	harbor1	chr6	56023775	56024182	LTR/ERV1	1767	+	204	56023979	69838
chr6	8255098	8455098	harbor1	chr6	8282358	8283547	LTR/ERV1	4750	+	594	8282952	27854
chr6	8255098	8455098	harbor1	chr6	8321758	8322210	LTR/ERV1	1834	+	226	8321984	66886
chr6	8255098	8455098	harbor1	chr6	8323005	8323017	LTR/ERV1	1834	+	6	8323011	67913
chr6	8255098	8455098	harbor1	chr6	8323407	8323448	LTR/ERV1	1834	+	20	8323427	68329
chr6	19440348	19640348	harbor1	chr6	19477388	19478012	LTR/ERV1	3460	+	312	19477700	37352
chr6	19440348	19640348	harbor1	chr6	19492664	19493063	LTR/ERV1	2251	+	200	19492864	52516
chr6	60410334	60610334	harbor1	chr6	60472570	60473078	LTR/ERV1	905	+	254	60472824	62490
chr6	159247284	159447284	harbor1	chr6	159295217	159295638	LTR/ERV1	960	+	210	159295427	48143
chr6	159247284	159447284	harbor1	chr6	159324712	159324938	LTR/ERV1	671	+	113	159324825	77541
chr6	64629114	64829114	harbor1	chr6	64662457	64662603	LTR/ERV1	429	+	73	64662530	33416
chr6	64629114	64829114	harbor1	chr6	64669870	64670387	LTR/ERV1	1409	+	258	64670128	41014
chr6	64629114	64829114	harbor1	chr6	64681505	64681607	LTR/ERV1	582	+	51	64681556	52442
chr6	64629114	64829114	harbor1	chr6	64682398	64682952	LTR/ERV1	2935	+	277	64682675	53561
chr6	64629114	64829114	harbor1	chr6	64710325	64710703	LTR/ERV1	2452	+	189	64710514	81400
chr6	64629114	64829114	harbor1	chr6	64683747	64684093	LTR/ERV1	440	+	173	64683920	54806
chr6	166643222	166843222	harbor1	chr6	166679581	166680847	LTR/ERV1	9124	+	633	166680214	36992
chr6	166643222	166843222	harbor1	chr6	166684115	166684579	LTR/ERV1	2145	+	232	166684347	41125
chr6	166643222	166843222	harbor1	chr6	166729641	166730715	LTR/ERV1	3639	+	537	166730178	86956
chr6	166643222	166843222	harbor1	chr6	166731479	166731957	LTR/ERV1	2470	+	239	166731718	88496
chr7	56585167	56785167	harbor1	chr7	56608502	56608854	LTR/ERV1	1208	+	176	56608678	23511
chr7	56585167	56785167	harbor1	chr7	56620420	56620848	LTR/ERV1	2390	+	214	56620634	35467
chr7	56585167	56785167	harbor1	chr7	56620866	56620990	LTR/ERV1	598	+	62	56620928	35761
chr7	56585167	56785167	harbor1	chr7	56621052	56621627	LTR/ERV1	2409	+	288	56621340	36173
chr7	56585167	56785167	harbor1	chr7	56621628	56621895	LTR/ERV1	1687	+	134	56621762	36595
chr7	56585167	56785167	harbor1	chr7	56625643	56626030	LTR/ERV1	1758	+	194	56625837	40670
chr7	56585167	56785167	harbor1	chr7	56621891	56625632	LTR/ERV1	14360	+	1870	56623761	38594
chr7	1736607	1936607	harbor1	chr7	1768826	1769284	LTR/ERV1	2530	+	229	1769055	32448
chr7	1736607	1936607	harbor1	chr7	1770033	1770088	LTR/ERV1	443	+	28	1770061	33454
chr7	1736607	1936607	harbor1	chr7	1770413	1770673	LTR/ERV1	462	+	130	1770543	33936
chr7	1736607	1936607	harbor1	chr7	1781795	1782035	LTR/ERV1	1818	+	120	1781915	45308
chr7	1736607	1936607	harbor1	chr7	1782339	1782564	LTR/ERV1	1818	+	112	1782451	45844
chr7	75518611	75718611	harbor1	chr7	75572552	75573539	LTR/ERV1	3794	+	494	75573046	54435
chr7	94137973	94337973	harbor1	chr7	94237447	94237877	LTR/ERV1	1667	+	215	94237662	99689
chr7	72221260	72421260	harbor1	chr7	72263979	72264394	LTR/ERV1	1203	+	208	72264187	42927
chr7	72221260	72421260	harbor1	chr7	72306013	72306513	LTR/ERV1	3859	+	250	72306263	85003
chr7	72221260	72421260	harbor1	chr7	72306516	72306625	LTR/ERV1	497	+	54	72306570	85310
chr7	72221260	72421260	harbor1	chr7	72306663	72306926	LTR/ERV1	1852	+	132	72306795	85535
chr7	1735810	1935810	harbor1	chr7	1768826	1769284	LTR/ERV1	2530	+	229	1769055	33245
chr7	1735810	1935810	harbor1	chr7	1770033	1770088	LTR/ERV1	443	+	28	1770061	34251
chr7	1735810	1935810	harbor1	chr7	1770413	1770673	LTR/ERV1	462	+	130	1770543	34733
chr7	1735810	1935810	harbor1	chr7	1781795	1782035	LTR/ERV1	1818	+	120	1781915	46105
chr7	1735810	1935810	harbor1	chr7	1782339	1782564	LTR/ERV1	1818	+	112	1782451	46641
chr7	112003637	112203637	harbor1	chr7	112014952	112015579	LTR/ERV1	4129	+	314	112015266	11629
chr7	112003637	112203637	harbor1	chr7	112072560	112073273	LTR/ERV1	3728	+	356	112072916	69279
chr7	119108827	119308827	harbor1	chr7	119123300	119124065	LTR/ERV1	4477	+	382	119123682	14855
chr7	67644948	67844948	harbor1	chr7	67672162	67672418	LTR/ERV1	744	+	128	67672290	27342
chr7	67644948	67844948	harbor1	chr7	67690198	67690936	LTR/ERV1	3267	+	369	67690567	45619
chr7	67644948	67844948	harbor1	chr7	67709138	67709698	LTR/ERV1	3597	+	280	67709418	64470
chr7	67644948	67844948	harbor1	chr7	67718411	67718881	LTR/ERV1	3532	+	235	67718646	73698
chr7	67644948	67844948	harbor1	chr7	67720143	67720763	LTR/ERV1	4372	+	310	67720453	75505
chr7	67644948	67844948	harbor1	chr7	67722747	67723496	LTR/ERV1	5736	+	374	67723121	78173
chr7	67644948	67844948	harbor1	chr7	67724526	67725162	LTR/ERV1	4689	+	318	67724844	79896
chr7	2087247	2287247	harbor1	chr7	2130587	2131117	LTR/ERV1	2438	+	265	2130852	43605
chr7	2087247	2287247	harbor1	chr7	2176929	2178554	LTR/ERV1	3957	+	812	2177741	90494
chr7	125700627	125900627	harbor1	chr7	125772998	125773731	LTR/ERV1	4077	+	366	125773364	72737
chr7	109307046	109507046	harbor1	chr7	109322813	109323224	LTR/ERV1	2571	+	206	109323019	15973
chr7	109307046	109507046	harbor1	chr7	109325085	109325170	LTR/ERV1	632	+	42	109325127	18081
chr7	109307046	109507046	harbor1	chr7	109325265	109325367	LTR/ERV1	615	+	51	109325316	18270
chr7	131046448	131246448	harbor1	chr7	131046253	131046550	LTR/ERV1	2681	+	148	131046401	47
chr7	131046448	131246448	harbor1	chr7	131058608	131060217	LTR/ERV1	10866	+	804	131059412	12964
chr7	131046448	131246448	harbor1	chr7	131090844	131091325	LTR/ERV1	2085	+	240	131091084	44636
chr7	131046448	131246448	harbor1	chr7	131071957	131072406	LTR/ERV1	3279	+	224	131072181	25733
chr7	126403725	126603725	harbor1	chr7	126434659	126434779	LTR/ERV1	1016	+	60	126434719	30994
chr7	126403725	126603725	harbor1	chr7	126434809	126434959	LTR/ERV1	1016	+	75	126434884	31159
chr7	126403725	126603725	harbor1	chr7	126485720	126486581	LTR/ERV1	4377	+	430	126486150	82425
chr7	23889592	24089592	harbor1	chr7	23968457	23968867	LTR/ERV1	2592	+	205	23968662	79070
chr7	7322911	7522911	harbor1	chr7	7351798	7352068	LTR/ERV1	1707	+	135	7351933	29022
chr7	7322911	7522911	harbor1	chr7	7352933	7353596	LTR/ERV1	3782	+	332	7353265	30354
chr7	7322911	7522911	harbor1	chr7	7364211	7364745	LTR/ERV1	2429	+	267	7364478	41567
chr7	21472595	21672595	harbor1	chr7	21541279	21541738	LTR/ERV1	965	+	230	21541509	68914
chr7	150218205	150418205	harbor1	chr7	150254381	150254862	LTR/ERV1	2683	+	240	150254621	36416
chr7	150218205	150418205	harbor1	chr7	150307240	150307703	LTR/ERV1	3239	+	232	150307472	89267
chr7	150218205	150418205	harbor1	chr7	150307704	150312283	LTR/ERV1	11427	+	2290	150309994	91789
chr7	150218205	150418205	harbor1	chr7	150312817	150313286	LTR/ERV1	3759	+	234	150313051	94846
chr7	154463106	154663106	harbor1	chr7	154532793	154533311	LTR/ERV1	1472	+	259	154533052	69946
chr7	63039994	63239994	harbor1	chr7	63093385	63093640	LTR/ERV1	764	+	128	63093513	53519
chr7	133667089	133867089	harbor1	chr7	133686401	133686549	LTR/ERV1	471	+	74	133686475	19386
chr7	133667089	133867089	harbor1	chr7	133687441	133687745	LTR/ERV1	1752	+	152	133687593	20504
chr7	133667089	133867089	harbor1	chr7	133696068	133696309	LTR/ERV1	1142	+	120	133696188	29099
chr7	78942432	79142432	harbor1	chr7	78968871	78969522	LTR/ERV1	3816	+	326	78969197	26765
chr7	79769351	79969351	harbor1	chr7	79835317	79835599	LTR/ERV1	1344	+	141	79835458	66107
chr7	79769351	79969351	harbor1	chr7	79846892	79847634	LTR/ERV1	3869	+	371	79847263	77912
chr7	79769351	79969351	harbor1	chr7	79862871	79863260	LTR/ERV1	2773	+	194	79863065	93714
chr7	79769351	79969351	harbor1	chr7	79863295	79863490	LTR/ERV1	2773	+	98	79863393	94042
chr7	11037962	11237962	harbor1	chr7	11082813	11083305	LTR/ERV1	2455	+	246	11083059	45097
chr7	56526456	56726456	harbor1	chr7	56584151	56584743	LTR/ERV1	2762	+	296	56584447	57991
chr7	56526456	56726456	harbor1	chr7	56608502	56608854	LTR/ERV1	1208	+	176	56608678	82222
chr7	56526456	56726456	harbor1	chr7	56620420	56620848	LTR/ERV1	2390	+	214	56620634	94178
chr7	56526456	56726456	harbor1	chr7	56620866	56620990	LTR/ERV1	598	+	62	56620928	94472
chr7	56526456	56726456	harbor1	chr7	56621052	56621627	LTR/ERV1	2409	+	288	56621340	94884
chr7	56526456	56726456	harbor1	chr7	56621628	56621895	LTR/ERV1	1687	+	134	56621762	95306
chr7	56526456	56726456	harbor1	chr7	56625643	56626030	LTR/ERV1	1758	+	194	56625837	99381
chr7	56526456	56726456	harbor1	chr7	56621891	56625632	LTR/ERV1	14360	+	1870	56623761	97305
chr7	16541080	16741080	harbor1	chr7	16571174	16571386	LTR/ERV1	1306	+	106	16571280	30200
chr7	16541080	16741080	harbor1	chr7	16575155	16575291	LTR/ERV1	999	+	68	16575223	34143
chr7	16541080	16741080	harbor1	chr7	16590549	16591030	LTR/ERV1	2927	+	240	16590789	49709
chr7	16541080	16741080	harbor1	chr7	16598002	16598552	LTR/ERV1	2139	+	275	16598277	57197
chr7	16541080	16741080	harbor1	chr7	16611563	16612101	LTR/ERV1	2679	+	269	16611832	70752
chr7	16541080	16741080	harbor1	chr7	16546899	16548846	LTR/ERV1	8109	+	974	16547873	6793
chr7	38792830	38992830	harbor1	chr7	38806828	38807296	LTR/ERV1	2293	+	234	38807062	14232
chr7	38792830	38992830	harbor1	chr7	38852039	38852518	LTR/ERV1	2034	+	240	38852279	59449
chr7	65321370	65521370	harbor1	chr7	65365875	65366196	LTR/ERV1	5437	+	160	65366035	44665
chr7	65321370	65521370	harbor1	chr7	65366474	65366913	LTR/ERV1	5437	+	220	65366694	45324
chr7	65321370	65521370	harbor1	chr7	65367200	65367411	LTR/ERV1	5437	+	106	65367306	45936
chr7	65321370	65521370	harbor1	chr7	65367660	65367926	LTR/ERV1	5437	+	133	65367793	46423
chr7	65321370	65521370	harbor1	chr7	65368171	65370350	LTR/ERV1	11331	+	1090	65369261	47891
chr7	65321370	65521370	harbor1	chr7	65370351	65370750	LTR/ERV1	1910	+	200	65370551	49181
chr7	65321370	65521370	harbor1	chr7	65381939	65383247	LTR/ERV1	7721	+	654	65382593	61223
chr7	65321370	65521370	harbor1	chr7	65403922	65406831	LTR/ERV1	17047	+	1454	65405376	84006
chr7	7265837	7465837	harbor1	chr7	7266428	7267063	LTR/ERV1	4652	+	318	7266746	909
chr7	7265837	7465837	harbor1	chr7	7280650	7281111	LTR/ERV1	3106	+	230	7280880	15043
chr7	7265837	7465837	harbor1	chr7	7322112	7322246	LTR/ERV1	768	+	67	7322179	56342
chr7	7265837	7465837	harbor1	chr7	7322245	7322366	LTR/ERV1	662	+	60	7322305	56468
chr7	7265837	7465837	harbor1	chr7	7351798	7352068	LTR/ERV1	1707	+	135	7351933	86096
chr7	7265837	7465837	harbor1	chr7	7352933	7353596	LTR/ERV1	3782	+	332	7353265	87428
chr7	7265837	7465837	harbor1	chr7	7364211	7364745	LTR/ERV1	2429	+	267	7364478	98641
chr7	127202488	127402488	harbor1	chr7	127207603	127208507	LTR/ERV1	4785	+	452	127208055	5567
chr7	127202488	127402488	harbor1	chr7	127266238	127266498	LTR/ERV1	983	+	130	127266368	63880
chr7	69394831	69594831	harbor1	chr7	69393648	69395028	LTR/ERV1	9585	+	690	69394338	493
chr7	69394831	69594831	harbor1	chr7	69481325	69481872	LTR/ERV1	5071	+	274	69481599	86768
chr7	69394831	69594831	harbor1	chr7	69482197	69482426	LTR/ERV1	5071	+	114	69482311	87480
chr7	69394831	69594831	harbor1	chr7	69482427	69483187	LTR/ERV1	5340	+	380	69482807	87976
chr7	104136121	104336121	harbor1	chr7	104137388	104138157	LTR/ERV1	4488	+	384	104137772	1651
chr7	104136121	104336121	harbor1	chr7	104173020	104173433	LTR/ERV1	2489	+	206	104173226	37105
chr7	104136121	104336121	harbor1	chr7	104173494	104173838	LTR/ERV1	1986	+	172	104173666	37545
chr7	104136121	104336121	harbor1	chr7	104174144	104174512	LTR/ERV1	1986	+	184	104174328	38207
chr7	104136121	104336121	harbor1	chr7	104174514	104175211	LTR/ERV1	3796	+	348	104174862	38741
chr7	104136121	104336121	harbor1	chr7	104175213	104176155	LTR/ERV1	3828	+	471	104175684	39563
chr7	104136121	104336121	harbor1	chr7	104176748	104177558	LTR/ERV1	2189	+	405	104177153	41032
chr7	104136121	104336121	harbor1	chr7	104178911	104179115	LTR/ERV1	1475	+	102	104179013	42892
chr7	104136121	104336121	harbor1	chr7	104179249	104179719	LTR/ERV1	1475	+	235	104179484	43363
chr7	104136121	104336121	harbor1	chr7	104179841	104181503	LTR/ERV1	5451	+	831	104180672	44551
chr7	104136121	104336121	harbor1	chr7	104181814	104182852	LTR/ERV1	5444	+	519	104182333	46212
chr7	104136121	104336121	harbor1	chr7	104183142	104183448	LTR/ERV1	5444	+	153	104183295	47174
chr7	104136121	104336121	harbor1	chr7	104183452	104183882	LTR/ERV1	2471	+	215	104183667	47546
chr7	104136121	104336121	harbor1	chr7	104184594	104185110	LTR/ERV1	1606	+	258	104184852	48731
chr7	104136121	104336121	harbor1	chr7	104185278	104185322	LTR/ERV1	1606	+	22	104185300	49179
chr7	53377076	53577076	harbor1	chr7	53385759	53386290	LTR/ERV1	3790	+	266	53386025	8949
chr7	53377076	53577076	harbor1	chr7	53389114	53389535	LTR/ERV1	972	+	210	53389324	12248
chr7	53377076	53577076	harbor1	chr7	53422057	53422607	LTR/ERV1	3507	+	275	53422332	45256
chr7	53377076	53577076	harbor1	chr7	53426061	53426547	LTR/ERV1	2706	+	243	53426304	49228
chr7	53377076	53577076	harbor1	chr7	53472494	53473030	LTR/ERV1	3848	+	268	53472762	95686
chr7	105957962	106157962	harbor1	chr7	105962113	105962228	LTR/ERV1	706	+	58	105962171	4209
chr7	105957962	106157962	harbor1	chr7	106037513	106038090	LTR/ERV1	2545	+	288	106037801	79839
chr7	26718798	26918798	harbor1	chr7	26736083	26736716	LTR/ERV1	4362	+	316	26736399	17601
chr7	26718798	26918798	harbor1	chr7	26784152	26784374	LTR/ERV1	489	+	111	26784263	65465
chr7	132182744	132382744	harbor1	chr7	132185610	132186032	LTR/ERV1	1972	+	211	132185821	3077
chr7	132182744	132382744	harbor1	chr7	132186664	132187370	LTR/ERV1	2569	+	353	132187017	4273
chr7	65698316	65898316	harbor1	chr7	65733451	65733716	LTR/ERV1	3418	+	132	65733583	35267
chr7	65698316	65898316	harbor1	chr7	65734032	65734329	LTR/ERV1	3418	+	148	65734180	35864
chr7	131818360	132018360	harbor1	chr7	131904816	131905295	LTR/ERV1	2577	+	240	131905056	86696
chr7	131818360	132018360	harbor1	chr7	131909167	131910634	LTR/ERV1	9022	+	734	131909901	91541
chr7	119415218	119615218	harbor1	chr7	119415534	119417877	LTR/ERV1	9558	+	1172	119416706	1488
chr7	119415218	119615218	harbor1	chr7	119417877	119417963	LTR/ERV1	543	+	43	119417920	2702
chr7	119415218	119615218	harbor1	chr7	119417972	119418443	LTR/ERV1	2655	+	236	119418208	2990
chr7	119415218	119615218	harbor1	chr7	119481735	119482450	LTR/ERV1	3997	+	358	119482093	66875
chr7	986338	1186338	harbor1	chr7	1068514	1069048	LTR/ERV1	3403	+	267	1068781	82443
chr7	17766358	17966358	harbor1	chr7	17782450	17782663	LTR/ERV1	595	+	106	17782556	16198
chr7	17766358	17966358	harbor1	chr7	17847928	17848873	LTR/ERV1	5589	+	472	17848400	82042
chr7	17766358	17966358	harbor1	chr7	17861402	17861999	LTR/ERV1	2378	+	298	17861700	95342
chr7	94087816	94287816	harbor1	chr7	94100721	94102397	LTR/ERV1	7600	+	838	94101559	13743
chr7	11693908	11893908	harbor1	chr7	11722036	11722651	LTR/ERV1	3644	+	308	11722344	28436
chr7	134981139	135181139	harbor1	chr7	135077678	135077741	LTR/ERV1	442	+	32	135077710	96571
chr7	94763305	94963305	harbor1	chr7	94776768	94777113	LTR/ERV1	1164	+	172	94776940	13635
chr7	94763305	94963305	harbor1	chr7	94777204	94777794	LTR/ERV1	3589	+	295	94777499	14194
chr7	94763305	94963305	harbor1	chr7	94825859	94826669	LTR/ERV1	4958	+	405	94826264	62959
chr7	94763305	94963305	harbor1	chr7	94847624	94847816	LTR/ERV1	724	+	96	94847720	84415
chr7	94763305	94963305	harbor1	chr7	94848110	94848286	LTR/ERV1	724	+	88	94848198	84893
chr7	94763305	94963305	harbor1	chr7	94781319	94781997	LTR/ERV1	3624	+	339	94781658	18353
chr7	86998990	87198990	harbor1	chr7	87030513	87030818	LTR/ERV1	818	+	152	87030665	31675
chr7	72629958	72829958	harbor1	chr7	72632933	72633419	LTR/ERV1	2923	+	243	72633176	3218
chr7	72629958	72829958	harbor1	chr7	72710928	72711473	LTR/ERV1	3635	+	272	72711200	81242
chr7	72629958	72829958	harbor1	chr7	72711787	72711801	LTR/ERV1	3635	+	7	72711794	81836
chr7	24979217	25179217	harbor1	chr7	25071799	25072206	LTR/ERV1	1239	+	204	25072003	92786
chr7	8361108	8561108	harbor1	chr7	8417731	8418204	LTR/ERV1	3311	+	236	8417967	56859
chr7	158329298	158529298	harbor1	chr7	158375525	158376317	LTR/ERV1	4336	+	396	158375921	46623
chr7	112955357	113155357	harbor1	chr7	113017160	113018654	LTR/ERV1	10373	+	747	113017907	62550
chr7	47384860	47584860	harbor1	chr7	47419370	47420076	LTR/ERV1	3621	+	353	47419723	34863
chr7	47384860	47584860	harbor1	chr7	47420211	47420896	LTR/ERV1	3960	+	342	47420553	35693
chr7	47384860	47584860	harbor1	chr7	47461422	47461574	LTR/ERV1	1098	+	76	47461498	76638
chr7	8357451	8557451	harbor1	chr7	8417731	8418204	LTR/ERV1	3311	+	236	8417967	60516
chr7	3449448	3649448	harbor1	chr7	3468309	3468940	LTR/ERV1	3483	+	316	3468625	19177
chr7	3449448	3649448	harbor1	chr7	3534682	3534999	LTR/ERV1	1622	+	158	3534840	85392
chr7	87404809	87604809	harbor1	chr7	87420117	87420471	LTR/ERV1	2205	+	177	87420294	15485
chr7	87404809	87604809	harbor1	chr7	87420459	87420604	LTR/ERV1	750	+	72	87420531	15722
chr7	121815146	122015146	harbor1	chr7	121857338	121857531	LTR/ERV1	806	+	96	121857434	42288
chr7	121815146	122015146	harbor1	chr7	121858028	121858315	LTR/ERV1	806	+	144	121858172	43026
chr7	121815146	122015146	harbor1	chr7	121904174	121904466	LTR/ERV1	452	+	146	121904320	89174
chr7	66085610	66285610	harbor1	chr7	66156829	66156874	LTR/ERV1	2196	+	22	66156851	71241
chr7	66085610	66285610	harbor1	chr7	66157182	66157515	LTR/ERV1	2196	+	166	66157348	71738
chr7	66085610	66285610	harbor1	chr7	66185404	66185501	LTR/ERV1	2234	+	48	66185452	99842
chr7	90742581	90942581	harbor1	chr7	90770840	90771250	LTR/ERV1	1867	+	205	90771045	28464
chr7	48401025	48601025	harbor1	chr7	48479958	48480378	LTR/ERV1	1815	+	210	48480168	79143
chr7	108557917	108757917	harbor1	chr7	108579245	108580737	LTR/ERV1	6962	+	746	108579991	22074
chr7	56248624	56448624	harbor1	chr7	56255515	56256509	LTR/ERV1	2728	+	497	56256012	7388
chr7	56248624	56448624	harbor1	chr7	56272523	56272616	LTR/ERV1	655	+	46	56272569	23945
chr7	56248624	56448624	harbor1	chr7	56272914	56273027	LTR/ERV1	657	+	56	56272970	24346
chr7	56248624	56448624	harbor1	chr7	56343506	56343847	LTR/ERV1	1162	+	170	56343676	95052
chr7	42931029	43131029	harbor1	chr7	42947943	42948571	LTR/ERV1	3632	+	314	42948257	17228
chr7	42931029	43131029	harbor1	chr7	42948576	42948725	LTR/ERV1	465	+	74	42948650	17621
chr7	42931029	43131029	harbor1	chr7	42948725	42949036	LTR/ERV1	20176	+	156	42948881	17852
chr7	42931029	43131029	harbor1	chr7	42949325	42949831	LTR/ERV1	20176	+	253	42949578	18549
chr7	42931029	43131029	harbor1	chr7	42950142	42950476	LTR/ERV1	20176	+	167	42950309	19280
chr7	42931029	43131029	harbor1	chr7	42950862	42952243	LTR/ERV1	20176	+	690	42951552	20523
chr7	42931029	43131029	harbor1	chr7	42952523	42954067	LTR/ERV1	20176	+	772	42953295	22266
chr7	42931029	43131029	harbor1	chr7	42961636	42962800	LTR/ERV1	6258	+	582	42962218	31189
chr7	42931029	43131029	harbor1	chr7	42962824	42963429	LTR/ERV1	3477	+	302	42963126	32097
chr7	42931029	43131029	harbor1	chr7	42970432	42971063	LTR/ERV1	1944	+	316	42970748	39719
chr7	42931029	43131029	harbor1	chr7	42974602	42974777	LTR/ERV1	1246	+	88	42974690	43661
chr7	42931029	43131029	harbor1	chr7	42974796	42974995	LTR/ERV1	1333	+	100	42974896	43867
chr7	154500976	154700976	harbor1	chr7	154532793	154533311	LTR/ERV1	1472	+	259	154533052	32076
chr7	126295872	126495872	harbor1	chr7	126301231	126301705	LTR/ERV1	2782	+	237	126301468	5596
chr7	126295872	126495872	harbor1	chr7	126301782	126301889	LTR/ERV1	493	+	54	126301836	5964
chr7	126295872	126495872	harbor1	chr7	126301896	126303103	LTR/ERV1	3202	+	604	126302500	6628
chr7	126295872	126495872	harbor1	chr7	126304680	126305122	LTR/ERV1	2645	+	221	126304901	9029
chr7	126295872	126495872	harbor1	chr7	126305123	126305687	LTR/ERV1	2380	+	282	126305405	9533
chr7	126295872	126495872	harbor1	chr7	126303102	126304616	LTR/ERV1	4354	+	757	126303859	7987
chr7	645232	845232	harbor1	chr7	725511	726196	LTR/ERV1	2247	+	342	725853	80621
chr7	52222140	52422140	harbor1	chr7	52272845	52273494	LTR/ERV1	4802	+	324	52273169	51029
chr7	52222140	52422140	harbor1	chr7	52294853	52295367	LTR/ERV1	2970	+	257	52295110	72970
chr7	52222140	52422140	harbor1	chr7	52295368	52297269	LTR/ERV1	8367	+	950	52296318	74178
chr7	52222140	52422140	harbor1	chr7	52308619	52309032	LTR/ERV1	2047	+	206	52308825	86685
chr7	52222140	52422140	harbor1	chr7	52320265	52320681	LTR/ERV1	1466	+	208	52320473	98333
chr7	52222140	52422140	harbor1	chr7	52320758	52321279	LTR/ERV1	1534	+	260	52321018	98878
chr7	158589512	158789512	harbor1	chr7	158625988	158626154	LTR/ERV1	3778	+	83	158626071	36559
chr7	158589512	158789512	harbor1	chr7	158626446	158626973	LTR/ERV1	3778	+	264	158626710	37198
chr7	35848454	36048454	harbor1	chr7	35933418	35933759	LTR/ERV1	1148	+	170	35933588	85134
chr7	759406	959406	harbor1	chr7	797269	797375	LTR/ERV1	523	+	53	797322	37916
chr7	759406	959406	harbor1	chr7	797376	797861	LTR/ERV1	3330	+	242	797618	38212
chr7	44753	244753	harbor1	chr7	50015	50399	LTR/ERV1	2244	+	192	50207	5454
chr7	44753	244753	harbor1	chr7	50692	50794	LTR/ERV1	2244	+	51	50743	5990
chr7	44753	244753	harbor1	chr7	136119	136735	LTR/ERV1	4220	+	308	136427	91674
chr7	44753	244753	harbor1	chr7	140677	140948	LTR/ERV1	1426	+	136	140813	96060
chr7	44753	244753	harbor1	chr7	141037	141344	LTR/ERV1	1324	+	154	141191	96438
chr7	109702072	109902072	harbor1	chr7	109707839	109708230	LTR/ERV1	729	+	196	109708035	5963
chr7	109702072	109902072	harbor1	chr7	109780227	109780700	LTR/ERV1	2451	+	236	109780463	78391
chr7	51825405	52025405	harbor1	chr7	51868272	51868662	LTR/ERV1	2392	+	195	51868467	43062
chr7	51825405	52025405	harbor1	chr7	51869850	51870330	LTR/ERV1	3084	+	240	51870090	44685
chr7	51825405	52025405	harbor1	chr7	51909747	51910328	LTR/ERV1	3054	+	290	51910037	84632
chr7	51825405	52025405	harbor1	chr7	51916994	51917563	LTR/ERV1	2039	+	284	51917278	91873
chr7	51825405	52025405	harbor1	chr7	51870333	51872089	LTR/ERV1	10054	+	878	51871211	45806
chr7	123012852	123212852	harbor1	chr7	123076014	123076566	LTR/ERV1	1645	+	276	123076290	63438
chr7	99278987	99478987	harbor1	chr7	99322238	99322580	LTR/ERV1	966	+	171	99322409	43422
chr7	140405165	140605165	harbor1	chr7	140483229	140483693	LTR/ERV1	2207	+	232	140483461	78296
chr7	140405165	140605165	harbor1	chr7	140484990	140485414	LTR/ERV1	1463	+	212	140485202	80037
chr7	140405165	140605165	harbor1	chr7	140488272	140488658	LTR/ERV1	2673	+	193	140488465	83300
chr7	140405165	140605165	harbor1	chr7	140504268	140504564	LTR/ERV1	1442	+	148	140504416	99251
chr7	16965530	17165530	harbor1	chr7	16965603	16966358	LTR/ERV1	5186	+	378	16965981	451
chr7	51097805	51297805	harbor1	chr7	51104825	51105281	LTR/ERV1	3419	+	228	51105053	7248
chr7	51097805	51297805	harbor1	chr7	51168904	51169486	LTR/ERV1	4038	+	291	51169195	71390
chr7	51097805	51297805	harbor1	chr7	51174512	51174880	LTR/ERV1	1070	+	184	51174696	76891
chr7	51097805	51297805	harbor1	chr7	51176033	51176399	LTR/ERV1	1508	+	183	51176216	78411
chr7	51097805	51297805	harbor1	chr7	51176431	51176616	LTR/ERV1	1508	+	92	51176523	78718
chr7	51097805	51297805	harbor1	chr7	51176597	51177492	LTR/ERV1	4677	+	448	51177045	79240
chr7	51097805	51297805	harbor1	chr7	51177819	51177862	LTR/ERV1	4677	+	22	51177841	80036
chr7	51097805	51297805	harbor1	chr7	51178182	51178625	LTR/ERV1	6066	+	222	51178404	80599
chr7	51097805	51297805	harbor1	chr7	51178909	51179246	LTR/ERV1	6066	+	168	51179077	81272
chr7	51097805	51297805	harbor1	chr7	51179506	51181236	LTR/ERV1	6260	+	865	51180371	82566
chr7	51097805	51297805	harbor1	chr7	51181252	51181695	LTR/ERV1	1136	+	222	51181474	83669
chr7	144459680	144659680	harbor1	chr7	144463782	144463889	LTR/ERV1	795	+	54	144463836	4156
chr7	144459680	144659680	harbor1	chr7	144463890	144464052	LTR/ERV1	892	+	81	144463971	4291
chr7	144459680	144659680	harbor1	chr7	144464102	144464667	LTR/ERV1	3686	+	282	144464384	4704
chr7	144459680	144659680	harbor1	chr7	144464665	144465402	LTR/ERV1	3690	+	368	144465033	5353
chr7	144459680	144659680	harbor1	chr7	144465398	144465750	LTR/ERV1	1852	+	176	144465574	5894
chr7	144459680	144659680	harbor1	chr7	144473300	144473800	LTR/ERV1	2131	+	250	144473550	13870
chr7	144459680	144659680	harbor1	chr7	144505495	144506243	LTR/ERV1	5143	+	374	144505869	46189
chr7	56625797	56825797	harbor1	chr7	56625643	56626030	LTR/ERV1	1758	+	194	56625837	40
chr7	56625797	56825797	harbor1	chr7	56701081	56701373	LTR/ERV1	1334	+	146	56701227	75430
chr7	56625797	56825797	harbor1	chr7	56701448	56701783	LTR/ERV1	1762	+	168	56701616	75819
chr7	56625797	56825797	harbor1	chr7	56702108	56702311	LTR/ERV1	1255	+	102	56702210	76413
chr7	56625797	56825797	harbor1	chr7	56703085	56703223	LTR/ERV1	2815	+	69	56703154	77357
chr7	56625797	56825797	harbor1	chr7	56703535	56703927	LTR/ERV1	2815	+	196	56703731	77934
chr7	56625797	56825797	harbor1	chr7	56705351	56705607	LTR/ERV1	713	+	128	56705479	79682
chr7	56625797	56825797	harbor1	chr7	56707244	56707596	LTR/ERV1	652	+	176	56707420	81623
chr8	53052913	53252913	harbor1	chr8	53062005	53062675	LTR/ERV1	4818	+	335	53062340	9427
chr8	53052913	53252913	harbor1	chr8	53078428	53078946	LTR/ERV1	1824	+	259	53078687	25774
chr8	7382295	7582295	harbor1	chr8	7402290	7402740	LTR/ERV1	3336	+	225	7402515	20220
chr8	7382295	7582295	harbor1	chr8	7405830	7405974	LTR/ERV1	777	+	72	7405902	23607
chr8	7382295	7582295	harbor1	chr8	7405974	7406464	LTR/ERV1	3417	+	245	7406219	23924
chr8	7382295	7582295	harbor1	chr8	7406467	7407126	LTR/ERV1	4190	+	330	7406797	24502
chr8	7382295	7582295	harbor1	chr8	7407128	7407343	LTR/ERV1	1383	+	108	7407236	24941
chr8	7382295	7582295	harbor1	chr8	7407342	7407721	LTR/ERV1	2596	+	190	7407532	25237
chr8	7382295	7582295	harbor1	chr8	7407722	7408174	LTR/ERV1	3424	+	226	7407948	25653
chr8	7382295	7582295	harbor1	chr8	7460116	7460745	LTR/ERV1	3577	+	314	7460430	78135
chr8	7382295	7582295	harbor1	chr8	7402743	7405835	LTR/ERV1	20285	+	1546	7404289	21994
chr8	81144167	81344167	harbor1	chr8	81195918	81195953	LTR/ERV1	2708	+	18	81195936	51769
chr8	81144167	81344167	harbor1	chr8	81195954	81196485	LTR/ERV1	3986	+	266	81196220	52053
chr8	81144167	81344167	harbor1	chr8	81196486	81197063	LTR/ERV1	2842	+	288	81196774	52607
chr8	143157069	143357069	harbor1	chr8	143164407	143164593	LTR/ERV1	1161	+	93	143164500	7431
chr8	143157069	143357069	harbor1	chr8	143198381	143198819	LTR/ERV1	2220	+	219	143198600	41531
chr8	143157069	143357069	harbor1	chr8	143199776	143199814	LTR/ERV1	414	+	19	143199795	42726
chr8	143157069	143357069	harbor1	chr8	143200117	143200209	LTR/ERV1	414	+	46	143200163	43094
chr8	143157069	143357069	harbor1	chr8	143200509	143200552	LTR/ERV1	414	+	22	143200531	43462
chr8	143157069	143357069	harbor1	chr8	143200601	143200763	LTR/ERV1	967	+	81	143200682	43613
chr8	143157069	143357069	harbor1	chr8	143201044	143201173	LTR/ERV1	967	+	64	143201108	44039
chr8	143157069	143357069	harbor1	chr8	143222239	143222777	LTR/ERV1	2138	+	269	143222508	65439
chr8	143157069	143357069	harbor1	chr8	143223393	143223886	LTR/ERV1	2599	+	246	143223639	66570
chr8	143157069	143357069	harbor1	chr8	143224188	143224331	LTR/ERV1	2599	+	72	143224260	67191
chr8	68305416	68505416	harbor1	chr8	68305482	68306192	LTR/ERV1	3860	+	355	68305837	421
chr8	68305416	68505416	harbor1	chr8	68306713	68307161	LTR/ERV1	2449	+	224	68306937	1521
chr8	68305416	68505416	harbor1	chr8	68309070	68309760	LTR/ERV1	3029	+	345	68309415	3999
chr8	68305416	68505416	harbor1	chr8	68313191	68313909	LTR/ERV1	3829	+	359	68313550	8134
chr8	68305416	68505416	harbor1	chr8	68323438	68323800	LTR/ERV1	1224	+	181	68323619	18203
chr8	108673175	108873175	harbor1	chr8	108745677	108746133	LTR/ERV1	3393	+	228	108745905	72730
chr8	108673175	108873175	harbor1	chr8	108750419	108751078	LTR/ERV1	3847	+	330	108750749	77574
chr8	101353816	101553816	harbor1	chr8	101355957	101356499	LTR/ERV1	4405	+	271	101356228	2412
chr8	42581424	42781424	harbor1	chr8	42663862	42664344	LTR/ERV1	2473	+	241	42664103	82679
chr8	123333555	123533555	harbor1	chr8	123410634	123411145	LTR/ERV1	3908	+	256	123410890	77335
chr8	123333555	123533555	harbor1	chr8	123411176	123411441	LTR/ERV1	2232	+	132	123411308	77753
chr8	123333555	123533555	harbor1	chr8	123411442	123411765	LTR/ERV1	2528	+	162	123411604	78049
chr8	123333555	123533555	harbor1	chr8	123412759	123413395	LTR/ERV1	3719	+	318	123413077	79522
chr8	50252282	50452282	harbor1	chr8	50281959	50282427	LTR/ERV1	3259	+	234	50282193	29911
chr8	50252282	50452282	harbor1	chr8	50298670	50298854	LTR/ERV1	948	+	92	50298762	46480
chr8	50252282	50452282	harbor1	chr8	50349737	50351102	LTR/ERV1	9323	+	682	50350419	98137
chr8	16596200	16796200	harbor1	chr8	16601853	16602659	LTR/ERV1	4789	+	403	16602256	6056
chr8	16596200	16796200	harbor1	chr8	16621758	16622150	LTR/ERV1	2295	+	196	16621954	25754
chr8	16596200	16796200	harbor1	chr8	16636976	16637294	LTR/ERV1	1081	+	159	16637135	40935
chr8	16596200	16796200	harbor1	chr8	16690890	16691372	LTR/ERV1	2396	+	241	16691131	94931
chr8	28650580	28850580	harbor1	chr8	28675135	28675630	LTR/ERV1	3093	+	248	28675383	24803
chr8	93366430	93566430	harbor1	chr8	93426224	93426595	LTR/ERV1	478	+	186	93426410	59980
chr8	38279257	38479257	harbor1	chr8	38333981	38334040	LTR/ERV1	417	+	30	38334011	54754
chr8	18746100	18946100	harbor1	chr8	18745949	18746573	LTR/ERV1	2092	+	312	18746261	161
chr8	105818874	106018874	harbor1	chr8	105886662	105887095	LTR/ERV1	2035	+	216	105886878	68004
chr8	107532019	107732019	harbor1	chr8	107629589	107629915	LTR/ERV1	1300	+	163	107629752	97733
chr8	107532019	107732019	harbor1	chr8	107629943	107630102	LTR/ERV1	1300	+	80	107630023	98004
chr8	88035418	88235418	harbor1	chr8	88128401	88128740	LTR/ERV1	1471	+	170	88128571	93153
chr8	48081195	48281195	harbor1	chr8	48080671	48081312	LTR/ERV1	3044	+	320	48080991	204
chr8	7808019	8008019	harbor1	chr8	7831968	7832328	LTR/ERV1	2069	+	180	7832148	24129
chr8	7808019	8008019	harbor1	chr8	7837935	7838398	LTR/ERV1	1813	+	232	7838167	30148
chr8	7808019	8008019	harbor1	chr8	7838712	7838909	LTR/ERV1	1712	+	98	7838810	30791
chr8	7808019	8008019	harbor1	chr8	7889272	7889714	LTR/ERV1	988	+	221	7889493	81474
chr8	26034626	26234626	harbor1	chr8	26090079	26090161	LTR/ERV1	506	+	41	26090120	55494
chr8	26034626	26234626	harbor1	chr8	26090704	26091051	LTR/ERV1	1279	+	174	26090878	56252
chr8	83160013	83360013	harbor1	chr8	83168069	83168488	LTR/ERV1	1809	+	210	83168279	8266
chr8	83160013	83360013	harbor1	chr8	83187209	83187773	LTR/ERV1	1641	+	282	83187491	27478
chr8	83160013	83360013	harbor1	chr8	83207848	83209024	LTR/ERV1	4415	+	588	83208436	48423
chr8	83160013	83360013	harbor1	chr8	83209319	83209862	LTR/ERV1	4415	+	272	83209591	49578
chr8	43308959	43508959	harbor1	chr8	43367916	43367971	LTR/ERV1	2145	+	28	43367944	58985
chr8	43308959	43508959	harbor1	chr8	43369383	43369692	LTR/ERV1	1178	+	154	43369537	60578
chr8	43308959	43508959	harbor1	chr8	43369993	43370097	LTR/ERV1	1178	+	52	43370045	61086
chr8	43308959	43508959	harbor1	chr8	43372801	43373326	LTR/ERV1	1854	+	262	43373063	64104
chr8	43308959	43508959	harbor1	chr8	43373313	43373418	LTR/ERV1	435	+	52	43373365	64406
chr8	43308959	43508959	harbor1	chr8	43373512	43373738	LTR/ERV1	577	+	113	43373625	64666
chr8	43308959	43508959	harbor1	chr8	43373869	43375351	LTR/ERV1	3426	+	741	43374610	65651
chr8	43308959	43508959	harbor1	chr8	43375333	43375880	LTR/ERV1	1474	+	274	43375607	66648
chr8	43308959	43508959	harbor1	chr8	43376179	43376587	LTR/ERV1	1474	+	204	43376383	67424
chr8	43308959	43508959	harbor1	chr8	43376571	43376824	LTR/ERV1	733	+	126	43376697	67738
chr8	43308959	43508959	harbor1	chr8	43377435	43377943	LTR/ERV1	1653	+	254	43377689	68730
chr8	43308959	43508959	harbor1	chr8	43378117	43378297	LTR/ERV1	492	+	90	43378207	69248
chr8	43308959	43508959	harbor1	chr8	43379488	43380036	LTR/ERV1	1617	+	274	43379762	70803
chr8	43308959	43508959	harbor1	chr8	43386923	43387051	LTR/ERV1	724	+	64	43386987	78028
chr8	43308959	43508959	harbor1	chr8	43387356	43387404	LTR/ERV1	724	+	24	43387380	78421
chr8	43308959	43508959	harbor1	chr8	43387407	43387927	LTR/ERV1	2838	+	260	43387667	78708
chr8	43308959	43508959	harbor1	chr8	43368286	43369247	LTR/ERV1	2145	+	480	43368766	59807
chr8	53733167	53933167	harbor1	chr8	53732330	53733189	LTR/ERV1	2824	+	430	53732760	407
chr8	53733167	53933167	harbor1	chr8	53733192	53736173	LTR/ERV1	14398	+	1490	53734682	1515
chr8	53733167	53933167	harbor1	chr8	53736215	53736494	LTR/ERV1	893	+	140	53736355	3188
chr8	53733167	53933167	harbor1	chr8	53736495	53736583	LTR/ERV1	437	+	44	53736539	3372
chr8	53733167	53933167	harbor1	chr8	53736584	53736773	LTR/ERV1	1013	+	94	53736678	3511
chr8	53733167	53933167	harbor1	chr8	53736774	53737226	LTR/ERV1	2510	+	226	53737000	3833
chr8	53733167	53933167	harbor1	chr8	53758327	53758719	LTR/ERV1	1509	+	196	53758523	25356
chr8	53733167	53933167	harbor1	chr8	53760042	53760691	LTR/ERV1	3621	+	324	53760366	27199
chr8	53733167	53933167	harbor1	chr8	53760694	53760859	LTR/ERV1	821	+	82	53760776	27609
chr8	132702980	132902980	harbor1	chr8	132715945	132716280	LTR/ERV1	928	+	168	132716113	13133
chr8	92738631	92938631	harbor1	chr8	92828895	92829503	LTR/ERV1	3165	+	304	92829199	90568
chr8	92738631	92938631	harbor1	chr8	92782556	92782896	LTR/ERV1	715	+	170	92782726	44095
chr8	85103874	85303874	harbor1	chr8	85152501	85154094	LTR/ERV1	8509	+	796	85153297	49423
chr8	13809575	14009575	harbor1	chr8	13833187	13833824	LTR/ERV1	1523	+	318	13833505	23930
chr8	13809575	14009575	harbor1	chr8	13837607	13838381	LTR/ERV1	3213	+	387	13837994	28419
chr8	13809575	14009575	harbor1	chr8	13841494	13842123	LTR/ERV1	2812	+	314	13841808	32233
chr8	13809575	14009575	harbor1	chr8	13855462	13856078	LTR/ERV1	4218	+	308	13855770	46195
chr8	13809575	14009575	harbor1	chr8	13859571	13860130	LTR/ERV1	2574	+	280	13859851	50276
chr8	135899	335899	harbor1	chr8	186947	187084	LTR/ERV1	467	+	68	187015	51116
chr8	135899	335899	harbor1	chr8	187161	187457	LTR/ERV1	790	+	148	187309	51410
chr8	135899	335899	harbor1	chr8	208719	209279	LTR/ERV1	2684	+	280	208999	73100
chr8	135899	335899	harbor1	chr8	209686	210332	LTR/ERV1	3756	+	323	210009	74110
chr8	135899	335899	harbor1	chr8	210633	210685	LTR/ERV1	3756	+	26	210659	74760
chr8	135899	335899	harbor1	chr8	211088	211545	LTR/ERV1	886	+	228	211316	75417
chr8	135899	335899	harbor1	chr8	211558	211773	LTR/ERV1	797	+	108	211666	75767
chr8	135899	335899	harbor1	chr8	213723	214272	LTR/ERV1	1391	+	274	213997	78098
chr8	135899	335899	harbor1	chr8	214289	214457	LTR/ERV1	486	+	84	214373	78474
chr8	135899	335899	harbor1	chr8	214657	215020	LTR/ERV1	1214	+	182	214839	78940
chr8	135899	335899	harbor1	chr8	215059	215480	LTR/ERV1	2169	+	210	215269	79370
chr8	135899	335899	harbor1	chr8	218306	218750	LTR/ERV1	2835	+	222	218528	82629
chr8	135899	335899	harbor1	chr8	230924	231098	LTR/ERV1	761	+	87	231011	95112
chr8	135899	335899	harbor1	chr8	212719	213159	LTR/ERV1	1396	+	220	212939	77040
chr8	70724956	70924956	harbor1	chr8	70748175	70749781	LTR/ERV1	5641	+	803	70748978	24022
chr8	70724956	70924956	harbor1	chr8	70820010	70820288	LTR/ERV1	635	+	139	70820149	95193
chr8	102866764	103066764	harbor1	chr8	102937920	102938038	LTR/ERV1	580	+	59	102937979	71215
chr8	102866764	103066764	harbor1	chr8	102938487	102939018	LTR/ERV1	2908	+	266	102938753	71989
chr8	132045470	132245470	harbor1	chr8	132072824	132073129	LTR/ERV1	690	+	152	132072976	27506
chr8	132045470	132245470	harbor1	chr8	132108592	132109007	LTR/ERV1	1774	+	208	132108800	63330
chr8	132045470	132245470	harbor1	chr8	132109384	132109537	LTR/ERV1	1774	+	76	132109460	63990
chr8	2123549	2323549	harbor1	chr8	2221941	2222378	LTR/ERV1	3180	+	218	2222159	98610
chr8	2123549	2323549	harbor1	chr8	2222381	2222470	LTR/ERV1	660	+	44	2222425	98876
chr8	2123549	2323549	harbor1	chr8	2222476	2222569	LTR/ERV1	723	+	46	2222522	98973
chr8	2123549	2323549	harbor1	chr8	2222573	2222664	LTR/ERV1	657	+	46	2222619	99070
chr8	2123549	2323549	harbor1	chr8	2222662	2222759	LTR/ERV1	584	+	48	2222710	99161
chr8	2123549	2323549	harbor1	chr8	2222756	2223002	LTR/ERV1	1692	+	123	2222879	99330
chr8	57760947	57960947	harbor1	chr8	57841144	57841804	LTR/ERV1	5086	+	330	57841474	80527
chr8	9154827	9354827	harbor1	chr8	9185051	9185479	LTR/ERV1	3227	+	214	9185265	30438
chr8	9154827	9354827	harbor1	chr8	9188664	9189149	LTR/ERV1	3732	+	242	9188906	34079
chr8	9154827	9354827	harbor1	chr8	9189463	9189625	LTR/ERV1	3732	+	81	9189544	34717
chr8	9154827	9354827	harbor1	chr8	9202139	9202924	LTR/ERV1	4672	+	392	9202531	47704
chr8	9154827	9354827	harbor1	chr8	9227108	9227636	LTR/ERV1	2879	+	264	9227372	72545
chr8	9154827	9354827	harbor1	chr8	9249336	9249524	LTR/ERV1	1434	+	94	9249430	94603
chr8	9154827	9354827	harbor1	chr8	9249525	9249599	LTR/ERV1	551	+	37	9249562	94735
chr8	9154827	9354827	harbor1	chr8	9249600	9249674	LTR/ERV1	555	+	37	9249637	94810
chr8	9154827	9354827	harbor1	chr8	9249675	9250815	LTR/ERV1	8502	+	570	9250245	95418
chr8	90525	290525	harbor1	chr8	99877	100533	LTR/ERV1	3999	+	328	100205	9680
chr8	90525	290525	harbor1	chr8	101818	102167	LTR/ERV1	5551	+	174	101992	11467
chr8	90525	290525	harbor1	chr8	102467	102888	LTR/ERV1	5551	+	210	102677	12152
chr8	90525	290525	harbor1	chr8	186947	187084	LTR/ERV1	467	+	68	187015	96490
chr8	90525	290525	harbor1	chr8	187161	187457	LTR/ERV1	790	+	148	187309	96784
chr8	81184443	81384443	harbor1	chr8	81195918	81195953	LTR/ERV1	2708	+	18	81195936	11493
chr8	81184443	81384443	harbor1	chr8	81195954	81196485	LTR/ERV1	3986	+	266	81196220	11777
chr8	81184443	81384443	harbor1	chr8	81196486	81197063	LTR/ERV1	2842	+	288	81196774	12331
chr8	31463973	31663973	harbor1	chr8	31465402	31465809	LTR/ERV1	2948	+	204	31465606	1633
chr8	31463973	31663973	harbor1	chr8	31479511	31480161	LTR/ERV1	3246	+	325	31479836	15863
chr8	31463973	31663973	harbor1	chr8	31528440	31529090	LTR/ERV1	1998	+	325	31528765	64792
chr8	31463973	31663973	harbor1	chr8	31489674	31491155	LTR/ERV1	10720	+	740	31490414	26441
chr8	96218124	96418124	harbor1	chr8	96235916	96236475	LTR/ERV1	3053	+	280	96236196	18072
chr8	61926399	62126399	harbor1	chr8	61937052	61937880	LTR/ERV1	4960	+	414	61937466	11067
chr8	61926399	62126399	harbor1	chr8	61938058	61938699	LTR/ERV1	3399	+	320	61938378	11979
chr8	61926399	62126399	harbor1	chr8	61982064	61982444	LTR/ERV1	1688	+	190	61982254	55855
chr8	111717210	111917210	harbor1	chr8	111732609	111733296	LTR/ERV1	3455	+	344	111732953	15743
chr8	111717210	111917210	harbor1	chr8	111740411	111740996	LTR/ERV1	2161	+	292	111740703	23493
chr8	111717210	111917210	harbor1	chr8	111741275	111741601	LTR/ERV1	1829	+	163	111741438	24228
chr8	111717210	111917210	harbor1	chr8	111765642	111766427	LTR/ERV1	4658	+	392	111766034	48824
chr8	111717210	111917210	harbor1	chr8	111796082	111796683	LTR/ERV1	3856	+	300	111796382	79172
chr8	111717210	111917210	harbor1	chr8	111805283	111805649	LTR/ERV1	2153	+	183	111805466	88256
chr8	16306633	16506633	harbor1	chr8	16393362	16393475	LTR/ERV1	693	+	56	16393418	86785
chr8	16306633	16506633	harbor1	chr8	16393871	16393946	LTR/ERV1	693	+	38	16393909	87276
chr8	93712207	93912207	harbor1	chr8	93744184	93744681	LTR/ERV1	3363	+	248	93744432	32225
chr8	93712207	93912207	harbor1	chr8	93752656	93753168	LTR/ERV1	2677	+	256	93752912	40705
chr8	144039108	144239108	harbor1	chr8	144061158	144061311	LTR/ERV1	1072	+	76	144061234	22126
chr8	144039108	144239108	harbor1	chr8	144061544	144061740	LTR/ERV1	2092	+	98	144061642	22534
chr8	144039108	144239108	harbor1	chr8	144062038	144062206	LTR/ERV1	2092	+	84	144062122	23014
chr8	144039108	144239108	harbor1	chr8	144067956	144068410	LTR/ERV1	2713	+	227	144068183	29075
chr8	144039108	144239108	harbor1	chr8	144093078	144093210	LTR/ERV1	3721	+	66	144093144	54036
chr8	144039108	144239108	harbor1	chr8	144093465	144093953	LTR/ERV1	3721	+	244	144093709	54601
chr8	91785182	91985182	harbor1	chr8	91816182	91817731	LTR/ERV1	11313	+	774	91816956	31774
chr8	91785182	91985182	harbor1	chr8	91866849	91867239	LTR/ERV1	1271	+	195	91867044	81862
chr8	91785182	91985182	harbor1	chr8	91867492	91869305	LTR/ERV1	7438	+	906	91868398	83216
chr8	88358154	88558154	harbor1	chr8	88367848	88368490	LTR/ERV1	2386	+	321	88368169	10015
chr8	88358154	88558154	harbor1	chr8	88374186	88374884	LTR/ERV1	4393	+	349	88374535	16381
chr8	88358154	88558154	harbor1	chr8	88382561	88382974	LTR/ERV1	1294	+	206	88382767	24613
chr8	88358154	88558154	harbor1	chr8	88422572	88423032	LTR/ERV1	2553	+	230	88422802	64648
chr8	88358154	88558154	harbor1	chr8	88425012	88425714	LTR/ERV1	3248	+	351	88425363	67209
chr8	128341596	128541596	harbor1	chr8	128370216	128370857	LTR/ERV1	3532	+	320	128370536	28940
chr8	128341596	128541596	harbor1	chr8	128370943	128370970	LTR/ERV1	3532	+	14	128370957	29361
chr8	128341596	128541596	harbor1	chr8	128371277	128371361	LTR/ERV1	3532	+	42	128371319	29723
chr8	128341596	128541596	harbor1	chr8	128375035	128375225	LTR/ERV1	1414	+	95	128375130	33534
chr8	128341596	128541596	harbor1	chr8	128375228	128377135	LTR/ERV1	9831	+	954	128376182	34586
chr8	128341596	128541596	harbor1	chr8	128377272	128377534	LTR/ERV1	1606	+	131	128377403	35807
chr8	128341596	128541596	harbor1	chr8	128382138	128382419	LTR/ERV1	2270	+	140	128382278	40682
chr8	128341596	128541596	harbor1	chr8	128382420	128382874	LTR/ERV1	3311	+	227	128382647	41051
chr8	128341596	128541596	harbor1	chr8	128397120	128397561	LTR/ERV1	2163	+	220	128397340	55744
chr8	3736271	3936271	harbor1	chr8	3743540	3744163	LTR/ERV1	3520	+	312	3743852	7581
chr8	11332763	11532763	harbor1	chr8	11385946	11386081	LTR/ERV1	2382	+	68	11386014	53251
chr8	11332763	11532763	harbor1	chr8	11413246	11413774	LTR/ERV1	2669	+	264	11413510	80747
chr8	11332763	11532763	harbor1	chr8	11425535	11426456	LTR/ERV1	4918	+	460	11425995	93232
chr8	11332763	11532763	harbor1	chr8	11386362	11387127	LTR/ERV1	2382	+	382	11386744	53981
chr8	93294409	93494409	harbor1	chr8	93345868	93346104	LTR/ERV1	1684	+	118	93345986	51577
chr8	79008310	79208310	harbor1	chr8	79081360	79081689	LTR/ERV1	593	+	164	79081524	73214
chr8	111330827	111530827	harbor1	chr8	111375078	111375587	LTR/ERV1	1301	+	254	111375332	44505
chr8	19440273	19640273	harbor1	chr8	19470588	19470814	LTR/ERV1	4028	+	113	19470701	30428
chr8	19440273	19640273	harbor1	chr8	19471118	19471645	LTR/ERV1	4028	+	264	19471382	31109
chr8	19440273	19640273	harbor1	chr8	19485381	19485759	LTR/ERV1	3046	+	189	19485570	45297
chr8	19440273	19640273	harbor1	chr8	19486065	19486256	LTR/ERV1	3046	+	96	19486161	45888
chr8	19440273	19640273	harbor1	chr8	19497693	19498165	LTR/ERV1	3308	+	236	19497929	57656
chr8	19440273	19640273	harbor1	chr8	19518142	19518751	LTR/ERV1	4035	+	304	19518446	78173
chr8	19440273	19640273	harbor1	chr8	19528279	19528819	LTR/ERV1	1993	+	270	19528549	88276
chr8	19440273	19640273	harbor1	chr8	19536964	19537683	LTR/ERV1	3989	+	360	19537324	97051
chr8	108747314	108947314	harbor1	chr8	108750419	108751078	LTR/ERV1	3847	+	330	108750749	3435
chr8	108747314	108947314	harbor1	chr8	108805130	108805536	LTR/ERV1	1308	+	203	108805333	58019
chr8	108747314	108947314	harbor1	chr8	108805829	108805974	LTR/ERV1	463	+	72	108805901	58587
chr8	108747314	108947314	harbor1	chr8	108806639	108806857	LTR/ERV1	2160	+	109	108806748	59434
chr8	108747314	108947314	harbor1	chr8	108807165	108807586	LTR/ERV1	2160	+	210	108807375	60061
chr8	108747314	108947314	harbor1	chr8	108808062	108808092	LTR/ERV1	792	+	15	108808077	60763
chr8	108747314	108947314	harbor1	chr8	108808441	108808738	LTR/ERV1	2850	+	148	108808589	61275
chr8	108747314	108947314	harbor1	chr8	108809030	108811744	LTR/ERV1	2983	+	1357	108810387	63073
chr8	108747314	108947314	harbor1	chr8	108811790	108812093	LTR/ERV1	1316	+	152	108811942	64628
chr8	108747314	108947314	harbor1	chr8	108818815	108819192	LTR/ERV1	1156	+	188	108819003	71689
chr8	108747314	108947314	harbor1	chr8	108832119	108832400	LTR/ERV1	2885	+	140	108832259	84945
chr8	108747314	108947314	harbor1	chr8	108832701	108832849	LTR/ERV1	2885	+	74	108832775	85461
chr8	135881308	136081308	harbor1	chr8	135966855	135967492	LTR/ERV1	1195	+	318	135967173	85865
chr8	131825492	132025492	harbor1	chr8	131875308	131875998	LTR/ERV1	3325	+	345	131875653	50161
chr8	50273379	50473379	harbor1	chr8	50281959	50282427	LTR/ERV1	3259	+	234	50282193	8814
chr8	50273379	50473379	harbor1	chr8	50298670	50298854	LTR/ERV1	948	+	92	50298762	25383
chr8	50273379	50473379	harbor1	chr8	50349737	50351102	LTR/ERV1	9323	+	682	50350419	77040
chr8	75385628	75585628	harbor1	chr8	75453206	75453721	LTR/ERV1	3102	+	258	75453464	67836
chr8	52734076	52934076	harbor1	chr8	52755243	52755363	LTR/ERV1	497	+	60	52755303	21227
chr8	52734076	52934076	harbor1	chr8	52781396	52781824	LTR/ERV1	2175	+	214	52781610	47534
chr8	52734076	52934076	harbor1	chr8	52800480	52801035	LTR/ERV1	2987	+	278	52800758	66682
chr8	52734076	52934076	harbor1	chr8	52818364	52818836	LTR/ERV1	2273	+	236	52818600	84524
chr8	17454242	17654242	harbor1	chr8	17477588	17478151	LTR/ERV1	3249	+	282	17477870	23628
chr8	17454242	17654242	harbor1	chr8	17491546	17491974	LTR/ERV1	2223	+	214	17491760	37518
chr8	29874083	30074083	harbor1	chr8	29884575	29885345	LTR/ERV1	4858	+	385	29884960	10877
chr8	29874083	30074083	harbor1	chr8	29972228	29972339	LTR/ERV1	2983	+	56	29972284	98201
chr8	29874083	30074083	harbor1	chr8	29972728	29973093	LTR/ERV1	2983	+	182	29972910	98827
chr8	51302061	51502061	harbor1	chr8	51360599	51360984	LTR/ERV1	2395	+	192	51360791	58730
chr8	51302061	51502061	harbor1	chr8	51360985	51361679	LTR/ERV1	7608	+	347	51361332	59271
chr8	51302061	51502061	harbor1	chr8	51361966	51363285	LTR/ERV1	7608	+	660	51362626	60565
chr8	51302061	51502061	harbor1	chr8	51365238	51366134	LTR/ERV1	11924	+	448	51365686	63625
chr8	51302061	51502061	harbor1	chr8	51366135	51366510	LTR/ERV1	2036	+	188	51366323	64262
chr8	51302061	51502061	harbor1	chr8	51377329	51378976	LTR/ERV1	10167	+	824	51378153	76092
chr8	51302061	51502061	harbor1	chr8	51363785	51364930	LTR/ERV1	11924	+	572	51364357	62296
chr8	84654187	84854187	harbor1	chr8	84657916	84658039	LTR/ERV1	729	+	62	84657978	3791
chr8	84654187	84854187	harbor1	chr8	84658048	84658427	LTR/ERV1	2199	+	190	84658238	4051
chr8	76446295	76646295	harbor1	chr8	76544494	76545509	LTR/ERV1	6232	+	508	76545002	98707
chr8	76446295	76646295	harbor1	chr8	76545570	76545714	LTR/ERV1	767	+	72	76545642	99347
chr8	76446295	76646295	harbor1	chr8	76545734	76546031	LTR/ERV1	1406	+	148	76545882	99587
chr8	17133482	17333482	harbor1	chr8	17171807	17172363	LTR/ERV1	4586	+	278	17172085	38603
chr8	135118460	135318460	harbor1	chr8	135143626	135144032	LTR/ERV1	1214	+	203	135143829	25369
chr8	40533354	40733354	harbor1	chr8	40537964	40538573	LTR/ERV1	2612	+	304	40538268	4914
chr8	40533354	40733354	harbor1	chr8	40540123	40540445	LTR/ERV1	2034	+	161	40540284	6930
chr8	40533354	40733354	harbor1	chr8	40558720	40559678	LTR/ERV1	4746	+	479	40559199	25845
chr8	40533354	40733354	harbor1	chr8	40560530	40561014	LTR/ERV1	1182	+	242	40560772	27418
chr8	40533354	40733354	harbor1	chr8	40584213	40584634	LTR/ERV1	617	+	210	40584423	51069
chr8	40533354	40733354	harbor1	chr8	40584934	40584975	LTR/ERV1	617	+	20	40584954	51600
chr8	40533354	40733354	harbor1	chr8	40583022	40583462	LTR/ERV1	802	+	220	40583242	49888
chr8	62628898	62828898	harbor1	chr8	62634057	62634559	LTR/ERV1	3109	+	251	62634308	5410
chr8	62628898	62828898	harbor1	chr8	62669403	62669482	LTR/ERV1	579	+	40	62669443	40545
chr8	144654869	144854869	harbor1	chr8	144654535	144655819	LTR/ERV1	5445	+	642	144655177	308
chr8	93957880	94157880	harbor1	chr8	93959526	93959939	LTR/ERV1	937	+	206	93959732	1852
chr8	93957880	94157880	harbor1	chr8	93999051	93999574	LTR/ERV1	3293	+	262	93999313	41433
chr8	93957880	94157880	harbor1	chr8	94047095	94047603	LTR/ERV1	3141	+	254	94047349	89469
chr8	93957880	94157880	harbor1	chr8	94048172	94048214	LTR/ERV1	3141	+	21	94048193	90313
chr8	111763340	111963340	harbor1	chr8	111765642	111766427	LTR/ERV1	4658	+	392	111766034	2694
chr8	111763340	111963340	harbor1	chr8	111796082	111796683	LTR/ERV1	3856	+	300	111796382	33042
chr8	111763340	111963340	harbor1	chr8	111805283	111805649	LTR/ERV1	2153	+	183	111805466	42126
chr8	111763340	111963340	harbor1	chr8	111825216	111825798	LTR/ERV1	3288	+	291	111825507	62167
chr8	117678044	117878044	harbor1	chr8	117696541	117697045	LTR/ERV1	1264	+	252	117696793	18749
chr8	117678044	117878044	harbor1	chr8	117708338	117708779	LTR/ERV1	3099	+	220	117708558	30514
chr8	110659949	110859949	harbor1	chr8	110686409	110689319	LTR/ERV1	27347	+	1455	110687864	27915
chr8	110659949	110859949	harbor1	chr8	110689625	110690155	LTR/ERV1	27347	+	265	110689890	29941
chr8	110659949	110859949	harbor1	chr8	110690767	110692077	LTR/ERV1	27347	+	655	110691422	31473
chr8	110659949	110859949	harbor1	chr8	110692103	110692542	LTR/ERV1	2124	+	220	110692323	32374
chr8	110659949	110859949	harbor1	chr8	110696667	110697460	LTR/ERV1	4904	+	396	110697063	37114
chr8	110659949	110859949	harbor1	chr8	110708269	110708675	LTR/ERV1	2124	+	203	110708472	48523
chr8	83516724	83716724	harbor1	chr8	83532119	83532611	LTR/ERV1	3062	+	246	83532365	15641
chr8	83516724	83716724	harbor1	chr8	83543715	83544154	LTR/ERV1	2456	+	220	83543935	27211
chr8	83516724	83716724	harbor1	chr8	83544178	83545417	LTR/ERV1	4335	+	620	83544798	28074
chr8	83516724	83716724	harbor1	chr8	83545974	83547212	LTR/ERV1	7040	+	619	83546593	29869
chr8	83516724	83716724	harbor1	chr8	83547203	83549680	LTR/ERV1	10694	+	1238	83548441	31717
chr8	83516724	83716724	harbor1	chr8	83549674	83550229	LTR/ERV1	3370	+	278	83549952	33228
chr8	83516724	83716724	harbor1	chr8	83550230	83550668	LTR/ERV1	2155	+	219	83550449	33725
chr8	83781390	83981390	harbor1	chr8	83808335	83808899	LTR/ERV1	2512	+	282	83808617	27227
chr8	83781390	83981390	harbor1	chr8	83810006	83810683	LTR/ERV1	4491	+	338	83810344	28954
chr8	83781390	83981390	harbor1	chr8	83810744	83811609	LTR/ERV1	5415	+	432	83811176	29786
chr8	83781390	83981390	harbor1	chr8	83868640	83870504	LTR/ERV1	9337	+	932	83869572	88182
chr8	109624787	109824787	harbor1	chr8	109678867	109679495	LTR/ERV1	4656	+	314	109679181	54394
chr8	29643995	29843995	harbor1	chr8	29730852	29730930	LTR/ERV1	585	+	39	29730891	86896
chr8	52026599	52226599	harbor1	chr8	52091697	52092005	LTR/ERV1	1171	+	154	52091851	65252
chr8	52026599	52226599	harbor1	chr8	52092038	52092359	LTR/ERV1	3099	+	160	52092198	65599
chr8	52026599	52226599	harbor1	chr8	52092982	52093408	LTR/ERV1	3099	+	213	52093195	66596
chr8	92157200	92357200	harbor1	chr8	92227204	92227849	LTR/ERV1	4006	+	322	92227526	70326
chr8	92157200	92357200	harbor1	chr8	92230611	92232281	LTR/ERV1	10514	+	835	92231446	74246
chr8	20032794	20232794	harbor1	chr8	20048792	20049283	LTR/ERV1	3162	+	246	20049038	16244
chr8	20032794	20232794	harbor1	chr8	20049476	20049663	LTR/ERV1	1331	+	94	20049570	16776
chr8	20032794	20232794	harbor1	chr8	20054610	20056058	LTR/ERV1	10066	+	724	20055334	22540
chr8	20032794	20232794	harbor1	chr8	20114444	20114809	LTR/ERV1	2550	+	182	20114626	81832
chr8	101294461	101494461	harbor1	chr8	101355957	101356499	LTR/ERV1	4405	+	271	101356228	61767
chr8	54682124	54882124	harbor1	chr8	54713890	54714006	LTR/ERV1	2231	+	58	54713948	31824
chr8	54682124	54882124	harbor1	chr8	54714226	54714803	LTR/ERV1	2231	+	288	54714514	32390
chr8	54682124	54882124	harbor1	chr8	54750497	54751156	LTR/ERV1	3346	+	330	54750827	68703
chr8	104428048	104628048	harbor1	chr8	104437260	104437821	LTR/ERV1	3119	+	280	104437540	9492
chr8	104428048	104628048	harbor1	chr8	104459934	104460146	LTR/ERV1	758	+	106	104460040	31992
chr8	104428048	104628048	harbor1	chr8	104468549	104469311	LTR/ERV1	5268	+	381	104468930	40882
chr8	104428048	104628048	harbor1	chr8	104478712	104479180	LTR/ERV1	1984	+	234	104478946	50898
chr8	113616317	113816317	harbor1	chr8	113645765	113646284	LTR/ERV1	2256	+	260	113646025	29708
chr8	113616317	113816317	harbor1	chr8	113650825	113651536	LTR/ERV1	3316	+	356	113651181	34864
chr8	113616317	113816317	harbor1	chr8	113675915	113676852	LTR/ERV1	5418	+	468	113676383	60066
chr8	88643334	88843334	harbor1	chr8	88674873	88675358	LTR/ERV1	3870	+	242	88675115	31781
chr8	88643334	88843334	harbor1	chr8	88703771	88704149	LTR/ERV1	854	+	189	88703960	60626
chr8	88643334	88843334	harbor1	chr8	88708957	88709515	LTR/ERV1	698	+	279	88709236	65902
chr8	88643334	88843334	harbor1	chr8	88709530	88710606	LTR/ERV1	4714	+	538	88710068	66734
chr8	88643334	88843334	harbor1	chr8	88710639	88711356	LTR/ERV1	12543	+	358	88710997	67663
chr8	88643334	88843334	harbor1	chr8	88711592	88714301	LTR/ERV1	12543	+	1354	88712946	69612
chr8	3478227	3678227	harbor1	chr8	3531641	3532273	LTR/ERV1	2348	+	316	3531957	53730
chr8	3478227	3678227	harbor1	chr8	3544070	3544609	LTR/ERV1	3240	+	270	3544340	66113
chr8	77857681	78057681	harbor1	chr8	77861493	77861932	LTR/ERV1	2986	+	220	77861713	4032
chr8	77857681	78057681	harbor1	chr8	77918673	77919347	LTR/ERV1	3693	+	337	77919010	61329
chr8	140997045	141197045	harbor1	chr8	141076505	141078018	LTR/ERV1	10992	+	756	141077261	80216
chr8	138055735	138255735	harbor1	chr8	138082433	138082991	LTR/ERV1	4681	+	279	138082712	26977
chr8	138055735	138255735	harbor1	chr8	138109347	138109888	LTR/ERV1	1149	+	270	138109617	53882
chr8	138055735	138255735	harbor1	chr8	138083954	138085695	LTR/ERV1	9993	+	870	138084824	29089
chr8	46014145	46214145	harbor1	chr8	46032617	46032833	LTR/ERV1	1318	+	108	46032725	18580
chr8	39467838	39667838	harbor1	chr8	39470484	39471435	LTR/ERV1	6185	+	476	39470960	3122
chr8	39467838	39667838	harbor1	chr8	39478065	39478454	LTR/ERV1	1388	+	194	39478259	10421
chr8	39467838	39667838	harbor1	chr8	39478743	39479147	LTR/ERV1	650	+	202	39478945	11107
chr8	39467838	39667838	harbor1	chr8	39480570	39480909	LTR/ERV1	477	+	170	39480740	12902
chr8	39467838	39667838	harbor1	chr8	39481097	39481562	LTR/ERV1	832	+	232	39481329	13491
chr8	39467838	39667838	harbor1	chr8	39482396	39485061	LTR/ERV1	1786	+	1332	39483728	15890
chr8	39467838	39667838	harbor1	chr8	39486973	39487156	LTR/ERV1	519	+	92	39487065	19227
chr8	39467838	39667838	harbor1	chr8	39487181	39487791	LTR/ERV1	1186	+	305	39487486	19648
chr8	39467838	39667838	harbor1	chr8	39489771	39489862	LTR/ERV1	420	+	46	39489817	21979
chr8	39467838	39667838	harbor1	chr8	39535464	39535959	LTR/ERV1	3253	+	248	39535712	67874
chr8	49983977	50183977	harbor1	chr8	50074688	50076015	LTR/ERV1	7069	+	664	50075352	91375
chr8	30215439	30415439	harbor1	chr8	30248192	30248724	LTR/ERV1	3947	+	266	30248458	33019
chr8	48242195	48442195	harbor1	chr8	48241593	48242198	LTR/ERV1	4981	+	302	48241895	300
chr8	48242195	48442195	harbor1	chr8	48242199	48242753	LTR/ERV1	3865	+	277	48242476	281
chr8	48242195	48442195	harbor1	chr8	48242754	48242978	LTR/ERV1	1483	+	112	48242866	671
chr8	48242195	48442195	harbor1	chr8	48242970	48243888	LTR/ERV1	6360	+	459	48243429	1234
chr8	48242195	48442195	harbor1	chr8	48243889	48244436	LTR/ERV1	3023	+	274	48244163	1968
chr8	20069818	20269818	harbor1	chr8	20114444	20114809	LTR/ERV1	2550	+	182	20114626	44808
chr8	20069818	20269818	harbor1	chr8	20154739	20155218	LTR/ERV1	3316	+	240	20154979	85161
chr8	20069818	20269818	harbor1	chr8	20155241	20157250	LTR/ERV1	6770	+	1004	20156245	86427
chr8	20069818	20269818	harbor1	chr8	20157245	20158897	LTR/ERV1	13731	+	826	20158071	88253
chr8	20069818	20269818	harbor1	chr8	20158879	20159027	LTR/ERV1	1039	+	74	20158953	89135
chr8	20069818	20269818	harbor1	chr8	20159014	20159304	LTR/ERV1	2324	+	145	20159159	89341
chr8	20069818	20269818	harbor1	chr8	20159309	20159633	LTR/ERV1	2257	+	162	20159471	89653
chr8	131623747	131823747	harbor1	chr8	131662917	131663236	LTR/ERV1	3626	+	160	131663077	39330
chr8	131623747	131823747	harbor1	chr8	131663537	131663907	LTR/ERV1	3626	+	185	131663722	39975
chr8	21177681	21377681	harbor1	chr8	21185469	21185838	LTR/ERV1	420	+	184	21185653	7972
chr8	21177681	21377681	harbor1	chr8	21189747	21189914	LTR/ERV1	449	+	84	21189831	12150
chr8	21177681	21377681	harbor1	chr8	21208671	21209296	LTR/ERV1	3203	+	312	21208983	31302
chr8	21177681	21377681	harbor1	chr8	21220334	21220573	LTR/ERV1	1113	+	120	21220454	42773
chr8	42859941	43059941	harbor1	chr8	42891193	42891752	LTR/ERV1	2195	+	280	42891473	31532
chr8	42859941	43059941	harbor1	chr8	42916485	42916925	LTR/ERV1	1949	+	220	42916705	56764
chr8	121924768	122124768	harbor1	chr8	121947855	121949542	LTR/ERV1	11070	+	844	121948699	23931
chr8	121924768	122124768	harbor1	chr8	121951555	121952001	LTR/ERV1	2956	+	223	121951778	27010
chr8	121924768	122124768	harbor1	chr8	121989817	121990256	LTR/ERV1	2905	+	220	121990037	65269
chr8	131580240	131780240	harbor1	chr8	131662917	131663236	LTR/ERV1	3626	+	160	131663077	82837
chr8	131580240	131780240	harbor1	chr8	131663537	131663907	LTR/ERV1	3626	+	185	131663722	83482
chr8	41187673	41387673	harbor1	chr8	41246697	41247116	LTR/ERV1	1891	+	210	41246907	59234
chr8	137611141	137811141	harbor1	chr8	137635396	137636092	LTR/ERV1	1838	+	348	137635744	24603
chr8	82878747	83078747	harbor1	chr8	82880507	82881878	LTR/ERV1	8827	+	686	82881193	2446
chr8	82878747	83078747	harbor1	chr8	82922924	82923123	LTR/ERV1	1274	+	100	82923024	44277
chr8	82878747	83078747	harbor1	chr8	82948890	82949516	LTR/ERV1	3632	+	313	82949203	70456
chr8	82878747	83078747	harbor1	chr8	82966307	82966955	LTR/ERV1	3653	+	324	82966631	87884
chr8	82878747	83078747	harbor1	chr8	82971880	82972123	LTR/ERV1	1383	+	122	82972002	93255
chr8	122786357	122986357	harbor1	chr8	122829982	122830052	LTR/ERV1	527	+	35	122830017	43660
chr8	122786357	122986357	harbor1	chr8	122836868	122837328	LTR/ERV1	3254	+	230	122837098	50741
chr8	97500299	97700299	harbor1	chr8	97542425	97543415	LTR/ERV1	4845	+	495	97542920	42621
chr8	97500299	97700299	harbor1	chr8	97546971	97547412	LTR/ERV1	2283	+	220	97547191	46892
chr8	97500299	97700299	harbor1	chr8	97556744	97557835	LTR/ERV1	4239	+	546	97557290	56991
chr8	75529986	75729986	harbor1	chr8	75569043	75569481	LTR/ERV1	2855	+	219	75569262	39276
chr8	87611523	87811523	harbor1	chr8	87636247	87636722	LTR/ERV1	3227	+	238	87636485	24962
chr8	114077220	114277220	harbor1	chr8	114159594	114160309	LTR/ERV1	1418	+	358	114159952	82732
chr8	43125137	43325137	harbor1	chr8	43134411	43134467	LTR/ERV1	447	+	28	43134439	9302
chr8	43125137	43325137	harbor1	chr8	43134468	43134584	LTR/ERV1	648	+	58	43134526	9389
chr8	43125137	43325137	harbor1	chr8	43134614	43135190	LTR/ERV1	19312	+	288	43134902	9765
chr8	43125137	43325137	harbor1	chr8	43135487	43136598	LTR/ERV1	19312	+	556	43136043	10906
chr8	43125137	43325137	harbor1	chr8	43136889	43137949	LTR/ERV1	19312	+	530	43137419	12282
chr8	43125137	43325137	harbor1	chr8	43137928	43138567	LTR/ERV1	3569	+	320	43138248	13111
chr8	43125137	43325137	harbor1	chr8	43139296	43139620	LTR/ERV1	1938	+	162	43139458	14321
chr8	43125137	43325137	harbor1	chr8	43214449	43214797	LTR/ERV1	598	+	174	43214623	89486
chr8	43125137	43325137	harbor1	chr8	43214813	43215001	LTR/ERV1	447	+	94	43214907	89770
chr8	43125137	43325137	harbor1	chr8	43139058	43139293	LTR/ERV1	2049	+	118	43139176	14039
chr8	132428186	132628186	harbor1	chr8	132491073	132491420	LTR/ERV1	728	+	174	132491247	63061
chr8	132428186	132628186	harbor1	chr8	132504180	132504335	LTR/ERV1	485	+	78	132504258	76072
chr8	132428186	132628186	harbor1	chr8	132517178	132517633	LTR/ERV1	1743	+	228	132517406	89220
chr8	132428186	132628186	harbor1	chr8	132525906	132526224	LTR/ERV1	461	+	159	132526065	97879
chr8	97567744	97767744	harbor1	chr8	97641250	97641342	LTR/ERV1	462	+	46	97641296	73552
chr8	97567744	97767744	harbor1	chr8	97641998	97642161	LTR/ERV1	509	+	82	97642080	74336
chr9	3878977	4078977	harbor1	chr9	3900861	3901293	LTR/ERV1	1625	+	216	3901077	22100
chr9	41505391	41705391	harbor1	chr9	41504761	41505666	LTR/ERV1	4637	+	452	41505213	178
chr9	41505391	41705391	harbor1	chr9	41526766	41527164	LTR/ERV1	2604	+	199	41526965	21574
chr9	41505391	41705391	harbor1	chr9	41527165	41527683	LTR/ERV1	946	+	259	41527424	22033
chr9	41505391	41705391	harbor1	chr9	41527674	41528301	LTR/ERV1	2876	+	314	41527988	22597
chr9	41505391	41705391	harbor1	chr9	41528626	41530076	LTR/ERV1	17134	+	725	41529351	23960
chr9	41505391	41705391	harbor1	chr9	41530443	41532903	LTR/ERV1	17134	+	1230	41531673	26282
chr9	41505391	41705391	harbor1	chr9	41532929	41533198	LTR/ERV1	17134	+	134	41533063	27672
chr9	41505391	41705391	harbor1	chr9	41533813	41533990	LTR/ERV1	2633	+	88	41533901	28510
chr9	41505391	41705391	harbor1	chr9	41534224	41534674	LTR/ERV1	2127	+	225	41534449	29058
chr9	41505391	41705391	harbor1	chr9	41544590	41545003	LTR/ERV1	2507	+	206	41544796	39405
chr9	41505391	41705391	harbor1	chr9	41533202	41533521	LTR/ERV1	2633	+	160	41533362	27971
chr9	4003941	4203941	harbor1	chr9	4041628	4042151	LTR/ERV1	3090	+	262	4041890	37949
chr9	74190838	74390838	harbor1	chr9	74217271	74217503	LTR/ERV1	5342	+	116	74217387	26549
chr9	74190838	74390838	harbor1	chr9	74217803	74218415	LTR/ERV1	5342	+	306	74218109	27271
chr9	74190838	74390838	harbor1	chr9	74268453	74268585	LTR/ERV1	466	+	66	74268519	77681
chr9	74190838	74390838	harbor1	chr9	74203027	74203175	LTR/ERV1	723	+	74	74203101	12263
chr9	32537660	32737660	harbor1	chr9	32574571	32574943	LTR/ERV1	1604	+	186	32574757	37097
chr9	32537660	32737660	harbor1	chr9	32577320	32577759	LTR/ERV1	1498	+	220	32577540	39880
chr9	32537660	32737660	harbor1	chr9	32578872	32579421	LTR/ERV1	4149	+	274	32579146	41486
chr9	37311312	37511312	harbor1	chr9	37406725	37406894	LTR/ERV1	2724	+	84	37406809	95497
chr9	37311312	37511312	harbor1	chr9	37407097	37407428	LTR/ERV1	2724	+	166	37407263	95951
chr9	67017542	67217542	harbor1	chr9	67020138	67020401	LTR/ERV1	1595	+	132	67020270	2728
chr9	67017542	67217542	harbor1	chr9	67020698	67020993	LTR/ERV1	1595	+	148	67020846	3304
chr9	8025004	8225004	harbor1	chr9	8111842	8112248	LTR/ERV1	1486	+	203	8112045	87041
chr9	85797048	85997048	harbor1	chr9	85880935	85881367	LTR/ERV1	2341	+	216	85881151	84103
chr9	85797048	85997048	harbor1	chr9	85881368	85881817	LTR/ERV1	1926	+	224	85881592	84544
chr9	85797048	85997048	harbor1	chr9	85881877	85884099	LTR/ERV1	11799	+	1111	85882988	85940
chr9	85797048	85997048	harbor1	chr9	85884093	85884510	LTR/ERV1	2573	+	208	85884301	87253
chr9	132659716	132859716	harbor1	chr9	132697760	132698214	LTR/ERV1	2401	+	227	132697987	38271
chr9	132659716	132859716	harbor1	chr9	132698282	132698801	LTR/ERV1	7628	+	260	132698542	38826
chr9	132659716	132859716	harbor1	chr9	132699097	132699503	LTR/ERV1	7628	+	203	132699300	39584
chr9	132659716	132859716	harbor1	chr9	132699805	132700761	LTR/ERV1	7628	+	478	132700283	40567
chr9	132659716	132859716	harbor1	chr9	132701062	132701349	LTR/ERV1	7628	+	144	132701206	41490
chr9	132659716	132859716	harbor1	chr9	132701660	132702658	LTR/ERV1	7628	+	499	132702159	42443
chr9	132659716	132859716	harbor1	chr9	132702947	132703093	LTR/ERV1	1861	+	73	132703020	43304
chr9	132659716	132859716	harbor1	chr9	132703236	132703757	LTR/ERV1	4536	+	260	132703496	43780
chr9	132659716	132859716	harbor1	chr9	132704050	132704097	LTR/ERV1	4536	+	24	132704074	44358
chr9	132659716	132859716	harbor1	chr9	132704429	132704839	LTR/ERV1	4536	+	205	132704634	44918
chr9	132659716	132859716	harbor1	chr9	132718027	132718768	LTR/ERV1	5774	+	370	132718397	58681
chr9	132659716	132859716	harbor1	chr9	132719069	132719107	LTR/ERV1	5774	+	19	132719088	59372
chr9	76643690	76843690	harbor1	chr9	76741421	76741921	LTR/ERV1	2157	+	250	76741671	97981
chr9	105625987	105825987	harbor1	chr9	105680374	105680503	LTR/ERV1	983	+	64	105680438	54451
chr9	105625987	105825987	harbor1	chr9	105680553	105680659	LTR/ERV1	587	+	53	105680606	54619
chr9	105625987	105825987	harbor1	chr9	105688152	105688497	LTR/ERV1	459	+	172	105688324	62337
chr9	105625987	105825987	harbor1	chr9	105712971	105714397	LTR/ERV1	3137	+	713	105713684	87697
chr9	31297537	31497537	harbor1	chr9	31326307	31326754	LTR/ERV1	3568	+	224	31326531	28994
chr9	31297537	31497537	harbor1	chr9	31326757	31329821	LTR/ERV1	19471	+	1532	31328289	30752
chr9	31297537	31497537	harbor1	chr9	31329801	31329950	LTR/ERV1	964	+	74	31329875	32338
chr9	31297537	31497537	harbor1	chr9	31329941	31334249	LTR/ERV1	26652	+	2154	31332095	34558
chr9	31297537	31497537	harbor1	chr9	31334250	31334697	LTR/ERV1	3458	+	224	31334474	36937
chr9	66799737	66999737	harbor1	chr9	66815396	66815772	LTR/ERV1	766	+	188	66815584	15847
chr9	66799737	66999737	harbor1	chr9	66816272	66816292	LTR/ERV1	766	+	10	66816282	16545
chr9	66799737	66999737	harbor1	chr9	66817686	66817830	LTR/ERV1	617	+	72	66817758	18021
chr9	66799737	66999737	harbor1	chr9	66818201	66818321	LTR/ERV1	617	+	60	66818261	18524
chr9	66799737	66999737	harbor1	chr9	66818993	66819551	LTR/ERV1	2276	+	279	66819272	19535
chr9	66799737	66999737	harbor1	chr9	66828683	66828936	LTR/ERV1	1192	+	126	66828809	29072
chr9	66799737	66999737	harbor1	chr9	66828949	66829275	LTR/ERV1	1535	+	163	66829112	29375
chr9	91185735	91385735	harbor1	chr9	91223779	91224187	LTR/ERV1	1825	+	204	91223983	38248
chr9	91185735	91385735	harbor1	chr9	91261914	91262137	LTR/ERV1	653	+	112	91262026	76291
chr9	14383528	14583528	harbor1	chr9	14391288	14392017	LTR/ERV1	3625	+	364	14391652	8124
chr9	14383528	14583528	harbor1	chr9	14450291	14450772	LTR/ERV1	585	+	240	14450531	67003
chr9	32971609	33171609	harbor1	chr9	33002297	33002777	LTR/ERV1	2948	+	240	33002537	30928
chr9	102916109	103116109	harbor1	chr9	102941424	102941611	LTR/ERV1	443	+	94	102941518	25409
chr9	102916109	103116109	harbor1	chr9	102942245	102942664	LTR/ERV1	1249	+	210	102942455	26346
chr9	102916109	103116109	harbor1	chr9	102942692	102943205	LTR/ERV1	1668	+	256	102942948	26839
chr9	62360984	62560984	harbor1	chr9	62390639	62391179	LTR/ERV1	3021	+	270	62390909	29925
chr9	62360984	62560984	harbor1	chr9	62398711	62398971	LTR/ERV1	749	+	130	62398841	37857
chr9	62360984	62560984	harbor1	chr9	62399253	62399546	LTR/ERV1	1299	+	146	62399399	38415
chr9	41349679	41549679	harbor1	chr9	41372384	41372935	LTR/ERV1	2699	+	276	41372660	22981
chr9	41349679	41549679	harbor1	chr9	41384956	41385468	LTR/ERV1	1847	+	256	41385212	35533
chr9	41349679	41549679	harbor1	chr9	41421139	41421571	LTR/ERV1	2515	+	216	41421355	71676
chr9	2291363	2491363	harbor1	chr9	2349051	2349486	LTR/ERV1	2148	+	218	2349269	57906
chr9	41143441	41343441	harbor1	chr9	41143046	41143483	LTR/ERV1	840	+	218	41143264	177
chr9	41143441	41343441	harbor1	chr9	41193349	41193618	LTR/ERV1	887	+	134	41193483	50042
chr9	41143441	41343441	harbor1	chr9	41193884	41193974	LTR/ERV1	887	+	45	41193929	50488
chr9	41143441	41343441	harbor1	chr9	41193975	41194102	LTR/ERV1	433	+	64	41194039	50598
chr9	41143441	41343441	harbor1	chr9	41194104	41194414	LTR/ERV1	999	+	155	41194259	50818
chr9	41143441	41343441	harbor1	chr9	41236000	41236454	LTR/ERV1	3637	+	227	41236227	92786
chr9	26039697	26239697	harbor1	chr9	26064492	26065218	LTR/ERV1	2095	+	363	26064855	25158
chr9	17040571	17240571	harbor1	chr9	17072424	17074114	LTR/ERV1	8908	+	845	17073269	32698
chr9	97571228	97771228	harbor1	chr9	97574037	97575455	LTR/ERV1	10646	+	709	97574746	3518
chr9	86211152	86411152	harbor1	chr9	86217606	86218068	LTR/ERV1	2890	+	231	86217837	6685
chr9	86211152	86411152	harbor1	chr9	86251064	86251914	LTR/ERV1	3559	+	425	86251489	40337
chr9	86211152	86411152	harbor1	chr9	86251943	86252028	LTR/ERV1	3559	+	42	86251985	40833
chr9	86211152	86411152	harbor1	chr9	86252334	86253594	LTR/ERV1	10728	+	630	86252964	41812
chr9	86211152	86411152	harbor1	chr9	86253759	86253809	LTR/ERV1	10728	+	25	86253784	42632
chr9	86211152	86411152	harbor1	chr9	86254111	86254774	LTR/ERV1	10728	+	332	86254443	43291
chr9	86211152	86411152	harbor1	chr9	86255093	86255265	LTR/ERV1	10728	+	86	86255179	44027
chr9	86211152	86411152	harbor1	chr9	86255268	86255853	LTR/ERV1	3641	+	292	86255560	44408
chr9	86211152	86411152	harbor1	chr9	86256606	86256723	LTR/ERV1	438	+	58	86256664	45512
chr9	86211152	86411152	harbor1	chr9	86256799	86256878	LTR/ERV1	510	+	40	86256839	45687
chr9	86211152	86411152	harbor1	chr9	86257019	86257236	LTR/ERV1	1207	+	108	86257127	45975
chr9	93869689	94069689	harbor1	chr9	93881403	93882248	LTR/ERV1	6397	+	422	93881825	12136
chr9	93869689	94069689	harbor1	chr9	93892623	93893067	LTR/ERV1	2214	+	222	93892845	23156
chr9	93869689	94069689	harbor1	chr9	93939631	93940151	LTR/ERV1	4095	+	260	93939891	70202
chr9	93869689	94069689	harbor1	chr9	93879760	93880479	LTR/ERV1	4591	+	360	93880120	10431
chr9	101133813	101333813	harbor1	chr9	101211199	101211436	LTR/ERV1	978	+	118	101211317	77504
chr9	101133813	101333813	harbor1	chr9	101211443	101211548	LTR/ERV1	481	+	52	101211495	77682
chr9	23810440	24010440	harbor1	chr9	23898744	23899372	LTR/ERV1	2991	+	314	23899058	88618
chr9	23810440	24010440	harbor1	chr9	23906471	23906975	LTR/ERV1	2728	+	252	23906723	96283
chr9	40090947	40290947	harbor1	chr9	40124652	40125241	LTR/ERV1	3246	+	294	40124946	33999
chr9	40090947	40290947	harbor1	chr9	40135775	40136343	LTR/ERV1	3201	+	284	40136059	45112
chr9	40090947	40290947	harbor1	chr9	40138717	40138929	LTR/ERV1	531	+	106	40138823	47876
chr9	40090947	40290947	harbor1	chr9	40139100	40139563	LTR/ERV1	2126	+	232	40139332	48385
chr9	40090947	40290947	harbor1	chr9	40141097	40141590	LTR/ERV1	3554	+	246	40141343	50396
chr9	40090947	40290947	harbor1	chr9	40177895	40178342	LTR/ERV1	2796	+	224	40178119	87172
chr9	90550377	90750377	harbor1	chr9	90586520	90586969	LTR/ERV1	1605	+	224	90586744	36367
chr9	90550377	90750377	harbor1	chr9	90608274	90608845	LTR/ERV1	3798	+	286	90608560	58183
chr9	72955879	73155879	harbor1	chr9	73016838	73017278	LTR/ERV1	2213	+	220	73017058	61179
chr9	104621899	104821899	harbor1	chr9	104641417	104642118	LTR/ERV1	4504	+	350	104641767	19868
chr9	104621899	104821899	harbor1	chr9	104700328	104700847	LTR/ERV1	3360	+	260	104700588	78689
chr9	112545496	112745496	harbor1	chr9	112546064	112546469	LTR/ERV1	2190	+	202	112546266	770
chr9	112545496	112745496	harbor1	chr9	112546542	112546651	LTR/ERV1	474	+	54	112546596	1100
chr9	112545496	112745496	harbor1	chr9	112547402	112547998	LTR/ERV1	5295	+	298	112547700	2204
chr9	112545496	112745496	harbor1	chr9	112548289	112548555	LTR/ERV1	5295	+	133	112548422	2926
chr9	112083273	112283273	harbor1	chr9	112162614	112163058	LTR/ERV1	2821	+	222	112162836	79563
chr9	112083273	112283273	harbor1	chr9	112170656	112170710	LTR/ERV1	417	+	27	112170683	87410
chr9	112083273	112283273	harbor1	chr9	112171013	112171403	LTR/ERV1	1605	+	195	112171208	87935
chr9	112083273	112283273	harbor1	chr9	112177861	112178126	LTR/ERV1	491	+	132	112177993	94720
chr9	102238113	102438113	harbor1	chr9	102238055	102238191	LTR/ERV1	459	+	68	102238123	10
chr9	102238113	102438113	harbor1	chr9	102238597	102238832	LTR/ERV1	742	+	118	102238715	602
chr9	102238113	102438113	harbor1	chr9	102238948	102239112	LTR/ERV1	501	+	82	102239030	917
chr9	102238113	102438113	harbor1	chr9	102239831	102240778	LTR/ERV1	1030	+	474	102240305	2192
chr9	102238113	102438113	harbor1	chr9	102240841	102242331	LTR/ERV1	3592	+	745	102241586	3473
chr9	102238113	102438113	harbor1	chr9	102242611	102242808	LTR/ERV1	3592	+	98	102242709	4596
chr9	102238113	102438113	harbor1	chr9	102242800	102243175	LTR/ERV1	577	+	188	102242988	4875
chr9	102238113	102438113	harbor1	chr9	102243182	102243650	LTR/ERV1	1290	+	234	102243416	5303
chr9	102238113	102438113	harbor1	chr9	102259113	102260810	LTR/ERV1	11022	+	848	102259961	21848
chr9	102238113	102438113	harbor1	chr9	102260811	102261195	LTR/ERV1	2287	+	192	102261003	22890
chr9	102238113	102438113	harbor1	chr9	102280473	102280964	LTR/ERV1	1783	+	246	102280719	42606
chr9	40624274	40824274	harbor1	chr9	40668461	40668791	LTR/ERV1	1789	+	165	40668626	44352
chr9	40624274	40824274	harbor1	chr9	40668776	40668999	LTR/ERV1	871	+	112	40668888	44614
chr9	40624274	40824274	harbor1	chr9	40669188	40669618	LTR/ERV1	1710	+	215	40669403	45129
chr9	40624274	40824274	harbor1	chr9	40670939	40670962	LTR/ERV1	1537	+	12	40670951	46677
chr9	40624274	40824274	harbor1	chr9	40671238	40671619	LTR/ERV1	1537	+	190	40671428	47154
chr9	40624274	40824274	harbor1	chr9	40688147	40689518	LTR/ERV1	6765	+	686	40688833	64559
chr9	5788482	5988482	harbor1	chr9	5819280	5819731	LTR/ERV1	2473	+	226	5819506	31024
chr9	5788482	5988482	harbor1	chr9	5828243	5828807	LTR/ERV1	2542	+	282	5828525	40043
chr9	5788482	5988482	harbor1	chr9	5882401	5882706	LTR/ERV1	2238	+	152	5882553	94071
chr9	5788482	5988482	harbor1	chr9	5883171	5883309	LTR/ERV1	2238	+	69	5883240	94758
chr9	190239	390239	harbor1	chr9	203072	203630	LTR/ERV1	542	+	279	203351	13112
chr9	76870660	77070660	harbor1	chr9	76916432	76916702	LTR/ERV1	1130	+	135	76916567	45907
chr9	76870660	77070660	harbor1	chr9	76925371	76925468	LTR/ERV1	437	+	48	76925419	54759
chr9	76870660	77070660	harbor1	chr9	76954632	76954698	LTR/ERV1	581	+	33	76954665	84005
chr9	76870660	77070660	harbor1	chr9	76956333	76956747	LTR/ERV1	3109	+	207	76956540	85880
chr9	86317097	86517097	harbor1	chr9	86360180	86360600	LTR/ERV1	2391	+	210	86360390	43293
chr9	86317097	86517097	harbor1	chr9	86369581	86369709	LTR/ERV1	723	+	64	86369645	52548
chr9	27651942	27851942	harbor1	chr9	27654729	27655541	LTR/ERV1	4631	+	406	27655135	3193
chr9	27651942	27851942	harbor1	chr9	27665019	27665627	LTR/ERV1	3477	+	304	27665323	13381
chr9	27651942	27851942	harbor1	chr9	27676064	27676793	LTR/ERV1	5281	+	364	27676428	24486
chr9	27651942	27851942	harbor1	chr9	27687819	27688720	LTR/ERV1	4788	+	450	27688269	36327
chr9	27651942	27851942	harbor1	chr9	27707589	27708100	LTR/ERV1	2716	+	256	27707845	55903
chr9	27651942	27851942	harbor1	chr9	27734888	27735258	LTR/ERV1	1301	+	185	27735073	83131
chr9	120887399	121087399	harbor1	chr9	120938241	120938549	LTR/ERV1	1502	+	154	120938395	50996
chr9	120887399	121087399	harbor1	chr9	120938843	120939029	LTR/ERV1	1502	+	93	120938936	51537
chr9	120887399	121087399	harbor1	chr9	120939139	120939540	LTR/ERV1	1502	+	200	120939339	51940
chr9	120887399	121087399	harbor1	chr9	120985780	120986208	LTR/ERV1	716	+	214	120985994	98595
chr9	120887399	121087399	harbor1	chr9	120946222	120946756	LTR/ERV1	1980	+	267	120946489	59090
chr9	78886424	79086424	harbor1	chr9	78919136	78919553	LTR/ERV1	1383	+	208	78919344	32920
chr9	78886424	79086424	harbor1	chr9	78919554	78920544	LTR/ERV1	6668	+	495	78920049	33625
chr9	78886424	79086424	harbor1	chr9	78920902	78921671	LTR/ERV1	6668	+	384	78921286	34862
chr9	78886424	79086424	harbor1	chr9	78923041	78923712	LTR/ERV1	3329	+	336	78923377	36953
chr9	78886424	79086424	harbor1	chr9	78923815	78925156	LTR/ERV1	6250	+	670	78924485	38061
chr9	78886424	79086424	harbor1	chr9	78925175	78926468	LTR/ERV1	15515	+	646	78925821	39397
chr9	78886424	79086424	harbor1	chr9	78926740	78928415	LTR/ERV1	15515	+	838	78927578	41154
chr9	78886424	79086424	harbor1	chr9	78928417	78928865	LTR/ERV1	1394	+	224	78928641	42217
chr9	78886424	79086424	harbor1	chr9	78970058	78970860	LTR/ERV1	3636	+	401	78970459	84035
chr9	112346402	112546402	harbor1	chr9	112348156	112348809	LTR/ERV1	3692	+	326	112348482	2080
chr9	79185210	79385210	harbor1	chr9	79221230	79221591	LTR/ERV1	1318	+	180	79221410	36200
chr9	79185210	79385210	harbor1	chr9	79221954	79222438	LTR/ERV1	1318	+	242	79222196	36986
chr9	79185210	79385210	harbor1	chr9	79228884	79229437	LTR/ERV1	3102	+	276	79229160	43950
chr9	105202249	105402249	harbor1	chr9	105223107	105223636	LTR/ERV1	2494	+	264	105223371	21122
chr9	89812466	90012466	harbor1	chr9	89850111	89850477	LTR/ERV1	1158	+	183	89850294	37828
chr9	67164397	67364397	harbor1	chr9	67202836	67203228	LTR/ERV1	1623	+	196	67203032	38635
chr9	20252645	20452645	harbor1	chr9	20273226	20273390	LTR/ERV1	1727	+	82	20273308	20663
chr9	20252645	20452645	harbor1	chr9	20273758	20274019	LTR/ERV1	1727	+	130	20273888	21243
chr9	20252645	20452645	harbor1	chr9	20337537	20337708	LTR/ERV1	547	+	86	20337623	84978
chr9	20252645	20452645	harbor1	chr9	20337996	20338356	LTR/ERV1	1613	+	180	20338176	85531
chr9	26456896	26656896	harbor1	chr9	26539676	26540032	LTR/ERV1	2065	+	178	26539854	82958
chr9	26456896	26656896	harbor1	chr9	26540018	26540338	LTR/ERV1	1366	+	160	26540178	83282
chr9	102079509	102279509	harbor1	chr9	102090958	102091507	LTR/ERV1	1599	+	274	102091232	11723
chr9	102079509	102279509	harbor1	chr9	102165160	102165577	LTR/ERV1	1948	+	208	102165368	85859
chr9	30451399	30651399	harbor1	chr9	30454320	30454715	LTR/ERV1	775	+	198	30454518	3119
chr9	30451399	30651399	harbor1	chr9	30465532	30466406	LTR/ERV1	3161	+	437	30465969	14570
chr9	30451399	30651399	harbor1	chr9	30503637	30504264	LTR/ERV1	3767	+	314	30503951	52552
chr9	26415210	26615210	harbor1	chr9	26452413	26452702	LTR/ERV1	1163	+	144	26452557	37347
chr9	65698429	65898429	harbor1	chr9	65765230	65766078	LTR/ERV1	3913	+	424	65765654	67225
chr9	73721646	73921646	harbor1	chr9	73728830	73729047	LTR/ERV1	392	+	108	73728938	7292
chr9	73721646	73921646	harbor1	chr9	73729453	73729603	LTR/ERV1	453	+	75	73729528	7882
chr9	27511039	27711039	harbor1	chr9	27574673	27575119	LTR/ERV1	2195	+	223	27574896	63857
chr9	27511039	27711039	harbor1	chr9	27586645	27587040	LTR/ERV1	2451	+	198	27586843	75804
chr9	27511039	27711039	harbor1	chr9	27595712	27596163	LTR/ERV1	2108	+	226	27595938	84899
chr9	27511039	27711039	harbor1	chr9	27603026	27603543	LTR/ERV1	3058	+	258	27603284	92245
chr9	30261974	30461974	harbor1	chr9	30291361	30291546	LTR/ERV1	473	+	92	30291453	29479
chr9	30261974	30461974	harbor1	chr9	30295397	30295883	LTR/ERV1	2013	+	243	30295640	33666
chr9	30261974	30461974	harbor1	chr9	30299077	30300658	LTR/ERV1	11076	+	790	30299867	37893
chr9	30261974	30461974	harbor1	chr9	30344017	30344347	LTR/ERV1	1659	+	165	30344182	82208
chr9	30261974	30461974	harbor1	chr9	30344465	30345631	LTR/ERV1	2819	+	583	30345048	83074
chr9	30261974	30461974	harbor1	chr9	30345660	30345791	LTR/ERV1	974	+	66	30345726	83752
chr9	30261974	30461974	harbor1	chr9	30346102	30346811	LTR/ERV1	2138	+	354	30346456	84482
chr9	30261974	30461974	harbor1	chr9	30347125	30347175	LTR/ERV1	2138	+	25	30347150	85176
chr9	30261974	30461974	harbor1	chr9	30347339	30347692	LTR/ERV1	1743	+	176	30347515	85541
chr9	13314251	13514251	harbor1	chr9	13363079	13363351	LTR/ERV1	665	+	136	13363215	48964
chr9	13314251	13514251	harbor1	chr9	13363706	13363863	LTR/ERV1	550	+	78	13363784	49533
chr9	13314251	13514251	harbor1	chr9	13381045	13381570	LTR/ERV1	659	+	262	13381307	67056
chr9	134842360	135042360	harbor1	chr9	134859506	134860091	LTR/ERV1	3796	+	292	134859798	17438
chr9	134842360	135042360	harbor1	chr9	134890001	134890583	LTR/ERV1	3337	+	291	134890292	47932
chr9	134842360	135042360	harbor1	chr9	134890625	134891349	LTR/ERV1	4769	+	362	134890987	48627
chr9	134842360	135042360	harbor1	chr9	134894255	134894737	LTR/ERV1	3327	+	241	134894496	52136
chr9	106781833	106981833	harbor1	chr9	106788282	106788693	LTR/ERV1	2846	+	206	106788488	6655
chr9	106781833	106981833	harbor1	chr9	106792597	106793258	LTR/ERV1	4016	+	330	106792927	11094
chr9	106781833	106981833	harbor1	chr9	106793260	106793475	LTR/ERV1	1295	+	108	106793368	11535
chr9	106781833	106981833	harbor1	chr9	106793476	106793849	LTR/ERV1	2273	+	186	106793662	11829
chr9	106781833	106981833	harbor1	chr9	106788696	106792594	LTR/ERV1	20864	+	1949	106790645	8812
chr9	118902974	119102974	harbor1	chr9	118930117	118930819	LTR/ERV1	3970	+	351	118930468	27494
chr9	96506681	96706681	harbor1	chr9	96582147	96582727	LTR/ERV1	4873	+	290	96582437	75756
chr9	65508840	65708840	harbor1	chr9	65516001	65516489	LTR/ERV1	744	+	244	65516245	7405
chr9	65508840	65708840	harbor1	chr9	65532012	65532339	LTR/ERV1	1405	+	164	65532176	23336
chr9	93089236	93289236	harbor1	chr9	93093156	93093588	LTR/ERV1	1635	+	216	93093372	4136
chr9	82397978	82597978	harbor1	chr9	82419983	82420326	LTR/ERV1	1518	+	172	82420155	22177
chr9	82397978	82597978	harbor1	chr9	82421060	82421223	LTR/ERV1	1518	+	82	82421142	23164
chr9	82397978	82597978	harbor1	chr9	82472119	82472510	LTR/ERV1	2115	+	196	82472315	74337
chr9	119951073	120151073	harbor1	chr9	120012044	120012432	LTR/ERV1	432	+	194	120012238	61165
chr9	94045412	94245412	harbor1	chr9	94054652	94055127	LTR/ERV1	1643	+	238	94054890	9478
chr9	94045412	94245412	harbor1	chr9	94134306	94135003	LTR/ERV1	4565	+	348	94134654	89242
chr9	94045412	94245412	harbor1	chr9	94137111	94137657	LTR/ERV1	4219	+	273	94137384	91972
chr9	20513613	20713613	harbor1	chr9	20593281	20593941	LTR/ERV1	6103	+	330	20593611	79998
chr9	20513613	20713613	harbor1	chr9	20594241	20594490	LTR/ERV1	6103	+	124	20594365	80752
chr9	20513613	20713613	harbor1	chr9	20594491	20595047	LTR/ERV1	3805	+	278	20594769	81156
chr9	100146880	100346880	harbor1	chr9	100227586	100227978	LTR/ERV1	2042	+	196	100227782	80902
chr9	100146880	100346880	harbor1	chr9	100228291	100228333	LTR/ERV1	2042	+	21	100228312	81432
chr9	72678200	72878200	harbor1	chr9	72721065	72721590	LTR/ERV1	1489	+	262	72721327	43127
chr9	98099239	98299239	harbor1	chr9	98102082	98102410	LTR/ERV1	860	+	164	98102246	3007
chr9	98099239	98299239	harbor1	chr9	98111494	98111657	LTR/ERV1	2427	+	82	98111576	12337
chr9	98099239	98299239	harbor1	chr9	98111958	98112518	LTR/ERV1	7670	+	280	98112238	12999
chr9	98099239	98299239	harbor1	chr9	98112820	98112831	LTR/ERV1	7670	+	6	98112826	13587
chr9	98099239	98299239	harbor1	chr9	98113141	98113357	LTR/ERV1	7670	+	108	98113249	14010
chr9	98099239	98299239	harbor1	chr9	98113655	98114337	LTR/ERV1	7670	+	341	98113996	14757
chr9	98099239	98299239	harbor1	chr9	98114622	98115070	LTR/ERV1	7670	+	224	98114846	15607
chr9	98099239	98299239	harbor1	chr9	98115683	98115852	LTR/ERV1	7670	+	84	98115767	16528
chr9	98099239	98299239	harbor1	chr9	98116034	98116046	LTR/ERV1	2433	+	6	98116040	16801
chr9	98099239	98299239	harbor1	chr9	98116323	98116554	LTR/ERV1	2433	+	116	98116439	17200
chr9	98099239	98299239	harbor1	chr9	98116864	98117141	LTR/ERV1	2433	+	138	98117002	17763
chr9	98099239	98299239	harbor1	chr9	98117595	98117804	LTR/ERV1	875	+	104	98117699	18460
chr9	108937191	109137191	harbor1	chr9	108975877	108975966	LTR/ERV1	416	+	44	108975921	38730
chr9	39493110	39693110	harbor1	chr9	39508851	39509333	LTR/ERV1	3771	+	241	39509092	15982
chr9	39493110	39693110	harbor1	chr9	39527403	39527474	LTR/ERV1	444	+	36	39527439	34329
chr9	39493110	39693110	harbor1	chr9	39527475	39527928	LTR/ERV1	3379	+	226	39527701	34591
chr9	39493110	39693110	harbor1	chr9	39542238	39542458	LTR/ERV1	1181	+	110	39542348	49238
chr9	39493110	39693110	harbor1	chr9	39543274	39543550	LTR/ERV1	800	+	138	39543412	50302
chr9	39493110	39693110	harbor1	chr9	39543551	39543669	LTR/ERV1	3242	+	59	39543610	50500
chr9	39493110	39693110	harbor1	chr9	39543670	39544009	LTR/ERV1	2435	+	170	39543840	50730
chr9	39493110	39693110	harbor1	chr9	39544010	39544483	LTR/ERV1	3242	+	236	39544246	51136
chr9	39493110	39693110	harbor1	chr9	39544520	39544937	LTR/ERV1	1927	+	208	39544728	51618
chr9	39493110	39693110	harbor1	chr9	39561775	39562158	LTR/ERV1	4239	+	192	39561967	68857
chr9	39493110	39693110	harbor1	chr9	39562458	39562632	LTR/ERV1	4239	+	87	39562545	69435
chr9	39493110	39693110	harbor1	chr9	39550770	39551034	LTR/ERV1	954	+	132	39550902	57792
chr9	97940368	98140368	harbor1	chr9	98039297	98039977	LTR/ERV1	5171	+	340	98039637	99269
chr9	61188283	61388283	harbor1	chr9	61282024	61282450	LTR/ERV1	2469	+	213	61282237	93954
chr9	11326079	11526079	harbor1	chr9	11326234	11326736	LTR/ERV1	2463	+	251	11326485	406
chr9	11326079	11526079	harbor1	chr9	11348208	11348653	LTR/ERV1	1167	+	222	11348430	22351
chr9	11326079	11526079	harbor1	chr9	11413167	11414640	LTR/ERV1	6343	+	736	11413903	87824
chr9	9228833	9428833	harbor1	chr9	9232706	9233080	LTR/ERV1	2274	+	187	9232893	4060
chr9	9228833	9428833	harbor1	chr9	9235354	9235594	LTR/ERV1	2274	+	120	9235474	6641
chr9	9228833	9428833	harbor1	chr9	9235621	9235863	LTR/ERV1	482	+	121	9235742	6909
chr9	9228833	9428833	harbor1	chr9	9236283	9237022	LTR/ERV1	1143	+	370	9236653	7820
chr9	9228833	9428833	harbor1	chr9	9237580	9238028	LTR/ERV1	1459	+	224	9237804	8971
chr9	9228833	9428833	harbor1	chr9	9238083	9238402	LTR/ERV1	1441	+	160	9238243	9410
chr9	9228833	9428833	harbor1	chr9	9238639	9238762	LTR/ERV1	407	+	62	9238701	9868
chr9	9228833	9428833	harbor1	chr9	9238990	9239208	LTR/ERV1	463	+	109	9239099	10266
chr9	9228833	9428833	harbor1	chr9	9239191	9239459	LTR/ERV1	635	+	134	9239325	10492
chr9	9228833	9428833	harbor1	chr9	9239619	9239968	LTR/ERV1	757	+	174	9239793	10960
chr9	9228833	9428833	harbor1	chr9	9240181	9240390	LTR/ERV1	732	+	104	9240285	11452
chr9	9228833	9428833	harbor1	chr9	9240592	9241600	LTR/ERV1	3219	+	504	9241096	12263
chr9	9228833	9428833	harbor1	chr9	9245790	9246782	LTR/ERV1	3037	+	496	9246286	17453
chr9	9228833	9428833	harbor1	chr9	9246846	9247549	LTR/ERV1	4179	+	352	9247198	18365
chr9	9228833	9428833	harbor1	chr9	9252117	9252479	LTR/ERV1	2007	+	181	9252298	23465
chr9	82655761	82855761	harbor1	chr9	82746166	82746838	LTR/ERV1	3225	+	336	82746502	90741
chr9	63594163	63794163	harbor1	chr9	63607594	63607996	LTR/ERV1	1901	+	201	63607795	13632
chr9	63594163	63794163	harbor1	chr9	63608001	63608430	LTR/ERV1	1561	+	214	63608215	14052
chr9	63594163	63794163	harbor1	chr9	63629710	63630114	LTR/ERV1	1561	+	202	63629912	35749
chr9	63594163	63794163	harbor1	chr9	63653088	63653418	LTR/ERV1	542	+	165	63653253	59090
chr9	63594163	63794163	harbor1	chr9	63661269	63661649	LTR/ERV1	1101	+	190	63661459	67296
chr9	128090719	128290719	harbor1	chr9	128155104	128155317	LTR/ERV1	3225	+	106	128155210	64491
chr9	128090719	128290719	harbor1	chr9	128155599	128156050	LTR/ERV1	3225	+	226	128155825	65106
chr9	79993953	80193953	harbor1	chr9	80056597	80056699	LTR/ERV1	544	+	51	80056648	62695
chr9	79993953	80193953	harbor1	chr9	80075502	80075998	LTR/ERV1	2434	+	248	80075750	81797
chr9	67508600	67708600	harbor1	chr9	67590933	67591215	LTR/ERV1	1514	+	141	67591074	82474
chr9	67508600	67708600	harbor1	chr9	67591283	67591612	LTR/ERV1	1189	+	164	67591447	82847
chr9	67508600	67708600	harbor1	chr9	67599163	67599637	LTR/ERV1	3778	+	237	67599400	90800
chr9	67508600	67708600	harbor1	chr9	67599945	67600079	LTR/ERV1	3778	+	67	67600012	91412
chr9	67508600	67708600	harbor1	chr9	67605572	67605963	LTR/ERV1	2733	+	196	67605768	97168
chr9	67508600	67708600	harbor1	chr9	67605953	67606066	LTR/ERV1	730	+	56	67606009	97409
chr9	6658963	6858963	harbor1	chr9	6683507	6683925	LTR/ERV1	1504	+	209	6683716	24753
chr9	6658963	6858963	harbor1	chr9	6708391	6708588	LTR/ERV1	1849	+	98	6708489	49526
chr9	6658963	6858963	harbor1	chr9	6708738	6709057	LTR/ERV1	1849	+	160	6708898	49935
chr9	6658963	6858963	harbor1	chr9	6717627	6718329	LTR/ERV1	3848	+	351	6717978	59015
chr9	6658963	6858963	harbor1	chr9	6718616	6718635	LTR/ERV1	3848	+	10	6718626	59663
chr9	6658963	6858963	harbor1	chr9	6718935	6719011	LTR/ERV1	3848	+	38	6718973	60010
chr9	447793	647793	harbor1	chr9	475513	475847	LTR/ERV1	2393	+	167	475680	27887
chr9	447793	647793	harbor1	chr9	474922	475512	LTR/ERV1	3671	+	295	475217	27424
chr9	132916076	133116076	harbor1	chr9	132964451	132964735	LTR/ERV1	1705	+	142	132964593	48517
chr9	132916076	133116076	harbor1	chr9	132964958	132965118	LTR/ERV1	821	+	80	132965038	48962
chr9	77307523	77507523	harbor1	chr9	77341217	77341336	LTR/ERV1	854	+	60	77341277	33754
chr9	112822031	113022031	harbor1	chr9	112879874	112880048	LTR/ERV1	1831	+	87	112879961	57930
chr9	112822031	113022031	harbor1	chr9	112880351	112880716	LTR/ERV1	1831	+	182	112880533	58502
chr9	112822031	113022031	harbor1	chr9	112906116	112906845	LTR/ERV1	3324	+	364	112906480	84449
chr9	112822031	113022031	harbor1	chr9	112913840	112914134	LTR/ERV1	848	+	147	112913987	91956
chr9	112822031	113022031	harbor1	chr9	112914435	112914552	LTR/ERV1	848	+	58	112914493	92462
chr9	13144466	13344466	harbor1	chr9	13211128	13211363	LTR/ERV1	512	+	118	13211246	66780
chr9	13144466	13344466	harbor1	chr9	13238016	13238638	LTR/ERV1	2979	+	311	13238327	93861
chr9	24632905	24832905	harbor1	chr9	24648234	24648515	LTR/ERV1	1799	+	140	24648374	15469
chr9	24632905	24832905	harbor1	chr9	24648529	24650078	LTR/ERV1	6913	+	774	24649303	16398
chr9	24632905	24832905	harbor1	chr9	24710623	24710742	LTR/ERV1	515	+	60	24710683	77778
chr9	24632905	24832905	harbor1	chr9	24728755	24729484	LTR/ERV1	5388	+	364	24729119	96214
chr9	131695081	131895081	harbor1	chr9	131695660	131695793	LTR/ERV1	483	+	66	131695726	645
chr9	31249949	31449949	harbor1	chr9	31272877	31273407	LTR/ERV1	3139	+	265	31273142	23193
chr9	31249949	31449949	harbor1	chr9	31326307	31326754	LTR/ERV1	3568	+	224	31326531	76582
chr9	31249949	31449949	harbor1	chr9	31326757	31329821	LTR/ERV1	19471	+	1532	31328289	78340
chr9	31249949	31449949	harbor1	chr9	31329801	31329950	LTR/ERV1	964	+	74	31329875	79926
chr9	31249949	31449949	harbor1	chr9	31329941	31334249	LTR/ERV1	26652	+	2154	31332095	82146
chr9	31249949	31449949	harbor1	chr9	31334250	31334697	LTR/ERV1	3458	+	224	31334474	84525
chr9	41143431	41343431	harbor1	chr9	41143046	41143483	LTR/ERV1	840	+	218	41143264	167
chr9	41143431	41343431	harbor1	chr9	41193349	41193618	LTR/ERV1	887	+	134	41193483	50052
chr9	41143431	41343431	harbor1	chr9	41193884	41193974	LTR/ERV1	887	+	45	41193929	50498
chr9	41143431	41343431	harbor1	chr9	41193975	41194102	LTR/ERV1	433	+	64	41194039	50608
chr9	41143431	41343431	harbor1	chr9	41194104	41194414	LTR/ERV1	999	+	155	41194259	50828
chr9	41143431	41343431	harbor1	chr9	41236000	41236454	LTR/ERV1	3637	+	227	41236227	92796
chr9	80880506	81080506	harbor1	chr9	80885627	80886154	LTR/ERV1	3585	+	264	80885891	5385
chr9	80880506	81080506	harbor1	chr9	80961594	80961933	LTR/ERV1	1717	+	170	80961764	81258
chr9	80880506	81080506	harbor1	chr9	80974418	80975118	LTR/ERV1	4833	+	350	80974768	94262
chr9	80880506	81080506	harbor1	chr9	80978757	80979208	LTR/ERV1	2552	+	226	80978983	98477
chr9	104672672	104872672	harbor1	chr9	104700328	104700847	LTR/ERV1	3360	+	260	104700588	27916
chr9	104672672	104872672	harbor1	chr9	104750431	104750816	LTR/ERV1	2357	+	192	104750623	77951
chr9	62866671	63066671	harbor1	chr9	62897038	62897208	LTR/ERV1	666	+	85	62897123	30452
chr9	62866671	63066671	harbor1	chr9	62897232	62897457	LTR/ERV1	802	+	112	62897344	30673
chr9	62866671	63066671	harbor1	chr9	62907891	62908886	LTR/ERV1	2663	+	498	62908389	41718
chr9	62866671	63066671	harbor1	chr9	62908874	62909700	LTR/ERV1	4346	+	413	62909287	42616
chr9	83339820	83539820	harbor1	chr9	83437042	83437490	LTR/ERV1	1212	+	224	83437266	97446
chr9	32301727	32501727	harbor1	chr9	32306748	32307094	LTR/ERV1	3572	+	173	32306921	5194
chr9	32301727	32501727	harbor1	chr9	32307390	32307653	LTR/ERV1	3572	+	132	32307522	5795
chr9	95355105	95555105	harbor1	chr9	95370890	95371237	LTR/ERV1	1106	+	174	95371064	15959
chr9	95355105	95555105	harbor1	chr9	95371695	95371824	LTR/ERV1	1106	+	64	95371759	16654
chr9	474364	674364	harbor1	chr9	475513	475847	LTR/ERV1	2393	+	167	475680	1316
chr9	474364	674364	harbor1	chr9	474922	475512	LTR/ERV1	3671	+	295	475217	853
chr9	10057263	10257263	harbor1	chr9	10058196	10058551	LTR/ERV1	1457	+	178	10058374	1111
chr9	88019469	88219469	harbor1	chr9	88020430	88020667	LTR/ERV1	1046	+	118	88020548	1079
chr9	88019469	88219469	harbor1	chr9	88041190	88041532	LTR/ERV1	2328	+	171	88041361	21892
chr9	88019469	88219469	harbor1	chr9	88045102	88045466	LTR/ERV1	5726	+	182	88045284	25815
chr9	88019469	88219469	harbor1	chr9	88045780	88046324	LTR/ERV1	5726	+	272	88046052	26583
chr9	88019469	88219469	harbor1	chr9	88046395	88046536	LTR/ERV1	1044	+	70	88046465	26996
chr9	88019469	88219469	harbor1	chr9	88046526	88046657	LTR/ERV1	1050	+	66	88046592	27123
chr9	88019469	88219469	harbor1	chr9	88053867	88054178	LTR/ERV1	1639	+	156	88054023	34554
chr9	88019469	88219469	harbor1	chr9	88090246	88090706	LTR/ERV1	1703	+	230	88090476	71007
chr9	88019469	88219469	harbor1	chr9	88092867	88093188	LTR/ERV1	1034	+	160	88093027	73558
chr9	88019469	88219469	harbor1	chr9	88108773	88109220	LTR/ERV1	2766	+	224	88108997	89528
chr9	75813361	76013361	harbor1	chr9	75851827	75852435	LTR/ERV1	4837	+	304	75852131	38770
chr9	75813361	76013361	harbor1	chr9	75875835	75876137	LTR/ERV1	2265	+	151	75875986	62625
chr9	75813361	76013361	harbor1	chr9	75876450	75876585	LTR/ERV1	2265	+	68	75876518	63157
chr9	76830450	77030450	harbor1	chr9	76916432	76916702	LTR/ERV1	1130	+	135	76916567	86117
chr9	76830450	77030450	harbor1	chr9	76925371	76925468	LTR/ERV1	437	+	48	76925419	94969
chr9	42054965	42254965	harbor1	chr9	42141466	42141970	LTR/ERV1	3538	+	252	42141718	86753
chr9	42054965	42254965	harbor1	chr9	42144967	42145536	LTR/ERV1	3780	+	284	42145251	90286
chr9	115314293	115514293	harbor1	chr9	115379427	115380031	LTR/ERV1	2562	+	302	115379729	65436
chr9	115314293	115514293	harbor1	chr9	115381593	115382584	LTR/ERV1	4319	+	496	115382089	67796
chr9	115314293	115514293	harbor1	chr9	115382638	115383290	LTR/ERV1	3816	+	326	115382964	68671
chr9	115314293	115514293	harbor1	chr9	115383299	115383429	LTR/ERV1	688	+	65	115383364	69071
chr9	115314293	115514293	harbor1	chr9	115383798	115384978	LTR/ERV1	2371	+	590	115384388	70095
chr9	115314293	115514293	harbor1	chr9	115384977	115385178	LTR/ERV1	1220	+	100	115385077	70784
chr9	115314293	115514293	harbor1	chr9	115385180	115386402	LTR/ERV1	7245	+	611	115385791	71498
chr9	26135317	26335317	harbor1	chr9	26151820	26151898	LTR/ERV1	570	+	39	26151859	16542
chr9	26135317	26335317	harbor1	chr9	26164374	26165154	LTR/ERV1	4484	+	390	26164764	29447
chr9	25089687	25289687	harbor1	chr9	25111455	25112448	LTR/ERV1	2506	+	496	25111951	22264
chr9	26046237	26246237	harbor1	chr9	26064492	26065218	LTR/ERV1	2095	+	363	26064855	18618
chr9	27197333	27397333	harbor1	chr9	27280875	27281200	LTR/ERV1	1247	+	162	27281037	83704
chr9	27197333	27397333	harbor1	chr9	27281205	27281566	LTR/ERV1	1922	+	180	27281385	84052
chr9	94328521	94528521	harbor1	chr9	94366153	94366393	LTR/ERV1	592	+	120	94366273	37752
chr9	83911096	84111096	harbor1	chr9	83924399	83924945	LTR/ERV1	765	+	273	83924672	13576
chr9	83911096	84111096	harbor1	chr9	83934516	83934561	LTR/ERV1	1664	+	22	83934538	23442
chr9	83911096	84111096	harbor1	chr9	83934697	83934977	LTR/ERV1	1664	+	140	83934837	23741
chr9	83911096	84111096	harbor1	chr9	83935517	83935819	LTR/ERV1	846	+	151	83935668	24572
chr9	72928890	73128890	harbor1	chr9	73016838	73017278	LTR/ERV1	2213	+	220	73017058	88168
chr9	135473597	135673597	harbor1	chr9	135543388	135543932	LTR/ERV1	3918	+	272	135543660	70063
chr9	135473597	135673597	harbor1	chr9	135559789	135559954	LTR/ERV1	794	+	82	135559871	86274
chr9	135473597	135673597	harbor1	chr9	135570480	135570986	LTR/ERV1	3295	+	253	135570733	97136
chr9	108094146	108294146	harbor1	chr9	108122092	108122724	LTR/ERV1	3524	+	316	108122408	28262
chr9	108094146	108294146	harbor1	chr9	108147180	108148429	LTR/ERV1	2016	+	624	108147804	53658
chr9	111742767	111942767	harbor1	chr9	111808417	111808886	LTR/ERV1	3397	+	234	111808651	65884
chr9	111742767	111942767	harbor1	chr9	111810243	111810973	LTR/ERV1	3185	+	365	111810608	67841
chr9	5824117	6024117	harbor1	chr9	5828243	5828807	LTR/ERV1	2542	+	282	5828525	4408
chr9	5824117	6024117	harbor1	chr9	5882401	5882706	LTR/ERV1	2238	+	152	5882553	58436
chr9	5824117	6024117	harbor1	chr9	5883171	5883309	LTR/ERV1	2238	+	69	5883240	59123
chr9	5824117	6024117	harbor1	chr9	5905217	5905487	LTR/ERV1	1515	+	135	5905352	81235
chr9	5824117	6024117	harbor1	chr9	5905588	5905938	LTR/ERV1	1664	+	175	5905763	81646
chr9	432916	632916	harbor1	chr9	475513	475847	LTR/ERV1	2393	+	167	475680	42764
chr9	432916	632916	harbor1	chr9	474922	475512	LTR/ERV1	3671	+	295	475217	42301
chr9	60722568	60922568	harbor1	chr9	60743057	60743140	LTR/ERV1	412	+	42	60743099	20531
chr9	60722568	60922568	harbor1	chr9	60748565	60748683	LTR/ERV1	428	+	59	60748624	26056
chr9	60722568	60922568	harbor1	chr9	60749470	60750012	LTR/ERV1	2653	+	271	60749741	27173
chr9	91546426	91746426	harbor1	chr9	91574629	91575034	LTR/ERV1	1549	+	202	91574831	28405
chr9	91546426	91746426	harbor1	chr9	91577693	91577915	LTR/ERV1	640	+	111	91577804	31378
chr9	9991754	10191754	harbor1	chr9	9997607	9998065	LTR/ERV1	2140	+	229	9997836	6082
chr9	9991754	10191754	harbor1	chr9	9998157	9998518	LTR/ERV1	2609	+	180	9998337	6583
chr9	9991754	10191754	harbor1	chr9	9998522	9998671	LTR/ERV1	676	+	74	9998596	6842
chr9	9991754	10191754	harbor1	chr9	9998675	9999079	LTR/ERV1	2579	+	202	9998877	7123
chr9	9991754	10191754	harbor1	chr9	9999067	9999840	LTR/ERV1	3476	+	386	9999453	7699
chr9	9991754	10191754	harbor1	chr9	9999832	10000000	LTR/ERV1	816	+	84	9999916	8162
chr9	9991754	10191754	harbor1	chr9	10000332	10000585	LTR/ERV1	1355	+	126	10000458	8704
chr9	9991754	10191754	harbor1	chr9	10000586	10001203	LTR/ERV1	2998	+	308	10000894	9140
chr9	9991754	10191754	harbor1	chr9	10008095	10008783	LTR/ERV1	2016	+	344	10008439	16685
chr9	9991754	10191754	harbor1	chr9	10025910	10026578	LTR/ERV1	657	+	334	10026244	34490
chr9	9991754	10191754	harbor1	chr9	10054410	10054829	LTR/ERV1	1908	+	210	10054620	62866
chr9	9991754	10191754	harbor1	chr9	10055232	10055271	LTR/ERV1	1908	+	20	10055252	63498
chr9	9991754	10191754	harbor1	chr9	10058196	10058551	LTR/ERV1	1457	+	178	10058374	66620
chr9	115377893	115577893	harbor1	chr9	115379427	115380031	LTR/ERV1	2562	+	302	115379729	1836
chr9	115377893	115577893	harbor1	chr9	115381593	115382584	LTR/ERV1	4319	+	496	115382089	4196
chr9	115377893	115577893	harbor1	chr9	115382638	115383290	LTR/ERV1	3816	+	326	115382964	5071
chr9	115377893	115577893	harbor1	chr9	115383299	115383429	LTR/ERV1	688	+	65	115383364	5471
chr9	115377893	115577893	harbor1	chr9	115383798	115384978	LTR/ERV1	2371	+	590	115384388	6495
chr9	115377893	115577893	harbor1	chr9	115384977	115385178	LTR/ERV1	1220	+	100	115385077	7184
chr9	115377893	115577893	harbor1	chr9	115385180	115386402	LTR/ERV1	7245	+	611	115385791	7898
chr9	115377893	115577893	harbor1	chr9	115436429	115436861	LTR/ERV1	2801	+	216	115436645	58752
chr9	115377893	115577893	harbor1	chr9	115473181	115473632	LTR/ERV1	3422	+	226	115473407	95514
chr9	115377893	115577893	harbor1	chr9	115473632	115474252	LTR/ERV1	3962	+	310	115473942	96049
chr9	115377893	115577893	harbor1	chr9	115476740	115476884	LTR/ERV1	770	+	72	115476812	98919
chr9	115377893	115577893	harbor1	chr9	115476875	115477377	LTR/ERV1	3028	+	251	115477126	99233
chr9	115377893	115577893	harbor1	chr9	115477382	115477996	LTR/ERV1	2771	+	307	115477689	99796
chr9	115377893	115577893	harbor1	chr9	115474254	115476760	LTR/ERV1	15758	+	1253	115475507	97614
chr9	135900303	136100303	harbor1	chr9	135962012	135962421	LTR/ERV1	2068	+	204	135962216	61913
chr9	103556930	103756930	harbor1	chr9	103586119	103587090	LTR/ERV1	4979	+	486	103586605	29675
chr9	103556930	103756930	harbor1	chr9	103598837	103599655	LTR/ERV1	4777	+	409	103599246	42316
chr9	103556930	103756930	harbor1	chr9	103601115	103601581	LTR/ERV1	2235	+	233	103601348	44418
chr9	103556930	103756930	harbor1	chr9	103635990	103636796	LTR/ERV1	3769	+	403	103636393	79463
chr9	63907492	64107492	harbor1	chr9	63972533	63972969	LTR/ERV1	961	+	218	63972751	65259
chr9	64654454	64854454	harbor1	chr9	64742141	64742368	LTR/ERV1	667	+	114	64742255	87801
chr9	43142566	43342566	harbor1	chr9	43238552	43238821	LTR/ERV1	784	+	134	43238686	96120
chr9	14323030	14523030	harbor1	chr9	14391288	14392017	LTR/ERV1	3625	+	364	14391652	68622
chr9	79234517	79434517	harbor1	chr9	79312186	79312942	LTR/ERV1	5251	+	378	79312564	78047
chr9	3155861	3355861	harbor1	chr9	3185689	3186048	LTR/ERV1	3714	+	180	3185869	30008
chr9	3155861	3355861	harbor1	chr9	3186388	3186744	LTR/ERV1	3714	+	178	3186566	30705
chr9	3155861	3355861	harbor1	chr9	3204239	3204466	LTR/ERV1	1726	+	114	3204353	48492
chr9	3155861	3355861	harbor1	chr9	3204852	3205238	LTR/ERV1	1726	+	193	3205045	49184
chr9	83107406	83307406	harbor1	chr9	83128224	83128923	LTR/ERV1	3626	+	350	83128574	21168
chr9	41463643	41663643	harbor1	chr9	41504761	41505666	LTR/ERV1	4637	+	452	41505213	41570
chr9	41463643	41663643	harbor1	chr9	41526766	41527164	LTR/ERV1	2604	+	199	41526965	63322
chr9	41463643	41663643	harbor1	chr9	41527165	41527683	LTR/ERV1	946	+	259	41527424	63781
chr9	41463643	41663643	harbor1	chr9	41527674	41528301	LTR/ERV1	2876	+	314	41527988	64345
chr9	41463643	41663643	harbor1	chr9	41528626	41530076	LTR/ERV1	17134	+	725	41529351	65708
chr9	41463643	41663643	harbor1	chr9	41530443	41532903	LTR/ERV1	17134	+	1230	41531673	68030
chr9	41463643	41663643	harbor1	chr9	41532929	41533198	LTR/ERV1	17134	+	134	41533063	69420
chr9	41463643	41663643	harbor1	chr9	41533813	41533990	LTR/ERV1	2633	+	88	41533901	70258
chr9	41463643	41663643	harbor1	chr9	41534224	41534674	LTR/ERV1	2127	+	225	41534449	70806
chr9	41463643	41663643	harbor1	chr9	41544590	41545003	LTR/ERV1	2507	+	206	41544796	81153
chr9	41463643	41663643	harbor1	chr9	41533202	41533521	LTR/ERV1	2633	+	160	41533362	69719
chr9	98084017	98284017	harbor1	chr9	98089096	98089175	LTR/ERV1	2797	+	40	98089136	5119
chr9	98084017	98284017	harbor1	chr9	98089477	98089992	LTR/ERV1	2797	+	258	98089735	5718
chr9	98084017	98284017	harbor1	chr9	98092586	98092981	LTR/ERV1	2732	+	198	98092784	8767
chr9	98084017	98284017	harbor1	chr9	98102082	98102410	LTR/ERV1	860	+	164	98102246	18229
chr9	98084017	98284017	harbor1	chr9	98111494	98111657	LTR/ERV1	2427	+	82	98111576	27559
chr9	98084017	98284017	harbor1	chr9	98111958	98112518	LTR/ERV1	7670	+	280	98112238	28221
chr9	98084017	98284017	harbor1	chr9	98112820	98112831	LTR/ERV1	7670	+	6	98112826	28809
chr9	98084017	98284017	harbor1	chr9	98113141	98113357	LTR/ERV1	7670	+	108	98113249	29232
chr9	98084017	98284017	harbor1	chr9	98113655	98114337	LTR/ERV1	7670	+	341	98113996	29979
chr9	98084017	98284017	harbor1	chr9	98114622	98115070	LTR/ERV1	7670	+	224	98114846	30829
chr9	98084017	98284017	harbor1	chr9	98115683	98115852	LTR/ERV1	7670	+	84	98115767	31750
chr9	98084017	98284017	harbor1	chr9	98116034	98116046	LTR/ERV1	2433	+	6	98116040	32023
chr9	98084017	98284017	harbor1	chr9	98116323	98116554	LTR/ERV1	2433	+	116	98116439	32422
chr9	98084017	98284017	harbor1	chr9	98116864	98117141	LTR/ERV1	2433	+	138	98117002	32985
chr9	98084017	98284017	harbor1	chr9	98117595	98117804	LTR/ERV1	875	+	104	98117699	33682
chr9	5555290	5755290	harbor1	chr9	5598997	5599420	LTR/ERV1	2170	+	212	5599209	43919
chr9	32450299	32650299	harbor1	chr9	32498024	32498551	LTR/ERV1	3342	+	264	32498288	47989
chr9	32450299	32650299	harbor1	chr9	32516030	32516420	LTR/ERV1	2129	+	195	32516225	65926
chr9	32450299	32650299	harbor1	chr9	32516426	32516747	LTR/ERV1	1609	+	160	32516586	66287
chr9	32450299	32650299	harbor1	chr9	32516758	32518823	LTR/ERV1	6173	+	1032	32517790	67491
chr9	32450299	32650299	harbor1	chr9	32519010	32520863	LTR/ERV1	17771	+	926	32519936	69637
chr9	32450299	32650299	harbor1	chr9	32522738	32522829	LTR/ERV1	583	+	46	32522784	72485
chr9	32450299	32650299	harbor1	chr9	32522830	32523267	LTR/ERV1	2242	+	218	32523048	72749
chr9	32450299	32650299	harbor1	chr9	32529596	32529870	LTR/ERV1	1220	+	137	32529733	79434
chr9	32450299	32650299	harbor1	chr9	32530193	32530231	LTR/ERV1	1220	+	19	32530212	79913
chr9	32450299	32650299	harbor1	chr9	32521163	32522738	LTR/ERV1	17771	+	788	32521951	71652
chr9	60723286	60923286	harbor1	chr9	60743057	60743140	LTR/ERV1	412	+	42	60743099	19813
chr9	60723286	60923286	harbor1	chr9	60748565	60748683	LTR/ERV1	428	+	59	60748624	25338
chr9	60723286	60923286	harbor1	chr9	60749470	60750012	LTR/ERV1	2653	+	271	60749741	26455
chr9	74070575	74270575	harbor1	chr9	74085583	74086032	LTR/ERV1	3483	+	224	74085807	15232
chr9	74070575	74270575	harbor1	chr9	74089057	74089204	LTR/ERV1	870	+	74	74089131	18556
chr9	74070575	74270575	harbor1	chr9	74089195	74089699	LTR/ERV1	3382	+	252	74089447	18872
chr9	74070575	74270575	harbor1	chr9	74089702	74090363	LTR/ERV1	4244	+	330	74090032	19457
chr9	74070575	74270575	harbor1	chr9	74090361	74090582	LTR/ERV1	1330	+	110	74090471	19896
chr9	74070575	74270575	harbor1	chr9	74090581	74090960	LTR/ERV1	2490	+	190	74090771	20196
chr9	74070575	74270575	harbor1	chr9	74090961	74091436	LTR/ERV1	3292	+	238	74091199	20624
chr9	74070575	74270575	harbor1	chr9	74091652	74092099	LTR/ERV1	4825	+	224	74091876	21301
chr9	74070575	74270575	harbor1	chr9	74092395	74092825	LTR/ERV1	4825	+	215	74092610	22035
chr9	74070575	74270575	harbor1	chr9	74086035	74089062	LTR/ERV1	19870	+	1514	74087549	16974
chr9	78184584	78384584	harbor1	chr9	78185057	78185247	LTR/ERV1	1403	+	95	78185152	568
chr9	78184584	78384584	harbor1	chr9	78185245	78185819	LTR/ERV1	3879	+	287	78185532	948
chr9	78184584	78384584	harbor1	chr9	78185821	78186031	LTR/ERV1	1295	+	105	78185926	1342
chr9	78184584	78384584	harbor1	chr9	78186030	78186408	LTR/ERV1	2350	+	189	78186219	1635
chr9	78184584	78384584	harbor1	chr9	78186409	78186819	LTR/ERV1	3081	+	205	78186614	2030
chr9	78184584	78384584	harbor1	chr9	78210228	78210534	LTR/ERV1	789	+	153	78210381	25797
chr9	78184584	78384584	harbor1	chr9	78210767	78210861	LTR/ERV1	789	+	47	78210814	26230
chr9	78184584	78384584	harbor1	chr9	78181105	78185060	LTR/ERV1	16686	+	1978	78183083	1501
chr9	68215703	68415703	harbor1	chr9	68312024	68312145	LTR/ERV1	491	+	60	68312084	96381
chr9	103693031	103893031	harbor1	chr9	103761988	103762480	LTR/ERV1	1207	+	246	103762234	69203
chr9	103693031	103893031	harbor1	chr9	103762910	103763119	LTR/ERV1	3053	+	104	103763014	69983
chr9	103693031	103893031	harbor1	chr9	103763163	103763392	LTR/ERV1	3053	+	114	103763277	70246
chr9	37541398	37741398	harbor1	chr9	37621242	37621771	LTR/ERV1	1651	+	264	37621506	80108
chr9	105618764	105818764	harbor1	chr9	105680374	105680503	LTR/ERV1	983	+	64	105680438	61674
chr9	105618764	105818764	harbor1	chr9	105680553	105680659	LTR/ERV1	587	+	53	105680606	61842
chr9	105618764	105818764	harbor1	chr9	105688152	105688497	LTR/ERV1	459	+	172	105688324	69560
chr9	105618764	105818764	harbor1	chr9	105712971	105714397	LTR/ERV1	3137	+	713	105713684	94920
chr9	83038004	83238004	harbor1	chr9	83078227	83078384	LTR/ERV1	1269	+	78	83078305	40301
chr9	83038004	83238004	harbor1	chr9	83078694	83078780	LTR/ERV1	1269	+	43	83078737	40733
chr9	83038004	83238004	harbor1	chr9	83128224	83128923	LTR/ERV1	3626	+	350	83128574	90570
chr9	97217247	97417247	harbor1	chr9	97216576	97218235	LTR/ERV1	11089	+	830	97217406	159
chr9	97217247	97417247	harbor1	chr9	97218230	97218379	LTR/ERV1	894	+	74	97218304	1057
chr9	97217247	97417247	harbor1	chr9	97218384	97218523	LTR/ERV1	879	+	70	97218454	1207
chr9	97217247	97417247	harbor1	chr9	97218526	97218932	LTR/ERV1	2486	+	203	97218729	1482
chr9	97217247	97417247	harbor1	chr9	97218934	97219151	LTR/ERV1	1286	+	108	97219042	1795
chr9	97217247	97417247	harbor1	chr9	97219152	97219532	LTR/ERV1	2358	+	190	97219342	2095
chr9	97217247	97417247	harbor1	chr9	97219533	97220014	LTR/ERV1	3194	+	240	97219773	2526
chr9	8915027	9115027	harbor1	chr9	8990444	8990932	LTR/ERV1	3415	+	244	8990688	75661
chr9	8915027	9115027	harbor1	chr9	8991238	8991410	LTR/ERV1	3415	+	86	8991324	76297
chr9	5897981	6097981	harbor1	chr9	5905217	5905487	LTR/ERV1	1515	+	135	5905352	7371
chr9	5897981	6097981	harbor1	chr9	5905588	5905938	LTR/ERV1	1664	+	175	5905763	7782
chr9	69483863	69683863	harbor1	chr9	69515079	69515639	LTR/ERV1	1563	+	280	69515359	31496
chr9	62370764	62570764	harbor1	chr9	62390639	62391179	LTR/ERV1	3021	+	270	62390909	20145
chr9	62370764	62570764	harbor1	chr9	62398711	62398971	LTR/ERV1	749	+	130	62398841	28077
chr9	62370764	62570764	harbor1	chr9	62399253	62399546	LTR/ERV1	1299	+	146	62399399	28635
chr9	95957197	96157197	harbor1	chr9	96030010	96030430	LTR/ERV1	2769	+	210	96030220	73023
chr9	95957197	96157197	harbor1	chr9	96030721	96030794	LTR/ERV1	2769	+	36	96030757	73560
chr9	95957197	96157197	harbor1	chr9	96034624	96035714	LTR/ERV1	5249	+	545	96035169	77972
chr9	95957197	96157197	harbor1	chr9	96043527	96043755	LTR/ERV1	742	+	114	96043641	86444
chr9	28274486	28474486	harbor1	chr9	28324353	28324955	LTR/ERV1	4038	+	301	28324654	50168
chr9	28274486	28474486	harbor1	chr9	28325117	28325435	LTR/ERV1	2115	+	159	28325276	50790
chr9	28274486	28474486	harbor1	chr9	28325799	28325991	LTR/ERV1	2115	+	96	28325895	51409
chr9	104583925	104783925	harbor1	chr9	104641417	104642118	LTR/ERV1	4504	+	350	104641767	57842
chr9	20309483	20509483	harbor1	chr9	20337537	20337708	LTR/ERV1	547	+	86	20337623	28140
chr9	20309483	20509483	harbor1	chr9	20337996	20338356	LTR/ERV1	1613	+	180	20338176	28693
chr9	80077245	80277245	harbor1	chr9	80137295	80137741	LTR/ERV1	3605	+	223	80137518	60273
chr9	80077245	80277245	harbor1	chr9	80137744	80140829	LTR/ERV1	19029	+	1542	80139286	62041
chr9	80077245	80277245	harbor1	chr9	80140809	80140958	LTR/ERV1	869	+	74	80140883	63638
chr9	80077245	80277245	harbor1	chr9	80140949	80141453	LTR/ERV1	3243	+	252	80141201	63956
chr9	80077245	80277245	harbor1	chr9	80141456	80142117	LTR/ERV1	4142	+	330	80141786	64541
chr9	80077245	80277245	harbor1	chr9	80142119	80142334	LTR/ERV1	1307	+	108	80142227	64982
chr9	80077245	80277245	harbor1	chr9	80142335	80142711	LTR/ERV1	2388	+	188	80142523	65278
chr9	80077245	80277245	harbor1	chr9	80142712	80143148	LTR/ERV1	3379	+	218	80142930	65685
chr9	28470617	28670617	harbor1	chr9	28518413	28518905	LTR/ERV1	1653	+	246	28518659	48042
chr9	69810002	70010002	harbor1	chr9	69848234	69849037	LTR/ERV1	855	+	402	69848636	38634
chr9	69810002	70010002	harbor1	chr9	69889040	69889758	LTR/ERV1	1135	+	359	69889399	79397
chr9	69810002	70010002	harbor1	chr9	69892527	69893321	LTR/ERV1	4191	+	397	69892924	82922
chr9	98110314	98310314	harbor1	chr9	98111494	98111657	LTR/ERV1	2427	+	82	98111576	1262
chr9	98110314	98310314	harbor1	chr9	98111958	98112518	LTR/ERV1	7670	+	280	98112238	1924
chr9	98110314	98310314	harbor1	chr9	98112820	98112831	LTR/ERV1	7670	+	6	98112826	2512
chr9	98110314	98310314	harbor1	chr9	98113141	98113357	LTR/ERV1	7670	+	108	98113249	2935
chr9	98110314	98310314	harbor1	chr9	98113655	98114337	LTR/ERV1	7670	+	341	98113996	3682
chr9	98110314	98310314	harbor1	chr9	98114622	98115070	LTR/ERV1	7670	+	224	98114846	4532
chr9	98110314	98310314	harbor1	chr9	98115683	98115852	LTR/ERV1	7670	+	84	98115767	5453
chr9	98110314	98310314	harbor1	chr9	98116034	98116046	LTR/ERV1	2433	+	6	98116040	5726
chr9	98110314	98310314	harbor1	chr9	98116323	98116554	LTR/ERV1	2433	+	116	98116439	6125
chr9	98110314	98310314	harbor1	chr9	98116864	98117141	LTR/ERV1	2433	+	138	98117002	6688
chr9	98110314	98310314	harbor1	chr9	98117595	98117804	LTR/ERV1	875	+	104	98117699	7385
chr9	127682046	127882046	harbor1	chr9	127700414	127701293	LTR/ERV1	5238	+	440	127700854	18808
chr9	127682046	127882046	harbor1	chr9	127703021	127703168	LTR/ERV1	773	+	74	127703095	21049
chr9	127682046	127882046	harbor1	chr9	127704540	127704787	LTR/ERV1	987	+	124	127704664	22618
chr9	127682046	127882046	harbor1	chr9	127737518	127737603	LTR/ERV1	2541	+	42	127737560	55514
chr9	127682046	127882046	harbor1	chr9	127737908	127738241	LTR/ERV1	2541	+	166	127738074	56028
chr9	40293644	40493644	harbor1	chr9	40328882	40329272	LTR/ERV1	1494	+	195	40329077	35433
chr9	40293644	40493644	harbor1	chr9	40359962	40360121	LTR/ERV1	492	+	80	40360042	66398
chr9	86651377	86851377	harbor1	chr9	86677223	86677943	LTR/ERV1	3923	+	360	86677583	26206
chr9	86651377	86851377	harbor1	chr9	86735442	86736310	LTR/ERV1	4775	+	434	86735876	84499
chr9	63405485	63605485	harbor1	chr9	63418152	63418379	LTR/ERV1	667	+	114	63418266	12781
chr9	63405485	63605485	harbor1	chr9	63467862	63468192	LTR/ERV1	1678	+	165	63468027	62542
chr9	63405485	63605485	harbor1	chr9	63468177	63468400	LTR/ERV1	805	+	112	63468289	62804
chr9	63405485	63605485	harbor1	chr9	63468589	63469019	LTR/ERV1	1683	+	215	63468804	63319
chr9	63405485	63605485	harbor1	chr9	63470340	63470363	LTR/ERV1	1408	+	12	63470352	64867
chr9	63405485	63605485	harbor1	chr9	63470639	63471020	LTR/ERV1	1408	+	190	63470829	65344
chr9	63405485	63605485	harbor1	chr9	63487545	63488916	LTR/ERV1	6367	+	686	63488231	82746
chr9	112259390	112459390	harbor1	chr9	112274698	112274789	LTR/ERV1	531	+	46	112274744	15354
chr9	112259390	112459390	harbor1	chr9	112274828	112275124	LTR/ERV1	1149	+	148	112274976	15586
chr9	112259390	112459390	harbor1	chr9	112322776	112322968	LTR/ERV1	1792	+	96	112322872	63482
chr9	112259390	112459390	harbor1	chr9	112323259	112323501	LTR/ERV1	1792	+	121	112323380	63990
chr9	112259390	112459390	harbor1	chr9	112325135	112325569	LTR/ERV1	2018	+	217	112325352	65962
chr9	112259390	112459390	harbor1	chr9	112348156	112348809	LTR/ERV1	3692	+	326	112348482	89092
chr9	41186114	41386114	harbor1	chr9	41193349	41193618	LTR/ERV1	887	+	134	41193483	7369
chr9	41186114	41386114	harbor1	chr9	41193884	41193974	LTR/ERV1	887	+	45	41193929	7815
chr9	41186114	41386114	harbor1	chr9	41193975	41194102	LTR/ERV1	433	+	64	41194039	7925
chr9	41186114	41386114	harbor1	chr9	41194104	41194414	LTR/ERV1	999	+	155	41194259	8145
chr9	41186114	41386114	harbor1	chr9	41236000	41236454	LTR/ERV1	3637	+	227	41236227	50113
chr9	41186114	41386114	harbor1	chr9	41246016	41246544	LTR/ERV1	2226	+	264	41246280	60166
chr9	41186114	41386114	harbor1	chr9	41284562	41285046	LTR/ERV1	1371	+	242	41284804	98690
chr9	80110499	80310499	harbor1	chr9	80137295	80137741	LTR/ERV1	3605	+	223	80137518	27019
chr9	80110499	80310499	harbor1	chr9	80137744	80140829	LTR/ERV1	19029	+	1542	80139286	28787
chr9	80110499	80310499	harbor1	chr9	80140809	80140958	LTR/ERV1	869	+	74	80140883	30384
chr9	80110499	80310499	harbor1	chr9	80140949	80141453	LTR/ERV1	3243	+	252	80141201	30702
chr9	80110499	80310499	harbor1	chr9	80141456	80142117	LTR/ERV1	4142	+	330	80141786	31287
chr9	80110499	80310499	harbor1	chr9	80142119	80142334	LTR/ERV1	1307	+	108	80142227	31728
chr9	80110499	80310499	harbor1	chr9	80142335	80142711	LTR/ERV1	2388	+	188	80142523	32024
chr9	80110499	80310499	harbor1	chr9	80142712	80143148	LTR/ERV1	3379	+	218	80142930	32431
chr9	80110499	80310499	harbor1	chr9	80181317	80182089	LTR/ERV1	4495	+	386	80181703	71204
chr9	2332356	2532356	harbor1	chr9	2349051	2349486	LTR/ERV1	2148	+	218	2349269	16913
chr9	2332356	2532356	harbor1	chr9	2406301	2407852	LTR/ERV1	5644	+	776	2407077	74721
chr9	103553360	103753360	harbor1	chr9	103586119	103587090	LTR/ERV1	4979	+	486	103586605	33245
chr9	103553360	103753360	harbor1	chr9	103598837	103599655	LTR/ERV1	4777	+	409	103599246	45886
chr9	103553360	103753360	harbor1	chr9	103601115	103601581	LTR/ERV1	2235	+	233	103601348	47988
chr9	103553360	103753360	harbor1	chr9	103635990	103636796	LTR/ERV1	3769	+	403	103636393	83033
chr9	1497790	1697790	harbor1	chr9	1503741	1504534	LTR/ERV1	4613	+	396	1504137	6347
chr9	1497790	1697790	harbor1	chr9	1520694	1521488	LTR/ERV1	4562	+	397	1521091	23301
chr9	1497790	1697790	harbor1	chr9	1524942	1525761	LTR/ERV1	2122	+	410	1525352	27562
chr9	3683116	3883116	harbor1	chr9	3733631	3734981	LTR/ERV1	9066	+	675	3734306	51190
chr9	3683116	3883116	harbor1	chr9	3749771	3750092	LTR/ERV1	2179	+	160	3749931	66815
chr9	3683116	3883116	harbor1	chr9	3757681	3758256	LTR/ERV1	2708	+	288	3757969	74853
chr9	89317707	89517707	harbor1	chr9	89398014	89398884	LTR/ERV1	4864	+	435	89398449	80742
chr9	28829925	29029925	harbor1	chr9	28895242	28895695	LTR/ERV1	2099	+	226	28895468	65543
chr9	28829925	29029925	harbor1	chr9	28915952	28916817	LTR/ERV1	4758	+	432	28916384	86459
chr9	135147248	135347248	harbor1	chr9	135172181	135172587	LTR/ERV1	2009	+	203	135172384	25136
chr9	135147248	135347248	harbor1	chr9	135209860	135210350	LTR/ERV1	556	+	245	135210105	62857
chr9	135147248	135347248	harbor1	chr9	135211265	135212318	LTR/ERV1	4346	+	526	135211791	64543
chr9	135147248	135347248	harbor1	chr9	135238074	135238520	LTR/ERV1	1295	+	223	135238297	91049
chr9	135147248	135347248	harbor1	chr9	135238793	135238836	LTR/ERV1	1295	+	22	135238815	91567
chr9	29831035	30031035	harbor1	chr9	29873535	29874244	LTR/ERV1	3310	+	354	29873889	42854
chr9	29831035	30031035	harbor1	chr9	29882939	29883195	LTR/ERV1	905	+	128	29883067	52032
chr9	29831035	30031035	harbor1	chr9	29898807	29899090	LTR/ERV1	898	+	142	29898949	67914
chr9	29831035	30031035	harbor1	chr9	29899653	29900160	LTR/ERV1	1178	+	254	29899907	68872
chr9	14132865	14332865	harbor1	chr9	14141814	14141902	LTR/ERV1	616	+	44	14141858	8993
chr9	40029931	40229931	harbor1	chr9	40033107	40033510	LTR/ERV1	1201	+	202	40033309	3378
chr9	40029931	40229931	harbor1	chr9	40056429	40056759	LTR/ERV1	526	+	165	40056594	26663
chr9	40029931	40229931	harbor1	chr9	40065271	40065649	LTR/ERV1	1117	+	189	40065460	35529
chr9	40029931	40229931	harbor1	chr9	40124652	40125241	LTR/ERV1	3246	+	294	40124946	95015
chr9	88967479	89167479	harbor1	chr9	89022386	89023013	LTR/ERV1	3368	+	314	89022700	55221
chr9	88967479	89167479	harbor1	chr9	89025486	89025961	LTR/ERV1	5605	+	238	89025724	58245
chr9	88967479	89167479	harbor1	chr9	89026283	89026691	LTR/ERV1	5605	+	204	89026487	59008
chr9	88967479	89167479	harbor1	chr9	89049622	89050017	LTR/ERV1	2861	+	198	89049820	82341
chr9	126284153	126484153	harbor1	chr9	126303897	126304056	LTR/ERV1	922	+	80	126303977	19824
chr9	10143963	10343963	harbor1	chr9	10238133	10238573	LTR/ERV1	2538	+	220	10238353	94390
chr9	10143963	10343963	harbor1	chr9	10239769	10240389	LTR/ERV1	2361	+	310	10240079	96116
chr9	120136111	120336111	harbor1	chr9	120202185	120202349	LTR/ERV1	1051	+	82	120202267	66156
chr9	120136111	120336111	harbor1	chr9	120202584	120202890	LTR/ERV1	1729	+	153	120202737	66626
chr9	80827037	81027037	harbor1	chr9	80885627	80886154	LTR/ERV1	3585	+	264	80885891	58854
chr9	9100607	9300607	harbor1	chr9	9196788	9197382	LTR/ERV1	2607	+	297	9197085	96478
chr9	82872493	83072493	harbor1	chr9	82883733	82884183	LTR/ERV1	3301	+	225	82883958	11465
chr9	82872493	83072493	harbor1	chr9	82887144	82887293	LTR/ERV1	992	+	74	82887218	14725
chr9	82872493	83072493	harbor1	chr9	82887284	82887787	LTR/ERV1	3241	+	252	82887536	15043
chr9	82872493	83072493	harbor1	chr9	82887790	82888447	LTR/ERV1	4230	+	328	82888118	15625
chr9	82872493	83072493	harbor1	chr9	82888449	82888664	LTR/ERV1	1297	+	108	82888557	16064
chr9	82872493	83072493	harbor1	chr9	82888665	82889040	LTR/ERV1	2377	+	188	82888853	16360
chr9	82872493	83072493	harbor1	chr9	82889041	82889489	LTR/ERV1	3455	+	224	82889265	16772
chr9	82872493	83072493	harbor1	chr9	82893579	82893841	LTR/ERV1	808	+	131	82893710	21217
chr9	82872493	83072493	harbor1	chr9	82884186	82887164	LTR/ERV1	19863	+	1489	82885675	13182
chr9	81299449	81499449	harbor1	chr9	81342484	81343050	LTR/ERV1	2651	+	283	81342767	43318
chr9	81299449	81499449	harbor1	chr9	81362157	81362626	LTR/ERV1	1971	+	234	81362391	62942
chr9	81299449	81499449	harbor1	chr9	81378741	81378768	LTR/ERV1	2377	+	14	81378755	79306
chr9	81299449	81499449	harbor1	chr9	81379084	81379618	LTR/ERV1	2377	+	267	81379351	79902
chr10	10162357	10362357	harbor1	chr10	10163730	10164368	LTR/ERV1	3746	+	319	10164049	1692
chr10	10162357	10362357	harbor1	chr10	10166541	10167036	LTR/ERV1	1907	+	248	10166789	4432
chr10	10162357	10362357	harbor1	chr10	10167832	10168106	LTR/ERV1	669	+	137	10167969	5612
chr10	10162357	10362357	harbor1	chr10	10200399	10200872	LTR/ERV1	933	+	236	10200635	38278
chr10	46426123	46626123	harbor1	chr10	46475761	46475779	LTR/ERV1	2774	+	9	46475770	49647
chr10	46426123	46626123	harbor1	chr10	46476083	46476476	LTR/ERV1	2774	+	196	46476279	50156
chr10	46426123	46626123	harbor1	chr10	46476477	46476882	LTR/ERV1	10461	+	202	46476679	50556
chr10	46426123	46626123	harbor1	chr10	46477189	46477295	LTR/ERV1	10461	+	53	46477242	51119
chr10	46426123	46626123	harbor1	chr10	46477599	46478641	LTR/ERV1	10461	+	521	46478120	51997
chr10	46426123	46626123	harbor1	chr10	46478636	46480346	LTR/ERV1	20142	+	855	46479491	53368
chr10	46426123	46626123	harbor1	chr10	46482029	46483388	LTR/ERV1	2129	+	680	46482709	56586
chr10	46426123	46626123	harbor1	chr10	46483516	46484867	LTR/ERV1	4905	+	676	46484192	58069
chr10	46426123	46626123	harbor1	chr10	46485290	46485539	LTR/ERV1	2381	+	124	46485414	59291
chr10	46426123	46626123	harbor1	chr10	46485868	46486448	LTR/ERV1	2381	+	290	46486158	60035
chr10	46426123	46626123	harbor1	chr10	46486507	46486946	LTR/ERV1	2234	+	220	46486727	60604
chr10	46426123	46626123	harbor1	chr10	46498445	46498994	LTR/ERV1	3764	+	274	46498719	72596
chr10	46426123	46626123	harbor1	chr10	46480652	46482033	LTR/ERV1	20142	+	690	46481342	55219
chr10	114102790	114302790	harbor1	chr10	114168465	114168860	LTR/ERV1	1454	+	198	114168663	65873
chr10	91668655	91868655	harbor1	chr10	91686955	91687400	LTR/ERV1	520	+	222	91687177	18522
chr10	91668655	91868655	harbor1	chr10	91728893	91729364	LTR/ERV1	4121	+	236	91729129	60474
chr10	91668655	91868655	harbor1	chr10	91729734	91729923	LTR/ERV1	4121	+	94	91729828	61173
chr10	100027665	100227665	harbor1	chr10	100028154	100028610	LTR/ERV1	2651	+	228	100028382	717
chr10	100027665	100227665	harbor1	chr10	100028617	100028906	LTR/ERV1	1952	+	144	100028761	1096
chr10	100027665	100227665	harbor1	chr10	100029208	100029232	LTR/ERV1	1952	+	12	100029220	1555
chr10	100027665	100227665	harbor1	chr10	100030667	100030795	LTR/ERV1	2103	+	64	100030731	3066
chr10	100027665	100227665	harbor1	chr10	100031112	100031369	LTR/ERV1	2103	+	128	100031240	3575
chr10	100027665	100227665	harbor1	chr10	100032135	100032465	LTR/ERV1	1875	+	165	100032300	4635
chr10	100027665	100227665	harbor1	chr10	100032500	100032873	LTR/ERV1	2153	+	186	100032686	5021
chr10	100027665	100227665	harbor1	chr10	100033668	100034487	LTR/ERV1	6451	+	410	100034078	6413
chr10	100027665	100227665	harbor1	chr10	100034758	100035134	LTR/ERV1	6451	+	188	100034946	7281
chr10	100027665	100227665	harbor1	chr10	100035145	100035236	LTR/ERV1	971	+	46	100035191	7526
chr10	100027665	100227665	harbor1	chr10	100035293	100035779	LTR/ERV1	2487	+	243	100035536	7871
chr10	100027665	100227665	harbor1	chr10	100036648	100037225	LTR/ERV1	3115	+	288	100036936	9271
chr10	100027665	100227665	harbor1	chr10	100037540	100037704	LTR/ERV1	3115	+	82	100037622	9957
chr10	100027665	100227665	harbor1	chr10	100047383	100047676	LTR/ERV1	1788	+	146	100047529	19864
chr10	100027665	100227665	harbor1	chr10	100111387	100111512	LTR/ERV1	3455	+	62	100111449	83784
chr10	100027665	100227665	harbor1	chr10	100111805	100112223	LTR/ERV1	3455	+	209	100112014	84349
chr10	55810898	56010898	harbor1	chr10	55813113	55814687	LTR/ERV1	6069	+	787	55813900	3002
chr10	55810898	56010898	harbor1	chr10	55822058	55822467	LTR/ERV1	1495	+	204	55822262	11364
chr10	55810898	56010898	harbor1	chr10	55822745	55822905	LTR/ERV1	1495	+	80	55822825	11927
chr10	55810898	56010898	harbor1	chr10	55823268	55823691	LTR/ERV1	2062	+	212	55823480	12582
chr10	55810898	56010898	harbor1	chr10	55848451	55848887	LTR/ERV1	2347	+	218	55848669	37771
chr10	55810898	56010898	harbor1	chr10	55910313	55910778	LTR/ERV1	522	+	232	55910545	99647
chr10	98403249	98603249	harbor1	chr10	98404053	98404453	LTR/ERV1	2733	+	200	98404253	1004
chr10	98403249	98603249	harbor1	chr10	98409044	98409561	LTR/ERV1	1493	+	258	98409302	6053
chr10	100039454	100239454	harbor1	chr10	100047383	100047676	LTR/ERV1	1788	+	146	100047529	8075
chr10	100039454	100239454	harbor1	chr10	100111387	100111512	LTR/ERV1	3455	+	62	100111449	71995
chr10	100039454	100239454	harbor1	chr10	100111805	100112223	LTR/ERV1	3455	+	209	100112014	72560
chr10	81140489	81340489	harbor1	chr10	81191959	81192071	LTR/ERV1	664	+	56	81192015	51526
chr10	81140489	81340489	harbor1	chr10	81192076	81192446	LTR/ERV1	1695	+	185	81192261	51772
chr10	81140489	81340489	harbor1	chr10	81192445	81193036	LTR/ERV1	3449	+	296	81192741	52252
chr10	81140489	81340489	harbor1	chr10	81193337	81193763	LTR/ERV1	3449	+	213	81193550	53061
chr10	81140489	81340489	harbor1	chr10	81195821	81196197	LTR/ERV1	1977	+	188	81196009	55520
chr10	81140489	81340489	harbor1	chr10	81196306	81196676	LTR/ERV1	2057	+	185	81196491	56002
chr10	81140489	81340489	harbor1	chr10	81196677	81196771	LTR/ERV1	4104	+	47	81196724	56235
chr10	81140489	81340489	harbor1	chr10	81196821	81197546	LTR/ERV1	4104	+	362	81197183	56694
chr10	124995949	125195949	harbor1	chr10	125008669	125009257	LTR/ERV1	4876	+	294	125008963	13014
chr10	33601166	33801166	harbor1	chr10	33600714	33601304	LTR/ERV1	5028	+	295	33601009	157
chr10	33601166	33801166	harbor1	chr10	33608731	33609278	LTR/ERV1	4347	+	274	33609005	7839
chr10	33601166	33801166	harbor1	chr10	33614892	33615192	LTR/ERV1	4387	+	150	33615042	13876
chr10	33601166	33801166	harbor1	chr10	33615968	33616403	LTR/ERV1	4387	+	218	33616186	15020
chr10	33601166	33801166	harbor1	chr10	33636987	33637412	LTR/ERV1	4469	+	212	33637199	36033
chr10	33601166	33801166	harbor1	chr10	33637701	33637944	LTR/ERV1	4469	+	122	33637823	36657
chr10	33601166	33801166	harbor1	chr10	33653265	33653707	LTR/ERV1	1996	+	221	33653486	52320
chr10	33601166	33801166	harbor1	chr10	33664403	33664828	LTR/ERV1	2275	+	212	33664615	63449
chr10	33601166	33801166	harbor1	chr10	33687892	33688388	LTR/ERV1	3432	+	248	33688140	86974
chr10	113654605	113854605	harbor1	chr10	113655916	113656541	LTR/ERV1	4423	+	312	113656228	1623
chr10	113654605	113854605	harbor1	chr10	113670425	113670739	LTR/ERV1	1674	+	157	113670582	15977
chr10	113654605	113854605	harbor1	chr10	113695513	113696146	LTR/ERV1	4521	+	316	113695829	41224
chr10	88994270	89194270	harbor1	chr10	89019954	89020609	LTR/ERV1	3419	+	328	89020282	26012
chr10	62186273	62386273	harbor1	chr10	62225016	62225541	LTR/ERV1	2275	+	262	62225278	39005
chr10	62186273	62386273	harbor1	chr10	62280194	62281803	LTR/ERV1	10258	+	804	62280998	94725
chr10	17443424	17643424	harbor1	chr10	17455192	17455525	LTR/ERV1	1214	+	166	17455358	11934
chr10	17443424	17643424	harbor1	chr10	17469673	17469914	LTR/ERV1	3360	+	120	17469793	26369
chr10	17443424	17643424	harbor1	chr10	17470199	17470243	LTR/ERV1	3360	+	22	17470221	26797
chr10	17443424	17643424	harbor1	chr10	17470605	17470879	LTR/ERV1	3360	+	137	17470742	27318
chr10	17443424	17643424	harbor1	chr10	17471184	17471285	LTR/ERV1	3360	+	50	17471234	27810
chr10	17443424	17643424	harbor1	chr10	17472540	17472600	LTR/ERV1	2482	+	30	17472570	29146
chr10	17443424	17643424	harbor1	chr10	17472894	17473347	LTR/ERV1	2482	+	226	17473120	29696
chr10	17443424	17643424	harbor1	chr10	17480586	17481011	LTR/ERV1	1363	+	212	17480798	37374
chr10	113443729	113643729	harbor1	chr10	113497616	113498050	LTR/ERV1	1146	+	217	113497833	54104
chr10	9597269	9797269	harbor1	chr10	9620719	9621201	LTR/ERV1	2854	+	241	9620960	23691
chr10	9597269	9797269	harbor1	chr10	9621255	9621407	LTR/ERV1	2854	+	76	9621331	24062
chr10	9597269	9797269	harbor1	chr10	9623883	9624432	LTR/ERV1	2845	+	274	9624157	26888
chr10	9597269	9797269	harbor1	chr10	9648974	9649462	LTR/ERV1	1158	+	244	9649218	51949
chr10	117399857	117599857	harbor1	chr10	117426343	117427009	LTR/ERV1	5264	+	333	117426676	26819
chr10	59736820	59936820	harbor1	chr10	59756009	59758474	LTR/ERV1	7035	+	1232	59757241	20421
chr10	59736820	59936820	harbor1	chr10	59759116	59759944	LTR/ERV1	7035	+	414	59759530	22710
chr10	59736820	59936820	harbor1	chr10	59760455	59760639	LTR/ERV1	7035	+	92	59760547	23727
chr10	59736820	59936820	harbor1	chr10	59761412	59761766	LTR/ERV1	1821	+	177	59761589	24769
chr10	59736820	59936820	harbor1	chr10	59761792	59761911	LTR/ERV1	496	+	60	59761852	25032
chr10	59736820	59936820	harbor1	chr10	59768033	59768132	LTR/ERV1	716	+	50	59768083	31263
chr10	59736820	59936820	harbor1	chr10	59822676	59823534	LTR/ERV1	4537	+	429	59823105	86285
chr10	26420839	26620839	harbor1	chr10	26423644	26424247	LTR/ERV1	4112	+	302	26423946	3107
chr10	26420839	26620839	harbor1	chr10	26424742	26425246	LTR/ERV1	3217	+	252	26424994	4155
chr10	26420839	26620839	harbor1	chr10	26434488	26435176	LTR/ERV1	4573	+	344	26434832	13993
chr10	80545960	80745960	harbor1	chr10	80585695	80587129	LTR/ERV1	10366	+	717	80586412	40452
chr10	88328642	88528642	harbor1	chr10	88366490	88367040	LTR/ERV1	1503	+	275	88366765	38123
chr10	88328642	88528642	harbor1	chr10	88378262	88378924	LTR/ERV1	3427	+	331	88378593	49951
chr10	75816889	76016889	harbor1	chr10	75881346	75881916	LTR/ERV1	3425	+	285	75881631	64742
chr10	16536708	16736708	harbor1	chr10	16549375	16549966	LTR/ERV1	1461	+	296	16549671	12963
chr10	16536708	16736708	harbor1	chr10	16550559	16550811	LTR/ERV1	1461	+	126	16550685	13977
chr10	5814276	6014276	harbor1	chr10	5863342	5863899	LTR/ERV1	3734	+	278	5863620	49344
chr10	5814276	6014276	harbor1	chr10	5865538	5867631	LTR/ERV1	10262	+	1046	5866584	52308
chr10	5814276	6014276	harbor1	chr10	5867630	5868407	LTR/ERV1	5981	+	388	5868018	53742
chr10	5814276	6014276	harbor1	chr10	5868408	5868938	LTR/ERV1	3468	+	265	5868673	54397
chr10	5814276	6014276	harbor1	chr10	5863908	5865537	LTR/ERV1	12794	+	814	5864722	50446
chr10	84080576	84280576	harbor1	chr10	84105940	84106054	LTR/ERV1	453	+	57	84105997	25421
chr10	84080576	84280576	harbor1	chr10	84108445	84108910	LTR/ERV1	3701	+	232	84108677	28101
chr10	84080576	84280576	harbor1	chr10	84116732	84117193	LTR/ERV1	3684	+	230	84116962	36386
chr10	84080576	84280576	harbor1	chr10	84117221	84117695	LTR/ERV1	3257	+	237	84117458	36882
chr10	84080576	84280576	harbor1	chr10	84162138	84162326	LTR/ERV1	3812	+	94	84162232	81656
chr10	84080576	84280576	harbor1	chr10	84162595	84162986	LTR/ERV1	3812	+	196	84162791	82215
chr10	84080576	84280576	harbor1	chr10	84163174	84163507	LTR/ERV1	2354	+	166	84163340	82764
chr10	84080576	84280576	harbor1	chr10	84163508	84163659	LTR/ERV1	1068	+	76	84163584	83008
chr10	84080576	84280576	harbor1	chr10	84108911	84116727	LTR/ERV1	52152	+	3908	84112819	32243
chr10	117391959	117591959	harbor1	chr10	117426343	117427009	LTR/ERV1	5264	+	333	117426676	34717
chr10	14752039	14952039	harbor1	chr10	14779116	14779192	LTR/ERV1	607	+	38	14779154	27115
chr10	14752039	14952039	harbor1	chr10	14812156	14812807	LTR/ERV1	4268	+	326	14812482	60443
chr10	14752039	14952039	harbor1	chr10	14815595	14815891	LTR/ERV1	2593	+	148	14815743	63704
chr10	14752039	14952039	harbor1	chr10	14816198	14816350	LTR/ERV1	2593	+	76	14816274	64235
chr10	1248159	1448159	harbor1	chr10	1288864	1289454	LTR/ERV1	3983	+	295	1289159	41000
chr10	77340129	77540129	harbor1	chr10	77372874	77373289	LTR/ERV1	1438	+	208	77373082	32953
chr10	77340129	77540129	harbor1	chr10	77430044	77430548	LTR/ERV1	1191	+	252	77430296	90167
chr10	106223783	106423783	harbor1	chr10	106267047	106267960	LTR/ERV1	4719	+	456	106267503	43720
chr10	106223783	106423783	harbor1	chr10	106267964	106268919	LTR/ERV1	9431	+	478	106268442	44659
chr10	106223783	106423783	harbor1	chr10	106269217	106274516	LTR/ERV1	33468	+	2650	106271867	48084
chr10	106223783	106423783	harbor1	chr10	106320116	106320317	LTR/ERV1	1029	+	100	106320216	96433
chr10	106223783	106423783	harbor1	chr10	106320302	106321239	LTR/ERV1	4447	+	468	106320770	96987
chr10	106223783	106423783	harbor1	chr10	106299081	106299483	LTR/ERV1	2132	+	201	106299282	75499
chr10	44101592	44301592	harbor1	chr10	44154116	44154414	LTR/ERV1	653	+	149	44154265	52673
chr10	20632342	20832342	harbor1	chr10	20639972	20640641	LTR/ERV1	3638	+	334	20640306	7964
chr10	90253430	90453430	harbor1	chr10	90294983	90295414	LTR/ERV1	2573	+	216	90295199	41769
chr10	90253430	90453430	harbor1	chr10	90295415	90298397	LTR/ERV1	19269	+	1491	90296906	43476
chr10	90253430	90453430	harbor1	chr10	90298392	90298539	LTR/ERV1	892	+	74	90298466	45036
chr10	90253430	90453430	harbor1	chr10	90298530	90299032	LTR/ERV1	3343	+	251	90298781	45351
chr10	90253430	90453430	harbor1	chr10	90299035	90299696	LTR/ERV1	4274	+	330	90299365	45935
chr10	90253430	90453430	harbor1	chr10	90299694	90299912	LTR/ERV1	1384	+	109	90299803	46373
chr10	90253430	90453430	harbor1	chr10	90299915	90300291	LTR/ERV1	2437	+	188	90300103	46673
chr10	90253430	90453430	harbor1	chr10	90300292	90300722	LTR/ERV1	2566	+	215	90300507	47077
chr10	90253430	90453430	harbor1	chr10	90303025	90303484	LTR/ERV1	2534	+	230	90303255	49825
chr10	95689335	95889335	harbor1	chr10	95710950	95711500	LTR/ERV1	2456	+	275	95711225	21890
chr10	95689335	95889335	harbor1	chr10	95711748	95711902	LTR/ERV1	2456	+	77	95711825	22490
chr10	95689335	95889335	harbor1	chr10	95711905	95712752	LTR/ERV1	3812	+	424	95712329	22994
chr10	95689335	95889335	harbor1	chr10	95713053	95713537	LTR/ERV1	3812	+	242	95713295	23960
chr10	91344346	91544346	harbor1	chr10	91344526	91344877	LTR/ERV1	1442	+	176	91344702	356
chr10	91344346	91544346	harbor1	chr10	91347042	91347423	LTR/ERV1	1030	+	190	91347232	2886
chr10	102842779	103042779	harbor1	chr10	102891979	102892687	LTR/ERV1	6098	+	354	102892333	49554
chr10	102842779	103042779	harbor1	chr10	102893091	102893313	LTR/ERV1	1417	+	111	102893202	50423
chr10	102842779	103042779	harbor1	chr10	102893934	102894143	LTR/ERV1	1140	+	104	102894038	51259
chr10	102842779	103042779	harbor1	chr10	102894456	102895059	LTR/ERV1	3315	+	302	102894758	51979
chr10	102842779	103042779	harbor1	chr10	102891360	102891666	LTR/ERV1	6098	+	153	102891513	48734
chr10	27444300	27644300	harbor1	chr10	27465310	27465760	LTR/ERV1	3332	+	225	27465535	21235
chr10	27444300	27644300	harbor1	chr10	27465763	27466234	LTR/ERV1	2768	+	236	27465999	21699
chr10	27444300	27644300	harbor1	chr10	27466293	27468007	LTR/ERV1	3648	+	857	27467150	22850
chr10	27444300	27644300	harbor1	chr10	27468005	27470486	LTR/ERV1	17400	+	1240	27469245	24945
chr10	27444300	27644300	harbor1	chr10	27470487	27470937	LTR/ERV1	3399	+	225	27470712	26412
chr10	27444300	27644300	harbor1	chr10	27495902	27496598	LTR/ERV1	4842	+	348	27496250	51950
chr10	97226320	97426320	harbor1	chr10	97290092	97290643	LTR/ERV1	3706	+	276	97290368	64048
chr10	97226320	97426320	harbor1	chr10	97290674	97290939	LTR/ERV1	2169	+	132	97290806	64486
chr10	97226320	97426320	harbor1	chr10	97290940	97291266	LTR/ERV1	2396	+	163	97291103	64783
chr10	114712314	114912314	harbor1	chr10	114723675	114724069	LTR/ERV1	1574	+	197	114723872	11558
chr10	47330122	47530122	harbor1	chr10	47345017	47345405	LTR/ERV1	1804	+	194	47345211	15089
chr10	85094795	85294795	harbor1	chr10	85141217	85142643	LTR/ERV1	10203	+	713	85141930	47135
chr10	85094795	85294795	harbor1	chr10	85149091	85149667	LTR/ERV1	3750	+	288	85149379	54584
chr10	85094795	85294795	harbor1	chr10	85153109	85153629	LTR/ERV1	1166	+	260	85153369	58574
chr10	85094795	85294795	harbor1	chr10	85153621	85154635	LTR/ERV1	7065	+	507	85154128	59333
chr10	85094795	85294795	harbor1	chr10	85154941	85155032	LTR/ERV1	7065	+	46	85154987	60192
chr10	85094795	85294795	harbor1	chr10	85155324	85156154	LTR/ERV1	7065	+	415	85155739	60944
chr10	85094795	85294795	harbor1	chr10	85157425	85158171	LTR/ERV1	7065	+	373	85157798	63003
chr10	85094795	85294795	harbor1	chr10	85158474	85159088	LTR/ERV1	7065	+	307	85158781	63986
chr10	85094795	85294795	harbor1	chr10	85159347	85159671	LTR/ERV1	1101	+	162	85159509	64714
chr10	85094795	85294795	harbor1	chr10	85159973	85160103	LTR/ERV1	1101	+	65	85160038	65243
chr10	62007144	62207144	harbor1	chr10	62022345	62022650	LTR/ERV1	1416	+	152	62022497	15353
chr10	536693	736693	harbor1	chr10	560702	561260	LTR/ERV1	2252	+	279	560981	24288
chr10	4510517	4710517	harbor1	chr10	4548828	4548913	LTR/ERV1	2277	+	42	4548870	38353
chr10	4510517	4710517	harbor1	chr10	4549226	4549645	LTR/ERV1	2277	+	210	4549436	38919
chr10	4510517	4710517	harbor1	chr10	4602566	4603474	LTR/ERV1	4950	+	454	4603020	92503
chr10	132277624	132477624	harbor1	chr10	132312665	132312757	LTR/ERV1	1708	+	46	132312711	35087
chr10	132277624	132477624	harbor1	chr10	132313068	132313324	LTR/ERV1	1708	+	128	132313196	35572
chr10	18380276	18580276	harbor1	chr10	18418435	18418756	LTR/ERV1	2262	+	160	18418595	38319
chr10	76755875	76955875	harbor1	chr10	76763351	76763628	LTR/ERV1	635	+	138	76763489	7614
chr10	76755875	76955875	harbor1	chr10	76792045	76792415	LTR/ERV1	884	+	185	76792230	36355
chr10	76755875	76955875	harbor1	chr10	76818221	76818660	LTR/ERV1	3522	+	220	76818441	62566
chr10	76755875	76955875	harbor1	chr10	76818711	76821994	LTR/ERV1	16034	+	1642	76820353	64478
chr10	76755875	76955875	harbor1	chr10	76821974	76822114	LTR/ERV1	782	+	70	76822044	66169
chr10	76755875	76955875	harbor1	chr10	76822121	76822263	LTR/ERV1	881	+	71	76822192	66317
chr10	76755875	76955875	harbor1	chr10	76822266	76822672	LTR/ERV1	2440	+	203	76822469	66594
chr10	76755875	76955875	harbor1	chr10	76822717	76822916	LTR/ERV1	1274	+	100	76822817	66942
chr10	76755875	76955875	harbor1	chr10	76822917	76823295	LTR/ERV1	2304	+	189	76823106	67231
chr10	76755875	76955875	harbor1	chr10	76823296	76823736	LTR/ERV1	3619	+	220	76823516	67641
chr10	133075670	133275670	harbor1	chr10	133151676	133152229	LTR/ERV1	1204	+	276	133151952	76282
chr10	18818088	19018088	harbor1	chr10	18887639	18888417	LTR/ERV1	4554	+	389	18888028	69940
chr10	54937281	55137281	harbor1	chr10	54957785	54958332	LTR/ERV1	2556	+	274	54958059	20778
chr10	54937281	55137281	harbor1	chr10	54961155	54962938	LTR/ERV1	5877	+	892	54962047	24766
chr10	54937281	55137281	harbor1	chr10	54977148	54977795	LTR/ERV1	3291	+	324	54977472	40191
chr10	54937281	55137281	harbor1	chr10	54978448	54978981	LTR/ERV1	2427	+	266	54978714	41433
chr10	54937281	55137281	harbor1	chr10	54984096	54984556	LTR/ERV1	1813	+	230	54984326	47045
chr10	54937281	55137281	harbor1	chr10	54984845	54985038	LTR/ERV1	1813	+	96	54984941	47660
chr10	54937281	55137281	harbor1	chr10	54995559	54996086	LTR/ERV1	2738	+	264	54995823	58542
chr10	54937281	55137281	harbor1	chr10	54996087	54996828	LTR/ERV1	9588	+	370	54996457	59176
chr10	54937281	55137281	harbor1	chr10	54997126	54998181	LTR/ERV1	9588	+	528	54997654	60373
chr10	54937281	55137281	harbor1	chr10	54998170	54998308	LTR/ERV1	697	+	69	54998239	60958
chr10	54937281	55137281	harbor1	chr10	54998502	54999530	LTR/ERV1	5879	+	514	54999016	61735
chr10	54937281	55137281	harbor1	chr10	54999531	54999676	LTR/ERV1	569	+	72	54999603	62322
chr10	54937281	55137281	harbor1	chr10	55001855	55002968	LTR/ERV1	3947	+	556	55002411	65130
chr10	54937281	55137281	harbor1	chr10	55002969	55004248	LTR/ERV1	7710	+	640	55003609	66328
chr10	54937281	55137281	harbor1	chr10	55004338	55004818	LTR/ERV1	2731	+	240	55004578	67297
chr10	54937281	55137281	harbor1	chr10	55020586	55021165	LTR/ERV1	2688	+	290	55020876	83595
chr10	54937281	55137281	harbor1	chr10	55000867	55001854	LTR/ERV1	4955	+	494	55001361	64080
chr10	24735189	24935189	harbor1	chr10	24737112	24737459	LTR/ERV1	1764	+	174	24737286	2097
chr10	24735189	24935189	harbor1	chr10	24813990	24814210	LTR/ERV1	2768	+	110	24814100	78911
chr10	24735189	24935189	harbor1	chr10	24814508	24814873	LTR/ERV1	2768	+	182	24814690	79501
chr10	33743943	33943943	harbor1	chr10	33771622	33772254	LTR/ERV1	4506	+	316	33771938	27995
chr10	33743943	33943943	harbor1	chr10	33773954	33774796	LTR/ERV1	4890	+	421	33774375	30432
chr10	33743943	33943943	harbor1	chr10	33797006	33797079	LTR/ERV1	1873	+	36	33797042	53099
chr10	33743943	33943943	harbor1	chr10	33797378	33797725	LTR/ERV1	1873	+	174	33797552	53609
chr10	33743943	33943943	harbor1	chr10	33798036	33798207	LTR/ERV1	1873	+	86	33798122	54179
chr10	33743943	33943943	harbor1	chr10	33822792	33823082	LTR/ERV1	3543	+	145	33822937	78994
chr10	33743943	33943943	harbor1	chr10	33823393	33823651	LTR/ERV1	3543	+	129	33823522	79579
chr10	33743943	33943943	harbor1	chr10	33829509	33829718	LTR/ERV1	901	+	104	33829613	85670
chr10	33743943	33943943	harbor1	chr10	33830898	33831123	LTR/ERV1	797	+	112	33831010	87067
chr10	33743943	33943943	harbor1	chr10	33837202	33837938	LTR/ERV1	3714	+	368	33837570	93627
chr10	93121417	93321417	harbor1	chr10	93127950	93128412	LTR/ERV1	3737	+	231	93128181	6764
chr10	93121417	93321417	harbor1	chr10	93144275	93144904	LTR/ERV1	3250	+	314	93144589	23172
chr10	5390021	5590021	harbor1	chr10	5391165	5391696	LTR/ERV1	3045	+	266	5391431	1410
chr10	5390021	5590021	harbor1	chr10	5425448	5425820	LTR/ERV1	1886	+	186	5425634	35613
chr10	5390021	5590021	harbor1	chr10	5457972	5458251	LTR/ERV1	897	+	140	5458112	68091
chr10	5390021	5590021	harbor1	chr10	5470768	5471177	LTR/ERV1	2808	+	204	5470972	80951
chr10	5390021	5590021	harbor1	chr10	5473093	5475360	LTR/ERV1	25266	+	1134	5474227	84206
chr10	5390021	5590021	harbor1	chr10	5475363	5476022	LTR/ERV1	4256	+	330	5475693	85672
chr10	5390021	5590021	harbor1	chr10	5476024	5476241	LTR/ERV1	1359	+	108	5476132	86111
chr10	5390021	5590021	harbor1	chr10	5476240	5476604	LTR/ERV1	2087	+	182	5476422	86401
chr10	5390021	5590021	harbor1	chr10	5476605	5477012	LTR/ERV1	2772	+	204	5476809	86788
chr10	5390021	5590021	harbor1	chr10	5471180	5472793	LTR/ERV1	25266	+	806	5471986	81965
chr10	72463387	72663387	harbor1	chr10	72541052	72541813	LTR/ERV1	4584	+	380	72541432	78045
chr10	72463387	72663387	harbor1	chr10	72543910	72544367	LTR/ERV1	3735	+	228	72544138	80751
chr10	72463387	72663387	harbor1	chr10	72546188	72546259	LTR/ERV1	438	+	36	72546224	82837
chr10	72463387	72663387	harbor1	chr10	72546260	72546629	LTR/ERV1	2084	+	184	72546444	83057
chr10	50423010	50623010	harbor1	chr10	50475131	50475447	LTR/ERV1	589	+	158	50475289	52279
chr10	50423010	50623010	harbor1	chr10	50492882	50493060	LTR/ERV1	871	+	89	50492971	69961
chr10	50423010	50623010	harbor1	chr10	50503342	50503701	LTR/ERV1	1962	+	180	50503522	80512
chr10	48543230	48743230	harbor1	chr10	48571949	48572830	LTR/ERV1	3978	+	440	48572389	29159
chr10	48543230	48743230	harbor1	chr10	48580962	48581419	LTR/ERV1	2703	+	228	48581190	37960
chr10	120014118	120214118	harbor1	chr10	120024816	120025360	LTR/ERV1	1796	+	272	120025088	10970
chr10	120014118	120214118	harbor1	chr10	120033079	120033294	LTR/ERV1	835	+	108	120033187	19069
chr10	120014118	120214118	harbor1	chr10	120033592	120033803	LTR/ERV1	936	+	106	120033698	19580
chr10	120014118	120214118	harbor1	chr10	120054196	120054548	LTR/ERV1	1101	+	176	120054372	40254
chr10	120014118	120214118	harbor1	chr10	120054804	120054840	LTR/ERV1	1101	+	18	120054822	40704
chr10	120014118	120214118	harbor1	chr10	120055687	120056026	LTR/ERV1	1188	+	170	120055857	41739
chr10	120014118	120214118	harbor1	chr10	120058351	120058567	LTR/ERV1	836	+	108	120058459	44341
chr10	120014118	120214118	harbor1	chr10	120061331	120061896	LTR/ERV1	2314	+	282	120061613	47495
chr10	120014118	120214118	harbor1	chr10	120071456	120071741	LTR/ERV1	2774	+	142	120071598	57480
chr10	120014118	120214118	harbor1	chr10	120072143	120072362	LTR/ERV1	2774	+	110	120072253	58135
chr10	120014118	120214118	harbor1	chr10	120107168	120107488	LTR/ERV1	3444	+	160	120107328	93210
chr10	120014118	120214118	harbor1	chr10	120107932	120108214	LTR/ERV1	3444	+	141	120108073	93955
chr10	74774083	74974083	harbor1	chr10	74775646	74775698	LTR/ERV1	2236	+	26	74775672	1589
chr10	74774083	74974083	harbor1	chr10	74775998	74776258	LTR/ERV1	2236	+	130	74776128	2045
chr10	74774083	74974083	harbor1	chr10	74776832	74777349	LTR/ERV1	9158	+	258	74777090	3007
chr10	74774083	74974083	harbor1	chr10	74777652	74778494	LTR/ERV1	16240	+	421	74778073	3990
chr10	74774083	74974083	harbor1	chr10	74779115	74779872	LTR/ERV1	16240	+	378	74779493	5410
chr10	74774083	74974083	harbor1	chr10	74780179	74780434	LTR/ERV1	16240	+	128	74780307	6224
chr10	74774083	74974083	harbor1	chr10	74780430	74780484	LTR/ERV1	1725	+	27	74780457	6374
chr10	74774083	74974083	harbor1	chr10	74780794	74780980	LTR/ERV1	1725	+	93	74780887	6804
chr10	74774083	74974083	harbor1	chr10	74780985	74781745	LTR/ERV1	8403	+	380	74781365	7282
chr10	74774083	74974083	harbor1	chr10	74782050	74782401	LTR/ERV1	8403	+	176	74782226	8143
chr10	74774083	74974083	harbor1	chr10	74782394	74782602	LTR/ERV1	1463	+	104	74782498	8415
chr10	74774083	74974083	harbor1	chr10	74782603	74783112	LTR/ERV1	4023	+	254	74782857	8774
chr10	74774083	74974083	harbor1	chr10	74776344	74776836	LTR/ERV1	3674	+	246	74776590	2507
chr10	126910105	127110105	harbor1	chr10	126951702	126951852	LTR/ERV1	837	+	75	126951777	41672
chr10	126910105	127110105	harbor1	chr10	126952148	126952189	LTR/ERV1	837	+	20	126952168	42063
chr10	72521546	72721546	harbor1	chr10	72541052	72541813	LTR/ERV1	4584	+	380	72541432	19886
chr10	72521546	72721546	harbor1	chr10	72543910	72544367	LTR/ERV1	3735	+	228	72544138	22592
chr10	72521546	72721546	harbor1	chr10	72546188	72546259	LTR/ERV1	438	+	36	72546224	24678
chr10	72521546	72721546	harbor1	chr10	72546260	72546629	LTR/ERV1	2084	+	184	72546444	24898
chr10	72521546	72721546	harbor1	chr10	72605050	72605577	LTR/ERV1	2676	+	264	72605314	83768
chr10	72521546	72721546	harbor1	chr10	72608675	72609031	LTR/ERV1	1746	+	178	72608853	87307
chr10	27345177	27545177	harbor1	chr10	27405919	27406238	LTR/ERV1	762	+	160	27406079	60902
chr10	112334921	112534921	harbor1	chr10	112349574	112350869	LTR/ERV1	4233	+	648	112350222	15301
chr10	112334921	112534921	harbor1	chr10	112369605	112370127	LTR/ERV1	7072	+	261	112369866	34945
chr10	112334921	112534921	harbor1	chr10	112370128	112371581	LTR/ERV1	10589	+	726	112370854	35933
chr10	112334921	112534921	harbor1	chr10	112371582	112372669	LTR/ERV1	7072	+	544	112372126	37205
chr10	57342966	57542966	harbor1	chr10	57343698	57344377	LTR/ERV1	4999	+	340	57344038	1072
chr10	62567016	62767016	harbor1	chr10	62657317	62658890	LTR/ERV1	7378	+	786	62658103	91087
chr10	73603002	73803002	harbor1	chr10	73672115	73672299	LTR/ERV1	854	+	92	73672207	69205
chr10	73603002	73803002	harbor1	chr10	73672313	73672451	LTR/ERV1	456	+	69	73672382	69380
chr10	127331303	127531303	harbor1	chr10	127400706	127401259	LTR/ERV1	1371	+	276	127400982	69679
chr10	127331303	127531303	harbor1	chr10	127401833	127401906	LTR/ERV1	469	+	36	127401869	70566
chr10	28676298	28876298	harbor1	chr10	28737037	28737477	LTR/ERV1	2981	+	220	28737257	60959
chr10	28676298	28876298	harbor1	chr10	28739303	28739732	LTR/ERV1	3027	+	214	28739517	63219
chr10	28676298	28876298	harbor1	chr10	28744390	28744943	LTR/ERV1	2498	+	276	28744666	68368
chr10	37525092	37725092	harbor1	chr10	37546475	37546704	LTR/ERV1	456	+	114	37546589	21497
chr10	37525092	37725092	harbor1	chr10	37550222	37550775	LTR/ERV1	3935	+	276	37550498	25406
chr10	47883300	48083300	harbor1	chr10	47896072	47896561	LTR/ERV1	2185	+	244	47896316	13016
chr10	47883300	48083300	harbor1	chr10	47963606	47964207	LTR/ERV1	4691	+	300	47963906	80606
chr10	751017	951017	harbor1	chr10	795144	795599	LTR/ERV1	3257	+	228	795372	44355
chr10	132866766	133066766	harbor1	chr10	132886660	132886944	LTR/ERV1	714	+	142	132886802	20036
chr10	132866766	133066766	harbor1	chr10	132888070	132888197	LTR/ERV1	538	+	64	132888134	21368
chr10	132866766	133066766	harbor1	chr10	132890320	132890554	LTR/ERV1	682	+	117	132890437	23671
chr10	132866766	133066766	harbor1	chr10	132891218	132892094	LTR/ERV1	5038	+	438	132891656	24890
chr10	132866766	133066766	harbor1	chr10	132892488	132892809	LTR/ERV1	1198	+	160	132892648	25882
chr10	132866766	133066766	harbor1	chr10	132892850	132893316	LTR/ERV1	3671	+	233	132893083	26317
chr10	132866766	133066766	harbor1	chr10	132893317	132893661	LTR/ERV1	2315	+	172	132893489	26723
chr10	132866766	133066766	harbor1	chr10	132893662	132893895	LTR/ERV1	3671	+	116	132893778	27012
chr10	132866766	133066766	harbor1	chr10	132956799	132956986	LTR/ERV1	2192	+	94	132956893	90127
chr10	132866766	133066766	harbor1	chr10	132962191	132962659	LTR/ERV1	2173	+	234	132962425	95659
chr10	132866766	133066766	harbor1	chr10	132890600	132890765	LTR/ERV1	733	+	82	132890682	23916
chr10	132866766	133066766	harbor1	chr10	132955898	132956444	LTR/ERV1	2192	+	273	132956171	89405
chr10	113263436	113463436	harbor1	chr10	113300654	113300998	LTR/ERV1	2171	+	172	113300826	37390
chr10	113263436	113463436	harbor1	chr10	113301311	113301328	LTR/ERV1	2171	+	8	113301319	37883
chr10	105525507	105725507	harbor1	chr10	105568542	105569048	LTR/ERV1	2776	+	253	105568795	43288
chr10	105525507	105725507	harbor1	chr10	105608048	105608479	LTR/ERV1	1845	+	216	105608264	82757
chr10	92566068	92766068	harbor1	chr10	92591083	92591570	LTR/ERV1	3524	+	244	92591327	25259
chr10	127801242	128001242	harbor1	chr10	127808521	127809104	LTR/ERV1	2647	+	292	127808813	7571
chr10	127801242	128001242	harbor1	chr10	127820667	127821064	LTR/ERV1	1077	+	198	127820865	19623
chr10	127801242	128001242	harbor1	chr10	127822208	127822926	LTR/ERV1	3640	+	359	127822567	21325
chr10	127801242	128001242	harbor1	chr10	127824202	127824295	LTR/ERV1	496	+	46	127824248	23006
chr10	127801242	128001242	harbor1	chr10	127824920	127825005	LTR/ERV1	496	+	42	127824962	23720
chr10	127801242	128001242	harbor1	chr10	127825004	127825103	LTR/ERV1	566	+	50	127825054	23812
chr10	127801242	128001242	harbor1	chr10	127825432	127825691	LTR/ERV1	1271	+	130	127825562	24320
chr10	127801242	128001242	harbor1	chr10	127832422	127832851	LTR/ERV1	2131	+	214	127832636	31394
chr10	127801242	128001242	harbor1	chr10	127863225	127863702	LTR/ERV1	1663	+	238	127863463	62221
chr10	127801242	128001242	harbor1	chr10	127863968	127864547	LTR/ERV1	2441	+	290	127864258	63016
chr10	84880834	85080834	harbor1	chr10	84943105	84943650	LTR/ERV1	3168	+	272	84943377	62543
chr10	84880834	85080834	harbor1	chr10	84959507	84960103	LTR/ERV1	3138	+	298	84959805	78971
chr10	120030496	120230496	harbor1	chr10	120033079	120033294	LTR/ERV1	835	+	108	120033187	2691
chr10	120030496	120230496	harbor1	chr10	120033592	120033803	LTR/ERV1	936	+	106	120033698	3202
chr10	120030496	120230496	harbor1	chr10	120054196	120054548	LTR/ERV1	1101	+	176	120054372	23876
chr10	120030496	120230496	harbor1	chr10	120054804	120054840	LTR/ERV1	1101	+	18	120054822	24326
chr10	120030496	120230496	harbor1	chr10	120055687	120056026	LTR/ERV1	1188	+	170	120055857	25361
chr10	120030496	120230496	harbor1	chr10	120058351	120058567	LTR/ERV1	836	+	108	120058459	27963
chr10	120030496	120230496	harbor1	chr10	120061331	120061896	LTR/ERV1	2314	+	282	120061613	31117
chr10	120030496	120230496	harbor1	chr10	120071456	120071741	LTR/ERV1	2774	+	142	120071598	41102
chr10	120030496	120230496	harbor1	chr10	120072143	120072362	LTR/ERV1	2774	+	110	120072253	41757
chr10	120030496	120230496	harbor1	chr10	120107168	120107488	LTR/ERV1	3444	+	160	120107328	76832
chr10	120030496	120230496	harbor1	chr10	120107932	120108214	LTR/ERV1	3444	+	141	120108073	77577
chr10	63036774	63236774	harbor1	chr10	63080036	63080146	LTR/ERV1	505	+	55	63080091	43317
chr10	63036774	63236774	harbor1	chr10	63101044	63101573	LTR/ERV1	3442	+	264	63101308	64534
chr10	63036774	63236774	harbor1	chr10	63105964	63106656	LTR/ERV1	5387	+	346	63106310	69536
chr10	63036774	63236774	harbor1	chr10	63108033	63108420	LTR/ERV1	3527	+	194	63108227	71453
chr10	63036774	63236774	harbor1	chr10	63108734	63109094	LTR/ERV1	3527	+	180	63108914	72140
chr10	63036774	63236774	harbor1	chr10	63125506	63125919	LTR/ERV1	2248	+	206	63125712	88938
chr10	63036774	63236774	harbor1	chr10	63127771	63127886	LTR/ERV1	1130	+	58	63127829	91055
chr10	63036774	63236774	harbor1	chr10	63128185	63128225	LTR/ERV1	1130	+	20	63128205	91431
chr10	63036774	63236774	harbor1	chr10	63128524	63128752	LTR/ERV1	1130	+	114	63128638	91864
chr10	99362546	99562546	harbor1	chr10	99399024	99399488	LTR/ERV1	3065	+	232	99399256	36710
chr10	99362546	99562546	harbor1	chr10	99399790	99399884	LTR/ERV1	3065	+	47	99399837	37291
chr10	126713630	126913630	harbor1	chr10	126715635	126716310	LTR/ERV1	4533	+	338	126715973	2343
chr10	126713630	126913630	harbor1	chr10	126758082	126758625	LTR/ERV1	2763	+	272	126758354	44724
chr10	126713630	126913630	harbor1	chr10	126776350	126776638	LTR/ERV1	568	+	144	126776494	62864
chr10	126713630	126913630	harbor1	chr10	126799106	126799683	LTR/ERV1	1666	+	288	126799394	85764
chr10	62294258	62494258	harbor1	chr10	62302610	62303192	LTR/ERV1	1417	+	291	62302901	8643
chr10	62294258	62494258	harbor1	chr10	62336582	62336888	LTR/ERV1	1730	+	153	62336735	42477
chr10	62294258	62494258	harbor1	chr10	62338168	62338926	LTR/ERV1	4946	+	379	62338547	44289
chr10	124872982	125072982	harbor1	chr10	124881246	124881496	LTR/ERV1	1791	+	125	124881371	8389
chr10	124872982	125072982	harbor1	chr10	124881479	124881591	LTR/ERV1	777	+	56	124881535	8553
chr10	124872982	125072982	harbor1	chr10	124882229	124882590	LTR/ERV1	2547	+	180	124882409	9427
chr10	25852535	26052535	harbor1	chr10	25898083	25898760	LTR/ERV1	3042	+	338	25898421	45886
chr10	25852535	26052535	harbor1	chr10	25900837	25901326	LTR/ERV1	1133	+	244	25901081	48546
chr10	25852535	26052535	harbor1	chr10	25916171	25916649	LTR/ERV1	3497	+	239	25916410	63875
chr10	25852535	26052535	harbor1	chr10	25931149	25931643	LTR/ERV1	1681	+	247	25931396	78861
chr10	72584277	72784277	harbor1	chr10	72605050	72605577	LTR/ERV1	2676	+	264	72605314	21037
chr10	72584277	72784277	harbor1	chr10	72608675	72609031	LTR/ERV1	1746	+	178	72608853	24576
chr10	72584277	72784277	harbor1	chr10	72641050	72641076	LTR/ERV1	658	+	13	72641063	56786
chr10	72584277	72784277	harbor1	chr10	72641378	72642493	LTR/ERV1	738	+	558	72641936	57659
chr10	72584277	72784277	harbor1	chr10	72643799	72643937	LTR/ERV1	433	+	69	72643868	59591
chr10	72584277	72784277	harbor1	chr10	72644264	72644318	LTR/ERV1	433	+	27	72644291	60014
chr10	72584277	72784277	harbor1	chr10	72644711	72645069	LTR/ERV1	450	+	179	72644890	60613
chr10	72584277	72784277	harbor1	chr10	72645074	72645306	LTR/ERV1	1081	+	116	72645190	60913
chr10	72584277	72784277	harbor1	chr10	72645897	72646065	LTR/ERV1	721	+	84	72645981	61704
chr10	46154905	46354905	harbor1	chr10	46159865	46160792	LTR/ERV1	10771	+	464	46160329	5424
chr10	46154905	46354905	harbor1	chr10	46161096	46161849	LTR/ERV1	10771	+	376	46161472	6567
chr10	46154905	46354905	harbor1	chr10	46161850	46162220	LTR/ERV1	1903	+	185	46162035	7130
chr10	46154905	46354905	harbor1	chr10	46208910	46209354	LTR/ERV1	3126	+	222	46209132	54227
chr10	46154905	46354905	harbor1	chr10	46209358	46209705	LTR/ERV1	2361	+	174	46209532	54627
chr10	46154905	46354905	harbor1	chr10	46209706	46210163	LTR/ERV1	3569	+	228	46209934	55029
chr10	46154905	46354905	harbor1	chr10	46210164	46210856	LTR/ERV1	4525	+	346	46210510	55605
chr10	46154905	46354905	harbor1	chr10	46210916	46211528	LTR/ERV1	4525	+	306	46211222	56317
chr10	46154905	46354905	harbor1	chr10	46211834	46211877	LTR/ERV1	4525	+	22	46211856	56951
chr10	46154905	46354905	harbor1	chr10	46239260	46239670	LTR/ERV1	1457	+	205	46239465	84560
chr10	37665276	37865276	harbor1	chr10	37667779	37668127	LTR/ERV1	1487	+	174	37667953	2677
chr10	37665276	37865276	harbor1	chr10	37731177	37731439	LTR/ERV1	1441	+	131	37731308	66032
chr10	37665276	37865276	harbor1	chr10	37731439	37732309	LTR/ERV1	2852	+	435	37731874	66598
chr10	37665276	37865276	harbor1	chr10	37737202	37738714	LTR/ERV1	9943	+	756	37737958	72682
chr11	14344595	14544595	harbor1	chr11	14385072	14385498	LTR/ERV1	2659	+	213	14385285	40690
chr11	125420387	125620387	harbor1	chr11	125458513	125458786	LTR/ERV1	728	+	136	125458649	38262
chr11	125420387	125620387	harbor1	chr11	125459096	125459165	LTR/ERV1	728	+	34	125459130	38743
chr11	125420387	125620387	harbor1	chr11	125459173	125459309	LTR/ERV1	929	+	68	125459241	38854
chr11	125420387	125620387	harbor1	chr11	125459617	125459708	LTR/ERV1	929	+	46	125459663	39276
chr11	125420387	125620387	harbor1	chr11	125506295	125506736	LTR/ERV1	2875	+	220	125506515	86128
chr11	125420387	125620387	harbor1	chr11	125507045	125507075	LTR/ERV1	2875	+	15	125507060	86673
chr11	125420387	125620387	harbor1	chr11	125511868	125511948	LTR/ERV1	467	+	40	125511908	91521
chr11	125420387	125620387	harbor1	chr11	125511949	125512392	LTR/ERV1	2031	+	222	125512171	91784
chr11	125420387	125620387	harbor1	chr11	125512599	125512661	LTR/ERV1	1913	+	31	125512630	92243
chr11	125420387	125620387	harbor1	chr11	125512970	125513374	LTR/ERV1	1913	+	202	125513172	92785
chr11	125420387	125620387	harbor1	chr11	125513688	125513892	LTR/ERV1	1913	+	102	125513790	93403
chr11	125420387	125620387	harbor1	chr11	125519621	125520337	LTR/ERV1	4258	+	358	125519979	99592
chr11	8731299	8931299	harbor1	chr11	8750936	8751718	LTR/ERV1	5673	+	391	8751327	20028
chr11	82927284	83127284	harbor1	chr11	82970492	82971932	LTR/ERV1	8381	+	720	82971212	43928
chr11	82927284	83127284	harbor1	chr11	83019935	83021782	LTR/ERV1	7257	+	924	83020859	93575
chr11	40312057	40512057	harbor1	chr11	40360573	40360689	LTR/ERV1	532	+	58	40360631	48574
chr11	40312057	40512057	harbor1	chr11	40363708	40364006	LTR/ERV1	1582	+	149	40363857	51800
chr11	7599749	7799749	harbor1	chr11	7675979	7676339	LTR/ERV1	2052	+	180	7676159	76410
chr11	46536539	46736539	harbor1	chr11	46566679	46566927	LTR/ERV1	1571	+	124	46566803	30264
chr11	46536539	46736539	harbor1	chr11	46567661	46567863	LTR/ERV1	753	+	101	46567762	31223
chr11	93458650	93658650	harbor1	chr11	93466692	93467444	LTR/ERV1	3311	+	376	93467068	8418
chr11	93458650	93658650	harbor1	chr11	93531726	93532173	LTR/ERV1	3076	+	224	93531950	73300
chr11	95474112	95674112	harbor1	chr11	95569064	95569427	LTR/ERV1	1290	+	182	95569246	95134
chr11	11241036	11441036	harbor1	chr11	11253306	11253644	LTR/ERV1	685	+	169	11253475	12439
chr11	11241036	11441036	harbor1	chr11	11253725	11254080	LTR/ERV1	914	+	178	11253903	12867
chr11	11241036	11441036	harbor1	chr11	11318728	11319094	LTR/ERV1	1381	+	183	11318911	77875
chr11	99627574	99827574	harbor1	chr11	99674576	99675012	LTR/ERV1	2407	+	218	99674794	47220
chr11	20530905	20730905	harbor1	chr11	20567875	20568314	LTR/ERV1	3767	+	220	20568095	37190
chr11	20530905	20730905	harbor1	chr11	20568316	20571208	LTR/ERV1	16959	+	1446	20569762	38857
chr11	20530905	20730905	harbor1	chr11	20571188	20571337	LTR/ERV1	992	+	74	20571262	40357
chr11	20530905	20730905	harbor1	chr11	20571328	20571767	LTR/ERV1	3079	+	220	20571548	40643
chr11	20530905	20730905	harbor1	chr11	20571774	20571836	LTR/ERV1	422	+	31	20571805	40900
chr11	20530905	20730905	harbor1	chr11	20571837	20572214	LTR/ERV1	2463	+	188	20572025	41120
chr11	20530905	20730905	harbor1	chr11	20572215	20572655	LTR/ERV1	3811	+	220	20572435	41530
chr11	20530905	20730905	harbor1	chr11	20611482	20611670	LTR/ERV1	2684	+	94	20611576	80671
chr11	20530905	20730905	harbor1	chr11	20611945	20612031	LTR/ERV1	473	+	43	20611988	81083
chr11	20530905	20730905	harbor1	chr11	20610921	20611180	LTR/ERV1	2678	+	130	20611051	80146
chr11	96663549	96863549	harbor1	chr11	96746481	96747252	LTR/ERV1	4822	+	386	96746867	83318
chr11	122497329	122697329	harbor1	chr11	122518376	122518835	LTR/ERV1	3854	+	230	122518606	21277
chr11	122497329	122697329	harbor1	chr11	122546527	122547025	LTR/ERV1	3275	+	249	122546776	49447
chr11	122497329	122697329	harbor1	chr11	122555154	122555602	LTR/ERV1	3630	+	224	122555378	58049
chr11	122497329	122697329	harbor1	chr11	122556641	122557789	LTR/ERV1	7088	+	574	122557215	59886
chr11	122497329	122697329	harbor1	chr11	122579996	122580501	LTR/ERV1	3972	+	252	122580248	82919
chr11	122497329	122697329	harbor1	chr11	122547028	122555153	LTR/ERV1	29824	+	4062	122551090	53761
chr11	39682468	39882468	harbor1	chr11	39728780	39729360	LTR/ERV1	3210	+	290	39729070	46602
chr11	39682468	39882468	harbor1	chr11	39732539	39733146	LTR/ERV1	2831	+	304	39732843	50375
chr11	39682468	39882468	harbor1	chr11	39734126	39734557	LTR/ERV1	3391	+	216	39734342	51874
chr11	39682468	39882468	harbor1	chr11	39734558	39739803	LTR/ERV1	15405	+	2622	39737180	54712
chr11	39682468	39882468	harbor1	chr11	39739801	39740067	LTR/ERV1	1460	+	133	39739934	57466
chr11	39682468	39882468	harbor1	chr11	39740061	39740631	LTR/ERV1	3525	+	285	39740346	57878
chr11	39682468	39882468	harbor1	chr11	39740632	39741063	LTR/ERV1	3303	+	216	39740848	58380
chr11	23675695	23875695	harbor1	chr11	23692159	23692318	LTR/ERV1	831	+	80	23692239	16544
chr11	23675695	23875695	harbor1	chr11	23692406	23692775	LTR/ERV1	1234	+	184	23692590	16895
chr11	23675695	23875695	harbor1	chr11	23764805	23765716	LTR/ERV1	4027	+	456	23765261	89566
chr11	81704916	81904916	harbor1	chr11	81769942	81770404	LTR/ERV1	3172	+	231	81770173	65257
chr11	81704916	81904916	harbor1	chr11	81770439	81770880	LTR/ERV1	1712	+	220	81770659	65743
chr11	81704916	81904916	harbor1	chr11	81802232	81802643	LTR/ERV1	2585	+	206	81802438	97522
chr11	81704916	81904916	harbor1	chr11	81804714	81804951	LTR/ERV1	1094	+	118	81804832	99916
chr11	104346183	104546183	harbor1	chr11	104398531	104399092	LTR/ERV1	3088	+	280	104398811	52628
chr11	58105506	58305506	harbor1	chr11	58204393	58205238	LTR/ERV1	555	+	422	58204815	99309
chr11	107394482	107594482	harbor1	chr11	107475138	107475889	LTR/ERV1	5779	+	376	107475514	81032
chr11	30576231	30776231	harbor1	chr11	30639955	30640498	LTR/ERV1	3808	+	272	30640227	63996
chr11	30576231	30776231	harbor1	chr11	30640499	30641296	LTR/ERV1	4141	+	398	30640897	64666
chr11	30576231	30776231	harbor1	chr11	30641272	30641941	LTR/ERV1	2572	+	334	30641606	65375
chr11	30576231	30776231	harbor1	chr11	30642249	30642603	LTR/ERV1	2572	+	177	30642426	66195
chr11	30576231	30776231	harbor1	chr11	30642598	30644796	LTR/ERV1	7386	+	1099	30643697	67466
chr11	30576231	30776231	harbor1	chr11	30644921	30645349	LTR/ERV1	3142	+	214	30645135	68904
chr11	114355628	114555628	harbor1	chr11	114362239	114362502	LTR/ERV1	1208	+	132	114362371	6743
chr11	114355628	114555628	harbor1	chr11	114362655	114362974	LTR/ERV1	1426	+	160	114362815	7187
chr11	114355628	114555628	harbor1	chr11	114438321	114438902	LTR/ERV1	3651	+	290	114438611	82983
chr11	114355628	114555628	harbor1	chr11	114376599	114376994	LTR/ERV1	1555	+	198	114376797	21169
chr11	30278673	30478673	harbor1	chr11	30307090	30307581	LTR/ERV1	1350	+	246	30307336	28663
chr11	55702672	55902672	harbor1	chr11	55798425	55798558	LTR/ERV1	461	+	66	55798491	95819
chr11	76821425	77021425	harbor1	chr11	76825703	76826412	LTR/ERV1	3998	+	354	76826057	4632
chr11	76821425	77021425	harbor1	chr11	76843362	76843487	LTR/ERV1	604	+	62	76843424	21999
chr11	76821425	77021425	harbor1	chr11	76843507	76843831	LTR/ERV1	2256	+	162	76843669	22244
chr11	76821425	77021425	harbor1	chr11	76843837	76844457	LTR/ERV1	3987	+	310	76844147	22722
chr11	76821425	77021425	harbor1	chr11	76903457	76903988	LTR/ERV1	4778	+	266	76903723	82298
chr11	76821425	77021425	harbor1	chr11	76904297	76904635	LTR/ERV1	4778	+	169	76904466	83041
chr11	76821425	77021425	harbor1	chr11	76905982	76906696	LTR/ERV1	4135	+	357	76906339	84914
chr11	123084950	123284950	harbor1	chr11	123085095	123085242	LTR/ERV1	500	+	74	123085169	219
chr11	123084950	123284950	harbor1	chr11	123085549	123085743	LTR/ERV1	500	+	97	123085646	696
chr11	123084950	123284950	harbor1	chr11	123101610	123101901	LTR/ERV1	1829	+	146	123101756	16806
chr11	123084950	123284950	harbor1	chr11	123102197	123102279	LTR/ERV1	1829	+	41	123102238	17288
chr11	123084950	123284950	harbor1	chr11	123106260	123106357	LTR/ERV1	631	+	48	123106308	21358
chr11	123084950	123284950	harbor1	chr11	123133246	123133596	LTR/ERV1	1134	+	175	123133421	48471
chr11	123084950	123284950	harbor1	chr11	123133600	123133985	LTR/ERV1	1026	+	192	123133792	48842
chr11	123084950	123284950	harbor1	chr11	123134271	123134363	LTR/ERV1	1026	+	46	123134317	49367
chr11	89310322	89510322	harbor1	chr11	89381304	89381670	LTR/ERV1	1912	+	183	89381487	71165
chr11	89310322	89510322	harbor1	chr11	89381673	89384408	LTR/ERV1	13791	+	1368	89383041	72719
chr11	89310322	89510322	harbor1	chr11	89384388	89384836	LTR/ERV1	2802	+	224	89384612	74290
chr11	89310322	89510322	harbor1	chr11	89384831	89386231	LTR/ERV1	7642	+	700	89385531	75209
chr11	89310322	89510322	harbor1	chr11	89386223	89386643	LTR/ERV1	2233	+	210	89386433	76111
chr11	89310322	89510322	harbor1	chr11	89386637	89387192	LTR/ERV1	3852	+	278	89386915	76593
chr11	89310322	89510322	harbor1	chr11	89387193	89387559	LTR/ERV1	2188	+	183	89387376	77054
chr11	14353441	14553441	harbor1	chr11	14385072	14385498	LTR/ERV1	2659	+	213	14385285	31844
chr11	86851045	87051045	harbor1	chr11	86850419	86851050	LTR/ERV1	4373	+	316	86850735	310
chr11	86851045	87051045	harbor1	chr11	86937365	86937900	LTR/ERV1	4277	+	268	86937633	86588
chr11	130235908	130435908	harbor1	chr11	130246784	130247259	LTR/ERV1	1181	+	238	130247022	11114
chr11	130235908	130435908	harbor1	chr11	130308874	130309308	LTR/ERV1	2856	+	217	130309091	73183
chr11	108876011	109076011	harbor1	chr11	108912609	108912981	LTR/ERV1	1521	+	186	108912795	36784
chr11	4313331	4513331	harbor1	chr11	4337177	4337266	LTR/ERV1	424	+	44	4337221	23890
chr11	4313331	4513331	harbor1	chr11	4337360	4337645	LTR/ERV1	887	+	142	4337502	24171
chr11	4313331	4513331	harbor1	chr11	4355238	4355409	LTR/ERV1	519	+	86	4355324	41993
chr11	95476904	95676904	harbor1	chr11	95569064	95569427	LTR/ERV1	1290	+	182	95569246	92342
chr11	101981020	102181020	harbor1	chr11	102028327	102029238	LTR/ERV1	3248	+	456	102028783	47763
chr11	129394922	129594922	harbor1	chr11	129466070	129466495	LTR/ERV1	1477	+	212	129466282	71360
chr11	121333431	121533431	harbor1	chr11	121346122	121346845	LTR/ERV1	3509	+	362	121346484	13053
chr11	121333431	121533431	harbor1	chr11	121374955	121375627	LTR/ERV1	1735	+	336	121375291	41860
chr11	121333431	121533431	harbor1	chr11	121386629	121386689	LTR/ERV1	3140	+	30	121386659	53228
chr11	121333431	121533431	harbor1	chr11	121386992	121387447	LTR/ERV1	3140	+	228	121387220	53789
chr11	121333431	121533431	harbor1	chr11	121407313	121408205	LTR/ERV1	5279	+	446	121407759	74328
chr11	121333431	121533431	harbor1	chr11	121413155	121413220	LTR/ERV1	486	+	32	121413187	79756
chr11	121333431	121533431	harbor1	chr11	121414210	121414388	LTR/ERV1	884	+	89	121414299	80868
chr11	121333431	121533431	harbor1	chr11	121418621	121419256	LTR/ERV1	1684	+	318	121418939	85508
chr11	24282835	24482835	harbor1	chr11	24299955	24300243	LTR/ERV1	945	+	144	24300099	17264
chr11	24282835	24482835	harbor1	chr11	24301402	24301761	LTR/ERV1	774	+	180	24301582	18747
chr11	24282835	24482835	harbor1	chr11	24338546	24339311	LTR/ERV1	4829	+	382	24338928	56093
chr11	25136854	25336854	harbor1	chr11	25150707	25150850	LTR/ERV1	714	+	72	25150779	13925
chr11	25136854	25336854	harbor1	chr11	25150851	25151042	LTR/ERV1	573	+	96	25150947	14093
chr11	134739164	134939164	harbor1	chr11	134751563	134752085	LTR/ERV1	1557	+	261	134751824	12660
chr11	59944807	60144807	harbor1	chr11	59961214	59961410	LTR/ERV1	5484	+	98	59961312	16505
chr11	59944807	60144807	harbor1	chr11	59961717	59962449	LTR/ERV1	5484	+	366	59962083	17276
chr11	90309693	90509693	harbor1	chr11	90319815	90320526	LTR/ERV1	4415	+	356	90320171	10478
chr11	90309693	90509693	harbor1	chr11	90320675	90321395	LTR/ERV1	3732	+	360	90321035	11342
chr11	90309693	90509693	harbor1	chr11	90326509	90326688	LTR/ERV1	1035	+	90	90326599	16906
chr11	90309693	90509693	harbor1	chr11	90326689	90326991	LTR/ERV1	1833	+	151	90326840	17147
chr11	90309693	90509693	harbor1	chr11	90332280	90332726	LTR/ERV1	2224	+	223	90332503	22810
chr11	118190620	118390620	harbor1	chr11	118219364	118219722	LTR/ERV1	2186	+	179	118219543	28923
chr11	118190620	118390620	harbor1	chr11	118219766	118221319	LTR/ERV1	10582	+	776	118220542	29922
chr11	118190620	118390620	harbor1	chr11	118221682	118222133	LTR/ERV1	10582	+	226	118221908	31288
chr11	118190620	118390620	harbor1	chr11	118222431	118222676	LTR/ERV1	4050	+	122	118222553	31933
chr11	118190620	118390620	harbor1	chr11	118222663	118222813	LTR/ERV1	5405	+	75	118222738	32118
chr11	118190620	118390620	harbor1	chr11	118223116	118223811	LTR/ERV1	5405	+	348	118223464	32844
chr11	118190620	118390620	harbor1	chr11	118226239	118226615	LTR/ERV1	2819	+	188	118226427	35807
chr11	118190620	118390620	harbor1	chr11	118272113	118272377	LTR/ERV1	1885	+	132	118272245	81625
chr11	118190620	118390620	harbor1	chr11	118273016	118273070	LTR/ERV1	1885	+	27	118273043	82423
chr11	118190620	118390620	harbor1	chr11	118273234	118273425	LTR/ERV1	1885	+	96	118273330	82710
chr11	75283222	75483222	harbor1	chr11	75331013	75331029	LTR/ERV1	5187	+	8	75331021	47799
chr11	75283222	75483222	harbor1	chr11	75331311	75331393	LTR/ERV1	5187	+	41	75331352	48130
chr11	75283222	75483222	harbor1	chr11	75331394	75331793	LTR/ERV1	2693	+	200	75331594	48372
chr11	75283222	75483222	harbor1	chr11	75331794	75331867	LTR/ERV1	5187	+	36	75331830	48608
chr11	75283222	75483222	harbor1	chr11	75331868	75332247	LTR/ERV1	1997	+	190	75332058	48836
chr11	75283222	75483222	harbor1	chr11	75332248	75332614	LTR/ERV1	5187	+	183	75332431	49209
chr11	75283222	75483222	harbor1	chr11	75332906	75333160	LTR/ERV1	5187	+	127	75333033	49811
chr11	88388387	88588387	harbor1	chr11	88448298	88448711	LTR/ERV1	3290	+	206	88448504	60117
chr11	88388387	88588387	harbor1	chr11	88448757	88448793	LTR/ERV1	3290	+	18	88448775	60388
chr11	41359916	41559916	harbor1	chr11	41427670	41428123	LTR/ERV1	3093	+	226	41427896	67980
chr11	38484530	38684530	harbor1	chr11	38503622	38504330	LTR/ERV1	4444	+	354	38503976	19446
chr11	42090385	42290385	harbor1	chr11	42120989	42121098	LTR/ERV1	948	+	54	42121043	30658
chr11	42090385	42290385	harbor1	chr11	42123976	42124125	LTR/ERV1	985	+	74	42124050	33665
chr11	42090385	42290385	harbor1	chr11	42124116	42124277	LTR/ERV1	1026	+	80	42124196	33811
chr11	42090385	42290385	harbor1	chr11	42124270	42124880	LTR/ERV1	4629	+	305	42124575	34190
chr11	42090385	42290385	harbor1	chr11	42124881	42125302	LTR/ERV1	3579	+	210	42125091	34706
chr11	42090385	42290385	harbor1	chr11	42121099	42123996	LTR/ERV1	15712	+	1448	42122547	32162
chr11	103502317	103702317	harbor1	chr11	103522840	103523180	LTR/ERV1	1085	+	170	103523010	20693
chr11	103502317	103702317	harbor1	chr11	103552436	103552723	LTR/ERV1	1572	+	144	103552580	50263
chr11	103502317	103702317	harbor1	chr11	103552769	103553108	LTR/ERV1	1613	+	170	103552939	50622
chr11	103502317	103702317	harbor1	chr11	103572042	103572502	LTR/ERV1	3452	+	230	103572272	69955
chr11	103502317	103702317	harbor1	chr11	103572511	103577581	LTR/ERV1	36672	+	2535	103575046	72729
chr11	103502317	103702317	harbor1	chr11	103577569	103578647	LTR/ERV1	7020	+	539	103578108	75791
chr11	103502317	103702317	harbor1	chr11	103578652	103579117	LTR/ERV1	2976	+	232	103578884	76567
chr11	103502317	103702317	harbor1	chr11	103589658	103590371	LTR/ERV1	3921	+	356	103590014	87697
chr11	103502317	103702317	harbor1	chr11	103600965	103601195	LTR/ERV1	451	+	115	103601080	98763
chr11	131460042	131660042	harbor1	chr11	131497674	131498165	LTR/ERV1	2550	+	246	131497920	37878
chr11	39686893	39886893	harbor1	chr11	39728780	39729360	LTR/ERV1	3210	+	290	39729070	42177
chr11	39686893	39886893	harbor1	chr11	39732539	39733146	LTR/ERV1	2831	+	304	39732843	45950
chr11	39686893	39886893	harbor1	chr11	39734126	39734557	LTR/ERV1	3391	+	216	39734342	47449
chr11	39686893	39886893	harbor1	chr11	39734558	39739803	LTR/ERV1	15405	+	2622	39737180	50287
chr11	39686893	39886893	harbor1	chr11	39739801	39740067	LTR/ERV1	1460	+	133	39739934	53041
chr11	39686893	39886893	harbor1	chr11	39740061	39740631	LTR/ERV1	3525	+	285	39740346	53453
chr11	39686893	39886893	harbor1	chr11	39740632	39741063	LTR/ERV1	3303	+	216	39740848	53955
chr11	121963765	122163765	harbor1	chr11	122025804	122026262	LTR/ERV1	1480	+	229	122026033	62268
chr11	69356778	69556778	harbor1	chr11	69401851	69402331	LTR/ERV1	1531	+	240	69402091	45313
chr11	103477047	103677047	harbor1	chr11	103487940	103488528	LTR/ERV1	3818	+	294	103488234	11187
chr11	103477047	103677047	harbor1	chr11	103492597	103492744	LTR/ERV1	1801	+	74	103492671	15624
chr11	103477047	103677047	harbor1	chr11	103493457	103494042	LTR/ERV1	2649	+	292	103493749	16702
chr11	103477047	103677047	harbor1	chr11	103494043	103494239	LTR/ERV1	1177	+	98	103494141	17094
chr11	103477047	103677047	harbor1	chr11	103494402	103494561	LTR/ERV1	776	+	80	103494482	17435
chr11	103477047	103677047	harbor1	chr11	103494648	103494726	LTR/ERV1	560	+	39	103494687	17640
chr11	103477047	103677047	harbor1	chr11	103494727	103495374	LTR/ERV1	3853	+	324	103495051	18004
chr11	103477047	103677047	harbor1	chr11	103495778	103496299	LTR/ERV1	783	+	260	103496038	18991
chr11	103477047	103677047	harbor1	chr11	103522840	103523180	LTR/ERV1	1085	+	170	103523010	45963
chr11	103477047	103677047	harbor1	chr11	103552436	103552723	LTR/ERV1	1572	+	144	103552580	75533
chr11	103477047	103677047	harbor1	chr11	103552769	103553108	LTR/ERV1	1613	+	170	103552939	75892
chr11	103477047	103677047	harbor1	chr11	103572042	103572502	LTR/ERV1	3452	+	230	103572272	95225
chr11	103477047	103677047	harbor1	chr11	103572511	103577581	LTR/ERV1	36672	+	2535	103575046	97999
chr11	66138353	66338353	harbor1	chr11	66189818	66190268	LTR/ERV1	2413	+	225	66190043	51690
chr11	6780138	6980138	harbor1	chr11	6801847	6802255	LTR/ERV1	2658	+	204	6802051	21913
chr11	6780138	6980138	harbor1	chr11	6817772	6819383	LTR/ERV1	8221	+	806	6818578	38440
chr11	6780138	6980138	harbor1	chr11	6852960	6853429	LTR/ERV1	9638	+	234	6853194	73056
chr11	6780138	6980138	harbor1	chr11	6853543	6854721	LTR/ERV1	9638	+	589	6854132	73994
chr11	6780138	6980138	harbor1	chr11	6854722	6854980	LTR/ERV1	4562	+	129	6854851	74713
chr11	6780138	6980138	harbor1	chr11	6855312	6855713	LTR/ERV1	4562	+	200	6855512	75374
chr11	123134655	123334655	harbor1	chr11	123212670	123212784	LTR/ERV1	1439	+	57	123212727	78072
chr11	123134655	123334655	harbor1	chr11	123213284	123213660	LTR/ERV1	1439	+	188	123213472	78817
chr11	123134655	123334655	harbor1	chr11	123218497	123219129	LTR/ERV1	4588	+	316	123218813	84158
chr11	89538689	89738689	harbor1	chr11	89571696	89572263	LTR/ERV1	3551	+	284	89571980	33291
chr11	89538689	89738689	harbor1	chr11	89589987	89590604	LTR/ERV1	3732	+	308	89590295	51606
chr11	131462723	131662723	harbor1	chr11	131497674	131498165	LTR/ERV1	2550	+	246	131497920	35197
chr11	94321756	94521756	harbor1	chr11	94344090	94344492	LTR/ERV1	647	+	201	94344291	22535
chr11	94321756	94521756	harbor1	chr11	94345725	94346118	LTR/ERV1	2763	+	196	94345921	24165
chr11	94321756	94521756	harbor1	chr11	94346126	94349120	LTR/ERV1	20161	+	1497	94347623	25867
chr11	94321756	94521756	harbor1	chr11	94349115	94349262	LTR/ERV1	897	+	74	94349189	27433
chr11	94321756	94521756	harbor1	chr11	94349253	94349753	LTR/ERV1	3346	+	250	94349503	27747
chr11	94321756	94521756	harbor1	chr11	94349756	94350418	LTR/ERV1	4416	+	331	94350087	28331
chr11	94321756	94521756	harbor1	chr11	94350420	94350637	LTR/ERV1	1419	+	108	94350528	28772
chr11	94321756	94521756	harbor1	chr11	94350636	94351011	LTR/ERV1	2298	+	188	94350824	29068
chr11	94321756	94521756	harbor1	chr11	94351012	94351415	LTR/ERV1	2737	+	202	94351214	29458
chr11	94321756	94521756	harbor1	chr11	94351418	94353033	LTR/ERV1	11131	+	808	94352226	30470
chr11	94321756	94521756	harbor1	chr11	94353028	94353879	LTR/ERV1	6293	+	426	94353454	31698
chr11	94321756	94521756	harbor1	chr11	94353882	94354544	LTR/ERV1	4497	+	331	94354213	32457
chr11	94321756	94521756	harbor1	chr11	94354546	94354761	LTR/ERV1	1395	+	108	94354654	32898
chr11	94321756	94521756	harbor1	chr11	94354760	94355138	LTR/ERV1	2471	+	189	94354949	33193
chr11	94321756	94521756	harbor1	chr11	94355139	94355534	LTR/ERV1	2758	+	198	94355337	33581
chr11	107138502	107338502	harbor1	chr11	107151409	107153427	LTR/ERV1	4378	+	1009	107152418	13916
chr11	107138502	107338502	harbor1	chr11	107153568	107153925	LTR/ERV1	3753	+	178	107153746	15244
chr11	107138502	107338502	harbor1	chr11	107154282	107155132	LTR/ERV1	3753	+	425	107154707	16205
chr11	107138502	107338502	harbor1	chr11	107155426	107156373	LTR/ERV1	3059	+	474	107155900	17398
chr11	107138502	107338502	harbor1	chr11	107156357	107156833	LTR/ERV1	1786	+	238	107156595	18093
chr11	107138502	107338502	harbor1	chr11	107157473	107157860	LTR/ERV1	2302	+	194	107157667	19165
chr11	107138502	107338502	harbor1	chr11	107219519	107219987	LTR/ERV1	3469	+	234	107219753	81251
chr11	85608148	85808148	harbor1	chr11	85607029	85612671	LTR/ERV1	31942	+	2821	85609850	1702
chr11	85608148	85808148	harbor1	chr11	85612686	85613464	LTR/ERV1	6037	+	389	85613075	4927
chr11	85608148	85808148	harbor1	chr11	85613466	85614182	LTR/ERV1	4819	+	358	85613824	5676
chr11	85608148	85808148	harbor1	chr11	85665815	85666202	LTR/ERV1	2236	+	194	85666009	57861
chr11	96961880	97161880	harbor1	chr11	97011002	97011686	LTR/ERV1	5272	+	342	97011344	49464
chr11	83108771	83308771	harbor1	chr11	83191981	83192491	LTR/ERV1	3994	+	255	83192236	83465
chr11	13740596	13940596	harbor1	chr11	13760125	13760381	LTR/ERV1	400	+	128	13760253	19657
chr11	13740596	13940596	harbor1	chr11	13777427	13777761	LTR/ERV1	2178	+	167	13777594	36998
chr11	13740596	13940596	harbor1	chr11	13805400	13805544	LTR/ERV1	935	+	72	13805472	64876
chr11	13740596	13940596	harbor1	chr11	13816862	13817103	LTR/ERV1	1182	+	120	13816982	76386
chr11	13740596	13940596	harbor1	chr11	13817410	13817589	LTR/ERV1	1182	+	90	13817500	76904
chr11	63516977	63716977	harbor1	chr11	63527502	63527719	LTR/ERV1	1230	+	108	63527610	10633
chr11	63516977	63716977	harbor1	chr11	63531910	63532556	LTR/ERV1	2780	+	323	63532233	15256
chr11	63516977	63716977	harbor1	chr11	63533169	63533672	LTR/ERV1	3417	+	252	63533421	16444
chr11	63516977	63716977	harbor1	chr11	63548195	63548632	LTR/ERV1	1894	+	218	63548413	31436
chr11	63516977	63716977	harbor1	chr11	63550022	63551588	LTR/ERV1	11048	+	783	63550805	33828
chr11	63516977	63716977	harbor1	chr11	63567104	63567796	LTR/ERV1	2916	+	346	63567450	50473
chr11	63516977	63716977	harbor1	chr11	63615441	63615664	LTR/ERV1	984	+	112	63615553	98576
chr11	63516977	63716977	harbor1	chr11	63616562	63616667	LTR/ERV1	590	+	52	63616614	99637
chr11	102882022	103082022	harbor1	chr11	102911690	102911953	LTR/ERV1	1421	+	132	102911822	29800
chr11	102882022	103082022	harbor1	chr11	102911954	102912394	LTR/ERV1	2453	+	220	102912174	30152
chr11	102882022	103082022	harbor1	chr11	102912395	102912429	LTR/ERV1	1421	+	17	102912412	30390
chr11	102882022	103082022	harbor1	chr11	102964477	102965231	LTR/ERV1	4046	+	377	102964854	82832
chr11	29448325	29648325	harbor1	chr11	29518506	29519128	LTR/ERV1	1777	+	311	29518817	70492
chr11	29448325	29648325	harbor1	chr11	29527354	29527987	LTR/ERV1	1796	+	316	29527670	79345
chr11	29448325	29648325	harbor1	chr11	29519152	29527353	LTR/ERV1	38354	+	4100	29523252	74927
chr11	83147528	83347528	harbor1	chr11	83191981	83192491	LTR/ERV1	3994	+	255	83192236	44708
chr11	12367641	12567641	harbor1	chr11	12374896	12375366	LTR/ERV1	1258	+	235	12375131	7490
chr11	43119223	43319223	harbor1	chr11	43179710	43179924	LTR/ERV1	405	+	107	43179817	60594
chr11	108574239	108774239	harbor1	chr11	108620142	108620586	LTR/ERV1	2731	+	222	108620364	46125
chr11	108574239	108774239	harbor1	chr11	108640332	108640746	LTR/ERV1	1842	+	207	108640539	66300
chr11	108574239	108774239	harbor1	chr11	108641228	108641395	LTR/ERV1	793	+	84	108641312	67073
chr11	108574239	108774239	harbor1	chr11	108641753	108642056	LTR/ERV1	4558	+	152	108641905	67666
chr11	108574239	108774239	harbor1	chr11	108642373	108642960	LTR/ERV1	4558	+	294	108642667	68428
chr11	88374871	88574871	harbor1	chr11	88448298	88448711	LTR/ERV1	3290	+	206	88448504	73633
chr11	88374871	88574871	harbor1	chr11	88448757	88448793	LTR/ERV1	3290	+	18	88448775	73904
chr11	55450892	55650892	harbor1	chr11	55496785	55497491	LTR/ERV1	4789	+	353	55497138	46246
chr11	55450892	55650892	harbor1	chr11	55500602	55501072	LTR/ERV1	2927	+	235	55500837	49945
chr11	55450892	55650892	harbor1	chr11	55501073	55502319	LTR/ERV1	5724	+	623	55501696	50804
chr11	55450892	55650892	harbor1	chr11	55502301	55504392	LTR/ERV1	13865	+	1046	55503347	52455
chr11	6530607	6730607	harbor1	chr11	6586520	6587937	LTR/ERV1	5342	+	708	6587228	56621
chr11	6530607	6730607	harbor1	chr11	6594457	6594828	LTR/ERV1	492	+	186	6594643	64036
chr11	17145391	17345391	harbor1	chr11	17162444	17162830	LTR/ERV1	2388	+	193	17162637	17246
chr11	17145391	17345391	harbor1	chr11	17226874	17227022	LTR/ERV1	587	+	74	17226948	81557
chr11	108145695	108345695	harbor1	chr11	108149825	108150225	LTR/ERV1	2613	+	200	108150025	4330
chr11	108145695	108345695	harbor1	chr11	108150527	108150680	LTR/ERV1	2613	+	76	108150603	4908
chr11	108145695	108345695	harbor1	chr11	108151045	108151146	LTR/ERV1	671	+	50	108151095	5400
chr11	108145695	108345695	harbor1	chr11	108151144	108151287	LTR/ERV1	811	+	72	108151216	5521
chr11	108145695	108345695	harbor1	chr11	108198480	108199480	LTR/ERV1	4283	+	500	108198980	53285
chr11	108145695	108345695	harbor1	chr11	108200262	108204146	LTR/ERV1	28613	+	1942	108202204	56509
chr11	108145695	108345695	harbor1	chr11	108204147	108204544	LTR/ERV1	2062	+	198	108204345	58650
chr11	108145695	108345695	harbor1	chr11	108204582	108204806	LTR/ERV1	2062	+	112	108204694	58999
chr11	108145695	108345695	harbor1	chr11	108199481	108200277	LTR/ERV1	4342	+	398	108199879	54184
chr11	68243792	68443792	harbor1	chr11	68275443	68275989	LTR/ERV1	3451	+	273	68275716	31924
chr11	68243792	68443792	harbor1	chr11	68287624	68287754	LTR/ERV1	1351	+	65	68287689	43897
chr11	68243792	68443792	harbor1	chr11	68288007	68288258	LTR/ERV1	1351	+	126	68288133	44341
chr11	49235848	49435848	harbor1	chr11	49266780	49267467	LTR/ERV1	3525	+	344	49267124	31276
chr11	49235848	49435848	harbor1	chr11	49286866	49287386	LTR/ERV1	1498	+	260	49287126	51278
chr11	85649151	85849151	harbor1	chr11	85665815	85666202	LTR/ERV1	2236	+	194	85666009	16858
chr11	21832342	22032342	harbor1	chr11	21831484	21832822	LTR/ERV1	1205	+	669	21832153	189
chr11	21832342	22032342	harbor1	chr11	21835076	21835214	LTR/ERV1	915	+	69	21835145	2803
chr11	21832342	22032342	harbor1	chr11	21835576	21835784	LTR/ERV1	915	+	104	21835680	3338
chr11	21832342	22032342	harbor1	chr11	21847750	21847934	LTR/ERV1	993	+	92	21847842	15500
chr11	21832342	22032342	harbor1	chr11	21852187	21852626	LTR/ERV1	2805	+	220	21852407	20065
chr11	21832342	22032342	harbor1	chr11	21923344	21923643	LTR/ERV1	1694	+	150	21923494	91152
chr11	78137720	78337720	harbor1	chr11	78178638	78179202	LTR/ERV1	3374	+	282	78178920	41200
chr11	120980118	121180118	harbor1	chr11	121021479	121022803	LTR/ERV1	9120	+	662	121022141	42023
chr11	62900720	63100720	harbor1	chr11	62955622	62956171	LTR/ERV1	1816	+	274	62955896	55176
chr11	62900720	63100720	harbor1	chr11	62968686	62968910	LTR/ERV1	425	+	112	62968798	68078
chr11	62900720	63100720	harbor1	chr11	62969049	62969236	LTR/ERV1	740	+	94	62969143	68423
chr11	89964595	90164595	harbor1	chr11	90009602	90010133	LTR/ERV1	2349	+	266	90009868	45273
chr11	76053459	76253459	harbor1	chr11	76060391	76061823	LTR/ERV1	10389	+	716	76061107	7648
chr11	76053459	76253459	harbor1	chr11	76089862	76090583	LTR/ERV1	3207	+	360	76090222	36763
chr11	20341874	20541874	harbor1	chr11	20341519	20342102	LTR/ERV1	2702	+	292	20341811	63
chr11	20341874	20541874	harbor1	chr11	20342223	20342371	LTR/ERV1	2702	+	74	20342297	423
chr11	20341874	20541874	harbor1	chr11	20350310	20350460	LTR/ERV1	742	+	75	20350385	8511
chr11	20341874	20541874	harbor1	chr11	20350455	20351015	LTR/ERV1	2555	+	280	20350735	8861
chr11	20341874	20541874	harbor1	chr11	20351018	20351184	LTR/ERV1	563	+	83	20351101	9227
chr11	20341874	20541874	harbor1	chr11	20348776	20349916	LTR/ERV1	2708	+	570	20349346	7472
chr11	106664915	106864915	harbor1	chr11	106670680	106671123	LTR/ERV1	1576	+	222	106670902	5987
chr11	111150438	111350438	harbor1	chr11	111221797	111223224	LTR/ERV1	11248	+	714	111222511	72073
chr11	56697911	56897911	harbor1	chr11	56792031	56792676	LTR/ERV1	2425	+	322	56792353	94442
chr11	93730450	93930450	harbor1	chr11	93758133	93758950	LTR/ERV1	2894	+	408	93758541	28091
chr11	93730450	93930450	harbor1	chr11	93769947	93770055	LTR/ERV1	2352	+	54	93770001	39551
chr11	93730450	93930450	harbor1	chr11	93770056	93770656	LTR/ERV1	4529	+	300	93770356	39906
chr11	93730450	93930450	harbor1	chr11	93770657	93770971	LTR/ERV1	2352	+	157	93770814	40364
chr11	93730450	93930450	harbor1	chr11	93776838	93777340	LTR/ERV1	3257	+	251	93777089	46639
chr11	93730450	93930450	harbor1	chr11	93777607	93777713	LTR/ERV1	3257	+	53	93777660	47210
chr11	93730450	93930450	harbor1	chr11	93777702	93777798	LTR/ERV1	705	+	48	93777750	47300
chr11	93730450	93930450	harbor1	chr11	93780094	93780495	LTR/ERV1	10434	+	200	93780294	49844
chr11	93730450	93930450	harbor1	chr11	93780799	93781372	LTR/ERV1	10434	+	286	93781085	50635
chr11	93730450	93930450	harbor1	chr11	93781698	93781919	LTR/ERV1	10434	+	110	93781808	51358
chr11	93730450	93930450	harbor1	chr11	93782223	93782984	LTR/ERV1	10434	+	380	93782603	52153
chr11	93730450	93930450	harbor1	chr11	93815107	93815687	LTR/ERV1	4107	+	290	93815397	84947
chr11	93730450	93930450	harbor1	chr11	93815987	93816148	LTR/ERV1	4107	+	80	93816067	85617
chr11	9234763	9434763	harbor1	chr11	9246029	9246330	LTR/ERV1	3594	+	150	9246179	11416
chr11	9234763	9434763	harbor1	chr11	9246632	9246948	LTR/ERV1	3594	+	158	9246790	12027
chr11	9234763	9434763	harbor1	chr11	9247248	9247415	LTR/ERV1	3594	+	84	9247332	12569
chr11	9234763	9434763	harbor1	chr11	9322486	9322919	LTR/ERV1	2152	+	216	9322702	87939
chr11	124337303	124537303	harbor1	chr11	124408671	124409102	LTR/ERV1	1829	+	216	124408887	71584
chr11	124337303	124537303	harbor1	chr11	124432047	124432200	LTR/ERV1	466	+	76	124432123	94820
chr11	83020976	83220976	harbor1	chr11	83019935	83021782	LTR/ERV1	7257	+	924	83020859	117
chr11	133039330	133239330	harbor1	chr11	133090017	133090261	LTR/ERV1	493	+	122	133090139	50809
chr11	94913229	95113229	harbor1	chr11	95006534	95006781	LTR/ERV1	419	+	124	95006658	93429
chr11	23719433	23919433	harbor1	chr11	23764805	23765716	LTR/ERV1	4027	+	456	23765261	45828
chr11	13485066	13685066	harbor1	chr11	13485185	13485843	LTR/ERV1	4252	+	329	13485514	448
chr11	134412616	134612616	harbor1	chr11	134455415	134456036	LTR/ERV1	3399	+	310	134455725	43109
chr11	123804540	124004540	harbor1	chr11	123871994	123872090	LTR/ERV1	649	+	48	123872042	67502
chr11	123804540	124004540	harbor1	chr11	123872628	123872975	LTR/ERV1	2637	+	174	123872802	68262
chr11	123804540	124004540	harbor1	chr11	123876426	123876861	LTR/ERV1	3060	+	218	123876644	72104
chr11	6773256	6973256	harbor1	chr11	6801847	6802255	LTR/ERV1	2658	+	204	6802051	28795
chr11	6773256	6973256	harbor1	chr11	6817772	6819383	LTR/ERV1	8221	+	806	6818578	45322
chr11	6773256	6973256	harbor1	chr11	6852960	6853429	LTR/ERV1	9638	+	234	6853194	79938
chr11	6773256	6973256	harbor1	chr11	6853543	6854721	LTR/ERV1	9638	+	589	6854132	80876
chr11	6773256	6973256	harbor1	chr11	6854722	6854980	LTR/ERV1	4562	+	129	6854851	81595
chr11	6773256	6973256	harbor1	chr11	6855312	6855713	LTR/ERV1	4562	+	200	6855512	82256
chr11	125974239	126174239	harbor1	chr11	126042940	126043537	LTR/ERV1	3208	+	298	126043238	68999
chr11	84683124	84883124	harbor1	chr11	84760726	84760783	LTR/ERV1	394	+	28	84760754	77630
chr11	84683124	84883124	harbor1	chr11	84760774	84761141	LTR/ERV1	2331	+	184	84760958	77834
chr11	113337808	113537808	harbor1	chr11	113376005	113376543	LTR/ERV1	2524	+	269	113376274	38466
chr11	133001290	133201290	harbor1	chr11	133006114	133006433	LTR/ERV1	1787	+	160	133006274	4984
chr11	133001290	133201290	harbor1	chr11	133013847	133014413	LTR/ERV1	3432	+	283	133014130	12840
chr11	133001290	133201290	harbor1	chr11	133090017	133090261	LTR/ERV1	493	+	122	133090139	88849
chr11	49707120	49907120	harbor1	chr11	49739722	49740151	LTR/ERV1	2306	+	214	49739936	32816
chr11	40027430	40227430	harbor1	chr11	40028993	40029686	LTR/ERV1	5055	+	346	40029339	1909
chr11	40027430	40227430	harbor1	chr11	40035127	40035915	LTR/ERV1	5409	+	394	40035521	8091
chr11	40027430	40227430	harbor1	chr11	40080415	40081043	LTR/ERV1	4245	+	314	40080729	53299
chr11	40027430	40227430	harbor1	chr11	40099468	40099818	LTR/ERV1	1468	+	175	40099643	72213
chr11	40027430	40227430	harbor1	chr11	40099828	40100434	LTR/ERV1	2072	+	303	40100131	72701
chr11	40027430	40227430	harbor1	chr11	40100822	40101731	LTR/ERV1	6638	+	454	40101276	73846
chr11	40027430	40227430	harbor1	chr11	40102032	40102417	LTR/ERV1	6638	+	192	40102224	74794
chr11	40027430	40227430	harbor1	chr11	40102801	40105251	LTR/ERV1	17096	+	1225	40104026	76596
chr11	40027430	40227430	harbor1	chr11	40105252	40105610	LTR/ERV1	1518	+	179	40105431	78001
chr11	40027430	40227430	harbor1	chr11	40121942	40122241	LTR/ERV1	850	+	150	40122092	94662
chr11	40027430	40227430	harbor1	chr11	40122533	40122657	LTR/ERV1	850	+	62	40122595	95165
chr11	17240056	17440056	harbor1	chr11	17274006	17274274	LTR/ERV1	2742	+	134	17274140	34084
chr11	17240056	17440056	harbor1	chr11	17274585	17274803	LTR/ERV1	2742	+	109	17274694	34638
chr11	32256513	32456513	harbor1	chr11	32263492	32263772	LTR/ERV1	1688	+	140	32263632	7119
chr11	32256513	32456513	harbor1	chr11	32263803	32264162	LTR/ERV1	1345	+	180	32263983	7470
chr11	32256513	32456513	harbor1	chr11	32328483	32328815	LTR/ERV1	1457	+	166	32328649	72136
chr11	32256513	32456513	harbor1	chr11	32329577	32329699	LTR/ERV1	768	+	61	32329638	73125
chr11	74867983	75067983	harbor1	chr11	74869317	74869984	LTR/ERV1	4194	+	334	74869651	1668
chr11	74867983	75067983	harbor1	chr11	74869998	74873955	LTR/ERV1	35825	+	1978	74871976	3993
chr11	74867983	75067983	harbor1	chr11	74875875	74877162	LTR/ERV1	35825	+	644	74876519	8536
chr11	74867983	75067983	harbor1	chr11	74883548	74883806	LTR/ERV1	1491	+	129	74883677	15694
chr11	74867983	75067983	harbor1	chr11	74883809	74883916	LTR/ERV1	3931	+	54	74883863	15880
chr11	74867983	75067983	harbor1	chr11	74884174	74884748	LTR/ERV1	3931	+	287	74884461	16478
chr11	74867983	75067983	harbor1	chr11	74874263	74875596	LTR/ERV1	35825	+	666	74874929	6946
chr11	12286716	12486716	harbor1	chr11	12374896	12375366	LTR/ERV1	1258	+	235	12375131	88415
chr11	9032564	9232564	harbor1	chr11	9097311	9098072	LTR/ERV1	5329	+	380	9097691	65127
chr11	100456914	100656914	harbor1	chr11	100553165	100553214	LTR/ERV1	388	+	24	100553189	96275
chr11	100456914	100656914	harbor1	chr11	100553215	100553416	LTR/ERV1	2986	+	100	100553315	96401
chr11	100456914	100656914	harbor1	chr11	100553719	100554121	LTR/ERV1	2986	+	201	100553920	97006
chr11	100456914	100656914	harbor1	chr11	100554122	100554226	LTR/ERV1	388	+	52	100554174	97260
chr11	100456914	100656914	harbor1	chr11	100554194	100554307	LTR/ERV1	493	+	56	100554250	97336
chr11	100456914	100656914	harbor1	chr11	100554609	100554733	LTR/ERV1	493	+	62	100554671	97757
chr11	100456914	100656914	harbor1	chr11	100555148	100555594	LTR/ERV1	1311	+	223	100555371	98457
chr11	100456914	100656914	harbor1	chr11	100555595	100555772	LTR/ERV1	452	+	88	100555683	98769
chr11	9018191	9218191	harbor1	chr11	9097311	9098072	LTR/ERV1	5329	+	380	9097691	79500
chr11	14582869	14782869	harbor1	chr11	14590886	14592270	LTR/ERV1	9907	+	692	14591578	8709
chr11	14582869	14782869	harbor1	chr11	14602788	14603514	LTR/ERV1	798	+	363	14603151	20282
chr11	14582869	14782869	harbor1	chr11	14679321	14679486	LTR/ERV1	1264	+	82	14679403	96534
chr11	14582869	14782869	harbor1	chr11	14679487	14679652	LTR/ERV1	870	+	82	14679569	96700
chr11	14582869	14782869	harbor1	chr11	14679645	14680784	LTR/ERV1	4703	+	570	14680215	97346
chr11	134412905	134612905	harbor1	chr11	134455415	134456036	LTR/ERV1	3399	+	310	134455725	42820
chr11	62917026	63117026	harbor1	chr11	62955622	62956171	LTR/ERV1	1816	+	274	62955896	38870
chr11	62917026	63117026	harbor1	chr11	62968686	62968910	LTR/ERV1	425	+	112	62968798	51772
chr11	62917026	63117026	harbor1	chr11	62969049	62969236	LTR/ERV1	740	+	94	62969143	52117
chr11	47771432	47971432	harbor1	chr11	47771644	47772056	LTR/ERV1	2657	+	206	47771850	418
chr11	47771432	47971432	harbor1	chr11	47773908	47774018	LTR/ERV1	615	+	55	47773963	2531
chr11	47771432	47971432	harbor1	chr11	47774147	47774284	LTR/ERV1	785	+	68	47774215	2783
chr11	47771432	47971432	harbor1	chr11	47774789	47774931	LTR/ERV1	833	+	71	47774860	3428
chr11	47771432	47971432	harbor1	chr11	47775231	47775267	LTR/ERV1	833	+	18	47775249	3817
chr11	47771432	47971432	harbor1	chr11	47776010	47776636	LTR/ERV1	2715	+	313	47776323	4891
chr11	47771432	47971432	harbor1	chr11	47776943	47776969	LTR/ERV1	2715	+	13	47776956	5524
chr11	47771432	47971432	harbor1	chr11	47831503	47831561	LTR/ERV1	3254	+	29	47831532	60100
chr11	47771432	47971432	harbor1	chr11	47831869	47831894	LTR/ERV1	3254	+	12	47831881	60449
chr11	47771432	47971432	harbor1	chr11	47832199	47832809	LTR/ERV1	3254	+	305	47832504	61072
chr11	47771432	47971432	harbor1	chr11	47844713	47845148	LTR/ERV1	4307	+	218	47844931	73499
chr11	47771432	47971432	harbor1	chr11	47845439	47845560	LTR/ERV1	4307	+	60	47845499	74067
chr11	47771432	47971432	harbor1	chr11	47860671	47861195	LTR/ERV1	4221	+	262	47860933	89501
chr11	103797045	103997045	harbor1	chr11	103848328	103848875	LTR/ERV1	4136	+	274	103848602	51557
chr11	109724655	109924655	harbor1	chr11	109729345	109730111	LTR/ERV1	4055	+	383	109729728	5073
chr11	109724655	109924655	harbor1	chr11	109750193	109750507	LTR/ERV1	643	+	157	109750350	25695
chr11	96747160	96947160	harbor1	chr11	96746481	96747252	LTR/ERV1	4822	+	386	96746867	293
chr11	102681897	102881897	harbor1	chr11	102684998	102685106	LTR/ERV1	716	+	54	102685052	3155
chr11	102681897	102881897	harbor1	chr11	102687331	102687763	LTR/ERV1	2655	+	216	102687547	5650
chr11	102681897	102881897	harbor1	chr11	102723285	102723361	LTR/ERV1	403	+	38	102723323	41426
chr11	9135891	9335891	harbor1	chr11	9229340	9229899	LTR/ERV1	2993	+	280	9229620	93729
chr11	9135891	9335891	harbor1	chr11	9230209	9230230	LTR/ERV1	2993	+	10	9230219	94328
chr11	9135891	9335891	harbor1	chr11	9230530	9230637	LTR/ERV1	2993	+	54	9230584	94693
chr11	69254265	69454265	harbor1	chr11	69328691	69328964	LTR/ERV1	3391	+	136	69328827	74562
chr11	69254265	69454265	harbor1	chr11	69329267	69329506	LTR/ERV1	3391	+	120	69329387	75122
chr11	34577149	34777149	harbor1	chr11	34665947	34666090	LTR/ERV1	1038	+	72	34666019	88870
chr11	29635974	29835974	harbor1	chr11	29693614	29693832	LTR/ERV1	1093	+	109	29693723	57749
chr11	29635974	29835974	harbor1	chr11	29699512	29699680	LTR/ERV1	829	+	84	29699596	63622
chr11	29635974	29835974	harbor1	chr11	29710868	29711265	LTR/ERV1	2141	+	198	29711066	75092
chr11	29635974	29835974	harbor1	chr11	29712462	29714085	LTR/ERV1	11245	+	812	29713274	77300
chr11	120018880	120218880	harbor1	chr11	120025716	120027154	LTR/ERV1	10011	+	719	120026435	7555
chr11	120018880	120218880	harbor1	chr11	120030850	120031135	LTR/ERV1	487	+	142	120030992	12112
chr11	24031109	24231109	harbor1	chr11	24078793	24078956	LTR/ERV1	1962	+	82	24078875	47766
chr11	24031109	24231109	harbor1	chr11	24079268	24079632	LTR/ERV1	1962	+	182	24079450	48341
chr11	113746120	113946120	harbor1	chr11	113775582	113776094	LTR/ERV1	2656	+	256	113775838	29718
chr11	11088926	11288926	harbor1	chr11	11090610	11090942	LTR/ERV1	2645	+	166	11090776	1850
chr11	11088926	11288926	harbor1	chr11	11090943	11091688	LTR/ERV1	3697	+	372	11091315	2389
chr11	11088926	11288926	harbor1	chr11	11091689	11091791	LTR/ERV1	2645	+	51	11091740	2814
chr11	11088926	11288926	harbor1	chr11	11105417	11105901	LTR/ERV1	2295	+	242	11105659	16733
chr11	11088926	11288926	harbor1	chr11	11105946	11106698	LTR/ERV1	2539	+	376	11106322	17396
chr11	11088926	11288926	harbor1	chr11	11106829	11107531	LTR/ERV1	5053	+	351	11107180	18254
chr11	11088926	11288926	harbor1	chr11	11139144	11139647	LTR/ERV1	1052	+	252	11139396	50470
chr11	11088926	11288926	harbor1	chr11	11160415	11161001	LTR/ERV1	3822	+	293	11160708	71782
chr11	128612171	128812171	harbor1	chr11	128658458	128658880	LTR/ERV1	2519	+	211	128658669	46498
chr11	106062763	106262763	harbor1	chr11	106063072	106063463	LTR/ERV1	1520	+	196	106063268	505
chr11	106062763	106262763	harbor1	chr11	106141760	106142136	LTR/ERV1	2656	+	188	106141948	79185
chr11	106062763	106262763	harbor1	chr11	106142138	106142511	LTR/ERV1	8347	+	186	106142324	79561
chr11	106062763	106262763	harbor1	chr11	106143140	106143525	LTR/ERV1	8347	+	192	106143332	80569
chr11	106062763	106262763	harbor1	chr11	106143830	106145252	LTR/ERV1	8347	+	711	106144541	81778
chr11	106062763	106262763	harbor1	chr11	106145547	106146594	LTR/ERV1	4900	+	524	106146071	83308
chr11	106062763	106262763	harbor1	chr11	106146600	106146983	LTR/ERV1	2459	+	192	106146792	84029
chr11	106062763	106262763	harbor1	chr11	106152225	106152596	LTR/ERV1	2177	+	186	106152411	89648
chr11	106062763	106262763	harbor1	chr11	106160965	106161531	LTR/ERV1	3024	+	283	106161248	98485
chr11	106062763	106262763	harbor1	chr11	106161536	106161652	LTR/ERV1	598	+	58	106161594	98831
chr11	80368797	80568797	harbor1	chr11	80378847	80379309	LTR/ERV1	490	+	231	80379078	10281
chr11	80368797	80568797	harbor1	chr11	80448484	80449203	LTR/ERV1	3360	+	360	80448844	80047
chr11	20604955	20804955	harbor1	chr11	20611482	20611670	LTR/ERV1	2684	+	94	20611576	6621
chr11	20604955	20804955	harbor1	chr11	20611945	20612031	LTR/ERV1	473	+	43	20611988	7033
chr11	20604955	20804955	harbor1	chr11	20610921	20611180	LTR/ERV1	2678	+	130	20611051	6096
chr11	30235927	30435927	harbor1	chr11	30257395	30257965	LTR/ERV1	1636	+	285	30257680	21753
chr11	30235927	30435927	harbor1	chr11	30307090	30307581	LTR/ERV1	1350	+	246	30307336	71409
chr11	83901266	84101266	harbor1	chr11	83925051	83925425	LTR/ERV1	2214	+	187	83925238	23972
chr11	83901266	84101266	harbor1	chr11	83955411	83955665	LTR/ERV1	1554	+	127	83955538	54272
chr11	83901266	84101266	harbor1	chr11	83956088	83956651	LTR/ERV1	2973	+	282	83956370	55104
chr11	9375860	9575860	harbor1	chr11	9378575	9378668	LTR/ERV1	4920	+	46	9378621	2761
chr11	9375860	9575860	harbor1	chr11	9378975	9379760	LTR/ERV1	4920	+	392	9379367	3507
chr11	25241921	25441921	harbor1	chr11	25265723	25265955	LTR/ERV1	388	+	116	25265839	23918
chr11	25241921	25441921	harbor1	chr11	25265956	25266498	LTR/ERV1	2266	+	271	25266227	24306
chr11	25241921	25441921	harbor1	chr11	25266577	25266722	LTR/ERV1	471	+	72	25266649	24728
chr11	25241921	25441921	harbor1	chr11	25333553	25333699	LTR/ERV1	437	+	73	25333626	91705
chr11	4927148	5127148	harbor1	chr11	4957459	4957679	LTR/ERV1	3038	+	110	4957569	30421
chr11	4927148	5127148	harbor1	chr11	4957941	4958401	LTR/ERV1	3038	+	230	4958171	31023
chr11	4927148	5127148	harbor1	chr11	4965092	4965592	LTR/ERV1	1708	+	250	4965342	38194
chr11	4927148	5127148	harbor1	chr11	4965606	4966023	LTR/ERV1	1338	+	208	4965814	38666
chr11	4927148	5127148	harbor1	chr11	5004923	5005581	LTR/ERV1	3394	+	329	5005252	78104
chr11	5384615	5584615	harbor1	chr11	5404115	5405024	LTR/ERV1	5066	+	454	5404569	19954
chr11	5384615	5584615	harbor1	chr11	5408510	5409024	LTR/ERV1	1523	+	257	5408767	24152
chr11	5384615	5584615	harbor1	chr11	5426629	5427333	LTR/ERV1	2978	+	352	5426981	42366
chr11	5384615	5584615	harbor1	chr11	5428622	5429353	LTR/ERV1	3916	+	366	5428988	44373
chr11	5384615	5584615	harbor1	chr11	5448867	5449012	LTR/ERV1	479	+	72	5448939	64324
chr11	7813040	8013040	harbor1	chr11	7906775	7908160	LTR/ERV1	5328	+	692	7907467	94427
chr11	7813040	8013040	harbor1	chr11	7908258	7908688	LTR/ERV1	2386	+	215	7908473	95433
chr11	7813040	8013040	harbor1	chr11	7909637	7910205	LTR/ERV1	1264	+	284	7909921	96881
chr11	127350412	127550412	harbor1	chr11	127396531	127397340	LTR/ERV1	4511	+	404	127396935	46523
chr11	18238699	18438699	harbor1	chr11	18313220	18313509	LTR/ERV1	1534	+	144	18313364	74665
chr11	18238699	18438699	harbor1	chr11	18314566	18314688	LTR/ERV1	744	+	61	18314627	75928
chr11	18238699	18438699	harbor1	chr11	18314998	18315018	LTR/ERV1	744	+	10	18315008	76309
chr11	18238699	18438699	harbor1	chr11	18315151	18315333	LTR/ERV1	1183	+	91	18315242	76543
chr11	18238699	18438699	harbor1	chr11	18315643	18315863	LTR/ERV1	1183	+	110	18315753	77054
chr11	18238699	18438699	harbor1	chr11	18316331	18316419	LTR/ERV1	456	+	44	18316375	77676
chr11	95914558	96114558	harbor1	chr11	95980844	95981256	LTR/ERV1	2873	+	206	95981050	66492
chr11	95914558	96114558	harbor1	chr11	96013401	96014181	LTR/ERV1	4816	+	390	96013791	99233
chr11	88259323	88459323	harbor1	chr11	88301118	88301584	LTR/ERV1	2046	+	233	88301351	42028
chr11	88259323	88459323	harbor1	chr11	88304525	88304815	LTR/ERV1	4301	+	145	88304670	45347
chr11	88259323	88459323	harbor1	chr11	88305111	88305387	LTR/ERV1	4301	+	138	88305249	45926
chr11	88259323	88459323	harbor1	chr11	88306285	88307074	LTR/ERV1	4063	+	394	88306679	47356
chr11	88259323	88459323	harbor1	chr11	88308077	88308867	LTR/ERV1	3044	+	395	88308472	49149
chr11	18275911	18475911	harbor1	chr11	18313220	18313509	LTR/ERV1	1534	+	144	18313364	37453
chr11	18275911	18475911	harbor1	chr11	18314566	18314688	LTR/ERV1	744	+	61	18314627	38716
chr11	18275911	18475911	harbor1	chr11	18314998	18315018	LTR/ERV1	744	+	10	18315008	39097
chr11	18275911	18475911	harbor1	chr11	18315151	18315333	LTR/ERV1	1183	+	91	18315242	39331
chr11	18275911	18475911	harbor1	chr11	18315643	18315863	LTR/ERV1	1183	+	110	18315753	39842
chr11	18275911	18475911	harbor1	chr11	18316331	18316419	LTR/ERV1	456	+	44	18316375	40464
chr11	18267351	18467351	harbor1	chr11	18313220	18313509	LTR/ERV1	1534	+	144	18313364	46013
chr11	18267351	18467351	harbor1	chr11	18314566	18314688	LTR/ERV1	744	+	61	18314627	47276
chr11	18267351	18467351	harbor1	chr11	18314998	18315018	LTR/ERV1	744	+	10	18315008	47657
chr11	18267351	18467351	harbor1	chr11	18315151	18315333	LTR/ERV1	1183	+	91	18315242	47891
chr11	18267351	18467351	harbor1	chr11	18315643	18315863	LTR/ERV1	1183	+	110	18315753	48402
chr11	18267351	18467351	harbor1	chr11	18316331	18316419	LTR/ERV1	456	+	44	18316375	49024
chr11	85876108	86076108	harbor1	chr11	85889875	85890733	LTR/ERV1	1572	+	429	85890304	14196
chr11	85876108	86076108	harbor1	chr11	85890758	85890993	LTR/ERV1	397	+	118	85890876	14768
chr11	101771192	101971192	harbor1	chr11	101798693	101798763	LTR/ERV1	437	+	35	101798728	27536
chr11	44566246	44766246	harbor1	chr11	44632337	44633072	LTR/ERV1	814	+	368	44632705	66459
chr11	44566246	44766246	harbor1	chr11	44633747	44634072	LTR/ERV1	814	+	162	44633909	67663
chr11	87861723	88061723	harbor1	chr11	87915202	87915825	LTR/ERV1	4086	+	312	87915514	53791
chr11	87861723	88061723	harbor1	chr11	87956614	87957147	LTR/ERV1	1861	+	266	87956880	95157
chr11	87861723	88061723	harbor1	chr11	87960605	87960684	LTR/ERV1	441	+	40	87960645	98922
chr11	59287099	59487099	harbor1	chr11	59371758	59371889	LTR/ERV1	859	+	66	59371824	84725
chr11	104703064	104903064	harbor1	chr11	104704913	104705426	LTR/ERV1	2322	+	256	104705169	2105
chr11	104703064	104903064	harbor1	chr11	104745494	104746202	LTR/ERV1	4219	+	354	104745848	42784
chr11	104703064	104903064	harbor1	chr11	104746467	104746615	LTR/ERV1	4219	+	74	104746541	43477
chr11	104703064	104903064	harbor1	chr11	104746736	104747510	LTR/ERV1	3811	+	387	104747123	44059
chr11	104703064	104903064	harbor1	chr11	104747917	104748463	LTR/ERV1	4185	+	273	104748190	45126
chr11	104703064	104903064	harbor1	chr11	104781651	104782159	LTR/ERV1	3525	+	254	104781905	78841
chr11	104394103	104594103	harbor1	chr11	104477518	104477633	LTR/ERV1	434	+	58	104477576	83473
chr11	104394103	104594103	harbor1	chr11	104478140	104478347	LTR/ERV1	434	+	104	104478244	84141
chr11	104394103	104594103	harbor1	chr11	104490194	104490338	LTR/ERV1	1041	+	72	104490266	96163
chr11	104394103	104594103	harbor1	chr11	104490339	104491597	LTR/ERV1	11656	+	629	104490968	96865
chr11	104394103	104594103	harbor1	chr11	104491639	104492562	LTR/ERV1	11656	+	462	104492101	97998
chr11	104394103	104594103	harbor1	chr11	104492557	104493170	LTR/ERV1	7320	+	306	104492863	98760
chr11	104394103	104594103	harbor1	chr11	104493477	104494432	LTR/ERV1	7320	+	478	104493955	99852
chr11	104394103	104594103	harbor1	chr11	104398531	104399092	LTR/ERV1	3088	+	280	104398811	4708
chr11	84881492	85081492	harbor1	chr11	84947344	84947709	LTR/ERV1	1688	+	182	84947526	66034
chr11	61038779	61238779	harbor1	chr11	61040001	61040524	LTR/ERV1	2290	+	262	61040263	1484
chr11	61038779	61238779	harbor1	chr11	61040825	61040956	LTR/ERV1	2290	+	66	61040891	2112
chr11	61038779	61238779	harbor1	chr11	61050394	61050501	LTR/ERV1	1822	+	54	61050448	11669
chr11	61038779	61238779	harbor1	chr11	61050794	61051220	LTR/ERV1	1822	+	213	61051007	12228
chr11	61038779	61238779	harbor1	chr11	61093594	61094050	LTR/ERV1	3672	+	228	61093822	55043
chr11	61038779	61238779	harbor1	chr11	61094051	61094441	LTR/ERV1	2890	+	195	61094246	55467
chr11	61038779	61238779	harbor1	chr11	61097037	61098391	LTR/ERV1	11158	+	677	61097714	58935
chr11	61038779	61238779	harbor1	chr11	61098392	61098841	LTR/ERV1	3416	+	224	61098616	59837
chr11	61038779	61238779	harbor1	chr11	61094435	61097062	LTR/ERV1	20948	+	1314	61095749	56970
chr11	37701605	37901605	harbor1	chr11	37702376	37702849	LTR/ERV1	2041	+	236	37702612	1007
chr11	37701605	37901605	harbor1	chr11	37774203	37774621	LTR/ERV1	2746	+	209	37774412	72807
chr11	35005890	35205890	harbor1	chr11	35043955	35044269	LTR/ERV1	974	+	157	35044112	38222
chr11	125523757	125723757	harbor1	chr11	125524013	125524138	LTR/ERV1	480	+	62	125524075	318
chr11	125523757	125723757	harbor1	chr11	125525332	125525366	LTR/ERV1	1029	+	17	125525349	1592
chr11	125523757	125723757	harbor1	chr11	125525730	125525874	LTR/ERV1	1029	+	72	125525802	2045
chr11	125523757	125723757	harbor1	chr11	125526179	125526279	LTR/ERV1	1029	+	50	125526229	2472
chr11	125523757	125723757	harbor1	chr11	125526274	125526641	LTR/ERV1	1971	+	184	125526458	2701
chr11	125523757	125723757	harbor1	chr11	125526919	125527102	LTR/ERV1	925	+	92	125527011	3254
chr11	125523757	125723757	harbor1	chr11	125527220	125527355	LTR/ERV1	412	+	68	125527288	3531
chr11	125523757	125723757	harbor1	chr11	125535257	125536031	LTR/ERV1	4725	+	387	125535644	11887
chr11	125523757	125723757	harbor1	chr11	125536059	125536264	LTR/ERV1	1069	+	102	125536161	12404
chr11	125523757	125723757	harbor1	chr11	125536567	125536605	LTR/ERV1	1069	+	19	125536586	12829
chr11	125523757	125723757	harbor1	chr11	125542655	125543347	LTR/ERV1	3627	+	346	125543001	19244
chr11	125523757	125723757	harbor1	chr11	125543348	125543762	LTR/ERV1	2423	+	207	125543555	19798
chr11	125523757	125723757	harbor1	chr11	125543763	125544263	LTR/ERV1	12910	+	250	125544013	20256
chr11	125523757	125723757	harbor1	chr11	125544605	125544860	LTR/ERV1	12910	+	128	125544733	20976
chr11	125523757	125723757	harbor1	chr11	125545163	125547199	LTR/ERV1	12910	+	1018	125546181	22424
chr11	125523757	125723757	harbor1	chr11	125547200	125547417	LTR/ERV1	1648	+	108	125547308	23551
chr11	125523757	125723757	harbor1	chr11	125547726	125547780	LTR/ERV1	1648	+	27	125547753	23996
chr11	125523757	125723757	harbor1	chr11	125551738	125552166	LTR/ERV1	2461	+	214	125551952	28195
chr11	125523757	125723757	harbor1	chr11	125556622	125557700	LTR/ERV1	29257	+	539	125557161	33404
chr11	125523757	125723757	harbor1	chr11	125558002	125558479	LTR/ERV1	29257	+	238	125558240	34483
chr11	125523757	125723757	harbor1	chr11	125558775	125558804	LTR/ERV1	29257	+	14	125558789	35032
chr11	125523757	125723757	harbor1	chr11	125559090	125559294	LTR/ERV1	29257	+	102	125559192	35435
chr11	125523757	125723757	harbor1	chr11	125559583	125560308	LTR/ERV1	29257	+	362	125559945	36188
chr11	125523757	125723757	harbor1	chr11	125560616	125562427	LTR/ERV1	29257	+	906	125561522	37765
chr11	125523757	125723757	harbor1	chr11	125562463	125562850	LTR/ERV1	2785	+	194	125562657	38900
chr11	125523757	125723757	harbor1	chr11	125562851	125563247	LTR/ERV1	1874	+	198	125563049	39292
chr11	125523757	125723757	harbor1	chr11	125563551	125563655	LTR/ERV1	4035	+	52	125563603	39846
chr11	125523757	125723757	harbor1	chr11	125563956	125564490	LTR/ERV1	4035	+	267	125564223	40466
chr11	27928269	28128269	harbor1	chr11	27999060	27999513	LTR/ERV1	2443	+	226	27999286	71017
chr11	27928269	28128269	harbor1	chr11	27999598	27999917	LTR/ERV1	543	+	160	27999758	71489
chr11	27928269	28128269	harbor1	chr11	28003321	28006676	LTR/ERV1	3630	+	1678	28004999	76730
chr11	27928269	28128269	harbor1	chr11	28006681	28007148	LTR/ERV1	2058	+	234	28006915	78646
chr11	27928269	28128269	harbor1	chr11	28007149	28007582	LTR/ERV1	2031	+	216	28007365	79096
chr11	27928269	28128269	harbor1	chr11	28000001	28001063	LTR/ERV1	3813	+	531	28000532	72263
chr11	20521196	20721196	harbor1	chr11	20567875	20568314	LTR/ERV1	3767	+	220	20568095	46899
chr11	20521196	20721196	harbor1	chr11	20568316	20571208	LTR/ERV1	16959	+	1446	20569762	48566
chr11	20521196	20721196	harbor1	chr11	20571188	20571337	LTR/ERV1	992	+	74	20571262	50066
chr11	20521196	20721196	harbor1	chr11	20571328	20571767	LTR/ERV1	3079	+	220	20571548	50352
chr11	20521196	20721196	harbor1	chr11	20571774	20571836	LTR/ERV1	422	+	31	20571805	50609
chr11	20521196	20721196	harbor1	chr11	20571837	20572214	LTR/ERV1	2463	+	188	20572025	50829
chr11	20521196	20721196	harbor1	chr11	20572215	20572655	LTR/ERV1	3811	+	220	20572435	51239
chr11	20521196	20721196	harbor1	chr11	20611482	20611670	LTR/ERV1	2684	+	94	20611576	90380
chr11	20521196	20721196	harbor1	chr11	20611945	20612031	LTR/ERV1	473	+	43	20611988	90792
chr11	20521196	20721196	harbor1	chr11	20610921	20611180	LTR/ERV1	2678	+	130	20611051	89855
chr11	121428805	121628805	harbor1	chr11	121440064	121440094	LTR/ERV1	3194	+	15	121440079	11274
chr11	121428805	121628805	harbor1	chr11	121440402	121441008	LTR/ERV1	3194	+	303	121440705	11900
chr11	26448784	26648784	harbor1	chr11	26478652	26479011	LTR/ERV1	1028	+	180	26478832	30048
chr11	82433722	82633722	harbor1	chr11	82441995	82442140	LTR/ERV1	608	+	72	82442067	8345
chr11	82433722	82633722	harbor1	chr11	82453103	82453531	LTR/ERV1	2039	+	214	82453317	19595
chr11	82433722	82633722	harbor1	chr11	82477329	82477645	LTR/ERV1	2197	+	158	82477487	43765
chr11	82433722	82633722	harbor1	chr11	82493498	82493896	LTR/ERV1	2619	+	199	82493697	59975
chr11	82433722	82633722	harbor1	chr11	82500976	82502534	LTR/ERV1	10633	+	779	82501755	68033
chr11	106429639	106629639	harbor1	chr11	106460039	106460172	LTR/ERV1	486	+	66	106460105	30466
chr11	106429639	106629639	harbor1	chr11	106460146	106460321	LTR/ERV1	396	+	88	106460234	30595
chr11	106429639	106629639	harbor1	chr11	106467552	106468148	LTR/ERV1	2843	+	298	106467850	38211
chr11	106429639	106629639	harbor1	chr11	106528745	106529233	LTR/ERV1	2447	+	244	106528989	99350
chr11	87455305	87655305	harbor1	chr11	87493449	87494081	LTR/ERV1	1736	+	316	87493765	38460
chr11	87455305	87655305	harbor1	chr11	87494544	87494590	LTR/ERV1	1736	+	23	87494567	39262
chr11	87455305	87655305	harbor1	chr11	87523650	87523671	LTR/ERV1	2372	+	10	87523660	68355
chr11	87455305	87655305	harbor1	chr11	87523672	87524422	LTR/ERV1	3435	+	375	87524047	68742
chr11	87455305	87655305	harbor1	chr11	87524423	87524803	LTR/ERV1	2372	+	190	87524613	69308
chr11	87455305	87655305	harbor1	chr11	87525469	87525650	LTR/ERV1	2372	+	90	87525559	70254
chr11	87455305	87655305	harbor1	chr11	87527257	87527615	LTR/ERV1	2392	+	179	87527436	72131
chr11	87455305	87655305	harbor1	chr11	87529731	87530017	LTR/ERV1	1537	+	143	87529874	74569
chr11	87455305	87655305	harbor1	chr11	87530442	87530895	LTR/ERV1	2354	+	226	87530668	75363
chr11	87455305	87655305	harbor1	chr11	87531405	87531841	LTR/ERV1	2281	+	218	87531623	76318
chr11	87455305	87655305	harbor1	chr11	87531834	87531916	LTR/ERV1	403	+	41	87531875	76570
chr11	87455305	87655305	harbor1	chr11	87531909	87532162	LTR/ERV1	1020	+	126	87532035	76730
chr11	87455305	87655305	harbor1	chr11	87532165	87532620	LTR/ERV1	2311	+	228	87532393	77088
chr11	87455305	87655305	harbor1	chr11	87532653	87532833	LTR/ERV1	814	+	90	87532743	77438
chr11	87455305	87655305	harbor1	chr11	87532832	87533876	LTR/ERV1	2400	+	522	87533354	78049
chr11	87455305	87655305	harbor1	chr11	87533912	87534104	LTR/ERV1	1537	+	96	87534008	78703
chr11	87455305	87655305	harbor1	chr11	87534494	87534822	LTR/ERV1	1327	+	164	87534658	79353
chr11	87455305	87655305	harbor1	chr11	87534801	87536029	LTR/ERV1	4305	+	614	87535415	80110
chr11	50035481	50235481	harbor1	chr11	50037013	50037535	LTR/ERV1	1747	+	261	50037274	1793
chr11	50035481	50235481	harbor1	chr11	50038617	50039962	LTR/ERV1	7277	+	672	50039289	3808
chr11	50035481	50235481	harbor1	chr11	50041136	50044870	LTR/ERV1	4311	+	1867	50043003	7522
chr11	50035481	50235481	harbor1	chr11	50044997	50045059	LTR/ERV1	387	+	31	50045028	9547
chr11	50035481	50235481	harbor1	chr11	50055279	50055781	LTR/ERV1	2074	+	251	50055530	20049
chr11	126081749	126281749	harbor1	chr11	126088962	126089487	LTR/ERV1	2202	+	262	126089224	7475
chr11	14518134	14718134	harbor1	chr11	14524261	14524693	LTR/ERV1	3223	+	216	14524477	6343
chr11	14518134	14718134	harbor1	chr11	14524694	14524836	LTR/ERV1	651	+	71	14524765	6631
chr11	14518134	14718134	harbor1	chr11	14524834	14527810	LTR/ERV1	12932	+	1488	14526322	8188
chr11	14518134	14718134	harbor1	chr11	14527808	14528073	LTR/ERV1	1395	+	132	14527940	9806
chr11	14518134	14718134	harbor1	chr11	14528067	14528628	LTR/ERV1	3248	+	280	14528347	10213
chr11	14518134	14718134	harbor1	chr11	14528630	14529062	LTR/ERV1	3225	+	216	14528846	10712
chr11	14518134	14718134	harbor1	chr11	14590886	14592270	LTR/ERV1	9907	+	692	14591578	73444
chr11	14518134	14718134	harbor1	chr11	14602788	14603514	LTR/ERV1	798	+	363	14603151	85017
chr11	66437089	66637089	harbor1	chr11	66439744	66439823	LTR/ERV1	2253	+	40	66439784	2695
chr11	66437089	66637089	harbor1	chr11	66441298	66441609	LTR/ERV1	2253	+	156	66441454	4365
chr11	66437089	66637089	harbor1	chr11	66443983	66444190	LTR/ERV1	1141	+	104	66444087	6998
chr11	66437089	66637089	harbor1	chr11	66445487	66446005	LTR/ERV1	4141	+	259	66445746	8657
chr11	66437089	66637089	harbor1	chr11	66446305	66446484	LTR/ERV1	4141	+	90	66446395	9306
chr11	66437089	66637089	harbor1	chr11	66448742	66449237	LTR/ERV1	5356	+	248	66448990	11901
chr11	66437089	66637089	harbor1	chr11	66449539	66449917	LTR/ERV1	5356	+	189	66449728	12639
chr11	66437089	66637089	harbor1	chr11	66456417	66456568	LTR/ERV1	1029	+	76	66456493	19404
chr11	66437089	66637089	harbor1	chr11	66457141	66457456	LTR/ERV1	2523	+	158	66457299	20210
chr11	66437089	66637089	harbor1	chr11	66457768	66457879	LTR/ERV1	2523	+	56	66457824	20735
chr11	112077533	112277533	harbor1	chr11	112122886	112123523	LTR/ERV1	3572	+	318	112123204	45671
chr11	131470084	131670084	harbor1	chr11	131497674	131498165	LTR/ERV1	2550	+	246	131497920	27836
chr11	78065097	78265097	harbor1	chr11	78080836	78081299	LTR/ERV1	3328	+	232	78081068	15971
chr11	78065097	78265097	harbor1	chr11	78081300	78085065	LTR/ERV1	9528	+	1882	78083182	18085
chr11	78065097	78265097	harbor1	chr11	78085062	78085581	LTR/ERV1	2845	+	260	78085322	20225
chr11	78065097	78265097	harbor1	chr11	78086563	78087032	LTR/ERV1	3422	+	234	78086797	21700
chr11	37039267	37239267	harbor1	chr11	37049274	37049983	LTR/ERV1	4016	+	354	37049628	10361
chr11	37039267	37239267	harbor1	chr11	37099016	37099385	LTR/ERV1	813	+	184	37099200	59933
chr11	128025297	128225297	harbor1	chr11	128104802	128105415	LTR/ERV1	2374	+	306	128105108	79811
chr11	103166665	103366665	harbor1	chr11	103249587	103250054	LTR/ERV1	987	+	234	103249821	83156
chr11	10075016	10275016	harbor1	chr11	10100175	10100322	LTR/ERV1	969	+	74	10100249	25233
chr11	10075016	10275016	harbor1	chr11	10100323	10101659	LTR/ERV1	10158	+	668	10100991	25975
chr11	10075016	10275016	harbor1	chr11	10101693	10102050	LTR/ERV1	10158	+	178	10101871	26855
chr11	10075016	10275016	harbor1	chr11	10102038	10103791	LTR/ERV1	10133	+	876	10102914	27898
chr11	10075016	10275016	harbor1	chr11	10124314	10124653	LTR/ERV1	1022	+	170	10124484	49468
chr11	10075016	10275016	harbor1	chr11	10155874	10156636	LTR/ERV1	2193	+	381	10156255	81239
chr11	10075016	10275016	harbor1	chr11	10159098	10159620	LTR/ERV1	5176	+	261	10159359	84343
chr11	10075016	10275016	harbor1	chr11	10159901	10160067	LTR/ERV1	5176	+	83	10159984	84968
chr11	24871415	25071415	harbor1	chr11	24896115	24897737	LTR/ERV1	8635	+	811	24896926	25511
chr11	24871415	25071415	harbor1	chr11	24900524	24900914	LTR/ERV1	2084	+	195	24900719	29304
chr11	24871415	25071415	harbor1	chr11	24901551	24901939	LTR/ERV1	1566	+	194	24901745	30330
chr11	24871415	25071415	harbor1	chr11	24923285	24923414	LTR/ERV1	1300	+	64	24923349	51934
chr11	24871415	25071415	harbor1	chr11	24923685	24924078	LTR/ERV1	1851	+	196	24923881	52466
chr11	24871415	25071415	harbor1	chr11	24924378	24924556	LTR/ERV1	1851	+	89	24924467	53052
chr11	41932777	42132777	harbor1	chr11	41978959	41979496	LTR/ERV1	3250	+	268	41979227	46450
chr11	23453809	23653809	harbor1	chr11	23490588	23491196	LTR/ERV1	3776	+	304	23490892	37083
chr11	23453809	23653809	harbor1	chr11	23491197	23491625	LTR/ERV1	1904	+	214	23491411	37602
chr11	23453809	23653809	harbor1	chr11	23492026	23492191	LTR/ERV1	1222	+	82	23492108	38299
chr11	23453809	23653809	harbor1	chr11	23492192	23492459	LTR/ERV1	1476	+	134	23492326	38517
chr11	23453809	23653809	harbor1	chr11	23492808	23493312	LTR/ERV1	2010	+	252	23493060	39251
chr11	23453809	23653809	harbor1	chr11	23507316	23508029	LTR/ERV1	4212	+	356	23507672	53863
chr11	23453809	23653809	harbor1	chr11	23518953	23519654	LTR/ERV1	1353	+	350	23519303	65494
chr11	23453809	23653809	harbor1	chr11	23541649	23542112	LTR/ERV1	3696	+	232	23541881	88072
chr11	75091837	75291837	harbor1	chr11	75098024	75099502	LTR/ERV1	9406	+	739	75098763	6926
chr11	75091837	75291837	harbor1	chr11	75112863	75113051	LTR/ERV1	2542	+	94	75112957	21120
chr11	75091837	75291837	harbor1	chr11	75113431	75113786	LTR/ERV1	2542	+	178	75113609	21772
chr11	75091837	75291837	harbor1	chr11	75145895	75146755	LTR/ERV1	5341	+	430	75146325	54488
chr11	75091837	75291837	harbor1	chr11	75147038	75147090	LTR/ERV1	5341	+	26	75147064	55227
chr11	13371929	13571929	harbor1	chr11	13433131	13433346	LTR/ERV1	772	+	108	13433239	61310
chr11	13371929	13571929	harbor1	chr11	13468886	13468957	LTR/ERV1	416	+	36	13468922	96993
chr11	13371929	13571929	harbor1	chr11	13468958	13469391	LTR/ERV1	1946	+	216	13469174	97245
chr11	13371929	13571929	harbor1	chr11	13469398	13470702	LTR/ERV1	4813	+	652	13470050	98121
chr11	39370326	39570326	harbor1	chr11	39371257	39371437	LTR/ERV1	426	+	90	39371347	1021
chr11	39370326	39570326	harbor1	chr11	39372579	39372765	LTR/ERV1	1167	+	93	39372672	2346
chr11	39370326	39570326	harbor1	chr11	39372753	39372833	LTR/ERV1	572	+	40	39372793	2467
chr11	39370326	39570326	harbor1	chr11	39373204	39373451	LTR/ERV1	1845	+	124	39373328	3002
chr11	39370326	39570326	harbor1	chr11	39373744	39373952	LTR/ERV1	1845	+	104	39373848	3522
chr11	39370326	39570326	harbor1	chr11	39443900	39444336	LTR/ERV1	1919	+	218	39444118	73792
chr11	39370326	39570326	harbor1	chr11	39445380	39445802	LTR/ERV1	1873	+	211	39445591	75265
chr11	2776723	2976723	harbor1	chr11	2857536	2857849	LTR/ERV1	745	+	156	2857692	80969
chr11	97644035	97844035	harbor1	chr11	97645277	97645934	LTR/ERV1	3300	+	328	97645605	1570
chr11	97644035	97844035	harbor1	chr11	97666909	97668296	LTR/ERV1	8087	+	694	97667603	23568
chr11	97644035	97844035	harbor1	chr11	97703239	97703620	LTR/ERV1	1655	+	190	97703429	59394
chr11	97644035	97844035	harbor1	chr11	97743304	97743752	LTR/ERV1	2183	+	224	97743528	99493
chr11	101819670	102019670	harbor1	chr11	101878989	101879438	LTR/ERV1	3034	+	224	101879213	59543
chr11	101819670	102019670	harbor1	chr11	101909775	101910109	LTR/ERV1	1755	+	167	101909942	90272
chr11	101819670	102019670	harbor1	chr11	101912681	101913575	LTR/ERV1	5248	+	447	101913128	93458
chr11	36393814	36593814	harbor1	chr11	36477595	36478059	LTR/ERV1	1606	+	232	36477827	84013
chr11	36393814	36593814	harbor1	chr11	36479229	36479541	LTR/ERV1	1282	+	156	36479385	85571
chr11	43874803	44074803	harbor1	chr11	43949396	43949532	LTR/ERV1	4460	+	68	43949464	74661
chr11	43874803	44074803	harbor1	chr11	43949862	43950385	LTR/ERV1	4460	+	262	43950124	75321
chr11	43874803	44074803	harbor1	chr11	43952351	43952803	LTR/ERV1	3575	+	226	43952577	77774
chr11	43874803	44074803	harbor1	chr11	43953062	43953233	LTR/ERV1	4178	+	86	43953148	78345
chr11	43874803	44074803	harbor1	chr11	43953541	43953988	LTR/ERV1	4178	+	224	43953765	78962
chr11	43874803	44074803	harbor1	chr11	43961752	43962088	LTR/ERV1	2263	+	168	43961920	87117
chr11	43874803	44074803	harbor1	chr11	43957922	43958628	LTR/ERV1	2882	+	353	43958275	83472
chr11	48191767	48391767	harbor1	chr11	48191902	48192353	LTR/ERV1	3300	+	226	48192128	361
chr11	48191767	48391767	harbor1	chr11	48228736	48230442	LTR/ERV1	9861	+	853	48229589	37822
chr11	48191767	48391767	harbor1	chr11	48291080	48291363	LTR/ERV1	936	+	142	48291222	99455
chr11	48191767	48391767	harbor1	chr11	48291368	48291868	LTR/ERV1	2899	+	250	48291618	99851
chr11	26384208	26584208	harbor1	chr11	26478652	26479011	LTR/ERV1	1028	+	180	26478832	94624
chr11	122003914	122203914	harbor1	chr11	122025804	122026262	LTR/ERV1	1480	+	229	122026033	22119
chr11	102896820	103096820	harbor1	chr11	102911690	102911953	LTR/ERV1	1421	+	132	102911822	15002
chr11	102896820	103096820	harbor1	chr11	102911954	102912394	LTR/ERV1	2453	+	220	102912174	15354
chr11	102896820	103096820	harbor1	chr11	102912395	102912429	LTR/ERV1	1421	+	17	102912412	15592
chr11	102896820	103096820	harbor1	chr11	102964477	102965231	LTR/ERV1	4046	+	377	102964854	68034
chr11	10748739	10948739	harbor1	chr11	10758604	10759044	LTR/ERV1	2215	+	220	10758824	10085
chr11	39900897	40100897	harbor1	chr11	39962223	39962624	LTR/ERV1	1161	+	200	39962423	61526
chr11	39900897	40100897	harbor1	chr11	39964998	39965712	LTR/ERV1	4177	+	357	39965355	64458
chr11	39900897	40100897	harbor1	chr11	39965720	39966445	LTR/ERV1	3729	+	362	39966082	65185
chr11	39900897	40100897	harbor1	chr11	39966447	39966589	LTR/ERV1	615	+	71	39966518	65621
chr11	39900897	40100897	harbor1	chr11	39966589	39967186	LTR/ERV1	3874	+	298	39966887	65990
chr11	39900897	40100897	harbor1	chr11	39967469	39968169	LTR/ERV1	3874	+	350	39967819	66922
chr11	39900897	40100897	harbor1	chr11	39968170	39968820	LTR/ERV1	3868	+	325	39968495	67598
chr11	39900897	40100897	harbor1	chr11	39969494	39970118	LTR/ERV1	3762	+	312	39969806	68909
chr11	39900897	40100897	harbor1	chr11	39971199	39971596	LTR/ERV1	2440	+	198	39971397	70500
chr11	39900897	40100897	harbor1	chr11	39972089	39972247	LTR/ERV1	2440	+	79	39972168	71271
chr11	39900897	40100897	harbor1	chr11	39990247	39990948	LTR/ERV1	4846	+	350	39990597	89700
chr11	39900897	40100897	harbor1	chr11	39999650	40000000	LTR/ERV1	2556	+	175	39999825	98928
chr11	39900897	40100897	harbor1	chr11	40000001	40000099	LTR/ERV1	792	+	49	40000050	99153
chr11	127802337	128002337	harbor1	chr11	127896988	127897539	LTR/ERV1	2765	+	276	127897264	94927
chr11	60363582	60563582	harbor1	chr11	60364270	60364473	LTR/ERV1	483	+	102	60364372	790
chr11	60363582	60563582	harbor1	chr11	60365434	60365774	LTR/ERV1	539	+	170	60365604	2022
chr11	60363582	60563582	harbor1	chr11	60367665	60368397	LTR/ERV1	5077	+	366	60368031	4449
chr11	60363582	60563582	harbor1	chr11	60369324	60370049	LTR/ERV1	4033	+	362	60369686	6104
chr11	60363582	60563582	harbor1	chr11	60373565	60374353	LTR/ERV1	5406	+	394	60373959	10377
chr11	19057301	19257301	harbor1	chr11	19073794	19074435	LTR/ERV1	4521	+	320	19074114	16813
chr11	3410716	3610716	harbor1	chr11	3439530	3439684	LTR/ERV1	441	+	77	3439607	28891
chr11	3410716	3610716	harbor1	chr11	3464733	3464806	LTR/ERV1	421	+	36	3464769	54053
chr11	3410716	3610716	harbor1	chr11	3507050	3507092	LTR/ERV1	2930	+	21	3507071	96355
chr11	3410716	3610716	harbor1	chr11	3507376	3507812	LTR/ERV1	2930	+	218	3507594	96878
chr12	104538620	104738620	harbor1	chr12	104608241	104608662	LTR/ERV1	2932	+	210	104608451	69831
chr12	34153109	34353109	harbor1	chr12	34175220	34175359	LTR/ERV1	713	+	70	34175290	22181
chr12	34153109	34353109	harbor1	chr12	34199750	34200615	LTR/ERV1	6024	+	432	34200182	47073
chr12	34153109	34353109	harbor1	chr12	34201227	34201277	LTR/ERV1	6024	+	25	34201252	48143
chr12	34153109	34353109	harbor1	chr12	34201567	34201750	LTR/ERV1	6024	+	92	34201659	48550
chr12	34153109	34353109	harbor1	chr12	34201778	34202314	LTR/ERV1	3155	+	268	34202046	48937
chr12	34153109	34353109	harbor1	chr12	34212060	34212277	LTR/ERV1	1213	+	108	34212168	59059
chr12	119676439	119876439	harbor1	chr12	119707376	119707536	LTR/ERV1	2120	+	80	119707456	31017
chr12	119676439	119876439	harbor1	chr12	119707800	119708084	LTR/ERV1	2120	+	142	119707942	31503
chr12	68286996	68486996	harbor1	chr12	68352094	68352199	LTR/ERV1	670	+	52	68352146	65150
chr12	68286996	68486996	harbor1	chr12	68352200	68352738	LTR/ERV1	3886	+	269	68352469	65473
chr12	77103330	77303330	harbor1	chr12	77181126	77181277	LTR/ERV1	935	+	76	77181202	77872
chr12	34157451	34357451	harbor1	chr12	34175220	34175359	LTR/ERV1	713	+	70	34175290	17839
chr12	34157451	34357451	harbor1	chr12	34199750	34200615	LTR/ERV1	6024	+	432	34200182	42731
chr12	34157451	34357451	harbor1	chr12	34201227	34201277	LTR/ERV1	6024	+	25	34201252	43801
chr12	34157451	34357451	harbor1	chr12	34201567	34201750	LTR/ERV1	6024	+	92	34201659	44208
chr12	34157451	34357451	harbor1	chr12	34201778	34202314	LTR/ERV1	3155	+	268	34202046	44595
chr12	34157451	34357451	harbor1	chr12	34212060	34212277	LTR/ERV1	1213	+	108	34212168	54717
chr12	99489484	99689484	harbor1	chr12	99549763	99549856	LTR/ERV1	490	+	46	99549809	60325
chr12	99489484	99689484	harbor1	chr12	99549945	99550115	LTR/ERV1	654	+	85	99550030	60546
chr12	61608699	61808699	harbor1	chr12	61636870	61637504	LTR/ERV1	3460	+	317	61637187	28488
chr12	61608699	61808699	harbor1	chr12	61647465	61648162	LTR/ERV1	3832	+	348	61647813	39114
chr12	61608699	61808699	harbor1	chr12	61693959	61694345	LTR/ERV1	1870	+	193	61694152	85453
chr12	61608699	61808699	harbor1	chr12	61694422	61695774	LTR/ERV1	5067	+	676	61695098	86399
chr12	61608699	61808699	harbor1	chr12	61695772	61699466	LTR/ERV1	11549	+	1847	61697619	88920
chr12	61608699	61808699	harbor1	chr12	61699477	61699920	LTR/ERV1	2452	+	222	61699699	91000
chr12	38387296	38587296	harbor1	chr12	38417103	38417645	LTR/ERV1	2969	+	271	38417374	30078
chr12	38387296	38587296	harbor1	chr12	38441769	38443353	LTR/ERV1	11106	+	792	38442561	55265
chr12	38387296	38587296	harbor1	chr12	38458410	38458920	LTR/ERV1	2026	+	255	38458665	71369
chr12	38387296	38587296	harbor1	chr12	38471581	38473789	LTR/ERV1	18758	+	1104	38472685	85389
chr12	38387296	38587296	harbor1	chr12	38473812	38474098	LTR/ERV1	2357	+	143	38473955	86659
chr12	38387296	38587296	harbor1	chr12	38474099	38474423	LTR/ERV1	2430	+	162	38474261	86965
chr12	85382035	85582035	harbor1	chr12	85456372	85457159	LTR/ERV1	4642	+	394	85456766	74731
chr12	65031211	65231211	harbor1	chr12	65092999	65093269	LTR/ERV1	521	+	135	65093134	61923
chr12	22561062	22761062	harbor1	chr12	22569088	22569206	LTR/ERV1	597	+	59	22569147	8085
chr12	22561062	22761062	harbor1	chr12	22583465	22584036	LTR/ERV1	2124	+	286	22583751	22689
chr12	22561062	22761062	harbor1	chr12	22613580	22614128	LTR/ERV1	4169	+	274	22613854	52792
chr12	22561062	22761062	harbor1	chr12	22614216	22615180	LTR/ERV1	5526	+	482	22614698	53636
chr12	22561062	22761062	harbor1	chr12	22615220	22615521	LTR/ERV1	5159	+	150	22615370	54308
chr12	22561062	22761062	harbor1	chr12	22615824	22616724	LTR/ERV1	12210	+	450	22616274	55212
chr12	22561062	22761062	harbor1	chr12	22617032	22618469	LTR/ERV1	12210	+	718	22617750	56688
chr12	22561062	22761062	harbor1	chr12	22618555	22618952	LTR/ERV1	2939	+	198	22618753	57691
chr12	22561062	22761062	harbor1	chr12	22619705	22619803	LTR/ERV1	680	+	49	22619754	58692
chr12	32480134	32680134	harbor1	chr12	32525491	32526918	LTR/ERV1	9384	+	714	32526205	46071
chr12	32480134	32680134	harbor1	chr12	32566889	32567325	LTR/ERV1	2682	+	218	32567107	86973
chr12	31794778	31994778	harbor1	chr12	31804038	31804343	LTR/ERV1	476	+	152	31804190	9412
chr12	31794778	31994778	harbor1	chr12	31806481	31807069	LTR/ERV1	2845	+	294	31806775	11997
chr12	31794778	31994778	harbor1	chr12	31807215	31807647	LTR/ERV1	2448	+	216	31807431	12653
chr12	31794778	31994778	harbor1	chr12	31808014	31808639	LTR/ERV1	5934	+	312	31808326	13548
chr12	31794778	31994778	harbor1	chr12	31808941	31809078	LTR/ERV1	5934	+	68	31809009	14231
chr12	31794778	31994778	harbor1	chr12	31827127	31827225	LTR/ERV1	477	+	49	31827176	32398
chr12	31794778	31994778	harbor1	chr12	31827880	31828087	LTR/ERV1	1197	+	104	31827984	33206
chr12	31794778	31994778	harbor1	chr12	31838046	31838086	LTR/ERV1	593	+	20	31838066	43288
chr12	31794778	31994778	harbor1	chr12	31838428	31838655	LTR/ERV1	593	+	114	31838542	43764
chr12	31794778	31994778	harbor1	chr12	31843362	31843692	LTR/ERV1	1114	+	165	31843527	48749
chr12	31794778	31994778	harbor1	chr12	31844030	31844048	LTR/ERV1	1114	+	9	31844039	49261
chr12	31794778	31994778	harbor1	chr12	31847621	31847853	LTR/ERV1	1825	+	116	31847737	52959
chr12	31794778	31994778	harbor1	chr12	31847939	31848698	LTR/ERV1	5111	+	380	31848319	53541
chr12	31794778	31994778	harbor1	chr12	31848699	31848742	LTR/ERV1	7985	+	22	31848721	53943
chr12	31794778	31994778	harbor1	chr12	31851849	31852013	LTR/ERV1	8906	+	82	31851931	57153
chr12	31794778	31994778	harbor1	chr12	31852014	31852561	LTR/ERV1	3955	+	274	31852288	57510
chr12	31794778	31994778	harbor1	chr12	31868622	31868977	LTR/ERV1	723	+	178	31868800	74022
chr12	31794778	31994778	harbor1	chr12	31872766	31872846	LTR/ERV1	743	+	40	31872806	78028
chr12	31794778	31994778	harbor1	chr12	31873646	31873712	LTR/ERV1	743	+	33	31873679	78901
chr12	31794778	31994778	harbor1	chr12	31874192	31874456	LTR/ERV1	1498	+	132	31874324	79546
chr12	31794778	31994778	harbor1	chr12	31875809	31875911	LTR/ERV1	552	+	51	31875860	81082
chr12	31794778	31994778	harbor1	chr12	31876563	31876676	LTR/ERV1	565	+	56	31876619	81841
chr12	31794778	31994778	harbor1	chr12	31887198	31887704	LTR/ERV1	3228	+	253	31887451	92673
chr12	31794778	31994778	harbor1	chr12	31882706	31883387	LTR/ERV1	4674	+	340	31883046	88268
chr12	31794778	31994778	harbor1	chr12	31849053	31851541	LTR/ERV1	8906	+	1244	31850297	55519
chr12	102651203	102851203	harbor1	chr12	102671508	102671806	LTR/ERV1	596	+	149	102671657	20454
chr12	81370162	81570162	harbor1	chr12	81403468	81404106	LTR/ERV1	3717	+	319	81403787	33625
chr12	81370162	81570162	harbor1	chr12	81395427	81396075	LTR/ERV1	1747	+	324	81395751	25589
chr12	73162888	73362888	harbor1	chr12	73162817	73163408	LTR/ERV1	2712	+	296	73163113	225
chr12	73162888	73362888	harbor1	chr12	73163557	73163854	LTR/ERV1	1247	+	148	73163705	817
chr12	73162888	73362888	harbor1	chr12	73163905	73164836	LTR/ERV1	5930	+	466	73164371	1483
chr12	73162888	73362888	harbor1	chr12	73164838	73165584	LTR/ERV1	4935	+	373	73165211	2323
chr12	73162888	73362888	harbor1	chr12	73165817	73166723	LTR/ERV1	4935	+	453	73166270	3382
chr12	73162888	73362888	harbor1	chr12	73166727	73167915	LTR/ERV1	6782	+	594	73167321	4433
chr12	73162888	73362888	harbor1	chr12	73169614	73170192	LTR/ERV1	4457	+	289	73169903	7015
chr12	73162888	73362888	harbor1	chr12	73170499	73170661	LTR/ERV1	4457	+	81	73170580	7692
chr12	73162888	73362888	harbor1	chr12	73170634	73170738	LTR/ERV1	526	+	52	73170686	7798
chr12	73162888	73362888	harbor1	chr12	73173404	73173612	LTR/ERV1	1099	+	104	73173508	10620
chr12	73162888	73362888	harbor1	chr12	73170746	73171216	LTR/ERV1	3390	+	235	73170981	8093
chr12	96371388	96571388	harbor1	chr12	96376039	96376424	LTR/ERV1	1355	+	192	96376231	4843
chr12	96371388	96571388	harbor1	chr12	96431615	96431945	LTR/ERV1	2541	+	165	96431780	60392
chr12	96371388	96571388	harbor1	chr12	96432412	96432730	LTR/ERV1	2347	+	159	96432571	61183
chr12	80764436	80964436	harbor1	chr12	80766919	80767689	LTR/ERV1	3204	+	385	80767304	2868
chr12	80764436	80964436	harbor1	chr12	80781055	80781430	LTR/ERV1	1955	+	188	80781243	16807
chr12	80764436	80964436	harbor1	chr12	80781440	80781738	LTR/ERV1	4669	+	149	80781589	17153
chr12	80764436	80964436	harbor1	chr12	80781803	80782251	LTR/ERV1	4669	+	224	80782027	17591
chr12	80764436	80964436	harbor1	chr12	80782750	80783107	LTR/ERV1	4669	+	178	80782928	18492
chr12	80764436	80964436	harbor1	chr12	80789702	80790457	LTR/ERV1	5816	+	378	80790080	25644
chr12	80764436	80964436	harbor1	chr12	80790458	80791969	LTR/ERV1	12695	+	756	80791214	26778
chr12	80764436	80964436	harbor1	chr12	80822588	80823742	LTR/ERV1	5402	+	577	80823165	58729
chr12	80764436	80964436	harbor1	chr12	80788893	80789701	LTR/ERV1	12695	+	404	80789297	24861
chr12	80764436	80964436	harbor1	chr12	80821590	80822276	LTR/ERV1	5402	+	343	80821933	57497
chr12	12657799	12857799	harbor1	chr12	12667935	12668371	LTR/ERV1	1906	+	218	12668153	10354
chr12	12657799	12857799	harbor1	chr12	12749303	12749933	LTR/ERV1	3653	+	315	12749618	91819
chr12	95785092	95985092	harbor1	chr12	95800564	95800917	LTR/ERV1	2459	+	176	95800740	15648
chr12	95785092	95985092	harbor1	chr12	95854298	95854927	LTR/ERV1	2151	+	314	95854612	69520
chr12	95785092	95985092	harbor1	chr12	95857239	95857408	LTR/ERV1	769	+	84	95857323	72231
chr12	95785092	95985092	harbor1	chr12	95857405	95857614	LTR/ERV1	1291	+	104	95857509	72417
chr12	95785092	95985092	harbor1	chr12	95876841	95877490	LTR/ERV1	5505	+	324	95877165	92073
chr12	32290100	32490100	harbor1	chr12	32290484	32290932	LTR/ERV1	1831	+	224	32290708	608
chr12	61338506	61538506	harbor1	chr12	61354938	61355379	LTR/ERV1	1100	+	220	61355158	16652
chr12	61338506	61538506	harbor1	chr12	61357224	61357839	LTR/ERV1	2276	+	308	61357532	19026
chr12	61338506	61538506	harbor1	chr12	61359613	61360091	LTR/ERV1	4245	+	239	61359852	21346
chr12	61338506	61538506	harbor1	chr12	61360394	61360556	LTR/ERV1	4245	+	81	61360475	21969
chr12	61338506	61538506	harbor1	chr12	61390928	61391235	LTR/ERV1	967	+	154	61391082	52576
chr12	55517876	55717876	harbor1	chr12	55616597	55617312	LTR/ERV1	3673	+	358	55616955	99079
chr12	87889665	88089665	harbor1	chr12	87895418	87896124	LTR/ERV1	3625	+	353	87895771	6106
chr12	108361043	108561043	harbor1	chr12	108439527	108439728	LTR/ERV1	5311	+	100	108439627	78584
chr12	108361043	108561043	harbor1	chr12	108439729	108440278	LTR/ERV1	3997	+	274	108440003	78960
chr12	108361043	108561043	harbor1	chr12	108440279	108440415	LTR/ERV1	5311	+	68	108440347	79304
chr12	108361043	108561043	harbor1	chr12	108440705	108441042	LTR/ERV1	5311	+	168	108440873	79830
chr12	108361043	108561043	harbor1	chr12	108441346	108441598	LTR/ERV1	5311	+	126	108441472	80429
chr12	108361043	108561043	harbor1	chr12	108442921	108443387	LTR/ERV1	3242	+	233	108443154	82111
chr12	108361043	108561043	harbor1	chr12	108447529	108447797	LTR/ERV1	1575	+	134	108447663	86620
chr12	108361043	108561043	harbor1	chr12	108448078	108448330	LTR/ERV1	1575	+	126	108448204	87161
chr12	108361043	108561043	harbor1	chr12	108454729	108455287	LTR/ERV1	4265	+	279	108455008	93965
chr12	5069188	5269188	harbor1	chr12	5132945	5133294	LTR/ERV1	948	+	174	5133119	63931
chr12	46058399	46258399	harbor1	chr12	46089317	46089817	LTR/ERV1	772	+	250	46089567	31168
chr12	46058399	46258399	harbor1	chr12	46089895	46090225	LTR/ERV1	732	+	165	46090060	31661
chr12	46058399	46258399	harbor1	chr12	46090550	46093142	LTR/ERV1	2653	+	1296	46091846	33447
chr12	46058399	46258399	harbor1	chr12	46093431	46095133	LTR/ERV1	1808	+	851	46094282	35883
chr12	46058399	46258399	harbor1	chr12	46101491	46101830	LTR/ERV1	628	+	170	46101661	43262
chr12	46058399	46258399	harbor1	chr12	46101829	46102622	LTR/ERV1	4724	+	396	46102225	43826
chr12	46058399	46258399	harbor1	chr12	46131965	46132498	LTR/ERV1	2022	+	266	46132231	73832
chr12	85415745	85615745	harbor1	chr12	85456372	85457159	LTR/ERV1	4642	+	394	85456766	41021
chr12	60419568	60619568	harbor1	chr12	60434906	60435066	LTR/ERV1	628	+	80	60434986	15418
chr12	60419568	60619568	harbor1	chr12	60439627	60439806	LTR/ERV1	651	+	90	60439717	20149
chr12	60419568	60619568	harbor1	chr12	60445073	60445163	LTR/ERV1	587	+	45	60445118	25550
chr12	60419568	60619568	harbor1	chr12	60445167	60445894	LTR/ERV1	3500	+	364	60445531	25963
chr12	60419568	60619568	harbor1	chr12	60517375	60517606	LTR/ERV1	729	+	116	60517491	97923
chr12	60419568	60619568	harbor1	chr12	60517657	60517946	LTR/ERV1	1386	+	144	60517801	98233
chr12	60419568	60619568	harbor1	chr12	60440337	60440728	LTR/ERV1	2064	+	196	60440533	20965
chr12	124732339	124932339	harbor1	chr12	124787494	124787735	LTR/ERV1	1016	+	120	124787614	55275
chr12	128407263	128607263	harbor1	chr12	128430325	128430529	LTR/ERV1	2421	+	102	128430427	23164
chr12	128407263	128607263	harbor1	chr12	128433281	128433510	LTR/ERV1	2421	+	114	128433395	26132
chr12	72110170	72310170	harbor1	chr12	72139740	72140617	LTR/ERV1	5276	+	438	72140178	30008
chr12	72110170	72310170	harbor1	chr12	72141807	72142499	LTR/ERV1	3993	+	346	72142153	31983
chr12	72110170	72310170	harbor1	chr12	72142507	72143296	LTR/ERV1	4759	+	394	72142901	32731
chr12	72110170	72310170	harbor1	chr12	72184857	72186604	LTR/ERV1	9982	+	874	72185731	75561
chr12	81374628	81574628	harbor1	chr12	81403468	81404106	LTR/ERV1	3717	+	319	81403787	29159
chr12	81374628	81574628	harbor1	chr12	81395427	81396075	LTR/ERV1	1747	+	324	81395751	21123
chr12	128863198	129063198	harbor1	chr12	128889632	128889766	LTR/ERV1	1484	+	67	128889699	26501
chr12	128863198	129063198	harbor1	chr12	128890074	128890371	LTR/ERV1	1484	+	148	128890222	27024
chr12	25068913	25268913	harbor1	chr12	25160292	25160795	LTR/ERV1	3402	+	252	25160544	91631
chr12	25068913	25268913	harbor1	chr12	25163213	25163626	LTR/ERV1	2351	+	206	25163419	94506
chr12	25068913	25268913	harbor1	chr12	25166543	25166690	LTR/ERV1	883	+	74	25166617	97704
chr12	25068913	25268913	harbor1	chr12	25166681	25167178	LTR/ERV1	3255	+	248	25166929	98016
chr12	25068913	25268913	harbor1	chr12	25167181	25167370	LTR/ERV1	1272	+	94	25167275	98362
chr12	25068913	25268913	harbor1	chr12	25167357	25167968	LTR/ERV1	4413	+	306	25167663	98750
chr12	25068913	25268913	harbor1	chr12	25167942	25169105	LTR/ERV1	8176	+	582	25168524	99611
chr12	25068913	25268913	harbor1	chr12	25163629	25166563	LTR/ERV1	14420	+	1467	25165096	96183
chr12	67448011	67648011	harbor1	chr12	67513769	67514168	LTR/ERV1	951	+	200	67513969	65958
chr12	98035455	98235455	harbor1	chr12	98056668	98057090	LTR/ERV1	2141	+	211	98056879	21424
chr12	43917586	44117586	harbor1	chr12	43950568	43950724	LTR/ERV1	1060	+	78	43950646	33060
chr12	44443450	44643450	harbor1	chr12	44449829	44450051	LTR/ERV1	1398	+	111	44449940	6490
chr12	44443450	44643450	harbor1	chr12	44450052	44450463	LTR/ERV1	2626	+	206	44450258	6808
chr12	44443450	44643450	harbor1	chr12	44450466	44450933	LTR/ERV1	2913	+	234	44450700	7250
chr12	44443450	44643450	harbor1	chr12	44450988	44453198	LTR/ERV1	13974	+	1105	44452093	8643
chr12	44443450	44643450	harbor1	chr12	44453193	44453342	LTR/ERV1	936	+	74	44453267	9817
chr12	44443450	44643450	harbor1	chr12	44453333	44455044	LTR/ERV1	7371	+	856	44454189	10739
chr12	44443450	44643450	harbor1	chr12	44455046	44455278	LTR/ERV1	1215	+	116	44455162	11712
chr12	44443450	44643450	harbor1	chr12	44455279	44455655	LTR/ERV1	2249	+	188	44455467	12017
chr12	44443450	44643450	harbor1	chr12	44455656	44456067	LTR/ERV1	2784	+	206	44455862	12412
chr12	44443450	44643450	harbor1	chr12	44456070	44456390	LTR/ERV1	1511	+	160	44456230	12780
chr12	44443450	44643450	harbor1	chr12	44475471	44476079	LTR/ERV1	4208	+	304	44475775	32325
chr12	44443450	44643450	harbor1	chr12	44476095	44479629	LTR/ERV1	10786	+	1767	44477862	34412
chr12	44443450	44643450	harbor1	chr12	44479625	44479744	LTR/ERV1	686	+	60	44479685	36235
chr12	44443450	44643450	harbor1	chr12	44479734	44481684	LTR/ERV1	13364	+	975	44480709	37259
chr12	44443450	44643450	harbor1	chr12	44500213	44501941	LTR/ERV1	10109	+	864	44501077	57627
chr12	118230630	118430630	harbor1	chr12	118308025	118308407	LTR/ERV1	3110	+	191	118308216	77586
chr12	4973955	5173955	harbor1	chr12	5030029	5030641	LTR/ERV1	1438	+	306	5030335	56380
chr12	130694580	130894580	harbor1	chr12	130749557	130750021	LTR/ERV1	3294	+	232	130749789	55209
chr12	130694580	130894580	harbor1	chr12	130767477	130768033	LTR/ERV1	1033	+	278	130767755	73175
chr12	130694580	130894580	harbor1	chr12	130768071	130768267	LTR/ERV1	1228	+	98	130768169	73589
chr12	130694580	130894580	harbor1	chr12	130768314	130768968	LTR/ERV1	2378	+	327	130768641	74061
chr12	130694580	130894580	harbor1	chr12	130770324	130770460	LTR/ERV1	512	+	68	130770392	75812
chr12	130694580	130894580	harbor1	chr12	130770801	130770953	LTR/ERV1	512	+	76	130770877	76297
chr12	56771697	56971697	harbor1	chr12	56780232	56780577	LTR/ERV1	4436	+	172	56780404	8707
chr12	56771697	56971697	harbor1	chr12	56780865	56781120	LTR/ERV1	4436	+	128	56780993	9296
chr12	56771697	56971697	harbor1	chr12	56839227	56839370	LTR/ERV1	787	+	72	56839299	67602
chr12	56771697	56971697	harbor1	chr12	56839492	56839870	LTR/ERV1	1785	+	189	56839681	67984
chr13	47380733	47580733	harbor1	chr13	47401212	47401328	LTR/ERV1	455	+	58	47401270	20537
chr13	47380733	47580733	harbor1	chr13	47415926	47416066	LTR/ERV1	424	+	70	47415996	35263
chr13	47380733	47580733	harbor1	chr13	47416687	47416872	LTR/ERV1	488	+	92	47416779	36046
chr13	47380733	47580733	harbor1	chr13	47433078	47433651	LTR/ERV1	3364	+	286	47433364	52631
chr13	47380733	47580733	harbor1	chr13	47472546	47472936	LTR/ERV1	1277	+	195	47472741	92008
chr13	81517976	81717976	harbor1	chr13	81520473	81520863	LTR/ERV1	2199	+	195	81520668	2692
chr13	81517976	81717976	harbor1	chr13	81529353	81530042	LTR/ERV1	2603	+	344	81529697	11721
chr13	81517976	81717976	harbor1	chr13	81538674	81539164	LTR/ERV1	1831	+	245	81538919	20943
chr13	81517976	81717976	harbor1	chr13	81542500	81542976	LTR/ERV1	2547	+	238	81542738	24762
chr13	81517976	81717976	harbor1	chr13	81545140	81545558	LTR/ERV1	3101	+	209	81545349	27373
chr13	81517976	81717976	harbor1	chr13	81547709	81547871	LTR/ERV1	3101	+	81	81547790	29814
chr13	81517976	81717976	harbor1	chr13	81584878	81585111	LTR/ERV1	624	+	116	81584994	67018
chr13	81517976	81717976	harbor1	chr13	81591639	81592125	LTR/ERV1	1637	+	243	81591882	73906
chr13	81517976	81717976	harbor1	chr13	81607285	81607602	LTR/ERV1	667	+	158	81607443	89467
chr13	81517976	81717976	harbor1	chr13	81610586	81611105	LTR/ERV1	3571	+	260	81610846	92870
chr13	106769575	106969575	harbor1	chr13	106795682	106796291	LTR/ERV1	3872	+	304	106795986	26411
chr13	106769575	106969575	harbor1	chr13	106857095	106857680	LTR/ERV1	2794	+	292	106857387	87812
chr13	106769575	106969575	harbor1	chr13	106861330	106861621	LTR/ERV1	1067	+	146	106861476	91901
chr13	106769575	106969575	harbor1	chr13	106864892	106865135	LTR/ERV1	626	+	122	106865014	95439
chr13	42854879	43054879	harbor1	chr13	42873542	42874115	LTR/ERV1	940	+	286	42873828	18949
chr13	42854879	43054879	harbor1	chr13	42929255	42929623	LTR/ERV1	1727	+	184	42929439	74560
chr13	42854879	43054879	harbor1	chr13	42944683	42945062	LTR/ERV1	2500	+	190	42944873	89994
chr13	42854879	43054879	harbor1	chr13	42945430	42945499	LTR/ERV1	2500	+	34	42945464	90585
chr13	42854879	43054879	harbor1	chr13	42948869	42949301	LTR/ERV1	1947	+	216	42949085	94206
chr13	42854879	43054879	harbor1	chr13	42951873	42952412	LTR/ERV1	3395	+	270	42952143	97264
chr13	54452533	54652533	harbor1	chr13	54494757	54495204	LTR/ERV1	3043	+	224	54494981	42448
chr13	50456224	50656224	harbor1	chr13	50515844	50516323	LTR/ERV1	1209	+	240	50516084	59860
chr13	50456224	50656224	harbor1	chr13	50532498	50533238	LTR/ERV1	3032	+	370	50532868	76644
chr13	50465187	50665187	harbor1	chr13	50515844	50516323	LTR/ERV1	1209	+	240	50516084	50897
chr13	50465187	50665187	harbor1	chr13	50532498	50533238	LTR/ERV1	3032	+	370	50532868	67681
chr13	84171787	84371787	harbor1	chr13	84251518	84251872	LTR/ERV1	1846	+	177	84251695	79908
chr13	84171787	84371787	harbor1	chr13	84253583	84253911	LTR/ERV1	2175	+	164	84253747	81960
chr13	84171787	84371787	harbor1	chr13	84253914	84254393	LTR/ERV1	3553	+	240	84254154	82367
chr13	84171787	84371787	harbor1	chr13	84254728	84254950	LTR/ERV1	3553	+	111	84254839	83052
chr13	84171787	84371787	harbor1	chr13	84259382	84259621	LTR/ERV1	962	+	120	84259502	87715
chr13	84171787	84371787	harbor1	chr13	84262132	84262488	LTR/ERV1	957	+	178	84262310	90523
chr13	84171787	84371787	harbor1	chr13	84263378	84263618	LTR/ERV1	881	+	120	84263498	91711
chr13	60240675	60440675	harbor1	chr13	60286238	60286359	LTR/ERV1	655	+	60	60286298	45623
chr13	60240675	60440675	harbor1	chr13	60286362	60286387	LTR/ERV1	3095	+	12	60286374	45699
chr13	60240675	60440675	harbor1	chr13	60286684	60287199	LTR/ERV1	3095	+	258	60286942	46267
chr13	85776756	85976756	harbor1	chr13	85823504	85823774	LTR/ERV1	1020	+	135	85823639	46883
chr13	85776756	85976756	harbor1	chr13	85823764	85824269	LTR/ERV1	3035	+	252	85824016	47260
chr13	85776756	85976756	harbor1	chr13	85827155	85827533	LTR/ERV1	1792	+	189	85827344	50588
chr13	85776756	85976756	harbor1	chr13	85853159	85854714	LTR/ERV1	6420	+	778	85853937	77181
chr13	27585286	27785286	harbor1	chr13	27613981	27614679	LTR/ERV1	3536	+	349	27614330	29044
chr13	58732314	58932314	harbor1	chr13	58773221	58774427	LTR/ERV1	7063	+	603	58773824	41510
chr13	19678694	19878694	harbor1	chr13	19756252	19756402	LTR/ERV1	956	+	75	19756327	77633
chr13	19678694	19878694	harbor1	chr13	19756430	19756500	LTR/ERV1	455	+	35	19756465	77771
chr13	19678694	19878694	harbor1	chr13	19756797	19756848	LTR/ERV1	1040	+	26	19756823	78129
chr13	19678694	19878694	harbor1	chr13	19757156	19757518	LTR/ERV1	1822	+	181	19757337	78643
chr13	19678694	19878694	harbor1	chr13	19757519	19757784	LTR/ERV1	1668	+	132	19757651	78957
chr13	31069298	31269298	harbor1	chr13	31098122	31098555	LTR/ERV1	4032	+	216	31098338	29040
chr13	31069298	31269298	harbor1	chr13	31098819	31098938	LTR/ERV1	4032	+	60	31098879	29581
chr13	31069298	31269298	harbor1	chr13	31098939	31099014	LTR/ERV1	412	+	38	31098977	29679
chr13	57278223	57478223	harbor1	chr13	57345306	57346044	LTR/ERV1	2259	+	369	57345675	67452
chr13	57278223	57478223	harbor1	chr13	57348292	57348865	LTR/ERV1	3015	+	286	57348578	70355
chr13	57278223	57478223	harbor1	chr13	57310647	57311535	LTR/ERV1	4168	+	444	57311091	32868
chr13	88101788	88301788	harbor1	chr13	88144366	88145185	LTR/ERV1	5395	+	410	88144776	42988
chr13	88101788	88301788	harbor1	chr13	88148123	88148352	LTR/ERV1	805	+	114	88148237	46449
chr13	88101788	88301788	harbor1	chr13	88173246	88173728	LTR/ERV1	2228	+	241	88173487	71699
chr13	88101788	88301788	harbor1	chr13	88179034	88179421	LTR/ERV1	2547	+	194	88179228	77440
chr13	88101788	88301788	harbor1	chr13	88179772	88180272	LTR/ERV1	1805	+	250	88180022	78234
chr13	88101788	88301788	harbor1	chr13	88183209	88183661	LTR/ERV1	2977	+	226	88183435	81647
chr13	88101788	88301788	harbor1	chr13	88183662	88184342	LTR/ERV1	3208	+	340	88184002	82214
chr13	88101788	88301788	harbor1	chr13	88184343	88184467	LTR/ERV1	2977	+	62	88184405	82617
chr13	88101788	88301788	harbor1	chr13	88184763	88184879	LTR/ERV1	2977	+	58	88184821	83033
chr13	107368824	107568824	harbor1	chr13	107391229	107391989	LTR/ERV1	5050	+	380	107391609	22785
chr13	20762374	20962374	harbor1	chr13	20803795	20804469	LTR/ERV1	2542	+	337	20804132	41758
chr13	20762374	20962374	harbor1	chr13	20841254	20841357	LTR/ERV1	495	+	52	20841306	78932
chr13	50573939	50773939	harbor1	chr13	50635555	50636053	LTR/ERV1	3224	+	249	50635804	61865
chr13	66871436	67071436	harbor1	chr13	66890371	66890876	LTR/ERV1	2072	+	252	66890623	19187
chr13	66871436	67071436	harbor1	chr13	66937536	66937975	LTR/ERV1	2805	+	220	66937756	66320
chr13	66871436	67071436	harbor1	chr13	66944945	66945491	LTR/ERV1	2802	+	273	66945218	73782
chr13	65060734	65260734	harbor1	chr13	65064952	65065485	LTR/ERV1	1232	+	266	65065218	4484
chr13	65060734	65260734	harbor1	chr13	65154069	65154160	LTR/ERV1	460	+	46	65154115	93381
chr13	65060734	65260734	harbor1	chr13	65154161	65154249	LTR/ERV1	2690	+	44	65154205	93471
chr13	65060734	65260734	harbor1	chr13	65154525	65154975	LTR/ERV1	2690	+	225	65154750	94016
chr13	26706345	26906345	harbor1	chr13	26733253	26733807	LTR/ERV1	3180	+	277	26733530	27185
chr13	26706345	26906345	harbor1	chr13	26793016	26793537	LTR/ERV1	1395	+	260	26793276	86931
chr13	26706345	26906345	harbor1	chr13	26795264	26795779	LTR/ERV1	2225	+	258	26795522	89177
chr14	86839072	87039072	harbor1	chr14	86933450	86933818	LTR/ERV1	2005	+	184	86933634	94562
chr14	45694355	45894355	harbor1	chr14	45741647	45741867	LTR/ERV1	464	+	110	45741757	47402
chr14	45694355	45894355	harbor1	chr14	45742415	45742657	LTR/ERV1	666	+	121	45742536	48181
chr14	45694355	45894355	harbor1	chr14	45757638	45758055	LTR/ERV1	2394	+	208	45757846	63491
chr14	45694355	45894355	harbor1	chr14	45785332	45785887	LTR/ERV1	3592	+	278	45785610	91255
chr14	45694355	45894355	harbor1	chr14	45785893	45787573	LTR/ERV1	8411	+	840	45786733	92378
chr14	45694355	45894355	harbor1	chr14	45787639	45787703	LTR/ERV1	2988	+	32	45787671	93316
chr14	45694355	45894355	harbor1	chr14	45788363	45788935	LTR/ERV1	2988	+	286	45788649	94294
chr14	45694355	45894355	harbor1	chr14	45788932	45789269	LTR/ERV1	7799	+	168	45789100	94745
chr14	45694355	45894355	harbor1	chr14	45789563	45793102	LTR/ERV1	18424	+	1770	45791333	96978
chr14	45694355	45894355	harbor1	chr14	45793107	45793724	LTR/ERV1	3645	+	308	45793415	99060
chr14	42637430	42837430	harbor1	chr14	42637521	42637618	LTR/ERV1	462	+	48	42637569	139
chr14	42637430	42837430	harbor1	chr14	42637653	42638999	LTR/ERV1	4804	+	673	42638326	896
chr14	42637430	42837430	harbor1	chr14	42653936	42654450	LTR/ERV1	3437	+	257	42654193	16763
chr14	42637430	42837430	harbor1	chr14	42654455	42654525	LTR/ERV1	731	+	35	42654490	17060
chr14	42637430	42837430	harbor1	chr14	42654551	42655030	LTR/ERV1	2767	+	240	42654791	17361
chr14	42637430	42837430	harbor1	chr14	42655209	42655518	LTR/ERV1	636	+	154	42655363	17933
chr14	42637430	42837430	harbor1	chr14	42655513	42656179	LTR/ERV1	3736	+	333	42655846	18416
chr14	42637430	42837430	harbor1	chr14	42656230	42656719	LTR/ERV1	2233	+	244	42656474	19044
chr14	42637430	42837430	harbor1	chr14	42656798	42657400	LTR/ERV1	3413	+	301	42657099	19669
chr14	42637430	42837430	harbor1	chr14	42657452	42657755	LTR/ERV1	1936	+	152	42657604	20174
chr14	50497871	50697871	harbor1	chr14	50546303	50546837	LTR/ERV1	3249	+	267	50546570	48699
chr14	50497871	50697871	harbor1	chr14	50547078	50547350	LTR/ERV1	3249	+	136	50547214	49343
chr14	103224858	103424858	harbor1	chr14	103242335	103242918	LTR/ERV1	4184	+	292	103242627	17769
chr14	103224858	103424858	harbor1	chr14	103243387	103243577	LTR/ERV1	1229	+	95	103243482	18624
chr14	103224858	103424858	harbor1	chr14	103246367	103246619	LTR/ERV1	2073	+	126	103246493	21635
chr14	103224858	103424858	harbor1	chr14	103246923	103247011	LTR/ERV1	2073	+	44	103246967	22109
chr14	103224858	103424858	harbor1	chr14	103250977	103251626	LTR/ERV1	2714	+	324	103251301	26443
chr14	103224858	103424858	harbor1	chr14	103255902	103255963	LTR/ERV1	2189	+	30	103255932	31074
chr14	103224858	103424858	harbor1	chr14	103256884	103257539	LTR/ERV1	2189	+	328	103257212	32354
chr14	103224858	103424858	harbor1	chr14	103269185	103269547	LTR/ERV1	1827	+	181	103269366	44508
chr14	103224858	103424858	harbor1	chr14	103269548	103270230	LTR/ERV1	3524	+	341	103269889	45031
chr14	103224858	103424858	harbor1	chr14	103251938	103252028	LTR/ERV1	2714	+	45	103251983	27125
chr14	103224858	103424858	harbor1	chr14	103284255	103285130	LTR/ERV1	4331	+	438	103284693	59835
chr14	90701718	90901718	harbor1	chr14	90760985	90761678	LTR/ERV1	4248	+	346	90761331	59613
chr14	90701718	90901718	harbor1	chr14	90776084	90776140	LTR/ERV1	2125	+	28	90776112	74394
chr14	90701718	90901718	harbor1	chr14	90776177	90776464	LTR/ERV1	2125	+	144	90776321	74603
chr14	88641441	88841441	harbor1	chr14	88736609	88737578	LTR/ERV1	3392	+	484	88737093	95652
chr14	95785244	95985244	harbor1	chr14	95845996	95846482	LTR/ERV1	2949	+	243	95846239	60995
chr14	92550386	92750386	harbor1	chr14	92570922	92571319	LTR/ERV1	2602	+	198	92571120	20734
chr14	28452872	28652872	harbor1	chr14	28475790	28476089	LTR/ERV1	1031	+	150	28475940	23068
chr14	28452872	28652872	harbor1	chr14	28476129	28476310	LTR/ERV1	1031	+	90	28476219	23347
chr14	28452872	28652872	harbor1	chr14	28479064	28479181	LTR/ERV1	729	+	58	28479122	26250
chr14	47228817	47428817	harbor1	chr14	47242262	47243807	LTR/ERV1	10508	+	772	47243034	14217
chr14	84416343	84616343	harbor1	chr14	84484370	84485002	LTR/ERV1	4691	+	316	84484686	68343
chr14	33335062	33535062	harbor1	chr14	33366114	33366266	LTR/ERV1	1092	+	76	33366190	31128
chr14	102116315	102316315	harbor1	chr14	102116414	102118271	LTR/ERV1	7284	+	928	102117342	1027
chr14	100289417	100489417	harbor1	chr14	100371865	100372268	LTR/ERV1	2522	+	202	100372067	82650
chr14	61226831	61426831	harbor1	chr14	61235877	61236095	LTR/ERV1	1378	+	109	61235986	9155
chr14	61226831	61426831	harbor1	chr14	61236238	61236429	LTR/ERV1	4099	+	96	61236334	9503
chr14	61226831	61426831	harbor1	chr14	61236736	61237106	LTR/ERV1	4099	+	185	61236921	10090
chr14	61226831	61426831	harbor1	chr14	61237260	61237928	LTR/ERV1	4032	+	334	61237594	10763
chr14	61226831	61426831	harbor1	chr14	61300586	61301215	LTR/ERV1	3665	+	314	61300900	74069
chr14	85133911	85333911	harbor1	chr14	85178779	85179318	LTR/ERV1	3249	+	270	85179049	45138
chr14	85133911	85333911	harbor1	chr14	85179768	85180404	LTR/ERV1	3850	+	318	85180086	46175
chr14	85133911	85333911	harbor1	chr14	85204263	85205198	LTR/ERV1	5771	+	468	85204731	70820
chr14	85133911	85333911	harbor1	chr14	85223533	85224236	LTR/ERV1	1760	+	352	85223885	89974
chr14	85133911	85333911	harbor1	chr14	85226167	85226803	LTR/ERV1	3022	+	318	85226485	92574
chr14	85133911	85333911	harbor1	chr14	85180405	85181045	LTR/ERV1	3946	+	320	85180725	46814
chr14	28306415	28506415	harbor1	chr14	28349284	28349359	LTR/ERV1	937	+	38	28349322	42907
chr14	28306415	28506415	harbor1	chr14	28349663	28349829	LTR/ERV1	937	+	83	28349746	43331
chr14	28306415	28506415	harbor1	chr14	28365108	28365900	LTR/ERV1	4402	+	396	28365504	59089
chr14	104232436	104432436	harbor1	chr14	104304402	104304986	LTR/ERV1	941	+	292	104304694	72258
chr14	72010851	72210851	harbor1	chr14	72010577	72011110	LTR/ERV1	1899	+	266	72010843	8
chr14	72010851	72210851	harbor1	chr14	72036949	72037566	LTR/ERV1	3880	+	308	72037257	26406
chr14	84534303	84734303	harbor1	chr14	84578746	84579552	LTR/ERV1	2927	+	403	84579149	44846
chr14	84534303	84734303	harbor1	chr14	84623060	84623694	LTR/ERV1	1393	+	317	84623377	89074
chr14	79568808	79768808	harbor1	chr14	79631287	79632341	LTR/ERV1	6587	+	527	79631814	63006
chr14	44383951	44583951	harbor1	chr14	44384560	44385957	LTR/ERV1	9693	+	698	44385258	1307
chr14	44383951	44583951	harbor1	chr14	44428520	44429009	LTR/ERV1	2331	+	244	44428764	44813
chr14	44383951	44583951	harbor1	chr14	44429604	44429766	LTR/ERV1	5615	+	81	44429685	45734
chr14	44383951	44583951	harbor1	chr14	44429805	44430630	LTR/ERV1	5615	+	412	44430217	46266
chr14	44383951	44583951	harbor1	chr14	44461809	44462167	LTR/ERV1	2360	+	179	44461988	78037
chr14	44383951	44583951	harbor1	chr14	44432882	44433539	LTR/ERV1	4843	+	328	44433210	49259
chr14	39691917	39891917	harbor1	chr14	39733123	39733889	LTR/ERV1	1856	+	383	39733506	41589
chr14	39691917	39891917	harbor1	chr14	39766851	39767048	LTR/ERV1	495	+	98	39766949	75032
chr14	91191240	91391240	harbor1	chr14	91265964	91266296	LTR/ERV1	1702	+	166	91266130	74890
chr14	25037602	25237602	harbor1	chr14	25091427	25091513	LTR/ERV1	1861	+	43	25091470	53868
chr14	25037602	25237602	harbor1	chr14	25091615	25092058	LTR/ERV1	1861	+	222	25091837	54235
chr14	25037602	25237602	harbor1	chr14	25095022	25095595	LTR/ERV1	3670	+	286	25095308	57706
chr14	25037602	25237602	harbor1	chr14	25116544	25116693	LTR/ERV1	889	+	74	25116618	79016
chr14	24256088	24456088	harbor1	chr14	24282998	24283307	LTR/ERV1	2394	+	154	24283152	27064
chr14	24256088	24456088	harbor1	chr14	24283622	24283846	LTR/ERV1	2394	+	112	24283734	27646
chr14	65752844	65952844	harbor1	chr14	65774452	65774596	LTR/ERV1	676	+	72	65774524	21680
chr14	65752844	65952844	harbor1	chr14	65775416	65775659	LTR/ERV1	470	+	122	65775538	22694
chr14	65752844	65952844	harbor1	chr14	65775647	65775947	LTR/ERV1	1249	+	150	65775797	22953
chr14	65752844	65952844	harbor1	chr14	65826950	65827536	LTR/ERV1	1949	+	293	65827243	74399
chr14	95003267	95203267	harbor1	chr14	95003645	95003802	LTR/ERV1	595	+	78	95003723	456
chr14	87928004	88128004	harbor1	chr14	87961884	87962216	LTR/ERV1	911	+	166	87962050	34046
chr14	87928004	88128004	harbor1	chr14	87962633	87963037	LTR/ERV1	1341	+	202	87962835	34831
chr14	87928004	88128004	harbor1	chr14	87963059	87963329	LTR/ERV1	846	+	135	87963194	35190
chr14	87928004	88128004	harbor1	chr14	87964686	87964971	LTR/ERV1	503	+	142	87964828	36824
chr14	87928004	88128004	harbor1	chr14	87993758	87994259	LTR/ERV1	2225	+	250	87994008	66004
chr14	87928004	88128004	harbor1	chr14	88015911	88016833	LTR/ERV1	5103	+	461	88016372	88368
chr14	87928004	88128004	harbor1	chr14	88019374	88019623	LTR/ERV1	1524	+	124	88019498	91494
chr14	87928004	88128004	harbor1	chr14	88020398	88020793	LTR/ERV1	2602	+	198	88020596	92592
chr14	84504713	84704713	harbor1	chr14	84578746	84579552	LTR/ERV1	2927	+	403	84579149	74436
chr14	42419640	42619640	harbor1	chr14	42429424	42429907	LTR/ERV1	2607	+	242	42429666	10026
chr14	42419640	42619640	harbor1	chr14	42459820	42460162	LTR/ERV1	2017	+	171	42459991	40351
chr14	44219092	44419092	harbor1	chr14	44260731	44261199	LTR/ERV1	2489	+	234	44260965	41873
chr14	44219092	44419092	harbor1	chr14	44289949	44290606	LTR/ERV1	2850	+	328	44290277	71185
chr14	44219092	44419092	harbor1	chr14	44301618	44302215	LTR/ERV1	3606	+	298	44301916	82824
chr14	44219092	44419092	harbor1	chr14	44309187	44309906	LTR/ERV1	2990	+	360	44309547	90455
chr14	50870008	51070008	harbor1	chr14	50893162	50893610	LTR/ERV1	3428	+	224	50893386	23378
chr14	50870008	51070008	harbor1	chr14	50893613	50896276	LTR/ERV1	19060	+	1332	50894945	24937
chr14	50870008	51070008	harbor1	chr14	50896276	50896391	LTR/ERV1	824	+	58	50896334	26326
chr14	50870008	51070008	harbor1	chr14	50896392	50896882	LTR/ERV1	2796	+	245	50896637	26629
chr14	50870008	51070008	harbor1	chr14	50937977	50938143	LTR/ERV1	1327	+	83	50938060	68052
chr14	50870008	51070008	harbor1	chr14	50938512	50938628	LTR/ERV1	790	+	58	50938570	68562
chr14	50870008	51070008	harbor1	chr14	50952720	50953181	LTR/ERV1	3678	+	230	50952950	82942
chr14	50870008	51070008	harbor1	chr14	50967833	50968171	LTR/ERV1	3458	+	169	50968002	97994
chr14	50870008	51070008	harbor1	chr14	50968479	50968702	LTR/ERV1	3458	+	112	50968591	98583
chr14	67764800	67964800	harbor1	chr14	67818274	67819003	LTR/ERV1	3500	+	364	67818638	53838
chr14	53528894	53728894	harbor1	chr14	53581575	53582090	LTR/ERV1	3346	+	258	53581833	52939
chr14	49916153	50116153	harbor1	chr14	50004771	50004964	LTR/ERV1	691	+	96	50004867	88714
chr14	70671528	70871528	harbor1	chr14	70708672	70709317	LTR/ERV1	4190	+	322	70708994	37466
chr14	26240929	26440929	harbor1	chr14	26259723	26260179	LTR/ERV1	3797	+	228	26259951	19022
chr14	26240929	26440929	harbor1	chr14	26260198	26261009	LTR/ERV1	5831	+	406	26260604	19675
chr14	88015852	88215852	harbor1	chr14	88015911	88016833	LTR/ERV1	5103	+	461	88016372	520
chr14	88015852	88215852	harbor1	chr14	88019374	88019623	LTR/ERV1	1524	+	124	88019498	3646
chr14	88015852	88215852	harbor1	chr14	88020398	88020793	LTR/ERV1	2602	+	198	88020596	4744
chr14	55407632	55607632	harbor1	chr14	55484251	55484330	LTR/ERV1	953	+	40	55484291	76659
chr14	55407632	55607632	harbor1	chr14	55484388	55484785	LTR/ERV1	953	+	198	55484586	76954
chr14	55407632	55607632	harbor1	chr14	55484801	55485014	LTR/ERV1	725	+	106	55484907	77275
chr14	55407632	55607632	harbor1	chr14	55500002	55500608	LTR/ERV1	3694	+	303	55500305	92673
chr14	55407632	55607632	harbor1	chr14	55501247	55501776	LTR/ERV1	3291	+	264	55501511	93879
chr14	48189103	48389103	harbor1	chr14	48193733	48194410	LTR/ERV1	3461	+	338	48194071	4968
chr14	48189103	48389103	harbor1	chr14	48202405	48202775	LTR/ERV1	2866	+	185	48202590	13487
chr14	48189103	48389103	harbor1	chr14	48202776	48203397	LTR/ERV1	4458	+	310	48203086	13983
chr14	48189103	48389103	harbor1	chr14	48244292	48246034	LTR/ERV1	3119	+	871	48245163	56060
chr14	48189103	48389103	harbor1	chr14	48246040	48246248	LTR/ERV1	1068	+	104	48246144	57041
chr14	48189103	48389103	harbor1	chr14	48246554	48246967	LTR/ERV1	1068	+	206	48246760	57657
chr14	48189103	48389103	harbor1	chr14	48247019	48247206	LTR/ERV1	818	+	94	48247113	58010
chr14	48189103	48389103	harbor1	chr14	48247681	48248122	LTR/ERV1	1522	+	220	48247901	58798
chr14	48189103	48389103	harbor1	chr14	48248212	48248629	LTR/ERV1	1726	+	208	48248420	59317
chr14	48189103	48389103	harbor1	chr14	48252405	48252675	LTR/ERV1	474	+	135	48252540	63437
chr14	48189103	48389103	harbor1	chr14	48199301	48202418	LTR/ERV1	25172	+	1558	48200859	11756
chr14	20030960	20230960	harbor1	chr14	20099013	20100223	LTR/ERV1	6795	+	605	20099618	68658
chr14	58823702	59023702	harbor1	chr14	58833756	58835200	LTR/ERV1	9032	+	722	58834478	10776
chr14	88339182	88539182	harbor1	chr14	88358654	88358896	LTR/ERV1	447	+	121	88358775	19593
chr14	84253716	84453716	harbor1	chr14	84302071	84302266	LTR/ERV1	2438	+	98	84302169	48453
chr14	84253716	84453716	harbor1	chr14	84302628	84303495	LTR/ERV1	2438	+	434	84303062	49346
chr14	84253716	84453716	harbor1	chr14	84314056	84314521	LTR/ERV1	1326	+	232	84314288	60572
chr14	84253716	84453716	harbor1	chr14	84327543	84327754	LTR/ERV1	3628	+	106	84327649	73933
chr14	84253716	84453716	harbor1	chr14	84328063	84328286	LTR/ERV1	3628	+	112	84328175	74459
chr14	84253716	84453716	harbor1	chr14	84328500	84328737	LTR/ERV1	3628	+	118	84328618	74902
chr14	84253716	84453716	harbor1	chr14	84336915	84337623	LTR/ERV1	5011	+	354	84337269	83553
chr14	84253716	84453716	harbor1	chr14	84341234	84341877	LTR/ERV1	4084	+	322	84341556	87840
chr14	67363483	67563483	harbor1	chr14	67443862	67444337	LTR/ERV1	3077	+	238	67444100	80617
chr14	81914270	82114270	harbor1	chr14	81950765	81951288	LTR/ERV1	1886	+	262	81951027	36757
chr14	81914270	82114270	harbor1	chr14	81966954	81967589	LTR/ERV1	3172	+	318	81967272	53002
chr14	23071503	23271503	harbor1	chr14	23106682	23107337	LTR/ERV1	2165	+	328	23107010	35507
chr14	23071503	23271503	harbor1	chr14	23124293	23124627	LTR/ERV1	2098	+	167	23124460	52957
chr14	23071503	23271503	harbor1	chr14	23124926	23125107	LTR/ERV1	2098	+	90	23125016	53513
chr14	40223085	40423085	harbor1	chr14	40242584	40243302	LTR/ERV1	2305	+	359	40242943	19858
chr14	57559874	57759874	harbor1	chr14	57637775	57638647	LTR/ERV1	4696	+	436	57638211	78337
chr14	57559874	57759874	harbor1	chr14	57647641	57647998	LTR/ERV1	2006	+	178	57647819	87945
chr14	89554168	89754168	harbor1	chr14	89590559	89591186	LTR/ERV1	3144	+	314	89590873	36705
chr14	78351073	78551073	harbor1	chr14	78371031	78371819	LTR/ERV1	3048	+	394	78371425	20352
chr14	54355858	54555858	harbor1	chr14	54393278	54394638	LTR/ERV1	9507	+	680	54393958	38100
chr14	54355858	54555858	harbor1	chr14	54442869	54444450	LTR/ERV1	11455	+	790	54443659	87801
chr14	89628980	89828980	harbor1	chr14	89662618	89663100	LTR/ERV1	1809	+	241	89662859	33879
chr14	89628980	89828980	harbor1	chr14	89684033	89684153	LTR/ERV1	915	+	60	89684093	55113
chr14	89628980	89828980	harbor1	chr14	89684154	89684238	LTR/ERV1	561	+	42	89684196	55216
chr14	89628980	89828980	harbor1	chr14	89684234	89685512	LTR/ERV1	9043	+	639	89684873	55893
chr14	89628980	89828980	harbor1	chr14	89685514	89685733	LTR/ERV1	1609	+	110	89685624	56644
chr14	98109503	98309503	harbor1	chr14	98183149	98183471	LTR/ERV1	802	+	161	98183310	73807
chr14	43958480	44158480	harbor1	chr14	44007990	44008471	LTR/ERV1	1357	+	240	44008230	49750
chr14	43958480	44158480	harbor1	chr14	44013849	44014086	LTR/ERV1	789	+	118	44013967	55487
chr14	43958480	44158480	harbor1	chr14	44015293	44015574	LTR/ERV1	1213	+	140	44015433	56953
chr14	43958480	44158480	harbor1	chr14	44028108	44028707	LTR/ERV1	2829	+	300	44028408	69928
chr14	53274795	53474795	harbor1	chr14	53285100	53285524	LTR/ERV1	2345	+	212	53285312	10517
chr14	53274795	53474795	harbor1	chr14	53352556	53352803	LTR/ERV1	1413	+	124	53352680	77885
chr14	53274795	53474795	harbor1	chr14	53352806	53353127	LTR/ERV1	1652	+	160	53352966	78171
chr14	53274795	53474795	harbor1	chr14	53361643	53361978	LTR/ERV1	2581	+	168	53361811	87016
chr14	53274795	53474795	harbor1	chr14	53361979	53362365	LTR/ERV1	3013	+	193	53362172	87377
chr14	53274795	53474795	harbor1	chr14	53362388	53362680	LTR/ERV1	2329	+	146	53362534	87739
chr14	53274795	53474795	harbor1	chr14	53362681	53363005	LTR/ERV1	2389	+	162	53362843	88048
chr14	105216678	105416678	harbor1	chr14	105223877	105224099	LTR/ERV1	1235	+	111	105223988	7310
chr14	105216678	105416678	harbor1	chr14	105224381	105224494	LTR/ERV1	1235	+	56	105224437	7759
chr14	105216678	105416678	harbor1	chr14	105225272	105225647	LTR/ERV1	2451	+	188	105225460	8782
chr14	105216678	105416678	harbor1	chr14	105225944	105226042	LTR/ERV1	2451	+	49	105225993	9315
chr14	49010037	49210037	harbor1	chr14	49033262	49033637	LTR/ERV1	1629	+	188	49033450	23413
chr14	54172065	54372065	harbor1	chr14	54256055	54256761	LTR/ERV1	4802	+	353	54256408	84343
chr14	36891476	37091476	harbor1	chr14	36971138	36971776	LTR/ERV1	3104	+	319	36971457	79981
chr14	36709619	36909619	harbor1	chr14	36748899	36749293	LTR/ERV1	2673	+	197	36749096	39477
chr14	104887600	105087600	harbor1	chr14	104910323	104910686	LTR/ERV1	2783	+	182	104910505	22905
chr14	104887600	105087600	harbor1	chr14	104910993	104911285	LTR/ERV1	2783	+	146	104911139	23539
chr14	104887600	105087600	harbor1	chr14	104918950	104919548	LTR/ERV1	4942	+	299	104919249	31649
chr14	50801765	51001765	harbor1	chr14	50893162	50893610	LTR/ERV1	3428	+	224	50893386	91621
chr14	50801765	51001765	harbor1	chr14	50893613	50896276	LTR/ERV1	19060	+	1332	50894945	93180
chr14	50801765	51001765	harbor1	chr14	50896276	50896391	LTR/ERV1	824	+	58	50896334	94569
chr14	50801765	51001765	harbor1	chr14	50896392	50896882	LTR/ERV1	2796	+	245	50896637	94872
chr14	60034637	60234637	harbor1	chr14	60094379	60094819	LTR/ERV1	2129	+	220	60094599	59962
chr14	60034637	60234637	harbor1	chr14	60096829	60097382	LTR/ERV1	4263	+	276	60097105	62468
chr14	60034637	60234637	harbor1	chr14	60097374	60097973	LTR/ERV1	4525	+	300	60097674	63037
chr14	60034637	60234637	harbor1	chr14	60097974	60098422	LTR/ERV1	2706	+	224	60098198	63561
chr14	60034637	60234637	harbor1	chr14	60100644	60101391	LTR/ERV1	5431	+	374	60101018	66381
chr14	102438758	102638758	harbor1	chr14	102520011	102520242	LTR/ERV1	2461	+	116	102520127	81369
chr14	102438758	102638758	harbor1	chr14	102520544	102520793	LTR/ERV1	2461	+	124	102520668	81910
chr14	102438758	102638758	harbor1	chr14	102521092	102521103	LTR/ERV1	2461	+	6	102521098	82340
chr14	102438758	102638758	harbor1	chr14	102521406	102521436	LTR/ERV1	2461	+	15	102521421	82663
chr14	102438758	102638758	harbor1	chr14	102522352	102522375	LTR/ERV1	2461	+	12	102522364	83606
chr14	102438758	102638758	harbor1	chr14	102530976	102531370	LTR/ERV1	1661	+	197	102531173	92415
chr14	47016503	47216503	harbor1	chr14	47070255	47070592	LTR/ERV1	1513	+	168	47070423	53920
chr14	47016503	47216503	harbor1	chr14	47070908	47071060	LTR/ERV1	1513	+	76	47070984	54481
chr14	47016503	47216503	harbor1	chr14	47104197	47104677	LTR/ERV1	3232	+	240	47104437	87934
chr14	47016503	47216503	harbor1	chr14	47104680	47107602	LTR/ERV1	16374	+	1461	47106141	89638
chr14	47016503	47216503	harbor1	chr14	47107582	47107728	LTR/ERV1	915	+	73	47107655	91152
chr14	47016503	47216503	harbor1	chr14	47107719	47108224	LTR/ERV1	2405	+	252	47107971	91468
chr14	47016503	47216503	harbor1	chr14	47108227	47108314	LTR/ERV1	567	+	44	47108271	91768
chr14	47016503	47216503	harbor1	chr14	47108315	47108765	LTR/ERV1	3393	+	225	47108540	92037
chr14	82254737	82454737	harbor1	chr14	82262901	82263332	LTR/ERV1	2159	+	216	82263117	8380
chr14	82254737	82454737	harbor1	chr14	82270081	82270759	LTR/ERV1	2292	+	339	82270420	15683
chr14	82254737	82454737	harbor1	chr14	82330244	82330727	LTR/ERV1	1542	+	242	82330486	75749
chr14	54877183	55077183	harbor1	chr14	54959824	54960006	LTR/ERV1	532	+	91	54959915	82732
chr14	43326571	43526571	harbor1	chr14	43326431	43327938	LTR/ERV1	10109	+	754	43327185	614
chr14	43326571	43526571	harbor1	chr14	43337970	43338371	LTR/ERV1	1534	+	200	43338170	11599
chr14	87110988	87310988	harbor1	chr14	87113255	87113631	LTR/ERV1	2417	+	188	87113443	2455
chr14	87110988	87310988	harbor1	chr14	87117591	87118753	LTR/ERV1	24674	+	581	87118172	7184
chr14	87110988	87310988	harbor1	chr14	87119058	87119841	LTR/ERV1	19740	+	392	87119450	8462
chr14	87110988	87310988	harbor1	chr14	87119845	87120216	LTR/ERV1	2488	+	186	87120031	9043
chr14	87110988	87310988	harbor1	chr14	87149944	87150445	LTR/ERV1	1905	+	250	87150194	39206
chr14	87110988	87310988	harbor1	chr14	87154781	87155209	LTR/ERV1	3742	+	214	87154995	44007
chr14	87110988	87310988	harbor1	chr14	87155518	87155746	LTR/ERV1	3742	+	114	87155632	44644
chr14	87110988	87310988	harbor1	chr14	87183770	87184145	LTR/ERV1	1510	+	188	87183958	72970
chr14	87110988	87310988	harbor1	chr14	87113632	87117555	LTR/ERV1	24674	+	1962	87115594	4606
chr14	91172117	91372117	harbor1	chr14	91265964	91266296	LTR/ERV1	1702	+	166	91266130	94013
chr14	63234170	63434170	harbor1	chr14	63261344	63261421	LTR/ERV1	924	+	38	63261382	27212
chr14	63234170	63434170	harbor1	chr14	63261741	63261904	LTR/ERV1	924	+	82	63261823	27653
chr14	103682572	103882572	harbor1	chr14	103702720	103703132	LTR/ERV1	1586	+	206	103702926	20354
chr14	103682572	103882572	harbor1	chr14	103712861	103713310	LTR/ERV1	1300	+	224	103713085	30513
chr14	103682572	103882572	harbor1	chr14	103719951	103720339	LTR/ERV1	776	+	194	103720145	37573
chr14	23540240	23740240	harbor1	chr14	23580444	23582015	LTR/ERV1	7335	+	786	23581230	40990
chr14	23540240	23740240	harbor1	chr14	23582182	23582261	LTR/ERV1	7335	+	40	23582222	41982
chr14	23540240	23740240	harbor1	chr14	23621190	23621445	LTR/ERV1	1432	+	128	23621318	81078
chr14	23540240	23740240	harbor1	chr14	23621446	23622084	LTR/ERV1	2362	+	319	23621765	81525
chr14	23540240	23740240	harbor1	chr14	23622086	23623833	LTR/ERV1	6454	+	874	23622960	82720
chr14	23540240	23740240	harbor1	chr14	23627051	23627374	LTR/ERV1	2530	+	162	23627213	86973
chr14	23540240	23740240	harbor1	chr14	23627375	23628074	LTR/ERV1	4598	+	350	23627725	87485
chr14	23540240	23740240	harbor1	chr14	23628088	23628213	LTR/ERV1	523	+	62	23628150	87910
chr14	23540240	23740240	harbor1	chr14	23629764	23629948	LTR/ERV1	900	+	92	23629856	89616
chr14	23540240	23740240	harbor1	chr14	23635627	23636652	LTR/ERV1	7112	+	512	23636139	95899
chr14	23540240	23740240	harbor1	chr14	23636653	23637705	LTR/ERV1	8143	+	526	23637179	96939
chr14	23540240	23740240	harbor1	chr14	23637706	23638396	LTR/ERV1	4872	+	345	23638051	97811
chr14	23540240	23740240	harbor1	chr14	23623828	23627052	LTR/ERV1	17767	+	1612	23625440	85200
chr14	94629501	94829501	harbor1	chr14	94631075	94631207	LTR/ERV1	441	+	66	94631141	1640
chr14	24234656	24434656	harbor1	chr14	24282998	24283307	LTR/ERV1	2394	+	154	24283152	48496
chr14	24234656	24434656	harbor1	chr14	24283622	24283846	LTR/ERV1	2394	+	112	24283734	49078
chr14	27003425	27203425	harbor1	chr14	27098328	27098863	LTR/ERV1	1317	+	268	27098596	95171
chr15	42947320	43147320	harbor1	chr15	43008124	43009616	LTR/ERV1	6525	+	746	43008870	61550
chr15	39807874	40007874	harbor1	chr15	39846207	39846376	LTR/ERV1	1285	+	84	39846291	38417
chr15	39807874	40007874	harbor1	chr15	39887804	39888273	LTR/ERV1	1706	+	234	39888038	80164
chr15	39807874	40007874	harbor1	chr15	39888593	39888683	LTR/ERV1	1944	+	45	39888638	80764
chr15	39807874	40007874	harbor1	chr15	39888978	39889096	LTR/ERV1	662	+	59	39889037	81163
chr15	39807874	40007874	harbor1	chr15	39904487	39904906	LTR/ERV1	1316	+	210	39904697	96823
chr15	39807874	40007874	harbor1	chr15	39904944	39905282	LTR/ERV1	468	+	169	39905113	97239
chr15	101782193	101982193	harbor1	chr15	101807186	101807253	LTR/ERV1	686	+	34	101807220	25027
chr15	101782193	101982193	harbor1	chr15	101807626	101807699	LTR/ERV1	686	+	36	101807662	25469
chr15	101782193	101982193	harbor1	chr15	101807784	101807982	LTR/ERV1	1158	+	99	101807883	25690
chr15	101782193	101982193	harbor1	chr15	101855112	101855328	LTR/ERV1	4182	+	108	101855220	73027
chr15	101782193	101982193	harbor1	chr15	101856040	101856127	LTR/ERV1	4182	+	44	101856084	73891
chr15	101782193	101982193	harbor1	chr15	101856428	101857158	LTR/ERV1	4950	+	365	101856793	74600
chr15	101782193	101982193	harbor1	chr15	101857541	101858050	LTR/ERV1	4950	+	254	101857795	75602
chr15	101782193	101982193	harbor1	chr15	101858329	101858702	LTR/ERV1	4950	+	186	101858515	76322
chr15	101782193	101982193	harbor1	chr15	101859703	101859976	LTR/ERV1	2902	+	136	101859839	77646
chr15	101782193	101982193	harbor1	chr15	101860945	101861193	LTR/ERV1	2902	+	124	101861069	78876
chr15	101782193	101982193	harbor1	chr15	101859256	101859449	LTR/ERV1	426	+	96	101859352	77159
chr15	91169839	91369839	harbor1	chr15	91191255	91191702	LTR/ERV1	1446	+	224	91191479	21640
chr15	25837206	26037206	harbor1	chr15	25852423	25853007	LTR/ERV1	1888	+	292	25852715	15509
chr15	25837206	26037206	harbor1	chr15	25882856	25883337	LTR/ERV1	3091	+	240	25883096	45890
chr15	25837206	26037206	harbor1	chr15	25925469	25925599	LTR/ERV1	482	+	65	25925534	88328
chr15	25837206	26037206	harbor1	chr15	25925632	25925730	LTR/ERV1	529	+	49	25925681	88475
chr15	25837206	26037206	harbor1	chr15	25925727	25925846	LTR/ERV1	3539	+	60	25925787	88581
chr15	25837206	26037206	harbor1	chr15	25926136	25927467	LTR/ERV1	3595	+	666	25926802	89596
chr15	25837206	26037206	harbor1	chr15	25927528	25927920	LTR/ERV1	847	+	196	25927724	90518
chr15	38841766	39041766	harbor1	chr15	38872255	38872687	LTR/ERV1	2961	+	216	38872471	30705
chr15	38841766	39041766	harbor1	chr15	38915129	38915562	LTR/ERV1	1976	+	216	38915345	73579
chr15	62262512	62462512	harbor1	chr15	62296471	62296867	LTR/ERV1	2496	+	198	62296669	34157
chr15	72036199	72236199	harbor1	chr15	72040096	72040310	LTR/ERV1	1369	+	107	72040203	4004
chr15	72036199	72236199	harbor1	chr15	72051220	72052984	LTR/ERV1	7745	+	882	72052102	15903
chr15	72036199	72236199	harbor1	chr15	72040311	72040602	LTR/ERV1	1262	+	146	72040457	4258
chr15	31262083	31462083	harbor1	chr15	31273211	31273364	LTR/ERV1	598	+	76	31273287	11204
chr15	73871405	74071405	harbor1	chr15	73962999	73963767	LTR/ERV1	5760	+	384	73963383	91978
chr15	73871405	74071405	harbor1	chr15	73891377	73892853	LTR/ERV1	7547	+	738	73892115	20710
chr15	64039475	64239475	harbor1	chr15	64069710	64069933	LTR/ERV1	1205	+	112	64069822	30347
chr15	64039475	64239475	harbor1	chr15	64070166	64070621	LTR/ERV1	3063	+	228	64070394	30919
chr15	64039475	64239475	harbor1	chr15	64060668	64062121	LTR/ERV1	9107	+	726	64061394	21919
chr15	29624672	29824672	harbor1	chr15	29651428	29652990	LTR/ERV1	7284	+	781	29652209	27537
chr15	29624672	29824672	harbor1	chr15	29668632	29669017	LTR/ERV1	834	+	192	29668824	44152
chr15	29624672	29824672	harbor1	chr15	29682250	29682647	LTR/ERV1	1046	+	198	29682448	57776
chr15	29624672	29824672	harbor1	chr15	29686409	29686972	LTR/ERV1	3514	+	282	29686691	62019
chr15	30369470	30569470	harbor1	chr15	30449598	30450374	LTR/ERV1	5439	+	388	30449986	80516
chr15	46632857	46832857	harbor1	chr15	46672125	46672581	LTR/ERV1	791	+	228	46672353	39496
chr15	46632857	46832857	harbor1	chr15	46680150	46680560	LTR/ERV1	2594	+	205	46680355	47498
chr15	46632857	46832857	harbor1	chr15	46680919	46681513	LTR/ERV1	3076	+	297	46681216	48359
chr15	46632857	46832857	harbor1	chr15	46682009	46682574	LTR/ERV1	4084	+	282	46682291	49434
chr15	46632857	46832857	harbor1	chr15	46683066	46683777	LTR/ERV1	3632	+	356	46683422	50565
chr15	28598269	28798269	harbor1	chr15	28692132	28692607	LTR/ERV1	2456	+	238	28692370	94101
chr15	70010239	70210239	harbor1	chr15	70022117	70022308	LTR/ERV1	1190	+	96	70022213	11974
chr15	84300251	84500251	harbor1	chr15	84320200	84320322	LTR/ERV1	913	+	61	84320261	20010
chr15	84300251	84500251	harbor1	chr15	84328977	84329413	LTR/ERV1	1417	+	218	84329195	28944
chr15	84300251	84500251	harbor1	chr15	84329733	84329751	LTR/ERV1	1417	+	9	84329742	29491
chr15	84300251	84500251	harbor1	chr15	84329752	84330289	LTR/ERV1	16511	+	268	84330020	29769
chr15	84300251	84500251	harbor1	chr15	84330323	84337368	LTR/ERV1	24970	+	3522	84333845	33594
chr15	84300251	84500251	harbor1	chr15	84337374	84337810	LTR/ERV1	1406	+	218	84337592	37341
chr15	26215569	26415569	harbor1	chr15	26289910	26290273	LTR/ERV1	1969	+	182	26290092	74523
chr15	26215569	26415569	harbor1	chr15	26290582	26290682	LTR/ERV1	1969	+	50	26290632	75063
chr15	26215569	26415569	harbor1	chr15	26305147	26305529	LTR/ERV1	1654	+	191	26305338	89769
chr15	26215569	26415569	harbor1	chr15	26307872	26308173	LTR/ERV1	1662	+	150	26308022	92453
chr15	26215569	26415569	harbor1	chr15	26308185	26308534	LTR/ERV1	10101	+	174	26308359	92790
chr15	26215569	26415569	harbor1	chr15	26308565	26309292	LTR/ERV1	10101	+	364	26308929	93360
chr15	26215569	26415569	harbor1	chr15	26309601	26310501	LTR/ERV1	10101	+	450	26310051	94482
chr15	26215569	26415569	harbor1	chr15	26310502	26310776	LTR/ERV1	1392	+	137	26310639	95070
chr15	26215569	26415569	harbor1	chr15	26314507	26314942	LTR/ERV1	2998	+	218	26314725	99156
chr15	96836054	97036054	harbor1	chr15	96867371	96868314	LTR/ERV1	6629	+	472	96867843	31789
chr15	96836054	97036054	harbor1	chr15	96903679	96903972	LTR/ERV1	1478	+	146	96903825	67771
chr15	45379160	45579160	harbor1	chr15	45385585	45386154	LTR/ERV1	3403	+	284	45385869	6709
chr15	45379160	45579160	harbor1	chr15	45469033	45469477	LTR/ERV1	1279	+	222	45469255	90095
chr15	45379160	45579160	harbor1	chr15	45469478	45469896	LTR/ERV1	2805	+	209	45469687	90527
chr15	45379160	45579160	harbor1	chr15	45469897	45469988	LTR/ERV1	1279	+	46	45469943	90783
chr15	45379160	45579160	harbor1	chr15	45471336	45471678	LTR/ERV1	1919	+	171	45471507	92347
chr15	45379160	45579160	harbor1	chr15	45472254	45472900	LTR/ERV1	2310	+	323	45472577	93417
chr15	32860486	33060486	harbor1	chr15	32940966	32941104	LTR/ERV1	915	+	69	32941035	80549
chr15	62260779	62460779	harbor1	chr15	62260898	62261492	LTR/ERV1	3305	+	297	62261195	416
chr15	62260779	62460779	harbor1	chr15	62296471	62296867	LTR/ERV1	2496	+	198	62296669	35890
chr15	95403544	95603544	harbor1	chr15	95443867	95444232	LTR/ERV1	422	+	182	95444049	40505
chr15	47804796	48004796	harbor1	chr15	47836758	47837053	LTR/ERV1	596	+	148	47836906	32110
chr15	47804796	48004796	harbor1	chr15	47886421	47887076	LTR/ERV1	4808	+	328	47886749	81953
chr15	96595426	96795426	harbor1	chr15	96674400	96675175	LTR/ERV1	505	+	388	96674788	79362
chr15	86911759	87111759	harbor1	chr15	86930725	86931493	LTR/ERV1	4843	+	384	86931109	19350
chr15	86911759	87111759	harbor1	chr15	86933512	86933655	LTR/ERV1	699	+	72	86933584	21825
chr15	86911759	87111759	harbor1	chr15	86940540	86941051	LTR/ERV1	2042	+	256	86940796	29037
chr15	86911759	87111759	harbor1	chr15	86933136	86933529	LTR/ERV1	1793	+	196	86933332	21573
chr15	68399907	68599907	harbor1	chr15	68471400	68471793	LTR/ERV1	2362	+	196	68471596	71689
chr15	68399907	68599907	harbor1	chr15	68481477	68481786	LTR/ERV1	1840	+	154	68481631	81724
chr15	26646883	26846883	harbor1	chr15	26650501	26651375	LTR/ERV1	4138	+	437	26650938	4055
chr15	26646883	26846883	harbor1	chr15	26651622	26652431	LTR/ERV1	2765	+	404	26652026	5143
chr15	26646883	26846883	harbor1	chr15	26652969	26653703	LTR/ERV1	3144	+	367	26653336	6453
chr15	26646883	26846883	harbor1	chr15	26657699	26658444	LTR/ERV1	2575	+	372	26658071	11188
chr15	26646883	26846883	harbor1	chr15	26672141	26672672	LTR/ERV1	769	+	266	26672407	25524
chr15	26646883	26846883	harbor1	chr15	26719883	26720337	LTR/ERV1	3401	+	227	26720110	73227
chr15	26646883	26846883	harbor1	chr15	26721175	26721686	LTR/ERV1	2985	+	256	26721431	74548
chr15	26646883	26846883	harbor1	chr15	26724266	26724978	LTR/ERV1	4114	+	356	26724622	77739
chr15	55067203	55267203	harbor1	chr15	55088143	55088457	LTR/ERV1	671	+	157	55088300	21097
chr15	55067203	55267203	harbor1	chr15	55115425	55115774	LTR/ERV1	642	+	174	55115599	48396
chr15	55067203	55267203	harbor1	chr15	55116639	55116905	LTR/ERV1	569	+	133	55116772	49569
chr15	49141211	49341211	harbor1	chr15	49164217	49164307	LTR/ERV1	646	+	45	49164262	23051
chr15	49141211	49341211	harbor1	chr15	49175612	49175650	LTR/ERV1	2166	+	19	49175631	34420
chr15	49141211	49341211	harbor1	chr15	49175651	49176088	LTR/ERV1	3286	+	218	49175869	34658
chr15	49141211	49341211	harbor1	chr15	49176089	49176487	LTR/ERV1	2166	+	199	49176288	35077
chr15	49141211	49341211	harbor1	chr15	49190145	49190525	LTR/ERV1	920	+	190	49190335	49124
chr15	49141211	49341211	harbor1	chr15	49190573	49191002	LTR/ERV1	2963	+	214	49190787	49576
chr15	93593913	93793913	harbor1	chr15	93610570	93611287	LTR/ERV1	4071	+	358	93610928	17015
chr15	51964115	52164115	harbor1	chr15	52016429	52016763	LTR/ERV1	719	+	167	52016596	52481
chr15	51964115	52164115	harbor1	chr15	52017081	52017128	LTR/ERV1	461	+	24	52017105	52990
chr15	51964115	52164115	harbor1	chr15	52017592	52017671	LTR/ERV1	461	+	40	52017632	53517
chr15	79910115	80110115	harbor1	chr15	79925931	79927231	LTR/ERV1	9150	+	650	79926581	16466
chr15	32325787	32525787	harbor1	chr15	32418450	32418949	LTR/ERV1	3441	+	250	32418700	92913
chr15	30790215	30990215	harbor1	chr15	30860655	30860816	LTR/ERV1	651	+	80	30860735	70520
chr15	30790215	30990215	harbor1	chr15	30883574	30885113	LTR/ERV1	10826	+	770	30884344	94129
chr15	100135993	100335993	harbor1	chr15	100149341	100149835	LTR/ERV1	2438	+	247	100149588	13595
chr15	100135993	100335993	harbor1	chr15	100172320	100172935	LTR/ERV1	2676	+	308	100172628	36635
chr15	100135993	100335993	harbor1	chr15	100173149	100173695	LTR/ERV1	3127	+	273	100173422	37429
chr15	28147447	28347447	harbor1	chr15	28197737	28198247	LTR/ERV1	1441	+	255	28197992	50545
chr15	50193765	50393765	harbor1	chr15	50240941	50241477	LTR/ERV1	3086	+	268	50241209	47444
chr15	23390412	23590412	harbor1	chr15	23406839	23407400	LTR/ERV1	3216	+	280	23407119	16707
chr15	23390412	23590412	harbor1	chr15	23475397	23476775	LTR/ERV1	6241	+	689	23476086	85674
chr15	23390412	23590412	harbor1	chr15	23476908	23476982	LTR/ERV1	698	+	37	23476945	86533
chr15	23390412	23590412	harbor1	chr15	23477280	23477457	LTR/ERV1	747	+	88	23477368	86956
chr15	23390412	23590412	harbor1	chr15	23477468	23477814	LTR/ERV1	1746	+	173	23477641	87229
chr15	23390412	23590412	harbor1	chr15	23478610	23478782	LTR/ERV1	1260	+	86	23478696	88284
chr15	23390412	23590412	harbor1	chr15	23478763	23479386	LTR/ERV1	3987	+	312	23479075	88663
chr15	23390412	23590412	harbor1	chr15	23479376	23480402	LTR/ERV1	7277	+	513	23479889	89477
chr15	23390412	23590412	harbor1	chr15	23480903	23480966	LTR/ERV1	2436	+	32	23480935	90523
chr15	23390412	23590412	harbor1	chr15	23481265	23481812	LTR/ERV1	2436	+	274	23481539	91127
chr15	23390412	23590412	harbor1	chr15	23482140	23482738	LTR/ERV1	3121	+	299	23482439	92027
chr15	23390412	23590412	harbor1	chr15	23482861	23483841	LTR/ERV1	4117	+	490	23483351	92939
chr15	23390412	23590412	harbor1	chr15	23478135	23478297	LTR/ERV1	1260	+	81	23478216	87804
chr15	41628899	41828899	harbor1	chr15	41632269	41632744	LTR/ERV1	2978	+	238	41632507	3608
chr15	25595729	25795729	harbor1	chr15	25625935	25626420	LTR/ERV1	1927	+	242	25626177	30448
chr15	25595729	25795729	harbor1	chr15	25654738	25654833	LTR/ERV1	470	+	48	25654786	59057
chr15	25595729	25795729	harbor1	chr15	25655145	25655581	LTR/ERV1	2565	+	218	25655363	59634
chr15	25595729	25795729	harbor1	chr15	25661281	25661714	LTR/ERV1	1354	+	216	25661497	65768
chr15	25595729	25795729	harbor1	chr15	25681125	25681544	LTR/ERV1	1869	+	210	25681335	85606
chr15	25595729	25795729	harbor1	chr15	25656651	25657411	LTR/ERV1	5255	+	380	25657031	61302
chr15	79950500	80150500	harbor1	chr15	80016340	80017800	LTR/ERV1	10137	+	730	80017070	66570
chr15	34133561	34333561	harbor1	chr15	34186202	34187495	LTR/ERV1	8549	+	646	34186848	53287
chr15	59109086	59309086	harbor1	chr15	59142958	59143040	LTR/ERV1	489	+	41	59142999	33913
chr15	84616295	84816295	harbor1	chr15	84628877	84628987	LTR/ERV1	1484	+	55	84628932	12637
chr15	84616295	84816295	harbor1	chr15	84629254	84629442	LTR/ERV1	1484	+	94	84629348	13053
chr15	84616295	84816295	harbor1	chr15	84629485	84629560	LTR/ERV1	424	+	38	84629523	13228
chr15	61327399	61527399	harbor1	chr15	61334968	61335408	LTR/ERV1	1456	+	220	61335188	7789
chr15	61327399	61527399	harbor1	chr15	61354150	61354898	LTR/ERV1	1527	+	374	61354524	27125
chr15	29156941	29356941	harbor1	chr15	29178461	29178806	LTR/ERV1	1036	+	172	29178633	21692
chr15	29156941	29356941	harbor1	chr15	29222002	29222533	LTR/ERV1	4067	+	266	29222268	65327
chr15	29156941	29356941	harbor1	chr15	29253990	29254134	LTR/ERV1	772	+	72	29254062	97121
chr15	29156941	29356941	harbor1	chr15	29254191	29254558	LTR/ERV1	1119	+	184	29254375	97434
chr15	53760444	53960444	harbor1	chr15	53762946	53763606	LTR/ERV1	2376	+	330	53763276	2832
chr15	53760444	53960444	harbor1	chr15	53810295	53810806	LTR/ERV1	4126	+	256	53810551	50107
chr15	53760444	53960444	harbor1	chr15	53821446	53822061	LTR/ERV1	3153	+	308	53821754	61310
chr15	53760444	53960444	harbor1	chr15	53822419	53822439	LTR/ERV1	2605	+	10	53822429	61985
chr15	53760444	53960444	harbor1	chr15	53831865	53832481	LTR/ERV1	2369	+	308	53832173	71729
chr15	53760444	53960444	harbor1	chr15	53836668	53836809	LTR/ERV1	712	+	70	53836738	76294
chr15	53760444	53960444	harbor1	chr15	53836821	53837054	LTR/ERV1	999	+	116	53836937	76493
chr15	53760444	53960444	harbor1	chr15	53857096	53857288	LTR/ERV1	1300	+	96	53857192	96748
chr15	83247805	83447805	harbor1	chr15	83330808	83331264	LTR/ERV1	3196	+	228	83331036	83231
chr15	98003761	98203761	harbor1	chr15	98019728	98020015	LTR/ERV1	673	+	144	98019872	16111
chr15	98003761	98203761	harbor1	chr15	98066210	98066572	LTR/ERV1	2063	+	181	98066391	62630
chr15	25522424	25722424	harbor1	chr15	25536873	25537315	LTR/ERV1	2745	+	221	25537094	14670
chr15	25522424	25722424	harbor1	chr15	25565835	25566198	LTR/ERV1	2890	+	182	25566017	43593
chr15	25522424	25722424	harbor1	chr15	25566964	25567241	LTR/ERV1	2890	+	138	25567102	44678
chr15	25522424	25722424	harbor1	chr15	25569313	25569993	LTR/ERV1	2355	+	340	25569653	47229
chr15	52711320	52911320	harbor1	chr15	52738558	52738987	LTR/ERV1	2612	+	214	52738772	27452
chr15	52711320	52911320	harbor1	chr15	52744191	52744407	LTR/ERV1	1389	+	108	52744299	32979
chr15	52711320	52911320	harbor1	chr15	52744406	52744783	LTR/ERV1	2387	+	188	52744594	33274
chr15	52711320	52911320	harbor1	chr15	52744784	52745204	LTR/ERV1	2705	+	210	52744994	33674
chr15	52711320	52911320	harbor1	chr15	52745244	52745899	LTR/ERV1	4116	+	328	52745572	34252
chr15	52711320	52911320	harbor1	chr15	52747319	52747772	LTR/ERV1	3218	+	226	52747545	36225
chr15	52711320	52911320	harbor1	chr15	52738990	52744189	LTR/ERV1	36345	+	2600	52741590	30270
chr15	55409019	55609019	harbor1	chr15	55424524	55424591	LTR/ERV1	1710	+	34	55424558	15539
chr15	55409019	55609019	harbor1	chr15	55425165	55425485	LTR/ERV1	1710	+	160	55425325	16306
chr15	55409019	55609019	harbor1	chr15	55426728	55426933	LTR/ERV1	994	+	102	55426830	17811
chr15	55409019	55609019	harbor1	chr15	55428836	55428938	LTR/ERV1	994	+	51	55428887	19868
chr15	55409019	55609019	harbor1	chr15	55477977	55478582	LTR/ERV1	3608	+	302	55478279	69260
chr15	55409019	55609019	harbor1	chr15	55480342	55480835	LTR/ERV1	1123	+	246	55480588	71569
chr15	55409019	55609019	harbor1	chr15	55481197	55481726	LTR/ERV1	1809	+	264	55481461	72442
chr15	55409019	55609019	harbor1	chr15	55481728	55482210	LTR/ERV1	1762	+	241	55481969	72950
chr15	55409019	55609019	harbor1	chr15	55487092	55487786	LTR/ERV1	4752	+	347	55487439	78420
chr15	55409019	55609019	harbor1	chr15	55496768	55497313	LTR/ERV1	940	+	272	55497040	88021
chr15	55409019	55609019	harbor1	chr15	55497608	55497623	LTR/ERV1	940	+	8	55497616	88597
chr15	55409019	55609019	harbor1	chr15	55499144	55499562	LTR/ERV1	2537	+	209	55499353	90334
chr15	55409019	55609019	harbor1	chr15	55502399	55502632	LTR/ERV1	496	+	116	55502515	93496
chr15	20781726	20981726	harbor1	chr15	20788809	20789401	LTR/ERV1	2319	+	296	20789105	7379
chr15	20781726	20981726	harbor1	chr15	20848871	20849359	LTR/ERV1	1462	+	244	20849115	67389
chr16	79247025	79447025	harbor1	chr16	79292580	79293217	LTR/ERV1	4530	+	318	79292898	45873
chr16	49582518	49782518	harbor1	chr16	49679191	49680935	LTR/ERV1	7715	+	872	49680063	97545
chr16	84434350	84634350	harbor1	chr16	84489790	84490443	LTR/ERV1	1340	+	326	84490116	55766
chr16	84434350	84634350	harbor1	chr16	84490480	84490654	LTR/ERV1	1340	+	87	84490567	56217
chr16	84434350	84634350	harbor1	chr16	84490696	84491038	LTR/ERV1	1170	+	171	84490867	56517
chr16	84434350	84634350	harbor1	chr16	84492882	84494041	LTR/ERV1	12208	+	580	84493462	59112
chr16	84434350	84634350	harbor1	chr16	84494075	84494838	LTR/ERV1	12208	+	382	84494457	60107
chr16	84434350	84634350	harbor1	chr16	84494852	84494992	LTR/ERV1	2429	+	70	84494922	60572
chr16	84434350	84634350	harbor1	chr16	84495293	84495590	LTR/ERV1	2429	+	148	84495441	61091
chr16	84434350	84634350	harbor1	chr16	84495966	84496589	LTR/ERV1	4015	+	312	84496278	61928
chr16	84434350	84634350	harbor1	chr16	84502909	84503096	LTR/ERV1	1890	+	94	84503003	68653
chr16	84434350	84634350	harbor1	chr16	84503307	84503587	LTR/ERV1	1890	+	140	84503447	69097
chr16	84434350	84634350	harbor1	chr16	84512416	84512543	LTR/ERV1	3093	+	64	84512480	78130
chr16	84434350	84634350	harbor1	chr16	84512836	84512846	LTR/ERV1	3093	+	5	84512841	78491
chr16	84434350	84634350	harbor1	chr16	84513114	84513673	LTR/ERV1	3093	+	280	84513394	79044
chr16	84434350	84634350	harbor1	chr16	84491873	84492564	LTR/ERV1	12208	+	346	84492219	57869
chr16	67628753	67828753	harbor1	chr16	67710776	67710939	LTR/ERV1	960	+	82	67710858	82105
chr16	1428558	1628558	harbor1	chr16	1475642	1475812	LTR/ERV1	537	+	85	1475727	47169
chr16	2684609	2884609	harbor1	chr16	2724745	2725243	LTR/ERV1	1637	+	249	2724994	40385
chr16	2684609	2884609	harbor1	chr16	2731942	2732270	LTR/ERV1	604	+	164	2732106	47497
chr16	2684609	2884609	harbor1	chr16	2781830	2782035	LTR/ERV1	842	+	102	2781932	97323
chr16	69097297	69297297	harbor1	chr16	69172706	69173080	LTR/ERV1	3935	+	187	69172893	75596
chr16	69097297	69297297	harbor1	chr16	69173385	69173540	LTR/ERV1	3935	+	78	69173463	76166
chr16	58982416	59182416	harbor1	chr16	59042242	59042958	LTR/ERV1	4121	+	358	59042600	60184
chr16	75376610	75576610	harbor1	chr16	75376669	75377149	LTR/ERV1	2564	+	240	75376909	299
chr16	75376610	75576610	harbor1	chr16	75390257	75390651	LTR/ERV1	1760	+	197	75390454	13844
chr16	75376610	75576610	harbor1	chr16	75419528	75420030	LTR/ERV1	3430	+	251	75419779	43169
chr16	75376610	75576610	harbor1	chr16	75421037	75421376	LTR/ERV1	2186	+	170	75421207	44597
chr16	75376610	75576610	harbor1	chr16	75473475	75473620	LTR/ERV1	531	+	72	75473547	96937
chr16	75376610	75576610	harbor1	chr16	75473634	75473890	LTR/ERV1	689	+	128	75473762	97152
chr16	75376610	75576610	harbor1	chr16	75474195	75474237	LTR/ERV1	689	+	21	75474216	97606
chr16	75376610	75576610	harbor1	chr16	75475226	75475273	LTR/ERV1	689	+	24	75475250	98640
chr16	22426060	22626060	harbor1	chr16	22506411	22506611	LTR/ERV1	1321	+	100	22506511	80451
chr16	60559730	60759730	harbor1	chr16	60577391	60577788	LTR/ERV1	2763	+	198	60577589	17859
chr16	60559730	60759730	harbor1	chr16	60577951	60578717	LTR/ERV1	6115	+	383	60578334	18604
chr16	60559730	60759730	harbor1	chr16	60578718	60579115	LTR/ERV1	2854	+	198	60578916	19186
chr16	60559730	60759730	harbor1	chr16	60636219	60636766	LTR/ERV1	3936	+	274	60636493	76763
chr16	60559730	60759730	harbor1	chr16	60651824	60652267	LTR/ERV1	1792	+	222	60652046	92316
chr16	61287052	61487052	harbor1	chr16	61295088	61295817	LTR/ERV1	3126	+	364	61295452	8400
chr16	46484095	46684095	harbor1	chr16	46533403	46533901	LTR/ERV1	1539	+	249	46533652	49557
chr16	46484095	46684095	harbor1	chr16	46542826	46542956	LTR/ERV1	688	+	65	46542891	58796
chr16	5114311	5314311	harbor1	chr16	5155555	5155705	LTR/ERV1	2607	+	75	5155630	41319
chr16	5114311	5314311	harbor1	chr16	5156077	5156427	LTR/ERV1	2607	+	175	5156252	41941
chr16	5114311	5314311	harbor1	chr16	5180478	5180954	LTR/ERV1	3279	+	238	5180716	66405
chr16	5114311	5314311	harbor1	chr16	5177020	5177557	LTR/ERV1	3425	+	268	5177288	62977
chr16	19695567	19895567	harbor1	chr16	19785402	19785987	LTR/ERV1	3124	+	292	19785694	90127
chr16	19695567	19895567	harbor1	chr16	19787847	19788311	LTR/ERV1	2372	+	232	19788079	92512
chr16	22238360	22438360	harbor1	chr16	22246636	22246757	LTR/ERV1	1987	+	60	22246696	8336
chr16	22238360	22438360	harbor1	chr16	22247068	22247158	LTR/ERV1	1987	+	45	22247113	8753
chr16	22238360	22438360	harbor1	chr16	22247461	22247820	LTR/ERV1	1987	+	180	22247641	9281
chr16	65480851	65680851	harbor1	chr16	65529541	65529929	LTR/ERV1	2267	+	194	65529735	48884
chr16	53346291	53546291	harbor1	chr16	53412650	53413585	LTR/ERV1	5885	+	468	53413118	66827
chr16	53346291	53546291	harbor1	chr16	53419198	53419720	LTR/ERV1	4217	+	261	53419459	73168
chr16	53346291	53546291	harbor1	chr16	53420027	53420104	LTR/ERV1	4217	+	38	53420065	73774
chr16	53346291	53546291	harbor1	chr16	53428870	53429599	LTR/ERV1	3027	+	364	53429234	82943
chr16	53346291	53546291	harbor1	chr16	53430070	53430374	LTR/ERV1	1589	+	152	53430222	83931
chr16	53346291	53546291	harbor1	chr16	53430551	53431086	LTR/ERV1	3970	+	268	53430819	84528
chr16	47592841	47792841	harbor1	chr16	47636272	47637543	LTR/ERV1	5446	+	636	47636908	44067
chr16	76752033	76952033	harbor1	chr16	76793909	76794407	LTR/ERV1	2181	+	249	76794158	42125
chr16	46554760	46754760	harbor1	chr16	46650301	46650497	LTR/ERV1	3698	+	98	46650399	95639
chr16	46554760	46754760	harbor1	chr16	46651555	46652059	LTR/ERV1	3698	+	252	46651807	97047
chr16	69470699	69670699	harbor1	chr16	69515324	69515546	LTR/ERV1	3314	+	111	69515435	44736
chr16	69470699	69670699	harbor1	chr16	69515841	69516248	LTR/ERV1	3314	+	204	69516045	45346
chr16	69470699	69670699	harbor1	chr16	69518444	69518470	LTR/ERV1	750	+	13	69518457	47758
chr16	69470699	69670699	harbor1	chr16	69518777	69518874	LTR/ERV1	750	+	48	69518825	48126
chr16	24378321	24578321	harbor1	chr16	24378502	24378578	LTR/ERV1	4525	+	38	24378540	219
chr16	24378321	24578321	harbor1	chr16	24378827	24379387	LTR/ERV1	2556	+	280	24379107	786
chr16	24378321	24578321	harbor1	chr16	24380509	24380718	LTR/ERV1	3526	+	104	24380613	2292
chr16	24378321	24578321	harbor1	chr16	24381327	24381589	LTR/ERV1	3526	+	131	24381458	3137
chr16	24378321	24578321	harbor1	chr16	24382086	24382210	LTR/ERV1	3526	+	62	24382148	3827
chr16	24378321	24578321	harbor1	chr16	24385256	24385901	LTR/ERV1	4203	+	322	24385578	7257
chr16	24378321	24578321	harbor1	chr16	24388712	24388799	LTR/ERV1	2016	+	44	24388756	10435
chr16	24378321	24578321	harbor1	chr16	24388800	24389458	LTR/ERV1	4354	+	329	24389129	10808
chr16	24378321	24578321	harbor1	chr16	24389459	24389715	LTR/ERV1	2016	+	128	24389587	11266
chr16	24378321	24578321	harbor1	chr16	24389927	24390215	LTR/ERV1	2075	+	144	24390071	11750
chr16	24378321	24578321	harbor1	chr16	24390510	24390674	LTR/ERV1	2075	+	82	24390592	12271
chr16	24378321	24578321	harbor1	chr16	24406342	24406909	LTR/ERV1	3667	+	284	24406626	28305
chr16	24378321	24578321	harbor1	chr16	24416359	24416731	LTR/ERV1	1800	+	186	24416545	38224
chr16	24378321	24578321	harbor1	chr16	24417549	24417712	LTR/ERV1	853	+	82	24417631	39310
chr16	24378321	24578321	harbor1	chr16	24418118	24418665	LTR/ERV1	2619	+	274	24418392	40071
chr16	24378321	24578321	harbor1	chr16	24418666	24419282	LTR/ERV1	1475	+	308	24418974	40653
chr16	24378321	24578321	harbor1	chr16	24423831	24424211	LTR/ERV1	2135	+	190	24424021	45700
chr16	24378321	24578321	harbor1	chr16	24434580	24435001	LTR/ERV1	1189	+	210	24434790	56469
chr16	24378321	24578321	harbor1	chr16	24436399	24436966	LTR/ERV1	3681	+	284	24436683	58362
chr16	24378321	24578321	harbor1	chr16	24440499	24440766	LTR/ERV1	3200	+	134	24440633	62312
chr16	24378321	24578321	harbor1	chr16	24441070	24441207	LTR/ERV1	3200	+	68	24441138	62817
chr16	24378321	24578321	harbor1	chr16	24441504	24441641	LTR/ERV1	3200	+	68	24441572	63251
chr16	24378321	24578321	harbor1	chr16	24444435	24444526	LTR/ERV1	756	+	46	24444481	66160
chr16	24378321	24578321	harbor1	chr16	24444827	24444839	LTR/ERV1	756	+	6	24444833	66512
chr16	24378321	24578321	harbor1	chr16	24445119	24445135	LTR/ERV1	756	+	8	24445127	66806
chr16	24378321	24578321	harbor1	chr16	24445168	24445364	LTR/ERV1	993	+	98	24445266	66945
chr16	24378321	24578321	harbor1	chr16	24445405	24445740	LTR/ERV1	1242	+	168	24445573	67252
chr16	24195584	24395584	harbor1	chr16	24262923	24263411	LTR/ERV1	812	+	244	24263167	67583
chr16	24195584	24395584	harbor1	chr16	24264363	24264905	LTR/ERV1	936	+	271	24264634	69050
chr16	23829161	24029161	harbor1	chr16	23862744	23863051	LTR/ERV1	2376	+	154	23862898	33737
chr16	23829161	24029161	harbor1	chr16	23863286	23863489	LTR/ERV1	1600	+	102	23863388	34227
chr16	84506681	84706681	harbor1	chr16	84512416	84512543	LTR/ERV1	3093	+	64	84512480	5799
chr16	84506681	84706681	harbor1	chr16	84512836	84512846	LTR/ERV1	3093	+	5	84512841	6160
chr16	84506681	84706681	harbor1	chr16	84513114	84513673	LTR/ERV1	3093	+	280	84513394	6713
chr16	84506681	84706681	harbor1	chr16	84535766	84536333	LTR/ERV1	2826	+	284	84536050	29369
chr16	84506681	84706681	harbor1	chr16	84552576	84552701	LTR/ERV1	745	+	62	84552638	45957
chr16	84506681	84706681	harbor1	chr16	84553173	84553544	LTR/ERV1	1413	+	186	84553359	46678
chr16	60761616	60961616	harbor1	chr16	60775167	60775300	LTR/ERV1	592	+	66	60775233	13617
chr16	60761616	60961616	harbor1	chr16	60825626	60825990	LTR/ERV1	1098	+	182	60825808	64192
chr16	54927919	55127919	harbor1	chr16	54979597	54979977	LTR/ERV1	1368	+	190	54979787	51868
chr16	80174265	80374265	harbor1	chr16	80250801	80251422	LTR/ERV1	4256	+	310	80251111	76846
chr16	19964926	20164926	harbor1	chr16	19991022	19991362	LTR/ERV1	1350	+	170	19991192	26266
chr16	19964926	20164926	harbor1	chr16	20014187	20014610	LTR/ERV1	2781	+	212	20014399	49473
chr16	11854572	12054572	harbor1	chr16	11936779	11937208	LTR/ERV1	1645	+	214	11936993	82421
chr16	31187708	31387708	harbor1	chr16	31216334	31216422	LTR/ERV1	612	+	44	31216378	28670
chr16	31187708	31387708	harbor1	chr16	31230075	31230445	LTR/ERV1	3236	+	185	31230260	42552
chr16	31187708	31387708	harbor1	chr16	31230745	31230875	LTR/ERV1	3236	+	65	31230810	43102
chr16	62953994	63153994	harbor1	chr16	62962503	62963041	LTR/ERV1	2192	+	269	62962772	8778
chr16	62953994	63153994	harbor1	chr16	62988067	62988549	LTR/ERV1	1440	+	241	62988308	34314
chr16	62953994	63153994	harbor1	chr16	63000833	63000964	LTR/ERV1	933	+	66	63000899	46905
chr16	62953994	63153994	harbor1	chr16	63033301	63034024	LTR/ERV1	3952	+	362	63033663	79669
chr16	74809651	75009651	harbor1	chr16	74811257	74811704	LTR/ERV1	3379	+	224	74811481	1830
chr16	74809651	75009651	harbor1	chr16	74850234	74850769	LTR/ERV1	2296	+	268	74850502	40851
chr16	74809651	75009651	harbor1	chr16	74867258	74867894	LTR/ERV1	3484	+	318	74867576	57925
chr16	74809651	75009651	harbor1	chr16	74876218	74876394	LTR/ERV1	453	+	88	74876306	66655
chr16	74809651	75009651	harbor1	chr16	74877847	74878261	LTR/ERV1	489	+	207	74878054	68403
chr16	74809651	75009651	harbor1	chr16	74878744	74879068	LTR/ERV1	434	+	162	74878906	69255
chr16	74809651	75009651	harbor1	chr16	74879408	74879691	LTR/ERV1	596	+	142	74879550	69899
chr16	74809651	75009651	harbor1	chr16	74880480	74880940	LTR/ERV1	442	+	230	74880710	71059
chr16	74809651	75009651	harbor1	chr16	74808559	74811250	LTR/ERV1	17707	+	1346	74809905	254
chr16	52976712	53176712	harbor1	chr16	53023590	53023959	LTR/ERV1	1476	+	184	53023774	47062
chr16	52976712	53176712	harbor1	chr16	53028008	53028080	LTR/ERV1	493	+	36	53028044	51332
chr16	52976712	53176712	harbor1	chr16	53029853	53030272	LTR/ERV1	2110	+	210	53030063	53351
chr16	52976712	53176712	harbor1	chr16	53030409	53030557	LTR/ERV1	885	+	74	53030483	53771
chr16	52976712	53176712	harbor1	chr16	53032712	53032738	LTR/ERV1	728	+	13	53032725	56013
chr16	52976712	53176712	harbor1	chr16	53033032	53033159	LTR/ERV1	728	+	64	53033096	56384
chr16	52976712	53176712	harbor1	chr16	53033160	53033674	LTR/ERV1	2501	+	257	53033417	56705
chr16	52976712	53176712	harbor1	chr16	53036545	53036942	LTR/ERV1	1158	+	198	53036743	60031
chr16	52976712	53176712	harbor1	chr16	53037234	53037265	LTR/ERV1	1158	+	16	53037250	60538
chr16	51276879	51476879	harbor1	chr16	51336874	51337281	LTR/ERV1	1516	+	204	51337078	60199
chr16	60946203	61146203	harbor1	chr16	60973255	60973913	LTR/ERV1	4579	+	329	60973584	27381
chr16	60946203	61146203	harbor1	chr16	60974493	60975181	LTR/ERV1	3660	+	344	60974837	28634
chr16	60946203	61146203	harbor1	chr16	60979090	60980351	LTR/ERV1	3763	+	630	60979720	33517
chr16	5395682	5595682	harbor1	chr16	5494933	5495001	LTR/ERV1	492	+	34	5494967	99285
chr16	47032223	47232223	harbor1	chr16	47069788	47070244	LTR/ERV1	1185	+	228	47070016	37793
chr16	47954153	48154153	harbor1	chr16	47982510	47983108	LTR/ERV1	3227	+	299	47982809	28656
chr16	47954153	48154153	harbor1	chr16	47999032	47999906	LTR/ERV1	5355	+	437	47999469	45316
chr16	47954153	48154153	harbor1	chr16	48049779	48050475	LTR/ERV1	4696	+	348	48050127	95974
chr16	16432962	16632962	harbor1	chr16	16493952	16494586	LTR/ERV1	3261	+	317	16494269	61307
chr16	75218417	75418417	harbor1	chr16	75284778	75284850	LTR/ERV1	564	+	36	75284814	66397
chr16	75218417	75418417	harbor1	chr16	75285117	75285201	LTR/ERV1	1488	+	42	75285159	66742
chr16	75218417	75418417	harbor1	chr16	75285799	75286055	LTR/ERV1	1488	+	128	75285927	67510
chr16	69101572	69301572	harbor1	chr16	69172706	69173080	LTR/ERV1	3935	+	187	69172893	71321
chr16	69101572	69301572	harbor1	chr16	69173385	69173540	LTR/ERV1	3935	+	78	69173463	71891
chr16	59935198	60135198	harbor1	chr16	59947705	59948314	LTR/ERV1	2011	+	304	59948009	12811
chr16	59935198	60135198	harbor1	chr16	60028104	60028683	LTR/ERV1	1370	+	290	60028394	93196
chr16	59935198	60135198	harbor1	chr16	60030631	60031071	LTR/ERV1	2582	+	220	60030851	95653
chr16	61259949	61459949	harbor1	chr16	61295088	61295817	LTR/ERV1	3126	+	364	61295452	35503
chr16	62899051	63099051	harbor1	chr16	62928954	62929347	LTR/ERV1	1458	+	196	62929150	30099
chr16	62899051	63099051	harbor1	chr16	62962503	62963041	LTR/ERV1	2192	+	269	62962772	63721
chr16	62899051	63099051	harbor1	chr16	62988067	62988549	LTR/ERV1	1440	+	241	62988308	89257
chr16	61960995	62160995	harbor1	chr16	61970786	61971275	LTR/ERV1	3537	+	244	61971030	10035
chr16	54947676	55147676	harbor1	chr16	54979597	54979977	LTR/ERV1	1368	+	190	54979787	32111
chr16	65465354	65665354	harbor1	chr16	65529541	65529929	LTR/ERV1	2267	+	194	65529735	64381
chr16	55962004	56162004	harbor1	chr16	55968247	55968633	LTR/ERV1	1740	+	193	55968440	6436
chr16	55962004	56162004	harbor1	chr16	55968856	55969087	LTR/ERV1	940	+	116	55968972	6968
chr16	55962004	56162004	harbor1	chr16	55970612	55970935	LTR/ERV1	1083	+	162	55970774	8770
chr16	55962004	56162004	harbor1	chr16	55970987	55971287	LTR/ERV1	907	+	150	55971137	9133
chr16	55962004	56162004	harbor1	chr16	55974851	55975404	LTR/ERV1	6918	+	276	55975127	13123
chr16	55962004	56162004	harbor1	chr16	55975794	55978340	LTR/ERV1	6918	+	1273	55977067	15063
chr16	55962004	56162004	harbor1	chr16	55979193	55979554	LTR/ERV1	777	+	180	55979373	17369
chr16	32683894	32883894	harbor1	chr16	32782353	32782678	LTR/ERV1	1752	+	162	32782515	98621
chr16	32683894	32883894	harbor1	chr16	32782688	32782894	LTR/ERV1	755	+	103	32782791	98897
chr16	32683894	32883894	harbor1	chr16	32783084	32783514	LTR/ERV1	1748	+	215	32783299	99405
chr16	17201124	17401124	harbor1	chr16	17269064	17269162	LTR/ERV1	454	+	49	17269113	67989
chr16	17201124	17401124	harbor1	chr16	17269479	17269792	LTR/ERV1	2147	+	156	17269635	68511
chr16	17201124	17401124	harbor1	chr16	17270112	17270260	LTR/ERV1	2147	+	74	17270186	69062
chr16	31890645	32090645	harbor1	chr16	31919905	31920917	LTR/ERV1	2167	+	506	31920411	29766
chr16	31890645	32090645	harbor1	chr16	31920964	31921138	LTR/ERV1	1604	+	87	31921051	30406
chr16	31890645	32090645	harbor1	chr16	31921430	31922095	LTR/ERV1	1604	+	332	31921762	31117
chr16	31890645	32090645	harbor1	chr16	31922566	31922836	LTR/ERV1	1163	+	135	31922701	32056
chr16	31890645	32090645	harbor1	chr16	31963296	31963478	LTR/ERV1	659	+	91	31963387	72742
chr16	31890645	32090645	harbor1	chr16	31963561	31963746	LTR/ERV1	727	+	92	31963653	73008
chr16	66745289	66945289	harbor1	chr16	66752168	66752399	LTR/ERV1	736	+	116	66752284	6995
chr16	9665574	9865574	harbor1	chr16	9679839	9680468	LTR/ERV1	3832	+	314	9680153	14579
chr16	9665574	9865574	harbor1	chr16	9684105	9684379	LTR/ERV1	2125	+	137	9684242	18668
chr16	9665574	9865574	harbor1	chr16	9687101	9687424	LTR/ERV1	1938	+	162	9687263	21689
chr16	9665574	9865574	harbor1	chr16	9688388	9688972	LTR/ERV1	4439	+	292	9688680	23106
chr16	9665574	9865574	harbor1	chr16	9689276	9689621	LTR/ERV1	4439	+	172	9689448	23874
chr16	9665574	9865574	harbor1	chr16	9703495	9703783	LTR/ERV1	1732	+	144	9703639	38065
chr16	9665574	9865574	harbor1	chr16	9703889	9704246	LTR/ERV1	1826	+	178	9704067	38493
chr16	9665574	9865574	harbor1	chr16	9706163	9706778	LTR/ERV1	2459	+	308	9706471	40897
chr16	9665574	9865574	harbor1	chr16	9707018	9707057	LTR/ERV1	2459	+	20	9707038	41464
chr16	9665574	9865574	harbor1	chr16	9736977	9737546	LTR/ERV1	3345	+	284	9737261	71687
chr16	9665574	9865574	harbor1	chr16	9752523	9752698	LTR/ERV1	908	+	88	9752611	87037
chr16	83493587	83693587	harbor1	chr16	83554482	83554972	LTR/ERV1	2303	+	245	83554727	61140
chr16	30050244	30250244	harbor1	chr16	30096876	30097207	LTR/ERV1	1422	+	166	30097042	46798
chr16	30050244	30250244	harbor1	chr16	30099417	30099721	LTR/ERV1	13918	+	152	30099569	49325
chr16	30050244	30250244	harbor1	chr16	30100063	30101001	LTR/ERV1	13918	+	469	30100532	50288
chr16	30050244	30250244	harbor1	chr16	30101276	30102246	LTR/ERV1	13918	+	485	30101761	51517
chr16	30050244	30250244	harbor1	chr16	30102244	30103835	LTR/ERV1	10306	+	796	30103040	52796
chr16	30050244	30250244	harbor1	chr16	30103884	30104167	LTR/ERV1	1304	+	142	30104026	53782
chr16	30050244	30250244	harbor1	chr16	30132198	30132434	LTR/ERV1	3720	+	118	30132316	82072
chr16	30050244	30250244	harbor1	chr16	30132743	30133180	LTR/ERV1	3720	+	218	30132961	82717
chr16	30050244	30250244	harbor1	chr16	30097209	30099040	LTR/ERV1	11309	+	916	30098125	47881
chr16	19692850	19892850	harbor1	chr16	19785402	19785987	LTR/ERV1	3124	+	292	19785694	92844
chr16	19692850	19892850	harbor1	chr16	19787847	19788311	LTR/ERV1	2372	+	232	19788079	95229
chr16	46472164	46672164	harbor1	chr16	46533403	46533901	LTR/ERV1	1539	+	249	46533652	61488
chr16	46472164	46672164	harbor1	chr16	46542826	46542956	LTR/ERV1	688	+	65	46542891	70727
chr16	35739148	35939148	harbor1	chr16	35796175	35796468	LTR/ERV1	1550	+	146	35796321	57173
chr16	35739148	35939148	harbor1	chr16	35801964	35802059	LTR/ERV1	450	+	48	35802012	62864
chr16	35739148	35939148	harbor1	chr16	35816009	35816150	LTR/ERV1	767	+	70	35816079	76931
chr16	35739148	35939148	harbor1	chr16	35816313	35816714	LTR/ERV1	4454	+	200	35816513	77365
chr16	35739148	35939148	harbor1	chr16	35816715	35817227	LTR/ERV1	2359	+	256	35816971	77823
chr16	35739148	35939148	harbor1	chr16	35817228	35817366	LTR/ERV1	4454	+	69	35817297	78149
chr16	35739148	35939148	harbor1	chr16	35817624	35818013	LTR/ERV1	4454	+	194	35817818	78670
chr16	35739148	35939148	harbor1	chr16	35819014	35819288	LTR/ERV1	4454	+	137	35819151	80003
chr16	35739148	35939148	harbor1	chr16	35819388	35820979	LTR/ERV1	6732	+	796	35820184	81036
chr16	80213897	80413897	harbor1	chr16	80250801	80251422	LTR/ERV1	4256	+	310	80251111	37214
chr16	80213897	80413897	harbor1	chr16	80306196	80307064	LTR/ERV1	4295	+	434	80306630	92733
chr16	15921037	16121037	harbor1	chr16	15940362	15940530	LTR/ERV1	878	+	84	15940446	19409
chr16	15921037	16121037	harbor1	chr16	15940841	15940981	LTR/ERV1	878	+	70	15940911	19874
chr16	77628976	77828976	harbor1	chr16	77662100	77662350	LTR/ERV1	1638	+	125	77662225	33249
chr16	77628976	77828976	harbor1	chr16	77662333	77662772	LTR/ERV1	2626	+	220	77662553	33577
chr16	77628976	77828976	harbor1	chr16	77704556	77704769	LTR/ERV1	1293	+	106	77704662	75686
chr16	53312008	53512008	harbor1	chr16	53339000	53339137	LTR/ERV1	474	+	68	53339068	27060
chr16	53312008	53512008	harbor1	chr16	53342059	53342784	LTR/ERV1	3594	+	362	53342421	30413
chr16	23538564	23738564	harbor1	chr16	23548651	23549504	LTR/ERV1	2836	+	426	23549077	10513
chr16	61363094	61563094	harbor1	chr16	61399415	61399985	LTR/ERV1	1457	+	285	61399700	36606
chr16	66749036	66949036	harbor1	chr16	66752168	66752399	LTR/ERV1	736	+	116	66752284	3248
chr16	82651258	82851258	harbor1	chr16	82662907	82663176	LTR/ERV1	3238	+	134	82663041	11783
chr16	82651258	82851258	harbor1	chr16	82663485	82663804	LTR/ERV1	3238	+	160	82663645	12387
chr16	3963550	4163550	harbor1	chr16	4026830	4027367	LTR/ERV1	1877	+	268	4027098	63548
chr16	64346121	64546121	harbor1	chr16	64345205	64346552	LTR/ERV1	4342	+	674	64345879	242
chr16	64346121	64546121	harbor1	chr16	64380803	64382377	LTR/ERV1	7643	+	787	64381590	35469
chr16	64346121	64546121	harbor1	chr16	64437939	64438262	LTR/ERV1	2101	+	162	64438101	91980
chr16	65842735	66042735	harbor1	chr16	65864112	65864817	LTR/ERV1	4266	+	352	65864464	21729
chr16	65842735	66042735	harbor1	chr16	65895018	65895766	LTR/ERV1	4610	+	374	65895392	52657
chr16	88520198	88720198	harbor1	chr16	88565920	88566026	LTR/ERV1	2278	+	53	88565973	45775
chr16	88520198	88720198	harbor1	chr16	88566326	88566685	LTR/ERV1	2278	+	180	88566506	46308
chr16	55791274	55991274	harbor1	chr16	55804147	55804428	LTR/ERV1	4301	+	140	55804287	13013
chr16	55791274	55991274	harbor1	chr16	55805115	55805734	LTR/ERV1	4301	+	310	55805425	14151
chr16	55791274	55991274	harbor1	chr16	55811496	55811954	LTR/ERV1	1235	+	229	55811725	20451
chr16	55791274	55991274	harbor1	chr16	55812086	55812185	LTR/ERV1	461	+	50	55812136	20862
chr16	55791274	55991274	harbor1	chr16	55890699	55890765	LTR/ERV1	499	+	33	55890732	99458
chr16	55791274	55991274	harbor1	chr16	55890865	55891403	LTR/ERV1	3447	+	269	55891134	99860
chr16	428632	628632	harbor1	chr16	483277	484114	LTR/ERV1	4267	+	418	483695	55063
chr16	9610192	9810192	harbor1	chr16	9632773	9633246	LTR/ERV1	2524	+	236	9633009	22817
chr16	9610192	9810192	harbor1	chr16	9679839	9680468	LTR/ERV1	3832	+	314	9680153	69961
chr16	9610192	9810192	harbor1	chr16	9684105	9684379	LTR/ERV1	2125	+	137	9684242	74050
chr16	9610192	9810192	harbor1	chr16	9687101	9687424	LTR/ERV1	1938	+	162	9687263	77071
chr16	9610192	9810192	harbor1	chr16	9688388	9688972	LTR/ERV1	4439	+	292	9688680	78488
chr16	9610192	9810192	harbor1	chr16	9689276	9689621	LTR/ERV1	4439	+	172	9689448	79256
chr16	9610192	9810192	harbor1	chr16	9703495	9703783	LTR/ERV1	1732	+	144	9703639	93447
chr16	9610192	9810192	harbor1	chr16	9703889	9704246	LTR/ERV1	1826	+	178	9704067	93875
chr16	9610192	9810192	harbor1	chr16	9706163	9706778	LTR/ERV1	2459	+	308	9706471	96279
chr16	9610192	9810192	harbor1	chr16	9707018	9707057	LTR/ERV1	2459	+	20	9707038	96846
chr16	56913112	57113112	harbor1	chr16	56984581	56985148	LTR/ERV1	3003	+	284	56984865	71753
chr16	82195950	82395950	harbor1	chr16	82270524	82270613	LTR/ERV1	471	+	44	82270568	74618
chr16	82195950	82395950	harbor1	chr16	82270591	82270924	LTR/ERV1	1718	+	166	82270757	74807
chr16	60501510	60701510	harbor1	chr16	60577391	60577788	LTR/ERV1	2763	+	198	60577589	76079
chr16	60501510	60701510	harbor1	chr16	60577951	60578717	LTR/ERV1	6115	+	383	60578334	76824
chr16	60501510	60701510	harbor1	chr16	60578718	60579115	LTR/ERV1	2854	+	198	60578916	77406
chr16	64664388	64864388	harbor1	chr16	64747083	64747202	LTR/ERV1	674	+	60	64747143	82755
chr16	64664388	64864388	harbor1	chr16	64747196	64747476	LTR/ERV1	3179	+	140	64747336	82948
chr16	64664388	64864388	harbor1	chr16	64747838	64748089	LTR/ERV1	3179	+	126	64747964	83576
chr16	20653	220653	harbor1	chr16	27849	28407	LTR/ERV1	1042	+	279	28128	7475
chr16	20653	220653	harbor1	chr16	41012	41496	LTR/ERV1	3445	+	242	41254	20601
chr16	20653	220653	harbor1	chr16	41497	42751	LTR/ERV1	5592	+	627	42124	21471
chr16	20653	220653	harbor1	chr16	42729	43450	LTR/ERV1	4199	+	360	43089	22436
chr16	20653	220653	harbor1	chr16	43442	43561	LTR/ERV1	494	+	60	43502	22849
chr16	20653	220653	harbor1	chr16	43897	44027	LTR/ERV1	2023	+	65	43962	23309
chr16	20653	220653	harbor1	chr16	44342	44709	LTR/ERV1	2023	+	184	44526	23873
chr16	20653	220653	harbor1	chr16	44715	46385	LTR/ERV1	7723	+	835	45550	24897
chr16	20653	220653	harbor1	chr16	74663	75026	LTR/ERV1	2084	+	182	74845	54192
chr16	17878368	18078368	harbor1	chr16	17886512	17886731	LTR/ERV1	3425	+	110	17886622	8254
chr16	17878368	18078368	harbor1	chr16	17886986	17887376	LTR/ERV1	3425	+	195	17887181	8813
chr16	17878368	18078368	harbor1	chr16	17960831	17961370	LTR/ERV1	4120	+	270	17961101	82733
chr16	17878368	18078368	harbor1	chr16	17961879	17962428	LTR/ERV1	3336	+	274	17962153	83785
chr16	60532826	60732826	harbor1	chr16	60577391	60577788	LTR/ERV1	2763	+	198	60577589	44763
chr16	60532826	60732826	harbor1	chr16	60577951	60578717	LTR/ERV1	6115	+	383	60578334	45508
chr16	60532826	60732826	harbor1	chr16	60578718	60579115	LTR/ERV1	2854	+	198	60578916	46090
chr16	63465982	63665982	harbor1	chr16	63466217	63466379	LTR/ERV1	521	+	81	63466298	316
chr16	63465982	63665982	harbor1	chr16	63466381	63466812	LTR/ERV1	1211	+	216	63466597	615
chr16	19150381	19350381	harbor1	chr16	19237368	19237822	LTR/ERV1	2566	+	227	19237595	87214
chr16	64668348	64868348	harbor1	chr16	64747083	64747202	LTR/ERV1	674	+	60	64747143	78795
chr16	64668348	64868348	harbor1	chr16	64747196	64747476	LTR/ERV1	3179	+	140	64747336	78988
chr16	64668348	64868348	harbor1	chr16	64747838	64748089	LTR/ERV1	3179	+	126	64747964	79616
chr16	13545688	13745688	harbor1	chr16	13589827	13590275	LTR/ERV1	1927	+	224	13590051	44363
chr16	13545688	13745688	harbor1	chr16	13593532	13593552	LTR/ERV1	2051	+	10	13593542	47854
chr16	13545688	13745688	harbor1	chr16	13593851	13594303	LTR/ERV1	2051	+	226	13594077	48389
chr16	13545688	13745688	harbor1	chr16	13605902	13606135	LTR/ERV1	2676	+	116	13606018	60330
chr16	13545688	13745688	harbor1	chr16	13606412	13606606	LTR/ERV1	2676	+	97	13606509	60821
chr16	13545688	13745688	harbor1	chr16	13606894	13607091	LTR/ERV1	1033	+	98	13606992	61304
chr16	13545688	13745688	harbor1	chr16	13607420	13607601	LTR/ERV1	1162	+	90	13607510	61822
chr16	13545688	13745688	harbor1	chr16	13607875	13608037	LTR/ERV1	1000	+	81	13607956	62268
chr16	13545688	13745688	harbor1	chr16	13608351	13608540	LTR/ERV1	1140	+	94	13608445	62757
chr16	13545688	13745688	harbor1	chr16	13608765	13609245	LTR/ERV1	3395	+	240	13609005	63317
chr16	13545688	13745688	harbor1	chr16	13609557	13609715	LTR/ERV1	3395	+	79	13609636	63948
chr16	13545688	13745688	harbor1	chr16	13610041	13610697	LTR/ERV1	4794	+	328	13610369	64681
chr16	13545688	13745688	harbor1	chr16	13619690	13619987	LTR/ERV1	2180	+	148	13619838	74150
chr16	13545688	13745688	harbor1	chr16	13620299	13620711	LTR/ERV1	2180	+	206	13620505	74817
chr16	13545688	13745688	harbor1	chr16	13631853	13632437	LTR/ERV1	4093	+	292	13632145	86457
chr16	13545688	13745688	harbor1	chr16	13633627	13634291	LTR/ERV1	5007	+	332	13633959	88271
chr16	13545688	13745688	harbor1	chr16	13637609	13637931	LTR/ERV1	1143	+	161	13637770	92082
chr16	13545688	13745688	harbor1	chr16	13631207	13631814	LTR/ERV1	3723	+	304	13631511	85823
chr16	27884862	28084862	harbor1	chr16	27984546	27984745	LTR/ERV1	5175	+	100	27984646	99784
chr17	16615146	16815146	harbor1	chr17	16644675	16645157	LTR/ERV1	1894	+	241	16644916	29770
chr17	16615146	16815146	harbor1	chr17	16677090	16677431	LTR/ERV1	1077	+	170	16677260	62114
chr17	16615146	16815146	harbor1	chr17	16678218	16678567	LTR/ERV1	1926	+	174	16678392	63246
chr17	16615146	16815146	harbor1	chr17	16688803	16689044	LTR/ERV1	1355	+	120	16688923	73777
chr17	54213243	54413243	harbor1	chr17	54216226	54216847	LTR/ERV1	3041	+	310	54216536	3293
chr17	54213243	54413243	harbor1	chr17	54286175	54286643	LTR/ERV1	2689	+	234	54286409	73166
chr17	54213243	54413243	harbor1	chr17	54286665	54289281	LTR/ERV1	48495	+	1308	54287973	74730
chr17	54213243	54413243	harbor1	chr17	54289564	54293612	LTR/ERV1	48495	+	2024	54291588	78345
chr17	53704825	53904825	harbor1	chr17	53790309	53790693	LTR/ERV1	2370	+	192	53790501	85676
chr17	53704825	53904825	harbor1	chr17	53791600	53792118	LTR/ERV1	1915	+	259	53791859	87034
chr17	53704825	53904825	harbor1	chr17	53792127	53793360	LTR/ERV1	7154	+	616	53792743	87918
chr17	53704825	53904825	harbor1	chr17	53706576	53707320	LTR/ERV1	3484	+	372	53706948	2123
chr17	7881354	8081354	harbor1	chr17	7961793	7961995	LTR/ERV1	593	+	101	7961894	80540
chr17	80795155	80995155	harbor1	chr17	80804411	80804602	LTR/ERV1	863	+	96	80804507	9352
chr17	82409283	82609283	harbor1	chr17	82451575	82451756	LTR/ERV1	4325	+	90	82451665	42382
chr17	82409283	82609283	harbor1	chr17	82452067	82452721	LTR/ERV1	4325	+	327	82452394	43111
chr17	82409283	82609283	harbor1	chr17	82455835	82455870	LTR/ERV1	3586	+	18	82455853	46570
chr17	82409283	82609283	harbor1	chr17	82456170	82456726	LTR/ERV1	3586	+	278	82456448	47165
chr17	82409283	82609283	harbor1	chr17	82457038	82457193	LTR/ERV1	3586	+	78	82457116	47833
chr17	82409283	82609283	harbor1	chr17	82507500	82507971	LTR/ERV1	1963	+	236	82507736	98453
chr17	60270176	60470176	harbor1	chr17	60284729	60285093	LTR/ERV1	1389	+	182	60284911	14735
chr17	60270176	60470176	harbor1	chr17	60286514	60286867	LTR/ERV1	3255	+	176	60286690	16514
chr17	60270176	60470176	harbor1	chr17	60287153	60287605	LTR/ERV1	3255	+	226	60287379	17203
chr17	60270176	60470176	harbor1	chr17	60290028	60290347	LTR/ERV1	992	+	160	60290188	20012
chr17	60270176	60470176	harbor1	chr17	60296817	60297116	LTR/ERV1	4185	+	150	60296967	26791
chr17	60270176	60470176	harbor1	chr17	60297398	60297436	LTR/ERV1	4185	+	19	60297417	27241
chr17	60270176	60470176	harbor1	chr17	60297733	60298427	LTR/ERV1	4185	+	347	60298080	27904
chr17	60270176	60470176	harbor1	chr17	60307641	60308462	LTR/ERV1	4595	+	410	60308051	37875
chr17	60270176	60470176	harbor1	chr17	60327238	60327371	LTR/ERV1	625	+	66	60327304	57128
chr17	60270176	60470176	harbor1	chr17	60327418	60329098	LTR/ERV1	6342	+	840	60328258	58082
chr17	18529767	18729767	harbor1	chr17	18547166	18547825	LTR/ERV1	5350	+	330	18547496	17729
chr17	18529767	18729767	harbor1	chr17	18549297	18549766	LTR/ERV1	3794	+	234	18549531	19764
chr17	18803951	19003951	harbor1	chr17	18809598	18810127	LTR/ERV1	1878	+	264	18809862	5911
chr17	46059641	46259641	harbor1	chr17	46079287	46079602	LTR/ERV1	559	+	158	46079445	19804
chr17	22427487	22627487	harbor1	chr17	22450004	22450496	LTR/ERV1	1566	+	246	22450250	22763
chr17	22427487	22627487	harbor1	chr17	22456201	22457007	LTR/ERV1	4792	+	403	22456604	29117
chr17	22427487	22627487	harbor1	chr17	22457682	22458278	LTR/ERV1	2435	+	298	22457980	30493
chr17	22427487	22627487	harbor1	chr17	22458572	22459078	LTR/ERV1	2587	+	253	22458825	31338
chr17	22427487	22627487	harbor1	chr17	22461502	22462052	LTR/ERV1	1873	+	275	22461777	34290
chr17	22427487	22627487	harbor1	chr17	22482859	22483392	LTR/ERV1	654	+	266	22483125	55638
chr17	63774640	63974640	harbor1	chr17	63852470	63852933	LTR/ERV1	1285	+	232	63852702	78062
chr17	51323513	51523513	harbor1	chr17	51366027	51366771	LTR/ERV1	5514	+	372	51366399	42886
chr17	39948885	40148885	harbor1	chr17	40010751	40011682	LTR/ERV1	6706	+	466	40011217	62332
chr17	39948885	40148885	harbor1	chr17	40012165	40012756	LTR/ERV1	4343	+	296	40012461	63576
chr17	71872766	72072766	harbor1	chr17	71915949	71916718	LTR/ERV1	5405	+	384	71916333	43567
chr17	71872766	72072766	harbor1	chr17	71949825	71950176	LTR/ERV1	2584	+	176	71950001	77235
chr17	22311968	22511968	harbor1	chr17	22322715	22322944	LTR/ERV1	769	+	114	22322829	10861
chr17	22311968	22511968	harbor1	chr17	22323257	22323724	LTR/ERV1	2042	+	234	22323491	11523
chr17	22311968	22511968	harbor1	chr17	22334565	22335046	LTR/ERV1	839	+	240	22334805	22837
chr17	22311968	22511968	harbor1	chr17	22358073	22358414	LTR/ERV1	1421	+	170	22358243	46275
chr17	15828419	16028419	harbor1	chr17	15859883	15860320	LTR/ERV1	3266	+	218	15860101	31682
chr17	64339005	64539005	harbor1	chr17	64338859	64339047	LTR/ERV1	1031	+	94	64338953	52
chr17	64339005	64539005	harbor1	chr17	64392995	64393185	LTR/ERV1	945	+	95	64393090	54085
chr17	64339005	64539005	harbor1	chr17	64406857	64407347	LTR/ERV1	3006	+	245	64407102	68097
chr17	64339005	64539005	harbor1	chr17	64408576	64408706	LTR/ERV1	697	+	65	64408641	69636
chr17	64339005	64539005	harbor1	chr17	64421422	64421844	LTR/ERV1	3231	+	211	64421633	82628
chr17	64339005	64539005	harbor1	chr17	64422100	64422117	LTR/ERV1	3231	+	8	64422108	83103
chr17	64339005	64539005	harbor1	chr17	64422436	64422577	LTR/ERV1	3231	+	70	64422506	83501
chr17	64339005	64539005	harbor1	chr17	64422580	64422876	LTR/ERV1	1854	+	148	64422728	83723
chr17	64339005	64539005	harbor1	chr17	64422876	64422963	LTR/ERV1	901	+	44	64422920	83915
chr17	64339005	64539005	harbor1	chr17	64423279	64423330	LTR/ERV1	901	+	26	64423305	84300
chr17	64339005	64539005	harbor1	chr17	64423331	64423500	LTR/ERV1	4919	+	84	64423415	84410
chr17	64339005	64539005	harbor1	chr17	64423812	64424331	LTR/ERV1	4919	+	260	64424072	85067
chr17	64339005	64539005	harbor1	chr17	64424332	64424385	LTR/ERV1	901	+	26	64424358	85353
chr17	64339005	64539005	harbor1	chr17	64426448	64427106	LTR/ERV1	2980	+	329	64426777	87772
chr17	64339005	64539005	harbor1	chr17	64432051	64432601	LTR/ERV1	8774	+	275	64432326	93321
chr17	64339005	64539005	harbor1	chr17	64432893	64433402	LTR/ERV1	8774	+	254	64433147	94142
chr17	64339005	64539005	harbor1	chr17	64433772	64434486	LTR/ERV1	8774	+	357	64434129	95124
chr17	64339005	64539005	harbor1	chr17	64434801	64435228	LTR/ERV1	8774	+	214	64435015	96010
chr17	64339005	64539005	harbor1	chr17	64435512	64435707	LTR/ERV1	8774	+	98	64435610	96605
chr17	64339005	64539005	harbor1	chr17	64436064	64436103	LTR/ERV1	6710	+	20	64436084	97079
chr17	64339005	64539005	harbor1	chr17	64436411	64436712	LTR/ERV1	6710	+	150	64436561	97556
chr17	64339005	64539005	harbor1	chr17	64437015	64437256	LTR/ERV1	4761	+	120	64437135	98130
chr17	64339005	64539005	harbor1	chr17	64437259	64437670	LTR/ERV1	2614	+	206	64437465	98460
chr17	64339005	64539005	harbor1	chr17	64437669	64437924	LTR/ERV1	1243	+	128	64437797	98792
chr17	1190416	1390416	harbor1	chr17	1240203	1240736	LTR/ERV1	4943	+	266	1240469	50053
chr17	1190416	1390416	harbor1	chr17	1241049	1241208	LTR/ERV1	4943	+	80	1241129	50713
chr17	20994147	21194147	harbor1	chr17	21055084	21055218	LTR/ERV1	1388	+	67	21055151	61004
chr17	20994147	21194147	harbor1	chr17	21055244	21055259	LTR/ERV1	1388	+	8	21055252	61105
chr17	20994147	21194147	harbor1	chr17	21055539	21055745	LTR/ERV1	1388	+	103	21055642	61495
chr17	20994147	21194147	harbor1	chr17	21056051	21056168	LTR/ERV1	1388	+	58	21056109	61962
chr17	20994147	21194147	harbor1	chr17	21081893	21082454	LTR/ERV1	3269	+	280	21082173	88026
chr17	61232526	61432526	harbor1	chr17	61237098	61237651	LTR/ERV1	3853	+	276	61237374	4848
chr17	61232526	61432526	harbor1	chr17	61284001	61284574	LTR/ERV1	3733	+	286	61284287	51761
chr17	35080978	35280978	harbor1	chr17	35095184	35095200	LTR/ERV1	1229	+	8	35095192	14214
chr17	35080978	35280978	harbor1	chr17	35095491	35095507	LTR/ERV1	1229	+	8	35095499	14521
chr17	35080978	35280978	harbor1	chr17	35095811	35096183	LTR/ERV1	1229	+	186	35095997	15019
chr17	79648872	79848872	harbor1	chr17	79696529	79697275	LTR/ERV1	4411	+	373	79696902	48030
chr17	35430322	35630322	harbor1	chr17	35482348	35483431	LTR/ERV1	4222	+	542	35482890	52568
chr17	35430322	35630322	harbor1	chr17	35500300	35500447	LTR/ERV1	3490	+	74	35500374	70052
chr17	35430322	35630322	harbor1	chr17	35500743	35501070	LTR/ERV1	3490	+	164	35500907	70585
chr17	35430322	35630322	harbor1	chr17	35507908	35508365	LTR/ERV1	3771	+	228	35508136	77814
chr17	35430322	35630322	harbor1	chr17	35519808	35520416	LTR/ERV1	3835	+	304	35520112	89790
chr17	35430322	35630322	harbor1	chr17	35520418	35520462	LTR/ERV1	1101	+	22	35520440	90118
chr17	35430322	35630322	harbor1	chr17	35520758	35521053	LTR/ERV1	1101	+	148	35520906	90584
chr17	35430322	35630322	harbor1	chr17	35501071	35507907	LTR/ERV1	54136	+	3418	35504489	74167
chr17	82924913	83124913	harbor1	chr17	82981507	82981769	LTR/ERV1	1279	+	131	82981638	56725
chr17	65239108	65439108	harbor1	chr17	65239269	65239393	LTR/ERV1	520	+	62	65239331	223
chr17	65239108	65439108	harbor1	chr17	65272930	65273634	LTR/ERV1	4479	+	352	65273282	34174
chr17	41609907	41809907	harbor1	chr17	41671949	41671999	LTR/ERV1	1110	+	25	41671974	62067
chr17	41609907	41809907	harbor1	chr17	41672308	41672583	LTR/ERV1	1110	+	138	41672446	62539
chr17	41609907	41809907	harbor1	chr17	41672718	41672743	LTR/ERV1	1110	+	12	41672730	62823
chr17	41609907	41809907	harbor1	chr17	41673048	41673066	LTR/ERV1	1110	+	9	41673057	63150
chr17	41609907	41809907	harbor1	chr17	41675224	41675426	LTR/ERV1	2788	+	101	41675325	65418
chr17	41609907	41809907	harbor1	chr17	41675732	41676059	LTR/ERV1	2788	+	164	41675896	65989
chr17	41609907	41809907	harbor1	chr17	41677844	41677957	LTR/ERV1	643	+	56	41677900	67993
chr17	41609907	41809907	harbor1	chr17	41678269	41678329	LTR/ERV1	643	+	30	41678299	68392
chr17	41609907	41809907	harbor1	chr17	41678325	41678495	LTR/ERV1	857	+	85	41678410	68503
chr17	41609907	41809907	harbor1	chr17	41678503	41678687	LTR/ERV1	710	+	92	41678595	68688
chr17	76601103	76801103	harbor1	chr17	76620933	76621171	LTR/ERV1	2247	+	119	76621052	19949
chr17	76601103	76801103	harbor1	chr17	76621775	76621942	LTR/ERV1	2247	+	84	76621859	20756
chr17	76601103	76801103	harbor1	chr17	76640866	76641353	LTR/ERV1	3302	+	244	76641110	40007
chr17	22247596	22447596	harbor1	chr17	22286288	22287016	LTR/ERV1	1655	+	364	22286652	39056
chr17	22247596	22447596	harbor1	chr17	22322715	22322944	LTR/ERV1	769	+	114	22322829	75233
chr17	22247596	22447596	harbor1	chr17	22323257	22323724	LTR/ERV1	2042	+	234	22323491	75895
chr17	22247596	22447596	harbor1	chr17	22334565	22335046	LTR/ERV1	839	+	240	22334805	87209
chr17	37824940	38024940	harbor1	chr17	37897090	37897715	LTR/ERV1	4256	+	312	37897402	72462
chr17	21309297	21509297	harbor1	chr17	21334086	21334933	LTR/ERV1	4818	+	424	21334510	25213
chr17	82920787	83120787	harbor1	chr17	82981507	82981769	LTR/ERV1	1279	+	131	82981638	60851
chr17	22159431	22359431	harbor1	chr17	22194161	22194610	LTR/ERV1	1274	+	224	22194385	34954
chr17	22159431	22359431	harbor1	chr17	22213022	22213635	LTR/ERV1	4224	+	306	22213328	53897
chr17	22159431	22359431	harbor1	chr17	22226804	22227135	LTR/ERV1	3087	+	166	22226970	67539
chr17	22159431	22359431	harbor1	chr17	22227434	22227707	LTR/ERV1	3087	+	136	22227570	68139
chr17	7988100	8188100	harbor1	chr17	8055134	8055224	LTR/ERV1	848	+	45	8055179	67079
chr17	7988100	8188100	harbor1	chr17	8055521	8055854	LTR/ERV1	848	+	166	8055687	67587
chr17	7988100	8188100	harbor1	chr17	8061907	8062290	LTR/ERV1	2073	+	192	8062099	73999
chr17	82082923	82282923	harbor1	chr17	82137358	82137673	LTR/ERV1	1445	+	158	82137516	54593
chr17	82082923	82282923	harbor1	chr17	82137972	82138079	LTR/ERV1	1445	+	54	82138026	55103
chr17	82082923	82282923	harbor1	chr17	82139044	82139347	LTR/ERV1	2407	+	152	82139196	56273
chr17	82082923	82282923	harbor1	chr17	82139656	82140079	LTR/ERV1	2407	+	212	82139868	56945
chr17	82082923	82282923	harbor1	chr17	82140524	82140956	LTR/ERV1	1843	+	216	82140740	57817
chr17	82082923	82282923	harbor1	chr17	82141482	82141661	LTR/ERV1	811	+	90	82141572	58649
chr17	82082923	82282923	harbor1	chr17	82141828	82142188	LTR/ERV1	747	+	180	82142008	59085
chr17	82082923	82282923	harbor1	chr17	82174354	82174999	LTR/ERV1	1997	+	322	82174676	91753
chr17	82082923	82282923	harbor1	chr17	82175383	82175813	LTR/ERV1	3131	+	215	82175598	92675
chr17	82082923	82282923	harbor1	chr17	82175817	82176010	LTR/ERV1	1217	+	96	82175913	92990
chr17	82082923	82282923	harbor1	chr17	82176718	82176962	LTR/ERV1	1471	+	122	82176840	93917
chr17	67652128	67852128	harbor1	chr17	67658138	67658651	LTR/ERV1	2452	+	256	67658394	6266
chr17	67652128	67852128	harbor1	chr17	67750624	67751707	LTR/ERV1	6860	+	542	67751166	99038
chr17	51648157	51848157	harbor1	chr17	51668600	51669762	LTR/ERV1	6799	+	581	51669181	21024
chr17	51648157	51848157	harbor1	chr17	51669764	51669853	LTR/ERV1	722	+	44	51669808	21651
chr17	70075526	70275526	harbor1	chr17	70095223	70095676	LTR/ERV1	1826	+	226	70095449	19923
chr17	288031	488031	harbor1	chr17	361411	362697	LTR/ERV1	8793	+	643	362054	74023
chr17	288031	488031	harbor1	chr17	371908	372488	LTR/ERV1	4107	+	290	372198	84167
chr17	18990903	19190903	harbor1	chr17	19066570	19066696	LTR/ERV1	828	+	63	19066633	75730
chr17	28390360	28590360	harbor1	chr17	28440491	28440929	LTR/ERV1	1581	+	219	28440710	50350
chr17	40877374	41077374	harbor1	chr17	40898086	40898489	LTR/ERV1	1214	+	202	40898288	20914
chr17	9545139	9745139	harbor1	chr17	9573044	9573680	LTR/ERV1	4137	+	318	9573362	28223
chr17	6028992	6228992	harbor1	chr17	6099115	6099234	LTR/ERV1	2719	+	60	6099175	70183
chr17	6028992	6228992	harbor1	chr17	6099536	6099987	LTR/ERV1	2719	+	226	6099762	70770
chr17	63994936	64194936	harbor1	chr17	64009660	64009900	LTR/ERV1	1544	+	120	64009780	14844
chr17	63994936	64194936	harbor1	chr17	64009925	64010240	LTR/ERV1	1823	+	158	64010083	15147
chr17	63994936	64194936	harbor1	chr17	64037763	64038359	LTR/ERV1	3446	+	298	64038061	43125
chr17	33455197	33655197	harbor1	chr17	33467374	33467951	LTR/ERV1	3045	+	288	33467662	12465
chr17	33455197	33655197	harbor1	chr17	33484652	33485117	LTR/ERV1	2355	+	232	33484884	29687
chr17	49314948	49514948	harbor1	chr17	49393537	49393986	LTR/ERV1	2587	+	224	49393761	78813
chr17	56704203	56904203	harbor1	chr17	56752649	56752991	LTR/ERV1	1308	+	171	56752820	48617
chr17	56704203	56904203	harbor1	chr17	56784646	56785215	LTR/ERV1	1604	+	284	56784930	80727
chr17	13672687	13872687	harbor1	chr17	13748766	13749257	LTR/ERV1	1525	+	246	13749012	76325
chr17	13672687	13872687	harbor1	chr17	13750133	13750674	LTR/ERV1	607	+	270	13750403	77716
chr17	13672687	13872687	harbor1	chr17	13751099	13751598	LTR/ERV1	3140	+	250	13751349	78662
chr17	78483526	78683526	harbor1	chr17	78508123	78508608	LTR/ERV1	1976	+	242	78508365	24839
chr17	78483526	78683526	harbor1	chr17	78512467	78512659	LTR/ERV1	1471	+	96	78512563	29037
chr17	78483526	78683526	harbor1	chr17	78512968	78513053	LTR/ERV1	1471	+	42	78513010	29484
chr17	78483526	78683526	harbor1	chr17	78513056	78513435	LTR/ERV1	2383	+	190	78513246	29720
chr17	78483526	78683526	harbor1	chr17	78513735	78513833	LTR/ERV1	537	+	49	78513784	30258
chr17	78483526	78683526	harbor1	chr17	78564977	78565288	LTR/ERV1	1355	+	156	78565133	81607
chr17	78483526	78683526	harbor1	chr17	78579450	78579971	LTR/ERV1	3890	+	260	78579710	96184
chr17	50448896	50648896	harbor1	chr17	50493781	50494226	LTR/ERV1	2676	+	222	50494003	45107
chr17	22067008	22267008	harbor1	chr17	22139111	22139503	LTR/ERV1	1387	+	196	22139307	72299
chr17	22067008	22267008	harbor1	chr17	22141833	22142551	LTR/ERV1	3893	+	359	22142192	75184
chr17	22067008	22267008	harbor1	chr17	22118341	22118605	LTR/ERV1	921	+	132	22118473	51465
chr17	80386460	80586460	harbor1	chr17	80397328	80397781	LTR/ERV1	3748	+	226	80397554	11094
chr17	80386460	80586460	harbor1	chr17	80397782	80399793	LTR/ERV1	7508	+	1006	80398788	12328
chr17	80386460	80586460	harbor1	chr17	80399794	80400230	LTR/ERV1	3625	+	218	80400012	13552
chr17	80386460	80586460	harbor1	chr17	80400241	80403146	LTR/ERV1	8045	+	1452	80401693	15233
chr17	80386460	80586460	harbor1	chr17	80403181	80403381	LTR/ERV1	8045	+	100	80403281	16821
chr17	80386460	80586460	harbor1	chr17	80403368	80403814	LTR/ERV1	2708	+	223	80403591	17131
chr17	80386460	80586460	harbor1	chr17	80403803	80407762	LTR/ERV1	23016	+	1980	80405783	19323
chr17	80386460	80586460	harbor1	chr17	80407763	80408186	LTR/ERV1	3293	+	212	80407975	21515
chr17	80386460	80586460	harbor1	chr17	80408187	80408936	LTR/ERV1	5046	+	374	80408561	22101
chr17	80386460	80586460	harbor1	chr17	80408952	80412448	LTR/ERV1	28946	+	1748	80410700	24240
chr17	80386460	80586460	harbor1	chr17	80413069	80413516	LTR/ERV1	3587	+	224	80413293	26833
chr17	80386460	80586460	harbor1	chr17	80413692	80414080	LTR/ERV1	1879	+	194	80413886	27426
chr17	80386460	80586460	harbor1	chr17	80437627	80438110	LTR/ERV1	2507	+	242	80437869	51409
chr17	80386460	80586460	harbor1	chr17	80412538	80413064	LTR/ERV1	28946	+	263	80412801	26341
chr17	63920891	64120891	harbor1	chr17	64009660	64009900	LTR/ERV1	1544	+	120	64009780	88889
chr17	63920891	64120891	harbor1	chr17	64009925	64010240	LTR/ERV1	1823	+	158	64010083	89192
chr17	71804052	72004052	harbor1	chr17	71824829	71825301	LTR/ERV1	944	+	236	71825065	21013
chr17	71804052	72004052	harbor1	chr17	71842913	71843242	LTR/ERV1	1885	+	164	71843077	39025
chr17	66588735	66788735	harbor1	chr17	66602766	66603101	LTR/ERV1	1736	+	168	66602934	14199
chr17	77654730	77854730	harbor1	chr17	77686623	77687052	LTR/ERV1	2059	+	214	77686837	32107
chr17	77654730	77854730	harbor1	chr17	77701875	77702034	LTR/ERV1	2454	+	80	77701955	47225
chr17	77654730	77854730	harbor1	chr17	77702409	77702760	LTR/ERV1	2454	+	176	77702585	47855
chr17	77654730	77854730	harbor1	chr17	77747831	77748443	LTR/ERV1	3600	+	306	77748137	93407
chr17	77654730	77854730	harbor1	chr17	77754361	77754589	LTR/ERV1	927	+	114	77754475	99745
chr17	39862049	40062049	harbor1	chr17	39917414	39917823	LTR/ERV1	2702	+	204	39917618	55569
chr17	39862049	40062049	harbor1	chr17	39947215	39947882	LTR/ERV1	5153	+	334	39947549	85500
chr17	45835176	46035176	harbor1	chr17	45867960	45868643	LTR/ERV1	4947	+	342	45868302	33126
chr17	15386660	15586660	harbor1	chr17	15485040	15485606	LTR/ERV1	1696	+	283	15485323	98663
chr17	5232216	5432216	harbor1	chr17	5239873	5240064	LTR/ERV1	897	+	96	5239969	7753
chr17	5232216	5432216	harbor1	chr17	5241258	5241581	LTR/ERV1	1157	+	162	5241420	9204
chr17	5232216	5432216	harbor1	chr17	5246113	5246281	LTR/ERV1	4494	+	84	5246197	13981
chr17	5232216	5432216	harbor1	chr17	5246613	5247027	LTR/ERV1	4494	+	207	5246820	14604
chr17	5232216	5432216	harbor1	chr17	5247336	5247504	LTR/ERV1	4494	+	84	5247420	15204
chr17	5232216	5432216	harbor1	chr17	5271960	5272650	LTR/ERV1	5250	+	345	5272305	40089
chr17	14988060	15188060	harbor1	chr17	15072252	15072703	LTR/ERV1	1389	+	226	15072478	84418
chr17	14988060	15188060	harbor1	chr17	15072922	15073078	LTR/ERV1	1389	+	78	15073000	84940
chr17	14988060	15188060	harbor1	chr17	15083702	15084125	LTR/ERV1	1988	+	212	15083914	95854
chr17	14988060	15188060	harbor1	chr17	15085063	15085226	LTR/ERV1	1988	+	82	15085145	97085
chr17	71323177	71523177	harbor1	chr17	71323759	71324399	LTR/ERV1	3121	+	320	71324079	902
chr17	71323177	71523177	harbor1	chr17	71341184	71341737	LTR/ERV1	3919	+	276	71341460	18283
chr17	60064482	60264482	harbor1	chr17	60152821	60153055	LTR/ERV1	3797	+	117	60152938	88456
chr17	60064482	60264482	harbor1	chr17	60153352	60153634	LTR/ERV1	3797	+	141	60153493	89011
chr17	60064482	60264482	harbor1	chr17	60129092	60129363	LTR/ERV1	639	+	136	60129228	64746
chr17	8260718	8460718	harbor1	chr17	8306373	8306514	LTR/ERV1	2746	+	70	8306443	45725
chr17	8260718	8460718	harbor1	chr17	8306804	8307083	LTR/ERV1	2746	+	140	8306944	46226
chr17	8260718	8460718	harbor1	chr17	8307335	8307346	LTR/ERV1	2746	+	6	8307341	46623
chr17	8260718	8460718	harbor1	chr17	8307347	8307413	LTR/ERV1	479	+	33	8307380	46662
chr17	8260718	8460718	harbor1	chr17	8307731	8308240	LTR/ERV1	3542	+	254	8307985	47267
chr17	8260718	8460718	harbor1	chr17	8308533	8308607	LTR/ERV1	3542	+	37	8308570	47852
chr17	8260718	8460718	harbor1	chr17	8338305	8338827	LTR/ERV1	2925	+	261	8338566	77848
chr17	70012207	70212207	harbor1	chr17	70095223	70095676	LTR/ERV1	1826	+	226	70095449	83242
chr17	70508440	70708440	harbor1	chr17	70524850	70525215	LTR/ERV1	2360	+	182	70525032	16592
chr17	70508440	70708440	harbor1	chr17	70525535	70525638	LTR/ERV1	2360	+	52	70525587	17147
chr17	70508440	70708440	harbor1	chr17	70542012	70542565	LTR/ERV1	4033	+	276	70542288	33848
chr17	70508440	70708440	harbor1	chr17	70577209	70577969	LTR/ERV1	4993	+	380	70577589	69149
chr17	41509090	41709090	harbor1	chr17	41556570	41557244	LTR/ERV1	4432	+	337	41556907	47817
chr17	41509090	41709090	harbor1	chr17	41559983	41560120	LTR/ERV1	1012	+	68	41560051	50961
chr17	74907816	75107816	harbor1	chr17	74908753	74908874	LTR/ERV1	762	+	60	74908813	997
chr17	74907816	75107816	harbor1	chr17	74908881	74913551	LTR/ERV1	28379	+	2335	74911216	3400
chr17	74907816	75107816	harbor1	chr17	74913552	74914455	LTR/ERV1	5969	+	452	74914004	6188
chr17	53894330	54094330	harbor1	chr17	53957445	53957547	LTR/ERV1	494	+	51	53957496	63166
chr17	53894330	54094330	harbor1	chr17	53957572	53957992	LTR/ERV1	2119	+	210	53957782	63452
chr17	53894330	54094330	harbor1	chr17	53980016	53980491	LTR/ERV1	3168	+	238	53980254	85924
chr17	53894330	54094330	harbor1	chr17	53993524	53993961	LTR/ERV1	1126	+	218	53993742	99412
chr17	29223231	29423231	harbor1	chr17	29237674	29237702	LTR/ERV1	574	+	14	29237688	14457
chr17	29223231	29423231	harbor1	chr17	29238007	29238079	LTR/ERV1	574	+	36	29238043	14812
chr17	29223231	29423231	harbor1	chr17	29238388	29239082	LTR/ERV1	1785	+	347	29238735	15504
chr17	29223231	29423231	harbor1	chr17	29239380	29239585	LTR/ERV1	1785	+	102	29239482	16251
chr17	29223231	29423231	harbor1	chr17	29240188	29240339	LTR/ERV1	1785	+	76	29240264	17033
chr17	17337177	17537177	harbor1	chr17	17371296	17371404	LTR/ERV1	843	+	54	17371350	34173
chr17	17337177	17537177	harbor1	chr17	17371520	17371651	LTR/ERV1	956	+	66	17371586	34409
chr17	17337177	17537177	harbor1	chr17	17371999	17372146	LTR/ERV1	2635	+	74	17372073	34896
chr17	17337177	17537177	harbor1	chr17	17372445	17372462	LTR/ERV1	2635	+	8	17372453	35276
chr17	17337177	17537177	harbor1	chr17	17372609	17373117	LTR/ERV1	2635	+	254	17372863	35686
chr17	17337177	17537177	harbor1	chr17	17391557	17392445	LTR/ERV1	3324	+	444	17392001	54824
chr17	17337177	17537177	harbor1	chr17	17400136	17400585	LTR/ERV1	2248	+	224	17400360	63183
chr17	17337177	17537177	harbor1	chr17	17423907	17425501	LTR/ERV1	7907	+	797	17424704	87527
chr17	17337177	17537177	harbor1	chr17	17425610	17426056	LTR/ERV1	3346	+	223	17425833	88656
chr17	17337177	17537177	harbor1	chr17	17426349	17426429	LTR/ERV1	3346	+	40	17426389	89212
chr17	17337177	17537177	harbor1	chr17	17426573	17427630	LTR/ERV1	7404	+	528	17427101	89924
chr17	17337177	17537177	harbor1	chr17	17427713	17427823	LTR/ERV1	2038	+	55	17427768	90591
chr17	17337177	17537177	harbor1	chr17	17428089	17430193	LTR/ERV1	7970	+	1052	17429141	91964
chr17	17337177	17537177	harbor1	chr17	17430225	17430330	LTR/ERV1	584	+	52	17430277	93100
chr17	47405517	47605517	harbor1	chr17	47470453	47470542	LTR/ERV1	1469	+	44	47470497	64980
chr17	47405517	47605517	harbor1	chr17	47470850	47471109	LTR/ERV1	1469	+	130	47470980	65463
chr17	74247114	74447114	harbor1	chr17	74267020	74267555	LTR/ERV1	2743	+	268	74267288	20174
chr17	35492876	35692876	harbor1	chr17	35500300	35500447	LTR/ERV1	3490	+	74	35500374	7498
chr17	35492876	35692876	harbor1	chr17	35500743	35501070	LTR/ERV1	3490	+	164	35500907	8031
chr17	35492876	35692876	harbor1	chr17	35507908	35508365	LTR/ERV1	3771	+	228	35508136	15260
chr17	35492876	35692876	harbor1	chr17	35519808	35520416	LTR/ERV1	3835	+	304	35520112	27236
chr17	35492876	35692876	harbor1	chr17	35520418	35520462	LTR/ERV1	1101	+	22	35520440	27564
chr17	35492876	35692876	harbor1	chr17	35520758	35521053	LTR/ERV1	1101	+	148	35520906	28030
chr17	35492876	35692876	harbor1	chr17	35551288	35552264	LTR/ERV1	5937	+	488	35551776	58900
chr17	35492876	35692876	harbor1	chr17	35552268	35552593	LTR/ERV1	2883	+	162	35552430	59554
chr17	35492876	35692876	harbor1	chr17	35501071	35507907	LTR/ERV1	54136	+	3418	35504489	11613
chr17	80819292	81019292	harbor1	chr17	80914119	80916662	LTR/ERV1	6418	+	1272	80915391	96099
chr17	44894203	45094203	harbor1	chr17	44985383	44986193	LTR/ERV1	4908	+	405	44985788	91585
chr17	37827468	38027468	harbor1	chr17	37897090	37897715	LTR/ERV1	4256	+	312	37897402	69934
chr17	62665157	62865157	harbor1	chr17	62695373	62695795	LTR/ERV1	2980	+	211	62695584	30427
chr17	62665157	62865157	harbor1	chr17	62696094	62696181	LTR/ERV1	2980	+	44	62696138	30981
chr17	41266533	41466533	harbor1	chr17	41298207	41298994	LTR/ERV1	4848	+	394	41298601	32068
chr17	55134541	55334541	harbor1	chr17	55215284	55215400	LTR/ERV1	3509	+	58	55215342	80801
chr17	55134541	55334541	harbor1	chr17	55215704	55216305	LTR/ERV1	3509	+	300	55216004	81463
chr17	74981108	75181108	harbor1	chr17	75025088	75025740	LTR/ERV1	4668	+	326	75025414	44306
chr17	14162247	14362247	harbor1	chr17	14235376	14235669	LTR/ERV1	1032	+	146	14235522	73275
chr17	14162247	14362247	harbor1	chr17	14238215	14238309	LTR/ERV1	595	+	47	14238262	76015
chr17	14162247	14362247	harbor1	chr17	14252906	14253363	LTR/ERV1	2342	+	228	14253134	90887
chr17	15442413	15642413	harbor1	chr17	15485040	15485606	LTR/ERV1	1696	+	283	15485323	42910
chr17	15442413	15642413	harbor1	chr17	15495707	15496046	LTR/ERV1	1755	+	170	15495877	53464
chr17	15442413	15642413	harbor1	chr17	15505516	15506856	LTR/ERV1	9174	+	670	15506186	63773
chr17	15442413	15642413	harbor1	chr17	15526930	15527239	LTR/ERV1	1542	+	154	15527084	84671
chr17	35240530	35440530	harbor1	chr17	35246965	35247415	LTR/ERV1	1957	+	225	35247190	6660
chr17	35240530	35440530	harbor1	chr17	35247420	35248505	LTR/ERV1	7910	+	542	35247962	7432
chr17	35240530	35440530	harbor1	chr17	35248552	35250377	LTR/ERV1	7910	+	912	35249464	8934
chr17	35240530	35440530	harbor1	chr17	35250674	35251386	LTR/ERV1	3247	+	356	35251030	10500
chr17	35240530	35440530	harbor1	chr17	35297637	35298074	LTR/ERV1	3162	+	218	35297855	57325
chr17	35240530	35440530	harbor1	chr17	35298075	35298368	LTR/ERV1	16895	+	146	35298221	57691
chr17	35240530	35440530	harbor1	chr17	35298424	35300398	LTR/ERV1	16895	+	987	35299411	58881
chr17	35240530	35440530	harbor1	chr17	35300704	35300844	LTR/ERV1	1148	+	70	35300774	60244
chr17	35240530	35440530	harbor1	chr17	35304258	35305670	LTR/ERV1	10898	+	706	35304964	64434
chr17	35240530	35440530	harbor1	chr17	35305664	35306693	LTR/ERV1	7381	+	514	35306178	65648
chr17	35240530	35440530	harbor1	chr17	35306697	35307396	LTR/ERV1	5683	+	350	35307047	66517
chr17	35240530	35440530	harbor1	chr17	35321723	35321971	LTR/ERV1	1814	+	124	35321847	81317
chr17	35240530	35440530	harbor1	chr17	35322007	35322433	LTR/ERV1	2029	+	213	35322220	81690
chr17	35240530	35440530	harbor1	chr17	35322437	35323060	LTR/ERV1	3923	+	312	35322749	82219
chr17	35240530	35440530	harbor1	chr17	35324366	35324451	LTR/ERV1	622	+	42	35324408	83878
chr17	35240530	35440530	harbor1	chr17	35324451	35324541	LTR/ERV1	666	+	45	35324496	83966
chr17	35240530	35440530	harbor1	chr17	35324542	35324983	LTR/ERV1	2658	+	220	35324762	84232
chr17	75164071	75364071	harbor1	chr17	75252621	75253051	LTR/ERV1	3360	+	215	75252836	88765
chr17	75164071	75364071	harbor1	chr17	75253054	75255974	LTR/ERV1	15290	+	1460	75254514	90443
chr17	75164071	75364071	harbor1	chr17	75255969	75256131	LTR/ERV1	892	+	81	75256050	91979
chr17	75164071	75364071	harbor1	chr17	75256107	75256607	LTR/ERV1	3186	+	250	75256357	92286
chr17	75164071	75364071	harbor1	chr17	75256610	75257265	LTR/ERV1	4162	+	328	75256938	92867
chr17	75164071	75364071	harbor1	chr17	75257267	75257854	LTR/ERV1	2239	+	294	75257561	93490
chr17	75164071	75364071	harbor1	chr17	75257855	75258281	LTR/ERV1	3382	+	213	75258068	93997
chr17	53552486	53752486	harbor1	chr17	53607381	53607981	LTR/ERV1	3386	+	300	53607681	55195
chr17	53552486	53752486	harbor1	chr17	53609537	53610017	LTR/ERV1	1927	+	240	53609777	57291
chr17	53552486	53752486	harbor1	chr17	53610657	53611166	LTR/ERV1	3490	+	254	53610911	58425
chr17	53552486	53752486	harbor1	chr17	53611167	53611593	LTR/ERV1	2711	+	213	53611380	58894
chr17	53552486	53752486	harbor1	chr17	53628816	53630746	LTR/ERV1	7152	+	965	53629781	77295
chr17	53552486	53752486	harbor1	chr17	53630739	53630868	LTR/ERV1	647	+	64	53630803	78317
chr17	53552486	53752486	harbor1	chr17	53630870	53631517	LTR/ERV1	4208	+	324	53631194	78708
chr17	53552486	53752486	harbor1	chr17	53631510	53632248	LTR/ERV1	4124	+	369	53631879	79393
chr17	53552486	53752486	harbor1	chr17	53632374	53632545	LTR/ERV1	676	+	86	53632460	79974
chr17	53552486	53752486	harbor1	chr17	53633166	53633426	LTR/ERV1	1125	+	130	53633296	80810
chr17	53552486	53752486	harbor1	chr17	53633427	53633567	LTR/ERV1	865	+	70	53633497	81011
chr17	53552486	53752486	harbor1	chr17	53608086	53608641	LTR/ERV1	2785	+	278	53608364	55878
chr17	70923628	71123628	harbor1	chr17	70980024	70980369	LTR/ERV1	1141	+	172	70980196	56568
chr17	70923628	71123628	harbor1	chr17	70987030	70987531	LTR/ERV1	1116	+	250	70987280	63652
chr17	61689302	61889302	harbor1	chr17	61752332	61752769	LTR/ERV1	904	+	218	61752550	63248
chr17	68842126	69042126	harbor1	chr17	68879538	68879678	LTR/ERV1	568	+	70	68879608	37482
chr17	68842126	69042126	harbor1	chr17	68879706	68880938	LTR/ERV1	6294	+	616	68880322	38196
chr17	19155229	19355229	harbor1	chr17	19192665	19192791	LTR/ERV1	828	+	63	19192728	37499
chr17	19155229	19355229	harbor1	chr17	19223711	19223793	LTR/ERV1	483	+	41	19223752	68523
chr17	40838357	41038357	harbor1	chr17	40853213	40853741	LTR/ERV1	3378	+	264	40853477	15120
chr17	40838357	41038357	harbor1	chr17	40898086	40898489	LTR/ERV1	1214	+	202	40898288	59931
chr17	34956416	35156416	harbor1	chr17	35055330	35055392	LTR/ERV1	2970	+	31	35055361	98945
chr17	34956416	35156416	harbor1	chr17	35055702	35056171	LTR/ERV1	2970	+	234	35055936	99520
chr17	41546946	41746946	harbor1	chr17	41556570	41557244	LTR/ERV1	4432	+	337	41556907	9961
chr17	41546946	41746946	harbor1	chr17	41559983	41560120	LTR/ERV1	1012	+	68	41560051	13105
chr17	46051927	46251927	harbor1	chr17	46079287	46079602	LTR/ERV1	559	+	158	46079445	27518
chr17	45782149	45982149	harbor1	chr17	45867960	45868643	LTR/ERV1	4947	+	342	45868302	86153
chr17	39271552	39471552	harbor1	chr17	39309017	39309326	LTR/ERV1	1673	+	154	39309171	37619
chr17	39271552	39471552	harbor1	chr17	39309849	39309866	LTR/ERV1	2820	+	8	39309857	38305
chr17	39271552	39471552	harbor1	chr17	39310178	39310570	LTR/ERV1	2820	+	196	39310374	38822
chr17	39271552	39471552	harbor1	chr17	39311189	39311249	LTR/ERV1	2820	+	30	39311219	39667
chr17	39271552	39471552	harbor1	chr17	39334919	39335403	LTR/ERV1	3672	+	242	39335161	63609
chr17	36094304	36294304	harbor1	chr17	36111038	36111493	LTR/ERV1	2223	+	228	36111266	16962
chr17	36094304	36294304	harbor1	chr17	36116346	36116461	LTR/ERV1	801	+	58	36116404	22100
chr17	67032577	67232577	harbor1	chr17	67064670	67065020	LTR/ERV1	5482	+	175	67064845	32268
chr17	67032577	67232577	harbor1	chr17	67065321	67065733	LTR/ERV1	5482	+	206	67065527	32950
chr17	70747224	70947224	harbor1	chr17	70796681	70797095	LTR/ERV1	1809	+	207	70796888	49664
chr17	76113394	76313394	harbor1	chr17	76177146	76178643	LTR/ERV1	6180	+	748	76177894	64500
chr17	76113394	76313394	harbor1	chr17	76195772	76196222	LTR/ERV1	2248	+	225	76195997	82603
chr17	69260842	69460842	harbor1	chr17	69323126	69323535	LTR/ERV1	1124	+	204	69323330	62488
chr17	69260842	69460842	harbor1	chr17	69348506	69349201	LTR/ERV1	4169	+	348	69348854	88012
chr17	69260842	69460842	harbor1	chr17	69351363	69351621	LTR/ERV1	1066	+	129	69351492	90650
chr17	69260842	69460842	harbor1	chr17	69352545	69352962	LTR/ERV1	708	+	208	69352753	91911
chr17	69260842	69460842	harbor1	chr17	69353256	69353507	LTR/ERV1	709	+	126	69353382	92540
chr17	48814031	49014031	harbor1	chr17	48822971	48823066	LTR/ERV1	1657	+	48	48823019	8988
chr17	48814031	49014031	harbor1	chr17	48823364	48823649	LTR/ERV1	1657	+	142	48823506	9475
chr17	29912854	30112854	harbor1	chr17	30005563	30006235	LTR/ERV1	1842	+	336	30005899	93045
chr17	7556832	7756832	harbor1	chr17	7640714	7642277	LTR/ERV1	11529	+	782	7641496	84664
chr17	12561571	12761571	harbor1	chr17	12581499	12582307	LTR/ERV1	4500	+	404	12581903	20332
chr17	60332500	60532500	harbor1	chr17	60384972	60385404	LTR/ERV1	2540	+	216	60385188	52688
chr17	60332500	60532500	harbor1	chr17	60408678	60409066	LTR/ERV1	2925	+	194	60408872	76372
chr17	60332500	60532500	harbor1	chr17	60409364	60409439	LTR/ERV1	2925	+	38	60409402	76902
chr17	60332500	60532500	harbor1	chr17	60409563	60409734	LTR/ERV1	1918	+	86	60409649	77149
chr17	60332500	60532500	harbor1	chr17	60409955	60410381	LTR/ERV1	1918	+	213	60410168	77668
chr17	60332500	60532500	harbor1	chr17	60424439	60424604	LTR/ERV1	2881	+	82	60424521	92021
chr17	60332500	60532500	harbor1	chr17	60424875	60425234	LTR/ERV1	2881	+	180	60425055	92555
chr17	16410744	16610744	harbor1	chr17	16453679	16454108	LTR/ERV1	2011	+	214	16453893	43149
chr17	16410744	16610744	harbor1	chr17	16454723	16454908	LTR/ERV1	2011	+	92	16454815	44071
chr17	16410744	16610744	harbor1	chr17	16455228	16455386	LTR/ERV1	2011	+	79	16455307	44563
chr17	16410744	16610744	harbor1	chr17	16501696	16502157	LTR/ERV1	3001	+	230	16501926	91182
chr17	64833728	65033728	harbor1	chr17	64883117	64883267	LTR/ERV1	585	+	75	64883192	49464
chr17	64833728	65033728	harbor1	chr17	64925888	64925962	LTR/ERV1	539	+	37	64925925	92197
chr17	51463380	51663380	harbor1	chr17	51474195	51474287	LTR/ERV1	1925	+	46	51474241	10861
chr17	51463380	51663380	harbor1	chr17	51474730	51475074	LTR/ERV1	1925	+	172	51474902	11522
chr17	51463380	51663380	harbor1	chr17	51512247	51512833	LTR/ERV1	3759	+	293	51512540	49160
chr17	83003262	83203262	harbor1	chr17	83029581	83030016	LTR/ERV1	2337	+	218	83029799	26537
chr17	40673173	40873173	harbor1	chr17	40674634	40675301	LTR/ERV1	3857	+	334	40674968	1795
chr17	40673173	40873173	harbor1	chr17	40743905	40744249	LTR/ERV1	2480	+	172	40744077	70904
chr17	40673173	40873173	harbor1	chr17	40744551	40744614	LTR/ERV1	2480	+	32	40744583	71410
chr17	40673173	40873173	harbor1	chr17	40697371	40697884	LTR/ERV1	2507	+	256	40697627	24454
chr17	28224012	28424012	harbor1	chr17	28260018	28260443	LTR/ERV1	3203	+	212	28260230	36218
chr17	28224012	28424012	harbor1	chr17	28260737	28260857	LTR/ERV1	3203	+	60	28260797	36785
chr17	28224012	28424012	harbor1	chr17	28260858	28261310	LTR/ERV1	3485	+	226	28261084	37072
chr17	28224012	28424012	harbor1	chr17	28265582	28265942	LTR/ERV1	1662	+	180	28265762	41750
chr17	28224012	28424012	harbor1	chr17	28266198	28266558	LTR/ERV1	1818	+	180	28266378	42366
chr17	28224012	28424012	harbor1	chr17	28266938	28267298	LTR/ERV1	1755	+	180	28267118	43106
chr17	28224012	28424012	harbor1	chr17	28267554	28267914	LTR/ERV1	1814	+	180	28267734	43722
chr17	28224012	28424012	harbor1	chr17	28268294	28268654	LTR/ERV1	1743	+	180	28268474	44462
chr17	28224012	28424012	harbor1	chr17	28272390	28273025	LTR/ERV1	4194	+	318	28272708	48696
chr17	28224012	28424012	harbor1	chr17	28307723	28307785	LTR/ERV1	548	+	31	28307754	83742
chr17	2470299	2670299	harbor1	chr17	2547549	2547927	LTR/ERV1	3092	+	189	2547738	77439
chr17	2470299	2670299	harbor1	chr17	2548038	2548131	LTR/ERV1	738	+	46	2548084	77785
chr17	47565416	47765416	harbor1	chr17	47580532	47581041	LTR/ERV1	1797	+	254	47580786	15370
chr17	68677269	68877269	harbor1	chr17	68732251	68732949	LTR/ERV1	4361	+	349	68732600	55331
chr17	68677269	68877269	harbor1	chr17	68733722	68734473	LTR/ERV1	2676	+	376	68734098	56829
chr17	68677269	68877269	harbor1	chr17	68740647	68741466	LTR/ERV1	5485	+	410	68741057	63788
chr17	68677269	68877269	harbor1	chr17	68742526	68743118	LTR/ERV1	3255	+	296	68742822	65553
chr17	68677269	68877269	harbor1	chr17	68744895	68745706	LTR/ERV1	5778	+	406	68745301	68032
chr17	80770485	80970485	harbor1	chr17	80804411	80804602	LTR/ERV1	863	+	96	80804507	34022
chr17	79997673	80197673	harbor1	chr17	80045730	80046122	LTR/ERV1	2023	+	196	80045926	48253
chr17	34883363	35083363	harbor1	chr17	34900782	34901371	LTR/ERV1	3756	+	294	34901076	17713
chr17	40734398	40934398	harbor1	chr17	40743905	40744249	LTR/ERV1	2480	+	172	40744077	9679
chr17	40734398	40934398	harbor1	chr17	40744551	40744614	LTR/ERV1	2480	+	32	40744583	10185
chr17	40734398	40934398	harbor1	chr17	40785523	40785992	LTR/ERV1	1961	+	234	40785757	51359
chr17	6251440	6451440	harbor1	chr17	6286361	6286898	LTR/ERV1	549	+	268	6286629	35189
chr17	13117122	13317122	harbor1	chr17	13170446	13172117	LTR/ERV1	3319	+	836	13171282	54160
chr17	13117122	13317122	harbor1	chr17	13175326	13175703	LTR/ERV1	2177	+	188	13175514	58392
chr17	13117122	13317122	harbor1	chr17	13172102	13174179	LTR/ERV1	11615	+	1038	13173140	56018
chr18	47071952	47271952	harbor1	chr18	47085248	47085785	LTR/ERV1	2106	+	268	47085516	13564
chr18	29311900	29511900	harbor1	chr18	29383076	29383358	LTR/ERV1	1477	+	141	29383217	71317
chr18	29311900	29511900	harbor1	chr18	29397681	29397969	LTR/ERV1	2198	+	144	29397825	85925
chr18	29311900	29511900	harbor1	chr18	29397970	29398708	LTR/ERV1	3988	+	369	29398339	86439
chr18	29311900	29511900	harbor1	chr18	29398709	29398857	LTR/ERV1	2198	+	74	29398783	86883
chr18	29311900	29511900	harbor1	chr18	29399643	29399695	LTR/ERV1	2198	+	26	29399669	87769
chr18	38869184	39069184	harbor1	chr18	38924238	38925377	LTR/ERV1	1058	+	570	38924808	55624
chr18	38869184	39069184	harbor1	chr18	38941462	38941585	LTR/ERV1	541	+	62	38941524	72340
chr18	38869184	39069184	harbor1	chr18	38942134	38942480	LTR/ERV1	879	+	173	38942307	73123
chr18	38869184	39069184	harbor1	chr18	38942778	38942836	LTR/ERV1	879	+	29	38942807	73623
chr18	26390349	26590349	harbor1	chr18	26471022	26471468	LTR/ERV1	2220	+	223	26471245	80896
chr18	66800942	67000942	harbor1	chr18	66866520	66866942	LTR/ERV1	2348	+	211	66866731	65789
chr18	68229855	68429855	harbor1	chr18	68275657	68275987	LTR/ERV1	419	+	165	68275822	45967
chr18	11266757	11466757	harbor1	chr18	11291763	11292145	LTR/ERV1	955	+	191	11291954	25197
chr18	11266757	11466757	harbor1	chr18	11292716	11293266	LTR/ERV1	3084	+	275	11292991	26234
chr18	11266757	11466757	harbor1	chr18	11293267	11293520	LTR/ERV1	25267	+	126	11293393	26636
chr18	11266757	11466757	harbor1	chr18	11293822	11297682	LTR/ERV1	25267	+	1930	11295752	28995
chr18	11266757	11466757	harbor1	chr18	11297734	11298486	LTR/ERV1	25267	+	376	11298110	31353
chr18	11266757	11466757	harbor1	chr18	11298678	11299235	LTR/ERV1	25267	+	278	11298956	32199
chr18	11266757	11466757	harbor1	chr18	11306176	11306353	LTR/ERV1	728	+	88	11306264	39507
chr18	11266757	11466757	harbor1	chr18	11307854	11308411	LTR/ERV1	1881	+	278	11308132	41375
chr18	11266757	11466757	harbor1	chr18	11343545	11343980	LTR/ERV1	2861	+	218	11343763	77006
chr18	11266757	11466757	harbor1	chr18	11365348	11365505	LTR/ERV1	557	+	78	11365426	98669
chr18	11266757	11466757	harbor1	chr18	11365723	11365912	LTR/ERV1	471	+	94	11365817	99060
chr18	74230086	74430086	harbor1	chr18	74271965	74272527	LTR/ERV1	3181	+	281	74272246	42160
chr18	74230086	74430086	harbor1	chr18	74293089	74293242	LTR/ERV1	749	+	76	74293165	63079
chr18	74230086	74430086	harbor1	chr18	74293243	74293654	LTR/ERV1	2636	+	206	74293449	63363
chr18	74230086	74430086	harbor1	chr18	74293656	74295723	LTR/ERV1	11962	+	1034	74294690	64604
chr18	74230086	74430086	harbor1	chr18	74295703	74295898	LTR/ERV1	1254	+	98	74295801	65715
chr18	74230086	74430086	harbor1	chr18	74295904	74297921	LTR/ERV1	12662	+	1008	74296912	66826
chr18	74230086	74430086	harbor1	chr18	74297899	74298094	LTR/ERV1	1120	+	98	74297997	67911
chr18	74230086	74430086	harbor1	chr18	74298145	74298681	LTR/ERV1	3805	+	268	74298413	68327
chr18	74230086	74430086	harbor1	chr18	74298682	74299036	LTR/ERV1	2145	+	177	74298859	68773
chr18	74230086	74430086	harbor1	chr18	74299508	74299945	LTR/ERV1	2302	+	218	74299726	69640
chr18	74230086	74430086	harbor1	chr18	74300508	74300717	LTR/ERV1	652	+	104	74300612	70526
chr18	74230086	74430086	harbor1	chr18	74303304	74303745	LTR/ERV1	2261	+	220	74303524	73438
chr18	74230086	74430086	harbor1	chr18	74326919	74327579	LTR/ERV1	5432	+	330	74327249	97163
chr18	74230086	74430086	harbor1	chr18	74300764	74303204	LTR/ERV1	4188	+	1220	74301984	71898
chr18	74101275	74301275	harbor1	chr18	74121836	74122356	LTR/ERV1	3404	+	260	74122096	20821
chr18	74101275	74301275	harbor1	chr18	74186726	74187123	LTR/ERV1	2826	+	198	74186924	85649
chr18	65962324	66162324	harbor1	chr18	65981833	65982184	LTR/ERV1	1470	+	176	65982009	19685
chr18	65962324	66162324	harbor1	chr18	66039129	66039614	LTR/ERV1	2628	+	242	66039371	77047
chr18	65962324	66162324	harbor1	chr18	66046439	66046560	LTR/ERV1	804	+	60	66046499	84175
chr18	65962324	66162324	harbor1	chr18	66048282	66048828	LTR/ERV1	1794	+	273	66048555	86231
chr18	49439935	49639935	harbor1	chr18	49447280	49447437	LTR/ERV1	598	+	78	49447358	7423
chr18	49439935	49639935	harbor1	chr18	49447449	49447549	LTR/ERV1	647	+	50	49447499	7564
chr18	49439935	49639935	harbor1	chr18	49447550	49449852	LTR/ERV1	6117	+	1151	49448701	8766
chr18	49439935	49639935	harbor1	chr18	49449853	49451949	LTR/ERV1	14881	+	1048	49450901	10966
chr18	49439935	49639935	harbor1	chr18	49451948	49452050	LTR/ERV1	740	+	51	49451999	12064
chr18	49439935	49639935	harbor1	chr18	49452646	49453666	LTR/ERV1	6772	+	510	49453156	13221
chr18	49439935	49639935	harbor1	chr18	49453667	49453799	LTR/ERV1	826	+	66	49453733	13798
chr18	49439935	49639935	harbor1	chr18	49454030	49454225	LTR/ERV1	1490	+	98	49454128	14193
chr18	49439935	49639935	harbor1	chr18	49454229	49454617	LTR/ERV1	2688	+	194	49454423	14488
chr18	49439935	49639935	harbor1	chr18	49454932	49455037	LTR/ERV1	2688	+	52	49454984	15049
chr18	49439935	49639935	harbor1	chr18	49467712	49468121	LTR/ERV1	1557	+	204	49467916	27981
chr18	49439935	49639935	harbor1	chr18	49480862	49480942	LTR/ERV1	575	+	40	49480902	40967
chr18	49439935	49639935	harbor1	chr18	49497230	49497315	LTR/ERV1	491	+	42	49497272	57337
chr18	49439935	49639935	harbor1	chr18	49497641	49497839	LTR/ERV1	1184	+	99	49497740	57805
chr18	49439935	49639935	harbor1	chr18	49525405	49525811	LTR/ERV1	995	+	203	49525608	85673
chr18	49439935	49639935	harbor1	chr18	49526206	49526354	LTR/ERV1	601	+	74	49526280	86345
chr18	49439935	49639935	harbor1	chr18	49528045	49528449	LTR/ERV1	2797	+	202	49528247	88312
chr18	49439935	49639935	harbor1	chr18	49528456	49528827	LTR/ERV1	3159	+	186	49528642	88707
chr18	49439935	49639935	harbor1	chr18	49529301	49529739	LTR/ERV1	3111	+	219	49529520	89585
chr18	49439935	49639935	harbor1	chr18	49529740	49530196	LTR/ERV1	3159	+	228	49529968	90033
chr18	49439935	49639935	harbor1	chr18	49531566	49531638	LTR/ERV1	1748	+	36	49531602	91667
chr18	49439935	49639935	harbor1	chr18	49532136	49532635	LTR/ERV1	1748	+	250	49532386	92451
chr18	49439935	49639935	harbor1	chr18	49532641	49533407	LTR/ERV1	14347	+	383	49533024	93089
chr18	49439935	49639935	harbor1	chr18	49533698	49533745	LTR/ERV1	14347	+	24	49533722	93787
chr18	49439935	49639935	harbor1	chr18	49534042	49536213	LTR/ERV1	14347	+	1086	49535128	95193
chr18	49439935	49639935	harbor1	chr18	49536214	49536591	LTR/ERV1	2505	+	188	49536402	96467
chr18	49439935	49639935	harbor1	chr18	49537983	49538415	LTR/ERV1	1176	+	216	49538199	98264
chr18	49439935	49639935	harbor1	chr18	49528828	49529011	LTR/ERV1	3111	+	92	49528920	88985
chr18	8952490	9152490	harbor1	chr18	8954365	8954760	LTR/ERV1	2258	+	198	8954563	2073
chr18	8952490	9152490	harbor1	chr18	8956276	8956970	LTR/ERV1	2605	+	347	8956623	4133
chr18	8952490	9152490	harbor1	chr18	8979677	8980221	LTR/ERV1	3046	+	272	8979949	27459
chr18	8952490	9152490	harbor1	chr18	8995354	8995611	LTR/ERV1	1071	+	128	8995482	42992
chr18	8952490	9152490	harbor1	chr18	8995910	8996058	LTR/ERV1	894	+	74	8995984	43494
chr18	39197398	39397398	harbor1	chr18	39235173	39236510	LTR/ERV1	7664	+	668	39235841	38443
chr18	8917045	9117045	harbor1	chr18	8914110	8920902	LTR/ERV1	54082	+	3396	8917506	461
chr18	8917045	9117045	harbor1	chr18	8920903	8921365	LTR/ERV1	4041	+	231	8921134	4089
chr18	8917045	9117045	harbor1	chr18	8926850	8927366	LTR/ERV1	1281	+	258	8927108	10063
chr18	8917045	9117045	harbor1	chr18	8933256	8933609	LTR/ERV1	2157	+	176	8933432	16387
chr18	8917045	9117045	harbor1	chr18	8937522	8937923	LTR/ERV1	2658	+	200	8937722	20677
chr18	8917045	9117045	harbor1	chr18	8937924	8938248	LTR/ERV1	2684	+	162	8938086	21041
chr18	8917045	9117045	harbor1	chr18	8938550	8938684	LTR/ERV1	2684	+	67	8938617	21572
chr18	8917045	9117045	harbor1	chr18	8938685	8938804	LTR/ERV1	2658	+	60	8938745	21700
chr18	8917045	9117045	harbor1	chr18	8939216	8939250	LTR/ERV1	2658	+	17	8939233	22188
chr18	8917045	9117045	harbor1	chr18	8940700	8941104	LTR/ERV1	1527	+	202	8940902	23857
chr18	8917045	9117045	harbor1	chr18	8944000	8944368	LTR/ERV1	2443	+	184	8944184	27139
chr18	8917045	9117045	harbor1	chr18	8944633	8944803	LTR/ERV1	2443	+	85	8944718	27673
chr18	8917045	9117045	harbor1	chr18	8954365	8954760	LTR/ERV1	2258	+	198	8954563	37518
chr18	8917045	9117045	harbor1	chr18	8956276	8956970	LTR/ERV1	2605	+	347	8956623	39578
chr18	8917045	9117045	harbor1	chr18	8979677	8980221	LTR/ERV1	3046	+	272	8979949	62904
chr18	8917045	9117045	harbor1	chr18	8995354	8995611	LTR/ERV1	1071	+	128	8995482	78437
chr18	8917045	9117045	harbor1	chr18	8995910	8996058	LTR/ERV1	894	+	74	8995984	78939
chr18	8917045	9117045	harbor1	chr18	8945350	8945965	LTR/ERV1	3873	+	308	8945658	28613
chr18	67660391	67860391	harbor1	chr18	67756444	67756985	LTR/ERV1	3611	+	270	67756714	96323
chr18	43264325	43464325	harbor1	chr18	43327044	43327523	LTR/ERV1	1213	+	240	43327284	62959
chr18	43264325	43464325	harbor1	chr18	43353069	43353270	LTR/ERV1	806	+	100	43353169	88844
chr18	43264325	43464325	harbor1	chr18	43353672	43353831	LTR/ERV1	480	+	80	43353752	89427
chr18	43264325	43464325	harbor1	chr18	43354250	43354501	LTR/ERV1	457	+	126	43354376	90051
chr18	43264325	43464325	harbor1	chr18	43354783	43355499	LTR/ERV1	957	+	358	43355141	90816
chr18	43264325	43464325	harbor1	chr18	43356226	43359240	LTR/ERV1	2335	+	1507	43357733	93408
chr18	43264325	43464325	harbor1	chr18	43360863	43361433	LTR/ERV1	1030	+	285	43361148	96823
chr18	43264325	43464325	harbor1	chr18	43362718	43362920	LTR/ERV1	806	+	101	43362819	98494
chr18	24111369	24311369	harbor1	chr18	24181636	24182001	LTR/ERV1	1066	+	182	24181818	70449
chr18	42729127	42929127	harbor1	chr18	42737046	42737438	LTR/ERV1	2602	+	196	42737242	8115
chr18	42729127	42929127	harbor1	chr18	42737441	42737854	LTR/ERV1	3014	+	206	42737647	8520
chr18	42729127	42929127	harbor1	chr18	42737853	42740052	LTR/ERV1	14531	+	1100	42738953	9826
chr18	42729127	42929127	harbor1	chr18	42740047	42740194	LTR/ERV1	872	+	74	42740121	10994
chr18	42729127	42929127	harbor1	chr18	42740194	42740687	LTR/ERV1	3302	+	246	42740440	11313
chr18	42729127	42929127	harbor1	chr18	42740690	42741353	LTR/ERV1	4326	+	332	42741022	11895
chr18	42729127	42929127	harbor1	chr18	42741355	42741570	LTR/ERV1	1317	+	108	42741463	12336
chr18	42729127	42929127	harbor1	chr18	42741571	42741944	LTR/ERV1	2274	+	186	42741757	12630
chr18	42729127	42929127	harbor1	chr18	42741945	42742345	LTR/ERV1	2707	+	200	42742145	13018
chr18	42729127	42929127	harbor1	chr18	42743802	42744300	LTR/ERV1	3320	+	249	42744051	14924
chr18	42729127	42929127	harbor1	chr18	42779102	42779597	LTR/ERV1	2125	+	248	42779350	50223
chr18	42729127	42929127	harbor1	chr18	42795066	42796475	LTR/ERV1	9848	+	704	42795770	66643
chr18	42729127	42929127	harbor1	chr18	42796581	42796690	LTR/ERV1	629	+	54	42796635	67508
chr18	42729127	42929127	harbor1	chr18	42825786	42826165	LTR/ERV1	1176	+	190	42825976	96849
chr18	45955407	46155407	harbor1	chr18	45958860	45959188	LTR/ERV1	2576	+	164	45959024	3617
chr18	45955407	46155407	harbor1	chr18	45980214	45980806	LTR/ERV1	4484	+	296	45980510	25103
chr18	45955407	46155407	harbor1	chr18	46040162	46040426	LTR/ERV1	1157	+	132	46040294	84887
chr18	45955407	46155407	harbor1	chr18	46040537	46040696	LTR/ERV1	681	+	80	46040617	85210
chr18	43090120	43290120	harbor1	chr18	43139338	43140813	LTR/ERV1	10630	+	738	43140076	49956
chr18	43090120	43290120	harbor1	chr18	43155852	43156258	LTR/ERV1	1539	+	203	43156055	65935
chr18	43090120	43290120	harbor1	chr18	43162440	43162763	LTR/ERV1	1964	+	162	43162602	72482
chr18	43090120	43290120	harbor1	chr18	43162764	43164121	LTR/ERV1	21523	+	678	43163442	73322
chr18	43090120	43290120	harbor1	chr18	43164476	43167501	LTR/ERV1	21523	+	1512	43165988	75868
chr18	43090120	43290120	harbor1	chr18	43167480	43167511	LTR/ERV1	14253	+	16	43167496	77376
chr18	43090120	43290120	harbor1	chr18	43167769	43169848	LTR/ERV1	14253	+	1040	43168809	78689
chr18	43090120	43290120	harbor1	chr18	43169832	43170870	LTR/ERV1	4164	+	519	43170351	80231
chr18	43090120	43290120	harbor1	chr18	43170878	43171130	LTR/ERV1	965	+	126	43171004	80884
chr18	43090120	43290120	harbor1	chr18	43171135	43171258	LTR/ERV1	473	+	62	43171197	81077
chr18	43090120	43290120	harbor1	chr18	43172797	43173471	LTR/ERV1	3437	+	337	43173134	83014
chr18	70185300	70385300	harbor1	chr18	70212522	70212724	LTR/ERV1	1285	+	101	70212623	27323
chr18	70185300	70385300	harbor1	chr18	70227019	70227686	LTR/ERV1	2021	+	334	70227353	42053
chr18	70185300	70385300	harbor1	chr18	70245518	70245733	LTR/ERV1	1218	+	108	70245626	60326
chr18	70185300	70385300	harbor1	chr18	70264933	70265327	LTR/ERV1	2960	+	197	70265130	79830
chr18	70185300	70385300	harbor1	chr18	70265626	70265889	LTR/ERV1	2960	+	132	70265758	80458
chr18	70185300	70385300	harbor1	chr18	70271207	70271946	LTR/ERV1	3388	+	370	70271577	86277
chr18	70185300	70385300	harbor1	chr18	70274162	70274707	LTR/ERV1	2905	+	272	70274434	89134
chr18	70185300	70385300	harbor1	chr18	70274781	70275198	LTR/ERV1	1524	+	208	70274989	89689
chr18	70185300	70385300	harbor1	chr18	70276683	70277144	LTR/ERV1	1798	+	230	70276913	91613
chr18	62706206	62906206	harbor1	chr18	62708596	62708825	LTR/ERV1	1079	+	114	62708710	2504
chr19	28680532	28880532	harbor1	chr19	28742104	28744022	LTR/ERV1	5618	+	959	28743063	62531
chr19	28680532	28880532	harbor1	chr19	28744038	28744511	LTR/ERV1	2093	+	236	28744274	63742
chr19	28680532	28880532	harbor1	chr19	28744509	28744753	LTR/ERV1	814	+	122	28744631	64099
chr19	28680532	28880532	harbor1	chr19	28744777	28745399	LTR/ERV1	1793	+	311	28745088	64556
chr19	36192082	36392082	harbor1	chr19	36253662	36253694	LTR/ERV1	2483	+	16	36253678	61596
chr19	36192082	36392082	harbor1	chr19	36253996	36254399	LTR/ERV1	2483	+	202	36254198	62116
chr19	37357847	37557847	harbor1	chr19	37364012	37364652	LTR/ERV1	2656	+	320	37364332	6485
chr19	37357847	37557847	harbor1	chr19	37434586	37435014	LTR/ERV1	3427	+	214	37434800	76953
chr19	18939928	19139928	harbor1	chr19	18964494	18964584	LTR/ERV1	3890	+	45	18964539	24611
chr19	18939928	19139928	harbor1	chr19	18965183	18965194	LTR/ERV1	3890	+	6	18965189	25261
chr19	18939928	19139928	harbor1	chr19	18965507	18965709	LTR/ERV1	3890	+	101	18965608	25680
chr19	18939928	19139928	harbor1	chr19	18965977	18966043	LTR/ERV1	3890	+	33	18966010	26082
chr19	18939928	19139928	harbor1	chr19	18966345	18966703	LTR/ERV1	3890	+	179	18966524	26596
chr19	18939928	19139928	harbor1	chr19	18997815	18998290	LTR/ERV1	1742	+	238	18998053	58125
chr19	12073512	12273512	harbor1	chr19	12139097	12139437	LTR/ERV1	2303	+	170	12139267	65755
chr19	12073512	12273512	harbor1	chr19	12154107	12154261	LTR/ERV1	956	+	77	12154184	80672
chr19	12073512	12273512	harbor1	chr19	12154498	12154635	LTR/ERV1	673	+	68	12154566	81054
chr19	12073512	12273512	harbor1	chr19	12154728	12154933	LTR/ERV1	983	+	102	12154830	81318
chr19	12073512	12273512	harbor1	chr19	12155239	12155320	LTR/ERV1	983	+	40	12155279	81767
chr19	12073512	12273512	harbor1	chr19	12157060	12157218	LTR/ERV1	815	+	79	12157139	83627
chr19	12073512	12273512	harbor1	chr19	12164738	12165032	LTR/ERV1	1518	+	147	12164885	91373
chr19	12073512	12273512	harbor1	chr19	12173216	12173340	LTR/ERV1	644	+	62	12173278	99766
chr19	53762314	53962314	harbor1	chr19	53769073	53769384	LTR/ERV1	853	+	156	53769229	6915
chr19	53762314	53962314	harbor1	chr19	53780548	53780872	LTR/ERV1	963	+	162	53780710	18396
chr19	53762314	53962314	harbor1	chr19	53831404	53831854	LTR/ERV1	3444	+	225	53831629	69315
chr19	53762314	53962314	harbor1	chr19	53831857	53835005	LTR/ERV1	10019	+	1574	53833431	71117
chr19	53762314	53962314	harbor1	chr19	53835000	53835146	LTR/ERV1	834	+	73	53835073	72759
chr19	53762314	53962314	harbor1	chr19	53835137	53835639	LTR/ERV1	3350	+	251	53835388	73074
chr19	53762314	53962314	harbor1	chr19	53835642	53836300	LTR/ERV1	4125	+	329	53835971	73657
chr19	53762314	53962314	harbor1	chr19	53836302	53836519	LTR/ERV1	1355	+	108	53836410	74096
chr19	53762314	53962314	harbor1	chr19	53836518	53836897	LTR/ERV1	2441	+	190	53836708	74394
chr19	53762314	53962314	harbor1	chr19	53836898	53837348	LTR/ERV1	3616	+	225	53837123	74809
chr19	53762314	53962314	harbor1	chr19	53845912	53846067	LTR/ERV1	851	+	78	53845990	83676
chr19	48798436	48998436	harbor1	chr19	48810167	48810574	LTR/ERV1	1554	+	204	48810371	11935
chr19	48798436	48998436	harbor1	chr19	48830072	48830629	LTR/ERV1	3847	+	278	48830350	31914
chr19	48798436	48998436	harbor1	chr19	48882278	48882395	LTR/ERV1	819	+	58	48882336	83900
chr19	48798436	48998436	harbor1	chr19	48883248	48883524	LTR/ERV1	1824	+	138	48883386	84950
chr19	48650862	48850862	harbor1	chr19	48682639	48682698	LTR/ERV1	2979	+	30	48682669	31807
chr19	48650862	48850862	harbor1	chr19	48683315	48683862	LTR/ERV1	2979	+	274	48683589	32727
chr19	20496146	20696146	harbor1	chr19	20538082	20538643	LTR/ERV1	4293	+	280	20538362	42216
chr19	20496146	20696146	harbor1	chr19	20562000	20562202	LTR/ERV1	1273	+	101	20562101	65955
chr19	20496146	20696146	harbor1	chr19	20562755	20563112	LTR/ERV1	1273	+	178	20562933	66787
chr19	20496146	20696146	harbor1	chr19	20564698	20564938	LTR/ERV1	1508	+	120	20564818	68672
chr19	20496146	20696146	harbor1	chr19	20565235	20565283	LTR/ERV1	1508	+	24	20565259	69113
chr19	20496146	20696146	harbor1	chr19	20572260	20572688	LTR/ERV1	1989	+	214	20572474	76328
chr19	33576001	33776001	harbor1	chr19	33586645	33586745	LTR/ERV1	795	+	50	33586695	10694
chr19	33576001	33776001	harbor1	chr19	33593953	33594641	LTR/ERV1	2197	+	344	33594297	18296
chr19	33576001	33776001	harbor1	chr19	33601127	33601838	LTR/ERV1	2646	+	356	33601483	25482
chr19	33576001	33776001	harbor1	chr19	33605866	33606419	LTR/ERV1	4383	+	276	33606142	30141
chr19	33576001	33776001	harbor1	chr19	33660426	33660967	LTR/ERV1	3146	+	270	33660696	84695
chr19	33576001	33776001	harbor1	chr19	33586884	33587250	LTR/ERV1	2740	+	183	33587067	11066
chr19	46550329	46750329	harbor1	chr19	46556363	46556518	LTR/ERV1	685	+	78	46556441	6112
chr19	46550329	46750329	harbor1	chr19	46557887	46558344	LTR/ERV1	1503	+	228	46558115	7786
chr19	46550329	46750329	harbor1	chr19	46587668	46588412	LTR/ERV1	3984	+	372	46588040	37711
chr19	37488524	37688524	harbor1	chr19	37501025	37501262	LTR/ERV1	681	+	118	37501143	12619
chr19	37488524	37688524	harbor1	chr19	37587171	37587374	LTR/ERV1	911	+	102	37587273	98749
chr19	29637375	29837375	harbor1	chr19	29643732	29643909	LTR/ERV1	4470	+	88	29643820	6445
chr19	29637375	29837375	harbor1	chr19	29644213	29644573	LTR/ERV1	4470	+	180	29644393	7018
chr19	29637375	29837375	harbor1	chr19	29644878	29644997	LTR/ERV1	4470	+	60	29644938	7563
chr19	29637375	29837375	harbor1	chr19	29712459	29712851	LTR/ERV1	1363	+	196	29712655	75280
chr19	29637375	29837375	harbor1	chr19	29727319	29727514	LTR/ERV1	4955	+	98	29727417	90042
chr19	29637375	29837375	harbor1	chr19	29727807	29728549	LTR/ERV1	4955	+	371	29728178	90803
chr19	48155679	48355679	harbor1	chr19	48201261	48201468	LTR/ERV1	1155	+	104	48201365	45686
chr19	48155679	48355679	harbor1	chr19	48202502	48202852	LTR/ERV1	2681	+	175	48202677	46998
chr19	48155679	48355679	harbor1	chr19	48203151	48203197	LTR/ERV1	2681	+	23	48203174	47495
chr19	48155679	48355679	harbor1	chr19	48206418	48206823	LTR/ERV1	1887	+	202	48206620	50941
chr19	48155679	48355679	harbor1	chr19	48214208	48214769	LTR/ERV1	3860	+	280	48214488	58809
chr19	48155679	48355679	harbor1	chr19	48215090	48215276	LTR/ERV1	3860	+	93	48215183	59504
chr19	48155679	48355679	harbor1	chr19	48254703	48255085	LTR/ERV1	2155	+	191	48254894	99215
chr19	48155679	48355679	harbor1	chr19	48255380	48255425	LTR/ERV1	2155	+	22	48255402	99723
chr19	40784472	40984472	harbor1	chr19	40833689	40834138	LTR/ERV1	3069	+	224	40833913	49441
chr19	40784472	40984472	harbor1	chr19	40864582	40865031	LTR/ERV1	3008	+	224	40864806	80334
chr19	18048813	18248813	harbor1	chr19	18061564	18061635	LTR/ERV1	1427	+	36	18061600	12787
chr19	18048813	18248813	harbor1	chr19	18061888	18062142	LTR/ERV1	1427	+	127	18062015	13202
chr19	18048813	18248813	harbor1	chr19	18064803	18065256	LTR/ERV1	2502	+	226	18065029	16216
chr19	43346850	43546850	harbor1	chr19	43382950	43383131	LTR/ERV1	2947	+	90	43383040	36190
chr19	43346850	43546850	harbor1	chr19	43383434	43383737	LTR/ERV1	2947	+	152	43383586	36736
chr19	43346850	43546850	harbor1	chr19	43388276	43388887	LTR/ERV1	3199	+	306	43388582	41732
chr19	43346850	43546850	harbor1	chr19	43398839	43399046	LTR/ERV1	727	+	104	43398943	52093
chr19	43346850	43546850	harbor1	chr19	43412858	43413225	LTR/ERV1	3515	+	184	43413042	66192
chr19	43346850	43546850	harbor1	chr19	43413512	43413640	LTR/ERV1	3515	+	64	43413576	66726
chr19	43346850	43546850	harbor1	chr19	43420392	43420770	LTR/ERV1	3166	+	189	43420581	73731
chr19	43346850	43546850	harbor1	chr19	43421062	43421267	LTR/ERV1	3166	+	102	43421164	74314
chr19	43346850	43546850	harbor1	chr19	43421574	43421703	LTR/ERV1	3166	+	64	43421638	74788
chr19	43346850	43546850	harbor1	chr19	43423697	43423960	LTR/ERV1	3171	+	132	43423829	76979
chr19	43346850	43546850	harbor1	chr19	43424291	43424425	LTR/ERV1	3171	+	67	43424358	77508
chr19	43346850	43546850	harbor1	chr19	43424714	43424896	LTR/ERV1	3171	+	91	43424805	77955
chr19	43346850	43546850	harbor1	chr19	43425932	43426466	LTR/ERV1	3406	+	267	43426199	79349
chr19	43346850	43546850	harbor1	chr19	43445526	43445937	LTR/ERV1	1299	+	206	43445732	98882
chr19	9921042	10121042	harbor1	chr19	10000058	10000276	LTR/ERV1	1118	+	109	10000167	79125
chr19	35823574	36023574	harbor1	chr19	35881206	35881656	LTR/ERV1	3329	+	225	35881431	57857
chr19	35823574	36023574	harbor1	chr19	35910696	35910855	LTR/ERV1	773	+	80	35910776	87202
chr19	57212762	57412762	harbor1	chr19	57241087	57241457	LTR/ERV1	1473	+	185	57241272	28510
chr19	57212762	57412762	harbor1	chr19	57267561	57268198	LTR/ERV1	3377	+	318	57267879	55117
chr19	57212762	57412762	harbor1	chr19	57268501	57268611	LTR/ERV1	3377	+	55	57268556	55794
chr19	39734302	39934302	harbor1	chr19	39756142	39756642	LTR/ERV1	2409	+	250	39756392	22090
chr19	39734302	39934302	harbor1	chr19	39768270	39768586	LTR/ERV1	1963	+	158	39768428	34126
chr19	39734302	39934302	harbor1	chr19	39772200	39772648	LTR/ERV1	1562	+	224	39772424	38122
chr19	32818777	33018777	harbor1	chr19	32855233	32855418	LTR/ERV1	3013	+	92	32855325	36548
chr19	32818777	33018777	harbor1	chr19	32855721	32855985	LTR/ERV1	3013	+	132	32855853	37076
chr19	32818777	33018777	harbor1	chr19	32894590	32894909	LTR/ERV1	680	+	160	32894750	75973
chr19	14847645	15047645	harbor1	chr19	14865944	14866394	LTR/ERV1	3510	+	225	14866169	18524
chr19	14847645	15047645	harbor1	chr19	14866696	14866793	LTR/ERV1	3510	+	48	14866744	19099
chr19	14847645	15047645	harbor1	chr19	14890676	14891431	LTR/ERV1	5032	+	378	14891054	43409
chr19	14847645	15047645	harbor1	chr19	14944486	14944925	LTR/ERV1	3082	+	220	14944706	97061
chr19	43816361	44016361	harbor1	chr19	43819587	43820045	LTR/ERV1	3282	+	229	43819816	3455
chr19	21039299	21239299	harbor1	chr19	21128499	21128747	LTR/ERV1	1787	+	124	21128623	89324
chr19	21039299	21239299	harbor1	chr19	21128748	21129271	LTR/ERV1	4117	+	262	21129010	89711
chr19	21039299	21239299	harbor1	chr19	21129272	21129347	LTR/ERV1	1787	+	38	21129310	90011
chr19	21039299	21239299	harbor1	chr19	21130752	21131084	LTR/ERV1	1891	+	166	21130918	91619
chr19	21039299	21239299	harbor1	chr19	21138943	21139245	LTR/ERV1	1395	+	151	21139094	99795
chr19	21039299	21239299	harbor1	chr19	21135258	21135420	LTR/ERV1	857	+	81	21135339	96040
chr19	41185565	41385565	harbor1	chr19	41185988	41186050	LTR/ERV1	2796	+	31	41186019	454
chr19	41185565	41385565	harbor1	chr19	41186355	41186573	LTR/ERV1	2796	+	109	41186464	899
chr19	41185565	41385565	harbor1	chr19	41186574	41186970	LTR/ERV1	2759	+	198	41186772	1207
chr19	41185565	41385565	harbor1	chr19	41186971	41187187	LTR/ERV1	2796	+	108	41187079	1514
chr19	41185565	41385565	harbor1	chr19	41188013	41188071	LTR/ERV1	2796	+	29	41188042	2477
chr19	13329899	13529899	harbor1	chr19	13394720	13394985	LTR/ERV1	3452	+	132	13394852	64953
chr19	13329899	13529899	harbor1	chr19	13395302	13395323	LTR/ERV1	3452	+	10	13395312	65413
chr19	13329899	13529899	harbor1	chr19	13395639	13396171	LTR/ERV1	3452	+	266	13395905	66006
chr19	6593652	6793652	harbor1	chr19	6597048	6597508	LTR/ERV1	3633	+	230	6597278	3626
chr19	6593652	6793652	harbor1	chr19	6597509	6597892	LTR/ERV1	2901	+	192	6597701	4049
chr19	6593652	6793652	harbor1	chr19	6597886	6598689	LTR/ERV1	5771	+	402	6598288	4636
chr19	6593652	6793652	harbor1	chr19	6598673	6599985	LTR/ERV1	8875	+	656	6599329	5677
chr19	6593652	6793652	harbor1	chr19	6600098	6601666	LTR/ERV1	12103	+	784	6600882	7230
chr19	6593652	6793652	harbor1	chr19	6601667	6601787	LTR/ERV1	1004	+	60	6601727	8075
chr19	6593652	6793652	harbor1	chr19	6601786	6602002	LTR/ERV1	1464	+	108	6601894	8242
chr19	6593652	6793652	harbor1	chr19	6602206	6602480	LTR/ERV1	2790	+	137	6602343	8691
chr19	6593652	6793652	harbor1	chr19	6603249	6603373	LTR/ERV1	2790	+	62	6603311	9659
chr19	6593652	6793652	harbor1	chr19	6652619	6653124	LTR/ERV1	2914	+	252	6652871	59219
chr19	6593652	6793652	harbor1	chr19	6653756	6653903	LTR/ERV1	2914	+	74	6653830	60178
chr19	6593652	6793652	harbor1	chr19	6675340	6675890	LTR/ERV1	3396	+	275	6675615	81963
chr19	6593652	6793652	harbor1	chr19	6676192	6676374	LTR/ERV1	3396	+	91	6676283	82631
chr19	6593652	6793652	harbor1	chr19	6602745	6602943	LTR/ERV1	2790	+	99	6602844	9192
chr19	12105134	12305134	harbor1	chr19	12139097	12139437	LTR/ERV1	2303	+	170	12139267	34133
chr19	12105134	12305134	harbor1	chr19	12154107	12154261	LTR/ERV1	956	+	77	12154184	49050
chr19	12105134	12305134	harbor1	chr19	12154498	12154635	LTR/ERV1	673	+	68	12154566	49432
chr19	12105134	12305134	harbor1	chr19	12154728	12154933	LTR/ERV1	983	+	102	12154830	49696
chr19	12105134	12305134	harbor1	chr19	12155239	12155320	LTR/ERV1	983	+	40	12155279	50145
chr19	12105134	12305134	harbor1	chr19	12157060	12157218	LTR/ERV1	815	+	79	12157139	52005
chr19	12105134	12305134	harbor1	chr19	12164738	12165032	LTR/ERV1	1518	+	147	12164885	59751
chr19	12105134	12305134	harbor1	chr19	12173216	12173340	LTR/ERV1	644	+	62	12173278	68144
chr19	53541112	53741112	harbor1	chr19	53639480	53639740	LTR/ERV1	991	+	130	53639610	98498
chr19	27904266	28104266	harbor1	chr19	27931316	27931966	LTR/ERV1	5008	+	325	27931641	27375
chr19	27904266	28104266	harbor1	chr19	27955586	27955919	LTR/ERV1	1745	+	166	27955752	51486
chr19	27904266	28104266	harbor1	chr19	27995337	27995659	LTR/ERV1	1844	+	161	27995498	91232
chr19	27904266	28104266	harbor1	chr19	27995932	27995973	LTR/ERV1	1844	+	20	27995952	91686
chr19	27904266	28104266	harbor1	chr19	27996288	27996578	LTR/ERV1	1246	+	145	27996433	92167
chr19	27904266	28104266	harbor1	chr19	28001998	28002215	LTR/ERV1	2327	+	108	28002106	97840
chr19	27904266	28104266	harbor1	chr19	28002522	28002779	LTR/ERV1	2327	+	128	28002650	98384
chr19	17443821	17643821	harbor1	chr19	17467366	17467517	LTR/ERV1	941	+	76	17467442	23621
chr19	39285635	39485635	harbor1	chr19	39305832	39306375	LTR/ERV1	1153	+	272	39306104	20469
chr19	20015524	20215524	harbor1	chr19	20038498	20038994	LTR/ERV1	2431	+	248	20038746	23222
chr19	20015524	20215524	harbor1	chr19	20045618	20046114	LTR/ERV1	3887	+	248	20045866	30342
chr19	20015524	20215524	harbor1	chr19	20047947	20048375	LTR/ERV1	1739	+	214	20048161	32637
chr19	20015524	20215524	harbor1	chr19	20059608	20060058	LTR/ERV1	3624	+	225	20059833	44309
chr19	20015524	20215524	harbor1	chr19	20068041	20068593	LTR/ERV1	3936	+	276	20068317	52793
chr19	20015524	20215524	harbor1	chr19	20077447	20077760	LTR/ERV1	1079	+	156	20077603	62079
chr19	20015524	20215524	harbor1	chr19	20078679	20078836	LTR/ERV1	654	+	78	20078757	63233
chr19	20015524	20215524	harbor1	chr19	20096887	20098102	LTR/ERV1	8466	+	608	20097495	81971
chr19	20015524	20215524	harbor1	chr19	20099536	20099787	LTR/ERV1	1883	+	126	20099662	84138
chr19	20015524	20215524	harbor1	chr19	20099767	20100381	LTR/ERV1	5274	+	307	20100074	84550
chr19	20015524	20215524	harbor1	chr19	20100404	20100692	LTR/ERV1	2237	+	144	20100548	85024
chr19	20015524	20215524	harbor1	chr19	20100698	20101469	LTR/ERV1	5031	+	386	20101084	85560
chr19	20015524	20215524	harbor1	chr19	20102115	20102634	LTR/ERV1	2337	+	260	20102375	86851
chr19	42524327	42724327	harbor1	chr19	42557356	42557790	LTR/ERV1	2810	+	217	42557573	33246
chr19	42524327	42724327	harbor1	chr19	42558050	42558112	LTR/ERV1	4106	+	31	42558081	33754
chr19	42524327	42724327	harbor1	chr19	42558406	42558963	LTR/ERV1	4106	+	278	42558684	34357
chr19	42524327	42724327	harbor1	chr19	42573890	42574103	LTR/ERV1	749	+	106	42573996	49669
chr19	42524327	42724327	harbor1	chr19	42574127	42575513	LTR/ERV1	8164	+	693	42574820	50493
chr19	42524327	42724327	harbor1	chr19	42575837	42576141	LTR/ERV1	669	+	152	42575989	51662
chr19	42524327	42724327	harbor1	chr19	42576474	42576735	LTR/ERV1	915	+	130	42576604	52277
chr19	42524327	42724327	harbor1	chr19	42576703	42576900	LTR/ERV1	811	+	98	42576801	52474
chr19	42524327	42724327	harbor1	chr19	42609481	42609664	LTR/ERV1	879	+	92	42609573	85246
chr19	42524327	42724327	harbor1	chr19	42611305	42611501	LTR/ERV1	909	+	98	42611403	87076
chr19	42524327	42724327	harbor1	chr19	42611522	42611750	LTR/ERV1	1047	+	114	42611636	87309
chr19	42524327	42724327	harbor1	chr19	42611755	42612515	LTR/ERV1	5914	+	380	42612135	87808
chr19	42524327	42724327	harbor1	chr19	42612519	42613554	LTR/ERV1	2333	+	518	42613037	88710
chr19	42524327	42724327	harbor1	chr19	42613563	42614256	LTR/ERV1	4404	+	346	42613909	89582
chr19	42524327	42724327	harbor1	chr19	42615261	42616246	LTR/ERV1	4005	+	492	42615753	91426
chr19	42524327	42724327	harbor1	chr19	42616234	42616524	LTR/ERV1	5155	+	145	42616379	92052
chr19	42524327	42724327	harbor1	chr19	42616812	42617616	LTR/ERV1	6022	+	402	42617214	92887
chr19	42524327	42724327	harbor1	chr19	42618150	42619169	LTR/ERV1	6202	+	510	42618660	94333
chr19	42524327	42724327	harbor1	chr19	42614575	42614940	LTR/ERV1	4005	+	182	42614757	90430
chr19	28378961	28578961	harbor1	chr19	28393968	28394485	LTR/ERV1	1753	+	258	28394226	15265
chr19	28378961	28578961	harbor1	chr19	28396357	28396839	LTR/ERV1	2586	+	241	28396598	17637
chr19	28378961	28578961	harbor1	chr19	28423644	28424111	LTR/ERV1	2484	+	234	28423878	44917
chr19	28378961	28578961	harbor1	chr19	28429264	28429653	LTR/ERV1	2360	+	194	28429458	50497
chr19	28378961	28578961	harbor1	chr19	28429941	28430084	LTR/ERV1	2360	+	72	28430013	51052
chr19	28378961	28578961	harbor1	chr19	28444762	28445468	LTR/ERV1	3247	+	353	28445115	66154
chr19	28378961	28578961	harbor1	chr19	28445470	28446407	LTR/ERV1	10303	+	468	28445938	66977
chr19	28378961	28578961	harbor1	chr19	28446408	28447026	LTR/ERV1	4007	+	309	28446717	67756
chr19	28378961	28578961	harbor1	chr19	28447027	28448940	LTR/ERV1	10303	+	956	28447983	69022
chr19	28378961	28578961	harbor1	chr19	28449246	28449610	LTR/ERV1	10303	+	182	28449428	70467
chr19	28378961	28578961	harbor1	chr19	28449583	28450049	LTR/ERV1	1930	+	233	28449816	70855
chr19	28378961	28578961	harbor1	chr19	28450072	28450451	LTR/ERV1	1924	+	190	28450262	71301
chr19	28378961	28578961	harbor1	chr19	28450452	28451183	LTR/ERV1	2909	+	366	28450818	71857
chr19	28378961	28578961	harbor1	chr19	28451182	28452052	LTR/ERV1	6079	+	435	28451617	72656
chr19	28378961	28578961	harbor1	chr19	28452053	28452186	LTR/ERV1	660	+	66	28452119	73158
chr19	28378961	28578961	harbor1	chr19	28452204	28452264	LTR/ERV1	2298	+	30	28452234	73273
chr19	28378961	28578961	harbor1	chr19	28452546	28452827	LTR/ERV1	2298	+	140	28452686	73725
chr19	28378961	28578961	harbor1	chr19	28452828	28453464	LTR/ERV1	3128	+	318	28453146	74185
chr19	28378961	28578961	harbor1	chr19	28458180	28458663	LTR/ERV1	1548	+	242	28458422	79461
chr19	28378961	28578961	harbor1	chr19	28458672	28459194	LTR/ERV1	2845	+	261	28458933	79972
chr19	33461054	33661054	harbor1	chr19	33502387	33502922	LTR/ERV1	1519	+	268	33502655	41601
chr19	33461054	33661054	harbor1	chr19	33532438	33532567	LTR/ERV1	822	+	64	33532502	71448
chr19	33461054	33661054	harbor1	chr19	33539093	33539182	LTR/ERV1	1281	+	44	33539137	78083
chr19	33461054	33661054	harbor1	chr19	33539489	33539755	LTR/ERV1	1281	+	133	33539622	78568
chr19	33461054	33661054	harbor1	chr19	33540068	33540248	LTR/ERV1	1281	+	90	33540158	79104
chr19	33461054	33661054	harbor1	chr19	33540530	33540576	LTR/ERV1	1281	+	23	33540553	79499
chr19	47489029	47689029	harbor1	chr19	47585331	47585395	LTR/ERV1	3070	+	32	47585363	96334
chr19	47489029	47689029	harbor1	chr19	47585706	47586254	LTR/ERV1	3070	+	274	47585980	96951
chr19	56634216	56834216	harbor1	chr19	56715804	56716051	LTR/ERV1	3080	+	124	56715928	81712
chr19	56634216	56834216	harbor1	chr19	56716365	56716624	LTR/ERV1	3080	+	130	56716495	82279
chr19	56634216	56834216	harbor1	chr19	56716930	56717042	LTR/ERV1	3080	+	56	56716986	82770
chr19	56634216	56834216	harbor1	chr19	56725069	56725522	LTR/ERV1	2623	+	226	56725295	91079
chr19	56634216	56834216	harbor1	chr19	56725524	56725685	LTR/ERV1	799	+	80	56725604	91388
chr19	56634216	56834216	harbor1	chr19	56725994	56726057	LTR/ERV1	656	+	32	56726026	91810
chr19	34785756	34985756	harbor1	chr19	34786107	34786470	LTR/ERV1	1318	+	182	34786289	533
chr19	34785756	34985756	harbor1	chr19	34804735	34805158	LTR/ERV1	2720	+	212	34804947	19191
chr19	34785756	34985756	harbor1	chr19	34806468	34806952	LTR/ERV1	829	+	242	34806710	20954
chr19	34785756	34985756	harbor1	chr19	34808265	34808418	LTR/ERV1	3588	+	76	34808341	22585
chr19	34785756	34985756	harbor1	chr19	34808622	34809052	LTR/ERV1	3588	+	215	34808837	23081
chr19	34785756	34985756	harbor1	chr19	34834559	34835036	LTR/ERV1	2716	+	238	34834797	49041
chr19	34785756	34985756	harbor1	chr19	34835969	34836397	LTR/ERV1	1945	+	214	34836183	50427
chr19	34785756	34985756	harbor1	chr19	34870546	34871020	LTR/ERV1	3192	+	237	34870783	85027
chr19	54651349	54851349	harbor1	chr19	54672643	54672924	LTR/ERV1	1253	+	140	54672783	21434
chr19	54651349	54851349	harbor1	chr19	54674107	54674246	LTR/ERV1	710	+	70	54674177	22828
chr19	54651349	54851349	harbor1	chr19	54674248	54674877	LTR/ERV1	3534	+	314	54674562	23213
chr19	54651349	54851349	harbor1	chr19	54674872	54675433	LTR/ERV1	3357	+	280	54675152	23803
chr19	54651349	54851349	harbor1	chr19	54675733	54675937	LTR/ERV1	3357	+	102	54675835	24486
chr19	54651349	54851349	harbor1	chr19	54676063	54676244	LTR/ERV1	679	+	90	54676153	24804
chr19	54651349	54851349	harbor1	chr19	54676829	54677103	LTR/ERV1	1216	+	137	54676966	25617
chr19	54651349	54851349	harbor1	chr19	54677104	54677704	LTR/ERV1	2789	+	300	54677404	26055
chr19	54651349	54851349	harbor1	chr19	54679942	54680164	LTR/ERV1	1782	+	111	54680053	28704
chr19	54651349	54851349	harbor1	chr19	54680818	54681271	LTR/ERV1	1699	+	226	54681044	29695
chr19	54651349	54851349	harbor1	chr19	54672926	54673755	LTR/ERV1	4820	+	414	54673340	21991
chr19	109669	309669	harbor1	chr19	177648	177928	LTR/ERV1	821	+	140	177788	68119
chr19	36954576	37154576	harbor1	chr19	37019880	37019935	LTR/ERV1	2089	+	28	37019908	65332
chr19	36954576	37154576	harbor1	chr19	37020239	37020596	LTR/ERV1	2089	+	178	37020417	65841
chr19	36954576	37154576	harbor1	chr19	37023906	37024438	LTR/ERV1	3069	+	266	37024172	69596
chr19	36954576	37154576	harbor1	chr19	37035023	37035364	LTR/ERV1	1552	+	170	37035193	80617
chr19	23303874	23503874	harbor1	chr19	23303821	23304261	LTR/ERV1	992	+	220	23304041	167
chr19	23303874	23503874	harbor1	chr19	23344732	23344908	LTR/ERV1	876	+	88	23344820	40946
chr19	23303874	23503874	harbor1	chr19	23344909	23346593	LTR/ERV1	10040	+	842	23345751	41877
chr19	23303874	23503874	harbor1	chr19	23349443	23350610	LTR/ERV1	18063	+	584	23350027	46153
chr19	23303874	23503874	harbor1	chr19	23350611	23350997	LTR/ERV1	2612	+	193	23350804	46930
chr19	23303874	23503874	harbor1	chr19	23391174	23391612	LTR/ERV1	918	+	219	23391393	87519
chr19	23303874	23503874	harbor1	chr19	23394177	23394448	LTR/ERV1	2688	+	136	23394313	90439
chr19	23303874	23503874	harbor1	chr19	23394749	23394969	LTR/ERV1	2688	+	110	23394859	90985
chr19	23303874	23503874	harbor1	chr19	23397285	23397817	LTR/ERV1	3312	+	266	23397551	93677
chr19	23303874	23503874	harbor1	chr19	23346593	23348277	LTR/ERV1	18063	+	842	23347435	43561
chr19	43209017	43409017	harbor1	chr19	43224334	43225081	LTR/ERV1	3562	+	374	43224708	15691
chr19	43209017	43409017	harbor1	chr19	43230571	43231183	LTR/ERV1	4163	+	306	43230877	21860
chr19	43209017	43409017	harbor1	chr19	43231850	43232724	LTR/ERV1	4163	+	437	43232287	23270
chr19	43209017	43409017	harbor1	chr19	43265001	43265754	LTR/ERV1	2025	+	376	43265377	56360
chr19	43209017	43409017	harbor1	chr19	43292340	43293204	LTR/ERV1	3452	+	432	43292772	83755
chr19	43209017	43409017	harbor1	chr19	43300415	43301151	LTR/ERV1	2080	+	368	43300783	91766
chr19	43209017	43409017	harbor1	chr19	43286222	43286970	LTR/ERV1	3640	+	374	43286596	77579
chr19	5550087	5750087	harbor1	chr19	5549017	5551892	LTR/ERV1	15423	+	1438	5550455	368
chr19	5550087	5750087	harbor1	chr19	5551872	5552016	LTR/ERV1	835	+	72	5551944	1857
chr19	5550087	5750087	harbor1	chr19	5552007	5552168	LTR/ERV1	1037	+	80	5552087	2000
chr19	5550087	5750087	harbor1	chr19	5552161	5552771	LTR/ERV1	4429	+	305	5552466	2379
chr19	5550087	5750087	harbor1	chr19	5552772	5553212	LTR/ERV1	3809	+	220	5552992	2905
chr19	28249187	28449187	harbor1	chr19	28290183	28290689	LTR/ERV1	1710	+	253	28290436	41249
chr19	28249187	28449187	harbor1	chr19	28318323	28318821	LTR/ERV1	2624	+	249	28318572	69385
chr19	28249187	28449187	harbor1	chr19	28324336	28325218	LTR/ERV1	5144	+	441	28324777	75590
chr19	28249187	28449187	harbor1	chr19	28328415	28328590	LTR/ERV1	738	+	88	28328503	79316
chr19	28249187	28449187	harbor1	chr19	28327640	28328039	LTR/ERV1	2175	+	200	28327840	78653
chr19	47807980	48007980	harbor1	chr19	47892220	47892697	LTR/ERV1	944	+	238	47892458	84478
chr19	36683880	36883880	harbor1	chr19	36771716	36772043	LTR/ERV1	1396	+	164	36771880	88000
chr19	27779782	27979782	harbor1	chr19	27823712	27824159	LTR/ERV1	875	+	224	27823936	44154
chr19	27779782	27979782	harbor1	chr19	27840872	27840981	LTR/ERV1	2810	+	54	27840926	61144
chr19	27779782	27979782	harbor1	chr19	27841275	27841619	LTR/ERV1	2810	+	172	27841447	61665
chr19	27779782	27979782	harbor1	chr19	27876948	27877566	LTR/ERV1	3389	+	309	27877257	97475
chr19	3462762	3662762	harbor1	chr19	3498224	3498410	LTR/ERV1	4572	+	93	3498317	35555
chr19	3462762	3662762	harbor1	chr19	3498705	3499184	LTR/ERV1	4572	+	240	3498945	36183
chr19	7896920	8096920	harbor1	chr19	7949063	7949297	LTR/ERV1	1345	+	117	7949180	52260
chr19	12219877	12419877	harbor1	chr19	12232959	12233402	LTR/ERV1	2303	+	222	12233181	13304
chr19	12219877	12419877	harbor1	chr19	12236273	12236468	LTR/ERV1	674	+	98	12236371	16494
chr19	12219877	12419877	harbor1	chr19	12236902	12237120	LTR/ERV1	860	+	109	12237011	17134
chr19	12219877	12419877	harbor1	chr19	12244304	12244446	LTR/ERV1	782	+	71	12244375	24498
chr19	12219877	12419877	harbor1	chr19	12244557	12245035	LTR/ERV1	1011	+	239	12244796	24919
chr19	12219877	12419877	harbor1	chr19	12282363	12282418	LTR/ERV1	2327	+	28	12282391	62514
chr19	12219877	12419877	harbor1	chr19	12282722	12283157	LTR/ERV1	2327	+	218	12282940	63063
chr19	12219877	12419877	harbor1	chr19	12288903	12289022	LTR/ERV1	1142	+	60	12288963	69086
chr19	12219877	12419877	harbor1	chr19	12289336	12289640	LTR/ERV1	1142	+	152	12289488	69611
chr19	12219877	12419877	harbor1	chr19	12289931	12289970	LTR/ERV1	1142	+	20	12289951	70074
chr19	12219877	12419877	harbor1	chr19	12293900	12294377	LTR/ERV1	990	+	238	12294138	74261
chr19	12219877	12419877	harbor1	chr19	12295710	12296164	LTR/ERV1	3236	+	227	12295937	76060
chr19	49208529	49408529	harbor1	chr19	49303697	49304169	LTR/ERV1	1798	+	236	49303933	95404
chr19	49208529	49408529	harbor1	chr19	49304170	49304482	LTR/ERV1	1789	+	156	49304326	95797
chr19	48766310	48966310	harbor1	chr19	48810167	48810574	LTR/ERV1	1554	+	204	48810371	44061
chr19	48766310	48966310	harbor1	chr19	48830072	48830629	LTR/ERV1	3847	+	278	48830350	64040
chr19	22300256	22500256	harbor1	chr19	22300094	22301372	LTR/ERV1	8142	+	639	22300733	477
chr19	29468999	29668999	harbor1	chr19	29477182	29477497	LTR/ERV1	1490	+	158	29477340	8341
chr19	29468999	29668999	harbor1	chr19	29477805	29477977	LTR/ERV1	1490	+	86	29477891	8892
chr19	29468999	29668999	harbor1	chr19	29480904	29481282	LTR/ERV1	1948	+	189	29481093	12094
chr19	29468999	29668999	harbor1	chr19	29481555	29481697	LTR/ERV1	955	+	71	29481626	12627
chr19	29468999	29668999	harbor1	chr19	29482458	29482811	LTR/ERV1	1930	+	176	29482634	13635
chr19	29468999	29668999	harbor1	chr19	29484566	29485065	LTR/ERV1	2713	+	250	29484816	15817
chr19	29468999	29668999	harbor1	chr19	29488756	29488812	LTR/ERV1	1897	+	28	29488784	19785
chr19	29468999	29668999	harbor1	chr19	29489115	29489501	LTR/ERV1	1897	+	193	29489308	20309
chr19	6413236	6613236	harbor1	chr19	6492582	6492758	LTR/ERV1	3902	+	88	6492670	79434
chr19	6413236	6613236	harbor1	chr19	6493102	6493352	LTR/ERV1	3902	+	125	6493227	79991
chr19	6413236	6613236	harbor1	chr19	6493962	6494076	LTR/ERV1	3902	+	57	6494019	80783
chr19	6413236	6613236	harbor1	chr19	6505812	6506242	LTR/ERV1	3400	+	215	6506027	92791
chr19	6413236	6613236	harbor1	chr19	6511014	6511127	LTR/ERV1	881	+	56	6511070	97834
chr19	6413236	6613236	harbor1	chr19	6511683	6512002	LTR/ERV1	2095	+	160	6511843	98607
chr19	6413236	6613236	harbor1	chr19	6512315	6512355	LTR/ERV1	2095	+	20	6512335	99099
chr19	6610290	6810290	harbor1	chr19	6652619	6653124	LTR/ERV1	2914	+	252	6652871	42581
chr19	6610290	6810290	harbor1	chr19	6653756	6653903	LTR/ERV1	2914	+	74	6653830	43540
chr19	6610290	6810290	harbor1	chr19	6675340	6675890	LTR/ERV1	3396	+	275	6675615	65325
chr19	6610290	6810290	harbor1	chr19	6676192	6676374	LTR/ERV1	3396	+	91	6676283	65993
chr19	6610290	6810290	harbor1	chr19	6701189	6701523	LTR/ERV1	1124	+	167	6701356	91066
chr19	49532281	49732281	harbor1	chr19	49579292	49579734	LTR/ERV1	2218	+	221	49579513	47232
chr19	27766712	27966712	harbor1	chr19	27823712	27824159	LTR/ERV1	875	+	224	27823936	57224
chr19	27766712	27966712	harbor1	chr19	27840872	27840981	LTR/ERV1	2810	+	54	27840926	74214
chr19	27766712	27966712	harbor1	chr19	27841275	27841619	LTR/ERV1	2810	+	172	27841447	74735
chr19	6447517	6647517	harbor1	chr19	6492582	6492758	LTR/ERV1	3902	+	88	6492670	45153
chr19	6447517	6647517	harbor1	chr19	6493102	6493352	LTR/ERV1	3902	+	125	6493227	45710
chr19	6447517	6647517	harbor1	chr19	6493962	6494076	LTR/ERV1	3902	+	57	6494019	46502
chr19	6447517	6647517	harbor1	chr19	6505812	6506242	LTR/ERV1	3400	+	215	6506027	58510
chr19	6447517	6647517	harbor1	chr19	6511014	6511127	LTR/ERV1	881	+	56	6511070	63553
chr19	6447517	6647517	harbor1	chr19	6511683	6512002	LTR/ERV1	2095	+	160	6511843	64326
chr19	6447517	6647517	harbor1	chr19	6512315	6512355	LTR/ERV1	2095	+	20	6512335	64818
chr19	18039067	18239067	harbor1	chr19	18061564	18061635	LTR/ERV1	1427	+	36	18061600	22533
chr19	18039067	18239067	harbor1	chr19	18061888	18062142	LTR/ERV1	1427	+	127	18062015	22948
chr19	18039067	18239067	harbor1	chr19	18064803	18065256	LTR/ERV1	2502	+	226	18065029	25962
chr19	43705683	43905683	harbor1	chr19	43804138	43804340	LTR/ERV1	1040	+	101	43804239	98556
chr19	43705683	43905683	harbor1	chr19	43804413	43804587	LTR/ERV1	650	+	87	43804500	98817
chr19	53221612	53421612	harbor1	chr19	53225659	53226015	LTR/ERV1	2413	+	178	53225837	4225
chr19	53221612	53421612	harbor1	chr19	53226271	53226367	LTR/ERV1	2413	+	48	53226319	4707
chr19	53221612	53421612	harbor1	chr19	53304653	53305198	LTR/ERV1	3122	+	272	53304925	83313
chr19	34470481	34670481	harbor1	chr19	34514096	34514494	LTR/ERV1	2704	+	199	34514295	43814
chr19	34470481	34670481	harbor1	chr19	34514497	34517397	LTR/ERV1	14251	+	1450	34515947	45466
chr19	34470481	34670481	harbor1	chr19	34517392	34517613	LTR/ERV1	1282	+	110	34517502	47021
chr19	16024750	16224750	harbor1	chr19	16051493	16051976	LTR/ERV1	2808	+	242	16051735	26985
chr19	57996467	58196467	harbor1	chr19	58005243	58005785	LTR/ERV1	2473	+	271	58005514	9047
chr19	57996467	58196467	harbor1	chr19	58021872	58022171	LTR/ERV1	709	+	150	58022022	25555
chr19	57996467	58196467	harbor1	chr19	58023055	58023408	LTR/ERV1	976	+	176	58023231	26764
chr19	29691537	29891537	harbor1	chr19	29712459	29712851	LTR/ERV1	1363	+	196	29712655	21118
chr19	29691537	29891537	harbor1	chr19	29727319	29727514	LTR/ERV1	4955	+	98	29727417	35880
chr19	29691537	29891537	harbor1	chr19	29727807	29728549	LTR/ERV1	4955	+	371	29728178	36641
chr19	53691656	53891656	harbor1	chr19	53769073	53769384	LTR/ERV1	853	+	156	53769229	77573
chr19	53691656	53891656	harbor1	chr19	53780548	53780872	LTR/ERV1	963	+	162	53780710	89054
chr19	57077720	57277720	harbor1	chr19	57078270	57078408	LTR/ERV1	864	+	69	57078339	619
chr19	57077720	57277720	harbor1	chr19	57091411	57091573	LTR/ERV1	919	+	81	57091492	13772
chr19	57077720	57277720	harbor1	chr19	57092506	57093103	LTR/ERV1	3033	+	298	57092804	15084
chr19	57077720	57277720	harbor1	chr19	57118404	57118959	LTR/ERV1	3479	+	278	57118682	40962
chr19	57077720	57277720	harbor1	chr19	57141445	57141481	LTR/ERV1	1803	+	18	57141463	63743
chr19	57077720	57277720	harbor1	chr19	57141518	57141617	LTR/ERV1	1803	+	50	57141568	63848
chr19	57077720	57277720	harbor1	chr19	57141864	57142137	LTR/ERV1	1803	+	136	57142000	64280
chr19	57077720	57277720	harbor1	chr19	57172534	57172693	LTR/ERV1	1067	+	80	57172614	94894
chr19	57077720	57277720	harbor1	chr19	57172998	57173036	LTR/ERV1	1067	+	19	57173017	95297
chr19	43351328	43551328	harbor1	chr19	43382950	43383131	LTR/ERV1	2947	+	90	43383040	31712
chr19	43351328	43551328	harbor1	chr19	43383434	43383737	LTR/ERV1	2947	+	152	43383586	32258
chr19	43351328	43551328	harbor1	chr19	43388276	43388887	LTR/ERV1	3199	+	306	43388582	37254
chr19	43351328	43551328	harbor1	chr19	43398839	43399046	LTR/ERV1	727	+	104	43398943	47615
chr19	43351328	43551328	harbor1	chr19	43412858	43413225	LTR/ERV1	3515	+	184	43413042	61714
chr19	43351328	43551328	harbor1	chr19	43413512	43413640	LTR/ERV1	3515	+	64	43413576	62248
chr19	43351328	43551328	harbor1	chr19	43420392	43420770	LTR/ERV1	3166	+	189	43420581	69253
chr19	43351328	43551328	harbor1	chr19	43421062	43421267	LTR/ERV1	3166	+	102	43421164	69836
chr19	43351328	43551328	harbor1	chr19	43421574	43421703	LTR/ERV1	3166	+	64	43421638	70310
chr19	43351328	43551328	harbor1	chr19	43423697	43423960	LTR/ERV1	3171	+	132	43423829	72501
chr19	43351328	43551328	harbor1	chr19	43424291	43424425	LTR/ERV1	3171	+	67	43424358	73030
chr19	43351328	43551328	harbor1	chr19	43424714	43424896	LTR/ERV1	3171	+	91	43424805	73477
chr19	43351328	43551328	harbor1	chr19	43425932	43426466	LTR/ERV1	3406	+	267	43426199	74871
chr19	43351328	43551328	harbor1	chr19	43445526	43445937	LTR/ERV1	1299	+	206	43445732	94404
chr19	43351328	43551328	harbor1	chr19	43448280	43448528	LTR/ERV1	1344	+	124	43448404	97076
chr19	46374763	46574763	harbor1	chr19	46396203	46396222	LTR/ERV1	1383	+	10	46396213	21450
chr19	46374763	46574763	harbor1	chr19	46396511	46396776	LTR/ERV1	1383	+	132	46396643	21880
chr19	46374763	46574763	harbor1	chr19	46397395	46397544	LTR/ERV1	1383	+	74	46397469	22706
chr19	46374763	46574763	harbor1	chr19	46442219	46442622	LTR/ERV1	3191	+	202	46442421	67658
chr19	46374763	46574763	harbor1	chr19	46442934	46443150	LTR/ERV1	3191	+	108	46443042	68279
chr19	46374763	46574763	harbor1	chr19	46472183	46472664	LTR/ERV1	2766	+	240	46472423	97660
chr19	46374763	46574763	harbor1	chr19	46474090	46474374	LTR/ERV1	1390	+	142	46474232	99469
chr19	18041970	18241970	harbor1	chr19	18061564	18061635	LTR/ERV1	1427	+	36	18061600	19630
chr19	18041970	18241970	harbor1	chr19	18061888	18062142	LTR/ERV1	1427	+	127	18062015	20045
chr19	18041970	18241970	harbor1	chr19	18064803	18065256	LTR/ERV1	2502	+	226	18065029	23059
chr19	52532080	52732080	harbor1	chr19	52534242	52534575	LTR/ERV1	1369	+	166	52534408	2328
chr19	52532080	52732080	harbor1	chr19	52565332	52565989	LTR/ERV1	3216	+	328	52565660	33580
chr19	52532080	52732080	harbor1	chr19	52566700	52566957	LTR/ERV1	1967	+	128	52566828	34748
chr19	52532080	52732080	harbor1	chr19	52567252	52567416	LTR/ERV1	1967	+	82	52567334	35254
chr19	52532080	52732080	harbor1	chr19	52568439	52568781	LTR/ERV1	1609	+	171	52568610	36530
chr19	52532080	52732080	harbor1	chr19	52568783	52569217	LTR/ERV1	1544	+	217	52569000	36920
chr19	52532080	52732080	harbor1	chr19	52599207	52599321	LTR/ERV1	1722	+	57	52599264	67184
chr19	52532080	52732080	harbor1	chr19	52599322	52599790	LTR/ERV1	2142	+	234	52599556	67476
chr19	52532080	52732080	harbor1	chr19	52599791	52600214	LTR/ERV1	1722	+	212	52600003	67923
chr19	52532080	52732080	harbor1	chr19	52605724	52606009	LTR/ERV1	1471	+	142	52605866	73786
chr19	52532080	52732080	harbor1	chr19	52620684	52621112	LTR/ERV1	2642	+	214	52620898	88818
chr19	52532080	52732080	harbor1	chr19	52621127	52625394	LTR/ERV1	15573	+	2134	52623261	91181
chr19	52532080	52732080	harbor1	chr19	52626894	52627315	LTR/ERV1	2526	+	210	52627104	95024
chr19	52532080	52732080	harbor1	chr19	52627795	52628192	LTR/ERV1	2504	+	198	52627993	95913
chr19	52532080	52732080	harbor1	chr19	52628195	52631191	LTR/ERV1	20769	+	1498	52629693	97613
chr19	52532080	52732080	harbor1	chr19	52631171	52631318	LTR/ERV1	888	+	74	52631245	99165
chr19	52532080	52732080	harbor1	chr19	52631318	52631810	LTR/ERV1	3562	+	246	52631564	99484
chr19	52532080	52732080	harbor1	chr19	52625393	52626863	LTR/ERV1	8555	+	735	52626128	94048
chr19	37610805	37810805	harbor1	chr19	37687834	37687958	LTR/ERV1	715	+	62	37687896	77091
chr19	37610805	37810805	harbor1	chr19	37701253	37701730	LTR/ERV1	3312	+	238	37701491	90686
chr19	38892955	39092955	harbor1	chr19	38950611	38950795	LTR/ERV1	1806	+	92	38950703	57748
chr19	38892955	39092955	harbor1	chr19	38951090	38951200	LTR/ERV1	1806	+	55	38951145	58190
chr19	38892955	39092955	harbor1	chr19	38951477	38951647	LTR/ERV1	947	+	85	38951562	58607
chr19	38892955	39092955	harbor1	chr19	38952247	38952294	LTR/ERV1	947	+	24	38952271	59316
chr19	38892955	39092955	harbor1	chr19	38979964	38980181	LTR/ERV1	6192	+	108	38980072	87117
chr19	38892955	39092955	harbor1	chr19	38980490	38981380	LTR/ERV1	6192	+	445	38980935	87980
chr19	37537304	37737304	harbor1	chr19	37587171	37587374	LTR/ERV1	911	+	102	37587273	49969
chr19	17253104	17453104	harbor1	chr19	17286861	17287148	LTR/ERV1	4196	+	144	17287005	33901
chr19	17253104	17453104	harbor1	chr19	17287454	17287729	LTR/ERV1	4196	+	138	17287592	34488
chr19	35559150	35759150	harbor1	chr19	35578890	35579252	LTR/ERV1	2511	+	181	35579071	19921
chr19	35559150	35759150	harbor1	chr19	35604596	35604970	LTR/ERV1	1792	+	187	35604783	45633
chr19	35559150	35759150	harbor1	chr19	35604971	35605415	LTR/ERV1	3078	+	222	35605193	46043
chr19	35559150	35759150	harbor1	chr19	35605725	35605975	LTR/ERV1	3078	+	125	35605850	46700
chr19	35559150	35759150	harbor1	chr19	35606347	35606371	LTR/ERV1	3078	+	12	35606359	47209
chr19	35559150	35759150	harbor1	chr19	35628109	35628305	LTR/ERV1	1308	+	98	35628207	69057
chr19	43932333	44132333	harbor1	chr19	43936331	43936700	LTR/ERV1	1285	+	184	43936515	4182
chr19	43932333	44132333	harbor1	chr19	43936885	43937218	LTR/ERV1	2723	+	166	43937051	4718
chr19	43932333	44132333	harbor1	chr19	43937509	43938002	LTR/ERV1	2723	+	246	43937755	5422
chr19	43932333	44132333	harbor1	chr19	43997621	43998440	LTR/ERV1	4852	+	410	43998031	65698
chr19	18410111	18610111	harbor1	chr19	18439406	18439848	LTR/ERV1	723	+	221	18439627	29516
chr19	10887244	11087244	harbor1	chr19	10939623	10939922	LTR/ERV1	1428	+	150	10939773	52529
chr19	10887244	11087244	harbor1	chr19	10940074	10940210	LTR/ERV1	787	+	68	10940142	52898
chr19	30126677	30326677	harbor1	chr19	30160052	30160580	LTR/ERV1	2946	+	264	30160316	33639
chr19	30126677	30326677	harbor1	chr19	30176414	30177006	LTR/ERV1	3284	+	296	30176710	50033
chr19	13606051	13806051	harbor1	chr19	13640980	13641341	LTR/ERV1	1356	+	180	13641160	35109
chr19	13606051	13806051	harbor1	chr19	13652628	13653297	LTR/ERV1	4183	+	334	13652962	46911
chr19	13606051	13806051	harbor1	chr19	13654281	13654590	LTR/ERV1	3971	+	154	13654435	48384
chr19	13606051	13806051	harbor1	chr19	13655075	13655243	LTR/ERV1	3971	+	84	13655159	49108
chr19	13606051	13806051	harbor1	chr19	13655540	13655703	LTR/ERV1	3971	+	82	13655622	49571
chr19	13606051	13806051	harbor1	chr19	13664595	13664758	LTR/ERV1	1298	+	82	13664677	58626
chr19	13606051	13806051	harbor1	chr19	13665149	13665275	LTR/ERV1	936	+	63	13665212	59161
chr19	37346414	37546414	harbor1	chr19	37364012	37364652	LTR/ERV1	2656	+	320	37364332	17918
chr19	37346414	37546414	harbor1	chr19	37434586	37435014	LTR/ERV1	3427	+	214	37434800	88386
chr19	36433990	36633990	harbor1	chr19	36436486	36436832	LTR/ERV1	1729	+	173	36436659	2669
chr19	36433990	36633990	harbor1	chr19	36437441	36437634	LTR/ERV1	1729	+	96	36437537	3547
chr19	36433990	36633990	harbor1	chr19	36507441	36507490	LTR/ERV1	790	+	24	36507465	73475
chr19	36433990	36633990	harbor1	chr19	36507789	36507985	LTR/ERV1	790	+	98	36507887	73897
chr19	36433990	36633990	harbor1	chr19	36508300	36508509	LTR/ERV1	1055	+	104	36508404	74414
chr19	36433990	36633990	harbor1	chr19	36509799	36509913	LTR/ERV1	1055	+	57	36509856	75866
chr19	5660976	5860976	harbor1	chr19	5675497	5675810	LTR/ERV1	1837	+	156	5675653	14677
chr19	43368148	43568148	harbor1	chr19	43382950	43383131	LTR/ERV1	2947	+	90	43383040	14892
chr19	43368148	43568148	harbor1	chr19	43383434	43383737	LTR/ERV1	2947	+	152	43383586	15438
chr19	43368148	43568148	harbor1	chr19	43388276	43388887	LTR/ERV1	3199	+	306	43388582	20434
chr19	43368148	43568148	harbor1	chr19	43398839	43399046	LTR/ERV1	727	+	104	43398943	30795
chr19	43368148	43568148	harbor1	chr19	43412858	43413225	LTR/ERV1	3515	+	184	43413042	44894
chr19	43368148	43568148	harbor1	chr19	43413512	43413640	LTR/ERV1	3515	+	64	43413576	45428
chr19	43368148	43568148	harbor1	chr19	43420392	43420770	LTR/ERV1	3166	+	189	43420581	52433
chr19	43368148	43568148	harbor1	chr19	43421062	43421267	LTR/ERV1	3166	+	102	43421164	53016
chr19	43368148	43568148	harbor1	chr19	43421574	43421703	LTR/ERV1	3166	+	64	43421638	53490
chr19	43368148	43568148	harbor1	chr19	43423697	43423960	LTR/ERV1	3171	+	132	43423829	55681
chr19	43368148	43568148	harbor1	chr19	43424291	43424425	LTR/ERV1	3171	+	67	43424358	56210
chr19	43368148	43568148	harbor1	chr19	43424714	43424896	LTR/ERV1	3171	+	91	43424805	56657
chr19	43368148	43568148	harbor1	chr19	43425932	43426466	LTR/ERV1	3406	+	267	43426199	58051
chr19	43368148	43568148	harbor1	chr19	43445526	43445937	LTR/ERV1	1299	+	206	43445732	77584
chr19	43368148	43568148	harbor1	chr19	43448280	43448528	LTR/ERV1	1344	+	124	43448404	80256
chr19	43368148	43568148	harbor1	chr19	43467912	43468218	LTR/ERV1	1742	+	153	43468065	99917
chr19	34018656	34218656	harbor1	chr19	34027826	34028086	LTR/ERV1	1614	+	130	34027956	9300
chr19	34018656	34218656	harbor1	chr19	34028386	34028396	LTR/ERV1	1614	+	5	34028391	9735
chr19	34018656	34218656	harbor1	chr19	34028692	34028878	LTR/ERV1	1614	+	93	34028785	10129
chr19	34018656	34218656	harbor1	chr19	34031011	34031279	LTR/ERV1	1468	+	134	34031145	12489
chr19	34018656	34218656	harbor1	chr19	34075700	34076456	LTR/ERV1	4213	+	378	34076078	57422
chr19	11570956	11770956	harbor1	chr19	11610623	11610757	LTR/ERV1	794	+	67	11610690	39734
chr19	17524278	17724278	harbor1	chr19	17593566	17593923	LTR/ERV1	2395	+	178	17593744	69466
chr19	17524278	17724278	harbor1	chr19	17596828	17596972	LTR/ERV1	865	+	72	17596900	72622
chr19	17524278	17724278	harbor1	chr19	17596963	17597465	LTR/ERV1	3285	+	251	17597214	72936
chr19	17524278	17724278	harbor1	chr19	17597468	17598095	LTR/ERV1	4237	+	314	17597782	73504
chr19	17524278	17724278	harbor1	chr19	17593926	17596833	LTR/ERV1	16344	+	1454	17595380	71102
chr19	9698874	9898874	harbor1	chr19	9702092	9702567	LTR/ERV1	2556	+	238	9702330	3456
chr19	9698874	9898874	harbor1	chr19	9702568	9702913	LTR/ERV1	2443	+	172	9702740	3866
chr19	9698874	9898874	harbor1	chr19	9702957	9703092	LTR/ERV1	799	+	68	9703025	4151
chr19	9698874	9898874	harbor1	chr19	9703073	9703931	LTR/ERV1	5964	+	429	9703502	4628
chr19	9698874	9898874	harbor1	chr19	9703912	9707920	LTR/ERV1	29513	+	2004	9705916	7042
chr19	9698874	9898874	harbor1	chr19	9707915	9708035	LTR/ERV1	666	+	60	9707975	9101
chr19	9698874	9898874	harbor1	chr19	9708037	9708483	LTR/ERV1	2376	+	223	9708260	9386
chr19	9698874	9898874	harbor1	chr19	9709310	9709779	LTR/ERV1	1160	+	234	9709544	10670
chr19	9698874	9898874	harbor1	chr19	9709804	9710646	LTR/ERV1	1327	+	421	9710225	11351
chr19	9698874	9898874	harbor1	chr19	9710641	9710943	LTR/ERV1	1457	+	151	9710792	11918
chr19	9698874	9898874	harbor1	chr19	9711230	9711489	LTR/ERV1	1457	+	130	9711360	12486
chr19	9698874	9898874	harbor1	chr19	9718757	9718847	LTR/ERV1	12422	+	45	9718802	19928
chr19	9698874	9898874	harbor1	chr19	9718912	9721844	LTR/ERV1	12422	+	1466	9720378	21504
chr19	9698874	9898874	harbor1	chr19	9722050	9722354	LTR/ERV1	1078	+	152	9722202	23328
chr19	9698874	9898874	harbor1	chr19	9741826	9742178	LTR/ERV1	1551	+	176	9742002	43128
chr19	9698874	9898874	harbor1	chr19	9742203	9747263	LTR/ERV1	17808	+	2530	9744733	45859
chr19	9698874	9898874	harbor1	chr19	9748660	9751420	LTR/ERV1	14673	+	1380	9750040	51166
chr19	9698874	9898874	harbor1	chr19	9751643	9751972	LTR/ERV1	1466	+	164	9751807	52933
chr19	9698874	9898874	harbor1	chr19	9798522	9798660	LTR/ERV1	3095	+	69	9798591	99717
chr19	9698874	9898874	harbor1	chr19	9797627	9798215	LTR/ERV1	3095	+	294	9797921	99047
chr19	2835774	3035774	harbor1	chr19	2861434	2861994	LTR/ERV1	6537	+	280	2861714	25940
chr19	2835774	3035774	harbor1	chr19	2862311	2863021	LTR/ERV1	6537	+	355	2862666	26892
chr19	2835774	3035774	harbor1	chr19	2863332	2863471	LTR/ERV1	6537	+	70	2863402	27628
chr19	2835774	3035774	harbor1	chr19	2864202	2864418	LTR/ERV1	1216	+	108	2864310	28536
chr19	2835774	3035774	harbor1	chr19	2865339	2865813	LTR/ERV1	3199	+	237	2865576	29802
chr19	30668622	30868622	harbor1	chr19	30756080	30756535	LTR/ERV1	1454	+	228	30756308	87686
chr19	16284182	16484182	harbor1	chr19	16307295	16307521	LTR/ERV1	1721	+	113	16307408	23226
chr19	16284182	16484182	harbor1	chr19	16307812	16307866	LTR/ERV1	1721	+	27	16307839	23657
chr19	12353663	12553663	harbor1	chr19	12359267	12359697	LTR/ERV1	1264	+	215	12359482	5819
chr19	12353663	12553663	harbor1	chr19	12359992	12360107	LTR/ERV1	1264	+	58	12360050	6387
chr19	12353663	12553663	harbor1	chr19	12364759	12365233	LTR/ERV1	1027	+	237	12364996	11333
chr19	12353663	12553663	harbor1	chr19	12366410	12366625	LTR/ERV1	3694	+	108	12366518	12855
chr19	12353663	12553663	harbor1	chr19	12366935	12367114	LTR/ERV1	3694	+	90	12367025	13362
chr19	12353663	12553663	harbor1	chr19	12368513	12368839	LTR/ERV1	3694	+	163	12368676	15013
chr19	12353663	12553663	harbor1	chr19	12400310	12400775	LTR/ERV1	876	+	232	12400542	46879
chr19	12353663	12553663	harbor1	chr19	12412655	12412757	LTR/ERV1	2453	+	51	12412706	59043
chr19	12353663	12553663	harbor1	chr19	12413072	12413465	LTR/ERV1	2453	+	196	12413268	59605
chr19	12353663	12553663	harbor1	chr19	12418791	12418967	LTR/ERV1	6210	+	88	12418879	65216
chr19	12353663	12553663	harbor1	chr19	12419267	12419514	LTR/ERV1	6210	+	124	12419391	65728
chr19	12353663	12553663	harbor1	chr19	12419819	12420932	LTR/ERV1	6210	+	556	12420375	66712
chr19	12353663	12553663	harbor1	chr19	12421237	12421276	LTR/ERV1	6210	+	20	12421257	67594
chr19	12353663	12553663	harbor1	chr19	12440152	12440636	LTR/ERV1	844	+	242	12440394	86731
chr19	34969181	35169181	harbor1	chr19	34975949	34976185	LTR/ERV1	3703	+	118	34976067	6886
chr19	34969181	35169181	harbor1	chr19	34976493	34976857	LTR/ERV1	3703	+	182	34976675	7494
chr19	39450055	39650055	harbor1	chr19	39493404	39493821	LTR/ERV1	2601	+	208	39493612	43557
chr19	39450055	39650055	harbor1	chr19	39546714	39547161	LTR/ERV1	2060	+	224	39546938	96883
chr19	57637711	57837711	harbor1	chr19	57651646	57653192	LTR/ERV1	4976	+	773	57652419	14708
chr19	57637711	57837711	harbor1	chr19	57696926	57697258	LTR/ERV1	1716	+	166	57697092	59381
chr19	57637711	57837711	harbor1	chr19	57714962	57715157	LTR/ERV1	3189	+	98	57715060	77349
chr19	57637711	57837711	harbor1	chr19	57715489	57715811	LTR/ERV1	3189	+	161	57715650	77939
chr19	57637711	57837711	harbor1	chr19	57653419	57656645	LTR/ERV1	16815	+	1613	57655032	17321
chr19	35327531	35527531	harbor1	chr19	35376179	35376584	LTR/ERV1	1887	+	202	35376381	48850
chr19	35327531	35527531	harbor1	chr19	35376900	35376975	LTR/ERV1	1887	+	38	35376938	49407
chr19	35327531	35527531	harbor1	chr19	35382450	35382947	LTR/ERV1	4161	+	248	35382698	55167
chr19	35327531	35527531	harbor1	chr19	35388427	35389187	LTR/ERV1	4980	+	380	35388807	61276
chr19	35327531	35527531	harbor1	chr19	35398868	35398884	LTR/ERV1	5326	+	8	35398876	71345
chr19	35327531	35527531	harbor1	chr19	35399185	35399804	LTR/ERV1	5326	+	310	35399495	71964
chr19	35327531	35527531	harbor1	chr19	35400105	35400351	LTR/ERV1	5326	+	123	35400228	72697
chr19	35327531	35527531	harbor1	chr19	35426735	35426962	LTR/ERV1	1839	+	114	35426849	99318
chr19	35327531	35527531	harbor1	chr19	35427256	35427653	LTR/ERV1	1839	+	198	35427454	99923
chr19	49704599	49904599	harbor1	chr19	49718672	49718801	LTR/ERV1	1603	+	64	49718736	14137
chr19	49704599	49904599	harbor1	chr19	49719110	49719414	LTR/ERV1	1603	+	152	49719262	14663
chr19	49704599	49904599	harbor1	chr19	49720688	49720863	LTR/ERV1	654	+	88	49720776	16177
chr19	49704599	49904599	harbor1	chr19	49722055	49722327	LTR/ERV1	1301	+	136	49722191	17592
chr19	49704599	49904599	harbor1	chr19	49724251	49724442	LTR/ERV1	911	+	96	49724347	19748
chr19	49704599	49904599	harbor1	chr19	49727163	49727741	LTR/ERV1	3887	+	289	49727452	22853
chr19	49704599	49904599	harbor1	chr19	49727742	49728063	LTR/ERV1	2039	+	160	49727902	23303
chr19	49704599	49904599	harbor1	chr19	49728379	49728810	LTR/ERV1	1746	+	216	49728595	23996
chr19	16466261	16666261	harbor1	chr19	16473001	16473122	LTR/ERV1	750	+	60	16473061	6800
chr19	16466261	16666261	harbor1	chr19	16474915	16475455	LTR/ERV1	1604	+	270	16475185	8924
chr19	16466261	16666261	harbor1	chr19	16493068	16493541	LTR/ERV1	2547	+	236	16493304	27043
chr19	46266753	46466753	harbor1	chr19	46272654	46272753	LTR/ERV1	1068	+	50	46272704	5951
chr19	46266753	46466753	harbor1	chr19	46273066	46273186	LTR/ERV1	1068	+	60	46273126	6373
chr19	46266753	46466753	harbor1	chr19	46278853	46279137	LTR/ERV1	1524	+	142	46278995	12242
chr19	46266753	46466753	harbor1	chr19	46338948	46339449	LTR/ERV1	3735	+	250	46339198	72445
chr19	28061962	28261962	harbor1	chr19	28068296	28068816	LTR/ERV1	1515	+	260	28068556	6594
chr19	28061962	28261962	harbor1	chr19	28068816	28069565	LTR/ERV1	4308	+	374	28069190	7228
chr19	28061962	28261962	harbor1	chr19	28069878	28070626	LTR/ERV1	4308	+	374	28070252	8290
chr19	28061962	28261962	harbor1	chr19	28070627	28070830	LTR/ERV1	816	+	102	28070729	8767
chr19	28061962	28261962	harbor1	chr19	28071134	28071575	LTR/ERV1	1484	+	220	28071354	9392
chr19	28061962	28261962	harbor1	chr19	28078404	28078880	LTR/ERV1	1696	+	238	28078642	16680
chr19	28061962	28261962	harbor1	chr19	28093627	28094502	LTR/ERV1	4995	+	438	28094065	32103
chr19	28061962	28261962	harbor1	chr19	28118147	28118443	LTR/ERV1	1212	+	148	28118295	56333
chr19	28061962	28261962	harbor1	chr19	28140298	28140744	LTR/ERV1	2601	+	223	28140521	78559
chr19	28061962	28261962	harbor1	chr19	28098328	28098764	LTR/ERV1	2302	+	218	28098546	36584
chr19	3139123	3339123	harbor1	chr19	3153003	3153196	LTR/ERV1	1410	+	96	3153099	13976
chr19	12791455	12991455	harbor1	chr19	12882804	12882934	LTR/ERV1	3404	+	65	12882869	91414
chr19	12791455	12991455	harbor1	chr19	12883256	12883427	LTR/ERV1	3404	+	86	12883342	91887
chr19	12791455	12991455	harbor1	chr19	12883725	12884154	LTR/ERV1	3404	+	214	12883939	92484
chr19	41830227	42030227	harbor1	chr19	41858027	41858412	LTR/ERV1	1514	+	192	41858219	27992
chr19	57094178	57294178	harbor1	chr19	57118404	57118959	LTR/ERV1	3479	+	278	57118682	24504
chr19	57094178	57294178	harbor1	chr19	57141445	57141481	LTR/ERV1	1803	+	18	57141463	47285
chr19	57094178	57294178	harbor1	chr19	57141518	57141617	LTR/ERV1	1803	+	50	57141568	47390
chr19	57094178	57294178	harbor1	chr19	57141864	57142137	LTR/ERV1	1803	+	136	57142000	47822
chr19	57094178	57294178	harbor1	chr19	57172534	57172693	LTR/ERV1	1067	+	80	57172614	78436
chr19	57094178	57294178	harbor1	chr19	57172998	57173036	LTR/ERV1	1067	+	19	57173017	78839
chr19	57094178	57294178	harbor1	chr19	57181546	57181759	LTR/ERV1	4102	+	106	57181652	87474
chr19	57094178	57294178	harbor1	chr19	57182059	57182439	LTR/ERV1	4102	+	190	57182249	88071
chr19	57094178	57294178	harbor1	chr19	57187710	57187815	LTR/ERV1	726	+	52	57187762	93584
chr19	57094178	57294178	harbor1	chr19	57187817	57188147	LTR/ERV1	1898	+	165	57187982	93804
chr19	57094178	57294178	harbor1	chr19	57188349	57188639	LTR/ERV1	1333	+	145	57188494	94316
chr19	57094178	57294178	harbor1	chr19	57188802	57188920	LTR/ERV1	3128	+	59	57188861	94683
chr19	57094178	57294178	harbor1	chr19	57189229	57189661	LTR/ERV1	3128	+	216	57189445	95267
chr19	57094178	57294178	harbor1	chr19	57189954	57190017	LTR/ERV1	3128	+	32	57189986	95808
chr19	57094178	57294178	harbor1	chr19	57190020	57190109	LTR/ERV1	666	+	44	57190064	95886
chr19	57094178	57294178	harbor1	chr19	57190110	57190615	LTR/ERV1	2897	+	252	57190362	96184
chr19	48306766	48506766	harbor1	chr19	48308622	48309692	LTR/ERV1	5066	+	535	48309157	2391
chr19	3211739	3411739	harbor1	chr19	3265564	3265794	LTR/ERV1	1295	+	115	3265679	53940
chr19	8218226	8418226	harbor1	chr19	8269895	8270163	LTR/ERV1	1186	+	134	8270029	51803
chr19	51448746	51648746	harbor1	chr19	51547800	51548367	LTR/ERV1	3777	+	284	51548084	99338
chr19	31793585	31993585	harbor1	chr19	31803842	31804441	LTR/ERV1	4301	+	300	31804142	10557
chr19	41614482	41814482	harbor1	chr19	41639975	41640224	LTR/ERV1	1063	+	124	41640099	25617
chr19	28103113	28303113	harbor1	chr19	28118147	28118443	LTR/ERV1	1212	+	148	28118295	15182
chr19	28103113	28303113	harbor1	chr19	28140298	28140744	LTR/ERV1	2601	+	223	28140521	37408
chr19	28103113	28303113	harbor1	chr19	28176176	28176314	LTR/ERV1	745	+	69	28176245	73132
chr19	28103113	28303113	harbor1	chr19	28176808	28177232	LTR/ERV1	1324	+	212	28177020	73907
chr19	28103113	28303113	harbor1	chr19	28183932	28184835	LTR/ERV1	5021	+	452	28184384	81271
chr19	28103113	28303113	harbor1	chr19	28190784	28191210	LTR/ERV1	4824	+	213	28190997	87884
chr19	28103113	28303113	harbor1	chr19	28191493	28191603	LTR/ERV1	4824	+	55	28191548	88435
chr19	28103113	28303113	harbor1	chr19	28192106	28192432	LTR/ERV1	4824	+	163	28192269	89156
chr19	28103113	28303113	harbor1	chr19	28192921	28193398	LTR/ERV1	3291	+	238	28193159	90046
chr19	51429608	51629608	harbor1	chr19	51441614	51442180	LTR/ERV1	3028	+	283	51441897	12289
chr19	47378038	47578038	harbor1	chr19	47384144	47384310	LTR/ERV1	1006	+	83	47384227	6189
chr19	47378038	47578038	harbor1	chr19	47392829	47393269	LTR/ERV1	3245	+	220	47393049	15011
chr19	47378038	47578038	harbor1	chr19	47393272	47397073	LTR/ERV1	8376	+	1900	47395172	17134
chr19	47378038	47578038	harbor1	chr19	47397076	47397719	LTR/ERV1	3955	+	322	47397398	19360
chr19	47378038	47578038	harbor1	chr19	47397721	47397937	LTR/ERV1	1247	+	108	47397829	19791
chr19	47378038	47578038	harbor1	chr19	47397936	47398315	LTR/ERV1	2183	+	190	47398126	20088
chr19	47378038	47578038	harbor1	chr19	47398316	47398756	LTR/ERV1	3209	+	220	47398536	20498
chr19	7419033	7619033	harbor1	chr19	7489637	7489849	LTR/ERV1	1034	+	106	7489743	70710
chr19	7419033	7619033	harbor1	chr19	7494663	7494972	LTR/ERV1	1506	+	154	7494817	75784
chr19	39928904	40128904	harbor1	chr19	39942040	39942513	LTR/ERV1	3235	+	236	39942276	13372
chr19	39928904	40128904	harbor1	chr19	39958057	39958404	LTR/ERV1	2869	+	174	39958231	29327
chr19	39928904	40128904	harbor1	chr19	39958975	39959078	LTR/ERV1	821	+	52	39959027	30123
chr19	39928904	40128904	harbor1	chr19	39966744	39966938	LTR/ERV1	786	+	97	39966841	37937
chr19	39928904	40128904	harbor1	chr19	39968477	39969195	LTR/ERV1	4784	+	359	39968836	39932
chr19	22172436	22372436	harbor1	chr19	22210577	22211085	LTR/ERV1	1111	+	254	22210831	38395
chr19	22172436	22372436	harbor1	chr19	22214197	22214332	LTR/ERV1	2607	+	68	22214265	41829
chr19	22172436	22372436	harbor1	chr19	22214619	22214757	LTR/ERV1	2607	+	69	22214688	42252
chr19	22172436	22372436	harbor1	chr19	22215071	22215294	LTR/ERV1	2607	+	112	22215183	42747
chr19	22172436	22372436	harbor1	chr19	22247028	22247281	LTR/ERV1	1477	+	126	22247154	74718
chr19	22172436	22372436	harbor1	chr19	22247578	22247625	LTR/ERV1	1477	+	24	22247602	75166
chr19	22172436	22372436	harbor1	chr19	22247754	22247859	LTR/ERV1	687	+	52	22247806	75370
chr19	22172436	22372436	harbor1	chr19	22248500	22248713	LTR/ERV1	1266	+	106	22248606	76170
chr19	22172436	22372436	harbor1	chr19	22249030	22249401	LTR/ERV1	3199	+	186	22249216	76780
chr19	22172436	22372436	harbor1	chr19	22249712	22249901	LTR/ERV1	3199	+	94	22249806	77370
chr19	22172436	22372436	harbor1	chr19	22250203	22250410	LTR/ERV1	3199	+	104	22250307	77871
chr19	22172436	22372436	harbor1	chr19	22250639	22250711	LTR/ERV1	4965	+	36	22250675	78239
chr19	22172436	22372436	harbor1	chr19	22251012	22251509	LTR/ERV1	4965	+	248	22251260	78824
chr19	22172436	22372436	harbor1	chr19	22251805	22252110	LTR/ERV1	4965	+	152	22251957	79521
chr19	22172436	22372436	harbor1	chr19	22261072	22261363	LTR/ERV1	1655	+	146	22261218	88782
chr19	12353459	12553459	harbor1	chr19	12359267	12359697	LTR/ERV1	1264	+	215	12359482	6023
chr19	12353459	12553459	harbor1	chr19	12359992	12360107	LTR/ERV1	1264	+	58	12360050	6591
chr19	12353459	12553459	harbor1	chr19	12364759	12365233	LTR/ERV1	1027	+	237	12364996	11537
chr19	12353459	12553459	harbor1	chr19	12366410	12366625	LTR/ERV1	3694	+	108	12366518	13059
chr19	12353459	12553459	harbor1	chr19	12366935	12367114	LTR/ERV1	3694	+	90	12367025	13566
chr19	12353459	12553459	harbor1	chr19	12368513	12368839	LTR/ERV1	3694	+	163	12368676	15217
chr19	12353459	12553459	harbor1	chr19	12400310	12400775	LTR/ERV1	876	+	232	12400542	47083
chr19	12353459	12553459	harbor1	chr19	12412655	12412757	LTR/ERV1	2453	+	51	12412706	59247
chr19	12353459	12553459	harbor1	chr19	12413072	12413465	LTR/ERV1	2453	+	196	12413268	59809
chr19	12353459	12553459	harbor1	chr19	12418791	12418967	LTR/ERV1	6210	+	88	12418879	65420
chr19	12353459	12553459	harbor1	chr19	12419267	12419514	LTR/ERV1	6210	+	124	12419391	65932
chr19	12353459	12553459	harbor1	chr19	12419819	12420932	LTR/ERV1	6210	+	556	12420375	66916
chr19	12353459	12553459	harbor1	chr19	12421237	12421276	LTR/ERV1	6210	+	20	12421257	67798
chr19	12353459	12553459	harbor1	chr19	12440152	12440636	LTR/ERV1	844	+	242	12440394	86935
chr19	12262919	12462919	harbor1	chr19	12282363	12282418	LTR/ERV1	2327	+	28	12282391	19472
chr19	12262919	12462919	harbor1	chr19	12282722	12283157	LTR/ERV1	2327	+	218	12282940	20021
chr19	12262919	12462919	harbor1	chr19	12288903	12289022	LTR/ERV1	1142	+	60	12288963	26044
chr19	12262919	12462919	harbor1	chr19	12289336	12289640	LTR/ERV1	1142	+	152	12289488	26569
chr19	12262919	12462919	harbor1	chr19	12289931	12289970	LTR/ERV1	1142	+	20	12289951	27032
chr19	12262919	12462919	harbor1	chr19	12293900	12294377	LTR/ERV1	990	+	238	12294138	31219
chr19	12262919	12462919	harbor1	chr19	12295710	12296164	LTR/ERV1	3236	+	227	12295937	33018
chr19	12262919	12462919	harbor1	chr19	12332580	12332937	LTR/ERV1	912	+	178	12332758	69839
chr19	12262919	12462919	harbor1	chr19	12335128	12335439	LTR/ERV1	1554	+	156	12335284	72365
chr19	12262919	12462919	harbor1	chr19	12335642	12336003	LTR/ERV1	2253	+	180	12335822	72903
chr19	12262919	12462919	harbor1	chr19	12359267	12359697	LTR/ERV1	1264	+	215	12359482	96563
chr19	12262919	12462919	harbor1	chr19	12359992	12360107	LTR/ERV1	1264	+	58	12360050	97131
chr19	36405428	36605428	harbor1	chr19	36429282	36429465	LTR/ERV1	2700	+	92	36429374	23946
chr19	36405428	36605428	harbor1	chr19	36429752	36429972	LTR/ERV1	2700	+	110	36429862	24434
chr19	36405428	36605428	harbor1	chr19	36430279	36430333	LTR/ERV1	2700	+	27	36430306	24878
chr19	36405428	36605428	harbor1	chr19	36436486	36436832	LTR/ERV1	1729	+	173	36436659	31231
chr19	36405428	36605428	harbor1	chr19	36437441	36437634	LTR/ERV1	1729	+	96	36437537	32109
chr19	17339965	17539965	harbor1	chr19	17415140	17415773	LTR/ERV1	2323	+	316	17415456	75491
chr19	17339965	17539965	harbor1	chr19	17415918	17416090	LTR/ERV1	749	+	86	17416004	76039
chr19	17339965	17539965	harbor1	chr19	17418829	17419385	LTR/ERV1	2596	+	278	17419107	79142
chr19	40021517	40221517	harbor1	chr19	40071941	40072014	LTR/ERV1	650	+	36	40071977	50460
chr19	40021517	40221517	harbor1	chr19	40072037	40072328	LTR/ERV1	2312	+	146	40072183	50666
chr19	40021517	40221517	harbor1	chr19	40072329	40072654	LTR/ERV1	2573	+	162	40072491	50974
chr19	58367439	58567439	harbor1	chr19	58460025	58460629	LTR/ERV1	1012	+	302	58460327	92888
chr19	58367439	58567439	harbor1	chr19	58460626	58460686	LTR/ERV1	3219	+	30	58460656	93217
chr19	58367439	58567439	harbor1	chr19	58460987	58461867	LTR/ERV1	3219	+	440	58461427	93988
chr19	58367439	58567439	harbor1	chr19	58462175	58462224	LTR/ERV1	3219	+	24	58462199	94760
chr19	9176991	9376991	harbor1	chr19	9189130	9189706	LTR/ERV1	3636	+	288	9189418	12427
chr19	9176991	9376991	harbor1	chr19	9231970	9232257	LTR/ERV1	3066	+	144	9232114	55123
chr19	9176991	9376991	harbor1	chr19	9232561	9232838	LTR/ERV1	3066	+	138	9232699	55708
chr19	9176991	9376991	harbor1	chr19	9254628	9254661	LTR/ERV1	1979	+	16	9254644	77653
chr19	9176991	9376991	harbor1	chr19	9254963	9255308	LTR/ERV1	1979	+	172	9255135	78144
chr19	9176991	9376991	harbor1	chr19	9255633	9255675	LTR/ERV1	1979	+	21	9255654	78663
chr19	9176991	9376991	harbor1	chr19	9259330	9260568	LTR/ERV1	8013	+	619	9259949	82958
chr19	9176991	9376991	harbor1	chr19	9270414	9271543	LTR/ERV1	5633	+	564	9270978	93987
chr19	54275525	54475525	harbor1	chr19	54316849	54317278	LTR/ERV1	2154	+	214	54317063	41538
chr19	54275525	54475525	harbor1	chr19	54317577	54317651	LTR/ERV1	2154	+	37	54317614	42089
chr19	54275525	54475525	harbor1	chr19	54317652	54318217	LTR/ERV1	1267	+	282	54317934	42409
chr19	54275525	54475525	harbor1	chr19	54351902	54352083	LTR/ERV1	708	+	90	54351992	76467
chr19	49506855	49706855	harbor1	chr19	49579292	49579734	LTR/ERV1	2218	+	221	49579513	72658
chr19	57576147	57776147	harbor1	chr19	57624309	57624831	LTR/ERV1	1548	+	261	57624570	48423
chr19	57576147	57776147	harbor1	chr19	57651646	57653192	LTR/ERV1	4976	+	773	57652419	76272
chr19	57576147	57776147	harbor1	chr19	57653419	57656645	LTR/ERV1	16815	+	1613	57655032	78885
chr19	7459237	7659237	harbor1	chr19	7489637	7489849	LTR/ERV1	1034	+	106	7489743	30506
chr19	7459237	7659237	harbor1	chr19	7494663	7494972	LTR/ERV1	1506	+	154	7494817	35580
chr19	14235230	14435230	harbor1	chr19	14268267	14268369	LTR/ERV1	1991	+	51	14268318	33088
chr19	14235230	14435230	harbor1	chr19	14268657	14269180	LTR/ERV1	1991	+	262	14268919	33689
chr19	14235230	14435230	harbor1	chr19	14275958	14276392	LTR/ERV1	2510	+	217	14276175	40945
chr19	14235230	14435230	harbor1	chr19	14277452	14278954	LTR/ERV1	10213	+	751	14278203	42973
chr19	14235230	14435230	harbor1	chr19	14284314	14284456	LTR/ERV1	2640	+	71	14284385	49155
chr19	14235230	14435230	harbor1	chr19	14284758	14284808	LTR/ERV1	2640	+	25	14284783	49553
chr19	14235230	14435230	harbor1	chr19	14285108	14285395	LTR/ERV1	2640	+	144	14285252	50022
chr19	14235230	14435230	harbor1	chr19	14285706	14285844	LTR/ERV1	2640	+	69	14285775	50545
chr19	14235230	14435230	harbor1	chr19	14300047	14300105	LTR/ERV1	1946	+	29	14300076	64846
chr19	14235230	14435230	harbor1	chr19	14300406	14300418	LTR/ERV1	1946	+	6	14300412	65182
chr19	14235230	14435230	harbor1	chr19	14300461	14300800	LTR/ERV1	1946	+	170	14300631	65401
chr19	14235230	14435230	harbor1	chr19	14301398	14301433	LTR/ERV1	1946	+	18	14301416	66186
chr19	7480458	7680458	harbor1	chr19	7489637	7489849	LTR/ERV1	1034	+	106	7489743	9285
chr19	7480458	7680458	harbor1	chr19	7494663	7494972	LTR/ERV1	1506	+	154	7494817	14359
chr19	34610698	34810698	harbor1	chr19	34637742	34638149	LTR/ERV1	1032	+	204	34637946	27248
chr19	34610698	34810698	harbor1	chr19	34638533	34639079	LTR/ERV1	1878	+	273	34638806	28108
chr19	34610698	34810698	harbor1	chr19	34641139	34641480	LTR/ERV1	916	+	170	34641309	30611
chr19	34610698	34810698	harbor1	chr19	34641877	34642006	LTR/ERV1	775	+	64	34641941	31243
chr19	34610698	34810698	harbor1	chr19	34642009	34642184	LTR/ERV1	950	+	88	34642097	31399
chr19	34610698	34810698	harbor1	chr19	34654506	34654961	LTR/ERV1	2054	+	228	34654734	44036
chr19	34610698	34810698	harbor1	chr19	34655092	34655711	LTR/ERV1	4059	+	310	34655402	44704
chr19	34610698	34810698	harbor1	chr19	34667499	34667760	LTR/ERV1	1761	+	130	34667629	56931
chr19	34610698	34810698	harbor1	chr19	34675409	34675656	LTR/ERV1	3588	+	124	34675533	64835
chr19	34610698	34810698	harbor1	chr19	34676297	34676685	LTR/ERV1	3588	+	194	34676491	65793
chr19	34610698	34810698	harbor1	chr19	34680680	34681063	LTR/ERV1	1675	+	192	34680872	70174
chr19	34610698	34810698	harbor1	chr19	34668011	34669231	LTR/ERV1	8236	+	610	34668621	57923
chr19	22346484	22546484	harbor1	chr19	22418419	22418596	LTR/ERV1	932	+	88	22418507	72023
chr19	22346484	22546484	harbor1	chr19	22418887	22419196	LTR/ERV1	932	+	154	22419041	72557
chr19	22346484	22546484	harbor1	chr19	22421372	22421826	LTR/ERV1	2352	+	227	22421599	75115
chr19	22346484	22546484	harbor1	chr19	22425403	22425703	LTR/ERV1	912	+	150	22425553	79069
chr19	22346484	22546484	harbor1	chr19	22434168	22434355	LTR/ERV1	8376	+	94	22434262	87778
chr19	22346484	22546484	harbor1	chr19	22434659	22435902	LTR/ERV1	8376	+	622	22435281	88797
chr19	22346484	22546484	harbor1	chr19	22436190	22436277	LTR/ERV1	8376	+	44	22436234	89750
chr19	22346484	22546484	harbor1	chr19	22436679	22436689	LTR/ERV1	8376	+	5	22436684	90200
chr19	22346484	22546484	harbor1	chr19	22436988	22437290	LTR/ERV1	8376	+	151	22437139	90655
chr19	22346484	22546484	harbor1	chr19	22437777	22438498	LTR/ERV1	6644	+	360	22438137	91653
chr19	22346484	22546484	harbor1	chr19	22438799	22439108	LTR/ERV1	6644	+	154	22438953	92469
chr19	22346484	22546484	harbor1	chr19	22439396	22439617	LTR/ERV1	6644	+	110	22439506	93022
chr19	22346484	22546484	harbor1	chr19	22439928	22440007	LTR/ERV1	6644	+	40	22439968	93484
chr19	22346484	22546484	harbor1	chr19	22440304	22440351	LTR/ERV1	6644	+	24	22440328	93844
chr19	32092140	32292140	harbor1	chr19	32099290	32099349	LTR/ERV1	2249	+	30	32099320	7180
chr19	32092140	32292140	harbor1	chr19	32099917	32100279	LTR/ERV1	2249	+	181	32100098	7958
chr19	49907208	50107208	harbor1	chr19	49936038	49936112	LTR/ERV1	667	+	37	49936075	28867
chr19	49907208	50107208	harbor1	chr19	49936246	49936674	LTR/ERV1	1659	+	214	49936460	29252
chr19	49907208	50107208	harbor1	chr19	49936904	49937023	LTR/ERV1	1659	+	60	49936964	29756
chr19	49907208	50107208	harbor1	chr19	49952495	49953047	LTR/ERV1	4074	+	276	49952771	45563
chr19	49907208	50107208	harbor1	chr19	49956030	49957315	LTR/ERV1	6537	+	642	49956672	49464
chr19	49907208	50107208	harbor1	chr19	49957318	49957720	LTR/ERV1	3224	+	201	49957519	50311
chr19	49907208	50107208	harbor1	chr19	49958018	49958143	LTR/ERV1	3224	+	62	49958080	50872
chr19	49907208	50107208	harbor1	chr19	49975426	49975845	LTR/ERV1	2844	+	210	49975636	68428
chr19	49907208	50107208	harbor1	chr19	49953048	49955205	LTR/ERV1	8069	+	1078	49954126	46918
chr19	23162505	23362505	harbor1	chr19	23169122	23169168	LTR/ERV1	12595	+	23	23169145	6640
chr19	23162505	23362505	harbor1	chr19	23169466	23170520	LTR/ERV1	12595	+	527	23169993	7488
chr19	23162505	23362505	harbor1	chr19	23170521	23171118	LTR/ERV1	4152	+	298	23170819	8314
chr19	23162505	23362505	harbor1	chr19	23171119	23171150	LTR/ERV1	12595	+	16	23171135	8630
chr19	23162505	23362505	harbor1	chr19	23171439	23172048	LTR/ERV1	12595	+	304	23171743	9238
chr19	23162505	23362505	harbor1	chr19	23172049	23172493	LTR/ERV1	3031	+	222	23172271	9766
chr19	23162505	23362505	harbor1	chr19	23174098	23174207	LTR/ERV1	10393	+	54	23174152	11647
chr19	23162505	23362505	harbor1	chr19	23174511	23174946	LTR/ERV1	10393	+	218	23174729	12224
chr19	23162505	23362505	harbor1	chr19	23175233	23176858	LTR/ERV1	10393	+	812	23176045	13540
chr19	23162505	23362505	harbor1	chr19	23176980	23177389	LTR/ERV1	2583	+	204	23177184	14679
chr19	23162505	23362505	harbor1	chr19	23177390	23177823	LTR/ERV1	1954	+	216	23177606	15101
chr19	23162505	23362505	harbor1	chr19	23178790	23179743	LTR/ERV1	3914	+	476	23179266	16761
chr19	23162505	23362505	harbor1	chr19	23186832	23188026	LTR/ERV1	4476	+	597	23187429	24924
chr19	23162505	23362505	harbor1	chr19	23200237	23200696	LTR/ERV1	4135	+	230	23200467	37962
chr19	23162505	23362505	harbor1	chr19	23205914	23206398	LTR/ERV1	3384	+	242	23206156	43651
chr19	23162505	23362505	harbor1	chr19	23206711	23206842	LTR/ERV1	3384	+	66	23206777	44272
chr19	23162505	23362505	harbor1	chr19	23240331	23240629	LTR/ERV1	1249	+	149	23240480	77975
chr19	23162505	23362505	harbor1	chr19	23245010	23245332	LTR/ERV1	996	+	161	23245171	82666
chr19	23162505	23362505	harbor1	chr19	23245628	23245794	LTR/ERV1	996	+	83	23245711	83206
chr19	23162505	23362505	harbor1	chr19	23248436	23248712	LTR/ERV1	2212	+	138	23248574	86069
chr19	23162505	23362505	harbor1	chr19	23249016	23249241	LTR/ERV1	2212	+	112	23249128	86623
chr19	23162505	23362505	harbor1	chr19	23249834	23249884	LTR/ERV1	2212	+	25	23249859	87354
chr19	23162505	23362505	harbor1	chr19	23252887	23252979	LTR/ERV1	738	+	46	23252933	90428
chr19	23162505	23362505	harbor1	chr19	23253263	23253288	LTR/ERV1	738	+	12	23253275	90770
chr19	23162505	23362505	harbor1	chr19	23253581	23253738	LTR/ERV1	738	+	78	23253659	91154
chr19	18425801	18625801	harbor1	chr19	18439406	18439848	LTR/ERV1	723	+	221	18439627	13826
chr19	5528359	5728359	harbor1	chr19	5548576	5549016	LTR/ERV1	3815	+	220	5548796	20437
chr19	5528359	5728359	harbor1	chr19	5549017	5551892	LTR/ERV1	15423	+	1438	5550455	22096
chr19	5528359	5728359	harbor1	chr19	5551872	5552016	LTR/ERV1	835	+	72	5551944	23585
chr19	5528359	5728359	harbor1	chr19	5552007	5552168	LTR/ERV1	1037	+	80	5552087	23728
chr19	5528359	5728359	harbor1	chr19	5552161	5552771	LTR/ERV1	4429	+	305	5552466	24107
chr19	5528359	5728359	harbor1	chr19	5552772	5553212	LTR/ERV1	3809	+	220	5552992	24633
chr19	35824158	36024158	harbor1	chr19	35881206	35881656	LTR/ERV1	3329	+	225	35881431	57273
chr19	35824158	36024158	harbor1	chr19	35910696	35910855	LTR/ERV1	773	+	80	35910776	86618
chr19	20886452	21086452	harbor1	chr19	20916370	20917391	LTR/ERV1	7852	+	510	20916880	30428
chr19	20886452	21086452	harbor1	chr19	20917728	20918331	LTR/ERV1	7852	+	302	20918030	31578
chr19	20886452	21086452	harbor1	chr19	20918641	20918722	LTR/ERV1	7852	+	40	20918681	32229
chr19	20886452	21086452	harbor1	chr19	20918733	20919132	LTR/ERV1	1730	+	200	20918933	32481
chr19	44308673	44508673	harbor1	chr19	44369282	44370004	LTR/ERV1	3892	+	361	44369643	60970
chr19	44308673	44508673	harbor1	chr19	44375612	44375893	LTR/ERV1	938	+	140	44375752	67079
chr19	24149632	24349632	harbor1	chr19	24153707	24153990	LTR/ERV1	1180	+	142	24153849	4217
chr19	27758122	27958122	harbor1	chr19	27823712	27824159	LTR/ERV1	875	+	224	27823936	65814
chr19	27758122	27958122	harbor1	chr19	27840872	27840981	LTR/ERV1	2810	+	54	27840926	82804
chr19	27758122	27958122	harbor1	chr19	27841275	27841619	LTR/ERV1	2810	+	172	27841447	83325
chr19	32463962	32663962	harbor1	chr19	32487171	32487809	LTR/ERV1	4241	+	319	32487490	23528
chr19	32463962	32663962	harbor1	chr19	32498291	32498826	LTR/ERV1	2823	+	268	32498559	34597
chr19	32463962	32663962	harbor1	chr19	32532240	32532481	LTR/ERV1	659	+	120	32532360	68398
chr19	32463962	32663962	harbor1	chr19	32558683	32559148	LTR/ERV1	2043	+	232	32558915	94953
chr19	48730331	48930331	harbor1	chr19	48810167	48810574	LTR/ERV1	1554	+	204	48810371	80040
chr19	48042049	48242049	harbor1	chr19	48063621	48063852	LTR/ERV1	1563	+	116	48063737	21688
chr19	48042049	48242049	harbor1	chr19	48064715	48064735	LTR/ERV1	1563	+	10	48064725	22676
chr19	48042049	48242049	harbor1	chr19	48140323	48141025	LTR/ERV1	3137	+	351	48140674	98625
chr19	52711399	52911399	harbor1	chr19	52716601	52716780	LTR/ERV1	2192	+	90	52716691	5292
chr19	52711399	52911399	harbor1	chr19	52717050	52717293	LTR/ERV1	2192	+	122	52717172	5773
chr19	52711399	52911399	harbor1	chr19	52735281	52735746	LTR/ERV1	3658	+	232	52735513	24114
chr19	52711399	52911399	harbor1	chr19	52743399	52743580	LTR/ERV1	2765	+	90	52743489	32090
chr19	52711399	52911399	harbor1	chr19	52743869	52744169	LTR/ERV1	2765	+	150	52744019	32620
chr19	52711399	52911399	harbor1	chr19	52755542	52755871	LTR/ERV1	2193	+	164	52755706	44307
chr19	52711399	52911399	harbor1	chr19	52755876	52756088	LTR/ERV1	1306	+	106	52755982	44583
chr19	52711399	52911399	harbor1	chr19	52756089	52756464	LTR/ERV1	2475	+	188	52756277	44878
chr19	52711399	52911399	harbor1	chr19	52779588	52779767	LTR/ERV1	2283	+	90	52779678	68279
chr19	52711399	52911399	harbor1	chr19	52780029	52780276	LTR/ERV1	2283	+	124	52780153	68754
chr19	52711399	52911399	harbor1	chr19	52792267	52792439	LTR/ERV1	1078	+	86	52792353	80954
chr19	52711399	52911399	harbor1	chr19	52792572	52792688	LTR/ERV1	715	+	58	52792630	81231
chr19	52711399	52911399	harbor1	chr19	52793181	52793368	LTR/ERV1	1203	+	94	52793275	81876
chr19	52711399	52911399	harbor1	chr19	52756465	52756855	LTR/ERV1	2073	+	195	52756660	45261
chr19	29164714	29364714	harbor1	chr19	29221029	29221515	LTR/ERV1	1730	+	243	29221272	56558
chr19	5576792	5776792	harbor1	chr19	5675497	5675810	LTR/ERV1	1837	+	156	5675653	98861
chr19	58472624	58672624	harbor1	chr19	58488940	58489636	LTR/ERV1	5160	+	348	58489288	16664
chr19	58472624	58672624	harbor1	chr19	58528021	58528377	LTR/ERV1	2543	+	178	58528199	55575
chr19	36137360	36337360	harbor1	chr19	36166338	36166399	LTR/ERV1	1904	+	30	36166368	29008
chr19	36137360	36337360	harbor1	chr19	36166716	36167006	LTR/ERV1	2176	+	145	36166861	29501
chr19	4160444	4360444	harbor1	chr19	4246208	4246484	LTR/ERV1	2027	+	138	4246346	85902
chr19	37681819	37881819	harbor1	chr19	37687834	37687958	LTR/ERV1	715	+	62	37687896	6077
chr19	37681819	37881819	harbor1	chr19	37701253	37701730	LTR/ERV1	3312	+	238	37701491	19672
chr19	37681819	37881819	harbor1	chr19	37718571	37719001	LTR/ERV1	2037	+	215	37718786	36967
chr19	37681819	37881819	harbor1	chr19	37756047	37756780	LTR/ERV1	1148	+	366	37756413	74594
chr19	37681819	37881819	harbor1	chr19	37761313	37761953	LTR/ERV1	3960	+	320	37761633	79814
chr19	37681819	37881819	harbor1	chr19	37766321	37766748	LTR/ERV1	1207	+	214	37766535	84716
chr19	37681819	37881819	harbor1	chr19	37766856	37767233	LTR/ERV1	2338	+	188	37767044	85225
chr19	37681819	37881819	harbor1	chr19	37767532	37767687	LTR/ERV1	2338	+	78	37767610	85791
chr19	16396516	16596516	harbor1	chr19	16473001	16473122	LTR/ERV1	750	+	60	16473061	76545
chr19	16396516	16596516	harbor1	chr19	16474915	16475455	LTR/ERV1	1604	+	270	16475185	78669
chr19	16396516	16596516	harbor1	chr19	16493068	16493541	LTR/ERV1	2547	+	236	16493304	96788
chr19	32319604	32519604	harbor1	chr19	32392867	32393645	LTR/ERV1	4338	+	389	32393256	73652
chr19	1408901	1608901	harbor1	chr19	1442428	1442896	LTR/ERV1	3133	+	234	1442662	33761
chr19	34655958	34855958	harbor1	chr19	34667499	34667760	LTR/ERV1	1761	+	130	34667629	11671
chr19	34655958	34855958	harbor1	chr19	34675409	34675656	LTR/ERV1	3588	+	124	34675533	19575
chr19	34655958	34855958	harbor1	chr19	34676297	34676685	LTR/ERV1	3588	+	194	34676491	20533
chr19	34655958	34855958	harbor1	chr19	34680680	34681063	LTR/ERV1	1675	+	192	34680872	24914
chr19	34655958	34855958	harbor1	chr19	34711195	34711494	LTR/ERV1	1762	+	150	34711345	55387
chr19	34655958	34855958	harbor1	chr19	34711792	34712390	LTR/ERV1	3845	+	299	34712091	56133
chr19	34655958	34855958	harbor1	chr19	34712488	34712828	LTR/ERV1	1458	+	170	34712658	56700
chr19	34655958	34855958	harbor1	chr19	34712819	34713511	LTR/ERV1	3215	+	346	34713165	57207
chr19	34655958	34855958	harbor1	chr19	34721933	34722488	LTR/ERV1	3933	+	278	34722211	66253
chr19	34655958	34855958	harbor1	chr19	34722491	34722849	LTR/ERV1	2717	+	179	34722670	66712
chr19	34655958	34855958	harbor1	chr19	34722924	34723282	LTR/ERV1	2717	+	179	34723103	67145
chr19	34655958	34855958	harbor1	chr19	34723306	34725034	LTR/ERV1	9265	+	864	34724170	68212
chr19	34655958	34855958	harbor1	chr19	34725029	34727233	LTR/ERV1	13400	+	1102	34726131	70173
chr19	34655958	34855958	harbor1	chr19	34727234	34727787	LTR/ERV1	3849	+	276	34727510	71552
chr19	34655958	34855958	harbor1	chr19	34736902	34737275	LTR/ERV1	1642	+	186	34737088	81130
chr19	34655958	34855958	harbor1	chr19	34668011	34669231	LTR/ERV1	8236	+	610	34668621	12663
chr19	441549	641549	harbor1	chr19	487753	488211	LTR/ERV1	3643	+	229	487982	46433
chr19	441549	641549	harbor1	chr19	504984	505370	LTR/ERV1	1805	+	193	505177	63628
chr19	6486027	6686027	harbor1	chr19	6492582	6492758	LTR/ERV1	3902	+	88	6492670	6643
chr19	6486027	6686027	harbor1	chr19	6493102	6493352	LTR/ERV1	3902	+	125	6493227	7200
chr19	6486027	6686027	harbor1	chr19	6493962	6494076	LTR/ERV1	3902	+	57	6494019	7992
chr19	6486027	6686027	harbor1	chr19	6505812	6506242	LTR/ERV1	3400	+	215	6506027	20000
chr19	6486027	6686027	harbor1	chr19	6511014	6511127	LTR/ERV1	881	+	56	6511070	25043
chr19	6486027	6686027	harbor1	chr19	6511683	6512002	LTR/ERV1	2095	+	160	6511843	25816
chr19	6486027	6686027	harbor1	chr19	6512315	6512355	LTR/ERV1	2095	+	20	6512335	26308
chr19	6486027	6686027	harbor1	chr19	6566474	6566787	LTR/ERV1	3332	+	156	6566630	80603
chr19	6486027	6686027	harbor1	chr19	6567133	6567665	LTR/ERV1	3332	+	266	6567399	81372
chr19	6486027	6686027	harbor1	chr19	6567667	6567906	LTR/ERV1	1040	+	120	6567787	81760
chr19	6486027	6686027	harbor1	chr19	6568539	6568620	LTR/ERV1	1903	+	40	6568579	82552
chr19	6486027	6686027	harbor1	chr19	6568884	6569169	LTR/ERV1	1903	+	142	6569026	82999
chr19	6486027	6686027	harbor1	chr19	6573454	6573784	LTR/ERV1	2697	+	165	6573619	87592
chr19	6486027	6686027	harbor1	chr19	6574425	6574608	LTR/ERV1	2697	+	92	6574517	88490
chr19	6486027	6686027	harbor1	chr19	6574614	6576096	LTR/ERV1	5930	+	741	6575355	89328
chr19	6486027	6686027	harbor1	chr19	6576074	6576299	LTR/ERV1	1348	+	112	6576186	90159
chr19	6486027	6686027	harbor1	chr19	6576348	6576888	LTR/ERV1	3459	+	270	6576618	90591
chr19	6486027	6686027	harbor1	chr19	6576889	6577300	LTR/ERV1	2327	+	206	6577095	91068
chr19	21481968	21681968	harbor1	chr19	21499774	21499928	LTR/ERV1	768	+	77	21499851	17883
chr19	21481968	21681968	harbor1	chr19	21499973	21499994	LTR/ERV1	768	+	10	21499983	18015
chr19	21481968	21681968	harbor1	chr19	21500003	21500297	LTR/ERV1	10632	+	147	21500150	18182
chr19	21481968	21681968	harbor1	chr19	21501205	21502841	LTR/ERV1	10632	+	818	21502023	20055
chr19	21481968	21681968	harbor1	chr19	21502886	21503086	LTR/ERV1	10632	+	100	21502986	21018
chr19	21481968	21681968	harbor1	chr19	21503184	21503411	LTR/ERV1	1119	+	114	21503298	21330
chr19	21481968	21681968	harbor1	chr19	21519107	21519758	LTR/ERV1	3831	+	326	21519433	37465
chr19	21481968	21681968	harbor1	chr19	21520329	21520550	LTR/ERV1	719	+	110	21520439	38471
chr19	21481968	21681968	harbor1	chr19	21522146	21522636	LTR/ERV1	8329	+	245	21522391	40423
chr19	21481968	21681968	harbor1	chr19	21522910	21523790	LTR/ERV1	8329	+	440	21523350	41382
chr19	21481968	21681968	harbor1	chr19	21526423	21526456	LTR/ERV1	1725	+	16	21526439	44471
chr19	21481968	21681968	harbor1	chr19	21526536	21526777	LTR/ERV1	1725	+	120	21526656	44688
chr19	21481968	21681968	harbor1	chr19	21564031	21564202	LTR/ERV1	1557	+	86	21564117	82149
chr19	21481968	21681968	harbor1	chr19	21564499	21564833	LTR/ERV1	1557	+	167	21564666	82698
chr19	21481968	21681968	harbor1	chr19	21567548	21567771	LTR/ERV1	1338	+	112	21567660	85692
chr19	11806977	12006977	harbor1	chr19	11880363	11880887	LTR/ERV1	3946	+	262	11880625	73648
chr19	11806977	12006977	harbor1	chr19	11880890	11881977	LTR/ERV1	2223	+	544	11881434	74457
chr19	11806977	12006977	harbor1	chr19	11882682	11883250	LTR/ERV1	1544	+	284	11882966	75989
chr19	11806977	12006977	harbor1	chr19	11883491	11885229	LTR/ERV1	7917	+	869	11884360	77383
chr19	11806977	12006977	harbor1	chr19	11885526	11885997	LTR/ERV1	7917	+	236	11885762	78785
chr19	11806977	12006977	harbor1	chr19	11885998	11886023	LTR/ERV1	3550	+	12	11886010	79033
chr19	11806977	12006977	harbor1	chr19	11886327	11886834	LTR/ERV1	3550	+	254	11886581	79604
chr19	41375986	41575986	harbor1	chr19	41456814	41457087	LTR/ERV1	1780	+	136	41456950	80964
chr19	41375986	41575986	harbor1	chr19	41457861	41458122	LTR/ERV1	1287	+	130	41457991	82005
chr19	41375986	41575986	harbor1	chr19	41458123	41458317	LTR/ERV1	2282	+	97	41458220	82234
chr19	41375986	41575986	harbor1	chr19	41458619	41458823	LTR/ERV1	2282	+	102	41458721	82735
chr19	16230796	16430796	harbor1	chr19	16307295	16307521	LTR/ERV1	1721	+	113	16307408	76612
chr19	16230796	16430796	harbor1	chr19	16307812	16307866	LTR/ERV1	1721	+	27	16307839	77043
chr19	23918914	24118914	harbor1	chr19	23947083	23947517	LTR/ERV1	3698	+	217	23947300	28386
chr19	23918914	24118914	harbor1	chr19	23947540	23947826	LTR/ERV1	2328	+	143	23947683	28769
chr19	23918914	24118914	harbor1	chr19	23947827	23948150	LTR/ERV1	2732	+	162	23947989	29075
chr19	23918914	24118914	harbor1	chr19	23949476	23949692	LTR/ERV1	869	+	108	23949584	30670
chr19	23918914	24118914	harbor1	chr19	24008653	24008886	LTR/ERV1	1192	+	116	24008769	89855
chr19	23918914	24118914	harbor1	chr19	24009203	24009541	LTR/ERV1	1192	+	169	24009372	90458
chr19	20918432	21118432	harbor1	chr19	20918641	20918722	LTR/ERV1	7852	+	40	20918681	249
chr19	20918432	21118432	harbor1	chr19	20918733	20919132	LTR/ERV1	1730	+	200	20918933	501
chr19	20918432	21118432	harbor1	chr19	21002382	21002840	LTR/ERV1	3625	+	229	21002611	84179
chr19	20918432	21118432	harbor1	chr19	21005405	21007280	LTR/ERV1	23942	+	938	21006343	87911
chr19	20918432	21118432	harbor1	chr19	21007353	21007741	LTR/ERV1	2607	+	194	21007547	89115
chr19	20918432	21118432	harbor1	chr19	21008919	21009375	LTR/ERV1	3336	+	228	21009147	90715
chr19	20918432	21118432	harbor1	chr19	21009366	21010125	LTR/ERV1	5525	+	380	21009746	91314
chr19	20918432	21118432	harbor1	chr19	21010127	21010589	LTR/ERV1	3200	+	231	21010358	91926
chr19	20918432	21118432	harbor1	chr19	21012263	21012602	LTR/ERV1	12221	+	170	21012433	94001
chr19	20918432	21118432	harbor1	chr19	21012892	21012926	LTR/ERV1	12221	+	17	21012909	94477
chr19	20918432	21118432	harbor1	chr19	21012969	21013055	LTR/ERV1	12221	+	43	21013012	94580
chr19	20918432	21118432	harbor1	chr19	21013334	21013543	LTR/ERV1	12221	+	104	21013438	95006
chr19	20918432	21118432	harbor1	chr19	21013843	21014302	LTR/ERV1	12221	+	230	21014073	95641
chr19	20918432	21118432	harbor1	chr19	21014611	21015426	LTR/ERV1	12221	+	408	21015019	96587
chr19	20918432	21118432	harbor1	chr19	21015726	21016414	LTR/ERV1	12221	+	344	21016070	97638
chr19	20918432	21118432	harbor1	chr19	21016415	21016807	LTR/ERV1	1680	+	196	21016611	98179
chr19	20918432	21118432	harbor1	chr19	21002841	21005098	LTR/ERV1	23942	+	1128	21003969	85537
chr19	12185509	12385509	harbor1	chr19	12232959	12233402	LTR/ERV1	2303	+	222	12233181	47672
chr19	12185509	12385509	harbor1	chr19	12236273	12236468	LTR/ERV1	674	+	98	12236371	50862
chr19	12185509	12385509	harbor1	chr19	12236902	12237120	LTR/ERV1	860	+	109	12237011	51502
chr19	12185509	12385509	harbor1	chr19	12244304	12244446	LTR/ERV1	782	+	71	12244375	58866
chr19	12185509	12385509	harbor1	chr19	12244557	12245035	LTR/ERV1	1011	+	239	12244796	59287
chr19	12185509	12385509	harbor1	chr19	12282363	12282418	LTR/ERV1	2327	+	28	12282391	96882
chr19	12185509	12385509	harbor1	chr19	12282722	12283157	LTR/ERV1	2327	+	218	12282940	97431
chr19	6284748	6484748	harbor1	chr19	6285805	6287690	LTR/ERV1	7881	+	942	6286747	1999
chr19	6284748	6484748	harbor1	chr19	6287691	6288167	LTR/ERV1	3142	+	238	6287929	3181
chr19	6284748	6484748	harbor1	chr19	6288322	6288366	LTR/ERV1	3142	+	22	6288344	3596
chr19	6284748	6484748	harbor1	chr19	6288648	6288740	LTR/ERV1	3142	+	46	6288694	3946
chr19	6284748	6484748	harbor1	chr19	6288862	6289357	LTR/ERV1	9058	+	248	6289110	4362
chr19	6284748	6484748	harbor1	chr19	6289655	6289846	LTR/ERV1	9058	+	96	6289751	5003
chr19	6284748	6484748	harbor1	chr19	6290460	6291235	LTR/ERV1	9058	+	388	6290848	6100
chr19	6284748	6484748	harbor1	chr19	6291798	6292476	LTR/ERV1	4085	+	339	6292137	7389
chr19	6284748	6484748	harbor1	chr19	6292791	6292960	LTR/ERV1	4085	+	84	6292875	8127
chr19	6284748	6484748	harbor1	chr19	6293022	6293177	LTR/ERV1	795	+	78	6293100	8352
chr19	6284748	6484748	harbor1	chr19	6293180	6293246	LTR/ERV1	2144	+	33	6293213	8465
chr19	6284748	6484748	harbor1	chr19	6293545	6293574	LTR/ERV1	2144	+	14	6293559	8811
chr19	6284748	6484748	harbor1	chr19	6293883	6294319	LTR/ERV1	5269	+	218	6294101	9353
chr19	6284748	6484748	harbor1	chr19	6294652	6295406	LTR/ERV1	5269	+	377	6295029	10281
chr19	6284748	6484748	harbor1	chr19	6295708	6296211	LTR/ERV1	5269	+	252	6295960	11212
chr19	6284748	6484748	harbor1	chr19	6296522	6296744	LTR/ERV1	2325	+	111	6296633	11885
chr19	6284748	6484748	harbor1	chr19	6296800	6296959	LTR/ERV1	1247	+	80	6296880	12132
chr19	6284748	6484748	harbor1	chr19	6297254	6297305	LTR/ERV1	1247	+	26	6297280	12532
chr19	6284748	6484748	harbor1	chr19	6297320	6298831	LTR/ERV1	7198	+	756	6298076	13328
chr19	49709102	49909102	harbor1	chr19	49718672	49718801	LTR/ERV1	1603	+	64	49718736	9634
chr19	49709102	49909102	harbor1	chr19	49719110	49719414	LTR/ERV1	1603	+	152	49719262	10160
chr19	49709102	49909102	harbor1	chr19	49720688	49720863	LTR/ERV1	654	+	88	49720776	11674
chr19	49709102	49909102	harbor1	chr19	49722055	49722327	LTR/ERV1	1301	+	136	49722191	13089
chr19	49709102	49909102	harbor1	chr19	49724251	49724442	LTR/ERV1	911	+	96	49724347	15245
chr19	49709102	49909102	harbor1	chr19	49727163	49727741	LTR/ERV1	3887	+	289	49727452	18350
chr19	49709102	49909102	harbor1	chr19	49727742	49728063	LTR/ERV1	2039	+	160	49727902	18800
chr19	49709102	49909102	harbor1	chr19	49728379	49728810	LTR/ERV1	1746	+	216	49728595	19493
chr19	23128007	23328007	harbor1	chr19	23169122	23169168	LTR/ERV1	12595	+	23	23169145	41138
chr19	23128007	23328007	harbor1	chr19	23169466	23170520	LTR/ERV1	12595	+	527	23169993	41986
chr19	23128007	23328007	harbor1	chr19	23170521	23171118	LTR/ERV1	4152	+	298	23170819	42812
chr19	23128007	23328007	harbor1	chr19	23171119	23171150	LTR/ERV1	12595	+	16	23171135	43128
chr19	23128007	23328007	harbor1	chr19	23171439	23172048	LTR/ERV1	12595	+	304	23171743	43736
chr19	23128007	23328007	harbor1	chr19	23172049	23172493	LTR/ERV1	3031	+	222	23172271	44264
chr19	23128007	23328007	harbor1	chr19	23174098	23174207	LTR/ERV1	10393	+	54	23174152	46145
chr19	23128007	23328007	harbor1	chr19	23174511	23174946	LTR/ERV1	10393	+	218	23174729	46722
chr19	23128007	23328007	harbor1	chr19	23175233	23176858	LTR/ERV1	10393	+	812	23176045	48038
chr19	23128007	23328007	harbor1	chr19	23176980	23177389	LTR/ERV1	2583	+	204	23177184	49177
chr19	23128007	23328007	harbor1	chr19	23177390	23177823	LTR/ERV1	1954	+	216	23177606	49599
chr19	23128007	23328007	harbor1	chr19	23178790	23179743	LTR/ERV1	3914	+	476	23179266	51259
chr19	23128007	23328007	harbor1	chr19	23186832	23188026	LTR/ERV1	4476	+	597	23187429	59422
chr19	23128007	23328007	harbor1	chr19	23200237	23200696	LTR/ERV1	4135	+	230	23200467	72460
chr19	23128007	23328007	harbor1	chr19	23205914	23206398	LTR/ERV1	3384	+	242	23206156	78149
chr19	23128007	23328007	harbor1	chr19	23206711	23206842	LTR/ERV1	3384	+	66	23206777	78770
chr19	16059961	16259961	harbor1	chr19	16136440	16137103	LTR/ERV1	4031	+	332	16136772	76811
chr19	2380446	2580446	harbor1	chr19	2392568	2393567	LTR/ERV1	5125	+	500	2393068	12622
chr19	2380446	2580446	harbor1	chr19	2466283	2466324	LTR/ERV1	2162	+	20	2466303	85857
chr19	2380446	2580446	harbor1	chr19	2466617	2466859	LTR/ERV1	2162	+	121	2466738	86292
chr19	2380446	2580446	harbor1	chr19	2467172	2467463	LTR/ERV1	2162	+	146	2467318	86872
chr19	2380446	2580446	harbor1	chr19	2467794	2467916	LTR/ERV1	2162	+	61	2467855	87409
chr19	2064480	2264480	harbor1	chr19	2162915	2163048	LTR/ERV1	998	+	66	2162981	98501
chr19	4215651	4415651	harbor1	chr19	4246208	4246484	LTR/ERV1	2027	+	138	4246346	30695
chr19	21704537	21904537	harbor1	chr19	21704430	21704849	LTR/ERV1	2369	+	210	21704640	103
chr19	21704537	21904537	harbor1	chr19	21713631	21714229	LTR/ERV1	3451	+	299	21713930	9393
chr19	21704537	21904537	harbor1	chr19	21759476	21759894	LTR/ERV1	2461	+	209	21759685	55148
chr19	21704537	21904537	harbor1	chr19	21760204	21760244	LTR/ERV1	5140	+	20	21760224	55687
chr19	21704537	21904537	harbor1	chr19	21760513	21760747	LTR/ERV1	5140	+	117	21760630	56093
chr19	21704537	21904537	harbor1	chr19	21761058	21761946	LTR/ERV1	5140	+	444	21761502	56965
chr19	21704537	21904537	harbor1	chr19	21762195	21762695	LTR/ERV1	5140	+	250	21762445	57908
chr19	21704537	21904537	harbor1	chr19	21762732	21763262	LTR/ERV1	3260	+	265	21762997	58460
chr19	21704537	21904537	harbor1	chr19	21766302	21766711	LTR/ERV1	2649	+	204	21766506	61969
chr19	21704537	21904537	harbor1	chr19	21767007	21767079	LTR/ERV1	2649	+	36	21767043	62506
chr19	28803526	29003526	harbor1	chr19	28862299	28862652	LTR/ERV1	1658	+	176	28862475	58949
chr19	28803526	29003526	harbor1	chr19	28880916	28881480	LTR/ERV1	2204	+	282	28881198	77672
chr19	20411270	20611270	harbor1	chr19	20421833	20421994	LTR/ERV1	911	+	80	20421913	10643
chr19	20411270	20611270	harbor1	chr19	20422294	20422601	LTR/ERV1	911	+	154	20422448	11178
chr19	20411270	20611270	harbor1	chr19	20443967	20445294	LTR/ERV1	7980	+	664	20444631	33361
chr19	20411270	20611270	harbor1	chr19	20472620	20472937	LTR/ERV1	915	+	158	20472778	61508
chr19	52984537	53184537	harbor1	chr19	52996655	52996796	LTR/ERV1	723	+	70	52996725	12188
chr19	52984537	53184537	harbor1	chr19	52999313	52999581	LTR/ERV1	1835	+	134	52999447	14910
chr19	52984537	53184537	harbor1	chr19	53007252	53007672	LTR/ERV1	946	+	210	53007462	22925
chr19	52984537	53184537	harbor1	chr19	53007847	53008093	LTR/ERV1	786	+	123	53007970	23433
chr19	52984537	53184537	harbor1	chr19	53009302	53011424	LTR/ERV1	4715	+	1061	53010363	25826
chr19	52984537	53184537	harbor1	chr19	53011452	53011898	LTR/ERV1	658	+	223	53011675	27138
chr19	52984537	53184537	harbor1	chr19	53015008	53015566	LTR/ERV1	988	+	279	53015287	30750
chr19	52984537	53184537	harbor1	chr19	53016034	53016299	LTR/ERV1	767	+	132	53016166	31629
chr19	52984537	53184537	harbor1	chr19	53016604	53016684	LTR/ERV1	767	+	40	53016644	32107
chr19	52984537	53184537	harbor1	chr19	53035488	53035729	LTR/ERV1	1413	+	120	53035608	51071
chr19	52984537	53184537	harbor1	chr19	53035724	53035903	LTR/ERV1	949	+	90	53035814	51277
chr19	52984537	53184537	harbor1	chr19	53044560	53044786	LTR/ERV1	800	+	113	53044673	60136
chr19	52984537	53184537	harbor1	chr19	53045068	53045293	LTR/ERV1	824	+	112	53045180	60643
chr19	52984537	53184537	harbor1	chr19	53050169	53050736	LTR/ERV1	1137	+	284	53050453	65916
chr19	52984537	53184537	harbor1	chr19	53055294	53055549	LTR/ERV1	1294	+	128	53055422	70885
chr19	52984537	53184537	harbor1	chr19	53055545	53055721	LTR/ERV1	1709	+	88	53055633	71096
chr19	52984537	53184537	harbor1	chr19	53056049	53056064	LTR/ERV1	1709	+	8	53056057	71520
chr19	52984537	53184537	harbor1	chr19	53056356	53056517	LTR/ERV1	1709	+	80	53056436	71899
chr19	52984537	53184537	harbor1	chr19	53083866	53084478	LTR/ERV1	4076	+	306	53084172	99635
chr19	56679064	56879064	harbor1	chr19	56715804	56716051	LTR/ERV1	3080	+	124	56715928	36864
chr19	56679064	56879064	harbor1	chr19	56716365	56716624	LTR/ERV1	3080	+	130	56716495	37431
chr19	56679064	56879064	harbor1	chr19	56716930	56717042	LTR/ERV1	3080	+	56	56716986	37922
chr19	56679064	56879064	harbor1	chr19	56725069	56725522	LTR/ERV1	2623	+	226	56725295	46231
chr19	56679064	56879064	harbor1	chr19	56725524	56725685	LTR/ERV1	799	+	80	56725604	46540
chr19	56679064	56879064	harbor1	chr19	56725994	56726057	LTR/ERV1	656	+	32	56726026	46962
chr19	56679064	56879064	harbor1	chr19	56738446	56738995	LTR/ERV1	3193	+	274	56738720	59656
chr19	47035657	47235657	harbor1	chr19	47057412	47057730	LTR/ERV1	989	+	159	47057571	21914
chr19	42555159	42755159	harbor1	chr19	42557356	42557790	LTR/ERV1	2810	+	217	42557573	2414
chr19	42555159	42755159	harbor1	chr19	42558050	42558112	LTR/ERV1	4106	+	31	42558081	2922
chr19	42555159	42755159	harbor1	chr19	42558406	42558963	LTR/ERV1	4106	+	278	42558684	3525
chr19	42555159	42755159	harbor1	chr19	42573890	42574103	LTR/ERV1	749	+	106	42573996	18837
chr19	42555159	42755159	harbor1	chr19	42574127	42575513	LTR/ERV1	8164	+	693	42574820	19661
chr19	42555159	42755159	harbor1	chr19	42575837	42576141	LTR/ERV1	669	+	152	42575989	20830
chr19	42555159	42755159	harbor1	chr19	42576474	42576735	LTR/ERV1	915	+	130	42576604	21445
chr19	42555159	42755159	harbor1	chr19	42576703	42576900	LTR/ERV1	811	+	98	42576801	21642
chr19	42555159	42755159	harbor1	chr19	42609481	42609664	LTR/ERV1	879	+	92	42609573	54414
chr19	42555159	42755159	harbor1	chr19	42611305	42611501	LTR/ERV1	909	+	98	42611403	56244
chr19	42555159	42755159	harbor1	chr19	42611522	42611750	LTR/ERV1	1047	+	114	42611636	56477
chr19	42555159	42755159	harbor1	chr19	42611755	42612515	LTR/ERV1	5914	+	380	42612135	56976
chr19	42555159	42755159	harbor1	chr19	42612519	42613554	LTR/ERV1	2333	+	518	42613037	57878
chr19	42555159	42755159	harbor1	chr19	42613563	42614256	LTR/ERV1	4404	+	346	42613909	58750
chr19	42555159	42755159	harbor1	chr19	42615261	42616246	LTR/ERV1	4005	+	492	42615753	60594
chr19	42555159	42755159	harbor1	chr19	42616234	42616524	LTR/ERV1	5155	+	145	42616379	61220
chr19	42555159	42755159	harbor1	chr19	42616812	42617616	LTR/ERV1	6022	+	402	42617214	62055
chr19	42555159	42755159	harbor1	chr19	42618150	42619169	LTR/ERV1	6202	+	510	42618660	63501
chr19	42555159	42755159	harbor1	chr19	42627732	42628219	LTR/ERV1	3056	+	244	42627976	72817
chr19	42555159	42755159	harbor1	chr19	42628220	42628887	LTR/ERV1	4382	+	334	42628554	73395
chr19	42555159	42755159	harbor1	chr19	42628963	42629723	LTR/ERV1	4035	+	380	42629343	74184
chr19	42555159	42755159	harbor1	chr19	42645342	42645722	LTR/ERV1	954	+	190	42645532	90373
chr19	42555159	42755159	harbor1	chr19	42645731	42645924	LTR/ERV1	917	+	96	42645827	90668
chr19	42555159	42755159	harbor1	chr19	42614575	42614940	LTR/ERV1	4005	+	182	42614757	59598
chr19	23229799	23429799	harbor1	chr19	23240331	23240629	LTR/ERV1	1249	+	149	23240480	10681
chr19	23229799	23429799	harbor1	chr19	23245010	23245332	LTR/ERV1	996	+	161	23245171	15372
chr19	23229799	23429799	harbor1	chr19	23245628	23245794	LTR/ERV1	996	+	83	23245711	15912
chr19	23229799	23429799	harbor1	chr19	23248436	23248712	LTR/ERV1	2212	+	138	23248574	18775
chr19	23229799	23429799	harbor1	chr19	23249016	23249241	LTR/ERV1	2212	+	112	23249128	19329
chr19	23229799	23429799	harbor1	chr19	23249834	23249884	LTR/ERV1	2212	+	25	23249859	20060
chr19	23229799	23429799	harbor1	chr19	23252887	23252979	LTR/ERV1	738	+	46	23252933	23134
chr19	23229799	23429799	harbor1	chr19	23253263	23253288	LTR/ERV1	738	+	12	23253275	23476
chr19	23229799	23429799	harbor1	chr19	23253581	23253738	LTR/ERV1	738	+	78	23253659	23860
chr19	23229799	23429799	harbor1	chr19	23272976	23273427	LTR/ERV1	2208	+	226	23273202	43403
chr19	23229799	23429799	harbor1	chr19	23273726	23273754	LTR/ERV1	2208	+	14	23273740	43941
chr19	23229799	23429799	harbor1	chr19	23276732	23277027	LTR/ERV1	1542	+	148	23276880	47081
chr19	23229799	23429799	harbor1	chr19	23303821	23304261	LTR/ERV1	992	+	220	23304041	74242
chr19	44197487	44397487	harbor1	chr19	44281559	44282219	LTR/ERV1	2558	+	330	44281889	84402
chr19	44197487	44397487	harbor1	chr19	44282650	44283216	LTR/ERV1	1585	+	283	44282933	85446
chr19	44197487	44397487	harbor1	chr19	44283767	44284141	LTR/ERV1	1585	+	187	44283954	86467
chr19	44197487	44397487	harbor1	chr19	44284436	44284525	LTR/ERV1	1585	+	44	44284480	86993
chr19	44197487	44397487	harbor1	chr19	44284885	44285445	LTR/ERV1	2837	+	280	44285165	87678
chr19	44398740	44598740	harbor1	chr19	44487501	44487711	LTR/ERV1	1496	+	105	44487606	88866
chr19	44398740	44598740	harbor1	chr19	44488023	44488044	LTR/ERV1	1496	+	10	44488033	89293
chr19	52917682	53117682	harbor1	chr19	52920546	52920938	LTR/ERV1	2794	+	196	52920742	3060
chr19	52917682	53117682	harbor1	chr19	52923622	52924121	LTR/ERV1	3706	+	250	52923872	6190
chr19	52917682	53117682	harbor1	chr19	52956727	52957204	LTR/ERV1	3400	+	238	52956965	39283
chr19	52917682	53117682	harbor1	chr19	52957205	52957363	LTR/ERV1	1106	+	79	52957284	39602
chr19	52917682	53117682	harbor1	chr19	52957363	52960571	LTR/ERV1	22418	+	1604	52958967	41285
chr19	52917682	53117682	harbor1	chr19	52960545	52962193	LTR/ERV1	11115	+	824	52961369	43687
chr19	52917682	53117682	harbor1	chr19	52962265	52962469	LTR/ERV1	1017	+	102	52962367	44685
chr19	52917682	53117682	harbor1	chr19	52996655	52996796	LTR/ERV1	723	+	70	52996725	79043
chr19	52917682	53117682	harbor1	chr19	52999313	52999581	LTR/ERV1	1835	+	134	52999447	81765
chr19	52917682	53117682	harbor1	chr19	53007252	53007672	LTR/ERV1	946	+	210	53007462	89780
chr19	52917682	53117682	harbor1	chr19	53007847	53008093	LTR/ERV1	786	+	123	53007970	90288
chr19	52917682	53117682	harbor1	chr19	53009302	53011424	LTR/ERV1	4715	+	1061	53010363	92681
chr19	52917682	53117682	harbor1	chr19	53011452	53011898	LTR/ERV1	658	+	223	53011675	93993
chr19	52917682	53117682	harbor1	chr19	53015008	53015566	LTR/ERV1	988	+	279	53015287	97605
chr19	52917682	53117682	harbor1	chr19	53016034	53016299	LTR/ERV1	767	+	132	53016166	98484
chr19	52917682	53117682	harbor1	chr19	53016604	53016684	LTR/ERV1	767	+	40	53016644	98962
chr19	41544529	41744529	harbor1	chr19	41546983	41547615	LTR/ERV1	3445	+	316	41547299	2770
chr19	41544529	41744529	harbor1	chr19	41639975	41640224	LTR/ERV1	1063	+	124	41640099	95570
chr19	42533792	42733792	harbor1	chr19	42557356	42557790	LTR/ERV1	2810	+	217	42557573	23781
chr19	42533792	42733792	harbor1	chr19	42558050	42558112	LTR/ERV1	4106	+	31	42558081	24289
chr19	42533792	42733792	harbor1	chr19	42558406	42558963	LTR/ERV1	4106	+	278	42558684	24892
chr19	42533792	42733792	harbor1	chr19	42573890	42574103	LTR/ERV1	749	+	106	42573996	40204
chr19	42533792	42733792	harbor1	chr19	42574127	42575513	LTR/ERV1	8164	+	693	42574820	41028
chr19	42533792	42733792	harbor1	chr19	42575837	42576141	LTR/ERV1	669	+	152	42575989	42197
chr19	42533792	42733792	harbor1	chr19	42576474	42576735	LTR/ERV1	915	+	130	42576604	42812
chr19	42533792	42733792	harbor1	chr19	42576703	42576900	LTR/ERV1	811	+	98	42576801	43009
chr19	42533792	42733792	harbor1	chr19	42609481	42609664	LTR/ERV1	879	+	92	42609573	75781
chr19	42533792	42733792	harbor1	chr19	42611305	42611501	LTR/ERV1	909	+	98	42611403	77611
chr19	42533792	42733792	harbor1	chr19	42611522	42611750	LTR/ERV1	1047	+	114	42611636	77844
chr19	42533792	42733792	harbor1	chr19	42611755	42612515	LTR/ERV1	5914	+	380	42612135	78343
chr19	42533792	42733792	harbor1	chr19	42612519	42613554	LTR/ERV1	2333	+	518	42613037	79245
chr19	42533792	42733792	harbor1	chr19	42613563	42614256	LTR/ERV1	4404	+	346	42613909	80117
chr19	42533792	42733792	harbor1	chr19	42615261	42616246	LTR/ERV1	4005	+	492	42615753	81961
chr19	42533792	42733792	harbor1	chr19	42616234	42616524	LTR/ERV1	5155	+	145	42616379	82587
chr19	42533792	42733792	harbor1	chr19	42616812	42617616	LTR/ERV1	6022	+	402	42617214	83422
chr19	42533792	42733792	harbor1	chr19	42618150	42619169	LTR/ERV1	6202	+	510	42618660	84868
chr19	42533792	42733792	harbor1	chr19	42627732	42628219	LTR/ERV1	3056	+	244	42627976	94184
chr19	42533792	42733792	harbor1	chr19	42628220	42628887	LTR/ERV1	4382	+	334	42628554	94762
chr19	42533792	42733792	harbor1	chr19	42628963	42629723	LTR/ERV1	4035	+	380	42629343	95551
chr19	42533792	42733792	harbor1	chr19	42614575	42614940	LTR/ERV1	4005	+	182	42614757	80965
chr19	33911245	34111245	harbor1	chr19	33915957	33916174	LTR/ERV1	1229	+	108	33916065	4820
chr19	33911245	34111245	harbor1	chr19	33977051	33977594	LTR/ERV1	4559	+	272	33977323	66078
chr19	33911245	34111245	harbor1	chr19	33993589	33993834	LTR/ERV1	1367	+	122	33993711	82466
chr19	33911245	34111245	harbor1	chr19	33993833	33994111	LTR/ERV1	1478	+	139	33993972	82727
chr19	33911245	34111245	harbor1	chr19	33914612	33915037	LTR/ERV1	2592	+	212	33914824	3579
chr19	23990969	24190969	harbor1	chr19	24008653	24008886	LTR/ERV1	1192	+	116	24008769	17800
chr19	23990969	24190969	harbor1	chr19	24009203	24009541	LTR/ERV1	1192	+	169	24009372	18403
chr19	23990969	24190969	harbor1	chr19	24019766	24020099	LTR/ERV1	1658	+	166	24019932	28963
chr19	23990969	24190969	harbor1	chr19	24037329	24037427	LTR/ERV1	1811	+	49	24037378	46409
chr19	23990969	24190969	harbor1	chr19	24038047	24039055	LTR/ERV1	2346	+	504	24038551	47582
chr19	23990969	24190969	harbor1	chr19	24041132	24042696	LTR/ERV1	9786	+	782	24041914	50945
chr19	23990969	24190969	harbor1	chr19	24045002	24045387	LTR/ERV1	2612	+	192	24045194	54225
chr19	23990969	24190969	harbor1	chr19	24045693	24045816	LTR/ERV1	2612	+	62	24045755	54786
chr19	23990969	24190969	harbor1	chr19	24076818	24077414	LTR/ERV1	2478	+	298	24077116	86147
chr19	23990969	24190969	harbor1	chr19	24077929	24078029	LTR/ERV1	1286	+	50	24077979	87010
chr19	23990969	24190969	harbor1	chr19	24078318	24078621	LTR/ERV1	1286	+	152	24078470	87501
chr19	23990969	24190969	harbor1	chr19	24079035	24080551	LTR/ERV1	11289	+	758	24079793	88824
chr19	23990969	24190969	harbor1	chr19	24080797	24080812	LTR/ERV1	11289	+	8	24080805	89836
chr19	23990969	24190969	harbor1	chr19	24081096	24081281	LTR/ERV1	11289	+	92	24081188	90219
chr19	23990969	24190969	harbor1	chr19	24081268	24081457	LTR/ERV1	956	+	94	24081362	90393
chr19	23990969	24190969	harbor1	chr19	24081459	24081841	LTR/ERV1	2735	+	191	24081650	90681
chr19	23990969	24190969	harbor1	chr19	24082143	24082258	LTR/ERV1	702	+	58	24082201	91232
chr19	23990969	24190969	harbor1	chr19	24082680	24082825	LTR/ERV1	1034	+	72	24082752	91783
chr19	23990969	24190969	harbor1	chr19	24085238	24085481	LTR/ERV1	1300	+	122	24085360	94391
chr19	23990969	24190969	harbor1	chr19	24085783	24085924	LTR/ERV1	1300	+	70	24085853	94884
chr19	23990969	24190969	harbor1	chr19	24086232	24086290	LTR/ERV1	1300	+	29	24086261	95292
chr19	23990969	24190969	harbor1	chr19	24086776	24086965	LTR/ERV1	721	+	94	24086870	95901
chr19	28255490	28455490	harbor1	chr19	28290183	28290689	LTR/ERV1	1710	+	253	28290436	34946
chr19	28255490	28455490	harbor1	chr19	28318323	28318821	LTR/ERV1	2624	+	249	28318572	63082
chr19	28255490	28455490	harbor1	chr19	28324336	28325218	LTR/ERV1	5144	+	441	28324777	69287
chr19	28255490	28455490	harbor1	chr19	28328415	28328590	LTR/ERV1	738	+	88	28328503	73013
chr19	28255490	28455490	harbor1	chr19	28327640	28328039	LTR/ERV1	2175	+	200	28327840	72350
chr19	2410912	2610912	harbor1	chr19	2466283	2466324	LTR/ERV1	2162	+	20	2466303	55391
chr19	2410912	2610912	harbor1	chr19	2466617	2466859	LTR/ERV1	2162	+	121	2466738	55826
chr19	2410912	2610912	harbor1	chr19	2467172	2467463	LTR/ERV1	2162	+	146	2467318	56406
chr19	2410912	2610912	harbor1	chr19	2467794	2467916	LTR/ERV1	2162	+	61	2467855	56943
chr19	46326583	46526583	harbor1	chr19	46338948	46339449	LTR/ERV1	3735	+	250	46339198	12615
chr19	46326583	46526583	harbor1	chr19	46396203	46396222	LTR/ERV1	1383	+	10	46396213	69630
chr19	46326583	46526583	harbor1	chr19	46396511	46396776	LTR/ERV1	1383	+	132	46396643	70060
chr19	46326583	46526583	harbor1	chr19	46397395	46397544	LTR/ERV1	1383	+	74	46397469	70886
chr19	19829990	20029990	harbor1	chr19	19859994	19860368	LTR/ERV1	2042	+	187	19860181	30191
chr19	19829990	20029990	harbor1	chr19	19860655	19860709	LTR/ERV1	2042	+	27	19860682	30692
chr19	19829990	20029990	harbor1	chr19	19864988	19865165	LTR/ERV1	753	+	88	19865076	35086
chr19	19829990	20029990	harbor1	chr19	19871513	19872561	LTR/ERV1	9006	+	524	19872037	42047
chr19	19829990	20029990	harbor1	chr19	19872602	19872804	LTR/ERV1	9006	+	101	19872703	42713
chr19	19829990	20029990	harbor1	chr19	19895560	19897352	LTR/ERV1	13385	+	896	19896456	66466
chr19	19829990	20029990	harbor1	chr19	19897353	19897814	LTR/ERV1	3635	+	230	19897583	67593
chr19	19829990	20029990	harbor1	chr19	19897815	19899157	LTR/ERV1	6342	+	671	19898486	68496
chr19	19829990	20029990	harbor1	chr19	19899202	19899805	LTR/ERV1	6342	+	302	19899504	69514
chr19	19829990	20029990	harbor1	chr19	19900136	19900640	LTR/ERV1	2520	+	252	19900388	70398
chr19	19829990	20029990	harbor1	chr19	19909367	19910648	LTR/ERV1	9292	+	640	19910007	80017
chr19	19626356	19826356	harbor1	chr19	19697161	19697725	LTR/ERV1	3767	+	282	19697443	71087
chr19	19626356	19826356	harbor1	chr19	19698737	19698924	LTR/ERV1	1285	+	94	19698831	72475
chr19	19626356	19826356	harbor1	chr19	19701247	19701427	LTR/ERV1	1147	+	90	19701337	74981
chr19	19626356	19826356	harbor1	chr19	19701741	19701868	LTR/ERV1	1147	+	64	19701805	75449
chr19	19626356	19826356	harbor1	chr19	19709224	19709942	LTR/ERV1	3773	+	359	19709583	83227
chr19	49979549	50179549	harbor1	chr19	50051734	50052026	LTR/ERV1	1142	+	146	50051880	72331
chr19	11756239	11956239	harbor1	chr19	11794168	11794683	LTR/ERV1	3799	+	258	11794426	38187
chr19	41460822	41660822	harbor1	chr19	41480235	41480853	LTR/ERV1	3624	+	309	41480544	19722
chr19	41460822	41660822	harbor1	chr19	41501866	41502087	LTR/ERV1	1362	+	110	41501976	41154
chr19	41460822	41660822	harbor1	chr19	41536367	41537235	LTR/ERV1	3578	+	434	41536801	75979
chr19	41460822	41660822	harbor1	chr19	41537355	41539698	LTR/ERV1	14635	+	1172	41538527	77705
chr19	41460822	41660822	harbor1	chr19	41539689	41539822	LTR/ERV1	970	+	66	41539755	78933
chr19	41460822	41660822	harbor1	chr19	41539835	41540526	LTR/ERV1	4403	+	346	41540181	79359
chr19	41460822	41660822	harbor1	chr19	41546983	41547615	LTR/ERV1	3445	+	316	41547299	86477
chr19	3238206	3438206	harbor1	chr19	3265564	3265794	LTR/ERV1	1295	+	115	3265679	27473
chr19	53162859	53362859	harbor1	chr19	53225659	53226015	LTR/ERV1	2413	+	178	53225837	62978
chr19	53162859	53362859	harbor1	chr19	53226271	53226367	LTR/ERV1	2413	+	48	53226319	63460
chr19	58184454	58384454	harbor1	chr19	58217514	58218061	LTR/ERV1	4085	+	274	58217788	33334
chr19	58184454	58384454	harbor1	chr19	58228225	58228541	LTR/ERV1	744	+	158	58228383	43929
chr19	58184454	58384454	harbor1	chr19	58274863	58275354	LTR/ERV1	1720	+	246	58275109	90655
chr19	58184454	58384454	harbor1	chr19	58277944	58278458	LTR/ERV1	3638	+	257	58278201	93747
chr19	46273520	46473520	harbor1	chr19	46278853	46279137	LTR/ERV1	1524	+	142	46278995	5475
chr19	46273520	46473520	harbor1	chr19	46338948	46339449	LTR/ERV1	3735	+	250	46339198	65678
chr19	39593137	39793137	harbor1	chr19	39670958	39671394	LTR/ERV1	2150	+	218	39671176	78039
chr19	39593137	39793137	harbor1	chr19	39671694	39671863	LTR/ERV1	975	+	84	39671778	78641
chr19	39593137	39793137	harbor1	chr19	39671948	39672111	LTR/ERV1	862	+	82	39672030	78893
chr19	39593137	39793137	harbor1	chr19	39672138	39673008	LTR/ERV1	4569	+	435	39672573	79436
chr19	39593137	39793137	harbor1	chr19	39673012	39673925	LTR/ERV1	5237	+	456	39673468	80331
chr19	39593137	39793137	harbor1	chr19	39673919	39674062	LTR/ERV1	847	+	72	39673991	80854
chr19	39593137	39793137	harbor1	chr19	39674107	39674452	LTR/ERV1	2380	+	172	39674279	81142
chr19	39593137	39793137	harbor1	chr19	39674441	39675061	LTR/ERV1	3204	+	310	39674751	81614
chr19	44910146	45110146	harbor1	chr19	44913972	44914427	LTR/ERV1	3524	+	228	44914200	4054
chr19	53679422	53879422	harbor1	chr19	53769073	53769384	LTR/ERV1	853	+	156	53769229	89807
chr19	18418725	18618725	harbor1	chr19	18439406	18439848	LTR/ERV1	723	+	221	18439627	20902
chr19	8218496	8418496	harbor1	chr19	8269895	8270163	LTR/ERV1	1186	+	134	8270029	51533
chr19	49678935	49878935	harbor1	chr19	49718672	49718801	LTR/ERV1	1603	+	64	49718736	39801
chr19	49678935	49878935	harbor1	chr19	49719110	49719414	LTR/ERV1	1603	+	152	49719262	40327
chr19	49678935	49878935	harbor1	chr19	49720688	49720863	LTR/ERV1	654	+	88	49720776	41841
chr19	49678935	49878935	harbor1	chr19	49722055	49722327	LTR/ERV1	1301	+	136	49722191	43256
chr19	49678935	49878935	harbor1	chr19	49724251	49724442	LTR/ERV1	911	+	96	49724347	45412
chr19	49678935	49878935	harbor1	chr19	49727163	49727741	LTR/ERV1	3887	+	289	49727452	48517
chr19	49678935	49878935	harbor1	chr19	49727742	49728063	LTR/ERV1	2039	+	160	49727902	48967
chr19	49678935	49878935	harbor1	chr19	49728379	49728810	LTR/ERV1	1746	+	216	49728595	49660
chr19	46184523	46384523	harbor1	chr19	46205120	46205748	LTR/ERV1	3157	+	314	46205434	20911
chr19	46184523	46384523	harbor1	chr19	46272654	46272753	LTR/ERV1	1068	+	50	46272704	88181
chr19	46184523	46384523	harbor1	chr19	46273066	46273186	LTR/ERV1	1068	+	60	46273126	88603
chr19	46184523	46384523	harbor1	chr19	46278853	46279137	LTR/ERV1	1524	+	142	46278995	94472
chr19	57883378	58083378	harbor1	chr19	57887511	57888152	LTR/ERV1	2774	+	320	57887831	4453
chr19	57883378	58083378	harbor1	chr19	57890886	57891243	LTR/ERV1	2817	+	178	57891064	7686
chr19	57883378	58083378	harbor1	chr19	57891540	57891569	LTR/ERV1	2817	+	14	57891554	8176
chr19	57883378	58083378	harbor1	chr19	57892052	57892251	LTR/ERV1	1635	+	100	57892152	8774
chr19	57883378	58083378	harbor1	chr19	57892252	57893158	LTR/ERV1	4805	+	453	57892705	9327
chr19	57883378	58083378	harbor1	chr19	57915507	57916213	LTR/ERV1	3085	+	353	57915860	32482
chr19	57883378	58083378	harbor1	chr19	57917557	57917966	LTR/ERV1	2932	+	204	57917761	34383
chr19	57883378	58083378	harbor1	chr19	57918246	57918301	LTR/ERV1	2932	+	28	57918274	34896
chr19	57883378	58083378	harbor1	chr19	57918767	57919313	LTR/ERV1	4278	+	273	57919040	35662
chr19	57883378	58083378	harbor1	chr19	57919621	57919669	LTR/ERV1	4278	+	24	57919645	36267
chr19	57883378	58083378	harbor1	chr19	57970090	57970535	LTR/ERV1	2480	+	222	57970312	86934
chr19	29868245	30068245	harbor1	chr19	29917339	29917800	LTR/ERV1	3165	+	230	29917569	49324
chr19	29868245	30068245	harbor1	chr19	29917972	29918258	LTR/ERV1	1631	+	143	29918115	49870
chr19	29868245	30068245	harbor1	chr19	29918752	29918789	LTR/ERV1	2391	+	18	29918770	50525
chr19	29868245	30068245	harbor1	chr19	29919110	29919506	LTR/ERV1	2391	+	198	29919308	51063
chr19	56659796	56859796	harbor1	chr19	56715804	56716051	LTR/ERV1	3080	+	124	56715928	56132
chr19	56659796	56859796	harbor1	chr19	56716365	56716624	LTR/ERV1	3080	+	130	56716495	56699
chr19	56659796	56859796	harbor1	chr19	56716930	56717042	LTR/ERV1	3080	+	56	56716986	57190
chr19	56659796	56859796	harbor1	chr19	56725069	56725522	LTR/ERV1	2623	+	226	56725295	65499
chr19	56659796	56859796	harbor1	chr19	56725524	56725685	LTR/ERV1	799	+	80	56725604	65808
chr19	56659796	56859796	harbor1	chr19	56725994	56726057	LTR/ERV1	656	+	32	56726026	66230
chr19	56659796	56859796	harbor1	chr19	56738446	56738995	LTR/ERV1	3193	+	274	56738720	78924
chr19	36253362	36453362	harbor1	chr19	36253662	36253694	LTR/ERV1	2483	+	16	36253678	316
chr19	36253362	36453362	harbor1	chr19	36253996	36254399	LTR/ERV1	2483	+	202	36254198	836
chr19	41967650	42167650	harbor1	chr19	42020458	42020881	LTR/ERV1	3466	+	212	42020670	53020
chr19	2849647	3049647	harbor1	chr19	2861434	2861994	LTR/ERV1	6537	+	280	2861714	12067
chr19	2849647	3049647	harbor1	chr19	2862311	2863021	LTR/ERV1	6537	+	355	2862666	13019
chr19	2849647	3049647	harbor1	chr19	2863332	2863471	LTR/ERV1	6537	+	70	2863402	13755
chr19	2849647	3049647	harbor1	chr19	2864202	2864418	LTR/ERV1	1216	+	108	2864310	14663
chr19	2849647	3049647	harbor1	chr19	2865339	2865813	LTR/ERV1	3199	+	237	2865576	15929
chr19	2849647	3049647	harbor1	chr19	2942616	2942814	LTR/ERV1	723	+	99	2942715	93068
chr19	2849647	3049647	harbor1	chr19	2943377	2943696	LTR/ERV1	711	+	160	2943537	93890
chr19	2849647	3049647	harbor1	chr19	2944010	2944029	LTR/ERV1	711	+	10	2944020	94373
chr19	2849647	3049647	harbor1	chr19	2945841	2946064	LTR/ERV1	732	+	112	2945953	96306
chr19	30699281	30899281	harbor1	chr19	30756080	30756535	LTR/ERV1	1454	+	228	30756308	57027
chr19	38724202	38924202	harbor1	chr19	38750493	38753013	LTR/ERV1	15638	+	1260	38751753	27551
chr19	38724202	38924202	harbor1	chr19	38753008	38753155	LTR/ERV1	825	+	74	38753082	28880
chr19	38724202	38924202	harbor1	chr19	38753146	38753648	LTR/ERV1	3220	+	251	38753397	29195
chr19	38724202	38924202	harbor1	chr19	38753651	38754296	LTR/ERV1	2602	+	322	38753973	29771
chr19	38724202	38924202	harbor1	chr19	38754298	38754514	LTR/ERV1	1211	+	108	38754406	30204
chr19	38724202	38924202	harbor1	chr19	38754515	38754888	LTR/ERV1	2246	+	186	38754701	30499
chr19	38724202	38924202	harbor1	chr19	38754889	38755295	LTR/ERV1	2713	+	203	38755092	30890
chr19	38724202	38924202	harbor1	chr19	38759648	38759886	LTR/ERV1	1102	+	119	38759767	35565
chr19	38724202	38924202	harbor1	chr19	38793391	38793705	LTR/ERV1	2148	+	157	38793548	69346
chr19	38724202	38924202	harbor1	chr19	38821337	38823305	LTR/ERV1	9317	+	984	38822321	98119
chr19	11839099	12039099	harbor1	chr19	11880363	11880887	LTR/ERV1	3946	+	262	11880625	41526
chr19	11839099	12039099	harbor1	chr19	11880890	11881977	LTR/ERV1	2223	+	544	11881434	42335
chr19	11839099	12039099	harbor1	chr19	11882682	11883250	LTR/ERV1	1544	+	284	11882966	43867
chr19	11839099	12039099	harbor1	chr19	11883491	11885229	LTR/ERV1	7917	+	869	11884360	45261
chr19	11839099	12039099	harbor1	chr19	11885526	11885997	LTR/ERV1	7917	+	236	11885762	46663
chr19	11839099	12039099	harbor1	chr19	11885998	11886023	LTR/ERV1	3550	+	12	11886010	46911
chr19	11839099	12039099	harbor1	chr19	11886327	11886834	LTR/ERV1	3550	+	254	11886581	47482
chr19	11839099	12039099	harbor1	chr19	11921894	11922481	LTR/ERV1	3369	+	294	11922188	83089
chr19	33771594	33971594	harbor1	chr19	33840867	33841279	LTR/ERV1	2271	+	206	33841073	69479
chr19	33771594	33971594	harbor1	chr19	33841613	33841699	LTR/ERV1	2271	+	43	33841656	70062
chr19	35509506	35709506	harbor1	chr19	35578890	35579252	LTR/ERV1	2511	+	181	35579071	69565
chr19	35509506	35709506	harbor1	chr19	35604596	35604970	LTR/ERV1	1792	+	187	35604783	95277
chr19	35509506	35709506	harbor1	chr19	35604971	35605415	LTR/ERV1	3078	+	222	35605193	95687
chr19	35509506	35709506	harbor1	chr19	35605725	35605975	LTR/ERV1	3078	+	125	35605850	96344
chr19	35509506	35709506	harbor1	chr19	35606347	35606371	LTR/ERV1	3078	+	12	35606359	96853
chr19	53618145	53818145	harbor1	chr19	53639480	53639740	LTR/ERV1	991	+	130	53639610	21465
chr19	53618145	53818145	harbor1	chr19	53643595	53643649	LTR/ERV1	1491	+	27	53643622	25477
chr19	53618145	53818145	harbor1	chr19	53643953	53644374	LTR/ERV1	1491	+	210	53644163	26018
chr19	53618145	53818145	harbor1	chr19	53649590	53649702	LTR/ERV1	2538	+	56	53649646	31501
chr19	53618145	53818145	harbor1	chr19	53650003	53650321	LTR/ERV1	2538	+	159	53650162	32017
chr19	53618145	53818145	harbor1	chr19	53650784	53651296	LTR/ERV1	3603	+	256	53651040	32895
chr19	53618145	53818145	harbor1	chr19	53651601	53651695	LTR/ERV1	3603	+	47	53651648	33503
chr19	53618145	53818145	harbor1	chr19	53652325	53652499	LTR/ERV1	1305	+	87	53652412	34267
chr19	53618145	53818145	harbor1	chr19	53652492	53653225	LTR/ERV1	3119	+	366	53652858	34713
chr19	53618145	53818145	harbor1	chr19	53654339	53654487	LTR/ERV1	877	+	74	53654413	36268
chr19	53618145	53818145	harbor1	chr19	53654477	53654950	LTR/ERV1	1827	+	236	53654713	36568
chr19	53618145	53818145	harbor1	chr19	53655149	53655634	LTR/ERV1	1706	+	242	53655391	37246
chr19	2341299	2541299	harbor1	chr19	2392568	2393567	LTR/ERV1	5125	+	500	2393068	51769
chr19	15745880	15945880	harbor1	chr19	15825860	15826094	LTR/ERV1	1002	+	117	15825977	80097
chr19	15745880	15945880	harbor1	chr19	15828738	15829200	LTR/ERV1	3697	+	231	15828969	83089
chr19	15745880	15945880	harbor1	chr19	15829202	15829645	LTR/ERV1	959	+	222	15829424	83544
chr19	15745880	15945880	harbor1	chr19	15829642	15834725	LTR/ERV1	10810	+	2542	15832184	86304
chr19	15745880	15945880	harbor1	chr19	15835691	15836170	LTR/ERV1	3565	+	240	15835931	90051
chr19	15745880	15945880	harbor1	chr19	15837284	15837348	LTR/ERV1	3916	+	32	15837316	91436
chr19	15745880	15945880	harbor1	chr19	15837933	15838455	LTR/ERV1	3916	+	261	15838194	92314
chr19	504314	704314	harbor1	chr19	504984	505370	LTR/ERV1	1805	+	193	505177	863
chr19	504314	704314	harbor1	chr19	571083	571344	LTR/ERV1	999	+	130	571213	66899
chr19	56430803	56630803	harbor1	chr19	56466899	56467062	LTR/ERV1	1054	+	82	56466981	36178
chr19	56430803	56630803	harbor1	chr19	56468269	56468678	LTR/ERV1	2259	+	204	56468473	37670
chr19	56430803	56630803	harbor1	chr19	56499358	56500000	LTR/ERV1	4569	+	321	56499679	68876
chr19	56430803	56630803	harbor1	chr19	56500001	56500113	LTR/ERV1	953	+	56	56500057	69254
chr19	56430803	56630803	harbor1	chr19	56500114	56500266	LTR/ERV1	1153	+	76	56500190	69387
chr19	56430803	56630803	harbor1	chr19	56500267	56500616	LTR/ERV1	1164	+	174	56500441	69638
chr19	39184071	39384071	harbor1	chr19	39249212	39249256	LTR/ERV1	2350	+	22	39249234	65163
chr19	39184071	39384071	harbor1	chr19	39249550	39249937	LTR/ERV1	2350	+	194	39249744	65673
chr19	39184071	39384071	harbor1	chr19	39250230	39250379	LTR/ERV1	2350	+	74	39250304	66233
chr19	39184071	39384071	harbor1	chr19	39262602	39262849	LTR/ERV1	1284	+	124	39262726	78655
chr19	39184071	39384071	harbor1	chr19	39263037	39263247	LTR/ERV1	1844	+	105	39263142	79071
chr19	39184071	39384071	harbor1	chr19	39263547	39263676	LTR/ERV1	1844	+	64	39263611	79540
chr19	56704905	56904905	harbor1	chr19	56715804	56716051	LTR/ERV1	3080	+	124	56715928	11023
chr19	56704905	56904905	harbor1	chr19	56716365	56716624	LTR/ERV1	3080	+	130	56716495	11590
chr19	56704905	56904905	harbor1	chr19	56716930	56717042	LTR/ERV1	3080	+	56	56716986	12081
chr19	56704905	56904905	harbor1	chr19	56725069	56725522	LTR/ERV1	2623	+	226	56725295	20390
chr19	56704905	56904905	harbor1	chr19	56725524	56725685	LTR/ERV1	799	+	80	56725604	20699
chr19	56704905	56904905	harbor1	chr19	56725994	56726057	LTR/ERV1	656	+	32	56726026	21121
chr19	56704905	56904905	harbor1	chr19	56738446	56738995	LTR/ERV1	3193	+	274	56738720	33815
chr19	56704905	56904905	harbor1	chr19	56797892	56798339	LTR/ERV1	1731	+	224	56798116	93211
chr19	56704905	56904905	harbor1	chr19	56800219	56800934	LTR/ERV1	2544	+	358	56800577	95672
chr19	56704905	56904905	harbor1	chr19	56801236	56801300	LTR/ERV1	1095	+	32	56801268	96363
chr19	84081	284081	harbor1	chr19	177648	177928	LTR/ERV1	821	+	140	177788	93707
chr19	30702719	30902719	harbor1	chr19	30756080	30756535	LTR/ERV1	1454	+	228	30756308	53589
chr19	21940421	22140421	harbor1	chr19	21944823	21945428	LTR/ERV1	3326	+	302	21945125	4704
chr19	21940421	22140421	harbor1	chr19	21945796	21946630	LTR/ERV1	5098	+	417	21946213	5792
chr19	21940421	22140421	harbor1	chr19	21946631	21950488	LTR/ERV1	19794	+	1928	21948559	8138
chr19	21940421	22140421	harbor1	chr19	21950795	21951669	LTR/ERV1	19794	+	437	21951232	10811
chr19	21940421	22140421	harbor1	chr19	21956973	21957037	LTR/ERV1	7352	+	32	21957005	16584
chr19	21940421	22140421	harbor1	chr19	21957337	21957837	LTR/ERV1	7352	+	250	21957587	17166
chr19	21940421	22140421	harbor1	chr19	21958157	21958834	LTR/ERV1	7352	+	338	21958495	18074
chr19	21940421	22140421	harbor1	chr19	22005853	22006355	LTR/ERV1	1085	+	251	22006104	65683
chr19	21940421	22140421	harbor1	chr19	22009332	22009467	LTR/ERV1	2827	+	68	22009400	68979
chr19	21940421	22140421	harbor1	chr19	22009765	22009903	LTR/ERV1	2827	+	69	22009834	69413
chr19	21940421	22140421	harbor1	chr19	22010213	22010440	LTR/ERV1	2827	+	114	22010327	69906
chr19	21940421	22140421	harbor1	chr19	22036807	22037060	LTR/ERV1	1399	+	126	22036933	96512
chr19	21940421	22140421	harbor1	chr19	22037388	22038057	LTR/ERV1	8617	+	334	22037722	97301
chr19	21940421	22140421	harbor1	chr19	22038357	22038852	LTR/ERV1	8617	+	248	22038605	98184
chr19	21940421	22140421	harbor1	chr19	22039150	22039424	LTR/ERV1	8617	+	137	22039287	98866
chr19	3132699	3332699	harbor1	chr19	3153003	3153196	LTR/ERV1	1410	+	96	3153099	20400
chr19	11757892	11957892	harbor1	chr19	11794168	11794683	LTR/ERV1	3799	+	258	11794426	36534
chr19	43776277	43976277	harbor1	chr19	43804138	43804340	LTR/ERV1	1040	+	101	43804239	27962
chr19	43776277	43976277	harbor1	chr19	43804413	43804587	LTR/ERV1	650	+	87	43804500	28223
chr19	43776277	43976277	harbor1	chr19	43819587	43820045	LTR/ERV1	3282	+	229	43819816	43539
chr19	52541081	52741081	harbor1	chr19	52565332	52565989	LTR/ERV1	3216	+	328	52565660	24579
chr19	52541081	52741081	harbor1	chr19	52566700	52566957	LTR/ERV1	1967	+	128	52566828	25747
chr19	52541081	52741081	harbor1	chr19	52567252	52567416	LTR/ERV1	1967	+	82	52567334	26253
chr19	52541081	52741081	harbor1	chr19	52568439	52568781	LTR/ERV1	1609	+	171	52568610	27529
chr19	52541081	52741081	harbor1	chr19	52568783	52569217	LTR/ERV1	1544	+	217	52569000	27919
chr19	52541081	52741081	harbor1	chr19	52599207	52599321	LTR/ERV1	1722	+	57	52599264	58183
chr19	52541081	52741081	harbor1	chr19	52599322	52599790	LTR/ERV1	2142	+	234	52599556	58475
chr19	52541081	52741081	harbor1	chr19	52599791	52600214	LTR/ERV1	1722	+	212	52600003	58922
chr19	52541081	52741081	harbor1	chr19	52605724	52606009	LTR/ERV1	1471	+	142	52605866	64785
chr19	52541081	52741081	harbor1	chr19	52620684	52621112	LTR/ERV1	2642	+	214	52620898	79817
chr19	52541081	52741081	harbor1	chr19	52621127	52625394	LTR/ERV1	15573	+	2134	52623261	82180
chr19	52541081	52741081	harbor1	chr19	52626894	52627315	LTR/ERV1	2526	+	210	52627104	86023
chr19	52541081	52741081	harbor1	chr19	52627795	52628192	LTR/ERV1	2504	+	198	52627993	86912
chr19	52541081	52741081	harbor1	chr19	52628195	52631191	LTR/ERV1	20769	+	1498	52629693	88612
chr19	52541081	52741081	harbor1	chr19	52631171	52631318	LTR/ERV1	888	+	74	52631245	90164
chr19	52541081	52741081	harbor1	chr19	52631318	52631810	LTR/ERV1	3562	+	246	52631564	90483
chr19	52541081	52741081	harbor1	chr19	52631813	52632449	LTR/ERV1	4188	+	318	52632131	91050
chr19	52541081	52741081	harbor1	chr19	52632451	52632666	LTR/ERV1	1319	+	108	52632559	91478
chr19	52541081	52741081	harbor1	chr19	52632667	52633045	LTR/ERV1	2391	+	189	52632856	91775
chr19	52541081	52741081	harbor1	chr19	52633046	52633395	LTR/ERV1	2114	+	174	52633220	92139
chr19	52541081	52741081	harbor1	chr19	52625393	52626863	LTR/ERV1	8555	+	735	52626128	85047
chr19	35446792	35646792	harbor1	chr19	35471700	35471866	LTR/ERV1	5450	+	83	35471783	24991
chr19	35446792	35646792	harbor1	chr19	35481181	35481492	LTR/ERV1	2338	+	156	35481337	34545
chr19	35446792	35646792	harbor1	chr19	35481794	35481930	LTR/ERV1	2338	+	68	35481862	35070
chr19	35446792	35646792	harbor1	chr19	35482233	35482310	LTR/ERV1	2338	+	38	35482271	35479
chr19	35446792	35646792	harbor1	chr19	35486444	35486904	LTR/ERV1	3353	+	230	35486674	39882
chr19	35446792	35646792	harbor1	chr19	35470815	35471397	LTR/ERV1	5450	+	291	35471106	24314
chr19	43032942	43232942	harbor1	chr19	43043134	43043878	LTR/ERV1	3568	+	372	43043506	10564
chr19	43032942	43232942	harbor1	chr19	43045234	43045311	LTR/ERV1	3536	+	38	43045272	12330
chr19	43032942	43232942	harbor1	chr19	43045982	43046858	LTR/ERV1	3536	+	438	43046420	13478
chr19	43032942	43232942	harbor1	chr19	43057400	43057608	LTR/ERV1	1133	+	104	43057504	24562
chr19	43032942	43232942	harbor1	chr19	43058396	43058607	LTR/ERV1	715	+	106	43058502	25560
chr19	43032942	43232942	harbor1	chr19	43078081	43078833	LTR/ERV1	1986	+	376	43078457	45515
chr19	43032942	43232942	harbor1	chr19	43099221	43099966	LTR/ERV1	3564	+	372	43099593	66651
chr19	43032942	43232942	harbor1	chr19	43105492	43106099	LTR/ERV1	3988	+	304	43105796	72854
chr19	43032942	43232942	harbor1	chr19	43106771	43107647	LTR/ERV1	3988	+	438	43107209	74267
chr19	43032942	43232942	harbor1	chr19	43125899	43126443	LTR/ERV1	4611	+	272	43126171	93229
chr19	43032942	43232942	harbor1	chr19	43126877	43127048	LTR/ERV1	1234	+	86	43126963	94021
chr19	39512570	39712570	harbor1	chr19	39546714	39547161	LTR/ERV1	2060	+	224	39546938	34368
chr19	7025051	7225051	harbor1	chr19	7092315	7092804	LTR/ERV1	3472	+	244	7092559	67508
chr19	7025051	7225051	harbor1	chr19	7094818	7095317	LTR/ERV1	3653	+	250	7095068	70017
chr19	7025051	7225051	harbor1	chr19	7099778	7100154	LTR/ERV1	2542	+	188	7099966	74915
chr19	7025051	7225051	harbor1	chr19	7100975	7100985	LTR/ERV1	2542	+	5	7100980	75929
chr19	7025051	7225051	harbor1	chr19	7101030	7101223	LTR/ERV1	2542	+	96	7101126	76075
chr19	7025051	7225051	harbor1	chr19	7101530	7101626	LTR/ERV1	809	+	48	7101578	76527
chr19	7025051	7225051	harbor1	chr19	7119990	7120438	LTR/ERV1	3256	+	224	7120214	95163
chr19	11472338	11672338	harbor1	chr19	11563355	11563531	LTR/ERV1	1672	+	88	11563443	91105
chr19	11472338	11672338	harbor1	chr19	11563833	11564039	LTR/ERV1	1672	+	103	11563936	91598
chr19	11472338	11672338	harbor1	chr19	11564336	11564351	LTR/ERV1	700	+	8	11564344	92006
chr19	11472338	11672338	harbor1	chr19	11564647	11564860	LTR/ERV1	1093	+	106	11564753	92415
chr19	37737411	37937411	harbor1	chr19	37756047	37756780	LTR/ERV1	1148	+	366	37756413	19002
chr19	37737411	37937411	harbor1	chr19	37761313	37761953	LTR/ERV1	3960	+	320	37761633	24222
chr19	37737411	37937411	harbor1	chr19	37766321	37766748	LTR/ERV1	1207	+	214	37766535	29124
chr19	37737411	37937411	harbor1	chr19	37766856	37767233	LTR/ERV1	2338	+	188	37767044	29633
chr19	37737411	37937411	harbor1	chr19	37767532	37767687	LTR/ERV1	2338	+	78	37767610	30199
chr19	37737411	37937411	harbor1	chr19	37795386	37795563	LTR/ERV1	768	+	88	37795474	58063
chr19	55409140	55609140	harbor1	chr19	55419211	55420356	LTR/ERV1	5961	+	572	55419783	10643
chr19	50038465	50238465	harbor1	chr19	50051734	50052026	LTR/ERV1	1142	+	146	50051880	13415
chr19	40038073	40238073	harbor1	chr19	40071941	40072014	LTR/ERV1	650	+	36	40071977	33904
chr19	40038073	40238073	harbor1	chr19	40072037	40072328	LTR/ERV1	2312	+	146	40072183	34110
chr19	40038073	40238073	harbor1	chr19	40072329	40072654	LTR/ERV1	2573	+	162	40072491	34418
chr20	61370575	61570575	harbor1	chr20	61374584	61374709	LTR/ERV1	595	+	62	61374646	4071
chr20	61370575	61570575	harbor1	chr20	61374711	61375235	LTR/ERV1	2285	+	262	61374973	4398
chr20	17757330	17957330	harbor1	chr20	17781165	17781603	LTR/ERV1	1406	+	219	17781384	24054
chr20	44779652	44979652	harbor1	chr20	44840891	44841388	LTR/ERV1	2446	+	248	44841139	61487
chr20	44779652	44979652	harbor1	chr20	44856571	44856751	LTR/ERV1	1148	+	90	44856661	77009
chr20	44779652	44979652	harbor1	chr20	44857037	44857324	LTR/ERV1	1360	+	144	44857181	77529
chr20	44779652	44979652	harbor1	chr20	44863445	44864118	LTR/ERV1	4583	+	336	44863781	84129
chr20	44779652	44979652	harbor1	chr20	44878837	44879161	LTR/ERV1	1135	+	162	44878999	99347
chr20	44779652	44979652	harbor1	chr20	44879462	44879599	LTR/ERV1	1135	+	68	44879530	99878
chr20	30361425	30561425	harbor1	chr20	30363779	30364123	LTR/ERV1	807	+	172	30363951	2526
chr20	30361425	30561425	harbor1	chr20	30369541	30369952	LTR/ERV1	1164	+	206	30369747	8322
chr20	20691771	20891771	harbor1	chr20	20738765	20739136	LTR/ERV1	2505	+	186	20738951	47180
chr20	20691771	20891771	harbor1	chr20	20748800	20749293	LTR/ERV1	3475	+	246	20749046	57275
chr20	20691771	20891771	harbor1	chr20	20768266	20770047	LTR/ERV1	9356	+	890	20769156	77385
chr20	20691771	20891771	harbor1	chr20	20778884	20779321	LTR/ERV1	1959	+	218	20779102	87331
chr20	20691771	20891771	harbor1	chr20	20779608	20779954	LTR/ERV1	1959	+	173	20779781	88010
chr20	41219839	41419839	harbor1	chr20	41312062	41312542	LTR/ERV1	2980	+	240	41312302	92463
chr20	18831823	19031823	harbor1	chr20	18837535	18838390	LTR/ERV1	4923	+	428	18837963	6140
chr20	18831823	19031823	harbor1	chr20	18907692	18908217	LTR/ERV1	3654	+	262	18907954	76131
chr20	18831823	19031823	harbor1	chr20	18910936	18911808	LTR/ERV1	5894	+	436	18911372	79549
chr20	18831823	19031823	harbor1	chr20	18919756	18920430	LTR/ERV1	3613	+	337	18920093	88270
chr20	29332595	29532595	harbor1	chr20	29376749	29376885	LTR/ERV1	703	+	68	29376817	44222
chr20	29332595	29532595	harbor1	chr20	29402695	29403573	LTR/ERV1	5889	+	439	29403134	70539
chr20	29332595	29532595	harbor1	chr20	29403847	29404083	LTR/ERV1	5889	+	118	29403965	71370
chr20	29332595	29532595	harbor1	chr20	29404111	29404654	LTR/ERV1	3361	+	272	29404383	71788
chr20	23158929	23358929	harbor1	chr20	23202288	23202732	LTR/ERV1	2041	+	222	23202510	43581
chr20	23158929	23358929	harbor1	chr20	23203870	23204342	LTR/ERV1	1143	+	236	23204106	45177
chr20	23158929	23358929	harbor1	chr20	23204386	23205005	LTR/ERV1	2044	+	310	23204696	45767
chr20	23158929	23358929	harbor1	chr20	23243758	23244244	LTR/ERV1	2512	+	243	23244001	85072
chr20	13106023	13306023	harbor1	chr20	13162582	13162984	LTR/ERV1	940	+	201	13162783	56760
chr20	13106023	13306023	harbor1	chr20	13188762	13189189	LTR/ERV1	2834	+	214	13188976	82953
chr20	59455789	59655789	harbor1	chr20	59476557	59476650	LTR/ERV1	508	+	46	59476603	20814
chr20	59455789	59655789	harbor1	chr20	59476817	59477353	LTR/ERV1	1934	+	268	59477085	21296
chr20	59455789	59655789	harbor1	chr20	59527449	59528248	LTR/ERV1	5115	+	400	59527849	72060
chr20	59455789	59655789	harbor1	chr20	59543419	59543868	LTR/ERV1	1246	+	224	59543643	87854
chr20	55891299	56091299	harbor1	chr20	55918801	55919346	LTR/ERV1	3855	+	272	55919073	27774
chr20	55891299	56091299	harbor1	chr20	55973545	55974329	LTR/ERV1	3858	+	392	55973937	82638
chr20	29366170	29566170	harbor1	chr20	29376749	29376885	LTR/ERV1	703	+	68	29376817	10647
chr20	29366170	29566170	harbor1	chr20	29402695	29403573	LTR/ERV1	5889	+	439	29403134	36964
chr20	29366170	29566170	harbor1	chr20	29403847	29404083	LTR/ERV1	5889	+	118	29403965	37795
chr20	29366170	29566170	harbor1	chr20	29404111	29404654	LTR/ERV1	3361	+	272	29404383	38213
chr20	29366170	29566170	harbor1	chr20	29464606	29464822	LTR/ERV1	1282	+	108	29464714	98544
chr20	29366170	29566170	harbor1	chr20	29464824	29465089	LTR/ERV1	1714	+	132	29464956	98786
chr20	22657682	22857682	harbor1	chr20	22721658	22722113	LTR/ERV1	1846	+	228	22721886	64204
chr20	30197384	30397384	harbor1	chr20	30252026	30252455	LTR/ERV1	2690	+	214	30252240	54856
chr20	30197384	30397384	harbor1	chr20	30252456	30252762	LTR/ERV1	2942	+	153	30252609	55225
chr20	30197384	30397384	harbor1	chr20	30253064	30253317	LTR/ERV1	2942	+	126	30253190	55806
chr20	35958756	36158756	harbor1	chr20	35966793	35967234	LTR/ERV1	2152	+	220	35967013	8257
chr20	20127999	20327999	harbor1	chr20	20218951	20219305	LTR/ERV1	801	+	177	20219128	91129
chr20	58030911	58230911	harbor1	chr20	58098123	58098233	LTR/ERV1	681	+	55	58098178	67267
chr20	23018105	23218105	harbor1	chr20	23020428	23021052	LTR/ERV1	4468	+	312	23020740	2635
chr20	23018105	23218105	harbor1	chr20	23023530	23023925	LTR/ERV1	2919	+	198	23023728	5623
chr20	23018105	23218105	harbor1	chr20	23024333	23024468	LTR/ERV1	2919	+	68	23024401	6296
chr20	23018105	23218105	harbor1	chr20	23059641	23060311	LTR/ERV1	4007	+	335	23059976	41871
chr20	23018105	23218105	harbor1	chr20	23070173	23070316	LTR/ERV1	459	+	72	23070245	52140
chr20	23018105	23218105	harbor1	chr20	23070623	23070780	LTR/ERV1	459	+	78	23070701	52596
chr20	44269064	44469064	harbor1	chr20	44298950	44300378	LTR/ERV1	10858	+	714	44299664	30600
chr20	44269064	44469064	harbor1	chr20	44319907	44320312	LTR/ERV1	1537	+	202	44320109	51045
chr20	10417114	10617114	harbor1	chr20	10483783	10484230	LTR/ERV1	1131	+	224	10484007	66893
chr20	41546184	41746184	harbor1	chr20	41553244	41553781	LTR/ERV1	2195	+	268	41553512	7328
chr20	41546184	41746184	harbor1	chr20	41574788	41575372	LTR/ERV1	3389	+	292	41575080	28896
chr20	41546184	41746184	harbor1	chr20	41585864	41586624	LTR/ERV1	5714	+	380	41586244	40060
chr20	41546184	41746184	harbor1	chr20	41594586	41595016	LTR/ERV1	1649	+	215	41594801	48617
chr20	41546184	41746184	harbor1	chr20	41595017	41597276	LTR/ERV1	11735	+	1130	41596147	49963
chr20	41546184	41746184	harbor1	chr20	41599676	41600107	LTR/ERV1	1644	+	216	41599892	53708
chr20	41546184	41746184	harbor1	chr20	41597270	41599672	LTR/ERV1	11454	+	1201	41598471	52287
chr20	9402040	9602040	harbor1	chr20	9412559	9412941	LTR/ERV1	971	+	191	9412750	10710
chr20	31506248	31706248	harbor1	chr20	31585586	31585972	LTR/ERV1	2157	+	193	31585779	79531
chr20	31506248	31706248	harbor1	chr20	31586271	31586477	LTR/ERV1	2157	+	103	31586374	80126
chr20	31506248	31706248	harbor1	chr20	31506028	31506546	LTR/ERV1	3702	+	259	31506287	39
chr20	39446282	39646282	harbor1	chr20	39482540	39483717	LTR/ERV1	8007	+	588	39483128	36846
chr20	39446282	39646282	harbor1	chr20	39486770	39487053	LTR/ERV1	2036	+	142	39486912	40630
chr20	39446282	39646282	harbor1	chr20	39487138	39488453	LTR/ERV1	9284	+	658	39487796	41514
chr20	39446282	39646282	harbor1	chr20	39488558	39489051	LTR/ERV1	2424	+	246	39488804	42522
chr20	42133499	42333499	harbor1	chr20	42148595	42149132	LTR/ERV1	2540	+	268	42148863	15364
chr20	59417815	59617815	harbor1	chr20	59476557	59476650	LTR/ERV1	508	+	46	59476603	58788
chr20	59417815	59617815	harbor1	chr20	59476817	59477353	LTR/ERV1	1934	+	268	59477085	59270
chr20	23678846	23878846	harbor1	chr20	23682898	23683476	LTR/ERV1	1483	+	289	23683187	4341
chr20	23678846	23878846	harbor1	chr20	23693631	23693938	LTR/ERV1	1059	+	154	23693785	14939
chr20	23678846	23878846	harbor1	chr20	23708538	23708673	LTR/ERV1	1085	+	68	23708606	29760
chr20	23678846	23878846	harbor1	chr20	23708673	23709075	LTR/ERV1	1335	+	201	23708874	30028
chr20	23678846	23878846	harbor1	chr20	23735751	23736388	LTR/ERV1	4697	+	318	23736069	57223
chr20	23678846	23878846	harbor1	chr20	23741359	23742103	LTR/ERV1	6036	+	372	23741731	62885
chr20	23678846	23878846	harbor1	chr20	23742104	23742764	LTR/ERV1	5131	+	330	23742434	63588
chr20	23678846	23878846	harbor1	chr20	23744824	23745403	LTR/ERV1	1501	+	290	23745114	66268
chr20	23678846	23878846	harbor1	chr20	23755558	23755866	LTR/ERV1	1039	+	154	23755712	76866
chr20	23678846	23878846	harbor1	chr20	23764763	23765176	LTR/ERV1	2741	+	206	23764969	86123
chr20	23678846	23878846	harbor1	chr20	23771148	23771283	LTR/ERV1	1071	+	68	23771216	92370
chr20	23678846	23878846	harbor1	chr20	23771283	23771548	LTR/ERV1	1199	+	132	23771415	92569
chr20	23678846	23878846	harbor1	chr20	23736389	23741266	LTR/ERV1	36357	+	2438	23738827	59981
chr20	1999665	2199665	harbor1	chr20	2040802	2041342	LTR/ERV1	2833	+	270	2041072	41407
chr20	1999665	2199665	harbor1	chr20	2056755	2057181	LTR/ERV1	1972	+	213	2056968	57303
chr20	25506175	25706175	harbor1	chr20	25534009	25534369	LTR/ERV1	1763	+	180	25534189	28014
chr20	25506175	25706175	harbor1	chr20	25543462	25543909	LTR/ERV1	1919	+	224	25543686	37511
chr20	25506175	25706175	harbor1	chr20	25545451	25546227	LTR/ERV1	3264	+	388	25545839	39664
chr20	25506175	25706175	harbor1	chr20	25542609	25542697	LTR/ERV1	515	+	44	25542653	36478
chr21	24631959	24831959	harbor1	chr21	24635263	24635597	LTR/ERV1	3874	+	167	24635430	3471
chr21	24631959	24831959	harbor1	chr21	24635923	24636327	LTR/ERV1	3874	+	202	24636125	4166
chr21	24631959	24831959	harbor1	chr21	24636657	24636920	LTR/ERV1	884	+	132	24636789	4830
chr21	24631959	24831959	harbor1	chr21	24638915	24639393	LTR/ERV1	3917	+	239	24639154	7195
chr21	24631959	24831959	harbor1	chr21	24640178	24641072	LTR/ERV1	4962	+	447	24640625	8666
chr21	24631959	24831959	harbor1	chr21	24686088	24687213	LTR/ERV1	4486	+	562	24686650	54691
chr21	24631959	24831959	harbor1	chr21	24687220	24687730	LTR/ERV1	2286	+	255	24687475	55516
chr21	24631959	24831959	harbor1	chr21	24687735	24688182	LTR/ERV1	1444	+	224	24687959	56000
chr21	24631959	24831959	harbor1	chr21	24657684	24658476	LTR/ERV1	4024	+	396	24658080	26121
chr21	24631959	24831959	harbor1	chr21	24674163	24674980	LTR/ERV1	3959	+	408	24674571	42612
chr21	34625073	34825073	harbor1	chr21	34641199	34641807	LTR/ERV1	4139	+	304	34641503	16430
chr21	15635602	15835602	harbor1	chr21	15638601	15639147	LTR/ERV1	3209	+	273	15638874	3272
chr21	15635602	15835602	harbor1	chr21	15660521	15660919	LTR/ERV1	1801	+	199	15660720	25118
chr21	15635602	15835602	harbor1	chr21	15724286	15724885	LTR/ERV1	2013	+	300	15724586	88984
chr21	30498359	30698359	harbor1	chr21	30568861	30569629	LTR/ERV1	3471	+	384	30569245	70886
chr21	14491627	14691627	harbor1	chr21	14491406	14491837	LTR/ERV1	2572	+	216	14491622	5
chr21	14491627	14691627	harbor1	chr21	14520583	14520971	LTR/ERV1	2422	+	194	14520777	29150
chr21	14491627	14691627	harbor1	chr21	14560308	14560495	LTR/ERV1	916	+	94	14560402	68775
chr21	14491627	14691627	harbor1	chr21	14560932	14561467	LTR/ERV1	2227	+	268	14561200	69573
chr21	14612836	14812836	harbor1	chr21	14700300	14700616	LTR/ERV1	749	+	158	14700458	87622
chr21	20000894	20200894	harbor1	chr21	20043515	20043930	LTR/ERV1	2470	+	208	20043723	42829
chr21	20000894	20200894	harbor1	chr21	20055950	20056198	LTR/ERV1	1527	+	124	20056074	55180
chr21	20000894	20200894	harbor1	chr21	20056526	20056657	LTR/ERV1	1545	+	66	20056592	55698
chr21	20000894	20200894	harbor1	chr21	20064134	20064730	LTR/ERV1	2074	+	298	20064432	63538
chr21	20000894	20200894	harbor1	chr21	20004426	20004940	LTR/ERV1	3216	+	257	20004683	3789
chr21	37130125	37330125	harbor1	chr21	37219659	37220246	LTR/ERV1	4144	+	294	37219953	89828
chr21	5817152	6017152	harbor1	chr21	5858475	5858729	LTR/ERV1	1078	+	127	5858602	41450
chr21	24448367	24648367	harbor1	chr21	24509556	24509779	LTR/ERV1	1361	+	112	24509668	61301
chr21	44467263	44667263	harbor1	chr21	44471201	44471981	LTR/ERV1	5514	+	390	44471591	4328
chr21	44467263	44667263	harbor1	chr21	44475207	44475796	LTR/ERV1	3440	+	294	44475501	8238
chr21	44467263	44667263	harbor1	chr21	44475873	44476116	LTR/ERV1	5095	+	122	44475995	8732
chr21	44467263	44667263	harbor1	chr21	44476461	44477031	LTR/ERV1	5095	+	285	44476746	9483
chr21	44467263	44667263	harbor1	chr21	44477078	44477482	LTR/ERV1	2406	+	202	44477280	10017
chr21	44467263	44667263	harbor1	chr21	44477477	44477617	LTR/ERV1	754	+	70	44477547	10284
chr21	44467263	44667263	harbor1	chr21	44483327	44483453	LTR/ERV1	4289	+	63	44483390	16127
chr21	44467263	44667263	harbor1	chr21	44485340	44486157	LTR/ERV1	4857	+	408	44485748	18485
chr21	44467263	44667263	harbor1	chr21	44486257	44486763	LTR/ERV1	2935	+	253	44486510	19247
chr21	44467263	44667263	harbor1	chr21	44487936	44490230	LTR/ERV1	15851	+	1147	44489083	21820
chr21	44467263	44667263	harbor1	chr21	44490231	44491111	LTR/ERV1	5043	+	440	44490671	23408
chr21	44467263	44667263	harbor1	chr21	44492510	44493069	LTR/ERV1	3402	+	280	44492790	25527
chr21	44467263	44667263	harbor1	chr21	44493648	44494091	LTR/ERV1	992	+	222	44493870	26607
chr21	44467263	44667263	harbor1	chr21	44496860	44497012	LTR/ERV1	454	+	76	44496936	29673
chr21	44467263	44667263	harbor1	chr21	44497239	44497628	LTR/ERV1	1340	+	194	44497433	30170
chr21	44467263	44667263	harbor1	chr21	44482550	44483021	LTR/ERV1	4289	+	236	44482786	15523
chr21	42450690	42650690	harbor1	chr21	42465891	42466173	LTR/ERV1	3797	+	141	42466032	15342
chr21	42450690	42650690	harbor1	chr21	42466485	42466951	LTR/ERV1	3797	+	233	42466718	16028
chr21	42450690	42650690	harbor1	chr21	42497881	42498211	LTR/ERV1	1909	+	165	42498046	47356
chr21	42450690	42650690	harbor1	chr21	42498190	42498647	LTR/ERV1	2472	+	228	42498418	47728
chr21	7083683	7283683	harbor1	chr21	7086838	7087255	LTR/ERV1	1372	+	208	7087046	3363
chr21	7083683	7283683	harbor1	chr21	7095793	7096349	LTR/ERV1	4021	+	278	7096071	12388
chr21	7083683	7283683	harbor1	chr21	7096753	7096821	LTR/ERV1	4021	+	34	7096787	13104
chr21	7083683	7283683	harbor1	chr21	7100502	7100985	LTR/ERV1	3063	+	242	7100744	17061
chr21	7083683	7283683	harbor1	chr21	7101181	7101834	LTR/ERV1	1622	+	326	7101507	17824
chr21	7083683	7283683	harbor1	chr21	7102444	7103101	LTR/ERV1	2921	+	328	7102772	19089
chr21	7083683	7283683	harbor1	chr21	7103102	7103328	LTR/ERV1	3436	+	113	7103215	19532
chr21	7083683	7283683	harbor1	chr21	7103629	7104008	LTR/ERV1	3436	+	190	7103819	20136
chr21	20256392	20456392	harbor1	chr21	20270900	20271368	LTR/ERV1	3776	+	234	20271134	14742
chr21	20256392	20456392	harbor1	chr21	20273813	20274221	LTR/ERV1	2335	+	204	20274017	17625
chr21	20256392	20456392	harbor1	chr21	20276419	20276587	LTR/ERV1	666	+	84	20276503	20111
chr21	20256392	20456392	harbor1	chr21	20276590	20276692	LTR/ERV1	629	+	51	20276641	20249
chr21	20256392	20456392	harbor1	chr21	20279899	20280134	LTR/ERV1	648	+	118	20280017	23625
chr21	20256392	20456392	harbor1	chr21	20280819	20280911	LTR/ERV1	685	+	46	20280865	24473
chr21	20256392	20456392	harbor1	chr21	20347377	20347974	LTR/ERV1	1386	+	298	20347675	91283
chr21	20256392	20456392	harbor1	chr21	20355029	20355332	LTR/ERV1	874	+	152	20355181	98789
chr21	34311097	34511097	harbor1	chr21	34406663	34407077	LTR/ERV1	2064	+	207	34406870	95773
chr21	34311097	34511097	harbor1	chr21	34373072	34373731	LTR/ERV1	1058	+	330	34373402	62305
chr21	16792096	16992096	harbor1	chr21	16888170	16888779	LTR/ERV1	770	+	304	16888474	96378
chr21	39743786	39943786	harbor1	chr21	39813161	39813696	LTR/ERV1	1458	+	268	39813429	69643
chr21	15464659	15664659	harbor1	chr21	15523559	15523860	LTR/ERV1	1880	+	150	15523709	59050
chr21	15464659	15664659	harbor1	chr21	15523879	15524248	LTR/ERV1	2660	+	184	15524063	59404
chr21	15464659	15664659	harbor1	chr21	15557404	15557828	LTR/ERV1	1764	+	212	15557616	92957
chr21	15464659	15664659	harbor1	chr21	15557829	15558458	LTR/ERV1	3032	+	314	15558143	93484
chr21	15464659	15664659	harbor1	chr21	15558459	15558574	LTR/ERV1	1764	+	58	15558517	93858
chr21	44316983	44516983	harbor1	chr21	44339863	44340066	LTR/ERV1	2051	+	102	44339965	22982
chr21	44316983	44516983	harbor1	chr21	44340067	44340790	LTR/ERV1	3306	+	362	44340429	23446
chr21	44316983	44516983	harbor1	chr21	44340791	44341132	LTR/ERV1	2051	+	170	44340961	23978
chr21	44316983	44516983	harbor1	chr21	44342598	44342928	LTR/ERV1	1675	+	165	44342763	25780
chr21	44316983	44516983	harbor1	chr21	44342940	44343061	LTR/ERV1	742	+	60	44343000	26017
chr21	44316983	44516983	harbor1	chr21	44346310	44346720	LTR/ERV1	2746	+	205	44346515	29532
chr21	32838069	33038069	harbor1	chr21	32886065	32886624	LTR/ERV1	3335	+	280	32886345	48276
chr21	32838069	33038069	harbor1	chr21	32902063	32902364	LTR/ERV1	451	+	150	32902213	64144
chr21	32838069	33038069	harbor1	chr21	32902984	32903428	LTR/ERV1	2684	+	222	32903206	65137
chr21	33991353	34191353	harbor1	chr21	34042124	34042725	LTR/ERV1	3500	+	300	34042424	51071
chr21	44997121	45197121	harbor1	chr21	45032132	45032373	LTR/ERV1	814	+	120	45032252	35131
chr21	19130418	19330418	harbor1	chr21	19130119	19130640	LTR/ERV1	2144	+	260	19130379	39
chr21	19130418	19330418	harbor1	chr21	19142350	19142500	LTR/ERV1	1450	+	75	19142425	12007
chr21	19130418	19330418	harbor1	chr21	19142804	19143141	LTR/ERV1	1450	+	168	19142972	12554
chr21	18121982	18321982	harbor1	chr21	18153610	18153741	LTR/ERV1	772	+	66	18153676	31694
chr21	18121982	18321982	harbor1	chr21	18154306	18154462	LTR/ERV1	591	+	78	18154384	32402
chr21	18121982	18321982	harbor1	chr21	18154462	18154576	LTR/ERV1	512	+	57	18154519	32537
chr21	13893683	14093683	harbor1	chr21	13897194	13897743	LTR/ERV1	3979	+	274	13897468	3785
chr21	13893683	14093683	harbor1	chr21	13923244	13923661	LTR/ERV1	2362	+	208	13923452	29769
chr21	13893683	14093683	harbor1	chr21	13924205	13924568	LTR/ERV1	1216	+	182	13924387	30704
chr22	39331954	39531954	harbor1	chr22	39357358	39358791	LTR/ERV1	9648	+	716	39358074	26120
chr22	10485187	10685187	harbor1	chr22	10574437	10575285	LTR/ERV1	4125	+	424	10574861	89674
chr22	45598581	45798581	harbor1	chr22	45621951	45622937	LTR/ERV1	4852	+	493	45622444	23863
chr22	45598581	45798581	harbor1	chr22	45655826	45657701	LTR/ERV1	12299	+	938	45656764	58183
chr22	45598581	45798581	harbor1	chr22	45657704	45658078	LTR/ERV1	2352	+	187	45657891	59310
chr22	45598581	45798581	harbor1	chr22	45668762	45668895	LTR/ERV1	1068	+	66	45668828	70247
chr22	45598581	45798581	harbor1	chr22	45669189	45669497	LTR/ERV1	1068	+	154	45669343	70762
chr22	22161368	22361368	harbor1	chr22	22176209	22176973	LTR/ERV1	3990	+	382	22176591	15223
chr22	22161368	22361368	harbor1	chr22	22234817	22234844	LTR/ERV1	4226	+	14	22234831	73463
chr22	22161368	22361368	harbor1	chr22	22235155	22235747	LTR/ERV1	4226	+	296	22235451	74083
chr22	38509582	38709582	harbor1	chr22	38514147	38514246	LTR/ERV1	3852	+	50	38514197	4615
chr22	38509582	38709582	harbor1	chr22	38514273	38514286	LTR/ERV1	3852	+	6	38514279	4697
chr22	38509582	38709582	harbor1	chr22	38514532	38514970	LTR/ERV1	3852	+	219	38514751	5169
chr22	38509582	38709582	harbor1	chr22	38515166	38515195	LTR/ERV1	3852	+	14	38515180	5598
chr22	38509582	38709582	harbor1	chr22	38515503	38515517	LTR/ERV1	3852	+	7	38515510	5928
chr22	38509582	38709582	harbor1	chr22	38515803	38515924	LTR/ERV1	3852	+	60	38515863	6281
chr22	38509582	38709582	harbor1	chr22	38540844	38541291	LTR/ERV1	5095	+	224	38541068	31486
chr22	38509582	38709582	harbor1	chr22	38541558	38541780	LTR/ERV1	5095	+	111	38541669	32087
chr22	38509582	38709582	harbor1	chr22	38543539	38544072	LTR/ERV1	3087	+	266	38543805	34223
chr22	38509582	38709582	harbor1	chr22	38544208	38544626	LTR/ERV1	3283	+	209	38544417	34835
chr22	38509582	38709582	harbor1	chr22	38544931	38544986	LTR/ERV1	3283	+	28	38544959	35377
chr22	38509582	38709582	harbor1	chr22	38565252	38565727	LTR/ERV1	3080	+	238	38565490	55908
chr22	24766312	24966312	harbor1	chr22	24770343	24770540	LTR/ERV1	1733	+	98	24770441	4129
chr22	24766312	24966312	harbor1	chr22	24770865	24771180	LTR/ERV1	1733	+	158	24771023	4711
chr22	24766312	24966312	harbor1	chr22	24771499	24771577	LTR/ERV1	1733	+	39	24771538	5226
chr22	24766312	24966312	harbor1	chr22	24774075	24774525	LTR/ERV1	2610	+	225	24774300	7988
chr22	24766312	24966312	harbor1	chr22	24774829	24774873	LTR/ERV1	2610	+	22	24774851	8539
chr22	24766312	24966312	harbor1	chr22	24775176	24775332	LTR/ERV1	2610	+	78	24775254	8942
chr22	44176045	44376045	harbor1	chr22	44259811	44260322	LTR/ERV1	1094	+	256	44260067	84022
chr22	42045353	42245353	harbor1	chr22	42063330	42063819	LTR/ERV1	3618	+	244	42063574	18221
chr22	42045353	42245353	harbor1	chr22	42075907	42076054	LTR/ERV1	818	+	74	42075981	30628
chr22	42045353	42245353	harbor1	chr22	42076163	42076294	LTR/ERV1	818	+	66	42076229	30876
chr22	42045353	42245353	harbor1	chr22	42076588	42076781	LTR/ERV1	818	+	96	42076684	31331
chr22	42045353	42245353	harbor1	chr22	42138118	42139675	LTR/ERV1	9248	+	778	42138896	93543
chr22	19759481	19959481	harbor1	chr22	19808981	19809756	LTR/ERV1	4545	+	388	19809369	49888
chr22	15230986	15430986	harbor1	chr22	15255782	15256109	LTR/ERV1	1532	+	164	15255946	24960
chr22	15230986	15430986	harbor1	chr22	15278120	15278633	LTR/ERV1	2408	+	256	15278376	47390
chr22	15230986	15430986	harbor1	chr22	15278649	15278981	LTR/ERV1	1149	+	166	15278815	47829
chr22	15230986	15430986	harbor1	chr22	15278993	15280559	LTR/ERV1	7940	+	783	15279776	48790
chr22	15230986	15430986	harbor1	chr22	15288191	15290106	LTR/ERV1	12036	+	958	15289149	58163
chr22	15230986	15430986	harbor1	chr22	15290184	15290702	LTR/ERV1	2572	+	259	15290443	59457
chr22	15230986	15430986	harbor1	chr22	15284876	15288198	LTR/ERV1	22668	+	1661	15286537	55551
chr22	16104386	16304386	harbor1	chr22	16123694	16124021	LTR/ERV1	1608	+	164	16123858	19472
chr22	16104386	16304386	harbor1	chr22	16146029	16146542	LTR/ERV1	2399	+	256	16146285	41899
chr22	16104386	16304386	harbor1	chr22	16146558	16146890	LTR/ERV1	1140	+	166	16146724	42338
chr22	16104386	16304386	harbor1	chr22	16146998	16148386	LTR/ERV1	24371	+	694	16147692	43306
chr22	16104386	16304386	harbor1	chr22	16148686	16152001	LTR/ERV1	24371	+	1658	16150344	45958
chr22	16104386	16304386	harbor1	chr22	16151998	16153919	LTR/ERV1	11986	+	960	16152958	48572
chr22	16104386	16304386	harbor1	chr22	16153997	16154515	LTR/ERV1	2593	+	259	16154256	49870
chr22	48734214	48934214	harbor1	chr22	48801613	48802062	LTR/ERV1	2839	+	224	48801837	67623
chr22	15156214	15356214	harbor1	chr22	15255782	15256109	LTR/ERV1	1532	+	164	15255946	99732
chr22	16487907	16687907	harbor1	chr22	16543068	16543390	LTR/ERV1	887	+	161	16543229	55322
chr22	16487907	16687907	harbor1	chr22	16549522	16550445	LTR/ERV1	4862	+	462	16549984	62077
chr22	33821349	34021349	harbor1	chr22	33834286	33834682	LTR/ERV1	2794	+	198	33834484	13135
chr22	48972287	49172287	harbor1	chr22	49007574	49008138	LTR/ERV1	3174	+	282	49007856	35569
chr22	12165173	12365173	harbor1	chr22	12178924	12179269	LTR/ERV1	978	+	172	12179096	13923
chr22	12165173	12365173	harbor1	chr22	12206640	12207140	LTR/ERV1	1886	+	250	12206890	41717
chr22	47287967	47487967	harbor1	chr22	47377659	47378192	LTR/ERV1	2978	+	266	47377925	89958
chr22	42927825	43127825	harbor1	chr22	42998657	42999320	LTR/ERV1	3580	+	332	42998989	71164
chr22	40561426	40761426	harbor1	chr22	40640427	40640938	LTR/ERV1	4214	+	256	40640683	79257
chr22	40561426	40761426	harbor1	chr22	40641246	40641372	LTR/ERV1	4214	+	63	40641309	79883
chr22	11314317	11514317	harbor1	chr22	11327587	11327724	LTR/ERV1	707	+	68	11327655	13338
chr22	33915598	34115598	harbor1	chr22	33928037	33928666	LTR/ERV1	3991	+	314	33928351	12753
chr22	19641586	19841586	harbor1	chr22	19667218	19668050	LTR/ERV1	5563	+	416	19667634	26048
chr22	49891300	50091300	harbor1	chr22	49939162	49939249	LTR/ERV1	2210	+	44	49939206	47906
chr22	49891300	50091300	harbor1	chr22	49939552	49939792	LTR/ERV1	2210	+	120	49939672	48372
chr22	49891300	50091300	harbor1	chr22	49940087	49940258	LTR/ERV1	2210	+	86	49940173	48873
chr22	49891300	50091300	harbor1	chr22	49940571	49940651	LTR/ERV1	2210	+	40	49940611	49311
chr22	49891300	50091300	harbor1	chr22	49940974	49941097	LTR/ERV1	2210	+	62	49941036	49736
chr22	49939974	50139974	harbor1	chr22	49940087	49940258	LTR/ERV1	2210	+	86	49940173	199
chr22	49939974	50139974	harbor1	chr22	49940571	49940651	LTR/ERV1	2210	+	40	49940611	637
chr22	49939974	50139974	harbor1	chr22	49940974	49941097	LTR/ERV1	2210	+	62	49941036	1062
chr22	49939974	50139974	harbor1	chr22	50001993	50002388	LTR/ERV1	2148	+	198	50002191	62217
chr22	27975529	28175529	harbor1	chr22	28046886	28047441	LTR/ERV1	654	+	278	28047164	71635
chr22	16504276	16704276	harbor1	chr22	16543068	16543390	LTR/ERV1	887	+	161	16543229	38953
chr22	16504276	16704276	harbor1	chr22	16549522	16550445	LTR/ERV1	4862	+	462	16549984	45708
chr22	34074412	34274412	harbor1	chr22	34094329	34094478	LTR/ERV1	816	+	74	34094403	19991
chr22	34074412	34274412	harbor1	chr22	34099639	34100219	LTR/ERV1	4845	+	290	34099929	25517
chr22	34074412	34274412	harbor1	chr22	34123628	34124131	LTR/ERV1	3161	+	252	34123880	49468
chr22	34074412	34274412	harbor1	chr22	34094925	34095152	LTR/ERV1	1153	+	114	34095039	20627
chr22	11758260	11958260	harbor1	chr22	11797098	11797185	LTR/ERV1	2595	+	44	11797142	38882
chr22	11758260	11958260	harbor1	chr22	11797475	11798190	LTR/ERV1	2595	+	358	11797833	39573
chr22	11758260	11958260	harbor1	chr22	11798184	11798655	LTR/ERV1	2192	+	236	11798420	40160
chr22	11758260	11958260	harbor1	chr22	11798966	11799073	LTR/ERV1	2192	+	54	11799020	40760
chr22	11758260	11958260	harbor1	chr22	11799370	11799790	LTR/ERV1	3538	+	210	11799580	41320
chr22	11758260	11958260	harbor1	chr22	11800084	11800862	LTR/ERV1	3538	+	389	11800473	42213
chr22	11758260	11958260	harbor1	chr22	11806129	11806499	LTR/ERV1	2198	+	185	11806314	48054
chr22	11758260	11958260	harbor1	chr22	11807319	11807843	LTR/ERV1	2974	+	262	11807581	49321
chr22	11758260	11958260	harbor1	chr22	11811890	11811972	LTR/ERV1	463	+	41	11811931	53671
chr22	11758260	11958260	harbor1	chr22	11796356	11796824	LTR/ERV1	2595	+	234	11796590	38330
chrX	48410247	48610247	harbor1	chrX	48427650	48428000	LTR/ERV1	1239	+	175	48427825	17578
chrX	48410247	48610247	harbor1	chrX	48428353	48428401	LTR/ERV1	1239	+	24	48428377	18130
chrX	48410247	48610247	harbor1	chrX	48494417	48494805	LTR/ERV1	1012	+	194	48494611	84364
chrX	48410247	48610247	harbor1	chrX	48495107	48495185	LTR/ERV1	1012	+	39	48495146	84899
chrX	48410247	48610247	harbor1	chrX	48503150	48503712	LTR/ERV1	3007	+	281	48503431	93184
chrX	57100477	57300477	harbor1	chrX	57165767	57166568	LTR/ERV1	4115	+	400	57166167	65690
chrX	47619362	47819362	harbor1	chrX	47664833	47665343	LTR/ERV1	2226	+	255	47665088	45726
chrX	47619362	47819362	harbor1	chrX	47665644	47665684	LTR/ERV1	2226	+	20	47665664	46302
chrX	47619362	47819362	harbor1	chrX	47675916	47676479	LTR/ERV1	4396	+	282	47676198	56836
chrX	47619362	47819362	harbor1	chrX	47697972	47698809	LTR/ERV1	3702	+	418	47698390	79028
chrX	47619362	47819362	harbor1	chrX	47698830	47699628	LTR/ERV1	1409	+	399	47699229	79867
chrX	47619362	47819362	harbor1	chrX	47712681	47713135	LTR/ERV1	3291	+	227	47712908	93546
chrX	47619362	47819362	harbor1	chrX	47715786	47715925	LTR/ERV1	1003	+	70	47715856	96494
chrX	122154051	122354051	harbor1	chrX	122189961	122190292	LTR/ERV1	1947	+	166	122190127	36076
chrX	122154051	122354051	harbor1	chrX	122190294	122190950	LTR/ERV1	2542	+	328	122190622	36571
chrX	122154051	122354051	harbor1	chrX	122191018	122191814	LTR/ERV1	5056	+	398	122191416	37365
chrX	122154051	122354051	harbor1	chrX	122193470	122196459	LTR/ERV1	15666	+	1494	122194964	40913
chrX	122154051	122354051	harbor1	chrX	122196460	122196793	LTR/ERV1	2218	+	166	122196626	42575
chrX	122154051	122354051	harbor1	chrX	122219886	122220341	LTR/ERV1	2362	+	228	122220114	66063
chrX	122154051	122354051	harbor1	chrX	122220748	122222003	LTR/ERV1	4530	+	628	122221376	67325
chrX	122154051	122354051	harbor1	chrX	122222004	122222454	LTR/ERV1	3432	+	225	122222229	68178
chrX	122154051	122354051	harbor1	chrX	122225431	122225580	LTR/ERV1	925	+	74	122225505	71454
chrX	122154051	122354051	harbor1	chrX	122225571	122226075	LTR/ERV1	3330	+	252	122225823	71772
chrX	122154051	122354051	harbor1	chrX	122226078	122226739	LTR/ERV1	4405	+	330	122226408	72357
chrX	122154051	122354051	harbor1	chrX	122226741	122226956	LTR/ERV1	1375	+	108	122226849	72798
chrX	122154051	122354051	harbor1	chrX	122226955	122227334	LTR/ERV1	2514	+	190	122227145	73094
chrX	122154051	122354051	harbor1	chrX	122227335	122227785	LTR/ERV1	3408	+	225	122227560	73509
chrX	122154051	122354051	harbor1	chrX	122227788	122231275	LTR/ERV1	9697	+	1744	122229532	75481
chrX	122154051	122354051	harbor1	chrX	122238108	122238756	LTR/ERV1	2870	+	324	122238432	84381
chrX	122154051	122354051	harbor1	chrX	122238797	122238831	LTR/ERV1	1586	+	17	122238814	84763
chrX	122154051	122354051	harbor1	chrX	122238832	122239298	LTR/ERV1	2254	+	233	122239065	85014
chrX	122154051	122354051	harbor1	chrX	122246994	122247854	LTR/ERV1	3947	+	430	122247424	93373
chrX	122154051	122354051	harbor1	chrX	122222457	122225451	LTR/ERV1	20475	+	1497	122223954	69903
chrX	8324370	8524370	harbor1	chrX	8374755	8375346	LTR/ERV1	3122	+	296	8375051	50681
chrX	8324370	8524370	harbor1	chrX	8400906	8401223	LTR/ERV1	1174	+	158	8401064	76694
chrX	8324370	8524370	harbor1	chrX	8401834	8401950	LTR/ERV1	1174	+	58	8401892	77522
chrX	120009773	120209773	harbor1	chrX	120033304	120034026	LTR/ERV1	4690	+	361	120033665	23892
chrX	120009773	120209773	harbor1	chrX	120035005	120035650	LTR/ERV1	2524	+	322	120035327	25554
chrX	120009773	120209773	harbor1	chrX	120035654	120035804	LTR/ERV1	3287	+	75	120035729	25956
chrX	120009773	120209773	harbor1	chrX	120036297	120036820	LTR/ERV1	3287	+	262	120036559	26786
chrX	120009773	120209773	harbor1	chrX	120036941	120037193	LTR/ERV1	2186	+	126	120037067	27294
chrX	120009773	120209773	harbor1	chrX	120037503	120038005	LTR/ERV1	2186	+	251	120037754	27981
chrX	120009773	120209773	harbor1	chrX	120041755	120042193	LTR/ERV1	2446	+	219	120041974	32201
chrX	120009773	120209773	harbor1	chrX	120042479	120043162	LTR/ERV1	5388	+	342	120042821	33048
chrX	120009773	120209773	harbor1	chrX	120043800	120044522	LTR/ERV1	4960	+	361	120044161	34388
chrX	120009773	120209773	harbor1	chrX	120053064	120053276	LTR/ERV1	1208	+	106	120053170	43397
chrX	120009773	120209773	harbor1	chrX	120059857	120060061	LTR/ERV1	872	+	102	120059959	50186
chrX	120009773	120209773	harbor1	chrX	120067084	120068400	LTR/ERV1	3504	+	658	120067742	57969
chrX	120009773	120209773	harbor1	chrX	120068401	120068623	LTR/ERV1	1432	+	111	120068512	58739
chrX	120009773	120209773	harbor1	chrX	120095937	120096606	LTR/ERV1	3901	+	334	120096271	86498
chrX	120009773	120209773	harbor1	chrX	120097944	120100486	LTR/ERV1	20803	+	1271	120099215	89442
chrX	120009773	120209773	harbor1	chrX	120100478	120101233	LTR/ERV1	5595	+	378	120100856	91083
chrX	120009773	120209773	harbor1	chrX	120101234	120101690	LTR/ERV1	3261	+	228	120101462	91689
chrX	120009773	120209773	harbor1	chrX	120101694	120101799	LTR/ERV1	805	+	52	120101746	91973
chrX	120009773	120209773	harbor1	chrX	120101803	120102757	LTR/ERV1	4574	+	477	120102280	92507
chrX	120009773	120209773	harbor1	chrX	120103044	120103121	LTR/ERV1	4574	+	38	120103082	93309
chrX	120009773	120209773	harbor1	chrX	120103170	120103827	LTR/ERV1	4574	+	328	120103498	93725
chrX	96100675	96300675	harbor1	chrX	96163104	96163244	LTR/ERV1	848	+	70	96163174	62499
chrX	96100675	96300675	harbor1	chrX	96164467	96164480	LTR/ERV1	1008	+	6	96164473	63798
chrX	96100675	96300675	harbor1	chrX	96164481	96165016	LTR/ERV1	2857	+	268	96164749	64074
chrX	96100675	96300675	harbor1	chrX	96165017	96165198	LTR/ERV1	1008	+	90	96165107	64432
chrX	96100675	96300675	harbor1	chrX	96181245	96181763	LTR/ERV1	1570	+	259	96181504	80829
chrX	96100675	96300675	harbor1	chrX	96182777	96183443	LTR/ERV1	2016	+	333	96183110	82435
chrX	146405723	146605723	harbor1	chrX	146435515	146436084	LTR/ERV1	2708	+	284	146435799	30076
chrX	146405723	146605723	harbor1	chrX	146440573	146440732	LTR/ERV1	933	+	80	146440653	34930
chrX	146405723	146605723	harbor1	chrX	146445912	146446614	LTR/ERV1	3820	+	351	146446263	40540
chrX	146405723	146605723	harbor1	chrX	146463840	146464069	LTR/ERV1	996	+	114	146463954	58231
chrX	38326752	38526752	harbor1	chrX	38329441	38329956	LTR/ERV1	2865	+	258	38329699	2947
chrX	38326752	38526752	harbor1	chrX	38345166	38345410	LTR/ERV1	1825	+	122	38345288	18536
chrX	38326752	38526752	harbor1	chrX	38370530	38370834	LTR/ERV1	1620	+	152	38370682	43930
chrX	79028734	79228734	harbor1	chrX	79100717	79101250	LTR/ERV1	2097	+	266	79100983	72249
chrX	88193192	88393192	harbor1	chrX	88270303	88270659	LTR/ERV1	2433	+	178	88270481	77289
chrX	1393857	1593857	harbor1	chrX	1443947	1444189	LTR/ERV1	804	+	121	1444068	50211
chrX	1393857	1593857	harbor1	chrX	1444549	1444716	LTR/ERV1	807	+	84	1444633	50776
chrX	1393857	1593857	harbor1	chrX	1444698	1445607	LTR/ERV1	5305	+	454	1445152	51295
chrX	1393857	1593857	harbor1	chrX	1446799	1447204	LTR/ERV1	1583	+	202	1447001	53144
chrX	1393857	1593857	harbor1	chrX	1448875	1449267	LTR/ERV1	1759	+	196	1449071	55214
chrX	42813765	43013765	harbor1	chrX	42821191	42821671	LTR/ERV1	1406	+	240	42821431	7666
chrX	42813765	43013765	harbor1	chrX	42833538	42834128	LTR/ERV1	4923	+	295	42833833	20068
chrX	42813765	43013765	harbor1	chrX	42858836	42859311	LTR/ERV1	1719	+	238	42859074	45309
chrX	42813765	43013765	harbor1	chrX	42859318	42859784	LTR/ERV1	1975	+	233	42859551	45786
chrX	42813765	43013765	harbor1	chrX	42861038	42861473	LTR/ERV1	3010	+	218	42861256	47491
